Origin,Country of origin,Country-code,Country,Year,Inflow,Outflow,Net-Migration
AFG,Afghanistan,AUS,Australia,2008,2033,77,1956
AFG,Afghanistan,AUS,Australia,2009,1696,96,1600
AFG,Afghanistan,AUS,Australia,2010,1618,105,1513
AFG,Afghanistan,AUS,Australia,2011,2030,164,1866
AFG,Afghanistan,AUS,Australia,2012,1623,116,1507
AFG,Afghanistan,AUS,Australia,2013,2178,114,2064
AFG,Afghanistan,AUS,Australia,2014,5686,115,5571
AFG,Afghanistan,AUS,Australia,2015,3323,100,3223
AFG,Afghanistan,AUS,Australia,2016,3197,100,3097
AFG,Afghanistan,AUS,Australia,2017,3566,0,3566
AFG,Afghanistan,AUT,Austria,2008,958,111,847
AFG,Afghanistan,AUT,Austria,2009,1422,297,1125
AFG,Afghanistan,AUT,Austria,2010,1281,317,964
AFG,Afghanistan,AUT,Austria,2011,2908,252,2656
AFG,Afghanistan,AUT,Austria,2012,3756,794,2962
AFG,Afghanistan,AUT,Austria,2013,2305,611,1694
AFG,Afghanistan,AUT,Austria,2014,3171,462,2709
AFG,Afghanistan,AUT,Austria,2015,19505,896,18609
AFG,Afghanistan,AUT,Austria,2016,11660,2668,8992
AFG,Afghanistan,AUT,Austria,2017,2103,1954,149
AFG,Afghanistan,BEL,Belgium,2008,138,0,138
AFG,Afghanistan,BEL,Belgium,2009,150,0,150
AFG,Afghanistan,BEL,Belgium,2010,208,19,189
AFG,Afghanistan,BEL,Belgium,2011,285,0,285
AFG,Afghanistan,BEL,Belgium,2012,2804,379,2425
AFG,Afghanistan,BEL,Belgium,2013,1255,765,490
AFG,Afghanistan,BEL,Belgium,2014,1134,481,653
AFG,Afghanistan,BEL,Belgium,2015,7453,317,7136
AFG,Afghanistan,BEL,Belgium,2016,2481,205,2276
AFG,Afghanistan,BEL,Belgium,2017,1537,431,1106
AFG,Afghanistan,CAN,Canada,2008,2110,0,2110
AFG,Afghanistan,CAN,Canada,2009,1745,0,1745
AFG,Afghanistan,CAN,Canada,2010,1758,0,1758
AFG,Afghanistan,CAN,Canada,2011,2203,0,2203
AFG,Afghanistan,CAN,Canada,2012,2635,0,2635
AFG,Afghanistan,CAN,Canada,2013,2003,0,2003
AFG,Afghanistan,CAN,Canada,2014,1489,0,1489
AFG,Afghanistan,CAN,Canada,2015,2587,0,2587
AFG,Afghanistan,CAN,Canada,2016,2635,0,2635
AFG,Afghanistan,CAN,Canada,2017,3440,0,3440
AFG,Afghanistan,CZE,Czech Republic,2008,21,6,15
AFG,Afghanistan,CZE,Czech Republic,2009,13,0,13
AFG,Afghanistan,CZE,Czech Republic,2010,27,0,27
AFG,Afghanistan,CZE,Czech Republic,2011,25,1,24
AFG,Afghanistan,CZE,Czech Republic,2012,25,1,24
AFG,Afghanistan,CZE,Czech Republic,2013,24,17,7
AFG,Afghanistan,CZE,Czech Republic,2014,32,9,23
AFG,Afghanistan,CZE,Czech Republic,2015,55,9,46
AFG,Afghanistan,CZE,Czech Republic,2016,84,49,35
AFG,Afghanistan,CZE,Czech Republic,2017,86,92,-6
AFG,Afghanistan,DNK,Denmark,2008,154,25,129
AFG,Afghanistan,DNK,Denmark,2009,325,13,312
AFG,Afghanistan,DNK,Denmark,2010,669,30,639
AFG,Afghanistan,DNK,Denmark,2011,710,27,683
AFG,Afghanistan,DNK,Denmark,2012,540,31,509
AFG,Afghanistan,DNK,Denmark,2013,645,24,621
AFG,Afghanistan,DNK,Denmark,2014,526,21,505
AFG,Afghanistan,DNK,Denmark,2015,267,33,234
AFG,Afghanistan,DNK,Denmark,2016,361,36,325
AFG,Afghanistan,DNK,Denmark,2017,589,32,557
AFG,Afghanistan,FIN,Finland,2008,219,8,211
AFG,Afghanistan,FIN,Finland,2009,226,8,218
AFG,Afghanistan,FIN,Finland,2010,321,4,317
AFG,Afghanistan,FIN,Finland,2011,373,3,370
AFG,Afghanistan,FIN,Finland,2012,593,4,589
AFG,Afghanistan,FIN,Finland,2013,627,5,622
AFG,Afghanistan,FIN,Finland,2014,515,7,508
AFG,Afghanistan,FIN,Finland,2015,394,7,387
AFG,Afghanistan,FIN,Finland,2016,1864,9,1855
AFG,Afghanistan,FIN,Finland,2017,879,11,868
AFG,Afghanistan,FRA,France,2008,172,0,172
AFG,Afghanistan,FRA,France,2009,215,0,215
AFG,Afghanistan,FRA,France,2010,355,0,355
AFG,Afghanistan,FRA,France,2011,448,0,448
AFG,Afghanistan,FRA,France,2012,646,0,646
AFG,Afghanistan,FRA,France,2013,895,0,895
AFG,Afghanistan,FRA,France,2014,781,0,781
AFG,Afghanistan,FRA,France,2015,630,0,630
AFG,Afghanistan,FRA,France,2016,1706,0,1706
AFG,Afghanistan,FRA,France,2017,4904,0,4904
AFG,Afghanistan,DEU,Germany,2008,1855,1510,345
AFG,Afghanistan,DEU,Germany,2009,4622,1597,3025
AFG,Afghanistan,DEU,Germany,2010,7377,1449,5928
AFG,Afghanistan,DEU,Germany,2011,9321,1453,7868
AFG,Afghanistan,DEU,Germany,2012,8581,1932,6649
AFG,Afghanistan,DEU,Germany,2013,9088,1860,7228
AFG,Afghanistan,DEU,Germany,2014,12922,2057,10865
AFG,Afghanistan,DEU,Germany,2015,84881,5309,79572
AFG,Afghanistan,DEU,Germany,2016,75763,19701,56062
AFG,Afghanistan,DEU,Germany,2017,12489,8849,3640
AFG,Afghanistan,HUN,Hungary,2008,11,1,10
AFG,Afghanistan,HUN,Hungary,2009,26,1,25
AFG,Afghanistan,HUN,Hungary,2010,21,0,21
AFG,Afghanistan,HUN,Hungary,2011,14,1,13
AFG,Afghanistan,HUN,Hungary,2012,25,0,25
AFG,Afghanistan,HUN,Hungary,2013,54,3,51
AFG,Afghanistan,HUN,Hungary,2014,108,5,103
AFG,Afghanistan,HUN,Hungary,2015,112,13,99
AFG,Afghanistan,HUN,Hungary,2016,101,6,95
AFG,Afghanistan,HUN,Hungary,2017,476,0,476
AFG,Afghanistan,ISL,Iceland,2008,0,0,0
AFG,Afghanistan,ISL,Iceland,2009,0,0,0
AFG,Afghanistan,ISL,Iceland,2010,3,0,3
AFG,Afghanistan,ISL,Iceland,2011,1,0,1
AFG,Afghanistan,ISL,Iceland,2012,3,1,2
AFG,Afghanistan,ISL,Iceland,2013,0,0,0
AFG,Afghanistan,ISL,Iceland,2014,6,1,5
AFG,Afghanistan,ISL,Iceland,2015,7,0,7
AFG,Afghanistan,ISL,Iceland,2016,10,2,8
AFG,Afghanistan,ISL,Iceland,2017,36,2,34
AFG,Afghanistan,ITA,Italy,2008,1175,8,1167
AFG,Afghanistan,ITA,Italy,2009,1017,11,1006
AFG,Afghanistan,ITA,Italy,2010,694,13,681
AFG,Afghanistan,ITA,Italy,2011,847,14,833
AFG,Afghanistan,ITA,Italy,2012,1109,8,1101
AFG,Afghanistan,ITA,Italy,2013,1147,19,1128
AFG,Afghanistan,ITA,Italy,2014,1527,43,1484
AFG,Afghanistan,ITA,Italy,2015,2370,79,2291
AFG,Afghanistan,ITA,Italy,2016,3191,0,3191
AFG,Afghanistan,ITA,Italy,2017,2120,125,1995
AFG,Afghanistan,JPN,Japan,2008,364,225,139
AFG,Afghanistan,JPN,Japan,2009,430,287,143
AFG,Afghanistan,JPN,Japan,2010,560,403,157
AFG,Afghanistan,JPN,Japan,2011,553,301,252
AFG,Afghanistan,JPN,Japan,2012,894,543,351
AFG,Afghanistan,JPN,Japan,2013,690,337,353
AFG,Afghanistan,JPN,Japan,2014,773,431,342
AFG,Afghanistan,JPN,Japan,2015,1118,564,554
AFG,Afghanistan,JPN,Japan,2016,747,407,340
AFG,Afghanistan,JPN,Japan,2017,743,523,220
AFG,Afghanistan,KOR,Korea,2008,84,44,40
AFG,Afghanistan,KOR,Korea,2009,88,67,21
AFG,Afghanistan,KOR,Korea,2010,88,75,13
AFG,Afghanistan,KOR,Korea,2011,158,88,70
AFG,Afghanistan,KOR,Korea,2012,107,95,12
AFG,Afghanistan,KOR,Korea,2013,111,104,7
AFG,Afghanistan,KOR,Korea,2014,92,102,-10
AFG,Afghanistan,KOR,Korea,2015,59,73,-14
AFG,Afghanistan,KOR,Korea,2016,68,68,0
AFG,Afghanistan,KOR,Korea,2017,81,61,20
AFG,Afghanistan,LUX,Luxembourg,2008,2,2,0
AFG,Afghanistan,LUX,Luxembourg,2009,18,0,18
AFG,Afghanistan,LUX,Luxembourg,2010,15,6,9
AFG,Afghanistan,LUX,Luxembourg,2011,16,1,15
AFG,Afghanistan,LUX,Luxembourg,2012,11,2,9
AFG,Afghanistan,LUX,Luxembourg,2013,14,4,10
AFG,Afghanistan,LUX,Luxembourg,2014,4,7,-3
AFG,Afghanistan,LUX,Luxembourg,2015,199,4,195
AFG,Afghanistan,LUX,Luxembourg,2016,71,19,52
AFG,Afghanistan,LUX,Luxembourg,2017,20,1,19
AFG,Afghanistan,MEX,Mexico,2008,1,0,1
AFG,Afghanistan,MEX,Mexico,2009,1,0,1
AFG,Afghanistan,MEX,Mexico,2012,4,0,4
AFG,Afghanistan,MEX,Mexico,2013,1,0,1
AFG,Afghanistan,MEX,Mexico,2014,0,0,0
AFG,Afghanistan,MEX,Mexico,2017,1,0,1
AFG,Afghanistan,NLD,Netherlands,2008,236,46,190
AFG,Afghanistan,NLD,Netherlands,2009,289,46,243
AFG,Afghanistan,NLD,Netherlands,2010,338,29,309
AFG,Afghanistan,NLD,Netherlands,2011,275,56,219
AFG,Afghanistan,NLD,Netherlands,2012,231,65,166
AFG,Afghanistan,NLD,Netherlands,2013,397,56,341
AFG,Afghanistan,NLD,Netherlands,2014,554,59,495
AFG,Afghanistan,NLD,Netherlands,2015,667,64,603
AFG,Afghanistan,NLD,Netherlands,2016,1879,76,1803
AFG,Afghanistan,NLD,Netherlands,2017,785,224,561
AFG,Afghanistan,NZL,New Zealand,2008,75,2,73
AFG,Afghanistan,NZL,New Zealand,2009,158,2,156
AFG,Afghanistan,NZL,New Zealand,2010,91,3,88
AFG,Afghanistan,NZL,New Zealand,2011,72,2,70
AFG,Afghanistan,NZL,New Zealand,2012,96,2,94
AFG,Afghanistan,NZL,New Zealand,2013,218,1,217
AFG,Afghanistan,NZL,New Zealand,2014,356,7,349
AFG,Afghanistan,NZL,New Zealand,2015,269,7,262
AFG,Afghanistan,NZL,New Zealand,2016,225,3,222
AFG,Afghanistan,NZL,New Zealand,2017,206,3,203
AFG,Afghanistan,NOR,Norway,2008,785,22,763
AFG,Afghanistan,NOR,Norway,2009,1386,36,1350
AFG,Afghanistan,NOR,Norway,2010,1417,42,1375
AFG,Afghanistan,NOR,Norway,2011,1095,49,1046
AFG,Afghanistan,NOR,Norway,2012,1219,58,1161
AFG,Afghanistan,NOR,Norway,2013,990,72,918
AFG,Afghanistan,NOR,Norway,2014,833,105,728
AFG,Afghanistan,NOR,Norway,2015,1381,84,1297
AFG,Afghanistan,NOR,Norway,2016,2166,67,2099
AFG,Afghanistan,NOR,Norway,2017,1114,110,1004
AFG,Afghanistan,POL,Poland,2008,25,0,25
AFG,Afghanistan,POL,Poland,2009,34,0,34
AFG,Afghanistan,POL,Poland,2010,31,0,31
AFG,Afghanistan,POL,Poland,2011,44,0,44
AFG,Afghanistan,POL,Poland,2012,51,0,51
AFG,Afghanistan,POL,Poland,2013,60,0,60
AFG,Afghanistan,POL,Poland,2014,32,0,32
AFG,Afghanistan,POL,Poland,2015,84,0,84
AFG,Afghanistan,POL,Poland,2016,76,0,76
AFG,Afghanistan,POL,Poland,2017,81,0,81
AFG,Afghanistan,SVK,Slovak Republic,2008,2,8,-6
AFG,Afghanistan,SVK,Slovak Republic,2009,1,7,-6
AFG,Afghanistan,SVK,Slovak Republic,2010,1,6,-5
AFG,Afghanistan,SVK,Slovak Republic,2011,3,13,-10
AFG,Afghanistan,SVK,Slovak Republic,2012,1,0,1
AFG,Afghanistan,SVK,Slovak Republic,2013,1,0,1
AFG,Afghanistan,SVK,Slovak Republic,2014,2,0,2
AFG,Afghanistan,SVK,Slovak Republic,2015,16,0,16
AFG,Afghanistan,SVK,Slovak Republic,2016,4,0,4
AFG,Afghanistan,ESP,Spain,2008,54,18,36
AFG,Afghanistan,ESP,Spain,2009,66,23,43
AFG,Afghanistan,ESP,Spain,2010,44,35,9
AFG,Afghanistan,ESP,Spain,2011,49,50,-1
AFG,Afghanistan,ESP,Spain,2012,40,39,1
AFG,Afghanistan,ESP,Spain,2013,68,32,36
AFG,Afghanistan,ESP,Spain,2014,113,45,68
AFG,Afghanistan,ESP,Spain,2015,48,24,24
AFG,Afghanistan,ESP,Spain,2016,83,23,60
AFG,Afghanistan,ESP,Spain,2017,121,28,93
AFG,Afghanistan,SWE,Sweden,2008,1033,60,973
AFG,Afghanistan,SWE,Sweden,2009,1558,34,1524
AFG,Afghanistan,SWE,Sweden,2010,1920,64,1856
AFG,Afghanistan,SWE,Sweden,2011,3415,58,3357
AFG,Afghanistan,SWE,Sweden,2012,4673,69,4604
AFG,Afghanistan,SWE,Sweden,2013,4165,63,4102
AFG,Afghanistan,SWE,Sweden,2014,3844,67,3777
AFG,Afghanistan,SWE,Sweden,2015,3375,80,3295
AFG,Afghanistan,SWE,Sweden,2016,4081,58,4023
AFG,Afghanistan,SWE,Sweden,2017,11309,63,11246
AFG,Afghanistan,CHE,Switzerland,2010,245,9,236
AFG,Afghanistan,CHE,Switzerland,2011,175,12,163
AFG,Afghanistan,CHE,Switzerland,2012,267,13,254
AFG,Afghanistan,CHE,Switzerland,2013,295,9,286
AFG,Afghanistan,CHE,Switzerland,2014,509,7,502
AFG,Afghanistan,CHE,Switzerland,2015,513,13,500
AFG,Afghanistan,CHE,Switzerland,2016,510,14,496
AFG,Afghanistan,CHE,Switzerland,2017,854,10,844
AFG,Afghanistan,TUR,Turkey,2010,2188,0,2188
AFG,Afghanistan,TUR,Turkey,2016,27850,6883,20967
AFG,Afghanistan,TUR,Turkey,2017,37747,6413,31334
AFG,Afghanistan,GBR,United Kingdom,2011,1000,0,1000
AFG,Afghanistan,GBR,United Kingdom,2012,1000,0,1000
AFG,Afghanistan,GBR,United Kingdom,2013,2000,0,2000
AFG,Afghanistan,GBR,United Kingdom,2015,1000,0,1000
AFG,Afghanistan,USA,United States,2008,2813,0,2813
AFG,Afghanistan,USA,United States,2009,3165,0,3165
AFG,Afghanistan,USA,United States,2010,2017,0,2017
AFG,Afghanistan,USA,United States,2011,1648,0,1648
AFG,Afghanistan,USA,United States,2012,1617,0,1617
AFG,Afghanistan,USA,United States,2013,2196,0,2196
AFG,Afghanistan,USA,United States,2014,10527,0,10527
AFG,Afghanistan,USA,United States,2015,8328,0,8328
AFG,Afghanistan,USA,United States,2016,12513,0,12513
AFG,Afghanistan,USA,United States,2017,19538,0,19538
AFG,Afghanistan,CHL,Chile,2008,0,0,0
AFG,Afghanistan,CHL,Chile,2009,1,0,1
AFG,Afghanistan,CHL,Chile,2010,0,0,0
AFG,Afghanistan,CHL,Chile,2011,1,0,1
AFG,Afghanistan,CHL,Chile,2012,3,0,3
AFG,Afghanistan,CHL,Chile,2013,9,0,9
AFG,Afghanistan,CHL,Chile,2014,0,0,0
AFG,Afghanistan,CHL,Chile,2015,5,0,5
AFG,Afghanistan,CHL,Chile,2016,4,0,4
AFG,Afghanistan,EST,Estonia,2008,1,0,1
AFG,Afghanistan,EST,Estonia,2009,0,0,0
AFG,Afghanistan,EST,Estonia,2010,0,0,0
AFG,Afghanistan,EST,Estonia,2011,1,0,1
AFG,Afghanistan,EST,Estonia,2012,0,0,0
AFG,Afghanistan,EST,Estonia,2013,1,0,1
AFG,Afghanistan,EST,Estonia,2014,0,0,0
AFG,Afghanistan,EST,Estonia,2015,5,0,5
AFG,Afghanistan,EST,Estonia,2016,16,0,16
AFG,Afghanistan,EST,Estonia,2017,19,0,19
AFG,Afghanistan,SVN,Slovenia,2014,2,0,2
AFG,Afghanistan,SVN,Slovenia,2015,2,0,2
ALB,Albania,AUS,Australia,2008,115,13,102
ALB,Albania,AUS,Australia,2009,161,9,152
ALB,Albania,AUS,Australia,2010,144,25,119
ALB,Albania,AUS,Australia,2011,110,11,99
ALB,Albania,AUS,Australia,2012,144,21,123
ALB,Albania,AUS,Australia,2013,117,6,111
ALB,Albania,AUS,Australia,2014,111,11,100
ALB,Albania,AUS,Australia,2015,89,0,89
ALB,Albania,AUS,Australia,2016,80,0,80
ALB,Albania,AUS,Australia,2017,101,0,101
ALB,Albania,AUT,Austria,2008,172,102,70
ALB,Albania,AUT,Austria,2009,185,117,68
ALB,Albania,AUT,Austria,2010,136,100,36
ALB,Albania,AUT,Austria,2011,192,125,67
ALB,Albania,AUT,Austria,2012,250,113,137
ALB,Albania,AUT,Austria,2013,330,153,177
ALB,Albania,AUT,Austria,2014,383,193,190
ALB,Albania,AUT,Austria,2015,482,218,264
ALB,Albania,AUT,Austria,2016,435,277,158
ALB,Albania,AUT,Austria,2017,507,284,223
ALB,Albania,BEL,Belgium,2008,297,0,297
ALB,Albania,BEL,Belgium,2009,351,0,351
ALB,Albania,BEL,Belgium,2010,376,78,298
ALB,Albania,BEL,Belgium,2011,395,0,395
ALB,Albania,BEL,Belgium,2012,881,468,413
ALB,Albania,BEL,Belgium,2013,830,672,158
ALB,Albania,BEL,Belgium,2014,727,499,228
ALB,Albania,BEL,Belgium,2015,878,565,313
ALB,Albania,BEL,Belgium,2016,912,236,676
ALB,Albania,BEL,Belgium,2017,976,219,757
ALB,Albania,CAN,Canada,2008,560,0,560
ALB,Albania,CAN,Canada,2009,715,0,715
ALB,Albania,CAN,Canada,2010,560,0,560
ALB,Albania,CAN,Canada,2011,539,0,539
ALB,Albania,CAN,Canada,2012,619,0,619
ALB,Albania,CAN,Canada,2013,603,0,603
ALB,Albania,CAN,Canada,2014,519,0,519
ALB,Albania,CAN,Canada,2015,574,0,574
ALB,Albania,CAN,Canada,2016,515,0,515
ALB,Albania,CAN,Canada,2017,645,0,645
ALB,Albania,CZE,Czech Republic,2008,42,2,40
ALB,Albania,CZE,Czech Republic,2009,38,0,38
ALB,Albania,CZE,Czech Republic,2010,30,1,29
ALB,Albania,CZE,Czech Republic,2011,21,0,21
ALB,Albania,CZE,Czech Republic,2012,50,23,27
ALB,Albania,CZE,Czech Republic,2013,30,53,-23
ALB,Albania,CZE,Czech Republic,2014,34,29,5
ALB,Albania,CZE,Czech Republic,2015,51,17,34
ALB,Albania,CZE,Czech Republic,2016,54,17,37
ALB,Albania,CZE,Czech Republic,2017,72,21,51
ALB,Albania,DNK,Denmark,2008,23,13,10
ALB,Albania,DNK,Denmark,2009,20,12,8
ALB,Albania,DNK,Denmark,2010,26,11,15
ALB,Albania,DNK,Denmark,2011,17,6,11
ALB,Albania,DNK,Denmark,2012,12,10,2
ALB,Albania,DNK,Denmark,2013,23,13,10
ALB,Albania,DNK,Denmark,2014,29,11,18
ALB,Albania,DNK,Denmark,2015,25,11,14
ALB,Albania,DNK,Denmark,2016,39,17,22
ALB,Albania,DNK,Denmark,2017,50,22,28
ALB,Albania,FIN,Finland,2008,31,1,30
ALB,Albania,FIN,Finland,2009,14,1,13
ALB,Albania,FIN,Finland,2010,9,1,8
ALB,Albania,FIN,Finland,2011,21,0,21
ALB,Albania,FIN,Finland,2012,38,2,36
ALB,Albania,FIN,Finland,2013,59,3,56
ALB,Albania,FIN,Finland,2014,54,4,50
ALB,Albania,FIN,Finland,2015,74,6,68
ALB,Albania,FIN,Finland,2016,76,2,74
ALB,Albania,FIN,Finland,2017,90,7,83
ALB,Albania,FRA,France,2008,358,0,358
ALB,Albania,FRA,France,2009,318,0,318
ALB,Albania,FRA,France,2010,303,0,303
ALB,Albania,FRA,France,2011,404,0,404
ALB,Albania,FRA,France,2012,397,0,397
ALB,Albania,FRA,France,2013,502,0,502
ALB,Albania,FRA,France,2014,768,0,768
ALB,Albania,FRA,France,2015,1128,0,1128
ALB,Albania,FRA,France,2016,1433,0,1433
ALB,Albania,FRA,France,2017,1654,0,1654
ALB,Albania,DEU,Germany,2008,1046,829,217
ALB,Albania,DEU,Germany,2009,961,812,149
ALB,Albania,DEU,Germany,2010,913,669,244
ALB,Albania,DEU,Germany,2011,1417,833,584
ALB,Albania,DEU,Germany,2012,2234,951,1283
ALB,Albania,DEU,Germany,2013,4131,1447,2684
ALB,Albania,DEU,Germany,2014,15165,3519,11646
ALB,Albania,DEU,Germany,2015,69362,22533,46829
ALB,Albania,DEU,Germany,2016,12982,39124,-26142
ALB,Albania,DEU,Germany,2017,14905,15904,-999
ALB,Albania,GRC,Greece,2008,32107,0,32107
ALB,Albania,GRC,Greece,2009,34610,0,34610
ALB,Albania,GRC,Greece,2010,23688,0,23688
ALB,Albania,GRC,Greece,2011,14327,0,14327
ALB,Albania,HUN,Hungary,2008,28,4,24
ALB,Albania,HUN,Hungary,2009,19,3,16
ALB,Albania,HUN,Hungary,2010,15,3,12
ALB,Albania,HUN,Hungary,2011,18,2,16
ALB,Albania,HUN,Hungary,2012,30,4,26
ALB,Albania,HUN,Hungary,2013,64,7,57
ALB,Albania,HUN,Hungary,2014,62,16,46
ALB,Albania,HUN,Hungary,2015,77,24,53
ALB,Albania,HUN,Hungary,2016,70,34,36
ALB,Albania,HUN,Hungary,2017,114,0,114
ALB,Albania,ISL,Iceland,2008,1,1,0
ALB,Albania,ISL,Iceland,2009,3,1,2
ALB,Albania,ISL,Iceland,2010,1,0,1
ALB,Albania,ISL,Iceland,2011,1,0,1
ALB,Albania,ISL,Iceland,2012,0,2,-2
ALB,Albania,ISL,Iceland,2013,4,0,4
ALB,Albania,ISL,Iceland,2014,5,3,2
ALB,Albania,ISL,Iceland,2015,8,0,8
ALB,Albania,ISL,Iceland,2016,29,1,28
ALB,Albania,ISL,Iceland,2017,42,2,40
ALB,Albania,ITA,Italy,2008,35715,925,34790
ALB,Albania,ITA,Italy,2009,27493,1110,26383
ALB,Albania,ITA,Italy,2010,22591,1495,21096
ALB,Albania,ITA,Italy,2011,16613,1525,15088
ALB,Albania,ITA,Italy,2012,14118,1794,12324
ALB,Albania,ITA,Italy,2013,12165,2296,9869
ALB,Albania,ITA,Italy,2014,11398,2114,9284
ALB,Albania,ITA,Italy,2015,11545,1959,9586
ALB,Albania,ITA,Italy,2016,12966,0,12966
ALB,Albania,ITA,Italy,2017,15385,1564,13821
ALB,Albania,JPN,Japan,2008,61,57,4
ALB,Albania,JPN,Japan,2009,54,52,2
ALB,Albania,JPN,Japan,2010,46,45,1
ALB,Albania,JPN,Japan,2011,35,36,-1
ALB,Albania,JPN,Japan,2012,56,56,0
ALB,Albania,JPN,Japan,2013,52,51,1
ALB,Albania,JPN,Japan,2014,34,34,0
ALB,Albania,JPN,Japan,2015,70,61,9
ALB,Albania,JPN,Japan,2016,48,44,4
ALB,Albania,JPN,Japan,2017,57,44,13
ALB,Albania,KOR,Korea,2008,12,11,1
ALB,Albania,KOR,Korea,2009,7,10,-3
ALB,Albania,KOR,Korea,2010,11,9,2
ALB,Albania,KOR,Korea,2011,17,11,6
ALB,Albania,KOR,Korea,2012,20,17,3
ALB,Albania,KOR,Korea,2013,18,16,2
ALB,Albania,KOR,Korea,2014,6,8,-2
ALB,Albania,KOR,Korea,2015,4,8,-4
ALB,Albania,KOR,Korea,2016,9,6,3
ALB,Albania,KOR,Korea,2017,16,14,2
ALB,Albania,LUX,Luxembourg,2008,35,20,15
ALB,Albania,LUX,Luxembourg,2009,40,10,30
ALB,Albania,LUX,Luxembourg,2010,98,12,86
ALB,Albania,LUX,Luxembourg,2011,40,5,35
ALB,Albania,LUX,Luxembourg,2012,123,15,108
ALB,Albania,LUX,Luxembourg,2013,74,40,34
ALB,Albania,LUX,Luxembourg,2014,107,68,39
ALB,Albania,LUX,Luxembourg,2015,146,90,56
ALB,Albania,LUX,Luxembourg,2016,163,81,82
ALB,Albania,LUX,Luxembourg,2017,114,130,-16
ALB,Albania,MEX,Mexico,2008,3,0,3
ALB,Albania,MEX,Mexico,2009,9,0,9
ALB,Albania,MEX,Mexico,2010,4,0,4
ALB,Albania,MEX,Mexico,2011,5,0,5
ALB,Albania,MEX,Mexico,2012,6,0,6
ALB,Albania,MEX,Mexico,2013,13,0,13
ALB,Albania,MEX,Mexico,2014,4,0,4
ALB,Albania,MEX,Mexico,2015,2,0,2
ALB,Albania,MEX,Mexico,2016,12,0,12
ALB,Albania,MEX,Mexico,2017,8,0,8
ALB,Albania,NLD,Netherlands,2008,97,23,74
ALB,Albania,NLD,Netherlands,2009,145,45,100
ALB,Albania,NLD,Netherlands,2010,94,69,25
ALB,Albania,NLD,Netherlands,2011,100,68,32
ALB,Albania,NLD,Netherlands,2012,120,66,54
ALB,Albania,NLD,Netherlands,2013,128,68,60
ALB,Albania,NLD,Netherlands,2014,179,56,123
ALB,Albania,NLD,Netherlands,2015,232,84,148
ALB,Albania,NLD,Netherlands,2016,271,92,179
ALB,Albania,NLD,Netherlands,2017,297,181,116
ALB,Albania,NZL,New Zealand,2008,5,0,5
ALB,Albania,NZL,New Zealand,2009,3,0,3
ALB,Albania,NZL,New Zealand,2010,5,0,5
ALB,Albania,NZL,New Zealand,2012,2,0,2
ALB,Albania,NZL,New Zealand,2013,3,0,3
ALB,Albania,NZL,New Zealand,2014,7,1,6
ALB,Albania,NZL,New Zealand,2015,5,0,5
ALB,Albania,NZL,New Zealand,2016,8,1,7
ALB,Albania,NZL,New Zealand,2017,4,1,3
ALB,Albania,NOR,Norway,2008,53,11,42
ALB,Albania,NOR,Norway,2009,34,9,25
ALB,Albania,NOR,Norway,2010,34,13,21
ALB,Albania,NOR,Norway,2011,50,15,35
ALB,Albania,NOR,Norway,2012,62,15,47
ALB,Albania,NOR,Norway,2013,69,14,55
ALB,Albania,NOR,Norway,2014,105,25,80
ALB,Albania,NOR,Norway,2015,143,21,122
ALB,Albania,NOR,Norway,2016,143,31,112
ALB,Albania,NOR,Norway,2017,170,31,139
ALB,Albania,POL,Poland,2008,175,0,175
ALB,Albania,POL,Poland,2009,179,0,179
ALB,Albania,POL,Poland,2010,145,0,145
ALB,Albania,POL,Poland,2011,106,0,106
ALB,Albania,POL,Poland,2012,83,0,83
ALB,Albania,POL,Poland,2013,92,0,92
ALB,Albania,POL,Poland,2014,58,0,58
ALB,Albania,POL,Poland,2015,98,0,98
ALB,Albania,POL,Poland,2016,101,0,101
ALB,Albania,POL,Poland,2017,98,0,98
ALB,Albania,SVK,Slovak Republic,2008,6,2,4
ALB,Albania,SVK,Slovak Republic,2009,10,1,9
ALB,Albania,SVK,Slovak Republic,2010,4,1,3
ALB,Albania,SVK,Slovak Republic,2011,4,2,2
ALB,Albania,SVK,Slovak Republic,2013,3,1,2
ALB,Albania,SVK,Slovak Republic,2014,1,0,1
ALB,Albania,SVK,Slovak Republic,2016,12,0,12
ALB,Albania,SVK,Slovak Republic,2017,8,1,7
ALB,Albania,ESP,Spain,2008,246,102,144
ALB,Albania,ESP,Spain,2009,189,171,18
ALB,Albania,ESP,Spain,2010,149,161,-12
ALB,Albania,ESP,Spain,2011,256,162,94
ALB,Albania,ESP,Spain,2012,237,162,75
ALB,Albania,ESP,Spain,2013,244,224,20
ALB,Albania,ESP,Spain,2014,234,119,115
ALB,Albania,ESP,Spain,2015,279,110,169
ALB,Albania,ESP,Spain,2016,361,106,255
ALB,Albania,ESP,Spain,2017,506,171,335
ALB,Albania,SWE,Sweden,2008,98,9,89
ALB,Albania,SWE,Sweden,2009,122,5,117
ALB,Albania,SWE,Sweden,2010,164,12,152
ALB,Albania,SWE,Sweden,2011,137,14,123
ALB,Albania,SWE,Sweden,2012,226,18,208
ALB,Albania,SWE,Sweden,2013,192,17,175
ALB,Albania,SWE,Sweden,2014,273,27,246
ALB,Albania,SWE,Sweden,2015,466,38,428
ALB,Albania,SWE,Sweden,2016,658,14,644
ALB,Albania,SWE,Sweden,2017,978,11,967
ALB,Albania,CHE,Switzerland,2010,113,45,68
ALB,Albania,CHE,Switzerland,2011,102,35,67
ALB,Albania,CHE,Switzerland,2012,115,38,77
ALB,Albania,CHE,Switzerland,2013,134,33,101
ALB,Albania,CHE,Switzerland,2014,158,46,112
ALB,Albania,CHE,Switzerland,2015,201,29,172
ALB,Albania,CHE,Switzerland,2016,242,50,192
ALB,Albania,CHE,Switzerland,2017,263,42,221
ALB,Albania,TUR,Turkey,2010,132,0,132
ALB,Albania,TUR,Turkey,2016,749,281,468
ALB,Albania,TUR,Turkey,2017,1119,446,673
ALB,Albania,USA,United States,2008,5754,0,5754
ALB,Albania,USA,United States,2009,5137,0,5137
ALB,Albania,USA,United States,2010,4711,0,4711
ALB,Albania,USA,United States,2011,3612,0,3612
ALB,Albania,USA,United States,2012,3364,0,3364
ALB,Albania,USA,United States,2013,3186,0,3186
ALB,Albania,USA,United States,2014,3828,0,3828
ALB,Albania,USA,United States,2015,4653,0,4653
ALB,Albania,USA,United States,2016,5773,0,5773
ALB,Albania,USA,United States,2017,5722,0,5722
ALB,Albania,CHL,Chile,2008,1,0,1
ALB,Albania,CHL,Chile,2009,2,0,2
ALB,Albania,CHL,Chile,2010,3,0,3
ALB,Albania,CHL,Chile,2011,2,0,2
ALB,Albania,CHL,Chile,2012,0,0,0
ALB,Albania,CHL,Chile,2013,1,0,1
ALB,Albania,CHL,Chile,2014,2,0,2
ALB,Albania,CHL,Chile,2015,6,0,6
ALB,Albania,CHL,Chile,2016,9,0,9
ALB,Albania,EST,Estonia,2008,2,0,2
ALB,Albania,EST,Estonia,2009,3,0,3
ALB,Albania,EST,Estonia,2010,0,0,0
ALB,Albania,EST,Estonia,2011,1,0,1
ALB,Albania,EST,Estonia,2012,3,0,3
ALB,Albania,EST,Estonia,2013,2,0,2
ALB,Albania,EST,Estonia,2014,1,0,1
ALB,Albania,EST,Estonia,2015,6,0,6
ALB,Albania,EST,Estonia,2016,14,0,14
ALB,Albania,EST,Estonia,2017,4,0,4
ALB,Albania,SVN,Slovenia,2008,53,3,50
ALB,Albania,SVN,Slovenia,2009,109,10,99
ALB,Albania,SVN,Slovenia,2010,29,11,18
ALB,Albania,SVN,Slovenia,2011,11,4,7
ALB,Albania,SVN,Slovenia,2012,13,1,12
ALB,Albania,SVN,Slovenia,2013,14,0,14
ALB,Albania,SVN,Slovenia,2014,9,0,9
ALB,Albania,SVN,Slovenia,2015,18,0,18
ALB,Albania,SVN,Slovenia,2016,18,3,15
ALB,Albania,SVN,Slovenia,2017,22,5,17
DZA,Algeria,AUS,Australia,2008,25,22,3
DZA,Algeria,AUS,Australia,2009,21,27,-6
DZA,Algeria,AUS,Australia,2010,27,25,2
DZA,Algeria,AUS,Australia,2011,25,29,-4
DZA,Algeria,AUS,Australia,2012,22,27,-5
DZA,Algeria,AUS,Australia,2013,19,26,-7
DZA,Algeria,AUS,Australia,2014,17,26,-9
DZA,Algeria,AUS,Australia,2015,19,0,19
DZA,Algeria,AUS,Australia,2016,32,0,32
DZA,Algeria,AUS,Australia,2017,28,0,28
DZA,Algeria,AUT,Austria,2008,196,142,54
DZA,Algeria,AUT,Austria,2009,252,180,72
DZA,Algeria,AUT,Austria,2010,239,207,32
DZA,Algeria,AUT,Austria,2011,251,186,65
DZA,Algeria,AUT,Austria,2012,249,238,11
DZA,Algeria,AUT,Austria,2013,365,213,152
DZA,Algeria,AUT,Austria,2014,336,241,95
DZA,Algeria,AUT,Austria,2015,498,276,222
DZA,Algeria,AUT,Austria,2016,661,441,220
DZA,Algeria,AUT,Austria,2017,392,566,-174
DZA,Algeria,BEL,Belgium,2008,915,110,805
DZA,Algeria,BEL,Belgium,2009,1074,129,945
DZA,Algeria,BEL,Belgium,2010,1097,194,903
DZA,Algeria,BEL,Belgium,2011,1095,173,922
DZA,Algeria,BEL,Belgium,2012,919,340,579
DZA,Algeria,BEL,Belgium,2013,730,503,227
DZA,Algeria,BEL,Belgium,2014,680,415,265
DZA,Algeria,BEL,Belgium,2015,716,335,381
DZA,Algeria,BEL,Belgium,2016,649,237,412
DZA,Algeria,BEL,Belgium,2017,639,172,467
DZA,Algeria,CAN,Canada,2008,4005,0,4005
DZA,Algeria,CAN,Canada,2009,5390,0,5390
DZA,Algeria,CAN,Canada,2010,4751,0,4751
DZA,Algeria,CAN,Canada,2011,4325,0,4325
DZA,Algeria,CAN,Canada,2012,3762,0,3762
DZA,Algeria,CAN,Canada,2013,4325,0,4325
DZA,Algeria,CAN,Canada,2014,3653,0,3653
DZA,Algeria,CAN,Canada,2015,2835,0,2835
DZA,Algeria,CAN,Canada,2016,2820,0,2820
DZA,Algeria,CAN,Canada,2017,2635,0,2635
DZA,Algeria,CZE,Czech Republic,2008,31,2,29
DZA,Algeria,CZE,Czech Republic,2009,23,2,21
DZA,Algeria,CZE,Czech Republic,2010,42,1,41
DZA,Algeria,CZE,Czech Republic,2011,18,3,15
DZA,Algeria,CZE,Czech Republic,2012,38,12,26
DZA,Algeria,CZE,Czech Republic,2013,34,30,4
DZA,Algeria,CZE,Czech Republic,2014,46,16,30
DZA,Algeria,CZE,Czech Republic,2015,42,22,20
DZA,Algeria,CZE,Czech Republic,2016,52,16,36
DZA,Algeria,CZE,Czech Republic,2017,42,13,29
DZA,Algeria,DNK,Denmark,2008,17,2,15
DZA,Algeria,DNK,Denmark,2009,11,5,6
DZA,Algeria,DNK,Denmark,2010,20,7,13
DZA,Algeria,DNK,Denmark,2011,16,6,10
DZA,Algeria,DNK,Denmark,2012,11,10,1
DZA,Algeria,DNK,Denmark,2013,19,5,14
DZA,Algeria,DNK,Denmark,2014,17,6,11
DZA,Algeria,DNK,Denmark,2015,13,8,5
DZA,Algeria,DNK,Denmark,2016,29,5,24
DZA,Algeria,DNK,Denmark,2017,29,6,23
DZA,Algeria,FIN,Finland,2008,32,7,25
DZA,Algeria,FIN,Finland,2009,43,3,40
DZA,Algeria,FIN,Finland,2010,36,0,36
DZA,Algeria,FIN,Finland,2011,34,4,30
DZA,Algeria,FIN,Finland,2012,46,3,43
DZA,Algeria,FIN,Finland,2013,42,3,39
DZA,Algeria,FIN,Finland,2014,44,14,30
DZA,Algeria,FIN,Finland,2015,61,5,56
DZA,Algeria,FIN,Finland,2016,47,8,39
DZA,Algeria,FIN,Finland,2017,41,6,35
DZA,Algeria,FRA,France,2008,24364,0,24364
DZA,Algeria,FRA,France,2009,23100,0,23100
DZA,Algeria,FRA,France,2010,21394,0,21394
DZA,Algeria,FRA,France,2011,21234,0,21234
DZA,Algeria,FRA,France,2012,23689,0,23689
DZA,Algeria,FRA,France,2013,23631,0,23631
DZA,Algeria,FRA,France,2014,24108,0,24108
DZA,Algeria,FRA,France,2015,22427,0,22427
DZA,Algeria,FRA,France,2016,21824,0,21824
DZA,Algeria,FRA,France,2017,21823,0,21823
DZA,Algeria,DEU,Germany,2008,1381,1352,29
DZA,Algeria,DEU,Germany,2009,1543,1305,238
DZA,Algeria,DEU,Germany,2010,1539,1180,359
DZA,Algeria,DEU,Germany,2011,1582,1143,439
DZA,Algeria,DEU,Germany,2012,1566,1079,487
DZA,Algeria,DEU,Germany,2013,2348,1202,1146
DZA,Algeria,DEU,Germany,2014,3879,1866,2013
DZA,Algeria,DEU,Germany,2015,9596,3540,6056
DZA,Algeria,DEU,Germany,2016,4845,7731,-2886
DZA,Algeria,DEU,Germany,2017,3706,4295,-589
DZA,Algeria,HUN,Hungary,2008,21,1,20
DZA,Algeria,HUN,Hungary,2009,32,1,31
DZA,Algeria,HUN,Hungary,2010,38,6,32
DZA,Algeria,HUN,Hungary,2011,23,8,15
DZA,Algeria,HUN,Hungary,2012,23,3,20
DZA,Algeria,HUN,Hungary,2013,33,6,27
DZA,Algeria,HUN,Hungary,2014,82,1,81
DZA,Algeria,HUN,Hungary,2015,67,4,63
DZA,Algeria,HUN,Hungary,2016,99,7,92
DZA,Algeria,HUN,Hungary,2017,82,0,82
DZA,Algeria,ISL,Iceland,2008,1,1,0
DZA,Algeria,ISL,Iceland,2009,2,2,0
DZA,Algeria,ISL,Iceland,2010,3,0,3
DZA,Algeria,ISL,Iceland,2011,3,2,1
DZA,Algeria,ISL,Iceland,2012,4,0,4
DZA,Algeria,ISL,Iceland,2013,3,1,2
DZA,Algeria,ISL,Iceland,2014,9,1,8
DZA,Algeria,ISL,Iceland,2015,10,1,9
DZA,Algeria,ISL,Iceland,2016,10,3,7
DZA,Algeria,ISL,Iceland,2017,3,1,2
DZA,Algeria,ITA,Italy,2008,1376,127,1249
DZA,Algeria,ITA,Italy,2009,1132,149,983
DZA,Algeria,ITA,Italy,2010,1199,152,1047
DZA,Algeria,ITA,Italy,2011,1089,165,924
DZA,Algeria,ITA,Italy,2012,944,140,804
DZA,Algeria,ITA,Italy,2013,935,159,776
DZA,Algeria,ITA,Italy,2014,927,136,791
DZA,Algeria,ITA,Italy,2015,866,181,685
DZA,Algeria,ITA,Italy,2016,676,0,676
DZA,Algeria,ITA,Italy,2017,702,108,594
DZA,Algeria,JPN,Japan,2008,171,164,7
DZA,Algeria,JPN,Japan,2009,58,47,11
DZA,Algeria,JPN,Japan,2010,75,51,24
DZA,Algeria,JPN,Japan,2011,45,39,6
DZA,Algeria,JPN,Japan,2012,97,74,23
DZA,Algeria,JPN,Japan,2013,75,57,18
DZA,Algeria,JPN,Japan,2014,82,58,24
DZA,Algeria,JPN,Japan,2015,104,87,17
DZA,Algeria,JPN,Japan,2016,77,34,43
DZA,Algeria,JPN,Japan,2017,78,45,33
DZA,Algeria,KOR,Korea,2008,32,24,8
DZA,Algeria,KOR,Korea,2009,26,22,4
DZA,Algeria,KOR,Korea,2010,44,24,20
DZA,Algeria,KOR,Korea,2011,37,37,0
DZA,Algeria,KOR,Korea,2012,36,57,-21
DZA,Algeria,KOR,Korea,2013,30,22,8
DZA,Algeria,KOR,Korea,2014,93,42,51
DZA,Algeria,KOR,Korea,2015,27,54,-27
DZA,Algeria,KOR,Korea,2016,61,49,12
DZA,Algeria,KOR,Korea,2017,111,53,58
DZA,Algeria,LUX,Luxembourg,2008,35,17,18
DZA,Algeria,LUX,Luxembourg,2009,36,12,24
DZA,Algeria,LUX,Luxembourg,2010,71,9,62
DZA,Algeria,LUX,Luxembourg,2011,55,13,42
DZA,Algeria,LUX,Luxembourg,2012,32,22,10
DZA,Algeria,LUX,Luxembourg,2013,64,28,36
DZA,Algeria,LUX,Luxembourg,2014,64,33,31
DZA,Algeria,LUX,Luxembourg,2015,47,35,12
DZA,Algeria,LUX,Luxembourg,2016,52,20,32
DZA,Algeria,LUX,Luxembourg,2017,54,25,29
DZA,Algeria,MEX,Mexico,2008,8,0,8
DZA,Algeria,MEX,Mexico,2009,8,0,8
DZA,Algeria,MEX,Mexico,2010,11,0,11
DZA,Algeria,MEX,Mexico,2011,15,0,15
DZA,Algeria,MEX,Mexico,2012,12,0,12
DZA,Algeria,MEX,Mexico,2013,27,0,27
DZA,Algeria,MEX,Mexico,2014,22,0,22
DZA,Algeria,MEX,Mexico,2015,8,0,8
DZA,Algeria,MEX,Mexico,2016,12,0,12
DZA,Algeria,MEX,Mexico,2017,12,0,12
DZA,Algeria,NLD,Netherlands,2008,68,28,40
DZA,Algeria,NLD,Netherlands,2009,58,41,17
DZA,Algeria,NLD,Netherlands,2010,52,23,29
DZA,Algeria,NLD,Netherlands,2011,65,36,29
DZA,Algeria,NLD,Netherlands,2012,53,33,20
DZA,Algeria,NLD,Netherlands,2013,53,28,25
DZA,Algeria,NLD,Netherlands,2014,69,36,33
DZA,Algeria,NLD,Netherlands,2015,60,31,29
DZA,Algeria,NLD,Netherlands,2016,70,30,40
DZA,Algeria,NLD,Netherlands,2017,77,36,41
DZA,Algeria,NZL,New Zealand,2008,2,0,2
DZA,Algeria,NZL,New Zealand,2009,7,2,5
DZA,Algeria,NZL,New Zealand,2010,7,3,4
DZA,Algeria,NZL,New Zealand,2011,2,1,1
DZA,Algeria,NZL,New Zealand,2012,1,1,0
DZA,Algeria,NZL,New Zealand,2013,4,0,4
DZA,Algeria,NZL,New Zealand,2014,6,0,6
DZA,Algeria,NZL,New Zealand,2015,4,1,3
DZA,Algeria,NZL,New Zealand,2016,7,0,7
DZA,Algeria,NZL,New Zealand,2017,6,1,5
DZA,Algeria,NOR,Norway,2008,46,17,29
DZA,Algeria,NOR,Norway,2009,45,10,35
DZA,Algeria,NOR,Norway,2010,37,24,13
DZA,Algeria,NOR,Norway,2011,48,22,26
DZA,Algeria,NOR,Norway,2012,59,14,45
DZA,Algeria,NOR,Norway,2013,40,30,10
DZA,Algeria,NOR,Norway,2014,40,21,19
DZA,Algeria,NOR,Norway,2015,34,12,22
DZA,Algeria,NOR,Norway,2016,34,25,9
DZA,Algeria,NOR,Norway,2017,32,14,18
DZA,Algeria,POL,Poland,2008,116,0,116
DZA,Algeria,POL,Poland,2009,131,0,131
DZA,Algeria,POL,Poland,2010,149,0,149
DZA,Algeria,POL,Poland,2011,170,0,170
DZA,Algeria,POL,Poland,2012,178,0,178
DZA,Algeria,POL,Poland,2013,213,0,213
DZA,Algeria,POL,Poland,2014,131,0,131
DZA,Algeria,POL,Poland,2015,214,0,214
DZA,Algeria,POL,Poland,2016,244,0,244
DZA,Algeria,POL,Poland,2017,286,0,286
DZA,Algeria,SVK,Slovak Republic,2008,2,1,1
DZA,Algeria,SVK,Slovak Republic,2009,4,10,-6
DZA,Algeria,SVK,Slovak Republic,2010,4,11,-7
DZA,Algeria,SVK,Slovak Republic,2011,2,0,2
DZA,Algeria,SVK,Slovak Republic,2012,4,0,4
DZA,Algeria,SVK,Slovak Republic,2013,3,0,3
DZA,Algeria,SVK,Slovak Republic,2014,1,0,1
DZA,Algeria,SVK,Slovak Republic,2015,3,0,3
DZA,Algeria,SVK,Slovak Republic,2016,2,0,2
DZA,Algeria,SVK,Slovak Republic,2017,3,0,3
DZA,Algeria,ESP,Spain,2008,5524,3245,2279
DZA,Algeria,ESP,Spain,2009,4314,4253,61
DZA,Algeria,ESP,Spain,2010,3761,4874,-1113
DZA,Algeria,ESP,Spain,2011,4257,5717,-1460
DZA,Algeria,ESP,Spain,2012,4522,5873,-1351
DZA,Algeria,ESP,Spain,2013,4762,6670,-1908
DZA,Algeria,ESP,Spain,2014,4534,4854,-320
DZA,Algeria,ESP,Spain,2015,4154,4035,119
DZA,Algeria,ESP,Spain,2016,4434,4088,346
DZA,Algeria,ESP,Spain,2017,4782,4501,281
DZA,Algeria,SWE,Sweden,2008,127,9,118
DZA,Algeria,SWE,Sweden,2009,145,6,139
DZA,Algeria,SWE,Sweden,2010,122,17,105
DZA,Algeria,SWE,Sweden,2011,100,16,84
DZA,Algeria,SWE,Sweden,2012,136,18,118
DZA,Algeria,SWE,Sweden,2013,98,14,84
DZA,Algeria,SWE,Sweden,2014,122,17,105
DZA,Algeria,SWE,Sweden,2015,103,18,85
DZA,Algeria,SWE,Sweden,2016,127,24,103
DZA,Algeria,SWE,Sweden,2017,128,21,107
DZA,Algeria,CHE,Switzerland,2010,296,80,216
DZA,Algeria,CHE,Switzerland,2011,266,84,182
DZA,Algeria,CHE,Switzerland,2012,266,52,214
DZA,Algeria,CHE,Switzerland,2013,259,64,195
DZA,Algeria,CHE,Switzerland,2014,259,79,180
DZA,Algeria,CHE,Switzerland,2015,241,50,191
DZA,Algeria,CHE,Switzerland,2016,264,61,203
DZA,Algeria,CHE,Switzerland,2017,232,51,181
DZA,Algeria,TUR,Turkey,2010,43,0,43
DZA,Algeria,TUR,Turkey,2016,839,236,603
DZA,Algeria,TUR,Turkey,2017,1478,381,1097
DZA,Algeria,GBR,United Kingdom,2013,1000,0,1000
DZA,Algeria,GBR,United Kingdom,2015,1000,0,1000
DZA,Algeria,USA,United States,2008,1037,0,1037
DZA,Algeria,USA,United States,2009,1485,0,1485
DZA,Algeria,USA,United States,2010,1305,0,1305
DZA,Algeria,USA,United States,2011,1364,0,1364
DZA,Algeria,USA,United States,2012,1369,0,1369
DZA,Algeria,USA,United States,2013,1241,0,1241
DZA,Algeria,USA,United States,2014,1669,0,1669
DZA,Algeria,USA,United States,2015,1775,0,1775
DZA,Algeria,USA,United States,2016,2180,0,2180
DZA,Algeria,USA,United States,2017,2139,0,2139
DZA,Algeria,CHL,Chile,2008,0,0,0
DZA,Algeria,CHL,Chile,2009,1,0,1
DZA,Algeria,CHL,Chile,2010,3,0,3
DZA,Algeria,CHL,Chile,2011,2,0,2
DZA,Algeria,CHL,Chile,2012,2,0,2
DZA,Algeria,CHL,Chile,2013,8,0,8
DZA,Algeria,CHL,Chile,2014,1,0,1
DZA,Algeria,CHL,Chile,2015,5,0,5
DZA,Algeria,CHL,Chile,2016,9,0,9
DZA,Algeria,EST,Estonia,2008,0,0,0
DZA,Algeria,EST,Estonia,2009,0,0,0
DZA,Algeria,EST,Estonia,2010,0,0,0
DZA,Algeria,EST,Estonia,2011,2,0,2
DZA,Algeria,EST,Estonia,2012,1,0,1
DZA,Algeria,EST,Estonia,2013,1,0,1
DZA,Algeria,EST,Estonia,2014,1,0,1
DZA,Algeria,EST,Estonia,2015,3,0,3
DZA,Algeria,EST,Estonia,2016,5,0,5
DZA,Algeria,EST,Estonia,2017,2,0,2
DZA,Algeria,SVN,Slovenia,2008,5,0,5
DZA,Algeria,SVN,Slovenia,2009,6,0,6
DZA,Algeria,SVN,Slovenia,2010,2,0,2
DZA,Algeria,SVN,Slovenia,2013,3,0,3
DZA,Algeria,SVN,Slovenia,2014,2,0,2
DZA,Algeria,SVN,Slovenia,2015,4,0,4
DZA,Algeria,SVN,Slovenia,2016,4,0,4
DZA,Algeria,SVN,Slovenia,2017,2,0,2
AND,Andorra,AUS,Australia,2008,0,0,0
AND,Andorra,AUS,Australia,2009,0,0,0
AND,Andorra,AUS,Australia,2010,0,0,0
AND,Andorra,AUS,Australia,2011,1,0,1
AND,Andorra,AUS,Australia,2012,0,0,0
AND,Andorra,AUS,Australia,2013,0,0,0
AND,Andorra,AUS,Australia,2014,0,0,0
AND,Andorra,AUS,Australia,2015,0,0,0
AND,Andorra,AUS,Australia,2016,0,0,0
AND,Andorra,AUS,Australia,2017,3,0,3
AND,Andorra,AUT,Austria,2008,2,0,2
AND,Andorra,AUT,Austria,2009,0,2,-2
AND,Andorra,AUT,Austria,2010,0,0,0
AND,Andorra,AUT,Austria,2011,0,1,-1
AND,Andorra,AUT,Austria,2012,0,0,0
AND,Andorra,AUT,Austria,2013,1,0,1
AND,Andorra,AUT,Austria,2014,0,0,0
AND,Andorra,AUT,Austria,2015,0,1,-1
AND,Andorra,AUT,Austria,2016,1,0,1
AND,Andorra,AUT,Austria,2017,1,0,1
AND,Andorra,BEL,Belgium,2008,1,0,1
AND,Andorra,BEL,Belgium,2009,3,0,3
AND,Andorra,BEL,Belgium,2010,2,1,1
AND,Andorra,BEL,Belgium,2011,1,0,1
AND,Andorra,BEL,Belgium,2012,5,0,5
AND,Andorra,BEL,Belgium,2013,2,1,1
AND,Andorra,BEL,Belgium,2014,1,4,-3
AND,Andorra,BEL,Belgium,2016,3,0,3
AND,Andorra,BEL,Belgium,2017,1,0,1
AND,Andorra,CAN,Canada,2008,0,0,0
AND,Andorra,CAN,Canada,2009,0,0,0
AND,Andorra,CAN,Canada,2010,0,0,0
AND,Andorra,CAN,Canada,2011,0,0,0
AND,Andorra,CAN,Canada,2012,1,0,1
AND,Andorra,CAN,Canada,2013,1,0,1
AND,Andorra,CAN,Canada,2014,0,0,0
AND,Andorra,CAN,Canada,2015,0,0,0
AND,Andorra,CAN,Canada,2016,0,0,0
AND,Andorra,CAN,Canada,2017,0,0,0
AND,Andorra,DNK,Denmark,2013,0,0,0
AND,Andorra,DNK,Denmark,2014,0,0,0
AND,Andorra,DNK,Denmark,2015,0,0,0
AND,Andorra,DNK,Denmark,2016,1,0,1
AND,Andorra,DNK,Denmark,2017,0,0,0
AND,Andorra,FIN,Finland,2008,0,0,0
AND,Andorra,FIN,Finland,2009,0,0,0
AND,Andorra,FIN,Finland,2010,0,0,0
AND,Andorra,FIN,Finland,2011,0,0,0
AND,Andorra,FIN,Finland,2012,0,0,0
AND,Andorra,FIN,Finland,2013,0,0,0
AND,Andorra,FIN,Finland,2014,0,0,0
AND,Andorra,FIN,Finland,2015,0,0,0
AND,Andorra,FIN,Finland,2016,0,0,0
AND,Andorra,FIN,Finland,2017,0,0,0
AND,Andorra,FRA,France,2008,17,0,17
AND,Andorra,FRA,France,2009,34,0,34
AND,Andorra,FRA,France,2010,28,0,28
AND,Andorra,FRA,France,2011,21,0,21
AND,Andorra,FRA,France,2012,19,0,19
AND,Andorra,FRA,France,2013,13,0,13
AND,Andorra,FRA,France,2014,15,0,15
AND,Andorra,FRA,France,2015,12,0,12
AND,Andorra,FRA,France,2016,7,0,7
AND,Andorra,FRA,France,2017,11,0,11
AND,Andorra,DEU,Germany,2008,2,1,1
AND,Andorra,DEU,Germany,2009,4,3,1
AND,Andorra,DEU,Germany,2010,0,3,-3
AND,Andorra,DEU,Germany,2011,4,1,3
AND,Andorra,DEU,Germany,2012,9,2,7
AND,Andorra,DEU,Germany,2013,16,6,10
AND,Andorra,DEU,Germany,2014,6,7,-1
AND,Andorra,DEU,Germany,2015,10,2,8
AND,Andorra,DEU,Germany,2016,7,5,2
AND,Andorra,DEU,Germany,2017,4,3,1
AND,Andorra,HUN,Hungary,2008,0,0,0
AND,Andorra,HUN,Hungary,2009,0,0,0
AND,Andorra,HUN,Hungary,2010,0,0,0
AND,Andorra,HUN,Hungary,2011,0,0,0
AND,Andorra,HUN,Hungary,2012,0,0,0
AND,Andorra,HUN,Hungary,2013,0,0,0
AND,Andorra,HUN,Hungary,2014,0,0,0
AND,Andorra,HUN,Hungary,2015,0,0,0
AND,Andorra,HUN,Hungary,2016,0,0,0
AND,Andorra,HUN,Hungary,2017,0,0,0
AND,Andorra,ISL,Iceland,2008,0,0,0
AND,Andorra,ISL,Iceland,2009,0,0,0
AND,Andorra,ISL,Iceland,2010,0,0,0
AND,Andorra,ISL,Iceland,2011,0,0,0
AND,Andorra,ISL,Iceland,2012,1,0,1
AND,Andorra,ISL,Iceland,2013,0,0,0
AND,Andorra,ISL,Iceland,2014,0,0,0
AND,Andorra,ISL,Iceland,2015,0,0,0
AND,Andorra,ISL,Iceland,2016,0,0,0
AND,Andorra,ISL,Iceland,2017,1,0,1
AND,Andorra,ITA,Italy,2008,13,2,11
AND,Andorra,ITA,Italy,2009,13,3,10
AND,Andorra,ITA,Italy,2010,7,0,7
AND,Andorra,ITA,Italy,2011,3,0,3
AND,Andorra,ITA,Italy,2012,4,2,2
AND,Andorra,ITA,Italy,2013,1,4,-3
AND,Andorra,ITA,Italy,2015,2,0,2
AND,Andorra,ITA,Italy,2016,2,0,2
AND,Andorra,ITA,Italy,2017,3,0,3
AND,Andorra,JPN,Japan,2008,1,2,-1
AND,Andorra,JPN,Japan,2009,1,1,0
AND,Andorra,JPN,Japan,2010,1,1,0
AND,Andorra,JPN,Japan,2011,1,1,0
AND,Andorra,JPN,Japan,2012,1,1,0
AND,Andorra,JPN,Japan,2013,0,0,0
AND,Andorra,JPN,Japan,2014,5,5,0
AND,Andorra,JPN,Japan,2015,0,0,0
AND,Andorra,JPN,Japan,2016,5,2,3
AND,Andorra,JPN,Japan,2017,5,4,1
AND,Andorra,KOR,Korea,2008,1,0,1
AND,Andorra,KOR,Korea,2009,0,0,0
AND,Andorra,KOR,Korea,2010,0,0,0
AND,Andorra,KOR,Korea,2011,1,0,1
AND,Andorra,KOR,Korea,2012,0,0,0
AND,Andorra,KOR,Korea,2013,0,0,0
AND,Andorra,KOR,Korea,2014,0,0,0
AND,Andorra,KOR,Korea,2015,1,1,0
AND,Andorra,KOR,Korea,2016,0,0,0
AND,Andorra,KOR,Korea,2017,0,0,0
AND,Andorra,LUX,Luxembourg,2008,1,0,1
AND,Andorra,LUX,Luxembourg,2009,0,0,0
AND,Andorra,LUX,Luxembourg,2010,0,0,0
AND,Andorra,LUX,Luxembourg,2011,1,0,1
AND,Andorra,LUX,Luxembourg,2012,1,0,1
AND,Andorra,LUX,Luxembourg,2013,0,2,-2
AND,Andorra,LUX,Luxembourg,2014,3,0,3
AND,Andorra,LUX,Luxembourg,2015,1,0,1
AND,Andorra,LUX,Luxembourg,2016,0,0,0
AND,Andorra,LUX,Luxembourg,2017,2,1,1
AND,Andorra,MEX,Mexico,2008,1,0,1
AND,Andorra,MEX,Mexico,2009,2,0,2
AND,Andorra,MEX,Mexico,2010,1,0,1
AND,Andorra,MEX,Mexico,2011,6,0,6
AND,Andorra,MEX,Mexico,2012,0,0,0
AND,Andorra,MEX,Mexico,2013,1,0,1
AND,Andorra,MEX,Mexico,2014,2,0,2
AND,Andorra,MEX,Mexico,2015,4,0,4
AND,Andorra,MEX,Mexico,2016,1,0,1
AND,Andorra,MEX,Mexico,2017,3,0,3
AND,Andorra,NLD,Netherlands,2011,1,0,1
AND,Andorra,NLD,Netherlands,2015,0,1,-1
AND,Andorra,NLD,Netherlands,2016,2,0,2
AND,Andorra,NLD,Netherlands,2017,5,2,3
AND,Andorra,NOR,Norway,2008,0,0,0
AND,Andorra,NOR,Norway,2009,0,0,0
AND,Andorra,NOR,Norway,2010,1,1,0
AND,Andorra,NOR,Norway,2011,1,0,1
AND,Andorra,NOR,Norway,2012,1,0,1
AND,Andorra,NOR,Norway,2013,0,0,0
AND,Andorra,NOR,Norway,2014,0,0,0
AND,Andorra,NOR,Norway,2015,0,0,0
AND,Andorra,NOR,Norway,2016,0,0,0
AND,Andorra,NOR,Norway,2017,0,0,0
AND,Andorra,POL,Poland,2009,0,0,0
AND,Andorra,POL,Poland,2010,0,0,0
AND,Andorra,POL,Poland,2011,0,0,0
AND,Andorra,POL,Poland,2012,0,0,0
AND,Andorra,POL,Poland,2013,0,0,0
AND,Andorra,POL,Poland,2014,0,0,0
AND,Andorra,POL,Poland,2015,0,0,0
AND,Andorra,POL,Poland,2016,0,0,0
AND,Andorra,POL,Poland,2017,0,0,0
AND,Andorra,SVK,Slovak Republic,2008,0,0,0
AND,Andorra,SVK,Slovak Republic,2010,0,0,0
AND,Andorra,ESP,Spain,2008,175,82,93
AND,Andorra,ESP,Spain,2009,146,101,45
AND,Andorra,ESP,Spain,2010,131,92,39
AND,Andorra,ESP,Spain,2011,153,106,47
AND,Andorra,ESP,Spain,2012,147,63,84
AND,Andorra,ESP,Spain,2013,129,123,6
AND,Andorra,ESP,Spain,2014,124,94,30
AND,Andorra,ESP,Spain,2015,141,65,76
AND,Andorra,ESP,Spain,2016,153,52,101
AND,Andorra,ESP,Spain,2017,138,104,34
AND,Andorra,SWE,Sweden,2008,0,0,0
AND,Andorra,SWE,Sweden,2009,0,0,0
AND,Andorra,SWE,Sweden,2010,1,0,1
AND,Andorra,SWE,Sweden,2011,0,0,0
AND,Andorra,SWE,Sweden,2012,0,0,0
AND,Andorra,SWE,Sweden,2013,0,0,0
AND,Andorra,SWE,Sweden,2014,0,0,0
AND,Andorra,SWE,Sweden,2015,0,0,0
AND,Andorra,SWE,Sweden,2016,0,0,0
AND,Andorra,SWE,Sweden,2017,0,0,0
AND,Andorra,CHE,Switzerland,2010,2,0,2
AND,Andorra,CHE,Switzerland,2011,5,0,5
AND,Andorra,CHE,Switzerland,2012,7,2,5
AND,Andorra,CHE,Switzerland,2013,6,1,5
AND,Andorra,CHE,Switzerland,2014,3,2,1
AND,Andorra,CHE,Switzerland,2015,5,2,3
AND,Andorra,CHE,Switzerland,2016,5,1,4
AND,Andorra,CHE,Switzerland,2017,3,1,2
AND,Andorra,USA,United States,2009,3,0,3
AND,Andorra,USA,United States,2010,3,0,3
AND,Andorra,USA,United States,2011,3,0,3
AND,Andorra,USA,United States,2013,3,0,3
AND,Andorra,USA,United States,2015,5,0,5
AND,Andorra,USA,United States,2016,5,0,5
AND,Andorra,USA,United States,2017,2,0,2
AND,Andorra,CHL,Chile,2008,0,0,0
AND,Andorra,CHL,Chile,2009,0,0,0
AND,Andorra,CHL,Chile,2010,0,0,0
AND,Andorra,CHL,Chile,2011,2,0,2
AND,Andorra,CHL,Chile,2012,0,0,0
AND,Andorra,CHL,Chile,2013,1,0,1
AND,Andorra,CHL,Chile,2014,1,0,1
AND,Andorra,CHL,Chile,2015,1,0,1
AND,Andorra,CHL,Chile,2016,1,0,1
AND,Andorra,EST,Estonia,2008,0,0,0
AND,Andorra,EST,Estonia,2009,0,0,0
AND,Andorra,EST,Estonia,2010,0,0,0
AND,Andorra,EST,Estonia,2011,0,0,0
AND,Andorra,EST,Estonia,2012,0,0,0
AND,Andorra,EST,Estonia,2013,0,0,0
AND,Andorra,EST,Estonia,2014,0,0,0
AND,Andorra,EST,Estonia,2015,0,0,0
AND,Andorra,EST,Estonia,2016,0,0,0
AND,Andorra,EST,Estonia,2017,0,0,0
AGO,Angola,AUS,Australia,2008,6,0,6
AGO,Angola,AUS,Australia,2009,5,0,5
AGO,Angola,AUS,Australia,2010,4,6,-2
AGO,Angola,AUS,Australia,2011,3,0,3
AGO,Angola,AUS,Australia,2012,1,0,1
AGO,Angola,AUS,Australia,2013,2,0,2
AGO,Angola,AUS,Australia,2014,0,0,0
AGO,Angola,AUS,Australia,2015,5,0,5
AGO,Angola,AUS,Australia,2017,5,0,5
AGO,Angola,AUT,Austria,2008,15,11,4
AGO,Angola,AUT,Austria,2009,7,8,-1
AGO,Angola,AUT,Austria,2010,18,14,4
AGO,Angola,AUT,Austria,2011,11,6,5
AGO,Angola,AUT,Austria,2012,8,7,1
AGO,Angola,AUT,Austria,2013,8,8,0
AGO,Angola,AUT,Austria,2014,7,7,0
AGO,Angola,AUT,Austria,2015,1,7,-6
AGO,Angola,AUT,Austria,2016,14,6,8
AGO,Angola,AUT,Austria,2017,16,10,6
AGO,Angola,BEL,Belgium,2008,96,0,96
AGO,Angola,BEL,Belgium,2009,89,0,89
AGO,Angola,BEL,Belgium,2010,136,13,123
AGO,Angola,BEL,Belgium,2011,114,0,114
AGO,Angola,BEL,Belgium,2012,265,108,157
AGO,Angola,BEL,Belgium,2013,192,159,33
AGO,Angola,BEL,Belgium,2014,150,159,-9
AGO,Angola,BEL,Belgium,2015,155,158,-3
AGO,Angola,BEL,Belgium,2016,149,88,61
AGO,Angola,BEL,Belgium,2017,193,64,129
AGO,Angola,CAN,Canada,2008,76,0,76
AGO,Angola,CAN,Canada,2009,62,0,62
AGO,Angola,CAN,Canada,2010,61,0,61
AGO,Angola,CAN,Canada,2011,39,0,39
AGO,Angola,CAN,Canada,2012,70,0,70
AGO,Angola,CAN,Canada,2013,45,0,45
AGO,Angola,CAN,Canada,2014,21,0,21
AGO,Angola,CAN,Canada,2015,30,0,30
AGO,Angola,CAN,Canada,2016,35,0,35
AGO,Angola,CAN,Canada,2017,45,0,45
AGO,Angola,CZE,Czech Republic,2008,12,0,12
AGO,Angola,CZE,Czech Republic,2009,5,2,3
AGO,Angola,CZE,Czech Republic,2010,2,0,2
AGO,Angola,CZE,Czech Republic,2011,9,0,9
AGO,Angola,CZE,Czech Republic,2012,7,13,-6
AGO,Angola,CZE,Czech Republic,2013,4,14,-10
AGO,Angola,CZE,Czech Republic,2014,7,6,1
AGO,Angola,CZE,Czech Republic,2015,5,7,-2
AGO,Angola,CZE,Czech Republic,2016,1,4,-3
AGO,Angola,CZE,Czech Republic,2017,3,8,-5
AGO,Angola,DNK,Denmark,2008,2,0,2
AGO,Angola,DNK,Denmark,2009,0,0,0
AGO,Angola,DNK,Denmark,2010,4,0,4
AGO,Angola,DNK,Denmark,2011,1,1,0
AGO,Angola,DNK,Denmark,2012,1,0,1
AGO,Angola,DNK,Denmark,2013,5,2,3
AGO,Angola,DNK,Denmark,2014,3,2,1
AGO,Angola,DNK,Denmark,2015,6,1,5
AGO,Angola,DNK,Denmark,2016,7,4,3
AGO,Angola,DNK,Denmark,2017,2,11,-9
AGO,Angola,FIN,Finland,2008,39,0,39
AGO,Angola,FIN,Finland,2009,19,1,18
AGO,Angola,FIN,Finland,2010,22,0,22
AGO,Angola,FIN,Finland,2011,35,3,32
AGO,Angola,FIN,Finland,2012,28,3,25
AGO,Angola,FIN,Finland,2013,33,0,33
AGO,Angola,FIN,Finland,2014,7,1,6
AGO,Angola,FIN,Finland,2015,10,4,6
AGO,Angola,FIN,Finland,2016,5,3,2
AGO,Angola,FIN,Finland,2017,9,2,7
AGO,Angola,FRA,France,2008,819,0,819
AGO,Angola,FRA,France,2009,719,0,719
AGO,Angola,FRA,France,2010,621,0,621
AGO,Angola,FRA,France,2011,659,0,659
AGO,Angola,FRA,France,2012,702,0,702
AGO,Angola,FRA,France,2013,801,0,801
AGO,Angola,FRA,France,2014,719,0,719
AGO,Angola,FRA,France,2015,672,0,672
AGO,Angola,FRA,France,2016,730,0,730
AGO,Angola,FRA,France,2017,707,0,707
AGO,Angola,DEU,Germany,2008,348,441,-93
AGO,Angola,DEU,Germany,2009,341,506,-165
AGO,Angola,DEU,Germany,2010,391,385,6
AGO,Angola,DEU,Germany,2011,349,324,25
AGO,Angola,DEU,Germany,2012,408,299,109
AGO,Angola,DEU,Germany,2013,353,342,11
AGO,Angola,DEU,Germany,2014,342,432,-90
AGO,Angola,DEU,Germany,2015,298,287,11
AGO,Angola,DEU,Germany,2016,337,303,34
AGO,Angola,DEU,Germany,2017,451,264,187
AGO,Angola,HUN,Hungary,2008,0,0,0
AGO,Angola,HUN,Hungary,2009,3,0,3
AGO,Angola,HUN,Hungary,2010,13,0,13
AGO,Angola,HUN,Hungary,2011,11,1,10
AGO,Angola,HUN,Hungary,2012,13,0,13
AGO,Angola,HUN,Hungary,2013,9,0,9
AGO,Angola,HUN,Hungary,2014,6,0,6
AGO,Angola,HUN,Hungary,2015,4,0,4
AGO,Angola,HUN,Hungary,2016,22,10,12
AGO,Angola,HUN,Hungary,2017,33,0,33
AGO,Angola,ISL,Iceland,2008,0,0,0
AGO,Angola,ISL,Iceland,2009,2,1,1
AGO,Angola,ISL,Iceland,2010,0,1,-1
AGO,Angola,ISL,Iceland,2011,0,0,0
AGO,Angola,ISL,Iceland,2012,0,0,0
AGO,Angola,ISL,Iceland,2013,0,0,0
AGO,Angola,ISL,Iceland,2014,0,0,0
AGO,Angola,ISL,Iceland,2015,0,0,0
AGO,Angola,ISL,Iceland,2016,1,0,1
AGO,Angola,ISL,Iceland,2017,1,1,0
AGO,Angola,ITA,Italy,2008,85,7,78
AGO,Angola,ITA,Italy,2009,83,9,74
AGO,Angola,ITA,Italy,2010,78,35,43
AGO,Angola,ITA,Italy,2011,69,7,62
AGO,Angola,ITA,Italy,2012,91,11,80
AGO,Angola,ITA,Italy,2013,64,22,42
AGO,Angola,ITA,Italy,2014,80,12,68
AGO,Angola,ITA,Italy,2015,69,8,61
AGO,Angola,ITA,Italy,2016,64,0,64
AGO,Angola,ITA,Italy,2017,79,12,67
AGO,Angola,JPN,Japan,2008,157,148,9
AGO,Angola,JPN,Japan,2009,56,50,6
AGO,Angola,JPN,Japan,2010,62,61,1
AGO,Angola,JPN,Japan,2011,97,90,7
AGO,Angola,JPN,Japan,2012,140,126,14
AGO,Angola,JPN,Japan,2013,133,122,11
AGO,Angola,JPN,Japan,2014,79,73,6
AGO,Angola,JPN,Japan,2015,61,53,8
AGO,Angola,JPN,Japan,2016,99,83,16
AGO,Angola,JPN,Japan,2017,67,60,7
AGO,Angola,KOR,Korea,2008,9,13,-4
AGO,Angola,KOR,Korea,2009,11,2,9
AGO,Angola,KOR,Korea,2010,11,4,7
AGO,Angola,KOR,Korea,2011,30,22,8
AGO,Angola,KOR,Korea,2012,46,38,8
AGO,Angola,KOR,Korea,2013,18,31,-13
AGO,Angola,KOR,Korea,2014,20,13,7
AGO,Angola,KOR,Korea,2015,14,28,-14
AGO,Angola,KOR,Korea,2016,12,6,6
AGO,Angola,KOR,Korea,2017,34,17,17
AGO,Angola,LUX,Luxembourg,2008,8,8,0
AGO,Angola,LUX,Luxembourg,2009,6,1,5
AGO,Angola,LUX,Luxembourg,2010,4,0,4
AGO,Angola,LUX,Luxembourg,2011,5,1,4
AGO,Angola,LUX,Luxembourg,2012,7,3,4
AGO,Angola,LUX,Luxembourg,2013,3,5,-2
AGO,Angola,LUX,Luxembourg,2014,7,4,3
AGO,Angola,LUX,Luxembourg,2015,7,2,5
AGO,Angola,LUX,Luxembourg,2016,4,1,3
AGO,Angola,LUX,Luxembourg,2017,5,2,3
AGO,Angola,MEX,Mexico,2008,1,0,1
AGO,Angola,MEX,Mexico,2009,3,0,3
AGO,Angola,MEX,Mexico,2010,2,0,2
AGO,Angola,MEX,Mexico,2012,1,0,1
AGO,Angola,MEX,Mexico,2013,3,0,3
AGO,Angola,MEX,Mexico,2014,1,0,1
AGO,Angola,MEX,Mexico,2015,1,0,1
AGO,Angola,MEX,Mexico,2016,2,0,2
AGO,Angola,NLD,Netherlands,2008,25,13,12
AGO,Angola,NLD,Netherlands,2009,20,36,-16
AGO,Angola,NLD,Netherlands,2010,37,16,21
AGO,Angola,NLD,Netherlands,2011,20,16,4
AGO,Angola,NLD,Netherlands,2012,18,32,-14
AGO,Angola,NLD,Netherlands,2013,29,27,2
AGO,Angola,NLD,Netherlands,2014,27,31,-4
AGO,Angola,NLD,Netherlands,2015,18,19,-1
AGO,Angola,NLD,Netherlands,2016,26,29,-3
AGO,Angola,NLD,Netherlands,2017,14,-1,15
AGO,Angola,NZL,New Zealand,2010,0,0,0
AGO,Angola,NZL,New Zealand,2017,1,0,1
AGO,Angola,NOR,Norway,2008,42,3,39
AGO,Angola,NOR,Norway,2009,31,14,17
AGO,Angola,NOR,Norway,2010,27,17,10
AGO,Angola,NOR,Norway,2011,38,23,15
AGO,Angola,NOR,Norway,2012,27,10,17
AGO,Angola,NOR,Norway,2013,20,25,-5
AGO,Angola,NOR,Norway,2014,17,12,5
AGO,Angola,NOR,Norway,2015,38,10,28
AGO,Angola,NOR,Norway,2016,19,27,-8
AGO,Angola,NOR,Norway,2017,7,26,-19
AGO,Angola,POL,Poland,2009,75,0,75
AGO,Angola,POL,Poland,2010,73,0,73
AGO,Angola,POL,Poland,2011,92,0,92
AGO,Angola,POL,Poland,2012,94,0,94
AGO,Angola,POL,Poland,2013,118,0,118
AGO,Angola,POL,Poland,2014,59,0,59
AGO,Angola,POL,Poland,2015,90,0,90
AGO,Angola,POL,Poland,2016,86,0,86
AGO,Angola,POL,Poland,2017,47,0,47
AGO,Angola,PRT,Portugal,2008,2021,0,2021
AGO,Angola,PRT,Portugal,2009,1543,0,1543
AGO,Angola,PRT,Portugal,2010,1317,0,1317
AGO,Angola,PRT,Portugal,2011,1369,0,1369
AGO,Angola,PRT,Portugal,2012,1293,0,1293
AGO,Angola,PRT,Portugal,2013,1477,0,1477
AGO,Angola,PRT,Portugal,2014,1469,0,1469
AGO,Angola,PRT,Portugal,2015,1277,0,1277
AGO,Angola,PRT,Portugal,2016,1479,0,1479
AGO,Angola,PRT,Portugal,2017,1831,0,1831
AGO,Angola,SVK,Slovak Republic,2008,4,1,3
AGO,Angola,SVK,Slovak Republic,2009,7,1,6
AGO,Angola,SVK,Slovak Republic,2010,1,0,1
AGO,Angola,ESP,Spain,2008,185,179,6
AGO,Angola,ESP,Spain,2009,151,221,-70
AGO,Angola,ESP,Spain,2010,114,193,-79
AGO,Angola,ESP,Spain,2011,128,212,-84
AGO,Angola,ESP,Spain,2012,181,115,66
AGO,Angola,ESP,Spain,2013,112,194,-82
AGO,Angola,ESP,Spain,2014,137,94,43
AGO,Angola,ESP,Spain,2015,129,90,39
AGO,Angola,ESP,Spain,2016,128,95,33
AGO,Angola,ESP,Spain,2017,121,142,-21
AGO,Angola,SWE,Sweden,2008,17,3,14
AGO,Angola,SWE,Sweden,2009,27,0,27
AGO,Angola,SWE,Sweden,2010,10,0,10
AGO,Angola,SWE,Sweden,2011,15,8,7
AGO,Angola,SWE,Sweden,2012,17,1,16
AGO,Angola,SWE,Sweden,2013,8,6,2
AGO,Angola,SWE,Sweden,2014,11,0,11
AGO,Angola,SWE,Sweden,2015,7,3,4
AGO,Angola,SWE,Sweden,2016,11,4,7
AGO,Angola,SWE,Sweden,2017,7,1,6
AGO,Angola,CHE,Switzerland,2010,314,12,302
AGO,Angola,CHE,Switzerland,2011,263,8,255
AGO,Angola,CHE,Switzerland,2012,207,11,196
AGO,Angola,CHE,Switzerland,2013,183,15,168
AGO,Angola,CHE,Switzerland,2014,143,14,129
AGO,Angola,CHE,Switzerland,2015,107,13,94
AGO,Angola,CHE,Switzerland,2016,95,16,79
AGO,Angola,CHE,Switzerland,2017,109,13,96
AGO,Angola,GBR,United Kingdom,2015,1000,1000,0
AGO,Angola,USA,United States,2008,221,0,221
AGO,Angola,USA,United States,2009,173,0,173
AGO,Angola,USA,United States,2010,148,0,148
AGO,Angola,USA,United States,2011,148,0,148
AGO,Angola,USA,United States,2012,187,0,187
AGO,Angola,USA,United States,2013,143,0,143
AGO,Angola,USA,United States,2014,148,0,148
AGO,Angola,USA,United States,2015,154,0,154
AGO,Angola,USA,United States,2016,198,0,198
AGO,Angola,USA,United States,2017,209,0,209
AGO,Angola,CHL,Chile,2008,2,0,2
AGO,Angola,CHL,Chile,2009,0,0,0
AGO,Angola,CHL,Chile,2010,4,0,4
AGO,Angola,CHL,Chile,2011,2,0,2
AGO,Angola,CHL,Chile,2012,2,0,2
AGO,Angola,CHL,Chile,2013,0,0,0
AGO,Angola,CHL,Chile,2014,1,0,1
AGO,Angola,CHL,Chile,2015,12,0,12
AGO,Angola,CHL,Chile,2016,12,0,12
AGO,Angola,EST,Estonia,2008,0,0,0
AGO,Angola,EST,Estonia,2009,0,0,0
AGO,Angola,EST,Estonia,2010,0,0,0
AGO,Angola,EST,Estonia,2011,0,0,0
AGO,Angola,EST,Estonia,2012,0,0,0
AGO,Angola,EST,Estonia,2013,0,0,0
AGO,Angola,EST,Estonia,2014,0,0,0
AGO,Angola,EST,Estonia,2015,0,0,0
AGO,Angola,EST,Estonia,2016,0,0,0
AGO,Angola,EST,Estonia,2017,0,0,0
AGO,Angola,SVN,Slovenia,2017,1,0,1
ATG,Antigua and Barbuda,AUS,Australia,2008,0,0,0
ATG,Antigua and Barbuda,AUS,Australia,2009,0,0,0
ATG,Antigua and Barbuda,AUS,Australia,2010,0,0,0
ATG,Antigua and Barbuda,AUS,Australia,2011,0,0,0
ATG,Antigua and Barbuda,AUS,Australia,2012,1,0,1
ATG,Antigua and Barbuda,AUS,Australia,2013,2,0,2
ATG,Antigua and Barbuda,AUS,Australia,2014,0,0,0
ATG,Antigua and Barbuda,AUS,Australia,2015,0,0,0
ATG,Antigua and Barbuda,AUS,Australia,2016,0,0,0
ATG,Antigua and Barbuda,AUS,Australia,2017,3,0,3
ATG,Antigua and Barbuda,AUT,Austria,2008,1,1,0
ATG,Antigua and Barbuda,AUT,Austria,2009,0,1,-1
ATG,Antigua and Barbuda,AUT,Austria,2010,0,0,0
ATG,Antigua and Barbuda,AUT,Austria,2011,1,1,0
ATG,Antigua and Barbuda,AUT,Austria,2012,0,0,0
ATG,Antigua and Barbuda,AUT,Austria,2013,0,0,0
ATG,Antigua and Barbuda,AUT,Austria,2014,1,1,0
ATG,Antigua and Barbuda,AUT,Austria,2015,2,0,2
ATG,Antigua and Barbuda,AUT,Austria,2016,0,1,-1
ATG,Antigua and Barbuda,AUT,Austria,2017,1,0,1
ATG,Antigua and Barbuda,BEL,Belgium,2010,0,0,0
ATG,Antigua and Barbuda,CAN,Canada,2008,32,0,32
ATG,Antigua and Barbuda,CAN,Canada,2009,38,0,38
ATG,Antigua and Barbuda,CAN,Canada,2010,27,0,27
ATG,Antigua and Barbuda,CAN,Canada,2011,37,0,37
ATG,Antigua and Barbuda,CAN,Canada,2012,50,0,50
ATG,Antigua and Barbuda,CAN,Canada,2013,25,0,25
ATG,Antigua and Barbuda,CAN,Canada,2014,50,0,50
ATG,Antigua and Barbuda,CAN,Canada,2015,51,0,51
ATG,Antigua and Barbuda,CAN,Canada,2016,45,0,45
ATG,Antigua and Barbuda,CAN,Canada,2017,85,0,85
ATG,Antigua and Barbuda,CZE,Czech Republic,2013,1,0,1
ATG,Antigua and Barbuda,DNK,Denmark,2013,0,0,0
ATG,Antigua and Barbuda,DNK,Denmark,2014,0,1,-1
ATG,Antigua and Barbuda,DNK,Denmark,2015,2,0,2
ATG,Antigua and Barbuda,DNK,Denmark,2016,0,0,0
ATG,Antigua and Barbuda,DNK,Denmark,2017,0,1,-1
ATG,Antigua and Barbuda,FIN,Finland,2008,0,0,0
ATG,Antigua and Barbuda,FIN,Finland,2009,0,0,0
ATG,Antigua and Barbuda,FIN,Finland,2010,0,0,0
ATG,Antigua and Barbuda,FIN,Finland,2011,0,0,0
ATG,Antigua and Barbuda,FIN,Finland,2012,0,0,0
ATG,Antigua and Barbuda,FIN,Finland,2013,0,0,0
ATG,Antigua and Barbuda,FIN,Finland,2014,0,0,0
ATG,Antigua and Barbuda,FIN,Finland,2015,0,0,0
ATG,Antigua and Barbuda,FIN,Finland,2016,0,0,0
ATG,Antigua and Barbuda,FIN,Finland,2017,0,0,0
ATG,Antigua and Barbuda,FRA,France,2008,1,0,1
ATG,Antigua and Barbuda,FRA,France,2009,1,0,1
ATG,Antigua and Barbuda,FRA,France,2010,2,0,2
ATG,Antigua and Barbuda,FRA,France,2011,2,0,2
ATG,Antigua and Barbuda,FRA,France,2012,2,0,2
ATG,Antigua and Barbuda,FRA,France,2013,3,0,3
ATG,Antigua and Barbuda,FRA,France,2014,0,0,0
ATG,Antigua and Barbuda,FRA,France,2015,2,0,2
ATG,Antigua and Barbuda,FRA,France,2016,5,0,5
ATG,Antigua and Barbuda,FRA,France,2017,3,0,3
ATG,Antigua and Barbuda,DEU,Germany,2008,3,3,0
ATG,Antigua and Barbuda,DEU,Germany,2009,2,0,2
ATG,Antigua and Barbuda,DEU,Germany,2010,1,1,0
ATG,Antigua and Barbuda,DEU,Germany,2011,4,1,3
ATG,Antigua and Barbuda,DEU,Germany,2012,1,1,0
ATG,Antigua and Barbuda,DEU,Germany,2013,2,1,1
ATG,Antigua and Barbuda,DEU,Germany,2014,1,0,1
ATG,Antigua and Barbuda,DEU,Germany,2015,3,1,2
ATG,Antigua and Barbuda,DEU,Germany,2016,5,4,1
ATG,Antigua and Barbuda,DEU,Germany,2017,9,2,7
ATG,Antigua and Barbuda,HUN,Hungary,2008,0,0,0
ATG,Antigua and Barbuda,HUN,Hungary,2009,0,0,0
ATG,Antigua and Barbuda,HUN,Hungary,2010,0,0,0
ATG,Antigua and Barbuda,HUN,Hungary,2011,0,0,0
ATG,Antigua and Barbuda,HUN,Hungary,2012,1,0,1
ATG,Antigua and Barbuda,HUN,Hungary,2013,0,0,0
ATG,Antigua and Barbuda,HUN,Hungary,2014,0,0,0
ATG,Antigua and Barbuda,HUN,Hungary,2015,0,0,0
ATG,Antigua and Barbuda,HUN,Hungary,2016,0,0,0
ATG,Antigua and Barbuda,HUN,Hungary,2017,0,0,0
ATG,Antigua and Barbuda,ISL,Iceland,2008,0,0,0
ATG,Antigua and Barbuda,ISL,Iceland,2009,0,0,0
ATG,Antigua and Barbuda,ISL,Iceland,2010,0,0,0
ATG,Antigua and Barbuda,ISL,Iceland,2011,0,0,0
ATG,Antigua and Barbuda,ISL,Iceland,2012,1,0,1
ATG,Antigua and Barbuda,ISL,Iceland,2013,0,0,0
ATG,Antigua and Barbuda,ISL,Iceland,2014,0,0,0
ATG,Antigua and Barbuda,ISL,Iceland,2015,1,0,1
ATG,Antigua and Barbuda,ISL,Iceland,2016,0,2,-2
ATG,Antigua and Barbuda,ISL,Iceland,2017,0,0,0
ATG,Antigua and Barbuda,ITA,Italy,2008,3,0,3
ATG,Antigua and Barbuda,ITA,Italy,2009,5,0,5
ATG,Antigua and Barbuda,ITA,Italy,2010,2,0,2
ATG,Antigua and Barbuda,ITA,Italy,2011,1,0,1
ATG,Antigua and Barbuda,ITA,Italy,2012,4,0,4
ATG,Antigua and Barbuda,ITA,Italy,2013,2,0,2
ATG,Antigua and Barbuda,ITA,Italy,2015,0,0,0
ATG,Antigua and Barbuda,ITA,Italy,2016,2,0,2
ATG,Antigua and Barbuda,JPN,Japan,2008,21,16,5
ATG,Antigua and Barbuda,JPN,Japan,2009,11,11,0
ATG,Antigua and Barbuda,JPN,Japan,2010,13,18,-5
ATG,Antigua and Barbuda,JPN,Japan,2011,7,7,0
ATG,Antigua and Barbuda,JPN,Japan,2012,7,6,1
ATG,Antigua and Barbuda,JPN,Japan,2013,14,12,2
ATG,Antigua and Barbuda,JPN,Japan,2014,19,18,1
ATG,Antigua and Barbuda,JPN,Japan,2015,25,25,0
ATG,Antigua and Barbuda,JPN,Japan,2016,9,7,2
ATG,Antigua and Barbuda,JPN,Japan,2017,13,14,-1
ATG,Antigua and Barbuda,KOR,Korea,2008,1,2,-1
ATG,Antigua and Barbuda,KOR,Korea,2009,2,1,1
ATG,Antigua and Barbuda,KOR,Korea,2010,0,0,0
ATG,Antigua and Barbuda,KOR,Korea,2011,0,1,-1
ATG,Antigua and Barbuda,KOR,Korea,2012,3,3,0
ATG,Antigua and Barbuda,KOR,Korea,2013,0,1,-1
ATG,Antigua and Barbuda,KOR,Korea,2014,1,1,0
ATG,Antigua and Barbuda,KOR,Korea,2015,0,1,-1
ATG,Antigua and Barbuda,KOR,Korea,2016,1,1,0
ATG,Antigua and Barbuda,KOR,Korea,2017,0,0,0
ATG,Antigua and Barbuda,LUX,Luxembourg,2008,0,0,0
ATG,Antigua and Barbuda,LUX,Luxembourg,2009,0,0,0
ATG,Antigua and Barbuda,LUX,Luxembourg,2010,0,0,0
ATG,Antigua and Barbuda,LUX,Luxembourg,2011,0,0,0
ATG,Antigua and Barbuda,LUX,Luxembourg,2012,0,0,0
ATG,Antigua and Barbuda,LUX,Luxembourg,2013,0,0,0
ATG,Antigua and Barbuda,LUX,Luxembourg,2014,0,0,0
ATG,Antigua and Barbuda,LUX,Luxembourg,2015,0,0,0
ATG,Antigua and Barbuda,LUX,Luxembourg,2016,0,0,0
ATG,Antigua and Barbuda,LUX,Luxembourg,2017,1,0,1
ATG,Antigua and Barbuda,MEX,Mexico,2012,0,0,0
ATG,Antigua and Barbuda,MEX,Mexico,2013,0,0,0
ATG,Antigua and Barbuda,MEX,Mexico,2014,0,0,0
ATG,Antigua and Barbuda,MEX,Mexico,2015,1,0,1
ATG,Antigua and Barbuda,NLD,Netherlands,2014,1,0,1
ATG,Antigua and Barbuda,NLD,Netherlands,2015,1,0,1
ATG,Antigua and Barbuda,NLD,Netherlands,2016,1,1,0
ATG,Antigua and Barbuda,NZL,New Zealand,2008,0,0,0
ATG,Antigua and Barbuda,NZL,New Zealand,2013,1,0,1
ATG,Antigua and Barbuda,NOR,Norway,2008,0,0,0
ATG,Antigua and Barbuda,NOR,Norway,2009,0,0,0
ATG,Antigua and Barbuda,NOR,Norway,2010,0,0,0
ATG,Antigua and Barbuda,NOR,Norway,2011,0,0,0
ATG,Antigua and Barbuda,NOR,Norway,2012,0,0,0
ATG,Antigua and Barbuda,NOR,Norway,2013,0,0,0
ATG,Antigua and Barbuda,NOR,Norway,2014,0,0,0
ATG,Antigua and Barbuda,NOR,Norway,2015,0,0,0
ATG,Antigua and Barbuda,NOR,Norway,2016,0,0,0
ATG,Antigua and Barbuda,NOR,Norway,2017,0,0,0
ATG,Antigua and Barbuda,POL,Poland,2009,0,0,0
ATG,Antigua and Barbuda,POL,Poland,2010,0,0,0
ATG,Antigua and Barbuda,POL,Poland,2011,0,0,0
ATG,Antigua and Barbuda,POL,Poland,2012,0,0,0
ATG,Antigua and Barbuda,POL,Poland,2013,0,0,0
ATG,Antigua and Barbuda,POL,Poland,2014,0,0,0
ATG,Antigua and Barbuda,POL,Poland,2015,0,0,0
ATG,Antigua and Barbuda,POL,Poland,2016,0,0,0
ATG,Antigua and Barbuda,POL,Poland,2017,0,0,0
ATG,Antigua and Barbuda,SVK,Slovak Republic,2008,0,0,0
ATG,Antigua and Barbuda,SVK,Slovak Republic,2010,0,0,0
ATG,Antigua and Barbuda,ESP,Spain,2008,1,1,0
ATG,Antigua and Barbuda,ESP,Spain,2009,0,1,-1
ATG,Antigua and Barbuda,ESP,Spain,2010,1,1,0
ATG,Antigua and Barbuda,ESP,Spain,2011,5,0,5
ATG,Antigua and Barbuda,ESP,Spain,2012,5,1,4
ATG,Antigua and Barbuda,ESP,Spain,2013,1,1,0
ATG,Antigua and Barbuda,ESP,Spain,2014,2,1,1
ATG,Antigua and Barbuda,ESP,Spain,2015,3,0,3
ATG,Antigua and Barbuda,ESP,Spain,2016,5,0,5
ATG,Antigua and Barbuda,ESP,Spain,2017,4,0,4
ATG,Antigua and Barbuda,SWE,Sweden,2008,1,0,1
ATG,Antigua and Barbuda,SWE,Sweden,2009,0,0,0
ATG,Antigua and Barbuda,SWE,Sweden,2010,0,0,0
ATG,Antigua and Barbuda,SWE,Sweden,2011,0,0,0
ATG,Antigua and Barbuda,SWE,Sweden,2012,0,1,-1
ATG,Antigua and Barbuda,SWE,Sweden,2013,1,0,1
ATG,Antigua and Barbuda,SWE,Sweden,2014,0,0,0
ATG,Antigua and Barbuda,SWE,Sweden,2015,0,0,0
ATG,Antigua and Barbuda,SWE,Sweden,2016,0,0,0
ATG,Antigua and Barbuda,SWE,Sweden,2017,2,1,1
ATG,Antigua and Barbuda,CHE,Switzerland,2010,5,1,4
ATG,Antigua and Barbuda,CHE,Switzerland,2011,0,4,-4
ATG,Antigua and Barbuda,CHE,Switzerland,2012,2,1,1
ATG,Antigua and Barbuda,CHE,Switzerland,2013,1,3,-2
ATG,Antigua and Barbuda,CHE,Switzerland,2014,1,1,0
ATG,Antigua and Barbuda,CHE,Switzerland,2015,1,0,1
ATG,Antigua and Barbuda,CHE,Switzerland,2016,1,1,0
ATG,Antigua and Barbuda,CHE,Switzerland,2017,1,1,0
ATG,Antigua and Barbuda,USA,United States,2008,444,0,444
ATG,Antigua and Barbuda,USA,United States,2009,437,0,437
ATG,Antigua and Barbuda,USA,United States,2010,359,0,359
ATG,Antigua and Barbuda,USA,United States,2011,368,0,368
ATG,Antigua and Barbuda,USA,United States,2012,337,0,337
ATG,Antigua and Barbuda,USA,United States,2013,344,0,344
ATG,Antigua and Barbuda,USA,United States,2014,369,0,369
ATG,Antigua and Barbuda,USA,United States,2015,290,0,290
ATG,Antigua and Barbuda,USA,United States,2016,324,0,324
ATG,Antigua and Barbuda,USA,United States,2017,322,0,322
ATG,Antigua and Barbuda,CHL,Chile,2008,2,0,2
ATG,Antigua and Barbuda,CHL,Chile,2009,0,0,0
ATG,Antigua and Barbuda,CHL,Chile,2010,0,0,0
ATG,Antigua and Barbuda,CHL,Chile,2011,0,0,0
ATG,Antigua and Barbuda,CHL,Chile,2012,0,0,0
ATG,Antigua and Barbuda,CHL,Chile,2013,0,0,0
ATG,Antigua and Barbuda,CHL,Chile,2014,0,0,0
ATG,Antigua and Barbuda,CHL,Chile,2015,0,0,0
ATG,Antigua and Barbuda,CHL,Chile,2016,0,0,0
ATG,Antigua and Barbuda,EST,Estonia,2008,0,0,0
ATG,Antigua and Barbuda,EST,Estonia,2009,0,0,0
ATG,Antigua and Barbuda,EST,Estonia,2010,0,0,0
ATG,Antigua and Barbuda,EST,Estonia,2011,0,0,0
ATG,Antigua and Barbuda,EST,Estonia,2012,0,0,0
ATG,Antigua and Barbuda,EST,Estonia,2013,0,0,0
ATG,Antigua and Barbuda,EST,Estonia,2014,0,0,0
ATG,Antigua and Barbuda,EST,Estonia,2015,4,0,4
ATG,Antigua and Barbuda,EST,Estonia,2016,0,0,0
ATG,Antigua and Barbuda,EST,Estonia,2017,0,0,0
ARG,Argentina,AUS,Australia,2008,175,112,63
ARG,Argentina,AUS,Australia,2009,161,124,37
ARG,Argentina,AUS,Australia,2010,204,100,104
ARG,Argentina,AUS,Australia,2011,128,106,22
ARG,Argentina,AUS,Australia,2012,173,113,60
ARG,Argentina,AUS,Australia,2013,186,93,93
ARG,Argentina,AUS,Australia,2014,231,85,146
ARG,Argentina,AUS,Australia,2015,190,100,90
ARG,Argentina,AUS,Australia,2016,249,100,149
ARG,Argentina,AUS,Australia,2017,239,0,239
ARG,Argentina,AUT,Austria,2008,78,54,24
ARG,Argentina,AUT,Austria,2009,73,67,6
ARG,Argentina,AUT,Austria,2010,99,58,41
ARG,Argentina,AUT,Austria,2011,101,55,46
ARG,Argentina,AUT,Austria,2012,92,78,14
ARG,Argentina,AUT,Austria,2013,82,59,23
ARG,Argentina,AUT,Austria,2014,94,52,42
ARG,Argentina,AUT,Austria,2015,93,53,40
ARG,Argentina,AUT,Austria,2016,93,69,24
ARG,Argentina,AUT,Austria,2017,95,87,8
ARG,Argentina,BEL,Belgium,2008,114,0,114
ARG,Argentina,BEL,Belgium,2009,109,0,109
ARG,Argentina,BEL,Belgium,2010,113,82,31
ARG,Argentina,BEL,Belgium,2011,127,0,127
ARG,Argentina,BEL,Belgium,2012,107,77,30
ARG,Argentina,BEL,Belgium,2013,113,78,35
ARG,Argentina,BEL,Belgium,2014,78,48,30
ARG,Argentina,BEL,Belgium,2015,99,41,58
ARG,Argentina,BEL,Belgium,2016,96,39,57
ARG,Argentina,BEL,Belgium,2017,119,42,77
ARG,Argentina,CAN,Canada,2008,540,0,540
ARG,Argentina,CAN,Canada,2009,467,0,467
ARG,Argentina,CAN,Canada,2010,459,0,459
ARG,Argentina,CAN,Canada,2011,278,0,278
ARG,Argentina,CAN,Canada,2012,263,0,263
ARG,Argentina,CAN,Canada,2013,282,0,282
ARG,Argentina,CAN,Canada,2014,214,0,214
ARG,Argentina,CAN,Canada,2015,237,0,237
ARG,Argentina,CAN,Canada,2016,260,0,260
ARG,Argentina,CAN,Canada,2017,235,0,235
ARG,Argentina,CZE,Czech Republic,2008,12,0,12
ARG,Argentina,CZE,Czech Republic,2009,14,0,14
ARG,Argentina,CZE,Czech Republic,2010,28,0,28
ARG,Argentina,CZE,Czech Republic,2011,21,0,21
ARG,Argentina,CZE,Czech Republic,2012,22,7,15
ARG,Argentina,CZE,Czech Republic,2013,21,10,11
ARG,Argentina,CZE,Czech Republic,2014,23,12,11
ARG,Argentina,CZE,Czech Republic,2015,25,21,4
ARG,Argentina,CZE,Czech Republic,2016,23,20,3
ARG,Argentina,CZE,Czech Republic,2017,43,14,29
ARG,Argentina,DNK,Denmark,2008,28,26,2
ARG,Argentina,DNK,Denmark,2009,26,27,-1
ARG,Argentina,DNK,Denmark,2010,22,33,-11
ARG,Argentina,DNK,Denmark,2011,39,27,12
ARG,Argentina,DNK,Denmark,2012,34,27,7
ARG,Argentina,DNK,Denmark,2013,58,43,15
ARG,Argentina,DNK,Denmark,2014,94,61,33
ARG,Argentina,DNK,Denmark,2015,138,135,3
ARG,Argentina,DNK,Denmark,2016,201,291,-90
ARG,Argentina,DNK,Denmark,2017,175,425,-250
ARG,Argentina,FIN,Finland,2008,17,5,12
ARG,Argentina,FIN,Finland,2009,16,10,6
ARG,Argentina,FIN,Finland,2010,14,3,11
ARG,Argentina,FIN,Finland,2011,18,4,14
ARG,Argentina,FIN,Finland,2012,20,8,12
ARG,Argentina,FIN,Finland,2013,20,14,6
ARG,Argentina,FIN,Finland,2014,18,11,7
ARG,Argentina,FIN,Finland,2015,26,2,24
ARG,Argentina,FIN,Finland,2016,15,6,9
ARG,Argentina,FIN,Finland,2017,18,8,10
ARG,Argentina,FRA,France,2008,328,0,328
ARG,Argentina,FRA,France,2009,423,0,423
ARG,Argentina,FRA,France,2010,343,0,343
ARG,Argentina,FRA,France,2011,310,0,310
ARG,Argentina,FRA,France,2012,373,0,373
ARG,Argentina,FRA,France,2013,352,0,352
ARG,Argentina,FRA,France,2014,384,0,384
ARG,Argentina,FRA,France,2015,487,0,487
ARG,Argentina,FRA,France,2016,498,0,498
ARG,Argentina,FRA,France,2017,533,0,533
ARG,Argentina,DEU,Germany,2008,911,884,27
ARG,Argentina,DEU,Germany,2009,896,835,61
ARG,Argentina,DEU,Germany,2010,921,752,169
ARG,Argentina,DEU,Germany,2011,988,707,281
ARG,Argentina,DEU,Germany,2012,1022,758,264
ARG,Argentina,DEU,Germany,2013,1083,740,343
ARG,Argentina,DEU,Germany,2014,1081,780,301
ARG,Argentina,DEU,Germany,2015,1073,792,281
ARG,Argentina,DEU,Germany,2016,1160,750,410
ARG,Argentina,DEU,Germany,2017,1688,836,852
ARG,Argentina,HUN,Hungary,2008,16,0,16
ARG,Argentina,HUN,Hungary,2009,20,2,18
ARG,Argentina,HUN,Hungary,2010,15,2,13
ARG,Argentina,HUN,Hungary,2011,25,7,18
ARG,Argentina,HUN,Hungary,2012,32,8,24
ARG,Argentina,HUN,Hungary,2013,41,5,36
ARG,Argentina,HUN,Hungary,2014,36,8,28
ARG,Argentina,HUN,Hungary,2015,21,10,11
ARG,Argentina,HUN,Hungary,2016,35,3,32
ARG,Argentina,HUN,Hungary,2017,34,0,34
ARG,Argentina,ISL,Iceland,2008,2,3,-1
ARG,Argentina,ISL,Iceland,2009,2,2,0
ARG,Argentina,ISL,Iceland,2010,5,2,3
ARG,Argentina,ISL,Iceland,2011,2,0,2
ARG,Argentina,ISL,Iceland,2012,4,3,1
ARG,Argentina,ISL,Iceland,2013,1,1,0
ARG,Argentina,ISL,Iceland,2014,3,2,1
ARG,Argentina,ISL,Iceland,2015,6,2,4
ARG,Argentina,ISL,Iceland,2016,8,2,6
ARG,Argentina,ISL,Iceland,2017,5,3,2
ARG,Argentina,ITA,Italy,2008,1937,261,1676
ARG,Argentina,ITA,Italy,2009,1434,330,1104
ARG,Argentina,ITA,Italy,2010,1195,179,1016
ARG,Argentina,ITA,Italy,2011,942,184,758
ARG,Argentina,ITA,Italy,2012,742,171,571
ARG,Argentina,ITA,Italy,2013,731,157,574
ARG,Argentina,ITA,Italy,2014,706,129,577
ARG,Argentina,ITA,Italy,2015,854,137,717
ARG,Argentina,ITA,Italy,2016,987,0,987
ARG,Argentina,ITA,Italy,2017,1424,114,1310
ARG,Argentina,JPN,Japan,2008,505,463,42
ARG,Argentina,JPN,Japan,2009,377,508,-131
ARG,Argentina,JPN,Japan,2010,370,362,8
ARG,Argentina,JPN,Japan,2011,319,354,-35
ARG,Argentina,JPN,Japan,2012,317,280,37
ARG,Argentina,JPN,Japan,2013,334,283,51
ARG,Argentina,JPN,Japan,2014,409,332,77
ARG,Argentina,JPN,Japan,2015,421,374,47
ARG,Argentina,JPN,Japan,2016,407,331,76
ARG,Argentina,JPN,Japan,2017,444,367,77
ARG,Argentina,KOR,Korea,2008,86,68,18
ARG,Argentina,KOR,Korea,2009,76,55,21
ARG,Argentina,KOR,Korea,2010,106,82,24
ARG,Argentina,KOR,Korea,2011,112,80,32
ARG,Argentina,KOR,Korea,2012,90,51,39
ARG,Argentina,KOR,Korea,2013,65,52,13
ARG,Argentina,KOR,Korea,2014,76,62,14
ARG,Argentina,KOR,Korea,2015,50,51,-1
ARG,Argentina,KOR,Korea,2016,66,44,22
ARG,Argentina,KOR,Korea,2017,70,54,16
ARG,Argentina,LUX,Luxembourg,2008,8,1,7
ARG,Argentina,LUX,Luxembourg,2009,8,2,6
ARG,Argentina,LUX,Luxembourg,2010,7,3,4
ARG,Argentina,LUX,Luxembourg,2011,23,3,20
ARG,Argentina,LUX,Luxembourg,2012,15,6,9
ARG,Argentina,LUX,Luxembourg,2013,16,8,8
ARG,Argentina,LUX,Luxembourg,2014,13,7,6
ARG,Argentina,LUX,Luxembourg,2015,13,3,10
ARG,Argentina,LUX,Luxembourg,2016,14,11,3
ARG,Argentina,LUX,Luxembourg,2017,15,16,-1
ARG,Argentina,MEX,Mexico,2008,921,0,921
ARG,Argentina,MEX,Mexico,2009,1378,0,1378
ARG,Argentina,MEX,Mexico,2010,1443,0,1443
ARG,Argentina,MEX,Mexico,2011,990,0,990
ARG,Argentina,MEX,Mexico,2012,859,0,859
ARG,Argentina,MEX,Mexico,2013,3232,0,3232
ARG,Argentina,MEX,Mexico,2014,2142,0,2142
ARG,Argentina,MEX,Mexico,2015,1428,0,1428
ARG,Argentina,MEX,Mexico,2016,1408,0,1408
ARG,Argentina,MEX,Mexico,2017,1003,0,1003
ARG,Argentina,NLD,Netherlands,2008,162,103,59
ARG,Argentina,NLD,Netherlands,2009,129,67,62
ARG,Argentina,NLD,Netherlands,2010,130,100,30
ARG,Argentina,NLD,Netherlands,2011,135,108,27
ARG,Argentina,NLD,Netherlands,2012,142,100,42
ARG,Argentina,NLD,Netherlands,2013,192,119,73
ARG,Argentina,NLD,Netherlands,2014,186,108,78
ARG,Argentina,NLD,Netherlands,2015,172,123,49
ARG,Argentina,NLD,Netherlands,2016,202,111,91
ARG,Argentina,NLD,Netherlands,2017,238,133,105
ARG,Argentina,NZL,New Zealand,2008,508,80,428
ARG,Argentina,NZL,New Zealand,2009,519,129,390
ARG,Argentina,NZL,New Zealand,2010,423,165,258
ARG,Argentina,NZL,New Zealand,2011,493,149,344
ARG,Argentina,NZL,New Zealand,2012,538,169,369
ARG,Argentina,NZL,New Zealand,2013,624,199,425
ARG,Argentina,NZL,New Zealand,2014,660,231,429
ARG,Argentina,NZL,New Zealand,2015,730,263,467
ARG,Argentina,NZL,New Zealand,2016,686,291,395
ARG,Argentina,NZL,New Zealand,2017,645,440,205
ARG,Argentina,NOR,Norway,2008,38,11,27
ARG,Argentina,NOR,Norway,2009,36,15,21
ARG,Argentina,NOR,Norway,2010,38,28,10
ARG,Argentina,NOR,Norway,2011,52,23,29
ARG,Argentina,NOR,Norway,2012,46,22,24
ARG,Argentina,NOR,Norway,2013,47,17,30
ARG,Argentina,NOR,Norway,2014,37,18,19
ARG,Argentina,NOR,Norway,2015,48,27,21
ARG,Argentina,NOR,Norway,2016,33,39,-6
ARG,Argentina,NOR,Norway,2017,56,13,43
ARG,Argentina,POL,Poland,2009,28,0,28
ARG,Argentina,POL,Poland,2010,31,0,31
ARG,Argentina,POL,Poland,2011,34,0,34
ARG,Argentina,POL,Poland,2012,50,0,50
ARG,Argentina,POL,Poland,2013,49,0,49
ARG,Argentina,POL,Poland,2014,26,0,26
ARG,Argentina,POL,Poland,2015,67,0,67
ARG,Argentina,POL,Poland,2016,74,0,74
ARG,Argentina,POL,Poland,2017,66,0,66
ARG,Argentina,SVK,Slovak Republic,2008,2,0,2
ARG,Argentina,SVK,Slovak Republic,2009,3,2,1
ARG,Argentina,SVK,Slovak Republic,2010,2,1,1
ARG,Argentina,SVK,Slovak Republic,2011,2,1,1
ARG,Argentina,SVK,Slovak Republic,2016,1,0,1
ARG,Argentina,SVK,Slovak Republic,2017,2,0,2
ARG,Argentina,ESP,Spain,2008,13363,9363,4000
ARG,Argentina,ESP,Spain,2009,6676,11034,-4358
ARG,Argentina,ESP,Spain,2010,5416,9886,-4470
ARG,Argentina,ESP,Spain,2011,4922,9043,-4121
ARG,Argentina,ESP,Spain,2012,3602,8094,-4492
ARG,Argentina,ESP,Spain,2013,3758,9417,-5659
ARG,Argentina,ESP,Spain,2014,4173,4743,-570
ARG,Argentina,ESP,Spain,2015,4986,3724,1262
ARG,Argentina,ESP,Spain,2016,6352,2786,3566
ARG,Argentina,ESP,Spain,2017,8782,4123,4659
ARG,Argentina,SWE,Sweden,2008,84,22,62
ARG,Argentina,SWE,Sweden,2009,75,22,53
ARG,Argentina,SWE,Sweden,2010,67,20,47
ARG,Argentina,SWE,Sweden,2011,74,28,46
ARG,Argentina,SWE,Sweden,2012,63,29,34
ARG,Argentina,SWE,Sweden,2013,72,21,51
ARG,Argentina,SWE,Sweden,2014,62,21,41
ARG,Argentina,SWE,Sweden,2015,46,30,16
ARG,Argentina,SWE,Sweden,2016,62,24,38
ARG,Argentina,SWE,Sweden,2017,62,10,52
ARG,Argentina,CHE,Switzerland,2010,239,130,109
ARG,Argentina,CHE,Switzerland,2011,262,107,155
ARG,Argentina,CHE,Switzerland,2012,222,147,75
ARG,Argentina,CHE,Switzerland,2013,215,143,72
ARG,Argentina,CHE,Switzerland,2014,205,132,73
ARG,Argentina,CHE,Switzerland,2015,234,116,118
ARG,Argentina,CHE,Switzerland,2016,172,126,46
ARG,Argentina,CHE,Switzerland,2017,186,114,72
ARG,Argentina,TUR,Turkey,2010,11,0,11
ARG,Argentina,GBR,United Kingdom,2012,1000,0,1000
ARG,Argentina,USA,United States,2008,5353,0,5353
ARG,Argentina,USA,United States,2009,5780,0,5780
ARG,Argentina,USA,United States,2010,4399,0,4399
ARG,Argentina,USA,United States,2011,4473,0,4473
ARG,Argentina,USA,United States,2012,4359,0,4359
ARG,Argentina,USA,United States,2013,4372,0,4372
ARG,Argentina,USA,United States,2014,3874,0,3874
ARG,Argentina,USA,United States,2015,3730,0,3730
ARG,Argentina,USA,United States,2016,4091,0,4091
ARG,Argentina,USA,United States,2017,3482,0,3482
ARG,Argentina,CHL,Chile,2008,2710,0,2710
ARG,Argentina,CHL,Chile,2009,2822,0,2822
ARG,Argentina,CHL,Chile,2010,2789,0,2789
ARG,Argentina,CHL,Chile,2011,2814,0,2814
ARG,Argentina,CHL,Chile,2012,3267,0,3267
ARG,Argentina,CHL,Chile,2013,4315,0,4315
ARG,Argentina,CHL,Chile,2014,4506,0,4506
ARG,Argentina,CHL,Chile,2015,4913,0,4913
ARG,Argentina,CHL,Chile,2016,4074,0,4074
ARG,Argentina,EST,Estonia,2008,0,0,0
ARG,Argentina,EST,Estonia,2009,2,0,2
ARG,Argentina,EST,Estonia,2010,0,0,0
ARG,Argentina,EST,Estonia,2011,0,0,0
ARG,Argentina,EST,Estonia,2012,1,0,1
ARG,Argentina,EST,Estonia,2013,1,0,1
ARG,Argentina,EST,Estonia,2014,4,0,4
ARG,Argentina,EST,Estonia,2015,4,0,4
ARG,Argentina,EST,Estonia,2016,4,0,4
ARG,Argentina,EST,Estonia,2017,5,0,5
ARG,Argentina,ISR,Israel,2008,188,0,188
ARG,Argentina,ISR,Israel,2009,284,0,284
ARG,Argentina,ISR,Israel,2010,337,0,337
ARG,Argentina,ISR,Israel,2011,220,0,220
ARG,Argentina,ISR,Israel,2012,222,0,222
ARG,Argentina,ISR,Israel,2013,255,0,255
ARG,Argentina,ISR,Israel,2014,271,0,271
ARG,Argentina,ISR,Israel,2015,262,0,262
ARG,Argentina,ISR,Israel,2016,255,0,255
ARG,Argentina,ISR,Israel,2017,246,0,246
ARG,Argentina,SVN,Slovenia,2008,5,0,5
ARG,Argentina,SVN,Slovenia,2009,10,0,10
ARG,Argentina,SVN,Slovenia,2010,7,0,7
ARG,Argentina,SVN,Slovenia,2011,4,0,4
ARG,Argentina,SVN,Slovenia,2013,4,2,2
ARG,Argentina,SVN,Slovenia,2014,1,0,1
ARG,Argentina,SVN,Slovenia,2015,2,1,1
ARG,Argentina,SVN,Slovenia,2016,1,1,0
ARG,Argentina,SVN,Slovenia,2017,10,0,10
ARM,Armenia,AUS,Australia,2008,30,5,25
ARM,Armenia,AUS,Australia,2009,52,13,39
ARM,Armenia,AUS,Australia,2010,24,5,19
ARM,Armenia,AUS,Australia,2011,26,11,15
ARM,Armenia,AUS,Australia,2012,35,0,35
ARM,Armenia,AUS,Australia,2013,27,10,17
ARM,Armenia,AUS,Australia,2014,37,8,29
ARM,Armenia,AUS,Australia,2015,30,0,30
ARM,Armenia,AUS,Australia,2016,18,0,18
ARM,Armenia,AUS,Australia,2017,33,0,33
ARM,Armenia,AUT,Austria,2008,275,179,96
ARM,Armenia,AUT,Austria,2009,241,181,60
ARM,Armenia,AUT,Austria,2010,194,263,-69
ARM,Armenia,AUT,Austria,2011,172,212,-40
ARM,Armenia,AUT,Austria,2012,318,148,170
ARM,Armenia,AUT,Austria,2013,284,130,154
ARM,Armenia,AUT,Austria,2014,344,72,272
ARM,Armenia,AUT,Austria,2015,309,120,189
ARM,Armenia,AUT,Austria,2016,303,126,177
ARM,Armenia,AUT,Austria,2017,246,285,-39
ARM,Armenia,BEL,Belgium,2008,177,0,177
ARM,Armenia,BEL,Belgium,2009,228,0,228
ARM,Armenia,BEL,Belgium,2010,283,26,257
ARM,Armenia,BEL,Belgium,2011,269,0,269
ARM,Armenia,BEL,Belgium,2012,453,558,-105
ARM,Armenia,BEL,Belgium,2013,391,628,-237
ARM,Armenia,BEL,Belgium,2014,309,764,-455
ARM,Armenia,BEL,Belgium,2015,342,497,-155
ARM,Armenia,BEL,Belgium,2016,332,211,121
ARM,Armenia,BEL,Belgium,2017,365,172,193
ARM,Armenia,CAN,Canada,2008,205,0,205
ARM,Armenia,CAN,Canada,2009,267,0,267
ARM,Armenia,CAN,Canada,2010,252,0,252
ARM,Armenia,CAN,Canada,2011,236,0,236
ARM,Armenia,CAN,Canada,2012,258,0,258
ARM,Armenia,CAN,Canada,2013,208,0,208
ARM,Armenia,CAN,Canada,2014,205,0,205
ARM,Armenia,CAN,Canada,2015,302,0,302
ARM,Armenia,CAN,Canada,2016,350,0,350
ARM,Armenia,CAN,Canada,2017,255,0,255
ARM,Armenia,CZE,Czech Republic,2008,380,4,376
ARM,Armenia,CZE,Czech Republic,2009,220,0,220
ARM,Armenia,CZE,Czech Republic,2010,183,2,181
ARM,Armenia,CZE,Czech Republic,2011,76,1,75
ARM,Armenia,CZE,Czech Republic,2012,96,98,-2
ARM,Armenia,CZE,Czech Republic,2013,69,127,-58
ARM,Armenia,CZE,Czech Republic,2014,116,121,-5
ARM,Armenia,CZE,Czech Republic,2015,101,88,13
ARM,Armenia,CZE,Czech Republic,2016,108,84,24
ARM,Armenia,CZE,Czech Republic,2017,141,67,74
ARM,Armenia,DNK,Denmark,2008,21,0,21
ARM,Armenia,DNK,Denmark,2009,18,1,17
ARM,Armenia,DNK,Denmark,2010,18,6,12
ARM,Armenia,DNK,Denmark,2011,31,5,26
ARM,Armenia,DNK,Denmark,2012,19,2,17
ARM,Armenia,DNK,Denmark,2013,40,4,36
ARM,Armenia,DNK,Denmark,2014,31,6,25
ARM,Armenia,DNK,Denmark,2015,23,2,21
ARM,Armenia,DNK,Denmark,2016,23,11,12
ARM,Armenia,DNK,Denmark,2017,22,7,15
ARM,Armenia,FIN,Finland,2008,7,1,6
ARM,Armenia,FIN,Finland,2009,19,0,19
ARM,Armenia,FIN,Finland,2010,6,3,3
ARM,Armenia,FIN,Finland,2011,9,0,9
ARM,Armenia,FIN,Finland,2012,4,2,2
ARM,Armenia,FIN,Finland,2013,10,1,9
ARM,Armenia,FIN,Finland,2014,6,3,3
ARM,Armenia,FIN,Finland,2015,10,0,10
ARM,Armenia,FIN,Finland,2016,13,0,13
ARM,Armenia,FIN,Finland,2017,6,1,5
ARM,Armenia,FRA,France,2008,1129,0,1129
ARM,Armenia,FRA,France,2009,1357,0,1357
ARM,Armenia,FRA,France,2010,1280,0,1280
ARM,Armenia,FRA,France,2011,1354,0,1354
ARM,Armenia,FRA,France,2012,1469,0,1469
ARM,Armenia,FRA,France,2013,1735,0,1735
ARM,Armenia,FRA,France,2014,1666,0,1666
ARM,Armenia,FRA,France,2015,1581,0,1581
ARM,Armenia,FRA,France,2016,1706,0,1706
ARM,Armenia,FRA,France,2017,1742,0,1742
ARM,Armenia,DEU,Germany,2008,610,858,-248
ARM,Armenia,DEU,Germany,2009,802,649,153
ARM,Armenia,DEU,Germany,2010,920,611,309
ARM,Armenia,DEU,Germany,2011,1060,554,506
ARM,Armenia,DEU,Germany,2012,1496,523,973
ARM,Armenia,DEU,Germany,2013,2066,557,1509
ARM,Armenia,DEU,Germany,2014,3174,767,2407
ARM,Armenia,DEU,Germany,2015,4259,978,3281
ARM,Armenia,DEU,Germany,2016,4940,1248,3692
ARM,Armenia,DEU,Germany,2017,3947,2081,1866
ARM,Armenia,HUN,Hungary,2008,9,1,8
ARM,Armenia,HUN,Hungary,2009,22,2,20
ARM,Armenia,HUN,Hungary,2010,17,3,14
ARM,Armenia,HUN,Hungary,2011,21,5,16
ARM,Armenia,HUN,Hungary,2012,15,4,11
ARM,Armenia,HUN,Hungary,2013,12,0,12
ARM,Armenia,HUN,Hungary,2014,21,5,16
ARM,Armenia,HUN,Hungary,2015,19,3,16
ARM,Armenia,HUN,Hungary,2016,34,6,28
ARM,Armenia,HUN,Hungary,2017,49,0,49
ARM,Armenia,ISL,Iceland,2008,1,0,1
ARM,Armenia,ISL,Iceland,2009,0,2,-2
ARM,Armenia,ISL,Iceland,2010,0,0,0
ARM,Armenia,ISL,Iceland,2011,0,0,0
ARM,Armenia,ISL,Iceland,2012,0,0,0
ARM,Armenia,ISL,Iceland,2013,1,0,1
ARM,Armenia,ISL,Iceland,2014,2,0,2
ARM,Armenia,ISL,Iceland,2015,0,0,0
ARM,Armenia,ISL,Iceland,2016,0,0,0
ARM,Armenia,ISL,Iceland,2017,1,1,0
ARM,Armenia,ITA,Italy,2008,135,1,134
ARM,Armenia,ITA,Italy,2009,109,1,108
ARM,Armenia,ITA,Italy,2010,131,8,123
ARM,Armenia,ITA,Italy,2011,139,7,132
ARM,Armenia,ITA,Italy,2012,119,11,108
ARM,Armenia,ITA,Italy,2013,137,5,132
ARM,Armenia,ITA,Italy,2014,126,13,113
ARM,Armenia,ITA,Italy,2015,127,7,120
ARM,Armenia,ITA,Italy,2016,120,0,120
ARM,Armenia,ITA,Italy,2017,163,13,150
ARM,Armenia,JPN,Japan,2008,140,137,3
ARM,Armenia,JPN,Japan,2009,71,72,-1
ARM,Armenia,JPN,Japan,2010,65,56,9
ARM,Armenia,JPN,Japan,2011,71,68,3
ARM,Armenia,JPN,Japan,2012,146,139,7
ARM,Armenia,JPN,Japan,2013,69,60,9
ARM,Armenia,JPN,Japan,2014,38,37,1
ARM,Armenia,JPN,Japan,2015,75,64,11
ARM,Armenia,JPN,Japan,2016,71,69,2
ARM,Armenia,JPN,Japan,2017,81,76,5
ARM,Armenia,KOR,Korea,2008,12,14,-2
ARM,Armenia,KOR,Korea,2009,16,13,3
ARM,Armenia,KOR,Korea,2010,18,17,1
ARM,Armenia,KOR,Korea,2011,32,19,13
ARM,Armenia,KOR,Korea,2012,28,34,-6
ARM,Armenia,KOR,Korea,2013,22,23,-1
ARM,Armenia,KOR,Korea,2014,25,26,-1
ARM,Armenia,KOR,Korea,2015,19,24,-5
ARM,Armenia,KOR,Korea,2016,20,20,0
ARM,Armenia,KOR,Korea,2017,18,30,-12
ARM,Armenia,LUX,Luxembourg,2008,6,1,5
ARM,Armenia,LUX,Luxembourg,2009,2,1,1
ARM,Armenia,LUX,Luxembourg,2010,5,0,5
ARM,Armenia,LUX,Luxembourg,2011,6,3,3
ARM,Armenia,LUX,Luxembourg,2012,9,0,9
ARM,Armenia,LUX,Luxembourg,2013,9,1,8
ARM,Armenia,LUX,Luxembourg,2014,10,0,10
ARM,Armenia,LUX,Luxembourg,2015,12,2,10
ARM,Armenia,LUX,Luxembourg,2016,14,5,9
ARM,Armenia,LUX,Luxembourg,2017,21,5,16
ARM,Armenia,MEX,Mexico,2008,13,0,13
ARM,Armenia,MEX,Mexico,2009,18,0,18
ARM,Armenia,MEX,Mexico,2010,11,0,11
ARM,Armenia,MEX,Mexico,2011,5,0,5
ARM,Armenia,MEX,Mexico,2012,9,0,9
ARM,Armenia,MEX,Mexico,2013,39,0,39
ARM,Armenia,MEX,Mexico,2014,16,0,16
ARM,Armenia,MEX,Mexico,2015,9,0,9
ARM,Armenia,MEX,Mexico,2016,12,0,12
ARM,Armenia,MEX,Mexico,2017,8,0,8
ARM,Armenia,NLD,Netherlands,2008,69,12,57
ARM,Armenia,NLD,Netherlands,2009,72,16,56
ARM,Armenia,NLD,Netherlands,2010,105,18,87
ARM,Armenia,NLD,Netherlands,2011,111,34,77
ARM,Armenia,NLD,Netherlands,2012,122,30,92
ARM,Armenia,NLD,Netherlands,2013,117,34,83
ARM,Armenia,NLD,Netherlands,2014,171,28,143
ARM,Armenia,NLD,Netherlands,2015,134,47,87
ARM,Armenia,NLD,Netherlands,2016,137,48,89
ARM,Armenia,NLD,Netherlands,2017,114,52,62
ARM,Armenia,NZL,New Zealand,2008,6,0,6
ARM,Armenia,NZL,New Zealand,2010,1,0,1
ARM,Armenia,NZL,New Zealand,2012,4,0,4
ARM,Armenia,NZL,New Zealand,2013,2,0,2
ARM,Armenia,NZL,New Zealand,2014,6,0,6
ARM,Armenia,NZL,New Zealand,2015,8,1,7
ARM,Armenia,NZL,New Zealand,2016,6,0,6
ARM,Armenia,NZL,New Zealand,2017,5,0,5
ARM,Armenia,NOR,Norway,2008,16,4,12
ARM,Armenia,NOR,Norway,2009,0,0,0
ARM,Armenia,NOR,Norway,2010,0,0,0
ARM,Armenia,NOR,Norway,2011,0,0,0
ARM,Armenia,NOR,Norway,2012,0,0,0
ARM,Armenia,NOR,Norway,2013,0,0,0
ARM,Armenia,NOR,Norway,2014,0,0,0
ARM,Armenia,NOR,Norway,2015,0,0,0
ARM,Armenia,NOR,Norway,2016,0,0,0
ARM,Armenia,NOR,Norway,2017,11,5,6
ARM,Armenia,POL,Poland,2008,1604,0,1604
ARM,Armenia,POL,Poland,2009,1559,0,1559
ARM,Armenia,POL,Poland,2010,1397,0,1397
ARM,Armenia,POL,Poland,2011,1181,0,1181
ARM,Armenia,POL,Poland,2012,1624,0,1624
ARM,Armenia,POL,Poland,2013,1090,0,1090
ARM,Armenia,POL,Poland,2014,889,0,889
ARM,Armenia,POL,Poland,2015,1206,0,1206
ARM,Armenia,POL,Poland,2016,970,0,970
ARM,Armenia,POL,Poland,2017,761,0,761
ARM,Armenia,SVK,Slovak Republic,2008,1,9,-8
ARM,Armenia,SVK,Slovak Republic,2009,6,14,-8
ARM,Armenia,SVK,Slovak Republic,2010,2,6,-4
ARM,Armenia,SVK,Slovak Republic,2011,1,2,-1
ARM,Armenia,SVK,Slovak Republic,2012,1,0,1
ARM,Armenia,SVK,Slovak Republic,2013,1,0,1
ARM,Armenia,SVK,Slovak Republic,2014,1,0,1
ARM,Armenia,SVK,Slovak Republic,2015,2,0,2
ARM,Armenia,SVK,Slovak Republic,2016,1,0,1
ARM,Armenia,ESP,Spain,2008,1073,804,269
ARM,Armenia,ESP,Spain,2009,624,878,-254
ARM,Armenia,ESP,Spain,2010,547,749,-202
ARM,Armenia,ESP,Spain,2011,710,769,-59
ARM,Armenia,ESP,Spain,2012,578,613,-35
ARM,Armenia,ESP,Spain,2013,565,758,-193
ARM,Armenia,ESP,Spain,2014,669,351,318
ARM,Armenia,ESP,Spain,2015,661,359,302
ARM,Armenia,ESP,Spain,2016,829,286,543
ARM,Armenia,ESP,Spain,2017,898,370,528
ARM,Armenia,SWE,Sweden,2008,97,8,89
ARM,Armenia,SWE,Sweden,2009,177,6,171
ARM,Armenia,SWE,Sweden,2010,174,7,167
ARM,Armenia,SWE,Sweden,2011,217,10,207
ARM,Armenia,SWE,Sweden,2012,246,20,226
ARM,Armenia,SWE,Sweden,2013,190,17,173
ARM,Armenia,SWE,Sweden,2014,206,25,181
ARM,Armenia,SWE,Sweden,2015,249,21,228
ARM,Armenia,SWE,Sweden,2016,175,13,162
ARM,Armenia,SWE,Sweden,2017,216,20,196
ARM,Armenia,CHE,Switzerland,2010,56,15,41
ARM,Armenia,CHE,Switzerland,2011,81,13,68
ARM,Armenia,CHE,Switzerland,2012,74,27,47
ARM,Armenia,CHE,Switzerland,2013,58,20,38
ARM,Armenia,CHE,Switzerland,2014,57,17,40
ARM,Armenia,CHE,Switzerland,2015,51,15,36
ARM,Armenia,CHE,Switzerland,2016,67,27,40
ARM,Armenia,CHE,Switzerland,2017,51,14,37
ARM,Armenia,TUR,Turkey,2010,50,0,50
ARM,Armenia,TUR,Turkey,2016,466,243,223
ARM,Armenia,TUR,Turkey,2017,684,255,429
ARM,Armenia,GBR,United Kingdom,2012,1000,0,1000
ARM,Armenia,USA,United States,2008,3586,0,3586
ARM,Armenia,USA,United States,2009,3442,0,3442
ARM,Armenia,USA,United States,2010,2979,0,2979
ARM,Armenia,USA,United States,2011,2983,0,2983
ARM,Armenia,USA,United States,2012,2681,0,2681
ARM,Armenia,USA,United States,2013,2722,0,2722
ARM,Armenia,USA,United States,2014,2913,0,2913
ARM,Armenia,USA,United States,2015,2962,0,2962
ARM,Armenia,USA,United States,2016,3543,0,3543
ARM,Armenia,USA,United States,2017,3437,0,3437
ARM,Armenia,CHL,Chile,2008,1,0,1
ARM,Armenia,CHL,Chile,2009,2,0,2
ARM,Armenia,CHL,Chile,2010,0,0,0
ARM,Armenia,CHL,Chile,2011,2,0,2
ARM,Armenia,CHL,Chile,2012,1,0,1
ARM,Armenia,CHL,Chile,2013,0,0,0
ARM,Armenia,CHL,Chile,2014,2,0,2
ARM,Armenia,CHL,Chile,2015,1,0,1
ARM,Armenia,CHL,Chile,2016,2,0,2
ARM,Armenia,EST,Estonia,2008,13,0,13
ARM,Armenia,EST,Estonia,2009,9,0,9
ARM,Armenia,EST,Estonia,2010,6,0,6
ARM,Armenia,EST,Estonia,2011,8,0,8
ARM,Armenia,EST,Estonia,2012,5,0,5
ARM,Armenia,EST,Estonia,2013,12,0,12
ARM,Armenia,EST,Estonia,2014,3,0,3
ARM,Armenia,EST,Estonia,2015,18,0,18
ARM,Armenia,EST,Estonia,2016,18,0,18
ARM,Armenia,EST,Estonia,2017,15,0,15
ARM,Armenia,SVN,Slovenia,2008,2,0,2
ARM,Armenia,SVN,Slovenia,2009,2,0,2
ARM,Armenia,SVN,Slovenia,2010,1,0,1
ARM,Armenia,SVN,Slovenia,2011,4,4,0
ARM,Armenia,SVN,Slovenia,2012,4,0,4
ARM,Armenia,SVN,Slovenia,2013,2,1,1
ARM,Armenia,SVN,Slovenia,2014,3,0,3
ARM,Armenia,SVN,Slovenia,2015,3,0,3
ARM,Armenia,SVN,Slovenia,2016,4,0,4
ARM,Armenia,SVN,Slovenia,2017,1,0,1
AUS,Australia,AUT,Austria,2008,274,129,145
AUS,Australia,AUT,Austria,2009,245,186,59
AUS,Australia,AUT,Austria,2010,231,174,57
AUS,Australia,AUT,Austria,2011,289,111,178
AUS,Australia,AUT,Austria,2012,239,159,80
AUS,Australia,AUT,Austria,2013,286,143,143
AUS,Australia,AUT,Austria,2014,248,119,129
AUS,Australia,AUT,Austria,2015,288,113,175
AUS,Australia,AUT,Austria,2016,270,105,165
AUS,Australia,AUT,Austria,2017,227,112,115
AUS,Australia,BEL,Belgium,2008,218,167,51
AUS,Australia,BEL,Belgium,2009,196,163,33
AUS,Australia,BEL,Belgium,2010,233,179,54
AUS,Australia,BEL,Belgium,2011,241,179,62
AUS,Australia,BEL,Belgium,2012,195,182,13
AUS,Australia,BEL,Belgium,2013,184,211,-27
AUS,Australia,BEL,Belgium,2014,147,219,-72
AUS,Australia,BEL,Belgium,2015,127,222,-95
AUS,Australia,BEL,Belgium,2016,145,200,-55
AUS,Australia,BEL,Belgium,2017,117,216,-99
AUS,Australia,CAN,Canada,2008,1018,1727,-709
AUS,Australia,CAN,Canada,2009,1018,1895,-877
AUS,Australia,CAN,Canada,2010,933,1938,-1005
AUS,Australia,CAN,Canada,2011,849,1740,-891
AUS,Australia,CAN,Canada,2012,982,2011,-1029
AUS,Australia,CAN,Canada,2013,1120,1999,-879
AUS,Australia,CAN,Canada,2014,1295,2073,-778
AUS,Australia,CAN,Canada,2015,1414,2039,-625
AUS,Australia,CAN,Canada,2016,1695,1962,-267
AUS,Australia,CAN,Canada,2017,1865,1946,-81
AUS,Australia,CZE,Czech Republic,2008,112,202,-90
AUS,Australia,CZE,Czech Republic,2009,67,188,-121
AUS,Australia,CZE,Czech Republic,2010,67,162,-95
AUS,Australia,CZE,Czech Republic,2011,36,175,-139
AUS,Australia,CZE,Czech Republic,2012,52,194,-142
AUS,Australia,CZE,Czech Republic,2013,56,218,-162
AUS,Australia,CZE,Czech Republic,2014,75,226,-151
AUS,Australia,CZE,Czech Republic,2015,62,225,-163
AUS,Australia,CZE,Czech Republic,2016,67,218,-151
AUS,Australia,CZE,Czech Republic,2017,75,218,-143
AUS,Australia,DNK,Denmark,2008,201,213,-12
AUS,Australia,DNK,Denmark,2009,197,161,36
AUS,Australia,DNK,Denmark,2010,244,139,105
AUS,Australia,DNK,Denmark,2011,277,141,136
AUS,Australia,DNK,Denmark,2012,249,142,107
AUS,Australia,DNK,Denmark,2013,240,167,73
AUS,Australia,DNK,Denmark,2014,310,135,175
AUS,Australia,DNK,Denmark,2015,348,148,200
AUS,Australia,DNK,Denmark,2016,376,124,252
AUS,Australia,DNK,Denmark,2017,337,142,195
AUS,Australia,FIN,Finland,2008,78,133,-55
AUS,Australia,FIN,Finland,2009,61,122,-61
AUS,Australia,FIN,Finland,2010,51,136,-85
AUS,Australia,FIN,Finland,2011,41,129,-88
AUS,Australia,FIN,Finland,2012,55,166,-111
AUS,Australia,FIN,Finland,2013,61,156,-95
AUS,Australia,FIN,Finland,2014,75,153,-78
AUS,Australia,FIN,Finland,2015,58,145,-87
AUS,Australia,FIN,Finland,2016,76,133,-57
AUS,Australia,FIN,Finland,2017,71,157,-86
AUS,Australia,FRA,France,2008,409,848,-439
AUS,Australia,FRA,France,2009,458,1041,-583
AUS,Australia,FRA,France,2010,394,1167,-773
AUS,Australia,FRA,France,2011,497,1241,-744
AUS,Australia,FRA,France,2012,496,1393,-897
AUS,Australia,FRA,France,2013,429,1512,-1083
AUS,Australia,FRA,France,2014,464,1661,-1197
AUS,Australia,FRA,France,2015,553,1616,-1063
AUS,Australia,FRA,France,2016,567,1620,-1053
AUS,Australia,FRA,France,2017,621,1654,-1033
AUS,Australia,DEU,Germany,2008,2157,1758,399
AUS,Australia,DEU,Germany,2009,2079,2063,16
AUS,Australia,DEU,Germany,2010,2225,2041,184
AUS,Australia,DEU,Germany,2011,2461,1745,716
AUS,Australia,DEU,Germany,2012,2382,1942,440
AUS,Australia,DEU,Germany,2013,2610,1912,698
AUS,Australia,DEU,Germany,2014,2612,1645,967
AUS,Australia,DEU,Germany,2015,2888,1535,1353
AUS,Australia,DEU,Germany,2016,2812,1504,1308
AUS,Australia,DEU,Germany,2017,2656,1418,1238
AUS,Australia,HUN,Hungary,2008,62,221,-159
AUS,Australia,HUN,Hungary,2009,42,249,-207
AUS,Australia,HUN,Hungary,2010,41,287,-246
AUS,Australia,HUN,Hungary,2011,44,256,-212
AUS,Australia,HUN,Hungary,2012,58,336,-278
AUS,Australia,HUN,Hungary,2013,43,373,-330
AUS,Australia,HUN,Hungary,2014,73,352,-279
AUS,Australia,HUN,Hungary,2015,51,362,-311
AUS,Australia,HUN,Hungary,2016,51,292,-241
AUS,Australia,HUN,Hungary,2017,56,302,-246
AUS,Australia,ISL,Iceland,2008,5,9,-4
AUS,Australia,ISL,Iceland,2009,10,17,-7
AUS,Australia,ISL,Iceland,2010,7,10,-3
AUS,Australia,ISL,Iceland,2011,19,7,12
AUS,Australia,ISL,Iceland,2012,16,14,2
AUS,Australia,ISL,Iceland,2013,14,15,-1
AUS,Australia,ISL,Iceland,2014,15,9,6
AUS,Australia,ISL,Iceland,2015,25,5,20
AUS,Australia,ISL,Iceland,2016,17,11,6
AUS,Australia,ISL,Iceland,2017,27,12,15
AUS,Australia,ITA,Italy,2008,215,591,-376
AUS,Australia,ITA,Italy,2009,248,707,-459
AUS,Australia,ITA,Italy,2010,252,701,-449
AUS,Australia,ITA,Italy,2011,226,788,-562
AUS,Australia,ITA,Italy,2012,202,936,-734
AUS,Australia,ITA,Italy,2013,235,1059,-824
AUS,Australia,ITA,Italy,2014,208,1097,-889
AUS,Australia,ITA,Italy,2015,213,1374,-1161
AUS,Australia,ITA,Italy,2016,185,1639,-1454
AUS,Australia,ITA,Italy,2017,191,1917,-1726
AUS,Australia,JPN,Japan,2008,3526,1935,1591
AUS,Australia,JPN,Japan,2009,3054,1954,1100
AUS,Australia,JPN,Japan,2010,1123,1636,-513
AUS,Australia,JPN,Japan,2011,2813,1470,1343
AUS,Australia,JPN,Japan,2012,2937,1628,1309
AUS,Australia,JPN,Japan,2013,2979,1776,1203
AUS,Australia,JPN,Japan,2014,3324,1317,2007
AUS,Australia,JPN,Japan,2015,3619,1118,2501
AUS,Australia,JPN,Japan,2016,3775,1141,2634
AUS,Australia,JPN,Japan,2017,4005,1176,2829
AUS,Australia,KOR,Korea,2008,1402,5036,-3634
AUS,Australia,KOR,Korea,2009,1365,5156,-3791
AUS,Australia,KOR,Korea,2010,1555,4307,-2752
AUS,Australia,KOR,Korea,2011,1766,4299,-2533
AUS,Australia,KOR,Korea,2012,1776,5042,-3266
AUS,Australia,KOR,Korea,2013,1756,5432,-3676
AUS,Australia,KOR,Korea,2014,1988,3763,-1775
AUS,Australia,KOR,Korea,2015,1668,3551,-1883
AUS,Australia,KOR,Korea,2016,1720,3310,-1590
AUS,Australia,KOR,Korea,2017,1519,3204,-1685
AUS,Australia,LUX,Luxembourg,2008,21,6,15
AUS,Australia,LUX,Luxembourg,2009,32,0,32
AUS,Australia,LUX,Luxembourg,2010,5,6,-1
AUS,Australia,LUX,Luxembourg,2011,17,2,15
AUS,Australia,LUX,Luxembourg,2012,13,2,11
AUS,Australia,LUX,Luxembourg,2013,23,8,15
AUS,Australia,LUX,Luxembourg,2014,28,0,28
AUS,Australia,LUX,Luxembourg,2015,24,6,18
AUS,Australia,LUX,Luxembourg,2016,23,0,23
AUS,Australia,LUX,Luxembourg,2017,29,3,26
AUS,Australia,MEX,Mexico,2008,23,282,-259
AUS,Australia,MEX,Mexico,2009,35,288,-253
AUS,Australia,MEX,Mexico,2010,28,278,-250
AUS,Australia,MEX,Mexico,2011,33,248,-215
AUS,Australia,MEX,Mexico,2012,29,336,-307
AUS,Australia,MEX,Mexico,2013,86,290,-204
AUS,Australia,MEX,Mexico,2014,66,268,-202
AUS,Australia,MEX,Mexico,2015,56,274,-218
AUS,Australia,MEX,Mexico,2016,79,280,-201
AUS,Australia,MEX,Mexico,2017,61,271,-210
AUS,Australia,NLD,Netherlands,2008,805,963,-158
AUS,Australia,NLD,Netherlands,2009,755,978,-223
AUS,Australia,NLD,Netherlands,2010,806,832,-26
AUS,Australia,NLD,Netherlands,2011,784,730,54
AUS,Australia,NLD,Netherlands,2012,758,805,-47
AUS,Australia,NLD,Netherlands,2013,768,855,-87
AUS,Australia,NLD,Netherlands,2014,871,731,140
AUS,Australia,NLD,Netherlands,2015,1015,684,331
AUS,Australia,NLD,Netherlands,2016,1113,575,538
AUS,Australia,NLD,Netherlands,2017,1174,607,567
AUS,Australia,NZL,New Zealand,2008,4282,34494,-30212
AUS,Australia,NZL,New Zealand,2009,3886,33034,-29148
AUS,Australia,NZL,New Zealand,2010,4143,24447,-20304
AUS,Australia,NZL,New Zealand,2011,3697,34567,-30870
AUS,Australia,NZL,New Zealand,2012,3580,44311,-40731
AUS,Australia,NZL,New Zealand,2013,4417,41230,-36813
AUS,Australia,NZL,New Zealand,2014,4894,27274,-22380
AUS,Australia,NZL,New Zealand,2015,5546,22432,-16886
AUS,Australia,NZL,New Zealand,2016,6033,19661,-13628
AUS,Australia,NZL,New Zealand,2017,6449,12552,-6103
AUS,Australia,NOR,Norway,2008,237,126,111
AUS,Australia,NOR,Norway,2009,256,168,88
AUS,Australia,NOR,Norway,2010,230,134,96
AUS,Australia,NOR,Norway,2011,253,120,133
AUS,Australia,NOR,Norway,2012,217,146,71
AUS,Australia,NOR,Norway,2013,209,137,72
AUS,Australia,NOR,Norway,2014,181,145,36
AUS,Australia,NOR,Norway,2015,188,133,55
AUS,Australia,NOR,Norway,2016,172,133,39
AUS,Australia,NOR,Norway,2017,178,119,59
AUS,Australia,POL,Poland,2008,109,525,-416
AUS,Australia,POL,Poland,2009,104,524,-420
AUS,Australia,POL,Poland,2010,83,523,-440
AUS,Australia,POL,Poland,2011,104,497,-393
AUS,Australia,POL,Poland,2012,92,590,-498
AUS,Australia,POL,Poland,2013,79,578,-499
AUS,Australia,POL,Poland,2014,52,599,-547
AUS,Australia,POL,Poland,2015,120,612,-492
AUS,Australia,POL,Poland,2016,86,613,-527
AUS,Australia,POL,Poland,2017,64,588,-524
AUS,Australia,SVK,Slovak Republic,2008,2,150,-148
AUS,Australia,SVK,Slovak Republic,2009,7,142,-135
AUS,Australia,SVK,Slovak Republic,2010,3,138,-135
AUS,Australia,SVK,Slovak Republic,2011,4,147,-143
AUS,Australia,SVK,Slovak Republic,2012,3,133,-130
AUS,Australia,SVK,Slovak Republic,2013,4,164,-160
AUS,Australia,SVK,Slovak Republic,2014,3,157,-154
AUS,Australia,SVK,Slovak Republic,2015,5,186,-181
AUS,Australia,SVK,Slovak Republic,2016,3,172,-169
AUS,Australia,SVK,Slovak Republic,2017,6,157,-151
AUS,Australia,ESP,Spain,2008,307,145,162
AUS,Australia,ESP,Spain,2009,274,211,63
AUS,Australia,ESP,Spain,2010,243,194,49
AUS,Australia,ESP,Spain,2011,353,243,110
AUS,Australia,ESP,Spain,2012,344,297,47
AUS,Australia,ESP,Spain,2013,351,383,-32
AUS,Australia,ESP,Spain,2014,367,440,-73
AUS,Australia,ESP,Spain,2015,411,552,-141
AUS,Australia,ESP,Spain,2016,429,477,-48
AUS,Australia,ESP,Spain,2017,554,502,52
AUS,Australia,SWE,Sweden,2008,310,425,-115
AUS,Australia,SWE,Sweden,2009,286,456,-170
AUS,Australia,SWE,Sweden,2010,319,429,-110
AUS,Australia,SWE,Sweden,2011,304,352,-48
AUS,Australia,SWE,Sweden,2012,294,425,-131
AUS,Australia,SWE,Sweden,2013,289,475,-186
AUS,Australia,SWE,Sweden,2014,320,492,-172
AUS,Australia,SWE,Sweden,2015,334,448,-114
AUS,Australia,SWE,Sweden,2016,357,409,-52
AUS,Australia,SWE,Sweden,2017,353,408,-55
AUS,Australia,CHE,Switzerland,2010,513,287,226
AUS,Australia,CHE,Switzerland,2011,465,229,236
AUS,Australia,CHE,Switzerland,2012,440,271,169
AUS,Australia,CHE,Switzerland,2013,455,204,251
AUS,Australia,CHE,Switzerland,2014,419,194,225
AUS,Australia,CHE,Switzerland,2015,458,212,246
AUS,Australia,CHE,Switzerland,2016,464,185,279
AUS,Australia,CHE,Switzerland,2017,427,183,244
AUS,Australia,TUR,Turkey,2010,100,449,-349
AUS,Australia,TUR,Turkey,2016,220,575,-355
AUS,Australia,TUR,Turkey,2017,180,624,-444
AUS,Australia,GBR,United Kingdom,2008,14000,31718,-17718
AUS,Australia,GBR,United Kingdom,2009,12000,33287,-21287
AUS,Australia,GBR,United Kingdom,2010,18000,26701,-8701
AUS,Australia,GBR,United Kingdom,2011,13000,21476,-8476
AUS,Australia,GBR,United Kingdom,2012,16000,27010,-11010
AUS,Australia,GBR,United Kingdom,2013,11000,23149,-12149
AUS,Australia,GBR,United Kingdom,2014,15000,23798,-8798
AUS,Australia,GBR,United Kingdom,2015,16000,22187,-6187
AUS,Australia,GBR,United Kingdom,2016,13000,18963,-5963
AUS,Australia,GBR,United Kingdom,2017,18000,17646,354
AUS,Australia,USA,United States,2008,2464,2964,-500
AUS,Australia,USA,United States,2009,2622,3071,-449
AUS,Australia,USA,United States,2010,2512,3176,-664
AUS,Australia,USA,United States,2011,2343,2986,-643
AUS,Australia,USA,United States,2012,2414,3258,-844
AUS,Australia,USA,United States,2013,2759,3844,-1085
AUS,Australia,USA,United States,2014,2809,3818,-1009
AUS,Australia,USA,United States,2015,3034,3515,-481
AUS,Australia,USA,United States,2016,3239,3489,-250
AUS,Australia,USA,United States,2017,2906,3601,-695
AUS,Australia,CHL,Chile,2008,128,181,-53
AUS,Australia,CHL,Chile,2009,111,236,-125
AUS,Australia,CHL,Chile,2010,124,240,-116
AUS,Australia,CHL,Chile,2011,181,236,-55
AUS,Australia,CHL,Chile,2012,183,234,-51
AUS,Australia,CHL,Chile,2013,170,218,-48
AUS,Australia,CHL,Chile,2014,147,270,-123
AUS,Australia,CHL,Chile,2015,117,232,-115
AUS,Australia,CHL,Chile,2016,67,236,-169
AUS,Australia,EST,Estonia,2008,4,30,-26
AUS,Australia,EST,Estonia,2009,8,38,-30
AUS,Australia,EST,Estonia,2010,2,54,-52
AUS,Australia,EST,Estonia,2011,7,69,-62
AUS,Australia,EST,Estonia,2012,7,61,-54
AUS,Australia,EST,Estonia,2013,6,104,-98
AUS,Australia,EST,Estonia,2014,8,121,-113
AUS,Australia,EST,Estonia,2015,6,135,-129
AUS,Australia,EST,Estonia,2016,17,172,-155
AUS,Australia,EST,Estonia,2017,18,142,-124
AUS,Australia,ISR,Israel,2008,109,502,-393
AUS,Australia,ISR,Israel,2009,107,554,-447
AUS,Australia,ISR,Israel,2010,133,526,-393
AUS,Australia,ISR,Israel,2011,92,422,-330
AUS,Australia,ISR,Israel,2012,96,352,-256
AUS,Australia,ISR,Israel,2013,145,518,-373
AUS,Australia,ISR,Israel,2014,124,420,-296
AUS,Australia,ISR,Israel,2015,103,379,-276
AUS,Australia,ISR,Israel,2016,108,365,-257
AUS,Australia,ISR,Israel,2017,138,377,-239
AUS,Australia,SVN,Slovenia,2009,27,63,-36
AUS,Australia,SVN,Slovenia,2010,17,51,-34
AUS,Australia,SVN,Slovenia,2011,9,47,-38
AUS,Australia,SVN,Slovenia,2012,12,73,-61
AUS,Australia,SVN,Slovenia,2013,6,62,-56
AUS,Australia,SVN,Slovenia,2014,6,91,-85
AUS,Australia,SVN,Slovenia,2015,8,54,-46
AUS,Australia,SVN,Slovenia,2016,8,66,-58
AUS,Australia,SVN,Slovenia,2017,5,57,-52
AUT,Austria,AUS,Australia,2008,129,274,-145
AUT,Austria,AUS,Australia,2009,186,245,-59
AUT,Austria,AUS,Australia,2010,174,231,-57
AUT,Austria,AUS,Australia,2011,111,289,-178
AUT,Austria,AUS,Australia,2012,159,239,-80
AUT,Austria,AUS,Australia,2013,143,286,-143
AUT,Austria,AUS,Australia,2014,119,248,-129
AUT,Austria,AUS,Australia,2015,113,288,-175
AUT,Austria,AUS,Australia,2016,105,270,-165
AUT,Austria,AUS,Australia,2017,112,227,-115
AUT,Austria,AUT,Austria,2017,0,0,0
AUT,Austria,BEL,Belgium,2008,284,284,0
AUT,Austria,BEL,Belgium,2009,283,248,35
AUT,Austria,BEL,Belgium,2010,282,256,26
AUT,Austria,BEL,Belgium,2011,305,275,30
AUT,Austria,BEL,Belgium,2012,280,306,-26
AUT,Austria,BEL,Belgium,2013,283,280,3
AUT,Austria,BEL,Belgium,2014,196,303,-107
AUT,Austria,BEL,Belgium,2015,225,359,-134
AUT,Austria,BEL,Belgium,2016,201,374,-173
AUT,Austria,BEL,Belgium,2017,199,389,-190
AUT,Austria,CAN,Canada,2008,91,328,-237
AUT,Austria,CAN,Canada,2009,109,298,-189
AUT,Austria,CAN,Canada,2010,124,283,-159
AUT,Austria,CAN,Canada,2011,84,362,-278
AUT,Austria,CAN,Canada,2012,102,393,-291
AUT,Austria,CAN,Canada,2013,90,387,-297
AUT,Austria,CAN,Canada,2014,98,384,-286
AUT,Austria,CAN,Canada,2015,118,463,-345
AUT,Austria,CAN,Canada,2016,100,420,-320
AUT,Austria,CAN,Canada,2017,105,474,-369
AUT,Austria,CZE,Czech Republic,2008,503,1323,-820
AUT,Austria,CZE,Czech Republic,2009,386,1251,-865
AUT,Austria,CZE,Czech Republic,2010,385,1144,-759
AUT,Austria,CZE,Czech Republic,2011,326,1565,-1239
AUT,Austria,CZE,Czech Republic,2012,188,1755,-1567
AUT,Austria,CZE,Czech Republic,2013,207,1815,-1608
AUT,Austria,CZE,Czech Republic,2014,116,1834,-1718
AUT,Austria,CZE,Czech Republic,2015,123,1760,-1637
AUT,Austria,CZE,Czech Republic,2016,127,1527,-1400
AUT,Austria,CZE,Czech Republic,2017,118,1591,-1473
AUT,Austria,DNK,Denmark,2008,90,151,-61
AUT,Austria,DNK,Denmark,2009,131,175,-44
AUT,Austria,DNK,Denmark,2010,145,152,-7
AUT,Austria,DNK,Denmark,2011,140,164,-24
AUT,Austria,DNK,Denmark,2012,110,162,-52
AUT,Austria,DNK,Denmark,2013,121,190,-69
AUT,Austria,DNK,Denmark,2014,144,173,-29
AUT,Austria,DNK,Denmark,2015,135,166,-31
AUT,Austria,DNK,Denmark,2016,140,225,-85
AUT,Austria,DNK,Denmark,2017,159,175,-16
AUT,Austria,FIN,Finland,2008,39,275,-236
AUT,Austria,FIN,Finland,2009,32,265,-233
AUT,Austria,FIN,Finland,2010,33,311,-278
AUT,Austria,FIN,Finland,2011,29,303,-274
AUT,Austria,FIN,Finland,2012,39,328,-289
AUT,Austria,FIN,Finland,2013,26,349,-323
AUT,Austria,FIN,Finland,2014,32,365,-333
AUT,Austria,FIN,Finland,2015,30,364,-334
AUT,Austria,FIN,Finland,2016,55,380,-325
AUT,Austria,FIN,Finland,2017,41,386,-345
AUT,Austria,FRA,France,2008,0,960,-960
AUT,Austria,FRA,France,2009,0,867,-867
AUT,Austria,FRA,France,2010,0,880,-880
AUT,Austria,FRA,France,2011,0,917,-917
AUT,Austria,FRA,France,2012,0,1144,-1144
AUT,Austria,FRA,France,2013,353,1156,-803
AUT,Austria,FRA,France,2014,410,1196,-786
AUT,Austria,FRA,France,2015,414,1199,-785
AUT,Austria,FRA,France,2016,307,1318,-1011
AUT,Austria,FRA,France,2017,371,1350,-979
AUT,Austria,DEU,Germany,2008,9477,19206,-9729
AUT,Austria,DEU,Germany,2009,9957,17553,-7596
AUT,Austria,DEU,Germany,2010,10039,17966,-7927
AUT,Austria,DEU,Germany,2011,10199,17410,-7211
AUT,Austria,DEU,Germany,2012,10089,17774,-7685
AUT,Austria,DEU,Germany,2013,9955,17743,-7788
AUT,Austria,DEU,Germany,2014,10120,16757,-6637
AUT,Austria,DEU,Germany,2015,10181,17028,-6847
AUT,Austria,DEU,Germany,2016,10393,16103,-5710
AUT,Austria,DEU,Germany,2017,10073,16234,-6161
AUT,Austria,HUN,Hungary,2008,659,5164,-4505
AUT,Austria,HUN,Hungary,2009,670,5768,-5098
AUT,Austria,HUN,Hungary,2010,585,6412,-5827
AUT,Austria,HUN,Hungary,2011,541,9250,-8709
AUT,Austria,HUN,Hungary,2012,455,13066,-12611
AUT,Austria,HUN,Hungary,2013,450,14935,-14485
AUT,Austria,HUN,Hungary,2014,472,14538,-14066
AUT,Austria,HUN,Hungary,2015,394,14394,-14000
AUT,Austria,HUN,Hungary,2016,385,13326,-12941
AUT,Austria,HUN,Hungary,2017,456,13113,-12657
AUT,Austria,ISL,Iceland,2008,39,24,15
AUT,Austria,ISL,Iceland,2009,27,41,-14
AUT,Austria,ISL,Iceland,2010,26,51,-25
AUT,Austria,ISL,Iceland,2011,12,52,-40
AUT,Austria,ISL,Iceland,2012,10,34,-24
AUT,Austria,ISL,Iceland,2013,19,23,-4
AUT,Austria,ISL,Iceland,2014,21,48,-27
AUT,Austria,ISL,Iceland,2015,21,47,-26
AUT,Austria,ISL,Iceland,2016,32,27,5
AUT,Austria,ISL,Iceland,2017,31,35,-4
AUT,Austria,ITA,Italy,2008,457,1842,-1385
AUT,Austria,ITA,Italy,2009,346,1955,-1609
AUT,Austria,ITA,Italy,2010,343,2167,-1824
AUT,Austria,ITA,Italy,2011,317,2297,-1980
AUT,Austria,ITA,Italy,2012,331,3095,-2764
AUT,Austria,ITA,Italy,2013,236,3975,-3739
AUT,Austria,ITA,Italy,2014,209,4101,-3892
AUT,Austria,ITA,Italy,2015,220,4611,-4391
AUT,Austria,ITA,Italy,2016,245,4249,-4004
AUT,Austria,ITA,Italy,2017,323,4389,-4066
AUT,Austria,JPN,Japan,2008,1433,357,1076
AUT,Austria,JPN,Japan,2009,1044,333,711
AUT,Austria,JPN,Japan,2010,3087,320,2767
AUT,Austria,JPN,Japan,2011,755,360,395
AUT,Austria,JPN,Japan,2012,1175,365,810
AUT,Austria,JPN,Japan,2013,881,371,510
AUT,Austria,JPN,Japan,2014,759,398,361
AUT,Austria,JPN,Japan,2015,884,436,448
AUT,Austria,JPN,Japan,2016,1331,447,884
AUT,Austria,JPN,Japan,2017,961,484,477
AUT,Austria,KOR,Korea,2008,71,345,-274
AUT,Austria,KOR,Korea,2009,79,372,-293
AUT,Austria,KOR,Korea,2010,85,352,-267
AUT,Austria,KOR,Korea,2011,93,362,-269
AUT,Austria,KOR,Korea,2012,103,411,-308
AUT,Austria,KOR,Korea,2013,122,425,-303
AUT,Austria,KOR,Korea,2014,82,445,-363
AUT,Austria,KOR,Korea,2015,110,399,-289
AUT,Austria,KOR,Korea,2016,109,419,-310
AUT,Austria,KOR,Korea,2017,91,477,-386
AUT,Austria,LUX,Luxembourg,2008,58,73,-15
AUT,Austria,LUX,Luxembourg,2009,72,67,5
AUT,Austria,LUX,Luxembourg,2010,62,80,-18
AUT,Austria,LUX,Luxembourg,2011,64,68,-4
AUT,Austria,LUX,Luxembourg,2012,65,96,-31
AUT,Austria,LUX,Luxembourg,2013,60,120,-60
AUT,Austria,LUX,Luxembourg,2014,104,127,-23
AUT,Austria,LUX,Luxembourg,2015,70,146,-76
AUT,Austria,LUX,Luxembourg,2016,73,156,-83
AUT,Austria,LUX,Luxembourg,2017,71,142,-71
AUT,Austria,MEX,Mexico,2008,31,184,-153
AUT,Austria,MEX,Mexico,2009,42,220,-178
AUT,Austria,MEX,Mexico,2010,26,193,-167
AUT,Austria,MEX,Mexico,2011,24,253,-229
AUT,Austria,MEX,Mexico,2012,25,237,-212
AUT,Austria,MEX,Mexico,2013,116,237,-121
AUT,Austria,MEX,Mexico,2014,61,238,-177
AUT,Austria,MEX,Mexico,2015,37,301,-264
AUT,Austria,MEX,Mexico,2016,41,326,-285
AUT,Austria,MEX,Mexico,2017,32,336,-304
AUT,Austria,NLD,Netherlands,2008,478,850,-372
AUT,Austria,NLD,Netherlands,2009,402,745,-343
AUT,Austria,NLD,Netherlands,2010,490,860,-370
AUT,Austria,NLD,Netherlands,2011,527,853,-326
AUT,Austria,NLD,Netherlands,2012,458,868,-410
AUT,Austria,NLD,Netherlands,2013,489,925,-436
AUT,Austria,NLD,Netherlands,2014,659,894,-235
AUT,Austria,NLD,Netherlands,2015,609,975,-366
AUT,Austria,NLD,Netherlands,2016,712,1033,-321
AUT,Austria,NLD,Netherlands,2017,801,1008,-207
AUT,Austria,NZL,New Zealand,2008,70,57,13
AUT,Austria,NZL,New Zealand,2009,61,41,20
AUT,Austria,NZL,New Zealand,2010,85,60,25
AUT,Austria,NZL,New Zealand,2011,62,41,21
AUT,Austria,NZL,New Zealand,2012,77,61,16
AUT,Austria,NZL,New Zealand,2013,52,55,-3
AUT,Austria,NZL,New Zealand,2014,52,53,-1
AUT,Austria,NZL,New Zealand,2015,56,55,1
AUT,Austria,NZL,New Zealand,2016,71,42,29
AUT,Austria,NZL,New Zealand,2017,71,53,18
AUT,Austria,NOR,Norway,2008,164,90,74
AUT,Austria,NOR,Norway,2009,101,79,22
AUT,Austria,NOR,Norway,2010,164,76,88
AUT,Austria,NOR,Norway,2011,114,98,16
AUT,Austria,NOR,Norway,2012,149,92,57
AUT,Austria,NOR,Norway,2013,142,78,64
AUT,Austria,NOR,Norway,2014,100,108,-8
AUT,Austria,NOR,Norway,2015,102,128,-26
AUT,Austria,NOR,Norway,2016,108,141,-33
AUT,Austria,NOR,Norway,2017,92,157,-65
AUT,Austria,POL,Poland,2008,168,4385,-4217
AUT,Austria,POL,Poland,2009,178,3845,-3667
AUT,Austria,POL,Poland,2010,185,4037,-3852
AUT,Austria,POL,Poland,2011,176,6428,-6252
AUT,Austria,POL,Poland,2012,139,7105,-6966
AUT,Austria,POL,Poland,2013,111,7297,-7186
AUT,Austria,POL,Poland,2014,112,6936,-6824
AUT,Austria,POL,Poland,2015,111,6136,-6025
AUT,Austria,POL,Poland,2016,76,5386,-5310
AUT,Austria,POL,Poland,2017,88,5232,-5144
AUT,Austria,SVK,Slovak Republic,2008,244,4926,-4682
AUT,Austria,SVK,Slovak Republic,2009,226,4011,-3785
AUT,Austria,SVK,Slovak Republic,2010,160,3997,-3837
AUT,Austria,SVK,Slovak Republic,2011,105,5314,-5209
AUT,Austria,SVK,Slovak Republic,2012,63,5957,-5894
AUT,Austria,SVK,Slovak Republic,2013,29,6234,-6205
AUT,Austria,SVK,Slovak Republic,2014,44,6467,-6423
AUT,Austria,SVK,Slovak Republic,2015,91,6080,-5989
AUT,Austria,SVK,Slovak Republic,2016,61,5575,-5514
AUT,Austria,SVK,Slovak Republic,2017,51,5054,-5003
AUT,Austria,ESP,Spain,2008,845,567,278
AUT,Austria,ESP,Spain,2009,676,660,16
AUT,Austria,ESP,Spain,2010,658,839,-181
AUT,Austria,ESP,Spain,2011,620,984,-364
AUT,Austria,ESP,Spain,2012,607,1430,-823
AUT,Austria,ESP,Spain,2013,584,1816,-1232
AUT,Austria,ESP,Spain,2014,553,1570,-1017
AUT,Austria,ESP,Spain,2015,539,1613,-1074
AUT,Austria,ESP,Spain,2016,584,1480,-896
AUT,Austria,ESP,Spain,2017,743,1443,-700
AUT,Austria,SWE,Sweden,2008,228,317,-89
AUT,Austria,SWE,Sweden,2009,219,317,-98
AUT,Austria,SWE,Sweden,2010,185,333,-148
AUT,Austria,SWE,Sweden,2011,151,323,-172
AUT,Austria,SWE,Sweden,2012,218,355,-137
AUT,Austria,SWE,Sweden,2013,171,311,-140
AUT,Austria,SWE,Sweden,2014,228,351,-123
AUT,Austria,SWE,Sweden,2015,192,393,-201
AUT,Austria,SWE,Sweden,2016,242,349,-107
AUT,Austria,SWE,Sweden,2017,235,369,-134
AUT,Austria,CHE,Switzerland,2008,3202,644,2558
AUT,Austria,CHE,Switzerland,2009,2775,505,2270
AUT,Austria,CHE,Switzerland,2010,2579,651,1928
AUT,Austria,CHE,Switzerland,2011,2855,563,2292
AUT,Austria,CHE,Switzerland,2012,3054,645,2409
AUT,Austria,CHE,Switzerland,2013,2915,655,2260
AUT,Austria,CHE,Switzerland,2014,2961,643,2318
AUT,Austria,CHE,Switzerland,2015,3168,632,2536
AUT,Austria,CHE,Switzerland,2016,2923,671,2252
AUT,Austria,CHE,Switzerland,2017,2777,724,2053
AUT,Austria,TUR,Turkey,2010,139,4258,-4119
AUT,Austria,TUR,Turkey,2016,1532,3707,-2175
AUT,Austria,TUR,Turkey,2017,1472,3347,-1875
AUT,Austria,GBR,United Kingdom,2012,1000,1225,-225
AUT,Austria,GBR,United Kingdom,2013,1000,1398,-398
AUT,Austria,GBR,United Kingdom,2014,1000,1373,-373
AUT,Austria,GBR,United Kingdom,2015,1000,1401,-401
AUT,Austria,USA,United States,2008,443,1664,-1221
AUT,Austria,USA,United States,2009,512,1565,-1053
AUT,Austria,USA,United States,2010,442,1632,-1190
AUT,Austria,USA,United States,2011,424,1805,-1381
AUT,Austria,USA,United States,2012,407,1796,-1389
AUT,Austria,USA,United States,2013,415,1801,-1386
AUT,Austria,USA,United States,2014,438,1861,-1423
AUT,Austria,USA,United States,2015,474,1977,-1503
AUT,Austria,USA,United States,2016,432,1880,-1448
AUT,Austria,USA,United States,2017,387,1938,-1551
AUT,Austria,CHL,Chile,2008,20,62,-42
AUT,Austria,CHL,Chile,2009,38,87,-49
AUT,Austria,CHL,Chile,2010,27,75,-48
AUT,Austria,CHL,Chile,2011,51,72,-21
AUT,Austria,CHL,Chile,2012,34,84,-50
AUT,Austria,CHL,Chile,2013,76,95,-19
AUT,Austria,CHL,Chile,2014,94,102,-8
AUT,Austria,CHL,Chile,2015,96,110,-14
AUT,Austria,CHL,Chile,2016,30,90,-60
AUT,Austria,EST,Estonia,2008,12,66,-54
AUT,Austria,EST,Estonia,2009,11,62,-51
AUT,Austria,EST,Estonia,2010,10,83,-73
AUT,Austria,EST,Estonia,2011,0,83,-83
AUT,Austria,EST,Estonia,2012,0,98,-98
AUT,Austria,EST,Estonia,2013,1,131,-130
AUT,Austria,EST,Estonia,2014,0,115,-115
AUT,Austria,EST,Estonia,2015,31,126,-95
AUT,Austria,EST,Estonia,2016,40,111,-71
AUT,Austria,EST,Estonia,2017,44,105,-61
AUT,Austria,ISR,Israel,2008,17,182,-165
AUT,Austria,ISR,Israel,2009,11,187,-176
AUT,Austria,ISR,Israel,2010,18,195,-177
AUT,Austria,ISR,Israel,2011,19,160,-141
AUT,Austria,ISR,Israel,2012,18,182,-164
AUT,Austria,ISR,Israel,2013,25,233,-208
AUT,Austria,ISR,Israel,2014,17,222,-205
AUT,Austria,ISR,Israel,2015,45,200,-155
AUT,Austria,ISR,Israel,2016,46,200,-154
AUT,Austria,ISR,Israel,2017,26,127,-101
AUT,Austria,SVN,Slovenia,2008,119,742,-623
AUT,Austria,SVN,Slovenia,2009,111,756,-645
AUT,Austria,SVN,Slovenia,2010,89,815,-726
AUT,Austria,SVN,Slovenia,2011,135,1344,-1209
AUT,Austria,SVN,Slovenia,2012,105,1876,-1771
AUT,Austria,SVN,Slovenia,2013,82,2520,-2438
AUT,Austria,SVN,Slovenia,2014,88,3083,-2995
AUT,Austria,SVN,Slovenia,2015,77,2834,-2757
AUT,Austria,SVN,Slovenia,2016,97,2697,-2600
AUT,Austria,SVN,Slovenia,2017,95,2496,-2401
AZE,Azerbaijan,AUS,Australia,2008,16,0,16
AZE,Azerbaijan,AUS,Australia,2009,19,0,19
AZE,Azerbaijan,AUS,Australia,2010,13,0,13
AZE,Azerbaijan,AUS,Australia,2011,21,5,16
AZE,Azerbaijan,AUS,Australia,2012,25,0,25
AZE,Azerbaijan,AUS,Australia,2013,35,0,35
AZE,Azerbaijan,AUS,Australia,2014,19,8,11
AZE,Azerbaijan,AUS,Australia,2015,19,0,19
AZE,Azerbaijan,AUS,Australia,2016,11,0,11
AZE,Azerbaijan,AUS,Australia,2017,21,0,21
AZE,Azerbaijan,AUT,Austria,2008,125,37,88
AZE,Azerbaijan,AUT,Austria,2009,142,78,64
AZE,Azerbaijan,AUT,Austria,2010,89,76,13
AZE,Azerbaijan,AUT,Austria,2011,108,69,39
AZE,Azerbaijan,AUT,Austria,2012,174,79,95
AZE,Azerbaijan,AUT,Austria,2013,160,88,72
AZE,Azerbaijan,AUT,Austria,2014,156,78,78
AZE,Azerbaijan,AUT,Austria,2015,131,77,54
AZE,Azerbaijan,AUT,Austria,2016,139,90,49
AZE,Azerbaijan,AUT,Austria,2017,152,91,61
AZE,Azerbaijan,BEL,Belgium,2008,23,0,23
AZE,Azerbaijan,BEL,Belgium,2009,28,0,28
AZE,Azerbaijan,BEL,Belgium,2010,48,11,37
AZE,Azerbaijan,BEL,Belgium,2011,33,0,33
AZE,Azerbaijan,BEL,Belgium,2012,139,51,88
AZE,Azerbaijan,BEL,Belgium,2013,87,133,-46
AZE,Azerbaijan,BEL,Belgium,2014,43,108,-65
AZE,Azerbaijan,BEL,Belgium,2015,57,73,-16
AZE,Azerbaijan,BEL,Belgium,2016,73,31,42
AZE,Azerbaijan,BEL,Belgium,2017,63,34,29
AZE,Azerbaijan,CAN,Canada,2008,125,0,125
AZE,Azerbaijan,CAN,Canada,2009,165,0,165
AZE,Azerbaijan,CAN,Canada,2010,209,0,209
AZE,Azerbaijan,CAN,Canada,2011,137,0,137
AZE,Azerbaijan,CAN,Canada,2012,160,0,160
AZE,Azerbaijan,CAN,Canada,2013,57,0,57
AZE,Azerbaijan,CAN,Canada,2014,63,0,63
AZE,Azerbaijan,CAN,Canada,2015,112,0,112
AZE,Azerbaijan,CAN,Canada,2016,115,0,115
AZE,Azerbaijan,CAN,Canada,2017,120,0,120
AZE,Azerbaijan,CZE,Czech Republic,2008,107,1,106
AZE,Azerbaijan,CZE,Czech Republic,2009,168,0,168
AZE,Azerbaijan,CZE,Czech Republic,2010,192,0,192
AZE,Azerbaijan,CZE,Czech Republic,2011,115,0,115
AZE,Azerbaijan,CZE,Czech Republic,2012,155,63,92
AZE,Azerbaijan,CZE,Czech Republic,2013,120,116,4
AZE,Azerbaijan,CZE,Czech Republic,2014,145,71,74
AZE,Azerbaijan,CZE,Czech Republic,2015,111,83,28
AZE,Azerbaijan,CZE,Czech Republic,2016,117,73,44
AZE,Azerbaijan,CZE,Czech Republic,2017,173,72,101
AZE,Azerbaijan,DNK,Denmark,2008,19,1,18
AZE,Azerbaijan,DNK,Denmark,2009,16,2,14
AZE,Azerbaijan,DNK,Denmark,2010,18,4,14
AZE,Azerbaijan,DNK,Denmark,2011,13,5,8
AZE,Azerbaijan,DNK,Denmark,2012,10,3,7
AZE,Azerbaijan,DNK,Denmark,2013,20,1,19
AZE,Azerbaijan,DNK,Denmark,2014,11,4,7
AZE,Azerbaijan,DNK,Denmark,2015,11,5,6
AZE,Azerbaijan,DNK,Denmark,2016,13,14,-1
AZE,Azerbaijan,DNK,Denmark,2017,24,3,21
AZE,Azerbaijan,FIN,Finland,2008,12,2,10
AZE,Azerbaijan,FIN,Finland,2009,8,0,8
AZE,Azerbaijan,FIN,Finland,2010,6,1,5
AZE,Azerbaijan,FIN,Finland,2011,20,0,20
AZE,Azerbaijan,FIN,Finland,2012,17,2,15
AZE,Azerbaijan,FIN,Finland,2013,8,6,2
AZE,Azerbaijan,FIN,Finland,2014,10,2,8
AZE,Azerbaijan,FIN,Finland,2015,16,0,16
AZE,Azerbaijan,FIN,Finland,2016,40,2,38
AZE,Azerbaijan,FIN,Finland,2017,17,3,14
AZE,Azerbaijan,FRA,France,2008,423,0,423
AZE,Azerbaijan,FRA,France,2009,389,0,389
AZE,Azerbaijan,FRA,France,2010,318,0,318
AZE,Azerbaijan,FRA,France,2011,362,0,362
AZE,Azerbaijan,FRA,France,2012,337,0,337
AZE,Azerbaijan,FRA,France,2013,301,0,301
AZE,Azerbaijan,FRA,France,2014,307,0,307
AZE,Azerbaijan,FRA,France,2015,272,0,272
AZE,Azerbaijan,FRA,France,2016,276,0,276
AZE,Azerbaijan,FRA,France,2017,251,0,251
AZE,Azerbaijan,DEU,Germany,2008,831,950,-119
AZE,Azerbaijan,DEU,Germany,2009,1193,844,349
AZE,Azerbaijan,DEU,Germany,2010,1081,803,278
AZE,Azerbaijan,DEU,Germany,2011,1350,607,743
AZE,Azerbaijan,DEU,Germany,2012,1360,686,674
AZE,Azerbaijan,DEU,Germany,2013,1705,679,1026
AZE,Azerbaijan,DEU,Germany,2014,2196,844,1352
AZE,Azerbaijan,DEU,Germany,2015,3154,912,2242
AZE,Azerbaijan,DEU,Germany,2016,3985,1194,2791
AZE,Azerbaijan,DEU,Germany,2017,3765,1760,2005
AZE,Azerbaijan,HUN,Hungary,2008,32,1,31
AZE,Azerbaijan,HUN,Hungary,2009,24,0,24
AZE,Azerbaijan,HUN,Hungary,2010,32,4,28
AZE,Azerbaijan,HUN,Hungary,2011,31,4,27
AZE,Azerbaijan,HUN,Hungary,2012,35,15,20
AZE,Azerbaijan,HUN,Hungary,2013,45,1,44
AZE,Azerbaijan,HUN,Hungary,2014,83,0,83
AZE,Azerbaijan,HUN,Hungary,2015,75,8,67
AZE,Azerbaijan,HUN,Hungary,2016,200,15,185
AZE,Azerbaijan,HUN,Hungary,2017,218,0,218
AZE,Azerbaijan,ISL,Iceland,2008,0,0,0
AZE,Azerbaijan,ISL,Iceland,2009,0,0,0
AZE,Azerbaijan,ISL,Iceland,2010,0,0,0
AZE,Azerbaijan,ISL,Iceland,2011,0,0,0
AZE,Azerbaijan,ISL,Iceland,2012,0,0,0
AZE,Azerbaijan,ISL,Iceland,2013,1,0,1
AZE,Azerbaijan,ISL,Iceland,2014,1,0,1
AZE,Azerbaijan,ISL,Iceland,2015,0,0,0
AZE,Azerbaijan,ISL,Iceland,2016,4,1,3
AZE,Azerbaijan,ISL,Iceland,2017,0,0,0
AZE,Azerbaijan,ITA,Italy,2008,34,0,34
AZE,Azerbaijan,ITA,Italy,2009,38,0,38
AZE,Azerbaijan,ITA,Italy,2010,42,3,39
AZE,Azerbaijan,ITA,Italy,2011,41,1,40
AZE,Azerbaijan,ITA,Italy,2012,35,2,33
AZE,Azerbaijan,ITA,Italy,2013,40,4,36
AZE,Azerbaijan,ITA,Italy,2014,17,5,12
AZE,Azerbaijan,ITA,Italy,2015,38,1,37
AZE,Azerbaijan,ITA,Italy,2016,44,0,44
AZE,Azerbaijan,ITA,Italy,2017,53,4,49
AZE,Azerbaijan,JPN,Japan,2008,79,80,-1
AZE,Azerbaijan,JPN,Japan,2009,83,74,9
AZE,Azerbaijan,JPN,Japan,2010,91,75,16
AZE,Azerbaijan,JPN,Japan,2011,64,61,3
AZE,Azerbaijan,JPN,Japan,2012,86,83,3
AZE,Azerbaijan,JPN,Japan,2013,78,68,10
AZE,Azerbaijan,JPN,Japan,2014,94,86,8
AZE,Azerbaijan,JPN,Japan,2015,86,83,3
AZE,Azerbaijan,JPN,Japan,2016,136,115,21
AZE,Azerbaijan,JPN,Japan,2017,108,88,20
AZE,Azerbaijan,KOR,Korea,2008,46,12,34
AZE,Azerbaijan,KOR,Korea,2009,40,11,29
AZE,Azerbaijan,KOR,Korea,2010,45,28,17
AZE,Azerbaijan,KOR,Korea,2011,42,38,4
AZE,Azerbaijan,KOR,Korea,2012,41,46,-5
AZE,Azerbaijan,KOR,Korea,2013,46,44,2
AZE,Azerbaijan,KOR,Korea,2014,39,37,2
AZE,Azerbaijan,KOR,Korea,2015,41,55,-14
AZE,Azerbaijan,KOR,Korea,2016,56,51,5
AZE,Azerbaijan,KOR,Korea,2017,83,46,37
AZE,Azerbaijan,LUX,Luxembourg,2008,2,0,2
AZE,Azerbaijan,LUX,Luxembourg,2009,14,0,14
AZE,Azerbaijan,LUX,Luxembourg,2010,6,5,1
AZE,Azerbaijan,LUX,Luxembourg,2011,18,0,18
AZE,Azerbaijan,LUX,Luxembourg,2012,17,1,16
AZE,Azerbaijan,LUX,Luxembourg,2013,13,5,8
AZE,Azerbaijan,LUX,Luxembourg,2014,7,6,1
AZE,Azerbaijan,LUX,Luxembourg,2015,13,4,9
AZE,Azerbaijan,LUX,Luxembourg,2016,25,1,24
AZE,Azerbaijan,LUX,Luxembourg,2017,45,3,42
AZE,Azerbaijan,MEX,Mexico,2008,3,0,3
AZE,Azerbaijan,MEX,Mexico,2009,2,0,2
AZE,Azerbaijan,MEX,Mexico,2012,1,0,1
AZE,Azerbaijan,MEX,Mexico,2013,5,0,5
AZE,Azerbaijan,MEX,Mexico,2014,0,0,0
AZE,Azerbaijan,MEX,Mexico,2016,2,0,2
AZE,Azerbaijan,NLD,Netherlands,2009,50,13,37
AZE,Azerbaijan,NLD,Netherlands,2010,67,19,48
AZE,Azerbaijan,NLD,Netherlands,2011,68,23,45
AZE,Azerbaijan,NLD,Netherlands,2012,59,30,29
AZE,Azerbaijan,NLD,Netherlands,2013,76,31,45
AZE,Azerbaijan,NLD,Netherlands,2014,119,42,77
AZE,Azerbaijan,NLD,Netherlands,2015,100,47,53
AZE,Azerbaijan,NLD,Netherlands,2016,144,72,72
AZE,Azerbaijan,NLD,Netherlands,2017,127,56,71
AZE,Azerbaijan,NZL,New Zealand,2008,2,1,1
AZE,Azerbaijan,NZL,New Zealand,2009,1,0,1
AZE,Azerbaijan,NZL,New Zealand,2010,4,2,2
AZE,Azerbaijan,NZL,New Zealand,2011,2,0,2
AZE,Azerbaijan,NZL,New Zealand,2012,2,0,2
AZE,Azerbaijan,NZL,New Zealand,2013,4,0,4
AZE,Azerbaijan,NZL,New Zealand,2014,1,1,0
AZE,Azerbaijan,NZL,New Zealand,2015,2,2,0
AZE,Azerbaijan,NZL,New Zealand,2017,2,1,1
AZE,Azerbaijan,NOR,Norway,2008,58,9,49
AZE,Azerbaijan,NOR,Norway,2009,37,10,27
AZE,Azerbaijan,NOR,Norway,2010,53,18,35
AZE,Azerbaijan,NOR,Norway,2011,62,21,41
AZE,Azerbaijan,NOR,Norway,2012,71,32,39
AZE,Azerbaijan,NOR,Norway,2013,39,45,-6
AZE,Azerbaijan,NOR,Norway,2014,31,29,2
AZE,Azerbaijan,NOR,Norway,2015,39,29,10
AZE,Azerbaijan,NOR,Norway,2016,28,13,15
AZE,Azerbaijan,NOR,Norway,2017,20,14,6
AZE,Azerbaijan,POL,Poland,2008,85,0,85
AZE,Azerbaijan,POL,Poland,2009,71,0,71
AZE,Azerbaijan,POL,Poland,2010,75,0,75
AZE,Azerbaijan,POL,Poland,2011,95,0,95
AZE,Azerbaijan,POL,Poland,2012,114,0,114
AZE,Azerbaijan,POL,Poland,2013,158,0,158
AZE,Azerbaijan,POL,Poland,2014,88,0,88
AZE,Azerbaijan,POL,Poland,2015,303,0,303
AZE,Azerbaijan,POL,Poland,2016,498,0,498
AZE,Azerbaijan,POL,Poland,2017,434,0,434
AZE,Azerbaijan,SVK,Slovak Republic,2008,4,0,4
AZE,Azerbaijan,SVK,Slovak Republic,2009,3,0,3
AZE,Azerbaijan,SVK,Slovak Republic,2010,3,3,0
AZE,Azerbaijan,SVK,Slovak Republic,2011,3,0,3
AZE,Azerbaijan,SVK,Slovak Republic,2014,1,0,1
AZE,Azerbaijan,SVK,Slovak Republic,2015,3,0,3
AZE,Azerbaijan,SVK,Slovak Republic,2016,1,0,1
AZE,Azerbaijan,ESP,Spain,2008,66,21,45
AZE,Azerbaijan,ESP,Spain,2009,34,25,9
AZE,Azerbaijan,ESP,Spain,2010,38,23,15
AZE,Azerbaijan,ESP,Spain,2011,46,25,21
AZE,Azerbaijan,ESP,Spain,2012,79,32,47
AZE,Azerbaijan,ESP,Spain,2013,75,51,24
AZE,Azerbaijan,ESP,Spain,2014,91,32,59
AZE,Azerbaijan,ESP,Spain,2015,101,28,73
AZE,Azerbaijan,ESP,Spain,2016,122,37,85
AZE,Azerbaijan,ESP,Spain,2017,122,66,56
AZE,Azerbaijan,SWE,Sweden,2008,114,7,107
AZE,Azerbaijan,SWE,Sweden,2009,176,5,171
AZE,Azerbaijan,SWE,Sweden,2010,228,10,218
AZE,Azerbaijan,SWE,Sweden,2011,250,21,229
AZE,Azerbaijan,SWE,Sweden,2012,247,23,224
AZE,Azerbaijan,SWE,Sweden,2013,196,30,166
AZE,Azerbaijan,SWE,Sweden,2014,193,36,157
AZE,Azerbaijan,SWE,Sweden,2015,179,50,129
AZE,Azerbaijan,SWE,Sweden,2016,238,21,217
AZE,Azerbaijan,SWE,Sweden,2017,154,19,135
AZE,Azerbaijan,CHE,Switzerland,2010,75,24,51
AZE,Azerbaijan,CHE,Switzerland,2011,109,24,85
AZE,Azerbaijan,CHE,Switzerland,2012,88,46,42
AZE,Azerbaijan,CHE,Switzerland,2013,101,46,55
AZE,Azerbaijan,CHE,Switzerland,2014,116,48,68
AZE,Azerbaijan,CHE,Switzerland,2015,98,71,27
AZE,Azerbaijan,CHE,Switzerland,2016,74,47,27
AZE,Azerbaijan,CHE,Switzerland,2017,53,46,7
AZE,Azerbaijan,TUR,Turkey,2010,2501,0,2501
AZE,Azerbaijan,TUR,Turkey,2016,15284,4290,10994
AZE,Azerbaijan,TUR,Turkey,2017,20865,10555,10310
AZE,Azerbaijan,GBR,United Kingdom,2014,1000,0,1000
AZE,Azerbaijan,USA,United States,2008,1071,0,1071
AZE,Azerbaijan,USA,United States,2009,834,0,834
AZE,Azerbaijan,USA,United States,2010,781,0,781
AZE,Azerbaijan,USA,United States,2011,728,0,728
AZE,Azerbaijan,USA,United States,2012,663,0,663
AZE,Azerbaijan,USA,United States,2013,637,0,637
AZE,Azerbaijan,USA,United States,2014,672,0,672
AZE,Azerbaijan,USA,United States,2015,676,0,676
AZE,Azerbaijan,USA,United States,2016,784,0,784
AZE,Azerbaijan,USA,United States,2017,881,0,881
AZE,Azerbaijan,CHL,Chile,2008,0,0,0
AZE,Azerbaijan,CHL,Chile,2009,1,0,1
AZE,Azerbaijan,CHL,Chile,2010,0,0,0
AZE,Azerbaijan,CHL,Chile,2011,0,0,0
AZE,Azerbaijan,CHL,Chile,2012,0,0,0
AZE,Azerbaijan,CHL,Chile,2013,1,0,1
AZE,Azerbaijan,CHL,Chile,2014,1,0,1
AZE,Azerbaijan,CHL,Chile,2015,0,0,0
AZE,Azerbaijan,CHL,Chile,2016,0,0,0
AZE,Azerbaijan,EST,Estonia,2008,10,0,10
AZE,Azerbaijan,EST,Estonia,2009,3,0,3
AZE,Azerbaijan,EST,Estonia,2010,7,0,7
AZE,Azerbaijan,EST,Estonia,2011,11,0,11
AZE,Azerbaijan,EST,Estonia,2012,5,0,5
AZE,Azerbaijan,EST,Estonia,2013,12,0,12
AZE,Azerbaijan,EST,Estonia,2014,6,0,6
AZE,Azerbaijan,EST,Estonia,2015,25,0,25
AZE,Azerbaijan,EST,Estonia,2016,27,0,27
AZE,Azerbaijan,EST,Estonia,2017,59,0,59
AZE,Azerbaijan,SVN,Slovenia,2011,1,0,1
AZE,Azerbaijan,SVN,Slovenia,2012,4,0,4
AZE,Azerbaijan,SVN,Slovenia,2013,3,0,3
AZE,Azerbaijan,SVN,Slovenia,2014,3,0,3
AZE,Azerbaijan,SVN,Slovenia,2015,10,0,10
AZE,Azerbaijan,SVN,Slovenia,2016,13,1,12
AZE,Azerbaijan,SVN,Slovenia,2017,9,0,9
BHS,Bahamas,AUS,Australia,2008,2,0,2
BHS,Bahamas,AUS,Australia,2009,0,0,0
BHS,Bahamas,AUS,Australia,2010,1,0,1
BHS,Bahamas,AUS,Australia,2011,3,6,-3
BHS,Bahamas,AUS,Australia,2012,1,0,1
BHS,Bahamas,AUS,Australia,2013,0,5,-5
BHS,Bahamas,AUS,Australia,2014,11,0,11
BHS,Bahamas,AUS,Australia,2015,0,0,0
BHS,Bahamas,AUS,Australia,2016,0,0,0
BHS,Bahamas,AUS,Australia,2017,3,0,3
BHS,Bahamas,AUT,Austria,2008,0,0,0
BHS,Bahamas,AUT,Austria,2009,1,0,1
BHS,Bahamas,AUT,Austria,2010,2,0,2
BHS,Bahamas,AUT,Austria,2011,2,0,2
BHS,Bahamas,AUT,Austria,2012,1,0,1
BHS,Bahamas,AUT,Austria,2013,0,0,0
BHS,Bahamas,AUT,Austria,2014,1,0,1
BHS,Bahamas,AUT,Austria,2015,1,1,0
BHS,Bahamas,AUT,Austria,2016,2,0,2
BHS,Bahamas,AUT,Austria,2017,3,0,3
BHS,Bahamas,BEL,Belgium,2008,0,0,0
BHS,Bahamas,BEL,Belgium,2009,0,0,0
BHS,Bahamas,BEL,Belgium,2010,0,1,-1
BHS,Bahamas,BEL,Belgium,2012,1,0,1
BHS,Bahamas,BEL,Belgium,2013,1,0,1
BHS,Bahamas,BEL,Belgium,2014,2,1,1
BHS,Bahamas,BEL,Belgium,2015,1,1,0
BHS,Bahamas,BEL,Belgium,2016,2,3,-1
BHS,Bahamas,BEL,Belgium,2017,1,0,1
BHS,Bahamas,CAN,Canada,2008,30,0,30
BHS,Bahamas,CAN,Canada,2009,27,0,27
BHS,Bahamas,CAN,Canada,2010,25,0,25
BHS,Bahamas,CAN,Canada,2011,40,0,40
BHS,Bahamas,CAN,Canada,2012,60,0,60
BHS,Bahamas,CAN,Canada,2013,55,0,55
BHS,Bahamas,CAN,Canada,2014,61,0,61
BHS,Bahamas,CAN,Canada,2015,74,0,74
BHS,Bahamas,CAN,Canada,2016,80,0,80
BHS,Bahamas,CAN,Canada,2017,125,0,125
BHS,Bahamas,DNK,Denmark,2012,0,1,-1
BHS,Bahamas,DNK,Denmark,2013,2,2,0
BHS,Bahamas,DNK,Denmark,2014,0,0,0
BHS,Bahamas,DNK,Denmark,2015,1,0,1
BHS,Bahamas,DNK,Denmark,2016,2,1,1
BHS,Bahamas,DNK,Denmark,2017,0,0,0
BHS,Bahamas,FIN,Finland,2008,0,0,0
BHS,Bahamas,FIN,Finland,2009,0,0,0
BHS,Bahamas,FIN,Finland,2010,0,0,0
BHS,Bahamas,FIN,Finland,2011,0,0,0
BHS,Bahamas,FIN,Finland,2012,0,0,0
BHS,Bahamas,FIN,Finland,2013,0,0,0
BHS,Bahamas,FIN,Finland,2014,0,0,0
BHS,Bahamas,FIN,Finland,2015,1,0,1
BHS,Bahamas,FIN,Finland,2016,0,0,0
BHS,Bahamas,FIN,Finland,2017,1,2,-1
BHS,Bahamas,FRA,France,2008,0,0,0
BHS,Bahamas,FRA,France,2009,0,0,0
BHS,Bahamas,FRA,France,2010,5,0,5
BHS,Bahamas,FRA,France,2011,4,0,4
BHS,Bahamas,FRA,France,2012,0,0,0
BHS,Bahamas,FRA,France,2013,1,0,1
BHS,Bahamas,FRA,France,2014,1,0,1
BHS,Bahamas,FRA,France,2015,2,0,2
BHS,Bahamas,FRA,France,2016,4,0,4
BHS,Bahamas,FRA,France,2017,9,0,9
BHS,Bahamas,DEU,Germany,2008,5,6,-1
BHS,Bahamas,DEU,Germany,2009,8,4,4
BHS,Bahamas,DEU,Germany,2010,8,5,3
BHS,Bahamas,DEU,Germany,2011,1,2,-1
BHS,Bahamas,DEU,Germany,2012,1,4,-3
BHS,Bahamas,DEU,Germany,2013,7,0,7
BHS,Bahamas,DEU,Germany,2014,7,6,1
BHS,Bahamas,DEU,Germany,2015,13,5,8
BHS,Bahamas,DEU,Germany,2016,4,5,-1
BHS,Bahamas,DEU,Germany,2017,6,5,1
BHS,Bahamas,HUN,Hungary,2008,1,0,1
BHS,Bahamas,HUN,Hungary,2009,0,0,0
BHS,Bahamas,HUN,Hungary,2010,0,0,0
BHS,Bahamas,HUN,Hungary,2011,0,0,0
BHS,Bahamas,HUN,Hungary,2012,0,0,0
BHS,Bahamas,HUN,Hungary,2013,0,0,0
BHS,Bahamas,HUN,Hungary,2014,0,0,0
BHS,Bahamas,HUN,Hungary,2015,0,0,0
BHS,Bahamas,HUN,Hungary,2016,0,0,0
BHS,Bahamas,HUN,Hungary,2017,1,0,1
BHS,Bahamas,ISL,Iceland,2008,1,0,1
BHS,Bahamas,ISL,Iceland,2009,0,0,0
BHS,Bahamas,ISL,Iceland,2010,0,0,0
BHS,Bahamas,ISL,Iceland,2011,0,0,0
BHS,Bahamas,ISL,Iceland,2012,0,0,0
BHS,Bahamas,ISL,Iceland,2013,0,0,0
BHS,Bahamas,ISL,Iceland,2014,0,0,0
BHS,Bahamas,ISL,Iceland,2015,1,0,1
BHS,Bahamas,ISL,Iceland,2016,0,1,-1
BHS,Bahamas,ISL,Iceland,2017,1,0,1
BHS,Bahamas,ITA,Italy,2008,4,0,4
BHS,Bahamas,ITA,Italy,2009,2,0,2
BHS,Bahamas,ITA,Italy,2010,11,2,9
BHS,Bahamas,ITA,Italy,2011,2,2,0
BHS,Bahamas,ITA,Italy,2012,6,0,6
BHS,Bahamas,ITA,Italy,2013,3,0,3
BHS,Bahamas,ITA,Italy,2014,3,0,3
BHS,Bahamas,ITA,Italy,2015,4,1,3
BHS,Bahamas,ITA,Italy,2016,1,0,1
BHS,Bahamas,ITA,Italy,2017,2,3,-1
BHS,Bahamas,JPN,Japan,2008,3,2,1
BHS,Bahamas,JPN,Japan,2009,4,3,1
BHS,Bahamas,JPN,Japan,2010,3,2,1
BHS,Bahamas,JPN,Japan,2011,6,3,3
BHS,Bahamas,JPN,Japan,2012,4,3,1
BHS,Bahamas,JPN,Japan,2013,5,1,4
BHS,Bahamas,JPN,Japan,2014,4,5,-1
BHS,Bahamas,JPN,Japan,2015,4,3,1
BHS,Bahamas,JPN,Japan,2016,6,4,2
BHS,Bahamas,JPN,Japan,2017,7,6,1
BHS,Bahamas,KOR,Korea,2008,0,0,0
BHS,Bahamas,KOR,Korea,2009,0,0,0
BHS,Bahamas,KOR,Korea,2010,2,1,1
BHS,Bahamas,KOR,Korea,2011,2,3,-1
BHS,Bahamas,KOR,Korea,2012,1,1,0
BHS,Bahamas,KOR,Korea,2013,2,1,1
BHS,Bahamas,KOR,Korea,2014,3,3,0
BHS,Bahamas,KOR,Korea,2015,2,2,0
BHS,Bahamas,KOR,Korea,2016,4,1,3
BHS,Bahamas,KOR,Korea,2017,2,1,1
BHS,Bahamas,LUX,Luxembourg,2008,0,0,0
BHS,Bahamas,LUX,Luxembourg,2009,0,0,0
BHS,Bahamas,LUX,Luxembourg,2010,0,0,0
BHS,Bahamas,LUX,Luxembourg,2011,0,0,0
BHS,Bahamas,LUX,Luxembourg,2012,0,0,0
BHS,Bahamas,LUX,Luxembourg,2013,0,0,0
BHS,Bahamas,LUX,Luxembourg,2014,0,0,0
BHS,Bahamas,LUX,Luxembourg,2015,0,0,0
BHS,Bahamas,LUX,Luxembourg,2016,0,0,0
BHS,Bahamas,LUX,Luxembourg,2017,0,0,0
BHS,Bahamas,MEX,Mexico,2011,1,0,1
BHS,Bahamas,MEX,Mexico,2012,0,0,0
BHS,Bahamas,MEX,Mexico,2013,2,0,2
BHS,Bahamas,MEX,Mexico,2014,1,0,1
BHS,Bahamas,MEX,Mexico,2015,1,0,1
BHS,Bahamas,MEX,Mexico,2016,2,0,2
BHS,Bahamas,MEX,Mexico,2017,2,0,2
BHS,Bahamas,NLD,Netherlands,2008,2,2,0
BHS,Bahamas,NLD,Netherlands,2011,1,0,1
BHS,Bahamas,NLD,Netherlands,2012,2,3,-1
BHS,Bahamas,NLD,Netherlands,2013,3,0,3
BHS,Bahamas,NLD,Netherlands,2014,4,2,2
BHS,Bahamas,NLD,Netherlands,2015,2,2,0
BHS,Bahamas,NLD,Netherlands,2016,1,1,0
BHS,Bahamas,NLD,Netherlands,2017,3,1,2
BHS,Bahamas,NZL,New Zealand,2008,0,0,0
BHS,Bahamas,NZL,New Zealand,2012,1,0,1
BHS,Bahamas,NZL,New Zealand,2014,2,0,2
BHS,Bahamas,NZL,New Zealand,2015,2,0,2
BHS,Bahamas,NOR,Norway,2008,3,0,3
BHS,Bahamas,NOR,Norway,2009,0,0,0
BHS,Bahamas,NOR,Norway,2010,0,1,-1
BHS,Bahamas,NOR,Norway,2011,2,0,2
BHS,Bahamas,NOR,Norway,2012,1,1,0
BHS,Bahamas,NOR,Norway,2013,1,0,1
BHS,Bahamas,NOR,Norway,2014,0,0,0
BHS,Bahamas,NOR,Norway,2015,2,0,2
BHS,Bahamas,NOR,Norway,2016,0,1,-1
BHS,Bahamas,NOR,Norway,2017,1,0,1
BHS,Bahamas,POL,Poland,2009,0,0,0
BHS,Bahamas,POL,Poland,2010,0,0,0
BHS,Bahamas,POL,Poland,2011,0,0,0
BHS,Bahamas,POL,Poland,2012,0,0,0
BHS,Bahamas,POL,Poland,2013,1,0,1
BHS,Bahamas,POL,Poland,2014,0,0,0
BHS,Bahamas,POL,Poland,2015,0,0,0
BHS,Bahamas,POL,Poland,2016,0,0,0
BHS,Bahamas,POL,Poland,2017,0,0,0
BHS,Bahamas,SVK,Slovak Republic,2008,0,0,0
BHS,Bahamas,SVK,Slovak Republic,2010,1,0,1
BHS,Bahamas,ESP,Spain,2008,1,1,0
BHS,Bahamas,ESP,Spain,2009,0,2,-2
BHS,Bahamas,ESP,Spain,2010,2,5,-3
BHS,Bahamas,ESP,Spain,2011,1,1,0
BHS,Bahamas,ESP,Spain,2012,3,0,3
BHS,Bahamas,ESP,Spain,2013,5,0,5
BHS,Bahamas,ESP,Spain,2014,2,2,0
BHS,Bahamas,ESP,Spain,2015,7,2,5
BHS,Bahamas,ESP,Spain,2016,4,0,4
BHS,Bahamas,ESP,Spain,2017,4,3,1
BHS,Bahamas,SWE,Sweden,2008,1,1,0
BHS,Bahamas,SWE,Sweden,2009,1,0,1
BHS,Bahamas,SWE,Sweden,2010,2,1,1
BHS,Bahamas,SWE,Sweden,2011,0,1,-1
BHS,Bahamas,SWE,Sweden,2012,4,2,2
BHS,Bahamas,SWE,Sweden,2013,0,4,-4
BHS,Bahamas,SWE,Sweden,2014,1,0,1
BHS,Bahamas,SWE,Sweden,2015,0,0,0
BHS,Bahamas,SWE,Sweden,2016,2,0,2
BHS,Bahamas,SWE,Sweden,2017,0,0,0
BHS,Bahamas,CHE,Switzerland,2010,0,2,-2
BHS,Bahamas,CHE,Switzerland,2011,5,3,2
BHS,Bahamas,CHE,Switzerland,2012,2,2,0
BHS,Bahamas,CHE,Switzerland,2013,4,2,2
BHS,Bahamas,CHE,Switzerland,2014,3,3,0
BHS,Bahamas,CHE,Switzerland,2015,2,3,-1
BHS,Bahamas,CHE,Switzerland,2016,2,0,2
BHS,Bahamas,CHE,Switzerland,2017,2,1,1
BHS,Bahamas,TUR,Turkey,2010,1,0,1
BHS,Bahamas,USA,United States,2008,682,0,682
BHS,Bahamas,USA,United States,2009,751,0,751
BHS,Bahamas,USA,United States,2010,652,0,652
BHS,Bahamas,USA,United States,2011,668,0,668
BHS,Bahamas,USA,United States,2012,619,0,619
BHS,Bahamas,USA,United States,2013,630,0,630
BHS,Bahamas,USA,United States,2014,654,0,654
BHS,Bahamas,USA,United States,2015,725,0,725
BHS,Bahamas,USA,United States,2016,656,0,656
BHS,Bahamas,USA,United States,2017,725,0,725
BHS,Bahamas,CHL,Chile,2008,1,0,1
BHS,Bahamas,CHL,Chile,2009,0,0,0
BHS,Bahamas,CHL,Chile,2010,0,0,0
BHS,Bahamas,CHL,Chile,2011,0,0,0
BHS,Bahamas,CHL,Chile,2012,0,0,0
BHS,Bahamas,CHL,Chile,2013,0,0,0
BHS,Bahamas,CHL,Chile,2014,5,0,5
BHS,Bahamas,CHL,Chile,2015,0,0,0
BHS,Bahamas,CHL,Chile,2016,1,0,1
BHS,Bahamas,EST,Estonia,2008,0,0,0
BHS,Bahamas,EST,Estonia,2009,0,0,0
BHS,Bahamas,EST,Estonia,2010,0,0,0
BHS,Bahamas,EST,Estonia,2011,0,0,0
BHS,Bahamas,EST,Estonia,2012,0,0,0
BHS,Bahamas,EST,Estonia,2013,0,0,0
BHS,Bahamas,EST,Estonia,2014,0,0,0
BHS,Bahamas,EST,Estonia,2015,0,0,0
BHS,Bahamas,EST,Estonia,2016,0,0,0
BHS,Bahamas,EST,Estonia,2017,0,0,0
BHR,Bahrain,AUS,Australia,2008,10,19,-9
BHR,Bahrain,AUS,Australia,2009,4,15,-11
BHR,Bahrain,AUS,Australia,2010,7,18,-11
BHR,Bahrain,AUS,Australia,2011,6,8,-2
BHR,Bahrain,AUS,Australia,2012,15,15,0
BHR,Bahrain,AUS,Australia,2013,29,13,16
BHR,Bahrain,AUS,Australia,2014,22,19,3
BHR,Bahrain,AUS,Australia,2015,16,0,16
BHR,Bahrain,AUS,Australia,2016,8,0,8
BHR,Bahrain,AUS,Australia,2017,8,0,8
BHR,Bahrain,AUT,Austria,2008,2,0,2
BHR,Bahrain,AUT,Austria,2009,5,0,5
BHR,Bahrain,AUT,Austria,2010,1,1,0
BHR,Bahrain,AUT,Austria,2011,0,1,-1
BHR,Bahrain,AUT,Austria,2012,0,0,0
BHR,Bahrain,AUT,Austria,2013,2,0,2
BHR,Bahrain,AUT,Austria,2014,1,1,0
BHR,Bahrain,AUT,Austria,2015,1,0,1
BHR,Bahrain,AUT,Austria,2016,3,2,1
BHR,Bahrain,AUT,Austria,2017,3,0,3
BHR,Bahrain,BEL,Belgium,2008,1,0,1
BHR,Bahrain,BEL,Belgium,2009,0,0,0
BHR,Bahrain,BEL,Belgium,2010,1,1,0
BHR,Bahrain,BEL,Belgium,2013,5,3,2
BHR,Bahrain,BEL,Belgium,2014,1,1,0
BHR,Bahrain,BEL,Belgium,2015,3,3,0
BHR,Bahrain,BEL,Belgium,2016,2,0,2
BHR,Bahrain,CAN,Canada,2008,9,0,9
BHR,Bahrain,CAN,Canada,2009,35,0,35
BHR,Bahrain,CAN,Canada,2010,28,0,28
BHR,Bahrain,CAN,Canada,2011,21,0,21
BHR,Bahrain,CAN,Canada,2012,39,0,39
BHR,Bahrain,CAN,Canada,2013,32,0,32
BHR,Bahrain,CAN,Canada,2014,25,0,25
BHR,Bahrain,CAN,Canada,2015,33,0,33
BHR,Bahrain,CAN,Canada,2016,20,0,20
BHR,Bahrain,CAN,Canada,2017,35,0,35
BHR,Bahrain,CZE,Czech Republic,2008,7,0,7
BHR,Bahrain,CZE,Czech Republic,2009,8,0,8
BHR,Bahrain,CZE,Czech Republic,2010,1,0,1
BHR,Bahrain,CZE,Czech Republic,2014,1,1,0
BHR,Bahrain,CZE,Czech Republic,2015,3,0,3
BHR,Bahrain,CZE,Czech Republic,2016,2,0,2
BHR,Bahrain,CZE,Czech Republic,2017,2,0,2
BHR,Bahrain,DNK,Denmark,2010,1,0,1
BHR,Bahrain,DNK,Denmark,2011,1,0,1
BHR,Bahrain,DNK,Denmark,2012,1,0,1
BHR,Bahrain,DNK,Denmark,2013,2,0,2
BHR,Bahrain,DNK,Denmark,2014,0,0,0
BHR,Bahrain,DNK,Denmark,2015,1,2,-1
BHR,Bahrain,DNK,Denmark,2016,1,1,0
BHR,Bahrain,DNK,Denmark,2017,2,2,0
BHR,Bahrain,FIN,Finland,2008,0,1,-1
BHR,Bahrain,FIN,Finland,2009,0,0,0
BHR,Bahrain,FIN,Finland,2010,0,0,0
BHR,Bahrain,FIN,Finland,2011,0,0,0
BHR,Bahrain,FIN,Finland,2012,1,0,1
BHR,Bahrain,FIN,Finland,2013,0,0,0
BHR,Bahrain,FIN,Finland,2014,0,0,0
BHR,Bahrain,FIN,Finland,2015,0,0,0
BHR,Bahrain,FIN,Finland,2016,2,0,2
BHR,Bahrain,FIN,Finland,2017,2,1,1
BHR,Bahrain,FRA,France,2008,4,0,4
BHR,Bahrain,FRA,France,2009,3,0,3
BHR,Bahrain,FRA,France,2010,5,0,5
BHR,Bahrain,FRA,France,2011,2,0,2
BHR,Bahrain,FRA,France,2012,2,0,2
BHR,Bahrain,FRA,France,2013,2,0,2
BHR,Bahrain,FRA,France,2014,2,0,2
BHR,Bahrain,FRA,France,2015,3,0,3
BHR,Bahrain,FRA,France,2016,1,0,1
BHR,Bahrain,FRA,France,2017,8,0,8
BHR,Bahrain,DEU,Germany,2008,49,50,-1
BHR,Bahrain,DEU,Germany,2009,79,67,12
BHR,Bahrain,DEU,Germany,2010,89,78,11
BHR,Bahrain,DEU,Germany,2011,53,53,0
BHR,Bahrain,DEU,Germany,2012,103,63,40
BHR,Bahrain,DEU,Germany,2013,126,74,52
BHR,Bahrain,DEU,Germany,2014,149,84,65
BHR,Bahrain,DEU,Germany,2015,213,112,101
BHR,Bahrain,DEU,Germany,2016,181,151,30
BHR,Bahrain,DEU,Germany,2017,101,75,26
BHR,Bahrain,HUN,Hungary,2008,0,0,0
BHR,Bahrain,HUN,Hungary,2009,0,0,0
BHR,Bahrain,HUN,Hungary,2010,0,0,0
BHR,Bahrain,HUN,Hungary,2011,3,0,3
BHR,Bahrain,HUN,Hungary,2012,1,0,1
BHR,Bahrain,HUN,Hungary,2013,0,0,0
BHR,Bahrain,HUN,Hungary,2014,0,0,0
BHR,Bahrain,HUN,Hungary,2015,1,0,1
BHR,Bahrain,HUN,Hungary,2016,10,0,10
BHR,Bahrain,HUN,Hungary,2017,8,0,8
BHR,Bahrain,ISL,Iceland,2008,0,0,0
BHR,Bahrain,ISL,Iceland,2009,0,0,0
BHR,Bahrain,ISL,Iceland,2010,0,0,0
BHR,Bahrain,ISL,Iceland,2011,0,0,0
BHR,Bahrain,ISL,Iceland,2012,0,1,-1
BHR,Bahrain,ISL,Iceland,2016,0,0,0
BHR,Bahrain,ISL,Iceland,2017,0,0,0
BHR,Bahrain,ITA,Italy,2008,2,0,2
BHR,Bahrain,ITA,Italy,2009,2,0,2
BHR,Bahrain,ITA,Italy,2010,2,0,2
BHR,Bahrain,ITA,Italy,2011,1,2,-1
BHR,Bahrain,ITA,Italy,2012,4,0,4
BHR,Bahrain,ITA,Italy,2013,5,1,4
BHR,Bahrain,ITA,Italy,2015,7,0,7
BHR,Bahrain,JPN,Japan,2008,61,58,3
BHR,Bahrain,JPN,Japan,2009,21,15,6
BHR,Bahrain,JPN,Japan,2010,27,23,4
BHR,Bahrain,JPN,Japan,2011,38,36,2
BHR,Bahrain,JPN,Japan,2012,124,126,-2
BHR,Bahrain,JPN,Japan,2013,94,86,8
BHR,Bahrain,JPN,Japan,2014,49,42,7
BHR,Bahrain,JPN,Japan,2015,62,61,1
BHR,Bahrain,JPN,Japan,2016,59,42,17
BHR,Bahrain,JPN,Japan,2017,58,53,5
BHR,Bahrain,KOR,Korea,2008,8,0,8
BHR,Bahrain,KOR,Korea,2009,3,12,-9
BHR,Bahrain,KOR,Korea,2010,3,2,1
BHR,Bahrain,KOR,Korea,2011,3,4,-1
BHR,Bahrain,KOR,Korea,2012,4,3,1
BHR,Bahrain,KOR,Korea,2013,1,0,1
BHR,Bahrain,KOR,Korea,2014,2,1,1
BHR,Bahrain,KOR,Korea,2015,7,5,2
BHR,Bahrain,KOR,Korea,2016,6,4,2
BHR,Bahrain,KOR,Korea,2017,5,5,0
BHR,Bahrain,LUX,Luxembourg,2008,0,0,0
BHR,Bahrain,LUX,Luxembourg,2009,0,0,0
BHR,Bahrain,LUX,Luxembourg,2010,0,0,0
BHR,Bahrain,LUX,Luxembourg,2011,0,0,0
BHR,Bahrain,LUX,Luxembourg,2012,0,0,0
BHR,Bahrain,LUX,Luxembourg,2013,0,0,0
BHR,Bahrain,LUX,Luxembourg,2014,0,0,0
BHR,Bahrain,LUX,Luxembourg,2015,0,0,0
BHR,Bahrain,LUX,Luxembourg,2016,0,0,0
BHR,Bahrain,LUX,Luxembourg,2017,0,0,0
BHR,Bahrain,MEX,Mexico,2012,0,0,0
BHR,Bahrain,MEX,Mexico,2013,0,0,0
BHR,Bahrain,MEX,Mexico,2014,0,0,0
BHR,Bahrain,MEX,Mexico,2017,1,0,1
BHR,Bahrain,NLD,Netherlands,2010,1,0,1
BHR,Bahrain,NLD,Netherlands,2011,5,1,4
BHR,Bahrain,NLD,Netherlands,2012,6,4,2
BHR,Bahrain,NLD,Netherlands,2013,2,4,-2
BHR,Bahrain,NLD,Netherlands,2014,2,1,1
BHR,Bahrain,NLD,Netherlands,2015,13,7,6
BHR,Bahrain,NLD,Netherlands,2016,10,5,5
BHR,Bahrain,NLD,Netherlands,2017,10,3,7
BHR,Bahrain,NZL,New Zealand,2008,15,3,12
BHR,Bahrain,NZL,New Zealand,2009,11,5,6
BHR,Bahrain,NZL,New Zealand,2010,7,4,3
BHR,Bahrain,NZL,New Zealand,2011,8,5,3
BHR,Bahrain,NZL,New Zealand,2012,12,4,8
BHR,Bahrain,NZL,New Zealand,2013,8,14,-6
BHR,Bahrain,NZL,New Zealand,2014,5,0,5
BHR,Bahrain,NZL,New Zealand,2015,2,0,2
BHR,Bahrain,NZL,New Zealand,2016,2,0,2
BHR,Bahrain,NZL,New Zealand,2017,1,0,1
BHR,Bahrain,NOR,Norway,2008,0,3,-3
BHR,Bahrain,NOR,Norway,2009,0,0,0
BHR,Bahrain,NOR,Norway,2010,1,0,1
BHR,Bahrain,NOR,Norway,2011,1,1,0
BHR,Bahrain,NOR,Norway,2012,0,0,0
BHR,Bahrain,NOR,Norway,2013,0,0,0
BHR,Bahrain,NOR,Norway,2014,0,0,0
BHR,Bahrain,NOR,Norway,2015,1,0,1
BHR,Bahrain,NOR,Norway,2016,2,0,2
BHR,Bahrain,NOR,Norway,2017,0,1,-1
BHR,Bahrain,POL,Poland,2009,0,0,0
BHR,Bahrain,POL,Poland,2010,1,0,1
BHR,Bahrain,POL,Poland,2011,0,0,0
BHR,Bahrain,POL,Poland,2012,0,0,0
BHR,Bahrain,POL,Poland,2013,1,0,1
BHR,Bahrain,POL,Poland,2014,0,0,0
BHR,Bahrain,POL,Poland,2015,1,0,1
BHR,Bahrain,POL,Poland,2016,9,0,9
BHR,Bahrain,POL,Poland,2017,5,0,5
BHR,Bahrain,SVK,Slovak Republic,2008,1,0,1
BHR,Bahrain,SVK,Slovak Republic,2010,1,0,1
BHR,Bahrain,ESP,Spain,2008,1,0,1
BHR,Bahrain,ESP,Spain,2009,0,1,-1
BHR,Bahrain,ESP,Spain,2010,1,0,1
BHR,Bahrain,ESP,Spain,2011,5,0,5
BHR,Bahrain,ESP,Spain,2012,5,0,5
BHR,Bahrain,ESP,Spain,2013,2,0,2
BHR,Bahrain,ESP,Spain,2014,4,0,4
BHR,Bahrain,ESP,Spain,2015,5,2,3
BHR,Bahrain,ESP,Spain,2016,11,1,10
BHR,Bahrain,ESP,Spain,2017,15,8,7
BHR,Bahrain,SWE,Sweden,2008,3,1,2
BHR,Bahrain,SWE,Sweden,2009,1,1,0
BHR,Bahrain,SWE,Sweden,2010,1,1,0
BHR,Bahrain,SWE,Sweden,2011,6,0,6
BHR,Bahrain,SWE,Sweden,2012,3,3,0
BHR,Bahrain,SWE,Sweden,2013,11,7,4
BHR,Bahrain,SWE,Sweden,2014,11,8,3
BHR,Bahrain,SWE,Sweden,2015,0,4,-4
BHR,Bahrain,SWE,Sweden,2016,4,0,4
BHR,Bahrain,SWE,Sweden,2017,4,6,-2
BHR,Bahrain,CHE,Switzerland,2010,8,7,1
BHR,Bahrain,CHE,Switzerland,2011,8,3,5
BHR,Bahrain,CHE,Switzerland,2012,13,13,0
BHR,Bahrain,CHE,Switzerland,2013,11,12,-1
BHR,Bahrain,CHE,Switzerland,2014,5,7,-2
BHR,Bahrain,CHE,Switzerland,2015,15,5,10
BHR,Bahrain,CHE,Switzerland,2016,13,7,6
BHR,Bahrain,CHE,Switzerland,2017,10,10,0
BHR,Bahrain,TUR,Turkey,2010,1,0,1
BHR,Bahrain,GBR,United Kingdom,2015,1000,0,1000
BHR,Bahrain,USA,United States,2008,96,0,96
BHR,Bahrain,USA,United States,2009,120,0,120
BHR,Bahrain,USA,United States,2010,104,0,104
BHR,Bahrain,USA,United States,2011,119,0,119
BHR,Bahrain,USA,United States,2012,104,0,104
BHR,Bahrain,USA,United States,2013,115,0,115
BHR,Bahrain,USA,United States,2014,122,0,122
BHR,Bahrain,USA,United States,2015,145,0,145
BHR,Bahrain,USA,United States,2016,138,0,138
BHR,Bahrain,USA,United States,2017,130,0,130
BHR,Bahrain,CHL,Chile,2008,0,0,0
BHR,Bahrain,CHL,Chile,2009,0,0,0
BHR,Bahrain,CHL,Chile,2010,0,0,0
BHR,Bahrain,CHL,Chile,2011,0,0,0
BHR,Bahrain,CHL,Chile,2012,0,0,0
BHR,Bahrain,CHL,Chile,2013,0,0,0
BHR,Bahrain,CHL,Chile,2014,0,0,0
BHR,Bahrain,CHL,Chile,2015,0,0,0
BHR,Bahrain,CHL,Chile,2016,0,0,0
BHR,Bahrain,EST,Estonia,2008,0,0,0
BHR,Bahrain,EST,Estonia,2009,0,0,0
BHR,Bahrain,EST,Estonia,2010,0,0,0
BHR,Bahrain,EST,Estonia,2011,0,0,0
BHR,Bahrain,EST,Estonia,2012,0,0,0
BHR,Bahrain,EST,Estonia,2013,0,0,0
BHR,Bahrain,EST,Estonia,2014,0,0,0
BHR,Bahrain,EST,Estonia,2015,0,0,0
BHR,Bahrain,EST,Estonia,2016,0,0,0
BHR,Bahrain,EST,Estonia,2017,0,0,0
BHR,Bahrain,SVN,Slovenia,2016,1,0,1
BHR,Bahrain,SVN,Slovenia,2017,1,0,1
BGD,Bangladesh,AUS,Australia,2008,2805,143,2662
BGD,Bangladesh,AUS,Australia,2009,2180,173,2007
BGD,Bangladesh,AUS,Australia,2010,2075,159,1916
BGD,Bangladesh,AUS,Australia,2011,2276,221,2055
BGD,Bangladesh,AUS,Australia,2012,2489,140,2349
BGD,Bangladesh,AUS,Australia,2013,2834,171,2663
BGD,Bangladesh,AUS,Australia,2014,2696,193,2503
BGD,Bangladesh,AUS,Australia,2015,3426,200,3226
BGD,Bangladesh,AUS,Australia,2016,3118,200,2918
BGD,Bangladesh,AUS,Australia,2017,2604,0,2604
BGD,Bangladesh,AUT,Austria,2008,137,99,38
BGD,Bangladesh,AUT,Austria,2009,145,79,66
BGD,Bangladesh,AUT,Austria,2010,146,90,56
BGD,Bangladesh,AUT,Austria,2011,168,91,77
BGD,Bangladesh,AUT,Austria,2012,257,85,172
BGD,Bangladesh,AUT,Austria,2013,230,78,152
BGD,Bangladesh,AUT,Austria,2014,230,82,148
BGD,Bangladesh,AUT,Austria,2015,361,78,283
BGD,Bangladesh,AUT,Austria,2016,347,119,228
BGD,Bangladesh,AUT,Austria,2017,232,114,118
BGD,Bangladesh,BEL,Belgium,2008,108,0,108
BGD,Bangladesh,BEL,Belgium,2009,146,0,146
BGD,Bangladesh,BEL,Belgium,2010,153,50,103
BGD,Bangladesh,BEL,Belgium,2011,160,0,160
BGD,Bangladesh,BEL,Belgium,2012,521,270,251
BGD,Bangladesh,BEL,Belgium,2013,312,331,-19
BGD,Bangladesh,BEL,Belgium,2014,139,390,-251
BGD,Bangladesh,BEL,Belgium,2015,183,270,-87
BGD,Bangladesh,BEL,Belgium,2016,191,142,49
BGD,Bangladesh,BEL,Belgium,2017,173,91,82
BGD,Bangladesh,CAN,Canada,2008,2939,0,2939
BGD,Bangladesh,CAN,Canada,2009,2104,0,2104
BGD,Bangladesh,CAN,Canada,2010,4721,0,4721
BGD,Bangladesh,CAN,Canada,2011,2694,0,2694
BGD,Bangladesh,CAN,Canada,2012,2630,0,2630
BGD,Bangladesh,CAN,Canada,2013,3792,0,3792
BGD,Bangladesh,CAN,Canada,2014,2233,0,2233
BGD,Bangladesh,CAN,Canada,2015,3304,0,3304
BGD,Bangladesh,CAN,Canada,2016,3230,0,3230
BGD,Bangladesh,CAN,Canada,2017,3185,0,3185
BGD,Bangladesh,CZE,Czech Republic,2008,15,0,15
BGD,Bangladesh,CZE,Czech Republic,2009,44,1,43
BGD,Bangladesh,CZE,Czech Republic,2010,29,0,29
BGD,Bangladesh,CZE,Czech Republic,2011,6,0,6
BGD,Bangladesh,CZE,Czech Republic,2012,14,3,11
BGD,Bangladesh,CZE,Czech Republic,2013,15,15,0
BGD,Bangladesh,CZE,Czech Republic,2014,31,8,23
BGD,Bangladesh,CZE,Czech Republic,2015,24,16,8
BGD,Bangladesh,CZE,Czech Republic,2016,65,14,51
BGD,Bangladesh,CZE,Czech Republic,2017,141,19,122
BGD,Bangladesh,DNK,Denmark,2008,91,14,77
BGD,Bangladesh,DNK,Denmark,2009,112,20,92
BGD,Bangladesh,DNK,Denmark,2010,171,27,144
BGD,Bangladesh,DNK,Denmark,2011,154,61,93
BGD,Bangladesh,DNK,Denmark,2012,150,72,78
BGD,Bangladesh,DNK,Denmark,2013,198,54,144
BGD,Bangladesh,DNK,Denmark,2014,199,54,145
BGD,Bangladesh,DNK,Denmark,2015,186,62,124
BGD,Bangladesh,DNK,Denmark,2016,210,97,113
BGD,Bangladesh,DNK,Denmark,2017,199,129,70
BGD,Bangladesh,FIN,Finland,2008,169,16,153
BGD,Bangladesh,FIN,Finland,2009,182,8,174
BGD,Bangladesh,FIN,Finland,2010,161,8,153
BGD,Bangladesh,FIN,Finland,2011,182,6,176
BGD,Bangladesh,FIN,Finland,2012,154,16,138
BGD,Bangladesh,FIN,Finland,2013,190,24,166
BGD,Bangladesh,FIN,Finland,2014,182,16,166
BGD,Bangladesh,FIN,Finland,2015,225,13,212
BGD,Bangladesh,FIN,Finland,2016,306,28,278
BGD,Bangladesh,FIN,Finland,2017,300,14,286
BGD,Bangladesh,FRA,France,2008,443,0,443
BGD,Bangladesh,FRA,France,2009,667,0,667
BGD,Bangladesh,FRA,France,2010,647,0,647
BGD,Bangladesh,FRA,France,2011,598,0,598
BGD,Bangladesh,FRA,France,2012,804,0,804
BGD,Bangladesh,FRA,France,2013,1212,0,1212
BGD,Bangladesh,FRA,France,2014,1737,0,1737
BGD,Bangladesh,FRA,France,2015,1975,0,1975
BGD,Bangladesh,FRA,France,2016,2521,0,2521
BGD,Bangladesh,FRA,France,2017,2488,0,2488
BGD,Bangladesh,DEU,Germany,2008,458,320,138
BGD,Bangladesh,DEU,Germany,2009,526,382,144
BGD,Bangladesh,DEU,Germany,2010,743,375,368
BGD,Bangladesh,DEU,Germany,2011,999,378,621
BGD,Bangladesh,DEU,Germany,2012,1502,440,1062
BGD,Bangladesh,DEU,Germany,2013,2375,680,1695
BGD,Bangladesh,DEU,Germany,2014,2006,795,1211
BGD,Bangladesh,DEU,Germany,2015,4297,1070,3227
BGD,Bangladesh,DEU,Germany,2016,1936,1979,-43
BGD,Bangladesh,DEU,Germany,2017,1883,1366,517
BGD,Bangladesh,HUN,Hungary,2008,8,0,8
BGD,Bangladesh,HUN,Hungary,2009,24,0,24
BGD,Bangladesh,HUN,Hungary,2010,6,3,3
BGD,Bangladesh,HUN,Hungary,2011,12,7,5
BGD,Bangladesh,HUN,Hungary,2012,6,1,5
BGD,Bangladesh,HUN,Hungary,2013,15,2,13
BGD,Bangladesh,HUN,Hungary,2014,17,0,17
BGD,Bangladesh,HUN,Hungary,2015,13,3,10
BGD,Bangladesh,HUN,Hungary,2016,13,0,13
BGD,Bangladesh,HUN,Hungary,2017,98,0,98
BGD,Bangladesh,ISL,Iceland,2008,1,1,0
BGD,Bangladesh,ISL,Iceland,2009,0,1,-1
BGD,Bangladesh,ISL,Iceland,2010,2,0,2
BGD,Bangladesh,ISL,Iceland,2011,3,2,1
BGD,Bangladesh,ISL,Iceland,2012,2,1,1
BGD,Bangladesh,ISL,Iceland,2013,6,2,4
BGD,Bangladesh,ISL,Iceland,2014,2,7,-5
BGD,Bangladesh,ISL,Iceland,2015,1,2,-1
BGD,Bangladesh,ISL,Iceland,2016,2,2,0
BGD,Bangladesh,ISL,Iceland,2017,3,1,2
BGD,Bangladesh,ITA,Italy,2008,9332,476,8856
BGD,Bangladesh,ITA,Italy,2009,8902,551,8351
BGD,Bangladesh,ITA,Italy,2010,9688,1039,8649
BGD,Bangladesh,ITA,Italy,2011,10348,680,9668
BGD,Bangladesh,ITA,Italy,2012,10144,770,9374
BGD,Bangladesh,ITA,Italy,2013,10487,739,9748
BGD,Bangladesh,ITA,Italy,2014,12673,754,11919
BGD,Bangladesh,ITA,Italy,2015,12443,556,11887
BGD,Bangladesh,ITA,Italy,2016,10733,0,10733
BGD,Bangladesh,ITA,Italy,2017,14551,605,13946
BGD,Bangladesh,JPN,Japan,2008,1584,888,696
BGD,Bangladesh,JPN,Japan,2009,1421,923,498
BGD,Bangladesh,JPN,Japan,2010,1083,870,213
BGD,Bangladesh,JPN,Japan,2011,848,774,74
BGD,Bangladesh,JPN,Japan,2012,1192,740,452
BGD,Bangladesh,JPN,Japan,2013,1237,653,584
BGD,Bangladesh,JPN,Japan,2014,2023,923,1100
BGD,Bangladesh,JPN,Japan,2015,2360,1018,1342
BGD,Bangladesh,JPN,Japan,2016,2755,1095,1660
BGD,Bangladesh,JPN,Japan,2017,2803,990,1813
BGD,Bangladesh,KOR,Korea,2008,2242,3089,-847
BGD,Bangladesh,KOR,Korea,2009,1429,2674,-1245
BGD,Bangladesh,KOR,Korea,2010,2902,1711,1191
BGD,Bangladesh,KOR,Korea,2011,2295,1564,731
BGD,Bangladesh,KOR,Korea,2012,1850,1558,292
BGD,Bangladesh,KOR,Korea,2013,2520,2501,19
BGD,Bangladesh,KOR,Korea,2014,2282,1364,918
BGD,Bangladesh,KOR,Korea,2015,2918,2719,199
BGD,Bangladesh,KOR,Korea,2016,2906,2074,832
BGD,Bangladesh,KOR,Korea,2017,2728,1883,845
BGD,Bangladesh,LUX,Luxembourg,2008,6,0,6
BGD,Bangladesh,LUX,Luxembourg,2009,2,0,2
BGD,Bangladesh,LUX,Luxembourg,2010,7,2,5
BGD,Bangladesh,LUX,Luxembourg,2011,10,2,8
BGD,Bangladesh,LUX,Luxembourg,2012,4,5,-1
BGD,Bangladesh,LUX,Luxembourg,2013,5,3,2
BGD,Bangladesh,LUX,Luxembourg,2014,6,0,6
BGD,Bangladesh,LUX,Luxembourg,2015,12,1,11
BGD,Bangladesh,LUX,Luxembourg,2016,10,3,7
BGD,Bangladesh,LUX,Luxembourg,2017,7,4,3
BGD,Bangladesh,MEX,Mexico,2008,3,0,3
BGD,Bangladesh,MEX,Mexico,2009,6,0,6
BGD,Bangladesh,MEX,Mexico,2010,3,0,3
BGD,Bangladesh,MEX,Mexico,2011,4,0,4
BGD,Bangladesh,MEX,Mexico,2012,5,0,5
BGD,Bangladesh,MEX,Mexico,2013,20,0,20
BGD,Bangladesh,MEX,Mexico,2014,15,0,15
BGD,Bangladesh,MEX,Mexico,2015,11,0,11
BGD,Bangladesh,MEX,Mexico,2016,15,0,15
BGD,Bangladesh,MEX,Mexico,2017,7,0,7
BGD,Bangladesh,NLD,Netherlands,2008,90,53,37
BGD,Bangladesh,NLD,Netherlands,2009,103,31,72
BGD,Bangladesh,NLD,Netherlands,2010,113,53,60
BGD,Bangladesh,NLD,Netherlands,2011,105,67,38
BGD,Bangladesh,NLD,Netherlands,2012,113,66,47
BGD,Bangladesh,NLD,Netherlands,2013,154,95,59
BGD,Bangladesh,NLD,Netherlands,2014,143,88,55
BGD,Bangladesh,NLD,Netherlands,2016,280,112,168
BGD,Bangladesh,NLD,Netherlands,2017,302,175,127
BGD,Bangladesh,NZL,New Zealand,2008,71,27,44
BGD,Bangladesh,NZL,New Zealand,2009,98,20,78
BGD,Bangladesh,NZL,New Zealand,2010,85,25,60
BGD,Bangladesh,NZL,New Zealand,2011,100,36,64
BGD,Bangladesh,NZL,New Zealand,2012,131,21,110
BGD,Bangladesh,NZL,New Zealand,2013,128,10,118
BGD,Bangladesh,NZL,New Zealand,2014,281,24,257
BGD,Bangladesh,NZL,New Zealand,2015,416,23,393
BGD,Bangladesh,NZL,New Zealand,2016,221,19,202
BGD,Bangladesh,NZL,New Zealand,2017,181,64,117
BGD,Bangladesh,NOR,Norway,2008,66,26,40
BGD,Bangladesh,NOR,Norway,2009,87,46,41
BGD,Bangladesh,NOR,Norway,2010,91,52,39
BGD,Bangladesh,NOR,Norway,2011,77,29,48
BGD,Bangladesh,NOR,Norway,2012,110,40,70
BGD,Bangladesh,NOR,Norway,2013,89,47,42
BGD,Bangladesh,NOR,Norway,2014,86,60,26
BGD,Bangladesh,NOR,Norway,2015,96,45,51
BGD,Bangladesh,NOR,Norway,2016,99,71,28
BGD,Bangladesh,NOR,Norway,2017,169,39,130
BGD,Bangladesh,POL,Poland,2008,74,0,74
BGD,Bangladesh,POL,Poland,2009,85,0,85
BGD,Bangladesh,POL,Poland,2010,75,0,75
BGD,Bangladesh,POL,Poland,2011,110,0,110
BGD,Bangladesh,POL,Poland,2012,116,0,116
BGD,Bangladesh,POL,Poland,2013,138,0,138
BGD,Bangladesh,POL,Poland,2014,122,0,122
BGD,Bangladesh,POL,Poland,2015,208,0,208
BGD,Bangladesh,POL,Poland,2016,330,0,330
BGD,Bangladesh,POL,Poland,2017,591,0,591
BGD,Bangladesh,PRT,Portugal,2008,176,0,176
BGD,Bangladesh,PRT,Portugal,2009,218,0,218
BGD,Bangladesh,PRT,Portugal,2010,187,0,187
BGD,Bangladesh,PRT,Portugal,2011,332,0,332
BGD,Bangladesh,PRT,Portugal,2012,299,0,299
BGD,Bangladesh,PRT,Portugal,2013,518,0,518
BGD,Bangladesh,PRT,Portugal,2014,408,0,408
BGD,Bangladesh,PRT,Portugal,2015,657,0,657
BGD,Bangladesh,PRT,Portugal,2016,437,0,437
BGD,Bangladesh,PRT,Portugal,2017,737,0,737
BGD,Bangladesh,SVK,Slovak Republic,2008,1,2,-1
BGD,Bangladesh,SVK,Slovak Republic,2009,1,3,-2
BGD,Bangladesh,SVK,Slovak Republic,2010,1,2,-1
BGD,Bangladesh,SVK,Slovak Republic,2011,12,0,12
BGD,Bangladesh,SVK,Slovak Republic,2012,1,0,1
BGD,Bangladesh,SVK,Slovak Republic,2014,2,1,1
BGD,Bangladesh,SVK,Slovak Republic,2017,1,0,1
BGD,Bangladesh,ESP,Spain,2008,1616,437,1179
BGD,Bangladesh,ESP,Spain,2009,1673,751,922
BGD,Bangladesh,ESP,Spain,2010,1409,1071,338
BGD,Bangladesh,ESP,Spain,2011,1559,1652,-93
BGD,Bangladesh,ESP,Spain,2012,1892,2050,-158
BGD,Bangladesh,ESP,Spain,2013,1343,2141,-798
BGD,Bangladesh,ESP,Spain,2014,1024,1399,-375
BGD,Bangladesh,ESP,Spain,2015,1277,975,302
BGD,Bangladesh,ESP,Spain,2016,1673,830,843
BGD,Bangladesh,ESP,Spain,2017,2039,698,1341
BGD,Bangladesh,SWE,Sweden,2008,500,95,405
BGD,Bangladesh,SWE,Sweden,2009,712,76,636
BGD,Bangladesh,SWE,Sweden,2010,957,134,823
BGD,Bangladesh,SWE,Sweden,2011,417,162,255
BGD,Bangladesh,SWE,Sweden,2012,430,238,192
BGD,Bangladesh,SWE,Sweden,2013,374,194,180
BGD,Bangladesh,SWE,Sweden,2014,478,214,264
BGD,Bangladesh,SWE,Sweden,2015,551,330,221
BGD,Bangladesh,SWE,Sweden,2016,594,128,466
BGD,Bangladesh,SWE,Sweden,2017,1004,132,872
BGD,Bangladesh,CHE,Switzerland,2010,99,29,70
BGD,Bangladesh,CHE,Switzerland,2011,104,39,65
BGD,Bangladesh,CHE,Switzerland,2012,139,26,113
BGD,Bangladesh,CHE,Switzerland,2013,114,23,91
BGD,Bangladesh,CHE,Switzerland,2014,88,28,60
BGD,Bangladesh,CHE,Switzerland,2015,135,29,106
BGD,Bangladesh,CHE,Switzerland,2016,108,22,86
BGD,Bangladesh,CHE,Switzerland,2017,101,28,73
BGD,Bangladesh,TUR,Turkey,2010,21,0,21
BGD,Bangladesh,TUR,Turkey,2016,187,95,92
BGD,Bangladesh,TUR,Turkey,2017,273,113,160
BGD,Bangladesh,GBR,United Kingdom,2008,6000,0,6000
BGD,Bangladesh,GBR,United Kingdom,2009,13000,0,13000
BGD,Bangladesh,GBR,United Kingdom,2010,9000,0,9000
BGD,Bangladesh,GBR,United Kingdom,2011,9000,1000,8000
BGD,Bangladesh,GBR,United Kingdom,2012,2000,1000,1000
BGD,Bangladesh,GBR,United Kingdom,2013,3000,1000,2000
BGD,Bangladesh,GBR,United Kingdom,2014,5000,0,5000
BGD,Bangladesh,GBR,United Kingdom,2015,2000,1000,1000
BGD,Bangladesh,USA,United States,2008,11753,0,11753
BGD,Bangladesh,USA,United States,2009,16651,0,16651
BGD,Bangladesh,USA,United States,2010,14819,0,14819
BGD,Bangladesh,USA,United States,2011,16707,0,16707
BGD,Bangladesh,USA,United States,2012,14705,0,14705
BGD,Bangladesh,USA,United States,2013,12099,0,12099
BGD,Bangladesh,USA,United States,2014,14645,0,14645
BGD,Bangladesh,USA,United States,2015,13570,0,13570
BGD,Bangladesh,USA,United States,2016,18723,0,18723
BGD,Bangladesh,USA,United States,2017,14693,0,14693
BGD,Bangladesh,CHL,Chile,2008,4,0,4
BGD,Bangladesh,CHL,Chile,2009,4,0,4
BGD,Bangladesh,CHL,Chile,2010,2,0,2
BGD,Bangladesh,CHL,Chile,2011,2,0,2
BGD,Bangladesh,CHL,Chile,2012,0,0,0
BGD,Bangladesh,CHL,Chile,2013,1,0,1
BGD,Bangladesh,CHL,Chile,2014,4,0,4
BGD,Bangladesh,CHL,Chile,2015,5,0,5
BGD,Bangladesh,CHL,Chile,2016,14,0,14
BGD,Bangladesh,EST,Estonia,2008,2,0,2
BGD,Bangladesh,EST,Estonia,2009,2,0,2
BGD,Bangladesh,EST,Estonia,2010,6,0,6
BGD,Bangladesh,EST,Estonia,2011,2,0,2
BGD,Bangladesh,EST,Estonia,2012,1,0,1
BGD,Bangladesh,EST,Estonia,2013,4,0,4
BGD,Bangladesh,EST,Estonia,2014,0,0,0
BGD,Bangladesh,EST,Estonia,2015,35,0,35
BGD,Bangladesh,EST,Estonia,2016,49,0,49
BGD,Bangladesh,EST,Estonia,2017,72,0,72
BGD,Bangladesh,SVN,Slovenia,2008,1,0,1
BGD,Bangladesh,SVN,Slovenia,2009,1,0,1
BGD,Bangladesh,SVN,Slovenia,2010,1,0,1
BGD,Bangladesh,SVN,Slovenia,2011,2,2,0
BGD,Bangladesh,SVN,Slovenia,2012,5,0,5
BGD,Bangladesh,SVN,Slovenia,2013,4,0,4
BGD,Bangladesh,SVN,Slovenia,2015,6,0,6
BGD,Bangladesh,SVN,Slovenia,2016,6,0,6
BGD,Bangladesh,SVN,Slovenia,2017,10,2,8
BRB,Barbados,AUS,Australia,2008,2,0,2
BRB,Barbados,AUS,Australia,2009,1,0,1
BRB,Barbados,AUS,Australia,2010,1,0,1
BRB,Barbados,AUS,Australia,2011,6,0,6
BRB,Barbados,AUS,Australia,2012,0,0,0
BRB,Barbados,AUS,Australia,2013,4,0,4
BRB,Barbados,AUS,Australia,2014,0,7,-7
BRB,Barbados,AUS,Australia,2015,6,0,6
BRB,Barbados,AUS,Australia,2016,5,0,5
BRB,Barbados,AUS,Australia,2017,6,0,6
BRB,Barbados,AUT,Austria,2008,2,4,-2
BRB,Barbados,AUT,Austria,2009,0,1,-1
BRB,Barbados,AUT,Austria,2010,3,2,1
BRB,Barbados,AUT,Austria,2011,2,0,2
BRB,Barbados,AUT,Austria,2012,2,0,2
BRB,Barbados,AUT,Austria,2013,0,0,0
BRB,Barbados,AUT,Austria,2014,0,2,-2
BRB,Barbados,AUT,Austria,2015,0,0,0
BRB,Barbados,AUT,Austria,2016,0,0,0
BRB,Barbados,AUT,Austria,2017,1,1,0
BRB,Barbados,BEL,Belgium,2008,1,0,1
BRB,Barbados,BEL,Belgium,2009,0,0,0
BRB,Barbados,BEL,Belgium,2010,0,1,-1
BRB,Barbados,BEL,Belgium,2015,1,2,-1
BRB,Barbados,BEL,Belgium,2016,2,0,2
BRB,Barbados,BEL,Belgium,2017,1,0,1
BRB,Barbados,CAN,Canada,2008,134,0,134
BRB,Barbados,CAN,Canada,2009,125,0,125
BRB,Barbados,CAN,Canada,2010,121,0,121
BRB,Barbados,CAN,Canada,2011,97,0,97
BRB,Barbados,CAN,Canada,2012,132,0,132
BRB,Barbados,CAN,Canada,2013,97,0,97
BRB,Barbados,CAN,Canada,2014,133,0,133
BRB,Barbados,CAN,Canada,2015,140,0,140
BRB,Barbados,CAN,Canada,2016,140,0,140
BRB,Barbados,CAN,Canada,2017,205,0,205
BRB,Barbados,CZE,Czech Republic,2009,1,0,1
BRB,Barbados,CZE,Czech Republic,2011,1,0,1
BRB,Barbados,DNK,Denmark,2008,0,0,0
BRB,Barbados,DNK,Denmark,2009,1,2,-1
BRB,Barbados,DNK,Denmark,2011,1,1,0
BRB,Barbados,DNK,Denmark,2012,1,0,1
BRB,Barbados,DNK,Denmark,2013,1,0,1
BRB,Barbados,DNK,Denmark,2014,1,0,1
BRB,Barbados,DNK,Denmark,2015,2,0,2
BRB,Barbados,DNK,Denmark,2016,2,1,1
BRB,Barbados,DNK,Denmark,2017,0,0,0
BRB,Barbados,FIN,Finland,2008,2,0,2
BRB,Barbados,FIN,Finland,2009,0,0,0
BRB,Barbados,FIN,Finland,2010,0,0,0
BRB,Barbados,FIN,Finland,2011,0,0,0
BRB,Barbados,FIN,Finland,2012,0,1,-1
BRB,Barbados,FIN,Finland,2013,0,0,0
BRB,Barbados,FIN,Finland,2014,0,0,0
BRB,Barbados,FIN,Finland,2015,2,0,2
BRB,Barbados,FIN,Finland,2016,1,0,1
BRB,Barbados,FIN,Finland,2017,0,0,0
BRB,Barbados,FRA,France,2008,2,0,2
BRB,Barbados,FRA,France,2009,4,0,4
BRB,Barbados,FRA,France,2010,0,0,0
BRB,Barbados,FRA,France,2011,4,0,4
BRB,Barbados,FRA,France,2012,5,0,5
BRB,Barbados,FRA,France,2013,3,0,3
BRB,Barbados,FRA,France,2014,16,0,16
BRB,Barbados,FRA,France,2015,11,0,11
BRB,Barbados,FRA,France,2016,12,0,12
BRB,Barbados,FRA,France,2017,13,0,13
BRB,Barbados,DEU,Germany,2008,8,13,-5
BRB,Barbados,DEU,Germany,2009,9,16,-7
BRB,Barbados,DEU,Germany,2010,5,9,-4
BRB,Barbados,DEU,Germany,2011,8,2,6
BRB,Barbados,DEU,Germany,2012,11,5,6
BRB,Barbados,DEU,Germany,2013,16,7,9
BRB,Barbados,DEU,Germany,2014,14,12,2
BRB,Barbados,DEU,Germany,2015,14,6,8
BRB,Barbados,DEU,Germany,2016,12,4,8
BRB,Barbados,DEU,Germany,2017,13,7,6
BRB,Barbados,HUN,Hungary,2008,1,0,1
BRB,Barbados,HUN,Hungary,2009,0,0,0
BRB,Barbados,HUN,Hungary,2010,0,0,0
BRB,Barbados,HUN,Hungary,2011,0,0,0
BRB,Barbados,HUN,Hungary,2012,0,0,0
BRB,Barbados,HUN,Hungary,2013,0,0,0
BRB,Barbados,HUN,Hungary,2014,0,0,0
BRB,Barbados,HUN,Hungary,2015,0,0,0
BRB,Barbados,HUN,Hungary,2016,0,0,0
BRB,Barbados,HUN,Hungary,2017,0,0,0
BRB,Barbados,ISL,Iceland,2008,0,0,0
BRB,Barbados,ISL,Iceland,2009,1,0,1
BRB,Barbados,ISL,Iceland,2010,1,1,0
BRB,Barbados,ISL,Iceland,2011,0,0,0
BRB,Barbados,ISL,Iceland,2012,0,0,0
BRB,Barbados,ISL,Iceland,2013,0,1,-1
BRB,Barbados,ISL,Iceland,2014,0,0,0
BRB,Barbados,ISL,Iceland,2015,0,0,0
BRB,Barbados,ISL,Iceland,2016,0,0,0
BRB,Barbados,ISL,Iceland,2017,0,0,0
BRB,Barbados,ITA,Italy,2008,5,1,4
BRB,Barbados,ITA,Italy,2009,0,1,-1
BRB,Barbados,ITA,Italy,2010,1,0,1
BRB,Barbados,ITA,Italy,2011,1,0,1
BRB,Barbados,ITA,Italy,2012,0,0,0
BRB,Barbados,ITA,Italy,2013,1,0,1
BRB,Barbados,ITA,Italy,2015,1,1,0
BRB,Barbados,ITA,Italy,2016,3,0,3
BRB,Barbados,ITA,Italy,2017,1,0,1
BRB,Barbados,JPN,Japan,2008,13,12,1
BRB,Barbados,JPN,Japan,2009,8,7,1
BRB,Barbados,JPN,Japan,2010,9,10,-1
BRB,Barbados,JPN,Japan,2011,12,9,3
BRB,Barbados,JPN,Japan,2012,10,10,0
BRB,Barbados,JPN,Japan,2013,12,14,-2
BRB,Barbados,JPN,Japan,2014,7,4,3
BRB,Barbados,JPN,Japan,2015,10,7,3
BRB,Barbados,JPN,Japan,2016,11,5,6
BRB,Barbados,JPN,Japan,2017,10,4,6
BRB,Barbados,KOR,Korea,2008,0,0,0
BRB,Barbados,KOR,Korea,2009,3,1,2
BRB,Barbados,KOR,Korea,2010,1,1,0
BRB,Barbados,KOR,Korea,2011,2,2,0
BRB,Barbados,KOR,Korea,2012,1,0,1
BRB,Barbados,KOR,Korea,2013,1,2,-1
BRB,Barbados,KOR,Korea,2014,3,1,2
BRB,Barbados,KOR,Korea,2015,2,3,-1
BRB,Barbados,KOR,Korea,2016,1,0,1
BRB,Barbados,KOR,Korea,2017,4,1,3
BRB,Barbados,LUX,Luxembourg,2008,0,0,0
BRB,Barbados,LUX,Luxembourg,2009,0,0,0
BRB,Barbados,LUX,Luxembourg,2010,0,0,0
BRB,Barbados,LUX,Luxembourg,2011,1,0,1
BRB,Barbados,LUX,Luxembourg,2012,0,0,0
BRB,Barbados,LUX,Luxembourg,2013,0,0,0
BRB,Barbados,LUX,Luxembourg,2014,0,0,0
BRB,Barbados,LUX,Luxembourg,2015,1,0,1
BRB,Barbados,LUX,Luxembourg,2016,1,0,1
BRB,Barbados,LUX,Luxembourg,2017,0,1,-1
BRB,Barbados,MEX,Mexico,2012,1,0,1
BRB,Barbados,MEX,Mexico,2013,1,0,1
BRB,Barbados,MEX,Mexico,2014,0,0,0
BRB,Barbados,MEX,Mexico,2017,1,0,1
BRB,Barbados,NLD,Netherlands,2008,0,3,-3
BRB,Barbados,NLD,Netherlands,2009,1,0,1
BRB,Barbados,NLD,Netherlands,2010,1,2,-1
BRB,Barbados,NLD,Netherlands,2011,3,1,2
BRB,Barbados,NLD,Netherlands,2012,6,4,2
BRB,Barbados,NLD,Netherlands,2013,5,2,3
BRB,Barbados,NLD,Netherlands,2015,3,0,3
BRB,Barbados,NLD,Netherlands,2016,7,1,6
BRB,Barbados,NLD,Netherlands,2017,4,3,1
BRB,Barbados,NZL,New Zealand,2008,3,0,3
BRB,Barbados,NZL,New Zealand,2010,3,1,2
BRB,Barbados,NZL,New Zealand,2012,4,0,4
BRB,Barbados,NZL,New Zealand,2013,4,0,4
BRB,Barbados,NZL,New Zealand,2014,1,0,1
BRB,Barbados,NZL,New Zealand,2015,4,3,1
BRB,Barbados,NZL,New Zealand,2016,3,0,3
BRB,Barbados,NZL,New Zealand,2017,2,1,1
BRB,Barbados,NOR,Norway,2008,0,0,0
BRB,Barbados,NOR,Norway,2009,0,1,-1
BRB,Barbados,NOR,Norway,2010,1,0,1
BRB,Barbados,NOR,Norway,2011,1,0,1
BRB,Barbados,NOR,Norway,2012,0,0,0
BRB,Barbados,NOR,Norway,2013,0,0,0
BRB,Barbados,NOR,Norway,2014,2,1,1
BRB,Barbados,NOR,Norway,2015,0,0,0
BRB,Barbados,NOR,Norway,2016,3,1,2
BRB,Barbados,NOR,Norway,2017,0,0,0
BRB,Barbados,POL,Poland,2009,1,0,1
BRB,Barbados,POL,Poland,2010,0,0,0
BRB,Barbados,POL,Poland,2011,0,0,0
BRB,Barbados,POL,Poland,2012,0,0,0
BRB,Barbados,POL,Poland,2013,0,0,0
BRB,Barbados,POL,Poland,2014,0,0,0
BRB,Barbados,POL,Poland,2015,0,0,0
BRB,Barbados,POL,Poland,2016,0,0,0
BRB,Barbados,POL,Poland,2017,0,0,0
BRB,Barbados,SVK,Slovak Republic,2008,0,0,0
BRB,Barbados,ESP,Spain,2008,0,1,-1
BRB,Barbados,ESP,Spain,2009,3,0,3
BRB,Barbados,ESP,Spain,2010,1,2,-1
BRB,Barbados,ESP,Spain,2011,2,4,-2
BRB,Barbados,ESP,Spain,2012,3,0,3
BRB,Barbados,ESP,Spain,2013,4,0,4
BRB,Barbados,ESP,Spain,2014,3,1,2
BRB,Barbados,ESP,Spain,2015,4,1,3
BRB,Barbados,ESP,Spain,2016,3,2,1
BRB,Barbados,ESP,Spain,2017,4,2,2
BRB,Barbados,SWE,Sweden,2008,3,0,3
BRB,Barbados,SWE,Sweden,2009,3,4,-1
BRB,Barbados,SWE,Sweden,2010,0,1,-1
BRB,Barbados,SWE,Sweden,2011,3,0,3
BRB,Barbados,SWE,Sweden,2012,1,0,1
BRB,Barbados,SWE,Sweden,2013,0,2,-2
BRB,Barbados,SWE,Sweden,2014,1,1,0
BRB,Barbados,SWE,Sweden,2015,2,1,1
BRB,Barbados,SWE,Sweden,2016,5,0,5
BRB,Barbados,SWE,Sweden,2017,2,1,1
BRB,Barbados,CHE,Switzerland,2010,3,0,3
BRB,Barbados,CHE,Switzerland,2011,6,2,4
BRB,Barbados,CHE,Switzerland,2012,4,3,1
BRB,Barbados,CHE,Switzerland,2013,1,1,0
BRB,Barbados,CHE,Switzerland,2014,1,0,1
BRB,Barbados,CHE,Switzerland,2015,6,0,6
BRB,Barbados,CHE,Switzerland,2016,1,2,-1
BRB,Barbados,CHE,Switzerland,2017,0,0,0
BRB,Barbados,TUR,Turkey,2010,1,0,1
BRB,Barbados,USA,United States,2008,585,0,585
BRB,Barbados,USA,United States,2009,603,0,603
BRB,Barbados,USA,United States,2010,465,0,465
BRB,Barbados,USA,United States,2011,455,0,455
BRB,Barbados,USA,United States,2012,460,0,460
BRB,Barbados,USA,United States,2013,428,0,428
BRB,Barbados,USA,United States,2014,384,0,384
BRB,Barbados,USA,United States,2015,376,0,376
BRB,Barbados,USA,United States,2016,371,0,371
BRB,Barbados,USA,United States,2017,373,0,373
BRB,Barbados,CHL,Chile,2008,0,0,0
BRB,Barbados,CHL,Chile,2009,0,0,0
BRB,Barbados,CHL,Chile,2010,0,0,0
BRB,Barbados,CHL,Chile,2011,0,0,0
BRB,Barbados,CHL,Chile,2012,0,0,0
BRB,Barbados,CHL,Chile,2013,0,0,0
BRB,Barbados,CHL,Chile,2014,0,0,0
BRB,Barbados,CHL,Chile,2015,0,0,0
BRB,Barbados,CHL,Chile,2016,0,0,0
BRB,Barbados,EST,Estonia,2008,0,0,0
BRB,Barbados,EST,Estonia,2009,0,0,0
BRB,Barbados,EST,Estonia,2010,0,0,0
BRB,Barbados,EST,Estonia,2011,0,0,0
BRB,Barbados,EST,Estonia,2012,0,0,0
BRB,Barbados,EST,Estonia,2013,0,0,0
BRB,Barbados,EST,Estonia,2014,0,0,0
BRB,Barbados,EST,Estonia,2015,1,0,1
BRB,Barbados,EST,Estonia,2016,0,0,0
BRB,Barbados,EST,Estonia,2017,0,0,0
BRB,Barbados,SVN,Slovenia,2017,1,0,1
BLR,Belarus,AUS,Australia,2008,41,12,29
BLR,Belarus,AUS,Australia,2009,69,6,63
BLR,Belarus,AUS,Australia,2010,47,10,37
BLR,Belarus,AUS,Australia,2011,60,12,48
BLR,Belarus,AUS,Australia,2012,37,16,21
BLR,Belarus,AUS,Australia,2013,73,13,60
BLR,Belarus,AUS,Australia,2014,101,12,89
BLR,Belarus,AUS,Australia,2015,56,0,56
BLR,Belarus,AUS,Australia,2016,56,0,56
BLR,Belarus,AUS,Australia,2017,66,0,66
BLR,Belarus,AUT,Austria,2008,154,100,54
BLR,Belarus,AUT,Austria,2009,155,110,45
BLR,Belarus,AUT,Austria,2010,111,108,3
BLR,Belarus,AUT,Austria,2011,135,78,57
BLR,Belarus,AUT,Austria,2012,176,75,101
BLR,Belarus,AUT,Austria,2013,185,93,92
BLR,Belarus,AUT,Austria,2014,218,83,135
BLR,Belarus,AUT,Austria,2015,197,100,97
BLR,Belarus,AUT,Austria,2016,166,120,46
BLR,Belarus,AUT,Austria,2017,173,107,66
BLR,Belarus,BEL,Belgium,2008,135,0,135
BLR,Belarus,BEL,Belgium,2009,123,0,123
BLR,Belarus,BEL,Belgium,2010,118,40,78
BLR,Belarus,BEL,Belgium,2011,103,0,103
BLR,Belarus,BEL,Belgium,2012,158,69,89
BLR,Belarus,BEL,Belgium,2013,149,108,41
BLR,Belarus,BEL,Belgium,2014,95,66,29
BLR,Belarus,BEL,Belgium,2015,93,60,33
BLR,Belarus,BEL,Belgium,2016,88,39,49
BLR,Belarus,BEL,Belgium,2017,95,47,48
BLR,Belarus,CAN,Canada,2008,524,0,524
BLR,Belarus,CAN,Canada,2009,454,0,454
BLR,Belarus,CAN,Canada,2010,438,0,438
BLR,Belarus,CAN,Canada,2011,357,0,357
BLR,Belarus,CAN,Canada,2012,277,0,277
BLR,Belarus,CAN,Canada,2013,247,0,247
BLR,Belarus,CAN,Canada,2014,175,0,175
BLR,Belarus,CAN,Canada,2015,214,0,214
BLR,Belarus,CAN,Canada,2016,360,0,360
BLR,Belarus,CAN,Canada,2017,310,0,310
BLR,Belarus,CZE,Czech Republic,2008,647,23,624
BLR,Belarus,CZE,Czech Republic,2009,427,9,418
BLR,Belarus,CZE,Czech Republic,2010,251,3,248
BLR,Belarus,CZE,Czech Republic,2011,237,7,230
BLR,Belarus,CZE,Czech Republic,2012,373,170,203
BLR,Belarus,CZE,Czech Republic,2013,387,329,58
BLR,Belarus,CZE,Czech Republic,2014,485,171,314
BLR,Belarus,CZE,Czech Republic,2015,342,193,149
BLR,Belarus,CZE,Czech Republic,2016,421,177,244
BLR,Belarus,CZE,Czech Republic,2017,657,181,476
BLR,Belarus,DNK,Denmark,2008,65,16,49
BLR,Belarus,DNK,Denmark,2009,66,59,7
BLR,Belarus,DNK,Denmark,2010,62,44,18
BLR,Belarus,DNK,Denmark,2011,44,34,10
BLR,Belarus,DNK,Denmark,2012,38,36,2
BLR,Belarus,DNK,Denmark,2013,38,24,14
BLR,Belarus,DNK,Denmark,2014,39,23,16
BLR,Belarus,DNK,Denmark,2015,46,20,26
BLR,Belarus,DNK,Denmark,2016,31,31,0
BLR,Belarus,DNK,Denmark,2017,28,25,3
BLR,Belarus,FIN,Finland,2008,53,9,44
BLR,Belarus,FIN,Finland,2009,39,3,36
BLR,Belarus,FIN,Finland,2010,22,9,13
BLR,Belarus,FIN,Finland,2011,38,3,35
BLR,Belarus,FIN,Finland,2012,43,2,41
BLR,Belarus,FIN,Finland,2013,34,6,28
BLR,Belarus,FIN,Finland,2014,59,8,51
BLR,Belarus,FIN,Finland,2015,42,3,39
BLR,Belarus,FIN,Finland,2016,53,8,45
BLR,Belarus,FIN,Finland,2017,55,13,42
BLR,Belarus,FRA,France,2008,267,0,267
BLR,Belarus,FRA,France,2009,245,0,245
BLR,Belarus,FRA,France,2010,232,0,232
BLR,Belarus,FRA,France,2011,214,0,214
BLR,Belarus,FRA,France,2012,235,0,235
BLR,Belarus,FRA,France,2013,231,0,231
BLR,Belarus,FRA,France,2014,237,0,237
BLR,Belarus,FRA,France,2015,223,0,223
BLR,Belarus,FRA,France,2016,209,0,209
BLR,Belarus,FRA,France,2017,214,0,214
BLR,Belarus,DEU,Germany,2008,1483,1292,191
BLR,Belarus,DEU,Germany,2009,1363,1124,239
BLR,Belarus,DEU,Germany,2010,1354,946,408
BLR,Belarus,DEU,Germany,2011,1435,780,655
BLR,Belarus,DEU,Germany,2012,1647,804,843
BLR,Belarus,DEU,Germany,2013,1638,850,788
BLR,Belarus,DEU,Germany,2014,1707,869,838
BLR,Belarus,DEU,Germany,2015,2021,840,1181
BLR,Belarus,DEU,Germany,2016,1943,872,1071
BLR,Belarus,DEU,Germany,2017,1938,1021,917
BLR,Belarus,HUN,Hungary,2008,26,0,26
BLR,Belarus,HUN,Hungary,2009,29,1,28
BLR,Belarus,HUN,Hungary,2010,29,5,24
BLR,Belarus,HUN,Hungary,2011,36,4,32
BLR,Belarus,HUN,Hungary,2012,34,5,29
BLR,Belarus,HUN,Hungary,2013,49,3,46
BLR,Belarus,HUN,Hungary,2014,43,1,42
BLR,Belarus,HUN,Hungary,2015,53,15,38
BLR,Belarus,HUN,Hungary,2016,51,12,39
BLR,Belarus,HUN,Hungary,2017,90,0,90
BLR,Belarus,ISL,Iceland,2008,2,6,-4
BLR,Belarus,ISL,Iceland,2009,3,3,0
BLR,Belarus,ISL,Iceland,2010,2,2,0
BLR,Belarus,ISL,Iceland,2011,1,0,1
BLR,Belarus,ISL,Iceland,2012,1,1,0
BLR,Belarus,ISL,Iceland,2013,2,1,1
BLR,Belarus,ISL,Iceland,2014,3,2,1
BLR,Belarus,ISL,Iceland,2015,5,1,4
BLR,Belarus,ISL,Iceland,2016,4,4,0
BLR,Belarus,ISL,Iceland,2017,7,3,4
BLR,Belarus,ITA,Italy,2008,959,18,941
BLR,Belarus,ITA,Italy,2009,949,23,926
BLR,Belarus,ITA,Italy,2010,1296,46,1250
BLR,Belarus,ITA,Italy,2011,988,41,947
BLR,Belarus,ITA,Italy,2012,813,64,749
BLR,Belarus,ITA,Italy,2013,698,68,630
BLR,Belarus,ITA,Italy,2014,590,71,519
BLR,Belarus,ITA,Italy,2015,545,70,475
BLR,Belarus,ITA,Italy,2016,522,0,522
BLR,Belarus,ITA,Italy,2017,551,68,483
BLR,Belarus,JPN,Japan,2008,134,115,19
BLR,Belarus,JPN,Japan,2009,104,89,15
BLR,Belarus,JPN,Japan,2010,112,100,12
BLR,Belarus,JPN,Japan,2011,120,98,22
BLR,Belarus,JPN,Japan,2012,206,194,12
BLR,Belarus,JPN,Japan,2013,129,121,8
BLR,Belarus,JPN,Japan,2014,118,93,25
BLR,Belarus,JPN,Japan,2015,143,126,17
BLR,Belarus,JPN,Japan,2016,166,119,47
BLR,Belarus,JPN,Japan,2017,151,109,42
BLR,Belarus,KOR,Korea,2008,46,77,-31
BLR,Belarus,KOR,Korea,2009,55,53,2
BLR,Belarus,KOR,Korea,2010,48,66,-18
BLR,Belarus,KOR,Korea,2011,58,40,18
BLR,Belarus,KOR,Korea,2012,63,70,-7
BLR,Belarus,KOR,Korea,2013,53,56,-3
BLR,Belarus,KOR,Korea,2014,57,56,1
BLR,Belarus,KOR,Korea,2015,85,66,19
BLR,Belarus,KOR,Korea,2016,91,86,5
BLR,Belarus,KOR,Korea,2017,106,80,26
BLR,Belarus,LUX,Luxembourg,2008,15,14,1
BLR,Belarus,LUX,Luxembourg,2009,28,9,19
BLR,Belarus,LUX,Luxembourg,2010,19,3,16
BLR,Belarus,LUX,Luxembourg,2011,19,8,11
BLR,Belarus,LUX,Luxembourg,2012,27,16,11
BLR,Belarus,LUX,Luxembourg,2013,30,11,19
BLR,Belarus,LUX,Luxembourg,2014,20,16,4
BLR,Belarus,LUX,Luxembourg,2015,24,6,18
BLR,Belarus,LUX,Luxembourg,2016,26,19,7
BLR,Belarus,LUX,Luxembourg,2017,31,15,16
BLR,Belarus,MEX,Mexico,2008,2,0,2
BLR,Belarus,MEX,Mexico,2009,3,0,3
BLR,Belarus,MEX,Mexico,2010,7,0,7
BLR,Belarus,MEX,Mexico,2011,8,0,8
BLR,Belarus,MEX,Mexico,2012,2,0,2
BLR,Belarus,MEX,Mexico,2013,17,0,17
BLR,Belarus,MEX,Mexico,2014,10,0,10
BLR,Belarus,MEX,Mexico,2015,12,0,12
BLR,Belarus,MEX,Mexico,2016,11,0,11
BLR,Belarus,MEX,Mexico,2017,14,0,14
BLR,Belarus,NLD,Netherlands,2008,115,41,74
BLR,Belarus,NLD,Netherlands,2009,113,36,77
BLR,Belarus,NLD,Netherlands,2010,111,48,63
BLR,Belarus,NLD,Netherlands,2011,127,44,83
BLR,Belarus,NLD,Netherlands,2012,117,40,77
BLR,Belarus,NLD,Netherlands,2013,111,55,56
BLR,Belarus,NLD,Netherlands,2014,171,42,129
BLR,Belarus,NLD,Netherlands,2015,150,51,99
BLR,Belarus,NLD,Netherlands,2016,185,48,137
BLR,Belarus,NLD,Netherlands,2017,192,64,128
BLR,Belarus,NZL,New Zealand,2008,10,3,7
BLR,Belarus,NZL,New Zealand,2009,10,0,10
BLR,Belarus,NZL,New Zealand,2010,2,2,0
BLR,Belarus,NZL,New Zealand,2011,17,2,15
BLR,Belarus,NZL,New Zealand,2012,7,0,7
BLR,Belarus,NZL,New Zealand,2013,17,2,15
BLR,Belarus,NZL,New Zealand,2014,18,6,12
BLR,Belarus,NZL,New Zealand,2015,16,0,16
BLR,Belarus,NZL,New Zealand,2016,20,8,12
BLR,Belarus,NZL,New Zealand,2017,30,1,29
BLR,Belarus,NOR,Norway,2008,78,22,56
BLR,Belarus,NOR,Norway,2009,75,18,57
BLR,Belarus,NOR,Norway,2010,64,26,38
BLR,Belarus,NOR,Norway,2011,88,27,61
BLR,Belarus,NOR,Norway,2012,97,16,81
BLR,Belarus,NOR,Norway,2013,76,24,52
BLR,Belarus,NOR,Norway,2014,59,23,36
BLR,Belarus,NOR,Norway,2015,48,24,24
BLR,Belarus,NOR,Norway,2016,51,35,16
BLR,Belarus,NOR,Norway,2017,80,14,66
BLR,Belarus,POL,Poland,2008,3077,0,3077
BLR,Belarus,POL,Poland,2009,3154,0,3154
BLR,Belarus,POL,Poland,2010,2920,0,2920
BLR,Belarus,POL,Poland,2011,2515,0,2515
BLR,Belarus,POL,Poland,2012,2618,0,2618
BLR,Belarus,POL,Poland,2013,2338,0,2338
BLR,Belarus,POL,Poland,2014,1415,0,1415
BLR,Belarus,POL,Poland,2015,3178,0,3178
BLR,Belarus,POL,Poland,2016,3499,0,3499
BLR,Belarus,POL,Poland,2017,6192,0,6192
BLR,Belarus,SVK,Slovak Republic,2008,9,1,8
BLR,Belarus,SVK,Slovak Republic,2009,6,4,2
BLR,Belarus,SVK,Slovak Republic,2010,3,4,-1
BLR,Belarus,SVK,Slovak Republic,2011,4,10,-6
BLR,Belarus,SVK,Slovak Republic,2012,4,0,4
BLR,Belarus,SVK,Slovak Republic,2013,5,0,5
BLR,Belarus,SVK,Slovak Republic,2014,4,2,2
BLR,Belarus,SVK,Slovak Republic,2015,6,0,6
BLR,Belarus,SVK,Slovak Republic,2016,2,1,1
BLR,Belarus,SVK,Slovak Republic,2017,7,0,7
BLR,Belarus,ESP,Spain,2008,341,172,169
BLR,Belarus,ESP,Spain,2009,226,230,-4
BLR,Belarus,ESP,Spain,2010,234,208,26
BLR,Belarus,ESP,Spain,2011,304,185,119
BLR,Belarus,ESP,Spain,2012,273,119,154
BLR,Belarus,ESP,Spain,2013,335,167,168
BLR,Belarus,ESP,Spain,2014,381,81,300
BLR,Belarus,ESP,Spain,2015,343,89,254
BLR,Belarus,ESP,Spain,2016,494,128,366
BLR,Belarus,ESP,Spain,2017,556,235,321
BLR,Belarus,SWE,Sweden,2008,166,17,149
BLR,Belarus,SWE,Sweden,2009,247,11,236
BLR,Belarus,SWE,Sweden,2010,215,20,195
BLR,Belarus,SWE,Sweden,2011,240,24,216
BLR,Belarus,SWE,Sweden,2012,239,34,205
BLR,Belarus,SWE,Sweden,2013,156,20,136
BLR,Belarus,SWE,Sweden,2014,174,33,141
BLR,Belarus,SWE,Sweden,2015,158,72,86
BLR,Belarus,SWE,Sweden,2016,162,30,132
BLR,Belarus,SWE,Sweden,2017,169,22,147
BLR,Belarus,CHE,Switzerland,2010,153,32,121
BLR,Belarus,CHE,Switzerland,2011,140,29,111
BLR,Belarus,CHE,Switzerland,2012,149,38,111
BLR,Belarus,CHE,Switzerland,2013,125,68,57
BLR,Belarus,CHE,Switzerland,2014,127,38,89
BLR,Belarus,CHE,Switzerland,2015,112,40,72
BLR,Belarus,CHE,Switzerland,2016,102,50,52
BLR,Belarus,CHE,Switzerland,2017,91,35,56
BLR,Belarus,TUR,Turkey,2010,107,0,107
BLR,Belarus,TUR,Turkey,2016,564,249,315
BLR,Belarus,TUR,Turkey,2017,609,323,286
BLR,Belarus,USA,United States,2008,2390,0,2390
BLR,Belarus,USA,United States,2009,2407,0,2407
BLR,Belarus,USA,United States,2010,2038,0,2038
BLR,Belarus,USA,United States,2011,1964,0,1964
BLR,Belarus,USA,United States,2012,1659,0,1659
BLR,Belarus,USA,United States,2013,1970,0,1970
BLR,Belarus,USA,United States,2014,2015,0,2015
BLR,Belarus,USA,United States,2015,1994,0,1994
BLR,Belarus,USA,United States,2016,2127,0,2127
BLR,Belarus,USA,United States,2017,1919,0,1919
BLR,Belarus,CHL,Chile,2008,6,0,6
BLR,Belarus,CHL,Chile,2009,9,0,9
BLR,Belarus,CHL,Chile,2010,12,0,12
BLR,Belarus,CHL,Chile,2011,16,0,16
BLR,Belarus,CHL,Chile,2012,12,0,12
BLR,Belarus,CHL,Chile,2013,7,0,7
BLR,Belarus,CHL,Chile,2014,2,0,2
BLR,Belarus,CHL,Chile,2015,22,0,22
BLR,Belarus,CHL,Chile,2016,10,0,10
BLR,Belarus,EST,Estonia,2008,36,0,36
BLR,Belarus,EST,Estonia,2009,35,0,35
BLR,Belarus,EST,Estonia,2010,19,0,19
BLR,Belarus,EST,Estonia,2011,50,0,50
BLR,Belarus,EST,Estonia,2012,35,0,35
BLR,Belarus,EST,Estonia,2013,50,0,50
BLR,Belarus,EST,Estonia,2014,45,0,45
BLR,Belarus,EST,Estonia,2015,91,0,91
BLR,Belarus,EST,Estonia,2016,118,0,118
BLR,Belarus,EST,Estonia,2017,133,0,133
BLR,Belarus,SVN,Slovenia,2008,26,0,26
BLR,Belarus,SVN,Slovenia,2009,9,0,9
BLR,Belarus,SVN,Slovenia,2010,1,0,1
BLR,Belarus,SVN,Slovenia,2011,22,1,21
BLR,Belarus,SVN,Slovenia,2012,20,2,18
BLR,Belarus,SVN,Slovenia,2013,18,0,18
BLR,Belarus,SVN,Slovenia,2014,10,1,9
BLR,Belarus,SVN,Slovenia,2015,21,2,19
BLR,Belarus,SVN,Slovenia,2016,21,2,19
BLR,Belarus,SVN,Slovenia,2017,25,1,24
BEL,Belgium,AUS,Australia,2008,167,218,-51
BEL,Belgium,AUS,Australia,2009,163,196,-33
BEL,Belgium,AUS,Australia,2010,179,233,-54
BEL,Belgium,AUS,Australia,2011,179,241,-62
BEL,Belgium,AUS,Australia,2012,182,195,-13
BEL,Belgium,AUS,Australia,2013,211,184,27
BEL,Belgium,AUS,Australia,2014,219,147,72
BEL,Belgium,AUS,Australia,2015,222,127,95
BEL,Belgium,AUS,Australia,2016,200,145,55
BEL,Belgium,AUS,Australia,2017,216,117,99
BEL,Belgium,AUT,Austria,2008,284,284,0
BEL,Belgium,AUT,Austria,2009,248,283,-35
BEL,Belgium,AUT,Austria,2010,256,282,-26
BEL,Belgium,AUT,Austria,2011,275,305,-30
BEL,Belgium,AUT,Austria,2012,306,280,26
BEL,Belgium,AUT,Austria,2013,280,283,-3
BEL,Belgium,AUT,Austria,2014,303,196,107
BEL,Belgium,AUT,Austria,2015,359,225,134
BEL,Belgium,AUT,Austria,2016,374,201,173
BEL,Belgium,AUT,Austria,2017,389,199,190
BEL,Belgium,BEL,Belgium,2010,0,0,0
BEL,Belgium,CAN,Canada,2008,335,653,-318
BEL,Belgium,CAN,Canada,2009,358,677,-319
BEL,Belgium,CAN,Canada,2010,363,710,-347
BEL,Belgium,CAN,Canada,2011,332,717,-385
BEL,Belgium,CAN,Canada,2012,401,615,-214
BEL,Belgium,CAN,Canada,2013,379,674,-295
BEL,Belgium,CAN,Canada,2014,356,477,-121
BEL,Belgium,CAN,Canada,2015,359,459,-100
BEL,Belgium,CAN,Canada,2016,455,520,-65
BEL,Belgium,CAN,Canada,2017,505,432,73
BEL,Belgium,CZE,Czech Republic,2008,57,526,-469
BEL,Belgium,CZE,Czech Republic,2009,38,525,-487
BEL,Belgium,CZE,Czech Republic,2010,48,556,-508
BEL,Belgium,CZE,Czech Republic,2011,36,560,-524
BEL,Belgium,CZE,Czech Republic,2012,43,498,-455
BEL,Belgium,CZE,Czech Republic,2013,61,500,-439
BEL,Belgium,CZE,Czech Republic,2014,47,388,-341
BEL,Belgium,CZE,Czech Republic,2015,45,341,-296
BEL,Belgium,CZE,Czech Republic,2016,58,292,-234
BEL,Belgium,CZE,Czech Republic,2017,51,316,-265
BEL,Belgium,DNK,Denmark,2008,111,271,-160
BEL,Belgium,DNK,Denmark,2009,84,258,-174
BEL,Belgium,DNK,Denmark,2010,100,247,-147
BEL,Belgium,DNK,Denmark,2011,112,295,-183
BEL,Belgium,DNK,Denmark,2012,156,257,-101
BEL,Belgium,DNK,Denmark,2013,120,241,-121
BEL,Belgium,DNK,Denmark,2014,126,230,-104
BEL,Belgium,DNK,Denmark,2015,141,221,-80
BEL,Belgium,DNK,Denmark,2016,184,254,-70
BEL,Belgium,DNK,Denmark,2017,198,200,-2
BEL,Belgium,FIN,Finland,2008,43,456,-413
BEL,Belgium,FIN,Finland,2009,32,404,-372
BEL,Belgium,FIN,Finland,2010,24,396,-372
BEL,Belgium,FIN,Finland,2011,43,361,-318
BEL,Belgium,FIN,Finland,2012,41,335,-294
BEL,Belgium,FIN,Finland,2013,40,370,-330
BEL,Belgium,FIN,Finland,2014,34,243,-209
BEL,Belgium,FIN,Finland,2015,56,239,-183
BEL,Belgium,FIN,Finland,2016,42,275,-233
BEL,Belgium,FIN,Finland,2017,41,306,-265
BEL,Belgium,FRA,France,2008,0,14086,-14086
BEL,Belgium,FRA,France,2009,0,12272,-12272
BEL,Belgium,FRA,France,2010,0,13500,-13500
BEL,Belgium,FRA,France,2011,0,13847,-13847
BEL,Belgium,FRA,France,2012,0,13338,-13338
BEL,Belgium,FRA,France,2013,6642,13603,-6961
BEL,Belgium,FRA,France,2014,6493,11969,-5476
BEL,Belgium,FRA,France,2015,6429,11977,-5548
BEL,Belgium,FRA,France,2016,6701,11073,-4372
BEL,Belgium,FRA,France,2017,6552,11183,-4631
BEL,Belgium,DEU,Germany,2008,2038,3763,-1725
BEL,Belgium,DEU,Germany,2009,1905,3401,-1496
BEL,Belgium,DEU,Germany,2010,2303,3302,-999
BEL,Belgium,DEU,Germany,2011,2418,3141,-723
BEL,Belgium,DEU,Germany,2012,2622,2892,-270
BEL,Belgium,DEU,Germany,2013,2563,2925,-362
BEL,Belgium,DEU,Germany,2014,2821,2450,371
BEL,Belgium,DEU,Germany,2015,2833,2455,378
BEL,Belgium,DEU,Germany,2016,2930,2412,518
BEL,Belgium,DEU,Germany,2017,2860,2434,426
BEL,Belgium,HUN,Hungary,2008,127,799,-672
BEL,Belgium,HUN,Hungary,2009,124,850,-726
BEL,Belgium,HUN,Hungary,2010,165,974,-809
BEL,Belgium,HUN,Hungary,2011,117,1126,-1009
BEL,Belgium,HUN,Hungary,2012,132,1199,-1067
BEL,Belgium,HUN,Hungary,2013,142,1113,-971
BEL,Belgium,HUN,Hungary,2014,147,838,-691
BEL,Belgium,HUN,Hungary,2015,139,765,-626
BEL,Belgium,HUN,Hungary,2016,193,608,-415
BEL,Belgium,HUN,Hungary,2017,178,689,-511
BEL,Belgium,ISL,Iceland,2008,17,35,-18
BEL,Belgium,ISL,Iceland,2009,13,44,-31
BEL,Belgium,ISL,Iceland,2010,12,57,-45
BEL,Belgium,ISL,Iceland,2011,9,0,9
BEL,Belgium,ISL,Iceland,2012,6,31,-25
BEL,Belgium,ISL,Iceland,2013,12,62,-50
BEL,Belgium,ISL,Iceland,2014,26,25,1
BEL,Belgium,ISL,Iceland,2015,19,24,-5
BEL,Belgium,ISL,Iceland,2016,26,33,-7
BEL,Belgium,ISL,Iceland,2017,30,48,-18
BEL,Belgium,ITA,Italy,2008,473,3655,-3182
BEL,Belgium,ITA,Italy,2009,362,3557,-3195
BEL,Belgium,ITA,Italy,2010,376,4315,-3939
BEL,Belgium,ITA,Italy,2011,354,4717,-4363
BEL,Belgium,ITA,Italy,2012,343,5238,-4895
BEL,Belgium,ITA,Italy,2013,273,5719,-5446
BEL,Belgium,ITA,Italy,2014,329,5302,-4973
BEL,Belgium,ITA,Italy,2015,302,5105,-4803
BEL,Belgium,ITA,Italy,2016,359,4775,-4416
BEL,Belgium,ITA,Italy,2017,338,4847,-4509
BEL,Belgium,JPN,Japan,2008,482,1084,-602
BEL,Belgium,JPN,Japan,2009,383,1063,-680
BEL,Belgium,JPN,Japan,2010,444,914,-470
BEL,Belgium,JPN,Japan,2011,351,1061,-710
BEL,Belgium,JPN,Japan,2012,496,994,-498
BEL,Belgium,JPN,Japan,2013,390,935,-545
BEL,Belgium,JPN,Japan,2014,411,786,-375
BEL,Belgium,JPN,Japan,2015,456,910,-454
BEL,Belgium,JPN,Japan,2016,470,830,-360
BEL,Belgium,JPN,Japan,2017,548,880,-332
BEL,Belgium,KOR,Korea,2008,67,203,-136
BEL,Belgium,KOR,Korea,2009,64,191,-127
BEL,Belgium,KOR,Korea,2010,103,205,-102
BEL,Belgium,KOR,Korea,2011,68,252,-184
BEL,Belgium,KOR,Korea,2012,80,248,-168
BEL,Belgium,KOR,Korea,2013,91,229,-138
BEL,Belgium,KOR,Korea,2014,85,201,-116
BEL,Belgium,KOR,Korea,2015,121,216,-95
BEL,Belgium,KOR,Korea,2016,128,238,-110
BEL,Belgium,KOR,Korea,2017,133,275,-142
BEL,Belgium,LUX,Luxembourg,2008,1002,319,683
BEL,Belgium,LUX,Luxembourg,2009,1020,242,778
BEL,Belgium,LUX,Luxembourg,2010,1171,253,918
BEL,Belgium,LUX,Luxembourg,2011,1159,243,916
BEL,Belgium,LUX,Luxembourg,2012,1304,250,1054
BEL,Belgium,LUX,Luxembourg,2013,1470,252,1218
BEL,Belgium,LUX,Luxembourg,2014,1592,240,1352
BEL,Belgium,LUX,Luxembourg,2015,1502,219,1283
BEL,Belgium,LUX,Luxembourg,2016,1320,229,1091
BEL,Belgium,LUX,Luxembourg,2017,1356,228,1128
BEL,Belgium,MEX,Mexico,2008,39,247,-208
BEL,Belgium,MEX,Mexico,2009,48,258,-210
BEL,Belgium,MEX,Mexico,2010,85,261,-176
BEL,Belgium,MEX,Mexico,2011,60,312,-252
BEL,Belgium,MEX,Mexico,2012,55,321,-266
BEL,Belgium,MEX,Mexico,2013,167,298,-131
BEL,Belgium,MEX,Mexico,2014,115,223,-108
BEL,Belgium,MEX,Mexico,2015,83,224,-141
BEL,Belgium,MEX,Mexico,2016,83,315,-232
BEL,Belgium,MEX,Mexico,2017,60,369,-309
BEL,Belgium,NLD,Netherlands,2008,2054,11702,-9648
BEL,Belgium,NLD,Netherlands,2009,1969,8774,-6805
BEL,Belgium,NLD,Netherlands,2010,2075,9322,-7247
BEL,Belgium,NLD,Netherlands,2011,2274,9510,-7236
BEL,Belgium,NLD,Netherlands,2012,2568,9079,-6511
BEL,Belgium,NLD,Netherlands,2013,2523,8967,-6444
BEL,Belgium,NLD,Netherlands,2014,2709,8066,-5357
BEL,Belgium,NLD,Netherlands,2015,2731,8125,-5394
BEL,Belgium,NLD,Netherlands,2016,3247,7541,-4294
BEL,Belgium,NLD,Netherlands,2017,3490,7696,-4206
BEL,Belgium,NZL,New Zealand,2008,115,71,44
BEL,Belgium,NZL,New Zealand,2009,131,56,75
BEL,Belgium,NZL,New Zealand,2010,140,57,83
BEL,Belgium,NZL,New Zealand,2011,122,0,122
BEL,Belgium,NZL,New Zealand,2012,132,64,68
BEL,Belgium,NZL,New Zealand,2013,176,51,125
BEL,Belgium,NZL,New Zealand,2014,236,34,202
BEL,Belgium,NZL,New Zealand,2015,285,30,255
BEL,Belgium,NZL,New Zealand,2016,378,35,343
BEL,Belgium,NZL,New Zealand,2017,398,42,356
BEL,Belgium,NOR,Norway,2008,124,248,-124
BEL,Belgium,NOR,Norway,2009,119,165,-46
BEL,Belgium,NOR,Norway,2010,121,232,-111
BEL,Belgium,NOR,Norway,2011,146,218,-72
BEL,Belgium,NOR,Norway,2012,123,164,-41
BEL,Belgium,NOR,Norway,2013,151,225,-74
BEL,Belgium,NOR,Norway,2014,118,130,-12
BEL,Belgium,NOR,Norway,2015,120,181,-61
BEL,Belgium,NOR,Norway,2016,108,175,-67
BEL,Belgium,NOR,Norway,2017,99,181,-82
BEL,Belgium,POL,Poland,2008,117,8963,-8846
BEL,Belgium,POL,Poland,2009,99,9911,-9812
BEL,Belgium,POL,Poland,2010,129,8887,-8758
BEL,Belgium,POL,Poland,2011,100,9287,-9187
BEL,Belgium,POL,Poland,2012,132,8616,-8484
BEL,Belgium,POL,Poland,2013,147,7488,-7341
BEL,Belgium,POL,Poland,2014,147,5767,-5620
BEL,Belgium,POL,Poland,2015,139,5320,-5181
BEL,Belgium,POL,Poland,2016,127,4414,-4287
BEL,Belgium,POL,Poland,2017,120,4301,-4181
BEL,Belgium,SVK,Slovak Republic,2008,53,549,-496
BEL,Belgium,SVK,Slovak Republic,2009,62,599,-537
BEL,Belgium,SVK,Slovak Republic,2010,51,735,-684
BEL,Belgium,SVK,Slovak Republic,2011,53,746,-693
BEL,Belgium,SVK,Slovak Republic,2012,28,682,-654
BEL,Belgium,SVK,Slovak Republic,2013,41,638,-597
BEL,Belgium,SVK,Slovak Republic,2014,21,542,-521
BEL,Belgium,SVK,Slovak Republic,2015,26,523,-497
BEL,Belgium,SVK,Slovak Republic,2016,21,430,-409
BEL,Belgium,SVK,Slovak Republic,2017,11,542,-531
BEL,Belgium,ESP,Spain,2008,1914,2829,-915
BEL,Belgium,ESP,Spain,2009,1726,3592,-1866
BEL,Belgium,ESP,Spain,2010,1844,4618,-2774
BEL,Belgium,ESP,Spain,2011,1975,5288,-3313
BEL,Belgium,ESP,Spain,2012,2198,5999,-3801
BEL,Belgium,ESP,Spain,2013,2319,6130,-3811
BEL,Belgium,ESP,Spain,2014,2266,5024,-2758
BEL,Belgium,ESP,Spain,2015,2705,4137,-1432
BEL,Belgium,ESP,Spain,2016,2964,3668,-704
BEL,Belgium,ESP,Spain,2017,3803,4044,-241
BEL,Belgium,SWE,Sweden,2008,170,627,-457
BEL,Belgium,SWE,Sweden,2009,163,519,-356
BEL,Belgium,SWE,Sweden,2010,145,487,-342
BEL,Belgium,SWE,Sweden,2011,176,476,-300
BEL,Belgium,SWE,Sweden,2012,187,414,-227
BEL,Belgium,SWE,Sweden,2013,198,342,-144
BEL,Belgium,SWE,Sweden,2014,204,286,-82
BEL,Belgium,SWE,Sweden,2015,203,339,-136
BEL,Belgium,SWE,Sweden,2016,248,325,-77
BEL,Belgium,SWE,Sweden,2017,261,299,-38
BEL,Belgium,CHE,Switzerland,2008,1228,253,975
BEL,Belgium,CHE,Switzerland,2009,1033,195,838
BEL,Belgium,CHE,Switzerland,2010,1076,244,832
BEL,Belgium,CHE,Switzerland,2011,1170,260,910
BEL,Belgium,CHE,Switzerland,2012,1163,203,960
BEL,Belgium,CHE,Switzerland,2013,1277,207,1070
BEL,Belgium,CHE,Switzerland,2014,1250,187,1063
BEL,Belgium,CHE,Switzerland,2015,1288,154,1134
BEL,Belgium,CHE,Switzerland,2016,1217,183,1034
BEL,Belgium,CHE,Switzerland,2017,1289,191,1098
BEL,Belgium,TUR,Turkey,2010,252,3232,-2980
BEL,Belgium,TUR,Turkey,2016,239,1742,-1503
BEL,Belgium,TUR,Turkey,2017,247,1925,-1678
BEL,Belgium,GBR,United Kingdom,2011,1000,2061,-1061
BEL,Belgium,GBR,United Kingdom,2012,3000,1999,1001
BEL,Belgium,GBR,United Kingdom,2013,1000,1993,-993
BEL,Belgium,GBR,United Kingdom,2014,3000,1638,1362
BEL,Belgium,GBR,United Kingdom,2015,2000,1739,261
BEL,Belgium,USA,United States,2008,642,2631,-1989
BEL,Belgium,USA,United States,2009,686,2650,-1964
BEL,Belgium,USA,United States,2010,592,2714,-2122
BEL,Belgium,USA,United States,2011,567,2559,-1992
BEL,Belgium,USA,United States,2012,574,2544,-1970
BEL,Belgium,USA,United States,2013,675,2587,-1912
BEL,Belgium,USA,United States,2014,632,2001,-1369
BEL,Belgium,USA,United States,2015,662,2179,-1517
BEL,Belgium,USA,United States,2016,691,2113,-1422
BEL,Belgium,USA,United States,2017,625,2078,-1453
BEL,Belgium,CHL,Chile,2008,54,118,-64
BEL,Belgium,CHL,Chile,2009,62,145,-83
BEL,Belgium,CHL,Chile,2010,36,149,-113
BEL,Belgium,CHL,Chile,2011,44,158,-114
BEL,Belgium,CHL,Chile,2012,65,139,-74
BEL,Belgium,CHL,Chile,2013,69,117,-48
BEL,Belgium,CHL,Chile,2014,74,120,-46
BEL,Belgium,CHL,Chile,2015,98,83,15
BEL,Belgium,CHL,Chile,2016,40,126,-86
BEL,Belgium,EST,Estonia,2008,11,153,-142
BEL,Belgium,EST,Estonia,2009,9,116,-107
BEL,Belgium,EST,Estonia,2010,6,185,-179
BEL,Belgium,EST,Estonia,2011,0,157,-157
BEL,Belgium,EST,Estonia,2012,0,131,-131
BEL,Belgium,EST,Estonia,2013,0,171,-171
BEL,Belgium,EST,Estonia,2014,1,107,-106
BEL,Belgium,EST,Estonia,2015,50,123,-73
BEL,Belgium,EST,Estonia,2016,43,101,-58
BEL,Belgium,EST,Estonia,2017,43,109,-66
BEL,Belgium,ISR,Israel,2008,84,189,-105
BEL,Belgium,ISR,Israel,2009,125,167,-42
BEL,Belgium,ISR,Israel,2010,186,150,36
BEL,Belgium,ISR,Israel,2011,175,160,15
BEL,Belgium,ISR,Israel,2012,140,130,10
BEL,Belgium,ISR,Israel,2013,222,124,98
BEL,Belgium,ISR,Israel,2014,224,110,114
BEL,Belgium,ISR,Israel,2015,242,110,132
BEL,Belgium,ISR,Israel,2016,185,65,120
BEL,Belgium,ISR,Israel,2017,117,98,19
BEL,Belgium,SVN,Slovenia,2008,20,149,-129
BEL,Belgium,SVN,Slovenia,2009,27,193,-166
BEL,Belgium,SVN,Slovenia,2010,23,181,-158
BEL,Belgium,SVN,Slovenia,2011,28,140,-112
BEL,Belgium,SVN,Slovenia,2012,45,149,-104
BEL,Belgium,SVN,Slovenia,2013,47,157,-110
BEL,Belgium,SVN,Slovenia,2014,47,110,-63
BEL,Belgium,SVN,Slovenia,2015,44,159,-115
BEL,Belgium,SVN,Slovenia,2016,47,132,-85
BEL,Belgium,SVN,Slovenia,2017,60,113,-53
BLZ,Belize,AUS,Australia,2008,2,0,2
BLZ,Belize,AUS,Australia,2009,1,0,1
BLZ,Belize,AUS,Australia,2010,0,0,0
BLZ,Belize,AUS,Australia,2011,0,0,0
BLZ,Belize,AUS,Australia,2012,2,0,2
BLZ,Belize,AUS,Australia,2013,2,0,2
BLZ,Belize,AUS,Australia,2014,0,0,0
BLZ,Belize,AUS,Australia,2015,0,0,0
BLZ,Belize,AUS,Australia,2017,0,0,0
BLZ,Belize,AUT,Austria,2008,4,3,1
BLZ,Belize,AUT,Austria,2009,0,2,-2
BLZ,Belize,AUT,Austria,2010,1,1,0
BLZ,Belize,AUT,Austria,2011,0,1,-1
BLZ,Belize,AUT,Austria,2012,0,0,0
BLZ,Belize,AUT,Austria,2013,0,1,-1
BLZ,Belize,AUT,Austria,2014,1,1,0
BLZ,Belize,AUT,Austria,2015,3,1,2
BLZ,Belize,AUT,Austria,2016,0,2,-2
BLZ,Belize,AUT,Austria,2017,0,0,0
BLZ,Belize,BEL,Belgium,2008,1,0,1
BLZ,Belize,BEL,Belgium,2009,0,0,0
BLZ,Belize,BEL,Belgium,2010,0,0,0
BLZ,Belize,BEL,Belgium,2013,1,1,0
BLZ,Belize,BEL,Belgium,2014,2,0,2
BLZ,Belize,BEL,Belgium,2017,1,1,0
BLZ,Belize,CAN,Canada,2008,48,0,48
BLZ,Belize,CAN,Canada,2009,38,0,38
BLZ,Belize,CAN,Canada,2010,39,0,39
BLZ,Belize,CAN,Canada,2011,35,0,35
BLZ,Belize,CAN,Canada,2012,33,0,33
BLZ,Belize,CAN,Canada,2013,53,0,53
BLZ,Belize,CAN,Canada,2014,53,0,53
BLZ,Belize,CAN,Canada,2015,27,0,27
BLZ,Belize,CAN,Canada,2016,65,0,65
BLZ,Belize,CAN,Canada,2017,80,0,80
BLZ,Belize,CZE,Czech Republic,2016,2,0,2
BLZ,Belize,DNK,Denmark,2008,0,0,0
BLZ,Belize,DNK,Denmark,2009,2,0,2
BLZ,Belize,DNK,Denmark,2012,0,0,0
BLZ,Belize,DNK,Denmark,2013,1,0,1
BLZ,Belize,DNK,Denmark,2014,0,0,0
BLZ,Belize,DNK,Denmark,2015,1,1,0
BLZ,Belize,DNK,Denmark,2016,1,0,1
BLZ,Belize,DNK,Denmark,2017,0,0,0
BLZ,Belize,FIN,Finland,2008,0,0,0
BLZ,Belize,FIN,Finland,2009,0,0,0
BLZ,Belize,FIN,Finland,2010,0,0,0
BLZ,Belize,FIN,Finland,2011,0,0,0
BLZ,Belize,FIN,Finland,2012,0,0,0
BLZ,Belize,FIN,Finland,2013,0,0,0
BLZ,Belize,FIN,Finland,2014,0,0,0
BLZ,Belize,FIN,Finland,2015,0,0,0
BLZ,Belize,FIN,Finland,2016,0,1,-1
BLZ,Belize,FIN,Finland,2017,0,0,0
BLZ,Belize,FRA,France,2008,0,0,0
BLZ,Belize,FRA,France,2009,1,0,1
BLZ,Belize,FRA,France,2010,1,0,1
BLZ,Belize,FRA,France,2011,0,0,0
BLZ,Belize,FRA,France,2012,1,0,1
BLZ,Belize,FRA,France,2013,1,0,1
BLZ,Belize,FRA,France,2014,1,0,1
BLZ,Belize,FRA,France,2015,3,0,3
BLZ,Belize,FRA,France,2016,0,0,0
BLZ,Belize,FRA,France,2017,0,0,0
BLZ,Belize,DEU,Germany,2008,2,1,1
BLZ,Belize,DEU,Germany,2009,5,4,1
BLZ,Belize,DEU,Germany,2010,11,8,3
BLZ,Belize,DEU,Germany,2011,7,6,1
BLZ,Belize,DEU,Germany,2012,5,2,3
BLZ,Belize,DEU,Germany,2013,6,1,5
BLZ,Belize,DEU,Germany,2014,7,5,2
BLZ,Belize,DEU,Germany,2015,9,5,4
BLZ,Belize,DEU,Germany,2016,11,7,4
BLZ,Belize,DEU,Germany,2017,9,6,3
BLZ,Belize,HUN,Hungary,2008,0,0,0
BLZ,Belize,HUN,Hungary,2009,1,0,1
BLZ,Belize,HUN,Hungary,2010,0,0,0
BLZ,Belize,HUN,Hungary,2011,0,0,0
BLZ,Belize,HUN,Hungary,2012,0,0,0
BLZ,Belize,HUN,Hungary,2013,0,0,0
BLZ,Belize,HUN,Hungary,2014,1,0,1
BLZ,Belize,HUN,Hungary,2015,0,0,0
BLZ,Belize,HUN,Hungary,2016,0,0,0
BLZ,Belize,HUN,Hungary,2017,0,0,0
BLZ,Belize,ISL,Iceland,2008,0,0,0
BLZ,Belize,ISL,Iceland,2009,1,0,1
BLZ,Belize,ISL,Iceland,2010,0,1,-1
BLZ,Belize,ISL,Iceland,2011,0,0,0
BLZ,Belize,ISL,Iceland,2012,0,0,0
BLZ,Belize,ISL,Iceland,2013,0,0,0
BLZ,Belize,ISL,Iceland,2014,0,0,0
BLZ,Belize,ISL,Iceland,2015,0,0,0
BLZ,Belize,ISL,Iceland,2016,0,0,0
BLZ,Belize,ISL,Iceland,2017,0,0,0
BLZ,Belize,ITA,Italy,2008,3,0,3
BLZ,Belize,ITA,Italy,2009,1,0,1
BLZ,Belize,ITA,Italy,2010,2,0,2
BLZ,Belize,ITA,Italy,2011,2,0,2
BLZ,Belize,ITA,Italy,2012,3,0,3
BLZ,Belize,ITA,Italy,2013,0,0,0
BLZ,Belize,ITA,Italy,2014,1,2,-1
BLZ,Belize,ITA,Italy,2015,3,0,3
BLZ,Belize,ITA,Italy,2016,3,0,3
BLZ,Belize,ITA,Italy,2017,2,1,1
BLZ,Belize,JPN,Japan,2008,18,15,3
BLZ,Belize,JPN,Japan,2009,21,20,1
BLZ,Belize,JPN,Japan,2010,27,26,1
BLZ,Belize,JPN,Japan,2011,8,8,0
BLZ,Belize,JPN,Japan,2012,17,15,2
BLZ,Belize,JPN,Japan,2013,24,22,2
BLZ,Belize,JPN,Japan,2014,23,21,2
BLZ,Belize,JPN,Japan,2015,12,11,1
BLZ,Belize,JPN,Japan,2016,13,14,-1
BLZ,Belize,JPN,Japan,2017,20,20,0
BLZ,Belize,KOR,Korea,2008,7,1,6
BLZ,Belize,KOR,Korea,2009,2,4,-2
BLZ,Belize,KOR,Korea,2010,3,1,2
BLZ,Belize,KOR,Korea,2011,5,3,2
BLZ,Belize,KOR,Korea,2012,6,3,3
BLZ,Belize,KOR,Korea,2013,7,3,4
BLZ,Belize,KOR,Korea,2014,2,4,-2
BLZ,Belize,KOR,Korea,2015,2,5,-3
BLZ,Belize,KOR,Korea,2016,2,4,-2
BLZ,Belize,KOR,Korea,2017,3,1,2
BLZ,Belize,LUX,Luxembourg,2008,0,0,0
BLZ,Belize,LUX,Luxembourg,2009,0,0,0
BLZ,Belize,LUX,Luxembourg,2010,0,0,0
BLZ,Belize,LUX,Luxembourg,2011,0,0,0
BLZ,Belize,LUX,Luxembourg,2012,0,1,-1
BLZ,Belize,LUX,Luxembourg,2013,0,0,0
BLZ,Belize,LUX,Luxembourg,2014,0,0,0
BLZ,Belize,LUX,Luxembourg,2015,0,0,0
BLZ,Belize,LUX,Luxembourg,2016,0,0,0
BLZ,Belize,LUX,Luxembourg,2017,0,0,0
BLZ,Belize,MEX,Mexico,2008,43,0,43
BLZ,Belize,MEX,Mexico,2009,74,0,74
BLZ,Belize,MEX,Mexico,2010,113,0,113
BLZ,Belize,MEX,Mexico,2011,79,0,79
BLZ,Belize,MEX,Mexico,2012,65,0,65
BLZ,Belize,MEX,Mexico,2013,217,0,217
BLZ,Belize,MEX,Mexico,2014,162,0,162
BLZ,Belize,MEX,Mexico,2015,83,0,83
BLZ,Belize,MEX,Mexico,2016,79,0,79
BLZ,Belize,MEX,Mexico,2017,61,0,61
BLZ,Belize,NLD,Netherlands,2008,4,1,3
BLZ,Belize,NLD,Netherlands,2009,1,1,0
BLZ,Belize,NLD,Netherlands,2011,1,0,1
BLZ,Belize,NLD,Netherlands,2012,1,0,1
BLZ,Belize,NLD,Netherlands,2013,1,3,-2
BLZ,Belize,NLD,Netherlands,2014,2,1,1
BLZ,Belize,NLD,Netherlands,2015,1,0,1
BLZ,Belize,NLD,Netherlands,2016,2,1,1
BLZ,Belize,NLD,Netherlands,2017,2,2,0
BLZ,Belize,NZL,New Zealand,2008,0,0,0
BLZ,Belize,NZL,New Zealand,2009,1,0,1
BLZ,Belize,NZL,New Zealand,2013,1,1,0
BLZ,Belize,NZL,New Zealand,2017,3,0,3
BLZ,Belize,NOR,Norway,2008,3,0,3
BLZ,Belize,NOR,Norway,2009,2,1,1
BLZ,Belize,NOR,Norway,2010,2,0,2
BLZ,Belize,NOR,Norway,2011,1,0,1
BLZ,Belize,NOR,Norway,2012,1,1,0
BLZ,Belize,NOR,Norway,2013,2,2,0
BLZ,Belize,NOR,Norway,2014,0,0,0
BLZ,Belize,NOR,Norway,2015,0,0,0
BLZ,Belize,NOR,Norway,2016,1,0,1
BLZ,Belize,NOR,Norway,2017,1,0,1
BLZ,Belize,POL,Poland,2009,0,0,0
BLZ,Belize,POL,Poland,2010,1,0,1
BLZ,Belize,POL,Poland,2011,1,0,1
BLZ,Belize,POL,Poland,2012,0,0,0
BLZ,Belize,POL,Poland,2013,0,0,0
BLZ,Belize,POL,Poland,2014,1,0,1
BLZ,Belize,POL,Poland,2015,1,0,1
BLZ,Belize,POL,Poland,2016,1,0,1
BLZ,Belize,POL,Poland,2017,1,0,1
BLZ,Belize,SVK,Slovak Republic,2008,0,0,0
BLZ,Belize,SVK,Slovak Republic,2010,1,0,1
BLZ,Belize,ESP,Spain,2008,0,2,-2
BLZ,Belize,ESP,Spain,2009,2,1,1
BLZ,Belize,ESP,Spain,2010,3,0,3
BLZ,Belize,ESP,Spain,2011,2,2,0
BLZ,Belize,ESP,Spain,2012,4,0,4
BLZ,Belize,ESP,Spain,2013,4,2,2
BLZ,Belize,ESP,Spain,2014,1,0,1
BLZ,Belize,ESP,Spain,2015,3,2,1
BLZ,Belize,ESP,Spain,2016,1,1,0
BLZ,Belize,ESP,Spain,2017,11,2,9
BLZ,Belize,SWE,Sweden,2008,2,0,2
BLZ,Belize,SWE,Sweden,2009,3,0,3
BLZ,Belize,SWE,Sweden,2010,1,0,1
BLZ,Belize,SWE,Sweden,2011,1,0,1
BLZ,Belize,SWE,Sweden,2012,1,0,1
BLZ,Belize,SWE,Sweden,2013,3,0,3
BLZ,Belize,SWE,Sweden,2014,3,2,1
BLZ,Belize,SWE,Sweden,2015,2,4,-2
BLZ,Belize,SWE,Sweden,2016,1,1,0
BLZ,Belize,SWE,Sweden,2017,1,0,1
BLZ,Belize,CHE,Switzerland,2010,2,0,2
BLZ,Belize,CHE,Switzerland,2011,1,1,0
BLZ,Belize,CHE,Switzerland,2012,2,0,2
BLZ,Belize,CHE,Switzerland,2013,0,0,0
BLZ,Belize,CHE,Switzerland,2014,1,1,0
BLZ,Belize,CHE,Switzerland,2015,0,1,-1
BLZ,Belize,CHE,Switzerland,2016,7,0,7
BLZ,Belize,CHE,Switzerland,2017,0,3,-3
BLZ,Belize,TUR,Turkey,2010,1,0,1
BLZ,Belize,USA,United States,2008,1077,0,1077
BLZ,Belize,USA,United States,2009,1041,0,1041
BLZ,Belize,USA,United States,2010,965,0,965
BLZ,Belize,USA,United States,2011,905,0,905
BLZ,Belize,USA,United States,2012,847,0,847
BLZ,Belize,USA,United States,2013,946,0,946
BLZ,Belize,USA,United States,2014,789,0,789
BLZ,Belize,USA,United States,2015,772,0,772
BLZ,Belize,USA,United States,2016,851,0,851
BLZ,Belize,USA,United States,2017,746,0,746
BLZ,Belize,CHL,Chile,2008,1,0,1
BLZ,Belize,CHL,Chile,2009,0,0,0
BLZ,Belize,CHL,Chile,2010,1,0,1
BLZ,Belize,CHL,Chile,2011,2,0,2
BLZ,Belize,CHL,Chile,2012,4,0,4
BLZ,Belize,CHL,Chile,2013,0,0,0
BLZ,Belize,CHL,Chile,2014,6,0,6
BLZ,Belize,CHL,Chile,2015,4,0,4
BLZ,Belize,CHL,Chile,2016,2,0,2
BLZ,Belize,EST,Estonia,2008,0,0,0
BLZ,Belize,EST,Estonia,2009,0,0,0
BLZ,Belize,EST,Estonia,2010,0,0,0
BLZ,Belize,EST,Estonia,2011,0,0,0
BLZ,Belize,EST,Estonia,2012,0,0,0
BLZ,Belize,EST,Estonia,2013,0,0,0
BLZ,Belize,EST,Estonia,2014,0,0,0
BLZ,Belize,EST,Estonia,2015,0,0,0
BLZ,Belize,EST,Estonia,2016,0,0,0
BLZ,Belize,EST,Estonia,2017,0,0,0
BLZ,Belize,SVN,Slovenia,2009,1,0,1
BLZ,Belize,SVN,Slovenia,2010,1,0,1
BEN,Benin,AUS,Australia,2008,0,0,0
BEN,Benin,AUS,Australia,2009,0,0,0
BEN,Benin,AUS,Australia,2010,0,0,0
BEN,Benin,AUS,Australia,2011,2,0,2
BEN,Benin,AUS,Australia,2012,8,0,8
BEN,Benin,AUS,Australia,2013,4,0,4
BEN,Benin,AUS,Australia,2014,0,0,0
BEN,Benin,AUS,Australia,2015,0,0,0
BEN,Benin,AUS,Australia,2016,0,0,0
BEN,Benin,AUS,Australia,2017,0,0,0
BEN,Benin,AUT,Austria,2008,7,4,3
BEN,Benin,AUT,Austria,2009,6,5,1
BEN,Benin,AUT,Austria,2010,6,5,1
BEN,Benin,AUT,Austria,2011,8,8,0
BEN,Benin,AUT,Austria,2012,11,5,6
BEN,Benin,AUT,Austria,2013,13,7,6
BEN,Benin,AUT,Austria,2014,29,10,19
BEN,Benin,AUT,Austria,2015,32,4,28
BEN,Benin,AUT,Austria,2016,23,15,8
BEN,Benin,AUT,Austria,2017,27,18,9
BEN,Benin,BEL,Belgium,2008,96,0,96
BEN,Benin,BEL,Belgium,2009,110,0,110
BEN,Benin,BEL,Belgium,2010,140,52,88
BEN,Benin,BEL,Belgium,2011,145,0,145
BEN,Benin,BEL,Belgium,2012,211,74,137
BEN,Benin,BEL,Belgium,2013,174,123,51
BEN,Benin,BEL,Belgium,2014,106,114,-8
BEN,Benin,BEL,Belgium,2015,111,97,14
BEN,Benin,BEL,Belgium,2016,126,67,59
BEN,Benin,BEL,Belgium,2017,138,52,86
BEN,Benin,CAN,Canada,2008,205,0,205
BEN,Benin,CAN,Canada,2009,238,0,238
BEN,Benin,CAN,Canada,2010,290,0,290
BEN,Benin,CAN,Canada,2011,284,0,284
BEN,Benin,CAN,Canada,2012,390,0,390
BEN,Benin,CAN,Canada,2013,397,0,397
BEN,Benin,CAN,Canada,2014,242,0,242
BEN,Benin,CAN,Canada,2015,259,0,259
BEN,Benin,CAN,Canada,2016,300,0,300
BEN,Benin,CAN,Canada,2017,195,0,195
BEN,Benin,CZE,Czech Republic,2008,4,0,4
BEN,Benin,CZE,Czech Republic,2009,7,0,7
BEN,Benin,CZE,Czech Republic,2010,2,0,2
BEN,Benin,CZE,Czech Republic,2012,1,0,1
BEN,Benin,CZE,Czech Republic,2013,1,1,0
BEN,Benin,CZE,Czech Republic,2014,6,4,2
BEN,Benin,CZE,Czech Republic,2015,2,3,-1
BEN,Benin,DNK,Denmark,2008,9,5,4
BEN,Benin,DNK,Denmark,2009,2,0,2
BEN,Benin,DNK,Denmark,2010,2,4,-2
BEN,Benin,DNK,Denmark,2011,1,4,-3
BEN,Benin,DNK,Denmark,2012,0,2,-2
BEN,Benin,DNK,Denmark,2013,2,3,-1
BEN,Benin,DNK,Denmark,2014,6,2,4
BEN,Benin,DNK,Denmark,2015,9,4,5
BEN,Benin,DNK,Denmark,2016,2,3,-1
BEN,Benin,DNK,Denmark,2017,2,3,-1
BEN,Benin,FIN,Finland,2008,1,0,1
BEN,Benin,FIN,Finland,2009,1,0,1
BEN,Benin,FIN,Finland,2010,2,0,2
BEN,Benin,FIN,Finland,2011,5,0,5
BEN,Benin,FIN,Finland,2012,3,0,3
BEN,Benin,FIN,Finland,2013,2,0,2
BEN,Benin,FIN,Finland,2014,2,1,1
BEN,Benin,FIN,Finland,2015,0,0,0
BEN,Benin,FIN,Finland,2016,1,2,-1
BEN,Benin,FIN,Finland,2017,0,0,0
BEN,Benin,FRA,France,2008,664,0,664
BEN,Benin,FRA,France,2009,709,0,709
BEN,Benin,FRA,France,2010,649,0,649
BEN,Benin,FRA,France,2011,712,0,712
BEN,Benin,FRA,France,2012,714,0,714
BEN,Benin,FRA,France,2013,727,0,727
BEN,Benin,FRA,France,2014,829,0,829
BEN,Benin,FRA,France,2015,591,0,591
BEN,Benin,FRA,France,2016,571,0,571
BEN,Benin,FRA,France,2017,560,0,560
BEN,Benin,DEU,Germany,2008,192,117,75
BEN,Benin,DEU,Germany,2009,196,181,15
BEN,Benin,DEU,Germany,2010,233,127,106
BEN,Benin,DEU,Germany,2011,216,111,105
BEN,Benin,DEU,Germany,2012,301,179,122
BEN,Benin,DEU,Germany,2013,323,245,78
BEN,Benin,DEU,Germany,2014,405,181,224
BEN,Benin,DEU,Germany,2015,569,199,370
BEN,Benin,DEU,Germany,2016,380,249,131
BEN,Benin,DEU,Germany,2017,400,329,71
BEN,Benin,HUN,Hungary,2008,0,0,0
BEN,Benin,HUN,Hungary,2009,0,0,0
BEN,Benin,HUN,Hungary,2010,0,0,0
BEN,Benin,HUN,Hungary,2011,0,0,0
BEN,Benin,HUN,Hungary,2012,1,0,1
BEN,Benin,HUN,Hungary,2013,1,0,1
BEN,Benin,HUN,Hungary,2014,0,0,0
BEN,Benin,HUN,Hungary,2015,1,0,1
BEN,Benin,HUN,Hungary,2016,4,0,4
BEN,Benin,HUN,Hungary,2017,4,0,4
BEN,Benin,ISL,Iceland,2008,0,0,0
BEN,Benin,ISL,Iceland,2009,0,0,0
BEN,Benin,ISL,Iceland,2010,0,0,0
BEN,Benin,ISL,Iceland,2011,0,0,0
BEN,Benin,ISL,Iceland,2012,0,0,0
BEN,Benin,ISL,Iceland,2013,0,0,0
BEN,Benin,ISL,Iceland,2014,0,0,0
BEN,Benin,ISL,Iceland,2015,1,0,1
BEN,Benin,ISL,Iceland,2016,0,0,0
BEN,Benin,ISL,Iceland,2017,0,0,0
BEN,Benin,ITA,Italy,2008,143,6,137
BEN,Benin,ITA,Italy,2009,178,6,172
BEN,Benin,ITA,Italy,2010,231,32,199
BEN,Benin,ITA,Italy,2011,153,12,141
BEN,Benin,ITA,Italy,2012,181,19,162
BEN,Benin,ITA,Italy,2013,149,13,136
BEN,Benin,ITA,Italy,2014,122,20,102
BEN,Benin,ITA,Italy,2015,171,19,152
BEN,Benin,ITA,Italy,2016,310,0,310
BEN,Benin,ITA,Italy,2017,302,14,288
BEN,Benin,JPN,Japan,2008,82,82,0
BEN,Benin,JPN,Japan,2009,60,48,12
BEN,Benin,JPN,Japan,2010,59,52,7
BEN,Benin,JPN,Japan,2011,51,48,3
BEN,Benin,JPN,Japan,2012,77,75,2
BEN,Benin,JPN,Japan,2013,123,120,3
BEN,Benin,JPN,Japan,2014,53,46,7
BEN,Benin,JPN,Japan,2015,89,74,15
BEN,Benin,JPN,Japan,2016,71,54,17
BEN,Benin,JPN,Japan,2017,67,49,18
BEN,Benin,KOR,Korea,2008,4,1,3
BEN,Benin,KOR,Korea,2009,7,9,-2
BEN,Benin,KOR,Korea,2010,2,1,1
BEN,Benin,KOR,Korea,2011,3,3,0
BEN,Benin,KOR,Korea,2012,7,6,1
BEN,Benin,KOR,Korea,2013,3,3,0
BEN,Benin,KOR,Korea,2014,5,2,3
BEN,Benin,KOR,Korea,2015,6,5,1
BEN,Benin,KOR,Korea,2016,5,6,-1
BEN,Benin,KOR,Korea,2017,7,8,-1
BEN,Benin,LUX,Luxembourg,2008,4,2,2
BEN,Benin,LUX,Luxembourg,2009,7,1,6
BEN,Benin,LUX,Luxembourg,2010,3,1,2
BEN,Benin,LUX,Luxembourg,2011,5,1,4
BEN,Benin,LUX,Luxembourg,2012,7,0,7
BEN,Benin,LUX,Luxembourg,2013,13,6,7
BEN,Benin,LUX,Luxembourg,2014,6,6,0
BEN,Benin,LUX,Luxembourg,2015,5,5,0
BEN,Benin,LUX,Luxembourg,2016,8,2,6
BEN,Benin,LUX,Luxembourg,2017,15,1,14
BEN,Benin,MEX,Mexico,2010,2,0,2
BEN,Benin,MEX,Mexico,2011,1,0,1
BEN,Benin,MEX,Mexico,2012,0,0,0
BEN,Benin,MEX,Mexico,2013,0,0,0
BEN,Benin,MEX,Mexico,2014,2,0,2
BEN,Benin,MEX,Mexico,2015,1,0,1
BEN,Benin,MEX,Mexico,2017,1,0,1
BEN,Benin,NLD,Netherlands,2008,15,5,10
BEN,Benin,NLD,Netherlands,2009,13,7,6
BEN,Benin,NLD,Netherlands,2010,17,18,-1
BEN,Benin,NLD,Netherlands,2011,20,5,15
BEN,Benin,NLD,Netherlands,2012,16,9,7
BEN,Benin,NLD,Netherlands,2013,18,18,0
BEN,Benin,NLD,Netherlands,2014,14,10,4
BEN,Benin,NLD,Netherlands,2015,17,11,6
BEN,Benin,NLD,Netherlands,2016,10,10,0
BEN,Benin,NLD,Netherlands,2017,15,8,7
BEN,Benin,NOR,Norway,2008,0,0,0
BEN,Benin,NOR,Norway,2009,0,0,0
BEN,Benin,NOR,Norway,2010,1,0,1
BEN,Benin,NOR,Norway,2011,5,0,5
BEN,Benin,NOR,Norway,2012,2,0,2
BEN,Benin,NOR,Norway,2013,3,1,2
BEN,Benin,NOR,Norway,2014,0,3,-3
BEN,Benin,NOR,Norway,2015,0,0,0
BEN,Benin,NOR,Norway,2016,1,0,1
BEN,Benin,NOR,Norway,2017,1,0,1
BEN,Benin,POL,Poland,2009,6,0,6
BEN,Benin,POL,Poland,2010,0,0,0
BEN,Benin,POL,Poland,2011,4,0,4
BEN,Benin,POL,Poland,2012,5,0,5
BEN,Benin,POL,Poland,2013,1,0,1
BEN,Benin,POL,Poland,2014,4,0,4
BEN,Benin,POL,Poland,2015,2,0,2
BEN,Benin,POL,Poland,2016,3,0,3
BEN,Benin,POL,Poland,2017,3,0,3
BEN,Benin,SVK,Slovak Republic,2008,1,0,1
BEN,Benin,SVK,Slovak Republic,2009,1,1,0
BEN,Benin,SVK,Slovak Republic,2010,4,0,4
BEN,Benin,ESP,Spain,2008,50,24,26
BEN,Benin,ESP,Spain,2009,33,48,-15
BEN,Benin,ESP,Spain,2010,29,34,-5
BEN,Benin,ESP,Spain,2011,34,50,-16
BEN,Benin,ESP,Spain,2012,31,21,10
BEN,Benin,ESP,Spain,2013,28,31,-3
BEN,Benin,ESP,Spain,2014,30,8,22
BEN,Benin,ESP,Spain,2015,31,5,26
BEN,Benin,ESP,Spain,2016,28,15,13
BEN,Benin,ESP,Spain,2017,30,25,5
BEN,Benin,SWE,Sweden,2008,8,0,8
BEN,Benin,SWE,Sweden,2009,7,0,7
BEN,Benin,SWE,Sweden,2010,13,2,11
BEN,Benin,SWE,Sweden,2011,3,3,0
BEN,Benin,SWE,Sweden,2012,7,0,7
BEN,Benin,SWE,Sweden,2013,3,2,1
BEN,Benin,SWE,Sweden,2014,2,1,1
BEN,Benin,SWE,Sweden,2015,4,3,1
BEN,Benin,SWE,Sweden,2016,6,2,4
BEN,Benin,SWE,Sweden,2017,6,0,6
BEN,Benin,CHE,Switzerland,2010,31,18,13
BEN,Benin,CHE,Switzerland,2011,26,5,21
BEN,Benin,CHE,Switzerland,2012,29,12,17
BEN,Benin,CHE,Switzerland,2013,40,12,28
BEN,Benin,CHE,Switzerland,2014,20,10,10
BEN,Benin,CHE,Switzerland,2015,25,6,19
BEN,Benin,CHE,Switzerland,2016,37,10,27
BEN,Benin,CHE,Switzerland,2017,39,10,29
BEN,Benin,TUR,Turkey,2010,3,0,3
BEN,Benin,USA,United States,2008,317,0,317
BEN,Benin,USA,United States,2009,401,0,401
BEN,Benin,USA,United States,2010,486,0,486
BEN,Benin,USA,United States,2011,462,0,462
BEN,Benin,USA,United States,2012,415,0,415
BEN,Benin,USA,United States,2013,342,0,342
BEN,Benin,USA,United States,2014,517,0,517
BEN,Benin,USA,United States,2015,466,0,466
BEN,Benin,USA,United States,2016,577,0,577
BEN,Benin,USA,United States,2017,648,0,648
BEN,Benin,CHL,Chile,2008,0,0,0
BEN,Benin,CHL,Chile,2009,2,0,2
BEN,Benin,CHL,Chile,2010,0,0,0
BEN,Benin,CHL,Chile,2011,0,0,0
BEN,Benin,CHL,Chile,2012,0,0,0
BEN,Benin,CHL,Chile,2013,0,0,0
BEN,Benin,CHL,Chile,2014,0,0,0
BEN,Benin,CHL,Chile,2015,2,0,2
BEN,Benin,CHL,Chile,2016,1,0,1
BEN,Benin,EST,Estonia,2008,0,0,0
BEN,Benin,EST,Estonia,2009,0,0,0
BEN,Benin,EST,Estonia,2010,0,0,0
BEN,Benin,EST,Estonia,2011,0,0,0
BEN,Benin,EST,Estonia,2012,0,0,0
BEN,Benin,EST,Estonia,2013,0,0,0
BEN,Benin,EST,Estonia,2014,0,0,0
BEN,Benin,EST,Estonia,2015,0,0,0
BEN,Benin,EST,Estonia,2016,1,0,1
BEN,Benin,EST,Estonia,2017,0,0,0
BEN,Benin,SVN,Slovenia,2013,1,0,1
BMU,Bermuda,AUS,Australia,2008,1,0,1
BMU,Bermuda,AUS,Australia,2009,1,0,1
BMU,Bermuda,AUS,Australia,2010,0,0,0
BMU,Bermuda,AUS,Australia,2011,0,0,0
BMU,Bermuda,AUS,Australia,2012,0,0,0
BMU,Bermuda,AUS,Australia,2013,0,0,0
BMU,Bermuda,AUS,Australia,2014,0,0,0
BMU,Bermuda,AUS,Australia,2015,0,0,0
BMU,Bermuda,AUS,Australia,2016,0,0,0
BMU,Bermuda,AUS,Australia,2017,3,0,3
BMU,Bermuda,AUT,Austria,2014,0,0,0
BMU,Bermuda,AUT,Austria,2015,0,0,0
BMU,Bermuda,AUT,Austria,2016,0,0,0
BMU,Bermuda,AUT,Austria,2017,0,0,0
BMU,Bermuda,BEL,Belgium,2010,0,0,0
BMU,Bermuda,CAN,Canada,2008,0,0,0
BMU,Bermuda,CAN,Canada,2009,0,0,0
BMU,Bermuda,CAN,Canada,2010,0,0,0
BMU,Bermuda,CAN,Canada,2011,0,0,0
BMU,Bermuda,CAN,Canada,2012,0,0,0
BMU,Bermuda,CAN,Canada,2013,0,0,0
BMU,Bermuda,CAN,Canada,2014,0,0,0
BMU,Bermuda,CAN,Canada,2015,0,0,0
BMU,Bermuda,CAN,Canada,2016,0,0,0
BMU,Bermuda,CAN,Canada,2017,0,0,0
BMU,Bermuda,DNK,Denmark,2013,0,0,0
BMU,Bermuda,DNK,Denmark,2014,0,0,0
BMU,Bermuda,DNK,Denmark,2015,0,0,0
BMU,Bermuda,DNK,Denmark,2016,0,0,0
BMU,Bermuda,DNK,Denmark,2017,0,0,0
BMU,Bermuda,FIN,Finland,2008,0,0,0
BMU,Bermuda,FIN,Finland,2009,0,0,0
BMU,Bermuda,FIN,Finland,2010,0,0,0
BMU,Bermuda,FIN,Finland,2011,0,0,0
BMU,Bermuda,FIN,Finland,2012,0,0,0
BMU,Bermuda,FIN,Finland,2013,0,0,0
BMU,Bermuda,FIN,Finland,2014,0,0,0
BMU,Bermuda,FIN,Finland,2015,0,0,0
BMU,Bermuda,FIN,Finland,2016,0,0,0
BMU,Bermuda,FIN,Finland,2017,0,0,0
BMU,Bermuda,FRA,France,2008,0,0,0
BMU,Bermuda,FRA,France,2009,0,0,0
BMU,Bermuda,FRA,France,2010,0,0,0
BMU,Bermuda,FRA,France,2011,0,0,0
BMU,Bermuda,FRA,France,2012,0,0,0
BMU,Bermuda,FRA,France,2013,0,0,0
BMU,Bermuda,FRA,France,2014,0,0,0
BMU,Bermuda,FRA,France,2015,0,0,0
BMU,Bermuda,FRA,France,2016,0,0,0
BMU,Bermuda,FRA,France,2017,0,0,0
BMU,Bermuda,HUN,Hungary,2008,0,0,0
BMU,Bermuda,HUN,Hungary,2009,0,0,0
BMU,Bermuda,HUN,Hungary,2010,0,0,0
BMU,Bermuda,HUN,Hungary,2011,0,0,0
BMU,Bermuda,HUN,Hungary,2012,0,0,0
BMU,Bermuda,HUN,Hungary,2013,0,0,0
BMU,Bermuda,HUN,Hungary,2014,0,0,0
BMU,Bermuda,HUN,Hungary,2015,0,0,0
BMU,Bermuda,HUN,Hungary,2016,0,0,0
BMU,Bermuda,HUN,Hungary,2017,0,0,0
BMU,Bermuda,ISL,Iceland,2008,0,0,0
BMU,Bermuda,ISL,Iceland,2009,0,0,0
BMU,Bermuda,ISL,Iceland,2010,0,0,0
BMU,Bermuda,ISL,Iceland,2011,0,0,0
BMU,Bermuda,ISL,Iceland,2012,0,0,0
BMU,Bermuda,ISL,Iceland,2016,0,0,0
BMU,Bermuda,ISL,Iceland,2017,0,0,0
BMU,Bermuda,ITA,Italy,2008,0,0,0
BMU,Bermuda,ITA,Italy,2009,0,0,0
BMU,Bermuda,ITA,Italy,2010,0,0,0
BMU,Bermuda,ITA,Italy,2011,0,0,0
BMU,Bermuda,ITA,Italy,2012,0,0,0
BMU,Bermuda,ITA,Italy,2013,0,0,0
BMU,Bermuda,ITA,Italy,2015,0,0,0
BMU,Bermuda,JPN,Japan,2008,0,0,0
BMU,Bermuda,JPN,Japan,2009,0,0,0
BMU,Bermuda,JPN,Japan,2010,0,0,0
BMU,Bermuda,JPN,Japan,2011,0,0,0
BMU,Bermuda,JPN,Japan,2012,0,0,0
BMU,Bermuda,JPN,Japan,2013,0,0,0
BMU,Bermuda,JPN,Japan,2014,0,0,0
BMU,Bermuda,JPN,Japan,2015,0,0,0
BMU,Bermuda,JPN,Japan,2016,0,0,0
BMU,Bermuda,JPN,Japan,2017,0,0,0
BMU,Bermuda,KOR,Korea,2008,0,0,0
BMU,Bermuda,KOR,Korea,2009,0,0,0
BMU,Bermuda,KOR,Korea,2010,0,0,0
BMU,Bermuda,KOR,Korea,2011,0,0,0
BMU,Bermuda,KOR,Korea,2012,0,0,0
BMU,Bermuda,KOR,Korea,2013,0,0,0
BMU,Bermuda,KOR,Korea,2014,0,0,0
BMU,Bermuda,KOR,Korea,2015,0,0,0
BMU,Bermuda,KOR,Korea,2016,0,0,0
BMU,Bermuda,KOR,Korea,2017,0,0,0
BMU,Bermuda,LUX,Luxembourg,2008,0,0,0
BMU,Bermuda,LUX,Luxembourg,2009,0,0,0
BMU,Bermuda,LUX,Luxembourg,2010,0,0,0
BMU,Bermuda,LUX,Luxembourg,2011,0,0,0
BMU,Bermuda,LUX,Luxembourg,2012,0,0,0
BMU,Bermuda,LUX,Luxembourg,2013,0,0,0
BMU,Bermuda,LUX,Luxembourg,2014,0,0,0
BMU,Bermuda,LUX,Luxembourg,2015,0,0,0
BMU,Bermuda,LUX,Luxembourg,2016,0,0,0
BMU,Bermuda,LUX,Luxembourg,2017,0,0,0
BMU,Bermuda,MEX,Mexico,2012,1,0,1
BMU,Bermuda,MEX,Mexico,2013,0,0,0
BMU,Bermuda,MEX,Mexico,2014,1,0,1
BMU,Bermuda,MEX,Mexico,2017,2,0,2
BMU,Bermuda,NZL,New Zealand,2008,1,0,1
BMU,Bermuda,NZL,New Zealand,2011,1,0,1
BMU,Bermuda,NOR,Norway,2008,0,0,0
BMU,Bermuda,NOR,Norway,2009,0,0,0
BMU,Bermuda,NOR,Norway,2010,0,0,0
BMU,Bermuda,NOR,Norway,2011,0,0,0
BMU,Bermuda,NOR,Norway,2012,0,0,0
BMU,Bermuda,NOR,Norway,2013,0,0,0
BMU,Bermuda,NOR,Norway,2014,0,0,0
BMU,Bermuda,NOR,Norway,2015,0,0,0
BMU,Bermuda,NOR,Norway,2016,0,0,0
BMU,Bermuda,NOR,Norway,2017,0,0,0
BMU,Bermuda,POL,Poland,2009,0,0,0
BMU,Bermuda,POL,Poland,2010,0,0,0
BMU,Bermuda,POL,Poland,2011,0,0,0
BMU,Bermuda,POL,Poland,2012,0,0,0
BMU,Bermuda,POL,Poland,2013,0,0,0
BMU,Bermuda,POL,Poland,2014,0,0,0
BMU,Bermuda,POL,Poland,2015,0,0,0
BMU,Bermuda,POL,Poland,2016,0,0,0
BMU,Bermuda,POL,Poland,2017,0,0,0
BMU,Bermuda,ESP,Spain,2008,0,0,0
BMU,Bermuda,ESP,Spain,2009,0,0,0
BMU,Bermuda,ESP,Spain,2010,0,0,0
BMU,Bermuda,ESP,Spain,2011,0,0,0
BMU,Bermuda,ESP,Spain,2012,0,0,0
BMU,Bermuda,ESP,Spain,2013,0,0,0
BMU,Bermuda,SWE,Sweden,2008,0,0,0
BMU,Bermuda,SWE,Sweden,2009,0,0,0
BMU,Bermuda,SWE,Sweden,2010,0,0,0
BMU,Bermuda,SWE,Sweden,2011,0,0,0
BMU,Bermuda,SWE,Sweden,2012,0,0,0
BMU,Bermuda,SWE,Sweden,2013,0,0,0
BMU,Bermuda,SWE,Sweden,2014,0,0,0
BMU,Bermuda,SWE,Sweden,2015,0,0,0
BMU,Bermuda,GBR,United Kingdom,2013,1000,0,1000
BMU,Bermuda,USA,United States,2008,92,0,92
BMU,Bermuda,USA,United States,2009,108,0,108
BMU,Bermuda,USA,United States,2010,72,0,72
BMU,Bermuda,USA,United States,2011,71,0,71
BMU,Bermuda,USA,United States,2012,85,0,85
BMU,Bermuda,USA,United States,2013,88,0,88
BMU,Bermuda,USA,United States,2014,106,0,106
BMU,Bermuda,USA,United States,2015,112,0,112
BMU,Bermuda,USA,United States,2016,99,0,99
BMU,Bermuda,USA,United States,2017,68,0,68
BMU,Bermuda,CHL,Chile,2008,1,0,1
BMU,Bermuda,CHL,Chile,2009,0,0,0
BMU,Bermuda,CHL,Chile,2010,0,0,0
BMU,Bermuda,CHL,Chile,2011,0,0,0
BMU,Bermuda,CHL,Chile,2012,0,0,0
BMU,Bermuda,CHL,Chile,2013,0,0,0
BMU,Bermuda,CHL,Chile,2014,0,0,0
BMU,Bermuda,CHL,Chile,2015,0,0,0
BMU,Bermuda,CHL,Chile,2016,0,0,0
BMU,Bermuda,EST,Estonia,2008,0,0,0
BMU,Bermuda,EST,Estonia,2009,0,0,0
BMU,Bermuda,EST,Estonia,2010,0,0,0
BMU,Bermuda,EST,Estonia,2011,0,0,0
BMU,Bermuda,EST,Estonia,2012,0,0,0
BMU,Bermuda,EST,Estonia,2013,0,0,0
BMU,Bermuda,EST,Estonia,2014,0,0,0
BMU,Bermuda,EST,Estonia,2015,0,0,0
BMU,Bermuda,EST,Estonia,2016,0,0,0
BMU,Bermuda,EST,Estonia,2017,0,0,0
BTN,Bhutan,AUS,Australia,2008,26,0,26
BTN,Bhutan,AUS,Australia,2009,767,0,767
BTN,Bhutan,AUS,Australia,2010,782,0,782
BTN,Bhutan,AUS,Australia,2011,1113,0,1113
BTN,Bhutan,AUS,Australia,2012,863,0,863
BTN,Bhutan,AUS,Australia,2013,808,0,808
BTN,Bhutan,AUS,Australia,2014,845,0,845
BTN,Bhutan,AUS,Australia,2015,307,0,307
BTN,Bhutan,AUS,Australia,2016,469,0,469
BTN,Bhutan,AUS,Australia,2017,734,0,734
BTN,Bhutan,AUT,Austria,2008,6,8,-2
BTN,Bhutan,AUT,Austria,2009,7,8,-1
BTN,Bhutan,AUT,Austria,2010,9,7,2
BTN,Bhutan,AUT,Austria,2011,11,15,-4
BTN,Bhutan,AUT,Austria,2012,9,11,-2
BTN,Bhutan,AUT,Austria,2013,9,7,2
BTN,Bhutan,AUT,Austria,2014,8,6,2
BTN,Bhutan,AUT,Austria,2015,16,9,7
BTN,Bhutan,AUT,Austria,2016,12,17,-5
BTN,Bhutan,AUT,Austria,2017,12,9,3
BTN,Bhutan,BEL,Belgium,2008,7,0,7
BTN,Bhutan,BEL,Belgium,2009,8,0,8
BTN,Bhutan,BEL,Belgium,2010,4,2,2
BTN,Bhutan,BEL,Belgium,2012,7,21,-14
BTN,Bhutan,BEL,Belgium,2013,4,19,-15
BTN,Bhutan,BEL,Belgium,2014,1,14,-13
BTN,Bhutan,BEL,Belgium,2015,1,13,-12
BTN,Bhutan,BEL,Belgium,2016,2,5,-3
BTN,Bhutan,BEL,Belgium,2017,1,1,0
BTN,Bhutan,CAN,Canada,2008,36,0,36
BTN,Bhutan,CAN,Canada,2009,865,0,865
BTN,Bhutan,CAN,Canada,2010,1464,0,1464
BTN,Bhutan,CAN,Canada,2011,1879,0,1879
BTN,Bhutan,CAN,Canada,2012,1075,0,1075
BTN,Bhutan,CAN,Canada,2013,487,0,487
BTN,Bhutan,CAN,Canada,2014,356,0,356
BTN,Bhutan,CAN,Canada,2015,387,0,387
BTN,Bhutan,CAN,Canada,2016,115,0,115
BTN,Bhutan,CAN,Canada,2017,65,0,65
BTN,Bhutan,CZE,Czech Republic,2008,1,0,1
BTN,Bhutan,CZE,Czech Republic,2009,1,0,1
BTN,Bhutan,CZE,Czech Republic,2014,2,0,2
BTN,Bhutan,CZE,Czech Republic,2015,2,0,2
BTN,Bhutan,CZE,Czech Republic,2016,1,0,1
BTN,Bhutan,DNK,Denmark,2008,15,7,8
BTN,Bhutan,DNK,Denmark,2009,295,0,295
BTN,Bhutan,DNK,Denmark,2010,11,3,8
BTN,Bhutan,DNK,Denmark,2011,177,3,174
BTN,Bhutan,DNK,Denmark,2012,1,8,-7
BTN,Bhutan,DNK,Denmark,2013,9,0,9
BTN,Bhutan,DNK,Denmark,2014,2,3,-1
BTN,Bhutan,DNK,Denmark,2015,1,1,0
BTN,Bhutan,DNK,Denmark,2016,1,0,1
BTN,Bhutan,DNK,Denmark,2017,2,2,0
BTN,Bhutan,FIN,Finland,2008,0,0,0
BTN,Bhutan,FIN,Finland,2009,0,0,0
BTN,Bhutan,FIN,Finland,2010,0,0,0
BTN,Bhutan,FIN,Finland,2011,1,0,1
BTN,Bhutan,FIN,Finland,2012,0,1,-1
BTN,Bhutan,FIN,Finland,2013,0,0,0
BTN,Bhutan,FIN,Finland,2014,0,0,0
BTN,Bhutan,FIN,Finland,2015,0,0,0
BTN,Bhutan,FIN,Finland,2016,0,0,0
BTN,Bhutan,FIN,Finland,2017,0,0,0
BTN,Bhutan,FRA,France,2008,11,0,11
BTN,Bhutan,FRA,France,2009,15,0,15
BTN,Bhutan,FRA,France,2010,42,0,42
BTN,Bhutan,FRA,France,2011,23,0,23
BTN,Bhutan,FRA,France,2012,22,0,22
BTN,Bhutan,FRA,France,2013,33,0,33
BTN,Bhutan,FRA,France,2014,23,0,23
BTN,Bhutan,FRA,France,2015,15,0,15
BTN,Bhutan,FRA,France,2016,12,0,12
BTN,Bhutan,FRA,France,2017,8,0,8
BTN,Bhutan,DEU,Germany,2008,17,25,-8
BTN,Bhutan,DEU,Germany,2009,22,24,-2
BTN,Bhutan,DEU,Germany,2010,25,32,-7
BTN,Bhutan,DEU,Germany,2011,20,19,1
BTN,Bhutan,DEU,Germany,2012,16,22,-6
BTN,Bhutan,DEU,Germany,2013,24,14,10
BTN,Bhutan,DEU,Germany,2014,19,12,7
BTN,Bhutan,DEU,Germany,2015,20,20,0
BTN,Bhutan,DEU,Germany,2016,11,16,-5
BTN,Bhutan,DEU,Germany,2017,15,11,4
BTN,Bhutan,HUN,Hungary,2008,0,0,0
BTN,Bhutan,HUN,Hungary,2009,1,0,1
BTN,Bhutan,HUN,Hungary,2010,0,0,0
BTN,Bhutan,HUN,Hungary,2011,0,0,0
BTN,Bhutan,HUN,Hungary,2012,0,0,0
BTN,Bhutan,HUN,Hungary,2013,1,0,1
BTN,Bhutan,HUN,Hungary,2014,0,0,0
BTN,Bhutan,HUN,Hungary,2015,0,0,0
BTN,Bhutan,HUN,Hungary,2016,7,1,6
BTN,Bhutan,HUN,Hungary,2017,1,0,1
BTN,Bhutan,ISL,Iceland,2016,0,0,0
BTN,Bhutan,ISL,Iceland,2017,0,0,0
BTN,Bhutan,ITA,Italy,2008,6,0,6
BTN,Bhutan,ITA,Italy,2009,4,0,4
BTN,Bhutan,ITA,Italy,2010,3,0,3
BTN,Bhutan,ITA,Italy,2011,0,0,0
BTN,Bhutan,ITA,Italy,2012,3,0,3
BTN,Bhutan,ITA,Italy,2013,13,2,11
BTN,Bhutan,ITA,Italy,2014,7,0,7
BTN,Bhutan,ITA,Italy,2015,0,0,0
BTN,Bhutan,ITA,Italy,2016,1,0,1
BTN,Bhutan,ITA,Italy,2017,5,0,5
BTN,Bhutan,JPN,Japan,2008,124,120,4
BTN,Bhutan,JPN,Japan,2009,177,179,-2
BTN,Bhutan,JPN,Japan,2010,208,205,3
BTN,Bhutan,JPN,Japan,2011,265,266,-1
BTN,Bhutan,JPN,Japan,2012,216,212,4
BTN,Bhutan,JPN,Japan,2013,234,225,9
BTN,Bhutan,JPN,Japan,2014,216,214,2
BTN,Bhutan,JPN,Japan,2015,283,261,22
BTN,Bhutan,JPN,Japan,2016,315,285,30
BTN,Bhutan,JPN,Japan,2017,884,363,521
BTN,Bhutan,KOR,Korea,2008,21,25,-4
BTN,Bhutan,KOR,Korea,2009,16,15,1
BTN,Bhutan,KOR,Korea,2010,15,13,2
BTN,Bhutan,KOR,Korea,2011,14,14,0
BTN,Bhutan,KOR,Korea,2012,17,15,2
BTN,Bhutan,KOR,Korea,2013,12,18,-6
BTN,Bhutan,KOR,Korea,2014,12,15,-3
BTN,Bhutan,KOR,Korea,2015,14,15,-1
BTN,Bhutan,KOR,Korea,2016,15,11,4
BTN,Bhutan,KOR,Korea,2017,32,21,11
BTN,Bhutan,LUX,Luxembourg,2008,0,0,0
BTN,Bhutan,LUX,Luxembourg,2009,1,0,1
BTN,Bhutan,LUX,Luxembourg,2010,0,0,0
BTN,Bhutan,LUX,Luxembourg,2011,0,0,0
BTN,Bhutan,LUX,Luxembourg,2012,1,0,1
BTN,Bhutan,LUX,Luxembourg,2013,0,0,0
BTN,Bhutan,LUX,Luxembourg,2014,0,0,0
BTN,Bhutan,LUX,Luxembourg,2015,0,0,0
BTN,Bhutan,LUX,Luxembourg,2016,0,2,-2
BTN,Bhutan,LUX,Luxembourg,2017,0,0,0
BTN,Bhutan,MEX,Mexico,2012,0,0,0
BTN,Bhutan,MEX,Mexico,2013,0,0,0
BTN,Bhutan,MEX,Mexico,2014,1,0,1
BTN,Bhutan,MEX,Mexico,2017,3,0,3
BTN,Bhutan,NLD,Netherlands,2008,28,32,-4
BTN,Bhutan,NLD,Netherlands,2009,42,26,16
BTN,Bhutan,NLD,Netherlands,2010,38,30,8
BTN,Bhutan,NLD,Netherlands,2011,20,30,-10
BTN,Bhutan,NLD,Netherlands,2012,16,13,3
BTN,Bhutan,NLD,Netherlands,2013,20,38,-18
BTN,Bhutan,NLD,Netherlands,2014,9,10,-1
BTN,Bhutan,NLD,Netherlands,2015,19,16,3
BTN,Bhutan,NLD,Netherlands,2016,12,12,0
BTN,Bhutan,NLD,Netherlands,2017,9,17,-8
BTN,Bhutan,NZL,New Zealand,2008,126,1,125
BTN,Bhutan,NZL,New Zealand,2009,169,3,166
BTN,Bhutan,NZL,New Zealand,2010,195,0,195
BTN,Bhutan,NZL,New Zealand,2011,92,0,92
BTN,Bhutan,NZL,New Zealand,2012,120,1,119
BTN,Bhutan,NZL,New Zealand,2013,152,3,149
BTN,Bhutan,NZL,New Zealand,2014,83,2,81
BTN,Bhutan,NZL,New Zealand,2015,57,1,56
BTN,Bhutan,NZL,New Zealand,2016,60,0,60
BTN,Bhutan,NZL,New Zealand,2017,33,3,30
BTN,Bhutan,NOR,Norway,2008,21,3,18
BTN,Bhutan,NOR,Norway,2009,246,3,243
BTN,Bhutan,NOR,Norway,2010,52,5,47
BTN,Bhutan,NOR,Norway,2011,17,3,14
BTN,Bhutan,NOR,Norway,2012,168,9,159
BTN,Bhutan,NOR,Norway,2013,6,2,4
BTN,Bhutan,NOR,Norway,2014,9,1,8
BTN,Bhutan,NOR,Norway,2015,7,2,5
BTN,Bhutan,NOR,Norway,2016,7,4,3
BTN,Bhutan,NOR,Norway,2017,2,1,1
BTN,Bhutan,POL,Poland,2009,0,0,0
BTN,Bhutan,POL,Poland,2010,1,0,1
BTN,Bhutan,POL,Poland,2011,2,0,2
BTN,Bhutan,POL,Poland,2012,2,0,2
BTN,Bhutan,POL,Poland,2013,2,0,2
BTN,Bhutan,POL,Poland,2014,0,0,0
BTN,Bhutan,POL,Poland,2015,1,0,1
BTN,Bhutan,POL,Poland,2016,0,0,0
BTN,Bhutan,POL,Poland,2017,0,0,0
BTN,Bhutan,SVK,Slovak Republic,2008,0,0,0
BTN,Bhutan,ESP,Spain,2008,0,0,0
BTN,Bhutan,ESP,Spain,2009,0,0,0
BTN,Bhutan,ESP,Spain,2010,0,0,0
BTN,Bhutan,ESP,Spain,2011,0,0,0
BTN,Bhutan,ESP,Spain,2012,2,0,2
BTN,Bhutan,ESP,Spain,2013,1,0,1
BTN,Bhutan,ESP,Spain,2014,4,1,3
BTN,Bhutan,ESP,Spain,2015,1,0,1
BTN,Bhutan,ESP,Spain,2016,5,2,3
BTN,Bhutan,ESP,Spain,2017,3,2,1
BTN,Bhutan,SWE,Sweden,2008,5,2,3
BTN,Bhutan,SWE,Sweden,2009,4,1,3
BTN,Bhutan,SWE,Sweden,2010,1,0,1
BTN,Bhutan,SWE,Sweden,2011,1,6,-5
BTN,Bhutan,SWE,Sweden,2012,1,4,-3
BTN,Bhutan,SWE,Sweden,2013,3,0,3
BTN,Bhutan,SWE,Sweden,2014,1,0,1
BTN,Bhutan,SWE,Sweden,2015,1,0,1
BTN,Bhutan,SWE,Sweden,2016,6,0,6
BTN,Bhutan,SWE,Sweden,2017,3,0,3
BTN,Bhutan,CHE,Switzerland,2010,3,1,2
BTN,Bhutan,CHE,Switzerland,2011,3,6,-3
BTN,Bhutan,CHE,Switzerland,2012,3,0,3
BTN,Bhutan,CHE,Switzerland,2013,3,3,0
BTN,Bhutan,CHE,Switzerland,2014,4,1,3
BTN,Bhutan,CHE,Switzerland,2015,13,3,10
BTN,Bhutan,CHE,Switzerland,2016,2,11,-9
BTN,Bhutan,CHE,Switzerland,2017,3,2,1
BTN,Bhutan,USA,United States,2008,42,0,42
BTN,Bhutan,USA,United States,2009,594,0,594
BTN,Bhutan,USA,United States,2010,6109,0,6109
BTN,Bhutan,USA,United States,2011,10137,0,10137
BTN,Bhutan,USA,United States,2012,10198,0,10198
BTN,Bhutan,USA,United States,2013,8954,0,8954
BTN,Bhutan,USA,United States,2014,7298,0,7298
BTN,Bhutan,USA,United States,2015,6325,0,6325
BTN,Bhutan,USA,United States,2016,4217,0,4217
BTN,Bhutan,USA,United States,2017,2940,0,2940
BTN,Bhutan,CHL,Chile,2008,1,0,1
BTN,Bhutan,CHL,Chile,2009,0,0,0
BTN,Bhutan,CHL,Chile,2010,0,0,0
BTN,Bhutan,CHL,Chile,2011,0,0,0
BTN,Bhutan,CHL,Chile,2012,0,0,0
BTN,Bhutan,CHL,Chile,2013,0,0,0
BTN,Bhutan,CHL,Chile,2014,0,0,0
BTN,Bhutan,CHL,Chile,2015,0,0,0
BTN,Bhutan,CHL,Chile,2016,0,0,0
BTN,Bhutan,EST,Estonia,2008,0,0,0
BTN,Bhutan,EST,Estonia,2009,0,0,0
BTN,Bhutan,EST,Estonia,2010,0,0,0
BTN,Bhutan,EST,Estonia,2011,0,0,0
BTN,Bhutan,EST,Estonia,2012,0,0,0
BTN,Bhutan,EST,Estonia,2013,0,0,0
BTN,Bhutan,EST,Estonia,2014,0,0,0
BTN,Bhutan,EST,Estonia,2015,1,0,1
BTN,Bhutan,EST,Estonia,2016,1,0,1
BTN,Bhutan,EST,Estonia,2017,1,0,1
BOL,Bolivia,AUS,Australia,2008,24,10,14
BOL,Bolivia,AUS,Australia,2009,18,14,4
BOL,Bolivia,AUS,Australia,2010,23,11,12
BOL,Bolivia,AUS,Australia,2011,26,13,13
BOL,Bolivia,AUS,Australia,2012,27,5,22
BOL,Bolivia,AUS,Australia,2013,27,13,14
BOL,Bolivia,AUS,Australia,2014,13,12,1
BOL,Bolivia,AUS,Australia,2015,14,0,14
BOL,Bolivia,AUS,Australia,2016,20,0,20
BOL,Bolivia,AUS,Australia,2017,16,0,16
BOL,Bolivia,AUT,Austria,2008,15,8,7
BOL,Bolivia,AUT,Austria,2009,24,9,15
BOL,Bolivia,AUT,Austria,2010,17,10,7
BOL,Bolivia,AUT,Austria,2011,14,9,5
BOL,Bolivia,AUT,Austria,2012,15,11,4
BOL,Bolivia,AUT,Austria,2013,18,6,12
BOL,Bolivia,AUT,Austria,2014,17,10,7
BOL,Bolivia,AUT,Austria,2015,10,8,2
BOL,Bolivia,AUT,Austria,2016,23,12,11
BOL,Bolivia,AUT,Austria,2017,12,8,4
BOL,Bolivia,BEL,Belgium,2008,62,0,62
BOL,Bolivia,BEL,Belgium,2009,85,0,85
BOL,Bolivia,BEL,Belgium,2010,104,22,82
BOL,Bolivia,BEL,Belgium,2011,78,0,78
BOL,Bolivia,BEL,Belgium,2012,67,33,34
BOL,Bolivia,BEL,Belgium,2013,54,31,23
BOL,Bolivia,BEL,Belgium,2014,35,31,4
BOL,Bolivia,BEL,Belgium,2015,40,28,12
BOL,Bolivia,BEL,Belgium,2016,42,19,23
BOL,Bolivia,BEL,Belgium,2017,50,15,35
BOL,Bolivia,CAN,Canada,2008,142,0,142
BOL,Bolivia,CAN,Canada,2009,214,0,214
BOL,Bolivia,CAN,Canada,2010,180,0,180
BOL,Bolivia,CAN,Canada,2011,86,0,86
BOL,Bolivia,CAN,Canada,2012,83,0,83
BOL,Bolivia,CAN,Canada,2013,107,0,107
BOL,Bolivia,CAN,Canada,2014,95,0,95
BOL,Bolivia,CAN,Canada,2015,74,0,74
BOL,Bolivia,CAN,Canada,2016,110,0,110
BOL,Bolivia,CAN,Canada,2017,100,0,100
BOL,Bolivia,CZE,Czech Republic,2008,9,0,9
BOL,Bolivia,CZE,Czech Republic,2009,6,0,6
BOL,Bolivia,CZE,Czech Republic,2010,2,0,2
BOL,Bolivia,CZE,Czech Republic,2011,1,0,1
BOL,Bolivia,CZE,Czech Republic,2012,5,4,1
BOL,Bolivia,CZE,Czech Republic,2013,2,5,-3
BOL,Bolivia,CZE,Czech Republic,2014,9,3,6
BOL,Bolivia,CZE,Czech Republic,2015,4,5,-1
BOL,Bolivia,CZE,Czech Republic,2016,3,6,-3
BOL,Bolivia,CZE,Czech Republic,2017,13,3,10
BOL,Bolivia,DNK,Denmark,2008,9,8,1
BOL,Bolivia,DNK,Denmark,2009,13,4,9
BOL,Bolivia,DNK,Denmark,2010,5,3,2
BOL,Bolivia,DNK,Denmark,2011,11,9,2
BOL,Bolivia,DNK,Denmark,2012,7,11,-4
BOL,Bolivia,DNK,Denmark,2013,11,4,7
BOL,Bolivia,DNK,Denmark,2014,5,12,-7
BOL,Bolivia,DNK,Denmark,2015,8,11,-3
BOL,Bolivia,DNK,Denmark,2016,9,5,4
BOL,Bolivia,DNK,Denmark,2017,12,7,5
BOL,Bolivia,FIN,Finland,2008,5,1,4
BOL,Bolivia,FIN,Finland,2009,6,1,5
BOL,Bolivia,FIN,Finland,2010,8,0,8
BOL,Bolivia,FIN,Finland,2011,6,0,6
BOL,Bolivia,FIN,Finland,2012,6,2,4
BOL,Bolivia,FIN,Finland,2013,4,1,3
BOL,Bolivia,FIN,Finland,2014,3,1,2
BOL,Bolivia,FIN,Finland,2015,3,1,2
BOL,Bolivia,FIN,Finland,2016,5,2,3
BOL,Bolivia,FIN,Finland,2017,3,3,0
BOL,Bolivia,FRA,France,2008,116,0,116
BOL,Bolivia,FRA,France,2009,102,0,102
BOL,Bolivia,FRA,France,2010,131,0,131
BOL,Bolivia,FRA,France,2011,152,0,152
BOL,Bolivia,FRA,France,2012,129,0,129
BOL,Bolivia,FRA,France,2013,229,0,229
BOL,Bolivia,FRA,France,2014,147,0,147
BOL,Bolivia,FRA,France,2015,160,0,160
BOL,Bolivia,FRA,France,2016,127,0,127
BOL,Bolivia,FRA,France,2017,135,0,135
BOL,Bolivia,DEU,Germany,2008,284,330,-46
BOL,Bolivia,DEU,Germany,2009,319,298,21
BOL,Bolivia,DEU,Germany,2010,288,273,15
BOL,Bolivia,DEU,Germany,2011,267,230,37
BOL,Bolivia,DEU,Germany,2012,312,177,135
BOL,Bolivia,DEU,Germany,2013,313,223,90
BOL,Bolivia,DEU,Germany,2014,307,199,108
BOL,Bolivia,DEU,Germany,2015,314,197,117
BOL,Bolivia,DEU,Germany,2016,319,217,102
BOL,Bolivia,DEU,Germany,2017,339,169,170
BOL,Bolivia,HUN,Hungary,2008,8,0,8
BOL,Bolivia,HUN,Hungary,2009,2,0,2
BOL,Bolivia,HUN,Hungary,2010,0,0,0
BOL,Bolivia,HUN,Hungary,2011,2,0,2
BOL,Bolivia,HUN,Hungary,2012,0,0,0
BOL,Bolivia,HUN,Hungary,2013,1,0,1
BOL,Bolivia,HUN,Hungary,2014,1,0,1
BOL,Bolivia,HUN,Hungary,2015,2,0,2
BOL,Bolivia,HUN,Hungary,2016,9,0,9
BOL,Bolivia,HUN,Hungary,2017,6,0,6
BOL,Bolivia,ISL,Iceland,2008,0,2,-2
BOL,Bolivia,ISL,Iceland,2009,1,1,0
BOL,Bolivia,ISL,Iceland,2010,0,0,0
BOL,Bolivia,ISL,Iceland,2011,3,0,3
BOL,Bolivia,ISL,Iceland,2012,0,1,-1
BOL,Bolivia,ISL,Iceland,2013,1,0,1
BOL,Bolivia,ISL,Iceland,2014,1,2,-1
BOL,Bolivia,ISL,Iceland,2015,4,1,3
BOL,Bolivia,ISL,Iceland,2016,2,1,1
BOL,Bolivia,ISL,Iceland,2017,2,1,1
BOL,Bolivia,ITA,Italy,2008,1143,47,1096
BOL,Bolivia,ITA,Italy,2009,1625,63,1562
BOL,Bolivia,ITA,Italy,2010,3362,77,3285
BOL,Bolivia,ITA,Italy,2011,1670,103,1567
BOL,Bolivia,ITA,Italy,2012,1027,112,915
BOL,Bolivia,ITA,Italy,2013,735,98,637
BOL,Bolivia,ITA,Italy,2014,410,117,293
BOL,Bolivia,ITA,Italy,2015,324,127,197
BOL,Bolivia,ITA,Italy,2016,238,0,238
BOL,Bolivia,ITA,Italy,2017,260,65,195
BOL,Bolivia,JPN,Japan,2008,376,209,167
BOL,Bolivia,JPN,Japan,2009,167,421,-254
BOL,Bolivia,JPN,Japan,2010,181,226,-45
BOL,Bolivia,JPN,Japan,2011,243,166,77
BOL,Bolivia,JPN,Japan,2012,251,119,132
BOL,Bolivia,JPN,Japan,2013,257,127,130
BOL,Bolivia,JPN,Japan,2014,213,109,104
BOL,Bolivia,JPN,Japan,2015,253,109,144
BOL,Bolivia,JPN,Japan,2016,270,93,177
BOL,Bolivia,JPN,Japan,2017,316,85,231
BOL,Bolivia,KOR,Korea,2008,13,21,-8
BOL,Bolivia,KOR,Korea,2009,16,14,2
BOL,Bolivia,KOR,Korea,2010,18,17,1
BOL,Bolivia,KOR,Korea,2011,12,11,1
BOL,Bolivia,KOR,Korea,2012,34,11,23
BOL,Bolivia,KOR,Korea,2013,32,24,8
BOL,Bolivia,KOR,Korea,2014,19,19,0
BOL,Bolivia,KOR,Korea,2015,19,21,-2
BOL,Bolivia,KOR,Korea,2016,23,18,5
BOL,Bolivia,KOR,Korea,2017,27,32,-5
BOL,Bolivia,LUX,Luxembourg,2008,1,1,0
BOL,Bolivia,LUX,Luxembourg,2009,0,0,0
BOL,Bolivia,LUX,Luxembourg,2010,2,2,0
BOL,Bolivia,LUX,Luxembourg,2011,3,1,2
BOL,Bolivia,LUX,Luxembourg,2012,1,0,1
BOL,Bolivia,LUX,Luxembourg,2013,2,2,0
BOL,Bolivia,LUX,Luxembourg,2014,1,1,0
BOL,Bolivia,LUX,Luxembourg,2015,1,1,0
BOL,Bolivia,LUX,Luxembourg,2016,6,0,6
BOL,Bolivia,LUX,Luxembourg,2017,7,3,4
BOL,Bolivia,MEX,Mexico,2008,95,0,95
BOL,Bolivia,MEX,Mexico,2009,169,0,169
BOL,Bolivia,MEX,Mexico,2010,176,0,176
BOL,Bolivia,MEX,Mexico,2011,101,0,101
BOL,Bolivia,MEX,Mexico,2012,109,0,109
BOL,Bolivia,MEX,Mexico,2013,329,0,329
BOL,Bolivia,MEX,Mexico,2014,199,0,199
BOL,Bolivia,MEX,Mexico,2015,174,0,174
BOL,Bolivia,MEX,Mexico,2016,131,0,131
BOL,Bolivia,MEX,Mexico,2017,114,0,114
BOL,Bolivia,NLD,Netherlands,2008,54,25,29
BOL,Bolivia,NLD,Netherlands,2009,56,30,26
BOL,Bolivia,NLD,Netherlands,2010,48,43,5
BOL,Bolivia,NLD,Netherlands,2011,42,25,17
BOL,Bolivia,NLD,Netherlands,2012,39,40,-1
BOL,Bolivia,NLD,Netherlands,2013,39,33,6
BOL,Bolivia,NLD,Netherlands,2014,45,21,24
BOL,Bolivia,NLD,Netherlands,2015,32,22,10
BOL,Bolivia,NLD,Netherlands,2016,28,26,2
BOL,Bolivia,NLD,Netherlands,2017,37,19,18
BOL,Bolivia,NZL,New Zealand,2008,2,2,0
BOL,Bolivia,NZL,New Zealand,2009,7,2,5
BOL,Bolivia,NZL,New Zealand,2010,3,1,2
BOL,Bolivia,NZL,New Zealand,2011,2,4,-2
BOL,Bolivia,NZL,New Zealand,2012,1,0,1
BOL,Bolivia,NZL,New Zealand,2013,10,5,5
BOL,Bolivia,NZL,New Zealand,2014,3,3,0
BOL,Bolivia,NZL,New Zealand,2015,4,2,2
BOL,Bolivia,NZL,New Zealand,2016,3,2,1
BOL,Bolivia,NZL,New Zealand,2017,2,1,1
BOL,Bolivia,NOR,Norway,2008,18,5,13
BOL,Bolivia,NOR,Norway,2009,19,7,12
BOL,Bolivia,NOR,Norway,2010,20,6,14
BOL,Bolivia,NOR,Norway,2011,21,8,13
BOL,Bolivia,NOR,Norway,2012,18,11,7
BOL,Bolivia,NOR,Norway,2013,13,8,5
BOL,Bolivia,NOR,Norway,2014,14,10,4
BOL,Bolivia,NOR,Norway,2015,11,10,1
BOL,Bolivia,NOR,Norway,2016,7,5,2
BOL,Bolivia,NOR,Norway,2017,10,5,5
BOL,Bolivia,POL,Poland,2009,9,0,9
BOL,Bolivia,POL,Poland,2010,14,0,14
BOL,Bolivia,POL,Poland,2011,12,0,12
BOL,Bolivia,POL,Poland,2012,12,0,12
BOL,Bolivia,POL,Poland,2013,19,0,19
BOL,Bolivia,POL,Poland,2014,5,0,5
BOL,Bolivia,POL,Poland,2015,6,0,6
BOL,Bolivia,POL,Poland,2016,13,0,13
BOL,Bolivia,POL,Poland,2017,13,0,13
BOL,Bolivia,SVK,Slovak Republic,2008,1,0,1
BOL,Bolivia,SVK,Slovak Republic,2009,1,0,1
BOL,Bolivia,SVK,Slovak Republic,2011,2,0,2
BOL,Bolivia,SVK,Slovak Republic,2013,1,0,1
BOL,Bolivia,ESP,Spain,2008,10390,18942,-8552
BOL,Bolivia,ESP,Spain,2009,5872,21304,-15432
BOL,Bolivia,ESP,Spain,2010,4045,19728,-15683
BOL,Bolivia,ESP,Spain,2011,4562,18505,-13943
BOL,Bolivia,ESP,Spain,2012,3871,19030,-15159
BOL,Bolivia,ESP,Spain,2013,3589,21321,-17732
BOL,Bolivia,ESP,Spain,2014,4138,10661,-6523
BOL,Bolivia,ESP,Spain,2015,4284,6119,-1835
BOL,Bolivia,ESP,Spain,2016,5272,4395,877
BOL,Bolivia,ESP,Spain,2017,6366,4741,1625
BOL,Bolivia,SWE,Sweden,2008,205,11,194
BOL,Bolivia,SWE,Sweden,2009,282,11,271
BOL,Bolivia,SWE,Sweden,2010,320,22,298
BOL,Bolivia,SWE,Sweden,2011,284,15,269
BOL,Bolivia,SWE,Sweden,2012,205,23,182
BOL,Bolivia,SWE,Sweden,2013,123,34,89
BOL,Bolivia,SWE,Sweden,2014,121,37,84
BOL,Bolivia,SWE,Sweden,2015,126,74,52
BOL,Bolivia,SWE,Sweden,2016,78,24,54
BOL,Bolivia,SWE,Sweden,2017,87,33,54
BOL,Bolivia,CHE,Switzerland,2010,247,43,204
BOL,Bolivia,CHE,Switzerland,2011,206,51,155
BOL,Bolivia,CHE,Switzerland,2012,179,67,112
BOL,Bolivia,CHE,Switzerland,2013,197,40,157
BOL,Bolivia,CHE,Switzerland,2014,176,47,129
BOL,Bolivia,CHE,Switzerland,2015,18,34,-16
BOL,Bolivia,CHE,Switzerland,2016,223,52,171
BOL,Bolivia,CHE,Switzerland,2017,237,41,196
BOL,Bolivia,TUR,Turkey,2010,1,0,1
BOL,Bolivia,USA,United States,2008,2436,0,2436
BOL,Bolivia,USA,United States,2009,2837,0,2837
BOL,Bolivia,USA,United States,2010,2253,0,2253
BOL,Bolivia,USA,United States,2011,2173,0,2173
BOL,Bolivia,USA,United States,2012,1948,0,1948
BOL,Bolivia,USA,United States,2013,2071,0,2071
BOL,Bolivia,USA,United States,2014,1719,0,1719
BOL,Bolivia,USA,United States,2015,1626,0,1626
BOL,Bolivia,USA,United States,2016,1595,0,1595
BOL,Bolivia,USA,United States,2017,1510,0,1510
BOL,Bolivia,CHL,Chile,2008,3371,0,3371
BOL,Bolivia,CHL,Chile,2009,2053,0,2053
BOL,Bolivia,CHL,Chile,2010,4632,0,4632
BOL,Bolivia,CHL,Chile,2011,6238,0,6238
BOL,Bolivia,CHL,Chile,2012,10803,0,10803
BOL,Bolivia,CHL,Chile,2013,23563,0,23563
BOL,Bolivia,CHL,Chile,2014,21559,0,21559
BOL,Bolivia,CHL,Chile,2015,19805,0,19805
BOL,Bolivia,CHL,Chile,2016,14811,0,14811
BOL,Bolivia,EST,Estonia,2008,0,0,0
BOL,Bolivia,EST,Estonia,2009,0,0,0
BOL,Bolivia,EST,Estonia,2010,0,0,0
BOL,Bolivia,EST,Estonia,2011,0,0,0
BOL,Bolivia,EST,Estonia,2012,0,0,0
BOL,Bolivia,EST,Estonia,2013,0,0,0
BOL,Bolivia,EST,Estonia,2014,0,0,0
BOL,Bolivia,EST,Estonia,2015,0,0,0
BOL,Bolivia,EST,Estonia,2016,1,0,1
BOL,Bolivia,EST,Estonia,2017,1,0,1
BOL,Bolivia,SVN,Slovenia,2008,1,0,1
BOL,Bolivia,SVN,Slovenia,2009,2,0,2
BOL,Bolivia,SVN,Slovenia,2010,11,0,11
BOL,Bolivia,SVN,Slovenia,2015,2,0,2
BOL,Bolivia,SVN,Slovenia,2017,1,0,1
BIH,Bosnia and Herzegovina,AUS,Australia,2008,190,314,-124
BIH,Bosnia and Herzegovina,AUS,Australia,2009,134,316,-182
BIH,Bosnia and Herzegovina,AUS,Australia,2010,150,259,-109
BIH,Bosnia and Herzegovina,AUS,Australia,2011,116,296,-180
BIH,Bosnia and Herzegovina,AUS,Australia,2012,118,250,-132
BIH,Bosnia and Herzegovina,AUS,Australia,2013,68,319,-251
BIH,Bosnia and Herzegovina,AUS,Australia,2014,137,349,-212
BIH,Bosnia and Herzegovina,AUS,Australia,2015,148,300,-152
BIH,Bosnia and Herzegovina,AUS,Australia,2016,107,200,-93
BIH,Bosnia and Herzegovina,AUS,Australia,2017,123,0,123
BIH,Bosnia and Herzegovina,AUT,Austria,2008,2924,2096,828
BIH,Bosnia and Herzegovina,AUT,Austria,2009,2423,2146,277
BIH,Bosnia and Herzegovina,AUT,Austria,2010,2526,1996,530
BIH,Bosnia and Herzegovina,AUT,Austria,2011,3872,2650,1222
BIH,Bosnia and Herzegovina,AUT,Austria,2012,4133,2597,1536
BIH,Bosnia and Herzegovina,AUT,Austria,2013,4990,2574,2416
BIH,Bosnia and Herzegovina,AUT,Austria,2014,5164,2539,2625
BIH,Bosnia and Herzegovina,AUT,Austria,2015,5193,2483,2710
BIH,Bosnia and Herzegovina,AUT,Austria,2016,4325,2515,1810
BIH,Bosnia and Herzegovina,AUT,Austria,2017,4207,2426,1781
BIH,Bosnia and Herzegovina,BEL,Belgium,2008,123,0,123
BIH,Bosnia and Herzegovina,BEL,Belgium,2009,113,0,113
BIH,Bosnia and Herzegovina,BEL,Belgium,2010,148,24,124
BIH,Bosnia and Herzegovina,BEL,Belgium,2011,110,0,110
BIH,Bosnia and Herzegovina,BEL,Belgium,2012,235,214,21
BIH,Bosnia and Herzegovina,BEL,Belgium,2013,204,313,-109
BIH,Bosnia and Herzegovina,BEL,Belgium,2014,185,216,-31
BIH,Bosnia and Herzegovina,BEL,Belgium,2015,140,206,-66
BIH,Bosnia and Herzegovina,BEL,Belgium,2016,128,82,46
BIH,Bosnia and Herzegovina,BEL,Belgium,2017,150,50,100
BIH,Bosnia and Herzegovina,CAN,Canada,2008,182,0,182
BIH,Bosnia and Herzegovina,CAN,Canada,2009,156,0,156
BIH,Bosnia and Herzegovina,CAN,Canada,2010,168,0,168
BIH,Bosnia and Herzegovina,CAN,Canada,2011,140,0,140
BIH,Bosnia and Herzegovina,CAN,Canada,2012,121,0,121
BIH,Bosnia and Herzegovina,CAN,Canada,2013,119,0,119
BIH,Bosnia and Herzegovina,CAN,Canada,2014,147,0,147
BIH,Bosnia and Herzegovina,CAN,Canada,2015,195,0,195
BIH,Bosnia and Herzegovina,CAN,Canada,2016,140,0,140
BIH,Bosnia and Herzegovina,CAN,Canada,2017,105,0,105
BIH,Bosnia and Herzegovina,CZE,Czech Republic,2008,669,4,665
BIH,Bosnia and Herzegovina,CZE,Czech Republic,2009,242,2,240
BIH,Bosnia and Herzegovina,CZE,Czech Republic,2010,71,4,67
BIH,Bosnia and Herzegovina,CZE,Czech Republic,2011,87,5,82
BIH,Bosnia and Herzegovina,CZE,Czech Republic,2012,222,70,152
BIH,Bosnia and Herzegovina,CZE,Czech Republic,2013,125,222,-97
BIH,Bosnia and Herzegovina,CZE,Czech Republic,2014,139,209,-70
BIH,Bosnia and Herzegovina,CZE,Czech Republic,2015,229,107,122
BIH,Bosnia and Herzegovina,CZE,Czech Republic,2016,209,154,55
BIH,Bosnia and Herzegovina,CZE,Czech Republic,2017,319,132,187
BIH,Bosnia and Herzegovina,DNK,Denmark,2008,112,21,91
BIH,Bosnia and Herzegovina,DNK,Denmark,2009,50,37,13
BIH,Bosnia and Herzegovina,DNK,Denmark,2010,87,101,-14
BIH,Bosnia and Herzegovina,DNK,Denmark,2011,51,129,-78
BIH,Bosnia and Herzegovina,DNK,Denmark,2012,81,95,-14
BIH,Bosnia and Herzegovina,DNK,Denmark,2013,100,71,29
BIH,Bosnia and Herzegovina,DNK,Denmark,2014,87,74,13
BIH,Bosnia and Herzegovina,DNK,Denmark,2015,68,80,-12
BIH,Bosnia and Herzegovina,DNK,Denmark,2016,81,59,22
BIH,Bosnia and Herzegovina,DNK,Denmark,2017,90,68,22
BIH,Bosnia and Herzegovina,FIN,Finland,2008,146,13,133
BIH,Bosnia and Herzegovina,FIN,Finland,2009,71,4,67
BIH,Bosnia and Herzegovina,FIN,Finland,2010,42,4,38
BIH,Bosnia and Herzegovina,FIN,Finland,2011,28,3,25
BIH,Bosnia and Herzegovina,FIN,Finland,2012,55,8,47
BIH,Bosnia and Herzegovina,FIN,Finland,2013,63,7,56
BIH,Bosnia and Herzegovina,FIN,Finland,2014,88,33,55
BIH,Bosnia and Herzegovina,FIN,Finland,2015,88,18,70
BIH,Bosnia and Herzegovina,FIN,Finland,2016,50,18,32
BIH,Bosnia and Herzegovina,FIN,Finland,2017,71,17,54
BIH,Bosnia and Herzegovina,FRA,France,2008,504,0,504
BIH,Bosnia and Herzegovina,FRA,France,2009,384,0,384
BIH,Bosnia and Herzegovina,FRA,France,2010,333,0,333
BIH,Bosnia and Herzegovina,FRA,France,2011,313,0,313
BIH,Bosnia and Herzegovina,FRA,France,2012,294,0,294
BIH,Bosnia and Herzegovina,FRA,France,2013,377,0,377
BIH,Bosnia and Herzegovina,FRA,France,2014,376,0,376
BIH,Bosnia and Herzegovina,FRA,France,2015,339,0,339
BIH,Bosnia and Herzegovina,FRA,France,2016,349,0,349
BIH,Bosnia and Herzegovina,FRA,France,2017,336,0,336
BIH,Bosnia and Herzegovina,DEU,Germany,2008,6154,6900,-746
BIH,Bosnia and Herzegovina,DEU,Germany,2009,6145,7435,-1290
BIH,Bosnia and Herzegovina,DEU,Germany,2010,6920,6607,313
BIH,Bosnia and Herzegovina,DEU,Germany,2011,9533,8360,1173
BIH,Bosnia and Herzegovina,DEU,Germany,2012,12235,8982,3253
BIH,Bosnia and Herzegovina,DEU,Germany,2013,15083,11043,4040
BIH,Bosnia and Herzegovina,DEU,Germany,2014,20659,13774,6885
BIH,Bosnia and Herzegovina,DEU,Germany,2015,21737,16055,5682
BIH,Bosnia and Herzegovina,DEU,Germany,2016,22393,16621,5772
BIH,Bosnia and Herzegovina,DEU,Germany,2017,23980,11831,12149
BIH,Bosnia and Herzegovina,HUN,Hungary,2008,79,8,71
BIH,Bosnia and Herzegovina,HUN,Hungary,2009,23,38,-15
BIH,Bosnia and Herzegovina,HUN,Hungary,2010,28,18,10
BIH,Bosnia and Herzegovina,HUN,Hungary,2011,45,6,39
BIH,Bosnia and Herzegovina,HUN,Hungary,2012,71,21,50
BIH,Bosnia and Herzegovina,HUN,Hungary,2013,105,24,81
BIH,Bosnia and Herzegovina,HUN,Hungary,2014,86,23,63
BIH,Bosnia and Herzegovina,HUN,Hungary,2015,111,23,88
BIH,Bosnia and Herzegovina,HUN,Hungary,2016,118,41,77
BIH,Bosnia and Herzegovina,HUN,Hungary,2017,91,0,91
BIH,Bosnia and Herzegovina,ISL,Iceland,2008,7,5,2
BIH,Bosnia and Herzegovina,ISL,Iceland,2009,2,1,1
BIH,Bosnia and Herzegovina,ISL,Iceland,2010,6,8,-2
BIH,Bosnia and Herzegovina,ISL,Iceland,2011,1,2,-1
BIH,Bosnia and Herzegovina,ISL,Iceland,2012,4,2,2
BIH,Bosnia and Herzegovina,ISL,Iceland,2013,8,2,6
BIH,Bosnia and Herzegovina,ISL,Iceland,2014,5,7,-2
BIH,Bosnia and Herzegovina,ISL,Iceland,2015,11,5,6
BIH,Bosnia and Herzegovina,ISL,Iceland,2016,6,4,2
BIH,Bosnia and Herzegovina,ISL,Iceland,2017,38,2,36
BIH,Bosnia and Herzegovina,ITA,Italy,2008,1959,114,1845
BIH,Bosnia and Herzegovina,ITA,Italy,2009,1435,135,1300
BIH,Bosnia and Herzegovina,ITA,Italy,2010,997,215,782
BIH,Bosnia and Herzegovina,ITA,Italy,2011,789,193,596
BIH,Bosnia and Herzegovina,ITA,Italy,2012,731,272,459
BIH,Bosnia and Herzegovina,ITA,Italy,2013,693,272,421
BIH,Bosnia and Herzegovina,ITA,Italy,2014,562,251,311
BIH,Bosnia and Herzegovina,ITA,Italy,2015,490,249,241
BIH,Bosnia and Herzegovina,ITA,Italy,2016,440,0,440
BIH,Bosnia and Herzegovina,ITA,Italy,2017,458,161,297
BIH,Bosnia and Herzegovina,JPN,Japan,2008,49,48,1
BIH,Bosnia and Herzegovina,JPN,Japan,2009,73,68,5
BIH,Bosnia and Herzegovina,JPN,Japan,2010,60,58,2
BIH,Bosnia and Herzegovina,JPN,Japan,2011,26,24,2
BIH,Bosnia and Herzegovina,JPN,Japan,2012,46,41,5
BIH,Bosnia and Herzegovina,JPN,Japan,2013,39,36,3
BIH,Bosnia and Herzegovina,JPN,Japan,2014,44,41,3
BIH,Bosnia and Herzegovina,JPN,Japan,2015,48,47,1
BIH,Bosnia and Herzegovina,JPN,Japan,2016,36,30,6
BIH,Bosnia and Herzegovina,JPN,Japan,2017,53,42,11
BIH,Bosnia and Herzegovina,KOR,Korea,2008,3,3,0
BIH,Bosnia and Herzegovina,KOR,Korea,2009,3,1,2
BIH,Bosnia and Herzegovina,KOR,Korea,2010,4,3,1
BIH,Bosnia and Herzegovina,KOR,Korea,2011,3,7,-4
BIH,Bosnia and Herzegovina,KOR,Korea,2012,2,5,-3
BIH,Bosnia and Herzegovina,KOR,Korea,2013,1,1,0
BIH,Bosnia and Herzegovina,KOR,Korea,2014,2,1,1
BIH,Bosnia and Herzegovina,KOR,Korea,2015,4,2,2
BIH,Bosnia and Herzegovina,KOR,Korea,2016,5,4,1
BIH,Bosnia and Herzegovina,KOR,Korea,2017,4,5,-1
BIH,Bosnia and Herzegovina,LUX,Luxembourg,2008,53,35,18
BIH,Bosnia and Herzegovina,LUX,Luxembourg,2009,47,17,30
BIH,Bosnia and Herzegovina,LUX,Luxembourg,2010,65,11,54
BIH,Bosnia and Herzegovina,LUX,Luxembourg,2011,94,16,78
BIH,Bosnia and Herzegovina,LUX,Luxembourg,2012,239,31,208
BIH,Bosnia and Herzegovina,LUX,Luxembourg,2013,171,142,29
BIH,Bosnia and Herzegovina,LUX,Luxembourg,2014,178,81,97
BIH,Bosnia and Herzegovina,LUX,Luxembourg,2015,121,205,-84
BIH,Bosnia and Herzegovina,LUX,Luxembourg,2016,136,63,73
BIH,Bosnia and Herzegovina,LUX,Luxembourg,2017,111,55,56
BIH,Bosnia and Herzegovina,MEX,Mexico,2010,1,0,1
BIH,Bosnia and Herzegovina,MEX,Mexico,2012,0,0,0
BIH,Bosnia and Herzegovina,MEX,Mexico,2013,3,0,3
BIH,Bosnia and Herzegovina,MEX,Mexico,2014,2,0,2
BIH,Bosnia and Herzegovina,MEX,Mexico,2015,2,0,2
BIH,Bosnia and Herzegovina,MEX,Mexico,2017,3,0,3
BIH,Bosnia and Herzegovina,NLD,Netherlands,2009,212,101,111
BIH,Bosnia and Herzegovina,NLD,Netherlands,2010,147,194,-47
BIH,Bosnia and Herzegovina,NLD,Netherlands,2011,223,129,94
BIH,Bosnia and Herzegovina,NLD,Netherlands,2012,135,177,-42
BIH,Bosnia and Herzegovina,NLD,Netherlands,2013,129,109,20
BIH,Bosnia and Herzegovina,NLD,Netherlands,2014,138,123,15
BIH,Bosnia and Herzegovina,NLD,Netherlands,2015,138,85,53
BIH,Bosnia and Herzegovina,NLD,Netherlands,2016,156,68,88
BIH,Bosnia and Herzegovina,NLD,Netherlands,2017,140,51,89
BIH,Bosnia and Herzegovina,NZL,New Zealand,2008,4,0,4
BIH,Bosnia and Herzegovina,NZL,New Zealand,2009,0,3,-3
BIH,Bosnia and Herzegovina,NZL,New Zealand,2010,0,0,0
BIH,Bosnia and Herzegovina,NZL,New Zealand,2012,0,0,0
BIH,Bosnia and Herzegovina,NZL,New Zealand,2014,1,0,1
BIH,Bosnia and Herzegovina,NZL,New Zealand,2015,1,0,1
BIH,Bosnia and Herzegovina,NZL,New Zealand,2016,3,0,3
BIH,Bosnia and Herzegovina,NZL,New Zealand,2017,10,0,10
BIH,Bosnia and Herzegovina,NOR,Norway,2008,198,22,176
BIH,Bosnia and Herzegovina,NOR,Norway,2009,130,40,90
BIH,Bosnia and Herzegovina,NOR,Norway,2010,111,67,44
BIH,Bosnia and Herzegovina,NOR,Norway,2011,107,61,46
BIH,Bosnia and Herzegovina,NOR,Norway,2012,159,34,125
BIH,Bosnia and Herzegovina,NOR,Norway,2013,172,46,126
BIH,Bosnia and Herzegovina,NOR,Norway,2014,166,29,137
BIH,Bosnia and Herzegovina,NOR,Norway,2015,222,52,170
BIH,Bosnia and Herzegovina,NOR,Norway,2016,179,37,142
BIH,Bosnia and Herzegovina,NOR,Norway,2017,194,41,153
BIH,Bosnia and Herzegovina,POL,Poland,2009,91,0,91
BIH,Bosnia and Herzegovina,POL,Poland,2010,61,0,61
BIH,Bosnia and Herzegovina,POL,Poland,2011,60,0,60
BIH,Bosnia and Herzegovina,POL,Poland,2012,34,0,34
BIH,Bosnia and Herzegovina,POL,Poland,2013,0,0,0
BIH,Bosnia and Herzegovina,POL,Poland,2014,0,0,0
BIH,Bosnia and Herzegovina,POL,Poland,2015,0,0,0
BIH,Bosnia and Herzegovina,POL,Poland,2016,0,0,0
BIH,Bosnia and Herzegovina,POL,Poland,2017,0,0,0
BIH,Bosnia and Herzegovina,SVK,Slovak Republic,2008,6,17,-11
BIH,Bosnia and Herzegovina,SVK,Slovak Republic,2009,2,7,-5
BIH,Bosnia and Herzegovina,SVK,Slovak Republic,2010,9,7,2
BIH,Bosnia and Herzegovina,SVK,Slovak Republic,2011,3,4,-1
BIH,Bosnia and Herzegovina,SVK,Slovak Republic,2012,3,0,3
BIH,Bosnia and Herzegovina,SVK,Slovak Republic,2013,2,0,2
BIH,Bosnia and Herzegovina,SVK,Slovak Republic,2014,3,1,2
BIH,Bosnia and Herzegovina,SVK,Slovak Republic,2015,5,0,5
BIH,Bosnia and Herzegovina,SVK,Slovak Republic,2016,4,0,4
BIH,Bosnia and Herzegovina,ESP,Spain,2008,132,126,6
BIH,Bosnia and Herzegovina,ESP,Spain,2009,74,128,-54
BIH,Bosnia and Herzegovina,ESP,Spain,2010,56,98,-42
BIH,Bosnia and Herzegovina,ESP,Spain,2011,95,94,1
BIH,Bosnia and Herzegovina,ESP,Spain,2012,96,54,42
BIH,Bosnia and Herzegovina,ESP,Spain,2013,77,79,-2
BIH,Bosnia and Herzegovina,ESP,Spain,2014,82,63,19
BIH,Bosnia and Herzegovina,ESP,Spain,2015,80,37,43
BIH,Bosnia and Herzegovina,ESP,Spain,2016,81,32,49
BIH,Bosnia and Herzegovina,ESP,Spain,2017,90,63,27
BIH,Bosnia and Herzegovina,SWE,Sweden,2008,607,84,523
BIH,Bosnia and Herzegovina,SWE,Sweden,2009,538,52,486
BIH,Bosnia and Herzegovina,SWE,Sweden,2010,516,79,437
BIH,Bosnia and Herzegovina,SWE,Sweden,2011,520,94,426
BIH,Bosnia and Herzegovina,SWE,Sweden,2012,745,50,695
BIH,Bosnia and Herzegovina,SWE,Sweden,2013,569,55,514
BIH,Bosnia and Herzegovina,SWE,Sweden,2014,633,72,561
BIH,Bosnia and Herzegovina,SWE,Sweden,2015,630,109,521
BIH,Bosnia and Herzegovina,SWE,Sweden,2016,603,83,520
BIH,Bosnia and Herzegovina,SWE,Sweden,2017,855,66,789
BIH,Bosnia and Herzegovina,CHE,Switzerland,2010,748,201,547
BIH,Bosnia and Herzegovina,CHE,Switzerland,2011,660,271,389
BIH,Bosnia and Herzegovina,CHE,Switzerland,2012,660,238,422
BIH,Bosnia and Herzegovina,CHE,Switzerland,2013,698,257,441
BIH,Bosnia and Herzegovina,CHE,Switzerland,2014,685,229,456
BIH,Bosnia and Herzegovina,CHE,Switzerland,2015,668,248,420
BIH,Bosnia and Herzegovina,CHE,Switzerland,2016,656,260,396
BIH,Bosnia and Herzegovina,CHE,Switzerland,2017,646,284,362
BIH,Bosnia and Herzegovina,TUR,Turkey,2010,66,0,66
BIH,Bosnia and Herzegovina,TUR,Turkey,2016,284,180,104
BIH,Bosnia and Herzegovina,TUR,Turkey,2017,242,202,40
BIH,Bosnia and Herzegovina,USA,United States,2008,1491,0,1491
BIH,Bosnia and Herzegovina,USA,United States,2009,1501,0,1501
BIH,Bosnia and Herzegovina,USA,United States,2010,946,0,946
BIH,Bosnia and Herzegovina,USA,United States,2011,878,0,878
BIH,Bosnia and Herzegovina,USA,United States,2012,815,0,815
BIH,Bosnia and Herzegovina,USA,United States,2013,697,0,697
BIH,Bosnia and Herzegovina,USA,United States,2014,693,0,693
BIH,Bosnia and Herzegovina,USA,United States,2015,859,0,859
BIH,Bosnia and Herzegovina,USA,United States,2016,971,0,971
BIH,Bosnia and Herzegovina,USA,United States,2017,846,0,846
BIH,Bosnia and Herzegovina,CHL,Chile,2008,1,0,1
BIH,Bosnia and Herzegovina,CHL,Chile,2009,1,0,1
BIH,Bosnia and Herzegovina,CHL,Chile,2010,1,0,1
BIH,Bosnia and Herzegovina,CHL,Chile,2011,4,0,4
BIH,Bosnia and Herzegovina,CHL,Chile,2012,4,0,4
BIH,Bosnia and Herzegovina,CHL,Chile,2013,1,0,1
BIH,Bosnia and Herzegovina,CHL,Chile,2014,1,0,1
BIH,Bosnia and Herzegovina,CHL,Chile,2015,38,0,38
BIH,Bosnia and Herzegovina,CHL,Chile,2016,6,0,6
BIH,Bosnia and Herzegovina,EST,Estonia,2008,0,0,0
BIH,Bosnia and Herzegovina,EST,Estonia,2009,1,0,1
BIH,Bosnia and Herzegovina,EST,Estonia,2010,0,0,0
BIH,Bosnia and Herzegovina,EST,Estonia,2011,0,0,0
BIH,Bosnia and Herzegovina,EST,Estonia,2012,0,0,0
BIH,Bosnia and Herzegovina,EST,Estonia,2013,1,0,1
BIH,Bosnia and Herzegovina,EST,Estonia,2014,0,0,0
BIH,Bosnia and Herzegovina,EST,Estonia,2015,0,0,0
BIH,Bosnia and Herzegovina,EST,Estonia,2016,0,0,0
BIH,Bosnia and Herzegovina,EST,Estonia,2017,1,0,1
BIH,Bosnia and Herzegovina,SVN,Slovenia,2008,17928,3016,14912
BIH,Bosnia and Herzegovina,SVN,Slovenia,2009,5330,6658,-1328
BIH,Bosnia and Herzegovina,SVN,Slovenia,2010,3694,4439,-745
BIH,Bosnia and Herzegovina,SVN,Slovenia,2011,4521,635,3886
BIH,Bosnia and Herzegovina,SVN,Slovenia,2012,4386,442,3944
BIH,Bosnia and Herzegovina,SVN,Slovenia,2013,3659,332,3327
BIH,Bosnia and Herzegovina,SVN,Slovenia,2014,5068,365,4703
BIH,Bosnia and Herzegovina,SVN,Slovenia,2015,5896,592,5304
BIH,Bosnia and Herzegovina,SVN,Slovenia,2016,6774,809,5965
BIH,Bosnia and Herzegovina,SVN,Slovenia,2017,11529,947,10582
BWA,Botswana,AUS,Australia,2008,43,0,43
BWA,Botswana,AUS,Australia,2009,46,8,38
BWA,Botswana,AUS,Australia,2010,60,6,54
BWA,Botswana,AUS,Australia,2011,52,6,46
BWA,Botswana,AUS,Australia,2012,68,7,61
BWA,Botswana,AUS,Australia,2013,76,7,69
BWA,Botswana,AUS,Australia,2014,66,6,60
BWA,Botswana,AUS,Australia,2015,42,0,42
BWA,Botswana,AUS,Australia,2016,41,0,41
BWA,Botswana,AUS,Australia,2017,44,0,44
BWA,Botswana,AUT,Austria,2008,5,1,4
BWA,Botswana,AUT,Austria,2009,0,3,-3
BWA,Botswana,AUT,Austria,2010,0,3,-3
BWA,Botswana,AUT,Austria,2011,2,0,2
BWA,Botswana,AUT,Austria,2012,0,1,-1
BWA,Botswana,AUT,Austria,2013,1,0,1
BWA,Botswana,AUT,Austria,2014,2,0,2
BWA,Botswana,AUT,Austria,2015,2,4,-2
BWA,Botswana,AUT,Austria,2016,2,0,2
BWA,Botswana,AUT,Austria,2017,1,1,0
BWA,Botswana,BEL,Belgium,2008,4,0,4
BWA,Botswana,BEL,Belgium,2009,0,0,0
BWA,Botswana,BEL,Belgium,2010,5,1,4
BWA,Botswana,BEL,Belgium,2011,4,0,4
BWA,Botswana,BEL,Belgium,2012,3,1,2
BWA,Botswana,BEL,Belgium,2013,1,2,-1
BWA,Botswana,BEL,Belgium,2014,5,2,3
BWA,Botswana,BEL,Belgium,2017,1,1,0
BWA,Botswana,CAN,Canada,2008,28,0,28
BWA,Botswana,CAN,Canada,2009,15,0,15
BWA,Botswana,CAN,Canada,2010,42,0,42
BWA,Botswana,CAN,Canada,2011,53,0,53
BWA,Botswana,CAN,Canada,2012,64,0,64
BWA,Botswana,CAN,Canada,2013,77,0,77
BWA,Botswana,CAN,Canada,2014,103,0,103
BWA,Botswana,CAN,Canada,2015,96,0,96
BWA,Botswana,CAN,Canada,2016,65,0,65
BWA,Botswana,CAN,Canada,2017,75,0,75
BWA,Botswana,CZE,Czech Republic,2008,15,0,15
BWA,Botswana,CZE,Czech Republic,2009,34,0,34
BWA,Botswana,CZE,Czech Republic,2010,22,0,22
BWA,Botswana,CZE,Czech Republic,2011,22,0,22
BWA,Botswana,CZE,Czech Republic,2012,27,18,9
BWA,Botswana,CZE,Czech Republic,2013,10,23,-13
BWA,Botswana,CZE,Czech Republic,2014,20,14,6
BWA,Botswana,CZE,Czech Republic,2015,3,21,-18
BWA,Botswana,CZE,Czech Republic,2016,3,12,-9
BWA,Botswana,CZE,Czech Republic,2017,4,23,-19
BWA,Botswana,DNK,Denmark,2008,2,0,2
BWA,Botswana,DNK,Denmark,2009,2,2,0
BWA,Botswana,DNK,Denmark,2010,1,1,0
BWA,Botswana,DNK,Denmark,2011,1,7,-6
BWA,Botswana,DNK,Denmark,2012,0,2,-2
BWA,Botswana,DNK,Denmark,2013,0,0,0
BWA,Botswana,DNK,Denmark,2014,1,1,0
BWA,Botswana,DNK,Denmark,2015,0,1,-1
BWA,Botswana,DNK,Denmark,2016,2,1,1
BWA,Botswana,DNK,Denmark,2017,0,2,-2
BWA,Botswana,FIN,Finland,2008,0,0,0
BWA,Botswana,FIN,Finland,2009,0,0,0
BWA,Botswana,FIN,Finland,2010,0,0,0
BWA,Botswana,FIN,Finland,2011,0,0,0
BWA,Botswana,FIN,Finland,2012,2,0,2
BWA,Botswana,FIN,Finland,2013,1,0,1
BWA,Botswana,FIN,Finland,2014,0,0,0
BWA,Botswana,FIN,Finland,2015,0,0,0
BWA,Botswana,FIN,Finland,2016,1,0,1
BWA,Botswana,FIN,Finland,2017,0,0,0
BWA,Botswana,FRA,France,2008,1,0,1
BWA,Botswana,FRA,France,2009,2,0,2
BWA,Botswana,FRA,France,2010,3,0,3
BWA,Botswana,FRA,France,2011,4,0,4
BWA,Botswana,FRA,France,2012,2,0,2
BWA,Botswana,FRA,France,2013,5,0,5
BWA,Botswana,FRA,France,2014,2,0,2
BWA,Botswana,FRA,France,2015,1,0,1
BWA,Botswana,FRA,France,2016,2,0,2
BWA,Botswana,FRA,France,2017,4,0,4
BWA,Botswana,DEU,Germany,2008,17,27,-10
BWA,Botswana,DEU,Germany,2009,15,19,-4
BWA,Botswana,DEU,Germany,2010,15,13,2
BWA,Botswana,DEU,Germany,2011,28,10,18
BWA,Botswana,DEU,Germany,2012,25,18,7
BWA,Botswana,DEU,Germany,2013,21,18,3
BWA,Botswana,DEU,Germany,2014,34,13,21
BWA,Botswana,DEU,Germany,2015,22,19,3
BWA,Botswana,DEU,Germany,2016,22,14,8
BWA,Botswana,DEU,Germany,2017,37,19,18
BWA,Botswana,HUN,Hungary,2008,0,0,0
BWA,Botswana,HUN,Hungary,2009,0,0,0
BWA,Botswana,HUN,Hungary,2010,2,0,2
BWA,Botswana,HUN,Hungary,2011,1,0,1
BWA,Botswana,HUN,Hungary,2012,2,1,1
BWA,Botswana,HUN,Hungary,2013,0,0,0
BWA,Botswana,HUN,Hungary,2014,0,0,0
BWA,Botswana,HUN,Hungary,2015,2,0,2
BWA,Botswana,HUN,Hungary,2016,0,0,0
BWA,Botswana,HUN,Hungary,2017,2,0,2
BWA,Botswana,ISL,Iceland,2016,0,0,0
BWA,Botswana,ISL,Iceland,2017,0,0,0
BWA,Botswana,ITA,Italy,2008,1,0,1
BWA,Botswana,ITA,Italy,2009,3,0,3
BWA,Botswana,ITA,Italy,2010,4,0,4
BWA,Botswana,ITA,Italy,2011,8,0,8
BWA,Botswana,ITA,Italy,2012,4,0,4
BWA,Botswana,ITA,Italy,2013,1,0,1
BWA,Botswana,ITA,Italy,2015,4,0,4
BWA,Botswana,ITA,Italy,2016,3,0,3
BWA,Botswana,ITA,Italy,2017,1,1,0
BWA,Botswana,JPN,Japan,2008,56,55,1
BWA,Botswana,JPN,Japan,2009,35,36,-1
BWA,Botswana,JPN,Japan,2010,91,72,19
BWA,Botswana,JPN,Japan,2011,84,79,5
BWA,Botswana,JPN,Japan,2012,66,62,4
BWA,Botswana,JPN,Japan,2013,108,104,4
BWA,Botswana,JPN,Japan,2014,71,69,2
BWA,Botswana,JPN,Japan,2015,95,80,15
BWA,Botswana,JPN,Japan,2016,67,54,13
BWA,Botswana,JPN,Japan,2017,98,101,-3
BWA,Botswana,KOR,Korea,2008,2,2,0
BWA,Botswana,KOR,Korea,2009,2,2,0
BWA,Botswana,KOR,Korea,2010,2,3,-1
BWA,Botswana,KOR,Korea,2011,5,2,3
BWA,Botswana,KOR,Korea,2012,1,4,-3
BWA,Botswana,KOR,Korea,2013,5,4,1
BWA,Botswana,KOR,Korea,2014,5,3,2
BWA,Botswana,KOR,Korea,2015,6,7,-1
BWA,Botswana,KOR,Korea,2016,3,1,2
BWA,Botswana,KOR,Korea,2017,6,7,-1
BWA,Botswana,LUX,Luxembourg,2008,0,0,0
BWA,Botswana,LUX,Luxembourg,2009,0,0,0
BWA,Botswana,LUX,Luxembourg,2010,1,0,1
BWA,Botswana,LUX,Luxembourg,2011,0,0,0
BWA,Botswana,LUX,Luxembourg,2012,0,0,0
BWA,Botswana,LUX,Luxembourg,2013,0,0,0
BWA,Botswana,LUX,Luxembourg,2014,0,0,0
BWA,Botswana,LUX,Luxembourg,2015,0,0,0
BWA,Botswana,LUX,Luxembourg,2016,3,0,3
BWA,Botswana,LUX,Luxembourg,2017,0,0,0
BWA,Botswana,MEX,Mexico,2012,0,0,0
BWA,Botswana,MEX,Mexico,2013,0,0,0
BWA,Botswana,MEX,Mexico,2014,0,0,0
BWA,Botswana,MEX,Mexico,2016,0,0,0
BWA,Botswana,NLD,Netherlands,2008,8,8,0
BWA,Botswana,NLD,Netherlands,2009,9,9,0
BWA,Botswana,NLD,Netherlands,2010,6,10,-4
BWA,Botswana,NLD,Netherlands,2011,5,1,4
BWA,Botswana,NLD,Netherlands,2012,5,2,3
BWA,Botswana,NLD,Netherlands,2013,4,2,2
BWA,Botswana,NLD,Netherlands,2014,5,4,1
BWA,Botswana,NLD,Netherlands,2015,3,2,1
BWA,Botswana,NLD,Netherlands,2016,6,5,1
BWA,Botswana,NLD,Netherlands,2017,7,6,1
BWA,Botswana,NZL,New Zealand,2008,3,3,0
BWA,Botswana,NZL,New Zealand,2009,12,1,11
BWA,Botswana,NZL,New Zealand,2010,15,2,13
BWA,Botswana,NZL,New Zealand,2011,9,2,7
BWA,Botswana,NZL,New Zealand,2012,5,6,-1
BWA,Botswana,NZL,New Zealand,2013,4,5,-1
BWA,Botswana,NZL,New Zealand,2014,5,2,3
BWA,Botswana,NZL,New Zealand,2015,7,3,4
BWA,Botswana,NZL,New Zealand,2016,13,4,9
BWA,Botswana,NZL,New Zealand,2017,3,6,-3
BWA,Botswana,NOR,Norway,2008,12,4,8
BWA,Botswana,NOR,Norway,2009,1,3,-2
BWA,Botswana,NOR,Norway,2010,4,6,-2
BWA,Botswana,NOR,Norway,2011,4,5,-1
BWA,Botswana,NOR,Norway,2012,6,5,1
BWA,Botswana,NOR,Norway,2013,6,2,4
BWA,Botswana,NOR,Norway,2014,1,9,-8
BWA,Botswana,NOR,Norway,2015,3,2,1
BWA,Botswana,NOR,Norway,2016,3,0,3
BWA,Botswana,NOR,Norway,2017,2,0,2
BWA,Botswana,POL,Poland,2009,0,0,0
BWA,Botswana,POL,Poland,2010,1,0,1
BWA,Botswana,POL,Poland,2011,0,0,0
BWA,Botswana,POL,Poland,2012,0,0,0
BWA,Botswana,POL,Poland,2013,1,0,1
BWA,Botswana,POL,Poland,2014,0,0,0
BWA,Botswana,POL,Poland,2015,1,0,1
BWA,Botswana,POL,Poland,2016,0,0,0
BWA,Botswana,POL,Poland,2017,0,0,0
BWA,Botswana,SVK,Slovak Republic,2008,0,0,0
BWA,Botswana,SVK,Slovak Republic,2010,1,0,1
BWA,Botswana,ESP,Spain,2008,2,0,2
BWA,Botswana,ESP,Spain,2009,2,0,2
BWA,Botswana,ESP,Spain,2010,0,1,-1
BWA,Botswana,ESP,Spain,2011,3,4,-1
BWA,Botswana,ESP,Spain,2012,2,0,2
BWA,Botswana,ESP,Spain,2013,3,2,1
BWA,Botswana,ESP,Spain,2014,2,1,1
BWA,Botswana,ESP,Spain,2015,3,0,3
BWA,Botswana,ESP,Spain,2016,0,1,-1
BWA,Botswana,ESP,Spain,2017,5,1,4
BWA,Botswana,SWE,Sweden,2008,4,1,3
BWA,Botswana,SWE,Sweden,2009,2,0,2
BWA,Botswana,SWE,Sweden,2010,5,6,-1
BWA,Botswana,SWE,Sweden,2011,7,0,7
BWA,Botswana,SWE,Sweden,2012,1,0,1
BWA,Botswana,SWE,Sweden,2013,3,1,2
BWA,Botswana,SWE,Sweden,2014,5,4,1
BWA,Botswana,SWE,Sweden,2015,2,1,1
BWA,Botswana,SWE,Sweden,2016,6,1,5
BWA,Botswana,SWE,Sweden,2017,3,2,1
BWA,Botswana,CHE,Switzerland,2010,1,0,1
BWA,Botswana,CHE,Switzerland,2011,1,0,1
BWA,Botswana,CHE,Switzerland,2012,3,1,2
BWA,Botswana,CHE,Switzerland,2013,2,0,2
BWA,Botswana,CHE,Switzerland,2014,1,2,-1
BWA,Botswana,CHE,Switzerland,2015,2,2,0
BWA,Botswana,CHE,Switzerland,2016,2,1,1
BWA,Botswana,CHE,Switzerland,2017,7,4,3
BWA,Botswana,TUR,Turkey,2010,1,0,1
BWA,Botswana,GBR,United Kingdom,2012,1000,0,1000
BWA,Botswana,USA,United States,2008,41,0,41
BWA,Botswana,USA,United States,2009,55,0,55
BWA,Botswana,USA,United States,2010,66,0,66
BWA,Botswana,USA,United States,2011,76,0,76
BWA,Botswana,USA,United States,2012,80,0,80
BWA,Botswana,USA,United States,2013,53,0,53
BWA,Botswana,USA,United States,2014,58,0,58
BWA,Botswana,USA,United States,2015,61,0,61
BWA,Botswana,USA,United States,2016,78,0,78
BWA,Botswana,USA,United States,2017,112,0,112
BWA,Botswana,CHL,Chile,2008,0,0,0
BWA,Botswana,CHL,Chile,2009,0,0,0
BWA,Botswana,CHL,Chile,2010,0,0,0
BWA,Botswana,CHL,Chile,2011,0,0,0
BWA,Botswana,CHL,Chile,2012,0,0,0
BWA,Botswana,CHL,Chile,2013,0,0,0
BWA,Botswana,CHL,Chile,2014,0,0,0
BWA,Botswana,CHL,Chile,2015,1,0,1
BWA,Botswana,CHL,Chile,2016,0,0,0
BWA,Botswana,EST,Estonia,2008,0,0,0
BWA,Botswana,EST,Estonia,2009,0,0,0
BWA,Botswana,EST,Estonia,2010,0,0,0
BWA,Botswana,EST,Estonia,2011,0,0,0
BWA,Botswana,EST,Estonia,2012,0,0,0
BWA,Botswana,EST,Estonia,2013,0,0,0
BWA,Botswana,EST,Estonia,2014,0,0,0
BWA,Botswana,EST,Estonia,2015,0,0,0
BWA,Botswana,EST,Estonia,2016,0,0,0
BWA,Botswana,EST,Estonia,2017,0,0,0
BWA,Botswana,SVN,Slovenia,2008,1,0,1
BRA,Brazil,AUS,Australia,2008,789,84,705
BRA,Brazil,AUS,Australia,2009,911,109,802
BRA,Brazil,AUS,Australia,2010,1206,105,1101
BRA,Brazil,AUS,Australia,2011,908,147,761
BRA,Brazil,AUS,Australia,2012,1084,156,928
BRA,Brazil,AUS,Australia,2013,1285,193,1092
BRA,Brazil,AUS,Australia,2014,1527,206,1321
BRA,Brazil,AUS,Australia,2015,1286,200,1086
BRA,Brazil,AUS,Australia,2016,1375,100,1275
BRA,Brazil,AUS,Australia,2017,1742,0,1742
BRA,Brazil,AUT,Austria,2008,476,284,192
BRA,Brazil,AUT,Austria,2009,442,357,85
BRA,Brazil,AUT,Austria,2010,408,315,93
BRA,Brazil,AUT,Austria,2011,369,332,37
BRA,Brazil,AUT,Austria,2012,424,312,112
BRA,Brazil,AUT,Austria,2013,395,290,105
BRA,Brazil,AUT,Austria,2014,433,284,149
BRA,Brazil,AUT,Austria,2015,491,315,176
BRA,Brazil,AUT,Austria,2016,544,315,229
BRA,Brazil,AUT,Austria,2017,622,342,280
BRA,Brazil,BEL,Belgium,2008,1209,379,830
BRA,Brazil,BEL,Belgium,2009,1330,486,844
BRA,Brazil,BEL,Belgium,2010,1608,488,1120
BRA,Brazil,BEL,Belgium,2011,1342,571,771
BRA,Brazil,BEL,Belgium,2012,1298,639,659
BRA,Brazil,BEL,Belgium,2013,1108,711,397
BRA,Brazil,BEL,Belgium,2014,826,488,338
BRA,Brazil,BEL,Belgium,2015,965,488,477
BRA,Brazil,BEL,Belgium,2016,1006,423,583
BRA,Brazil,BEL,Belgium,2017,1172,370,802
BRA,Brazil,CAN,Canada,2008,2137,0,2137
BRA,Brazil,CAN,Canada,2009,2509,0,2509
BRA,Brazil,CAN,Canada,2010,2598,0,2598
BRA,Brazil,CAN,Canada,2011,1508,0,1508
BRA,Brazil,CAN,Canada,2012,1641,0,1641
BRA,Brazil,CAN,Canada,2013,1712,0,1712
BRA,Brazil,CAN,Canada,2014,1916,0,1916
BRA,Brazil,CAN,Canada,2015,1750,0,1750
BRA,Brazil,CAN,Canada,2016,1730,0,1730
BRA,Brazil,CAN,Canada,2017,2760,0,2760
BRA,Brazil,CZE,Czech Republic,2008,138,0,138
BRA,Brazil,CZE,Czech Republic,2009,106,1,105
BRA,Brazil,CZE,Czech Republic,2010,91,0,91
BRA,Brazil,CZE,Czech Republic,2011,59,0,59
BRA,Brazil,CZE,Czech Republic,2012,54,28,26
BRA,Brazil,CZE,Czech Republic,2013,83,51,32
BRA,Brazil,CZE,Czech Republic,2014,78,51,27
BRA,Brazil,CZE,Czech Republic,2015,96,54,42
BRA,Brazil,CZE,Czech Republic,2016,166,41,125
BRA,Brazil,CZE,Czech Republic,2017,251,59,192
BRA,Brazil,DNK,Denmark,2008,304,149,155
BRA,Brazil,DNK,Denmark,2009,245,256,-11
BRA,Brazil,DNK,Denmark,2010,267,252,15
BRA,Brazil,DNK,Denmark,2011,202,241,-39
BRA,Brazil,DNK,Denmark,2012,168,254,-86
BRA,Brazil,DNK,Denmark,2013,237,252,-15
BRA,Brazil,DNK,Denmark,2014,288,265,23
BRA,Brazil,DNK,Denmark,2015,295,281,14
BRA,Brazil,DNK,Denmark,2016,346,268,78
BRA,Brazil,DNK,Denmark,2017,385,270,115
BRA,Brazil,FIN,Finland,2008,115,36,79
BRA,Brazil,FIN,Finland,2009,114,24,90
BRA,Brazil,FIN,Finland,2010,99,36,63
BRA,Brazil,FIN,Finland,2011,118,38,80
BRA,Brazil,FIN,Finland,2012,82,56,26
BRA,Brazil,FIN,Finland,2013,90,33,57
BRA,Brazil,FIN,Finland,2014,113,43,70
BRA,Brazil,FIN,Finland,2015,114,24,90
BRA,Brazil,FIN,Finland,2016,159,30,129
BRA,Brazil,FIN,Finland,2017,150,23,127
BRA,Brazil,FRA,France,2008,2192,0,2192
BRA,Brazil,FRA,France,2009,2318,0,2318
BRA,Brazil,FRA,France,2010,2678,0,2678
BRA,Brazil,FRA,France,2011,2282,0,2282
BRA,Brazil,FRA,France,2012,2618,0,2618
BRA,Brazil,FRA,France,2013,2737,0,2737
BRA,Brazil,FRA,France,2014,3070,0,3070
BRA,Brazil,FRA,France,2015,3113,0,3113
BRA,Brazil,FRA,France,2016,2998,0,2998
BRA,Brazil,FRA,France,2017,3239,0,3239
BRA,Brazil,DEU,Germany,2008,6290,5364,926
BRA,Brazil,DEU,Germany,2009,6390,5238,1152
BRA,Brazil,DEU,Germany,2010,6127,5123,1004
BRA,Brazil,DEU,Germany,2011,6870,4821,2049
BRA,Brazil,DEU,Germany,2012,7091,5194,1897
BRA,Brazil,DEU,Germany,2013,7779,5553,2226
BRA,Brazil,DEU,Germany,2014,8926,5773,3153
BRA,Brazil,DEU,Germany,2015,8010,6522,1488
BRA,Brazil,DEU,Germany,2016,8429,6418,2011
BRA,Brazil,DEU,Germany,2017,9477,4903,4574
BRA,Brazil,HUN,Hungary,2008,121,9,112
BRA,Brazil,HUN,Hungary,2009,109,18,91
BRA,Brazil,HUN,Hungary,2010,101,22,79
BRA,Brazil,HUN,Hungary,2011,90,9,81
BRA,Brazil,HUN,Hungary,2012,137,19,118
BRA,Brazil,HUN,Hungary,2013,419,17,402
BRA,Brazil,HUN,Hungary,2014,495,50,445
BRA,Brazil,HUN,Hungary,2015,213,129,84
BRA,Brazil,HUN,Hungary,2016,175,53,122
BRA,Brazil,HUN,Hungary,2017,284,0,284
BRA,Brazil,ISL,Iceland,2008,21,13,8
BRA,Brazil,ISL,Iceland,2009,16,15,1
BRA,Brazil,ISL,Iceland,2010,11,8,3
BRA,Brazil,ISL,Iceland,2011,14,4,10
BRA,Brazil,ISL,Iceland,2012,7,6,1
BRA,Brazil,ISL,Iceland,2013,15,12,3
BRA,Brazil,ISL,Iceland,2014,13,6,7
BRA,Brazil,ISL,Iceland,2015,15,4,11
BRA,Brazil,ISL,Iceland,2016,22,8,14
BRA,Brazil,ISL,Iceland,2017,23,10,13
BRA,Brazil,ITA,Italy,2008,12645,637,12008
BRA,Brazil,ITA,Italy,2009,9658,758,8900
BRA,Brazil,ITA,Italy,2010,8566,670,7896
BRA,Brazil,ITA,Italy,2011,7097,620,6477
BRA,Brazil,ITA,Italy,2012,5716,753,4963
BRA,Brazil,ITA,Italy,2013,4963,724,4239
BRA,Brazil,ITA,Italy,2014,5010,632,4378
BRA,Brazil,ITA,Italy,2015,7008,501,6507
BRA,Brazil,ITA,Italy,2016,10495,0,10495
BRA,Brazil,ITA,Italy,2017,15686,562,15124
BRA,Brazil,JPN,Japan,2008,14402,11558,2844
BRA,Brazil,JPN,Japan,2009,2954,33153,-30199
BRA,Brazil,JPN,Japan,2010,4719,10435,-5716
BRA,Brazil,JPN,Japan,2011,4517,6763,-2246
BRA,Brazil,JPN,Japan,2012,5790,3852,1938
BRA,Brazil,JPN,Japan,2013,4814,2813,2001
BRA,Brazil,JPN,Japan,2014,6118,2493,3625
BRA,Brazil,JPN,Japan,2015,9062,2419,6643
BRA,Brazil,JPN,Japan,2016,12830,2216,10614
BRA,Brazil,JPN,Japan,2017,14188,2344,11844
BRA,Brazil,KOR,Korea,2008,352,320,32
BRA,Brazil,KOR,Korea,2009,347,338,9
BRA,Brazil,KOR,Korea,2010,427,352,75
BRA,Brazil,KOR,Korea,2011,478,465,13
BRA,Brazil,KOR,Korea,2012,494,502,-8
BRA,Brazil,KOR,Korea,2013,584,354,230
BRA,Brazil,KOR,Korea,2014,469,496,-27
BRA,Brazil,KOR,Korea,2015,417,480,-63
BRA,Brazil,KOR,Korea,2016,371,379,-8
BRA,Brazil,KOR,Korea,2017,401,304,97
BRA,Brazil,LUX,Luxembourg,2008,204,64,140
BRA,Brazil,LUX,Luxembourg,2009,216,78,138
BRA,Brazil,LUX,Luxembourg,2010,209,59,150
BRA,Brazil,LUX,Luxembourg,2011,185,75,110
BRA,Brazil,LUX,Luxembourg,2012,160,76,84
BRA,Brazil,LUX,Luxembourg,2013,267,78,189
BRA,Brazil,LUX,Luxembourg,2014,179,62,117
BRA,Brazil,LUX,Luxembourg,2015,199,97,102
BRA,Brazil,LUX,Luxembourg,2016,214,55,159
BRA,Brazil,LUX,Luxembourg,2017,302,79,223
BRA,Brazil,MEX,Mexico,2008,304,0,304
BRA,Brazil,MEX,Mexico,2009,439,0,439
BRA,Brazil,MEX,Mexico,2010,460,0,460
BRA,Brazil,MEX,Mexico,2011,370,0,370
BRA,Brazil,MEX,Mexico,2012,290,0,290
BRA,Brazil,MEX,Mexico,2013,1058,0,1058
BRA,Brazil,MEX,Mexico,2014,733,0,733
BRA,Brazil,MEX,Mexico,2015,627,0,627
BRA,Brazil,MEX,Mexico,2016,617,0,617
BRA,Brazil,MEX,Mexico,2017,541,0,541
BRA,Brazil,NLD,Netherlands,2008,1164,485,679
BRA,Brazil,NLD,Netherlands,2009,1124,559,565
BRA,Brazil,NLD,Netherlands,2010,1153,587,566
BRA,Brazil,NLD,Netherlands,2011,1152,627,525
BRA,Brazil,NLD,Netherlands,2012,1138,664,474
BRA,Brazil,NLD,Netherlands,2013,1556,886,670
BRA,Brazil,NLD,Netherlands,2014,1610,1096,514
BRA,Brazil,NLD,Netherlands,2015,1940,1044,896
BRA,Brazil,NLD,Netherlands,2016,1505,1284,221
BRA,Brazil,NLD,Netherlands,2017,2178,898,1280
BRA,Brazil,NZL,New Zealand,2008,227,435,-208
BRA,Brazil,NZL,New Zealand,2009,265,496,-231
BRA,Brazil,NZL,New Zealand,2010,241,503,-262
BRA,Brazil,NZL,New Zealand,2011,227,359,-132
BRA,Brazil,NZL,New Zealand,2012,238,312,-74
BRA,Brazil,NZL,New Zealand,2013,263,236,27
BRA,Brazil,NZL,New Zealand,2014,435,172,263
BRA,Brazil,NZL,New Zealand,2015,526,209,317
BRA,Brazil,NZL,New Zealand,2016,576,252,324
BRA,Brazil,NZL,New Zealand,2017,804,268,536
BRA,Brazil,NOR,Norway,2008,393,95,298
BRA,Brazil,NOR,Norway,2009,448,153,295
BRA,Brazil,NOR,Norway,2010,315,142,173
BRA,Brazil,NOR,Norway,2011,443,179,264
BRA,Brazil,NOR,Norway,2012,470,146,324
BRA,Brazil,NOR,Norway,2013,441,180,261
BRA,Brazil,NOR,Norway,2014,497,205,292
BRA,Brazil,NOR,Norway,2015,384,300,84
BRA,Brazil,NOR,Norway,2016,378,260,118
BRA,Brazil,NOR,Norway,2017,342,108,234
BRA,Brazil,POL,Poland,2008,153,0,153
BRA,Brazil,POL,Poland,2009,192,0,192
BRA,Brazil,POL,Poland,2010,189,0,189
BRA,Brazil,POL,Poland,2011,160,0,160
BRA,Brazil,POL,Poland,2012,175,0,175
BRA,Brazil,POL,Poland,2013,219,0,219
BRA,Brazil,POL,Poland,2014,103,0,103
BRA,Brazil,POL,Poland,2015,258,0,258
BRA,Brazil,POL,Poland,2016,307,0,307
BRA,Brazil,POL,Poland,2017,412,0,412
BRA,Brazil,PRT,Portugal,2008,32751,0,32751
BRA,Brazil,PRT,Portugal,2009,23138,0,23138
BRA,Brazil,PRT,Portugal,2010,16165,0,16165
BRA,Brazil,PRT,Portugal,2011,12896,0,12896
BRA,Brazil,PRT,Portugal,2012,11715,0,11715
BRA,Brazil,PRT,Portugal,2013,6680,0,6680
BRA,Brazil,PRT,Portugal,2014,5560,0,5560
BRA,Brazil,PRT,Portugal,2015,5716,0,5716
BRA,Brazil,PRT,Portugal,2016,7059,0,7059
BRA,Brazil,PRT,Portugal,2017,11574,0,11574
BRA,Brazil,SVK,Slovak Republic,2008,4,3,1
BRA,Brazil,SVK,Slovak Republic,2009,6,21,-15
BRA,Brazil,SVK,Slovak Republic,2010,9,1,8
BRA,Brazil,SVK,Slovak Republic,2011,5,14,-9
BRA,Brazil,SVK,Slovak Republic,2012,6,0,6
BRA,Brazil,SVK,Slovak Republic,2013,4,0,4
BRA,Brazil,SVK,Slovak Republic,2014,3,0,3
BRA,Brazil,SVK,Slovak Republic,2015,11,0,11
BRA,Brazil,SVK,Slovak Republic,2016,5,1,4
BRA,Brazil,SVK,Slovak Republic,2017,6,0,6
BRA,Brazil,ESP,Spain,2008,20489,12489,8000
BRA,Brazil,ESP,Spain,2009,10473,16776,-6303
BRA,Brazil,ESP,Spain,2010,8691,15582,-6891
BRA,Brazil,ESP,Spain,2011,7945,14568,-6623
BRA,Brazil,ESP,Spain,2012,6397,13801,-7404
BRA,Brazil,ESP,Spain,2013,5076,14977,-9901
BRA,Brazil,ESP,Spain,2014,5644,7524,-1880
BRA,Brazil,ESP,Spain,2015,7086,4890,2196
BRA,Brazil,ESP,Spain,2016,9715,4271,5444
BRA,Brazil,ESP,Spain,2017,12535,5800,6735
BRA,Brazil,SWE,Sweden,2008,475,118,357
BRA,Brazil,SWE,Sweden,2009,436,125,311
BRA,Brazil,SWE,Sweden,2010,380,141,239
BRA,Brazil,SWE,Sweden,2011,414,119,295
BRA,Brazil,SWE,Sweden,2012,353,145,208
BRA,Brazil,SWE,Sweden,2013,383,144,239
BRA,Brazil,SWE,Sweden,2014,358,179,179
BRA,Brazil,SWE,Sweden,2015,554,221,333
BRA,Brazil,SWE,Sweden,2016,643,190,453
BRA,Brazil,SWE,Sweden,2017,689,258,431
BRA,Brazil,CHE,Switzerland,2010,2473,952,1521
BRA,Brazil,CHE,Switzerland,2011,2152,943,1209
BRA,Brazil,CHE,Switzerland,2012,1942,945,997
BRA,Brazil,CHE,Switzerland,2013,1904,1005,899
BRA,Brazil,CHE,Switzerland,2014,1730,883,847
BRA,Brazil,CHE,Switzerland,2015,1769,778,991
BRA,Brazil,CHE,Switzerland,2016,1793,759,1034
BRA,Brazil,CHE,Switzerland,2017,1917,713,1204
BRA,Brazil,TUR,Turkey,2010,53,0,53
BRA,Brazil,TUR,Turkey,2016,324,168,156
BRA,Brazil,TUR,Turkey,2017,373,281,92
BRA,Brazil,GBR,United Kingdom,2011,1000,1000,0
BRA,Brazil,GBR,United Kingdom,2012,1000,2000,-1000
BRA,Brazil,GBR,United Kingdom,2013,3000,1000,2000
BRA,Brazil,GBR,United Kingdom,2014,9000,1000,8000
BRA,Brazil,GBR,United Kingdom,2015,2000,3000,-1000
BRA,Brazil,USA,United States,2008,12195,0,12195
BRA,Brazil,USA,United States,2009,14701,0,14701
BRA,Brazil,USA,United States,2010,12258,0,12258
BRA,Brazil,USA,United States,2011,11763,0,11763
BRA,Brazil,USA,United States,2012,11441,0,11441
BRA,Brazil,USA,United States,2013,11033,0,11033
BRA,Brazil,USA,United States,2014,10429,0,10429
BRA,Brazil,USA,United States,2015,11424,0,11424
BRA,Brazil,USA,United States,2016,13812,0,13812
BRA,Brazil,USA,United States,2017,14989,0,14989
BRA,Brazil,CHL,Chile,2008,909,0,909
BRA,Brazil,CHL,Chile,2009,800,0,800
BRA,Brazil,CHL,Chile,2010,998,0,998
BRA,Brazil,CHL,Chile,2011,1095,0,1095
BRA,Brazil,CHL,Chile,2012,1235,0,1235
BRA,Brazil,CHL,Chile,2013,1163,0,1163
BRA,Brazil,CHL,Chile,2014,1218,0,1218
BRA,Brazil,CHL,Chile,2015,1707,0,1707
BRA,Brazil,CHL,Chile,2016,1991,0,1991
BRA,Brazil,EST,Estonia,2008,5,0,5
BRA,Brazil,EST,Estonia,2009,4,0,4
BRA,Brazil,EST,Estonia,2010,4,0,4
BRA,Brazil,EST,Estonia,2011,12,0,12
BRA,Brazil,EST,Estonia,2012,3,0,3
BRA,Brazil,EST,Estonia,2013,12,0,12
BRA,Brazil,EST,Estonia,2014,6,0,6
BRA,Brazil,EST,Estonia,2015,22,0,22
BRA,Brazil,EST,Estonia,2016,32,0,32
BRA,Brazil,EST,Estonia,2017,38,0,38
BRA,Brazil,ISR,Israel,2008,208,0,208
BRA,Brazil,ISR,Israel,2009,236,0,236
BRA,Brazil,ISR,Israel,2010,244,0,244
BRA,Brazil,ISR,Israel,2011,157,0,157
BRA,Brazil,ISR,Israel,2012,163,0,163
BRA,Brazil,ISR,Israel,2013,169,0,169
BRA,Brazil,ISR,Israel,2014,251,0,251
BRA,Brazil,ISR,Israel,2015,404,0,404
BRA,Brazil,ISR,Israel,2016,579,0,579
BRA,Brazil,ISR,Israel,2017,618,0,618
BRA,Brazil,SVN,Slovenia,2008,21,0,21
BRA,Brazil,SVN,Slovenia,2009,26,0,26
BRA,Brazil,SVN,Slovenia,2010,21,0,21
BRA,Brazil,SVN,Slovenia,2011,12,0,12
BRA,Brazil,SVN,Slovenia,2012,12,4,8
BRA,Brazil,SVN,Slovenia,2013,8,0,8
BRA,Brazil,SVN,Slovenia,2014,8,0,8
BRA,Brazil,SVN,Slovenia,2015,34,1,33
BRA,Brazil,SVN,Slovenia,2016,8,0,8
BRA,Brazil,SVN,Slovenia,2017,34,5,29
BRN,Brunei Darussalam,AUS,Australia,2008,39,31,8
BRN,Brunei Darussalam,AUS,Australia,2009,30,16,14
BRN,Brunei Darussalam,AUS,Australia,2010,37,19,18
BRN,Brunei Darussalam,AUS,Australia,2011,28,31,-3
BRN,Brunei Darussalam,AUS,Australia,2012,31,18,13
BRN,Brunei Darussalam,AUS,Australia,2013,36,24,12
BRN,Brunei Darussalam,AUS,Australia,2014,29,27,2
BRN,Brunei Darussalam,AUS,Australia,2015,26,0,26
BRN,Brunei Darussalam,AUS,Australia,2016,41,0,41
BRN,Brunei Darussalam,AUS,Australia,2017,24,0,24
BRN,Brunei Darussalam,AUT,Austria,2008,0,0,0
BRN,Brunei Darussalam,AUT,Austria,2009,4,0,4
BRN,Brunei Darussalam,AUT,Austria,2010,1,0,1
BRN,Brunei Darussalam,AUT,Austria,2011,4,1,3
BRN,Brunei Darussalam,AUT,Austria,2012,0,0,0
BRN,Brunei Darussalam,AUT,Austria,2013,1,0,1
BRN,Brunei Darussalam,AUT,Austria,2014,0,0,0
BRN,Brunei Darussalam,AUT,Austria,2015,4,1,3
BRN,Brunei Darussalam,AUT,Austria,2016,4,1,3
BRN,Brunei Darussalam,AUT,Austria,2017,0,4,-4
BRN,Brunei Darussalam,BEL,Belgium,2010,1,0,1
BRN,Brunei Darussalam,CAN,Canada,2008,10,0,10
BRN,Brunei Darussalam,CAN,Canada,2009,5,0,5
BRN,Brunei Darussalam,CAN,Canada,2010,12,0,12
BRN,Brunei Darussalam,CAN,Canada,2011,6,0,6
BRN,Brunei Darussalam,CAN,Canada,2012,3,0,3
BRN,Brunei Darussalam,CAN,Canada,2013,6,0,6
BRN,Brunei Darussalam,CAN,Canada,2014,3,0,3
BRN,Brunei Darussalam,CAN,Canada,2015,9,0,9
BRN,Brunei Darussalam,CAN,Canada,2016,5,0,5
BRN,Brunei Darussalam,CAN,Canada,2017,10,0,10
BRN,Brunei Darussalam,DNK,Denmark,2013,0,0,0
BRN,Brunei Darussalam,DNK,Denmark,2014,0,0,0
BRN,Brunei Darussalam,DNK,Denmark,2015,0,0,0
BRN,Brunei Darussalam,DNK,Denmark,2016,1,0,1
BRN,Brunei Darussalam,DNK,Denmark,2017,0,0,0
BRN,Brunei Darussalam,FIN,Finland,2008,0,1,-1
BRN,Brunei Darussalam,FIN,Finland,2009,0,0,0
BRN,Brunei Darussalam,FIN,Finland,2010,0,0,0
BRN,Brunei Darussalam,FIN,Finland,2011,0,0,0
BRN,Brunei Darussalam,FIN,Finland,2012,0,0,0
BRN,Brunei Darussalam,FIN,Finland,2013,0,0,0
BRN,Brunei Darussalam,FIN,Finland,2014,1,0,1
BRN,Brunei Darussalam,FIN,Finland,2015,0,0,0
BRN,Brunei Darussalam,FIN,Finland,2016,0,0,0
BRN,Brunei Darussalam,FIN,Finland,2017,1,0,1
BRN,Brunei Darussalam,FRA,France,2008,0,0,0
BRN,Brunei Darussalam,FRA,France,2009,0,0,0
BRN,Brunei Darussalam,FRA,France,2010,1,0,1
BRN,Brunei Darussalam,FRA,France,2011,1,0,1
BRN,Brunei Darussalam,FRA,France,2012,2,0,2
BRN,Brunei Darussalam,FRA,France,2013,2,0,2
BRN,Brunei Darussalam,FRA,France,2014,1,0,1
BRN,Brunei Darussalam,FRA,France,2015,2,0,2
BRN,Brunei Darussalam,FRA,France,2016,1,0,1
BRN,Brunei Darussalam,FRA,France,2017,0,0,0
BRN,Brunei Darussalam,DEU,Germany,2008,12,17,-5
BRN,Brunei Darussalam,DEU,Germany,2009,61,4,57
BRN,Brunei Darussalam,DEU,Germany,2010,89,45,44
BRN,Brunei Darussalam,DEU,Germany,2011,56,132,-76
BRN,Brunei Darussalam,DEU,Germany,2012,19,7,12
BRN,Brunei Darussalam,DEU,Germany,2013,17,15,2
BRN,Brunei Darussalam,DEU,Germany,2014,22,16,6
BRN,Brunei Darussalam,DEU,Germany,2015,14,16,-2
BRN,Brunei Darussalam,DEU,Germany,2016,10,8,2
BRN,Brunei Darussalam,DEU,Germany,2017,6,9,-3
BRN,Brunei Darussalam,HUN,Hungary,2008,0,0,0
BRN,Brunei Darussalam,HUN,Hungary,2009,0,0,0
BRN,Brunei Darussalam,HUN,Hungary,2010,0,0,0
BRN,Brunei Darussalam,HUN,Hungary,2011,0,0,0
BRN,Brunei Darussalam,HUN,Hungary,2012,0,0,0
BRN,Brunei Darussalam,HUN,Hungary,2013,1,0,1
BRN,Brunei Darussalam,HUN,Hungary,2014,0,0,0
BRN,Brunei Darussalam,HUN,Hungary,2015,0,0,0
BRN,Brunei Darussalam,HUN,Hungary,2016,0,0,0
BRN,Brunei Darussalam,HUN,Hungary,2017,0,0,0
BRN,Brunei Darussalam,ISL,Iceland,2016,0,0,0
BRN,Brunei Darussalam,ISL,Iceland,2017,0,0,0
BRN,Brunei Darussalam,ITA,Italy,2008,9,2,7
BRN,Brunei Darussalam,ITA,Italy,2009,8,2,6
BRN,Brunei Darussalam,ITA,Italy,2010,8,0,8
BRN,Brunei Darussalam,ITA,Italy,2011,1,0,1
BRN,Brunei Darussalam,ITA,Italy,2012,3,0,3
BRN,Brunei Darussalam,ITA,Italy,2013,2,0,2
BRN,Brunei Darussalam,ITA,Italy,2014,2,0,2
BRN,Brunei Darussalam,ITA,Italy,2015,0,1,-1
BRN,Brunei Darussalam,JPN,Japan,2008,21,19,2
BRN,Brunei Darussalam,JPN,Japan,2009,20,27,-7
BRN,Brunei Darussalam,JPN,Japan,2010,24,16,8
BRN,Brunei Darussalam,JPN,Japan,2011,15,14,1
BRN,Brunei Darussalam,JPN,Japan,2012,32,26,6
BRN,Brunei Darussalam,JPN,Japan,2013,47,43,4
BRN,Brunei Darussalam,JPN,Japan,2014,67,48,19
BRN,Brunei Darussalam,JPN,Japan,2015,83,79,4
BRN,Brunei Darussalam,JPN,Japan,2016,82,80,2
BRN,Brunei Darussalam,JPN,Japan,2017,76,79,-3
BRN,Brunei Darussalam,KOR,Korea,2008,4,2,2
BRN,Brunei Darussalam,KOR,Korea,2009,7,3,4
BRN,Brunei Darussalam,KOR,Korea,2010,14,2,12
BRN,Brunei Darussalam,KOR,Korea,2011,10,17,-7
BRN,Brunei Darussalam,KOR,Korea,2012,61,44,17
BRN,Brunei Darussalam,KOR,Korea,2013,114,89,25
BRN,Brunei Darussalam,KOR,Korea,2014,135,135,0
BRN,Brunei Darussalam,KOR,Korea,2015,119,161,-42
BRN,Brunei Darussalam,KOR,Korea,2016,125,121,4
BRN,Brunei Darussalam,KOR,Korea,2017,101,107,-6
BRN,Brunei Darussalam,LUX,Luxembourg,2008,0,0,0
BRN,Brunei Darussalam,LUX,Luxembourg,2009,0,0,0
BRN,Brunei Darussalam,LUX,Luxembourg,2010,0,0,0
BRN,Brunei Darussalam,LUX,Luxembourg,2011,0,0,0
BRN,Brunei Darussalam,LUX,Luxembourg,2012,0,0,0
BRN,Brunei Darussalam,LUX,Luxembourg,2013,0,0,0
BRN,Brunei Darussalam,LUX,Luxembourg,2014,0,0,0
BRN,Brunei Darussalam,LUX,Luxembourg,2015,0,0,0
BRN,Brunei Darussalam,LUX,Luxembourg,2016,0,0,0
BRN,Brunei Darussalam,LUX,Luxembourg,2017,1,0,1
BRN,Brunei Darussalam,MEX,Mexico,2012,0,0,0
BRN,Brunei Darussalam,MEX,Mexico,2013,0,0,0
BRN,Brunei Darussalam,MEX,Mexico,2014,0,0,0
BRN,Brunei Darussalam,NLD,Netherlands,2008,5,14,-9
BRN,Brunei Darussalam,NLD,Netherlands,2009,7,12,-5
BRN,Brunei Darussalam,NLD,Netherlands,2010,6,4,2
BRN,Brunei Darussalam,NLD,Netherlands,2011,10,12,-2
BRN,Brunei Darussalam,NLD,Netherlands,2012,7,12,-5
BRN,Brunei Darussalam,NLD,Netherlands,2013,31,1,30
BRN,Brunei Darussalam,NLD,Netherlands,2014,14,7,7
BRN,Brunei Darussalam,NLD,Netherlands,2015,16,12,4
BRN,Brunei Darussalam,NLD,Netherlands,2016,3,16,-13
BRN,Brunei Darussalam,NLD,Netherlands,2017,10,19,-9
BRN,Brunei Darussalam,NZL,New Zealand,2008,14,4,10
BRN,Brunei Darussalam,NZL,New Zealand,2009,12,9,3
BRN,Brunei Darussalam,NZL,New Zealand,2010,18,6,12
BRN,Brunei Darussalam,NZL,New Zealand,2011,19,8,11
BRN,Brunei Darussalam,NZL,New Zealand,2012,19,10,9
BRN,Brunei Darussalam,NZL,New Zealand,2013,15,15,0
BRN,Brunei Darussalam,NZL,New Zealand,2014,22,9,13
BRN,Brunei Darussalam,NZL,New Zealand,2015,26,7,19
BRN,Brunei Darussalam,NZL,New Zealand,2016,24,8,16
BRN,Brunei Darussalam,NZL,New Zealand,2017,14,9,5
BRN,Brunei Darussalam,NOR,Norway,2008,0,0,0
BRN,Brunei Darussalam,NOR,Norway,2009,3,0,3
BRN,Brunei Darussalam,NOR,Norway,2010,0,0,0
BRN,Brunei Darussalam,NOR,Norway,2011,3,0,3
BRN,Brunei Darussalam,NOR,Norway,2012,0,3,-3
BRN,Brunei Darussalam,NOR,Norway,2013,1,3,-2
BRN,Brunei Darussalam,NOR,Norway,2014,0,0,0
BRN,Brunei Darussalam,NOR,Norway,2015,0,0,0
BRN,Brunei Darussalam,NOR,Norway,2016,1,1,0
BRN,Brunei Darussalam,NOR,Norway,2017,0,0,0
BRN,Brunei Darussalam,POL,Poland,2009,0,0,0
BRN,Brunei Darussalam,POL,Poland,2010,0,0,0
BRN,Brunei Darussalam,POL,Poland,2011,1,0,1
BRN,Brunei Darussalam,POL,Poland,2012,0,0,0
BRN,Brunei Darussalam,POL,Poland,2013,0,0,0
BRN,Brunei Darussalam,POL,Poland,2014,0,0,0
BRN,Brunei Darussalam,POL,Poland,2015,0,0,0
BRN,Brunei Darussalam,POL,Poland,2016,0,0,0
BRN,Brunei Darussalam,POL,Poland,2017,0,0,0
BRN,Brunei Darussalam,SVK,Slovak Republic,2008,0,0,0
BRN,Brunei Darussalam,ESP,Spain,2008,1,0,1
BRN,Brunei Darussalam,ESP,Spain,2009,1,2,-1
BRN,Brunei Darussalam,ESP,Spain,2010,0,0,0
BRN,Brunei Darussalam,ESP,Spain,2011,0,0,0
BRN,Brunei Darussalam,ESP,Spain,2012,0,0,0
BRN,Brunei Darussalam,ESP,Spain,2013,1,0,1
BRN,Brunei Darussalam,ESP,Spain,2014,1,0,1
BRN,Brunei Darussalam,ESP,Spain,2015,2,0,2
BRN,Brunei Darussalam,ESP,Spain,2016,0,0,0
BRN,Brunei Darussalam,ESP,Spain,2017,1,0,1
BRN,Brunei Darussalam,SWE,Sweden,2008,1,0,1
BRN,Brunei Darussalam,SWE,Sweden,2009,0,0,0
BRN,Brunei Darussalam,SWE,Sweden,2010,0,1,-1
BRN,Brunei Darussalam,SWE,Sweden,2011,3,1,2
BRN,Brunei Darussalam,SWE,Sweden,2012,0,2,-2
BRN,Brunei Darussalam,SWE,Sweden,2013,0,0,0
BRN,Brunei Darussalam,SWE,Sweden,2014,0,0,0
BRN,Brunei Darussalam,SWE,Sweden,2015,0,0,0
BRN,Brunei Darussalam,SWE,Sweden,2016,0,0,0
BRN,Brunei Darussalam,SWE,Sweden,2017,0,0,0
BRN,Brunei Darussalam,CHE,Switzerland,2010,1,1,0
BRN,Brunei Darussalam,CHE,Switzerland,2011,1,2,-1
BRN,Brunei Darussalam,CHE,Switzerland,2012,1,2,-1
BRN,Brunei Darussalam,CHE,Switzerland,2013,2,1,1
BRN,Brunei Darussalam,CHE,Switzerland,2014,2,1,1
BRN,Brunei Darussalam,CHE,Switzerland,2015,2,0,2
BRN,Brunei Darussalam,CHE,Switzerland,2016,2,1,1
BRN,Brunei Darussalam,CHE,Switzerland,2017,3,2,1
BRN,Brunei Darussalam,TUR,Turkey,2010,1,0,1
BRN,Brunei Darussalam,USA,United States,2008,18,0,18
BRN,Brunei Darussalam,USA,United States,2009,26,0,26
BRN,Brunei Darussalam,USA,United States,2010,20,0,20
BRN,Brunei Darussalam,USA,United States,2011,25,0,25
BRN,Brunei Darussalam,USA,United States,2012,19,0,19
BRN,Brunei Darussalam,USA,United States,2013,21,0,21
BRN,Brunei Darussalam,USA,United States,2014,25,0,25
BRN,Brunei Darussalam,USA,United States,2015,21,0,21
BRN,Brunei Darussalam,USA,United States,2016,31,0,31
BRN,Brunei Darussalam,USA,United States,2017,24,0,24
BRN,Brunei Darussalam,CHL,Chile,2008,0,0,0
BRN,Brunei Darussalam,CHL,Chile,2009,0,0,0
BRN,Brunei Darussalam,CHL,Chile,2010,0,0,0
BRN,Brunei Darussalam,CHL,Chile,2011,0,0,0
BRN,Brunei Darussalam,CHL,Chile,2012,0,0,0
BRN,Brunei Darussalam,CHL,Chile,2013,0,0,0
BRN,Brunei Darussalam,CHL,Chile,2014,0,0,0
BRN,Brunei Darussalam,CHL,Chile,2015,0,0,0
BRN,Brunei Darussalam,CHL,Chile,2016,0,0,0
BRN,Brunei Darussalam,EST,Estonia,2008,0,0,0
BRN,Brunei Darussalam,EST,Estonia,2009,0,0,0
BRN,Brunei Darussalam,EST,Estonia,2010,0,0,0
BRN,Brunei Darussalam,EST,Estonia,2011,0,0,0
BRN,Brunei Darussalam,EST,Estonia,2012,0,0,0
BRN,Brunei Darussalam,EST,Estonia,2013,0,0,0
BRN,Brunei Darussalam,EST,Estonia,2014,0,0,0
BRN,Brunei Darussalam,EST,Estonia,2015,0,0,0
BRN,Brunei Darussalam,EST,Estonia,2016,0,0,0
BRN,Brunei Darussalam,EST,Estonia,2017,0,0,0
BGR,Bulgaria,AUS,Australia,2008,106,57,49
BGR,Bulgaria,AUS,Australia,2009,93,44,49
BGR,Bulgaria,AUS,Australia,2010,88,43,45
BGR,Bulgaria,AUS,Australia,2011,64,39,25
BGR,Bulgaria,AUS,Australia,2012,79,53,26
BGR,Bulgaria,AUS,Australia,2013,66,29,37
BGR,Bulgaria,AUS,Australia,2014,120,33,87
BGR,Bulgaria,AUS,Australia,2015,89,0,89
BGR,Bulgaria,AUS,Australia,2016,88,0,88
BGR,Bulgaria,AUS,Australia,2017,90,0,90
BGR,Bulgaria,AUT,Austria,2008,2457,1204,1253
BGR,Bulgaria,AUT,Austria,2009,2628,1698,930
BGR,Bulgaria,AUT,Austria,2010,3121,1896,1225
BGR,Bulgaria,AUT,Austria,2011,3242,2097,1145
BGR,Bulgaria,AUT,Austria,2012,3631,2137,1494
BGR,Bulgaria,AUT,Austria,2013,3909,2294,1615
BGR,Bulgaria,AUT,Austria,2014,5824,2419,3405
BGR,Bulgaria,AUT,Austria,2015,5232,2690,2542
BGR,Bulgaria,AUT,Austria,2016,4929,2746,2183
BGR,Bulgaria,AUT,Austria,2017,5001,2800,2201
BGR,Bulgaria,BEL,Belgium,2008,3887,351,3536
BGR,Bulgaria,BEL,Belgium,2009,3277,673,2604
BGR,Bulgaria,BEL,Belgium,2010,4227,752,3475
BGR,Bulgaria,BEL,Belgium,2011,4285,1445,2840
BGR,Bulgaria,BEL,Belgium,2012,4517,1688,2829
BGR,Bulgaria,BEL,Belgium,2013,3934,1616,2318
BGR,Bulgaria,BEL,Belgium,2014,4231,1453,2778
BGR,Bulgaria,BEL,Belgium,2015,3753,1190,2563
BGR,Bulgaria,BEL,Belgium,2016,3273,1139,2134
BGR,Bulgaria,BEL,Belgium,2017,3623,1111,2512
BGR,Bulgaria,CAN,Canada,2008,994,0,994
BGR,Bulgaria,CAN,Canada,2009,784,0,784
BGR,Bulgaria,CAN,Canada,2010,556,0,556
BGR,Bulgaria,CAN,Canada,2011,365,0,365
BGR,Bulgaria,CAN,Canada,2012,451,0,451
BGR,Bulgaria,CAN,Canada,2013,512,0,512
BGR,Bulgaria,CAN,Canada,2014,451,0,451
BGR,Bulgaria,CAN,Canada,2015,371,0,371
BGR,Bulgaria,CAN,Canada,2016,370,0,370
BGR,Bulgaria,CAN,Canada,2017,300,0,300
BGR,Bulgaria,CZE,Czech Republic,2008,1031,81,950
BGR,Bulgaria,CZE,Czech Republic,2009,571,131,440
BGR,Bulgaria,CZE,Czech Republic,2010,583,59,524
BGR,Bulgaria,CZE,Czech Republic,2011,488,24,464
BGR,Bulgaria,CZE,Czech Republic,2012,733,30,703
BGR,Bulgaria,CZE,Czech Republic,2013,951,79,872
BGR,Bulgaria,CZE,Czech Republic,2014,1102,79,1023
BGR,Bulgaria,CZE,Czech Republic,2015,1022,101,921
BGR,Bulgaria,CZE,Czech Republic,2016,1331,120,1211
BGR,Bulgaria,CZE,Czech Republic,2017,1620,183,1437
BGR,Bulgaria,DNK,Denmark,2008,697,101,596
BGR,Bulgaria,DNK,Denmark,2009,853,155,698
BGR,Bulgaria,DNK,Denmark,2010,933,236,697
BGR,Bulgaria,DNK,Denmark,2011,991,277,714
BGR,Bulgaria,DNK,Denmark,2012,1172,329,843
BGR,Bulgaria,DNK,Denmark,2013,1364,502,862
BGR,Bulgaria,DNK,Denmark,2014,1445,537,908
BGR,Bulgaria,DNK,Denmark,2015,1389,671,718
BGR,Bulgaria,DNK,Denmark,2016,1373,815,558
BGR,Bulgaria,DNK,Denmark,2017,1319,891,428
BGR,Bulgaria,FIN,Finland,2008,166,24,142
BGR,Bulgaria,FIN,Finland,2009,127,34,93
BGR,Bulgaria,FIN,Finland,2010,129,11,118
BGR,Bulgaria,FIN,Finland,2011,195,12,183
BGR,Bulgaria,FIN,Finland,2012,269,16,253
BGR,Bulgaria,FIN,Finland,2013,272,25,247
BGR,Bulgaria,FIN,Finland,2014,251,28,223
BGR,Bulgaria,FIN,Finland,2015,228,36,192
BGR,Bulgaria,FIN,Finland,2016,182,47,135
BGR,Bulgaria,FIN,Finland,2017,200,44,156
BGR,Bulgaria,FRA,France,2008,0,0,0
BGR,Bulgaria,FRA,France,2009,0,0,0
BGR,Bulgaria,FRA,France,2010,0,0,0
BGR,Bulgaria,FRA,France,2011,0,0,0
BGR,Bulgaria,FRA,France,2012,0,0,0
BGR,Bulgaria,FRA,France,2013,1820,0,1820
BGR,Bulgaria,FRA,France,2014,1346,0,1346
BGR,Bulgaria,FRA,France,2015,1771,0,1771
BGR,Bulgaria,FRA,France,2016,1423,0,1423
BGR,Bulgaria,FRA,France,2017,1260,0,1260
BGR,Bulgaria,DEU,Germany,2008,24093,15990,8103
BGR,Bulgaria,DEU,Germany,2009,29221,20065,9156
BGR,Bulgaria,DEU,Germany,2010,39844,23985,15859
BGR,Bulgaria,DEU,Germany,2011,52417,29756,22661
BGR,Bulgaria,DEU,Germany,2012,60209,34276,25933
BGR,Bulgaria,DEU,Germany,2013,60896,39172,21724
BGR,Bulgaria,DEU,Germany,2014,80069,45216,34853
BGR,Bulgaria,DEU,Germany,2015,86274,46754,39520
BGR,Bulgaria,DEU,Germany,2016,82956,55859,27097
BGR,Bulgaria,DEU,Germany,2017,81627,51290,30337
BGR,Bulgaria,HUN,Hungary,2008,91,75,16
BGR,Bulgaria,HUN,Hungary,2009,72,19,53
BGR,Bulgaria,HUN,Hungary,2010,65,42,23
BGR,Bulgaria,HUN,Hungary,2011,77,0,77
BGR,Bulgaria,HUN,Hungary,2012,80,77,3
BGR,Bulgaria,HUN,Hungary,2013,54,80,-26
BGR,Bulgaria,HUN,Hungary,2014,85,49,36
BGR,Bulgaria,HUN,Hungary,2015,69,39,30
BGR,Bulgaria,HUN,Hungary,2016,99,51,48
BGR,Bulgaria,HUN,Hungary,2017,81,52,29
BGR,Bulgaria,ISL,Iceland,2008,15,16,-1
BGR,Bulgaria,ISL,Iceland,2009,6,10,-4
BGR,Bulgaria,ISL,Iceland,2010,3,3,0
BGR,Bulgaria,ISL,Iceland,2011,9,10,-1
BGR,Bulgaria,ISL,Iceland,2012,18,1,17
BGR,Bulgaria,ISL,Iceland,2013,39,7,32
BGR,Bulgaria,ISL,Iceland,2014,72,9,63
BGR,Bulgaria,ISL,Iceland,2015,64,11,53
BGR,Bulgaria,ISL,Iceland,2016,96,36,60
BGR,Bulgaria,ISL,Iceland,2017,95,27,68
BGR,Bulgaria,ITA,Italy,2008,8436,540,7896
BGR,Bulgaria,ITA,Italy,2009,6244,640,5604
BGR,Bulgaria,ITA,Italy,2010,5877,448,5429
BGR,Bulgaria,ITA,Italy,2011,5101,401,4700
BGR,Bulgaria,ITA,Italy,2012,4794,539,4255
BGR,Bulgaria,ITA,Italy,2013,3734,728,3006
BGR,Bulgaria,ITA,Italy,2014,2932,770,2162
BGR,Bulgaria,ITA,Italy,2015,2794,723,2071
BGR,Bulgaria,ITA,Italy,2016,2760,0,2760
BGR,Bulgaria,ITA,Italy,2017,2566,827,1739
BGR,Bulgaria,JPN,Japan,2008,474,463,11
BGR,Bulgaria,JPN,Japan,2009,260,255,5
BGR,Bulgaria,JPN,Japan,2010,21,15,6
BGR,Bulgaria,JPN,Japan,2011,173,188,-15
BGR,Bulgaria,JPN,Japan,2012,352,328,24
BGR,Bulgaria,JPN,Japan,2013,167,168,-1
BGR,Bulgaria,JPN,Japan,2014,176,135,41
BGR,Bulgaria,JPN,Japan,2015,413,348,65
BGR,Bulgaria,JPN,Japan,2016,321,211,110
BGR,Bulgaria,JPN,Japan,2017,153,153,0
BGR,Bulgaria,KOR,Korea,2008,78,81,-3
BGR,Bulgaria,KOR,Korea,2009,45,57,-12
BGR,Bulgaria,KOR,Korea,2010,51,54,-3
BGR,Bulgaria,KOR,Korea,2011,43,38,5
BGR,Bulgaria,KOR,Korea,2012,44,37,7
BGR,Bulgaria,KOR,Korea,2013,46,53,-7
BGR,Bulgaria,KOR,Korea,2014,49,48,1
BGR,Bulgaria,KOR,Korea,2015,38,38,0
BGR,Bulgaria,KOR,Korea,2016,42,42,0
BGR,Bulgaria,KOR,Korea,2017,45,53,-8
BGR,Bulgaria,LUX,Luxembourg,2008,163,29,134
BGR,Bulgaria,LUX,Luxembourg,2009,106,26,80
BGR,Bulgaria,LUX,Luxembourg,2010,100,22,78
BGR,Bulgaria,LUX,Luxembourg,2011,138,35,103
BGR,Bulgaria,LUX,Luxembourg,2012,127,52,75
BGR,Bulgaria,LUX,Luxembourg,2013,102,59,43
BGR,Bulgaria,LUX,Luxembourg,2014,191,37,154
BGR,Bulgaria,LUX,Luxembourg,2015,194,42,152
BGR,Bulgaria,LUX,Luxembourg,2016,204,67,137
BGR,Bulgaria,LUX,Luxembourg,2017,203,86,117
BGR,Bulgaria,MEX,Mexico,2008,20,0,20
BGR,Bulgaria,MEX,Mexico,2009,28,0,28
BGR,Bulgaria,MEX,Mexico,2010,27,0,27
BGR,Bulgaria,MEX,Mexico,2011,15,0,15
BGR,Bulgaria,MEX,Mexico,2012,7,0,7
BGR,Bulgaria,MEX,Mexico,2013,57,0,57
BGR,Bulgaria,MEX,Mexico,2014,38,0,38
BGR,Bulgaria,MEX,Mexico,2015,19,0,19
BGR,Bulgaria,MEX,Mexico,2016,20,0,20
BGR,Bulgaria,MEX,Mexico,2017,21,0,21
BGR,Bulgaria,NLD,Netherlands,2008,5231,1529,3702
BGR,Bulgaria,NLD,Netherlands,2009,4333,2310,2023
BGR,Bulgaria,NLD,Netherlands,2010,4269,2593,1676
BGR,Bulgaria,NLD,Netherlands,2011,5350,2853,2497
BGR,Bulgaria,NLD,Netherlands,2012,5030,4290,740
BGR,Bulgaria,NLD,Netherlands,2013,4519,4413,106
BGR,Bulgaria,NLD,Netherlands,2014,5184,3273,1911
BGR,Bulgaria,NLD,Netherlands,2015,4828,2934,1894
BGR,Bulgaria,NLD,Netherlands,2016,4981,3039,1942
BGR,Bulgaria,NLD,Netherlands,2017,5971,3087,2884
BGR,Bulgaria,NZL,New Zealand,2008,24,11,13
BGR,Bulgaria,NZL,New Zealand,2009,8,13,-5
BGR,Bulgaria,NZL,New Zealand,2010,18,16,2
BGR,Bulgaria,NZL,New Zealand,2011,13,10,3
BGR,Bulgaria,NZL,New Zealand,2012,26,3,23
BGR,Bulgaria,NZL,New Zealand,2013,44,9,35
BGR,Bulgaria,NZL,New Zealand,2014,25,8,17
BGR,Bulgaria,NZL,New Zealand,2015,36,12,24
BGR,Bulgaria,NZL,New Zealand,2016,22,16,6
BGR,Bulgaria,NZL,New Zealand,2017,12,5,7
BGR,Bulgaria,NOR,Norway,2008,420,27,393
BGR,Bulgaria,NOR,Norway,2009,419,70,349
BGR,Bulgaria,NOR,Norway,2010,638,107,531
BGR,Bulgaria,NOR,Norway,2011,779,155,624
BGR,Bulgaria,NOR,Norway,2012,1027,197,830
BGR,Bulgaria,NOR,Norway,2013,1204,127,1077
BGR,Bulgaria,NOR,Norway,2014,965,108,857
BGR,Bulgaria,NOR,Norway,2015,903,118,785
BGR,Bulgaria,NOR,Norway,2016,674,317,357
BGR,Bulgaria,NOR,Norway,2017,672,350,322
BGR,Bulgaria,POL,Poland,2008,378,0,378
BGR,Bulgaria,POL,Poland,2009,398,0,398
BGR,Bulgaria,POL,Poland,2010,407,0,407
BGR,Bulgaria,POL,Poland,2011,321,0,321
BGR,Bulgaria,POL,Poland,2012,394,0,394
BGR,Bulgaria,POL,Poland,2013,572,0,572
BGR,Bulgaria,POL,Poland,2014,572,0,572
BGR,Bulgaria,POL,Poland,2015,435,0,435
BGR,Bulgaria,POL,Poland,2016,685,0,685
BGR,Bulgaria,POL,Poland,2017,753,0,753
BGR,Bulgaria,PRT,Portugal,2008,884,0,884
BGR,Bulgaria,PRT,Portugal,2009,1519,0,1519
BGR,Bulgaria,PRT,Portugal,2010,1367,0,1367
BGR,Bulgaria,PRT,Portugal,2011,973,0,973
BGR,Bulgaria,PRT,Portugal,2012,695,0,695
BGR,Bulgaria,PRT,Portugal,2013,839,0,839
BGR,Bulgaria,PRT,Portugal,2014,780,0,780
BGR,Bulgaria,PRT,Portugal,2015,857,0,857
BGR,Bulgaria,PRT,Portugal,2016,857,0,857
BGR,Bulgaria,PRT,Portugal,2017,802,0,802
BGR,Bulgaria,SVK,Slovak Republic,2008,350,5,345
BGR,Bulgaria,SVK,Slovak Republic,2009,124,11,113
BGR,Bulgaria,SVK,Slovak Republic,2010,135,6,129
BGR,Bulgaria,SVK,Slovak Republic,2011,205,17,188
BGR,Bulgaria,SVK,Slovak Republic,2012,177,6,171
BGR,Bulgaria,SVK,Slovak Republic,2013,51,0,51
BGR,Bulgaria,SVK,Slovak Republic,2014,54,4,50
BGR,Bulgaria,SVK,Slovak Republic,2015,146,0,146
BGR,Bulgaria,SVK,Slovak Republic,2016,140,0,140
BGR,Bulgaria,SVK,Slovak Republic,2017,82,0,82
BGR,Bulgaria,ESP,Spain,2008,10766,7010,3756
BGR,Bulgaria,ESP,Spain,2009,7680,11090,-3410
BGR,Bulgaria,ESP,Spain,2010,8386,11376,-2990
BGR,Bulgaria,ESP,Spain,2011,9890,8546,1344
BGR,Bulgaria,ESP,Spain,2012,6224,11307,-5083
BGR,Bulgaria,ESP,Spain,2013,4947,12822,-7875
BGR,Bulgaria,ESP,Spain,2014,4699,10610,-5911
BGR,Bulgaria,ESP,Spain,2015,4921,9359,-4438
BGR,Bulgaria,ESP,Spain,2016,5150,8515,-3365
BGR,Bulgaria,ESP,Spain,2017,6071,8728,-2657
BGR,Bulgaria,SWE,Sweden,2008,962,117,845
BGR,Bulgaria,SWE,Sweden,2009,767,145,622
BGR,Bulgaria,SWE,Sweden,2010,629,162,467
BGR,Bulgaria,SWE,Sweden,2011,600,215,385
BGR,Bulgaria,SWE,Sweden,2012,764,231,533
BGR,Bulgaria,SWE,Sweden,2013,862,223,639
BGR,Bulgaria,SWE,Sweden,2014,934,234,700
BGR,Bulgaria,SWE,Sweden,2015,877,242,635
BGR,Bulgaria,SWE,Sweden,2016,804,252,552
BGR,Bulgaria,SWE,Sweden,2017,812,193,619
BGR,Bulgaria,CHE,Switzerland,2008,349,170,179
BGR,Bulgaria,CHE,Switzerland,2009,490,165,325
BGR,Bulgaria,CHE,Switzerland,2010,600,155,445
BGR,Bulgaria,CHE,Switzerland,2011,898,167,731
BGR,Bulgaria,CHE,Switzerland,2012,1025,183,842
BGR,Bulgaria,CHE,Switzerland,2013,1057,240,817
BGR,Bulgaria,CHE,Switzerland,2014,949,228,721
BGR,Bulgaria,CHE,Switzerland,2015,991,258,733
BGR,Bulgaria,CHE,Switzerland,2016,1773,262,1511
BGR,Bulgaria,CHE,Switzerland,2017,1691,326,1365
BGR,Bulgaria,TUR,Turkey,2010,1076,0,1076
BGR,Bulgaria,TUR,Turkey,2016,1381,1135,246
BGR,Bulgaria,TUR,Turkey,2017,1391,1520,-129
BGR,Bulgaria,GBR,United Kingdom,2011,4000,1000,3000
BGR,Bulgaria,GBR,United Kingdom,2012,3000,1000,2000
BGR,Bulgaria,GBR,United Kingdom,2013,4000,1000,3000
BGR,Bulgaria,GBR,United Kingdom,2014,8000,1000,7000
BGR,Bulgaria,GBR,United Kingdom,2015,5000,1000,4000
BGR,Bulgaria,GBR,United Kingdom,2016,6000,0,6000
BGR,Bulgaria,GBR,United Kingdom,2017,6000,0,6000
BGR,Bulgaria,USA,United States,2008,2960,0,2960
BGR,Bulgaria,USA,United States,2009,3133,0,3133
BGR,Bulgaria,USA,United States,2010,2570,0,2570
BGR,Bulgaria,USA,United States,2011,2661,0,2661
BGR,Bulgaria,USA,United States,2012,2440,0,2440
BGR,Bulgaria,USA,United States,2013,2844,0,2844
BGR,Bulgaria,USA,United States,2014,2981,0,2981
BGR,Bulgaria,USA,United States,2015,2688,0,2688
BGR,Bulgaria,USA,United States,2016,2670,0,2670
BGR,Bulgaria,USA,United States,2017,2184,0,2184
BGR,Bulgaria,CHL,Chile,2008,12,0,12
BGR,Bulgaria,CHL,Chile,2009,6,0,6
BGR,Bulgaria,CHL,Chile,2010,10,0,10
BGR,Bulgaria,CHL,Chile,2011,16,0,16
BGR,Bulgaria,CHL,Chile,2012,8,0,8
BGR,Bulgaria,CHL,Chile,2013,16,0,16
BGR,Bulgaria,CHL,Chile,2014,22,0,22
BGR,Bulgaria,CHL,Chile,2015,79,0,79
BGR,Bulgaria,CHL,Chile,2016,75,0,75
BGR,Bulgaria,EST,Estonia,2008,14,0,14
BGR,Bulgaria,EST,Estonia,2009,7,0,7
BGR,Bulgaria,EST,Estonia,2010,13,0,13
BGR,Bulgaria,EST,Estonia,2011,6,0,6
BGR,Bulgaria,EST,Estonia,2012,1,0,1
BGR,Bulgaria,EST,Estonia,2013,18,0,18
BGR,Bulgaria,EST,Estonia,2014,20,0,20
BGR,Bulgaria,EST,Estonia,2015,50,0,50
BGR,Bulgaria,EST,Estonia,2016,76,0,76
BGR,Bulgaria,EST,Estonia,2017,75,0,75
BGR,Bulgaria,ISR,Israel,2008,21,0,21
BGR,Bulgaria,ISR,Israel,2009,17,0,17
BGR,Bulgaria,ISR,Israel,2010,30,0,30
BGR,Bulgaria,ISR,Israel,2011,33,0,33
BGR,Bulgaria,ISR,Israel,2012,17,0,17
BGR,Bulgaria,ISR,Israel,2013,15,0,15
BGR,Bulgaria,ISR,Israel,2014,24,0,24
BGR,Bulgaria,ISR,Israel,2015,13,0,13
BGR,Bulgaria,ISR,Israel,2016,11,0,11
BGR,Bulgaria,ISR,Israel,2017,14,0,14
BGR,Bulgaria,SVN,Slovenia,2008,2329,130,2199
BGR,Bulgaria,SVN,Slovenia,2009,1292,382,910
BGR,Bulgaria,SVN,Slovenia,2010,19,311,-292
BGR,Bulgaria,SVN,Slovenia,2011,2330,154,2176
BGR,Bulgaria,SVN,Slovenia,2012,2423,224,2199
BGR,Bulgaria,SVN,Slovenia,2013,2475,2,2473
BGR,Bulgaria,SVN,Slovenia,2014,2103,38,2065
BGR,Bulgaria,SVN,Slovenia,2015,1848,88,1760
BGR,Bulgaria,SVN,Slovenia,2016,1554,81,1473
BGR,Bulgaria,SVN,Slovenia,2017,1446,112,1334
BFA,Burkina Faso,AUS,Australia,2008,0,0,0
BFA,Burkina Faso,AUS,Australia,2009,1,0,1
BFA,Burkina Faso,AUS,Australia,2010,11,0,11
BFA,Burkina Faso,AUS,Australia,2011,0,0,0
BFA,Burkina Faso,AUS,Australia,2012,2,0,2
BFA,Burkina Faso,AUS,Australia,2013,1,0,1
BFA,Burkina Faso,AUS,Australia,2014,0,0,0
BFA,Burkina Faso,AUS,Australia,2015,0,0,0
BFA,Burkina Faso,AUS,Australia,2017,0,0,0
BFA,Burkina Faso,AUT,Austria,2008,12,1,11
BFA,Burkina Faso,AUT,Austria,2009,12,5,7
BFA,Burkina Faso,AUT,Austria,2010,21,8,13
BFA,Burkina Faso,AUT,Austria,2011,3,8,-5
BFA,Burkina Faso,AUT,Austria,2012,13,6,7
BFA,Burkina Faso,AUT,Austria,2013,18,9,9
BFA,Burkina Faso,AUT,Austria,2014,13,10,3
BFA,Burkina Faso,AUT,Austria,2015,20,11,9
BFA,Burkina Faso,AUT,Austria,2016,18,9,9
BFA,Burkina Faso,AUT,Austria,2017,12,7,5
BFA,Burkina Faso,BEL,Belgium,2008,96,0,96
BFA,Burkina Faso,BEL,Belgium,2009,75,0,75
BFA,Burkina Faso,BEL,Belgium,2010,123,30,93
BFA,Burkina Faso,BEL,Belgium,2011,101,0,101
BFA,Burkina Faso,BEL,Belgium,2012,183,95,88
BFA,Burkina Faso,BEL,Belgium,2013,164,101,63
BFA,Burkina Faso,BEL,Belgium,2014,142,76,66
BFA,Burkina Faso,BEL,Belgium,2015,139,77,62
BFA,Burkina Faso,BEL,Belgium,2016,107,42,65
BFA,Burkina Faso,BEL,Belgium,2017,118,43,75
BFA,Burkina Faso,CAN,Canada,2008,139,0,139
BFA,Burkina Faso,CAN,Canada,2009,162,0,162
BFA,Burkina Faso,CAN,Canada,2010,186,0,186
BFA,Burkina Faso,CAN,Canada,2011,144,0,144
BFA,Burkina Faso,CAN,Canada,2012,269,0,269
BFA,Burkina Faso,CAN,Canada,2013,322,0,322
BFA,Burkina Faso,CAN,Canada,2014,339,0,339
BFA,Burkina Faso,CAN,Canada,2015,236,0,236
BFA,Burkina Faso,CAN,Canada,2016,280,0,280
BFA,Burkina Faso,CAN,Canada,2017,260,0,260
BFA,Burkina Faso,CZE,Czech Republic,2008,1,0,1
BFA,Burkina Faso,CZE,Czech Republic,2009,4,0,4
BFA,Burkina Faso,CZE,Czech Republic,2011,11,0,11
BFA,Burkina Faso,CZE,Czech Republic,2012,1,11,-10
BFA,Burkina Faso,CZE,Czech Republic,2013,1,0,1
BFA,Burkina Faso,CZE,Czech Republic,2014,1,0,1
BFA,Burkina Faso,DNK,Denmark,2008,1,4,-3
BFA,Burkina Faso,DNK,Denmark,2009,4,4,0
BFA,Burkina Faso,DNK,Denmark,2010,5,5,0
BFA,Burkina Faso,DNK,Denmark,2011,2,2,0
BFA,Burkina Faso,DNK,Denmark,2012,9,0,9
BFA,Burkina Faso,DNK,Denmark,2013,4,6,-2
BFA,Burkina Faso,DNK,Denmark,2014,1,1,0
BFA,Burkina Faso,DNK,Denmark,2015,6,0,6
BFA,Burkina Faso,DNK,Denmark,2016,1,2,-1
BFA,Burkina Faso,DNK,Denmark,2017,3,2,1
BFA,Burkina Faso,FIN,Finland,2008,1,1,0
BFA,Burkina Faso,FIN,Finland,2009,0,0,0
BFA,Burkina Faso,FIN,Finland,2010,2,0,2
BFA,Burkina Faso,FIN,Finland,2011,2,0,2
BFA,Burkina Faso,FIN,Finland,2012,0,0,0
BFA,Burkina Faso,FIN,Finland,2013,3,0,3
BFA,Burkina Faso,FIN,Finland,2014,5,0,5
BFA,Burkina Faso,FIN,Finland,2015,1,0,1
BFA,Burkina Faso,FIN,Finland,2016,5,0,5
BFA,Burkina Faso,FIN,Finland,2017,2,0,2
BFA,Burkina Faso,FRA,France,2008,406,0,406
BFA,Burkina Faso,FRA,France,2009,427,0,427
BFA,Burkina Faso,FRA,France,2010,422,0,422
BFA,Burkina Faso,FRA,France,2011,430,0,430
BFA,Burkina Faso,FRA,France,2012,446,0,446
BFA,Burkina Faso,FRA,France,2013,456,0,456
BFA,Burkina Faso,FRA,France,2014,514,0,514
BFA,Burkina Faso,FRA,France,2015,457,0,457
BFA,Burkina Faso,FRA,France,2016,398,0,398
BFA,Burkina Faso,FRA,France,2017,465,0,465
BFA,Burkina Faso,DEU,Germany,2008,150,192,-42
BFA,Burkina Faso,DEU,Germany,2009,165,132,33
BFA,Burkina Faso,DEU,Germany,2010,191,150,41
BFA,Burkina Faso,DEU,Germany,2011,194,118,76
BFA,Burkina Faso,DEU,Germany,2012,239,133,106
BFA,Burkina Faso,DEU,Germany,2013,348,152,196
BFA,Burkina Faso,DEU,Germany,2014,353,227,126
BFA,Burkina Faso,DEU,Germany,2015,425,203,222
BFA,Burkina Faso,DEU,Germany,2016,442,268,174
BFA,Burkina Faso,DEU,Germany,2017,424,410,14
BFA,Burkina Faso,HUN,Hungary,2008,1,0,1
BFA,Burkina Faso,HUN,Hungary,2009,0,0,0
BFA,Burkina Faso,HUN,Hungary,2010,0,0,0
BFA,Burkina Faso,HUN,Hungary,2011,0,0,0
BFA,Burkina Faso,HUN,Hungary,2012,1,0,1
BFA,Burkina Faso,HUN,Hungary,2013,0,0,0
BFA,Burkina Faso,HUN,Hungary,2014,1,0,1
BFA,Burkina Faso,HUN,Hungary,2015,2,0,2
BFA,Burkina Faso,HUN,Hungary,2016,3,0,3
BFA,Burkina Faso,HUN,Hungary,2017,4,0,4
BFA,Burkina Faso,ISL,Iceland,2008,0,0,0
BFA,Burkina Faso,ISL,Iceland,2009,0,0,0
BFA,Burkina Faso,ISL,Iceland,2010,0,0,0
BFA,Burkina Faso,ISL,Iceland,2011,0,0,0
BFA,Burkina Faso,ISL,Iceland,2012,0,0,0
BFA,Burkina Faso,ISL,Iceland,2013,0,0,0
BFA,Burkina Faso,ISL,Iceland,2014,0,0,0
BFA,Burkina Faso,ISL,Iceland,2015,0,0,0
BFA,Burkina Faso,ISL,Iceland,2016,0,0,0
BFA,Burkina Faso,ISL,Iceland,2017,0,0,0
BFA,Burkina Faso,ITA,Italy,2008,1334,31,1303
BFA,Burkina Faso,ITA,Italy,2009,1105,35,1070
BFA,Burkina Faso,ITA,Italy,2010,1255,62,1193
BFA,Burkina Faso,ITA,Italy,2011,913,40,873
BFA,Burkina Faso,ITA,Italy,2012,1015,64,951
BFA,Burkina Faso,ITA,Italy,2013,829,56,773
BFA,Burkina Faso,ITA,Italy,2014,519,55,464
BFA,Burkina Faso,ITA,Italy,2015,619,56,563
BFA,Burkina Faso,ITA,Italy,2016,809,0,809
BFA,Burkina Faso,ITA,Italy,2017,1072,55,1017
BFA,Burkina Faso,JPN,Japan,2008,92,85,7
BFA,Burkina Faso,JPN,Japan,2009,77,76,1
BFA,Burkina Faso,JPN,Japan,2010,170,96,74
BFA,Burkina Faso,JPN,Japan,2011,78,75,3
BFA,Burkina Faso,JPN,Japan,2012,111,105,6
BFA,Burkina Faso,JPN,Japan,2013,131,123,8
BFA,Burkina Faso,JPN,Japan,2014,99,83,16
BFA,Burkina Faso,JPN,Japan,2015,135,129,6
BFA,Burkina Faso,JPN,Japan,2016,113,97,16
BFA,Burkina Faso,JPN,Japan,2017,124,110,14
BFA,Burkina Faso,KOR,Korea,2008,1,3,-2
BFA,Burkina Faso,KOR,Korea,2009,3,2,1
BFA,Burkina Faso,KOR,Korea,2010,1,3,-2
BFA,Burkina Faso,KOR,Korea,2011,1,1,0
BFA,Burkina Faso,KOR,Korea,2012,19,11,8
BFA,Burkina Faso,KOR,Korea,2013,2,0,2
BFA,Burkina Faso,KOR,Korea,2014,3,7,-4
BFA,Burkina Faso,KOR,Korea,2015,4,4,0
BFA,Burkina Faso,KOR,Korea,2016,14,2,12
BFA,Burkina Faso,KOR,Korea,2017,18,7,11
BFA,Burkina Faso,LUX,Luxembourg,2008,1,0,1
BFA,Burkina Faso,LUX,Luxembourg,2009,8,0,8
BFA,Burkina Faso,LUX,Luxembourg,2010,3,3,0
BFA,Burkina Faso,LUX,Luxembourg,2011,4,0,4
BFA,Burkina Faso,LUX,Luxembourg,2012,4,1,3
BFA,Burkina Faso,LUX,Luxembourg,2013,1,4,-3
BFA,Burkina Faso,LUX,Luxembourg,2014,3,0,3
BFA,Burkina Faso,LUX,Luxembourg,2015,3,4,-1
BFA,Burkina Faso,LUX,Luxembourg,2016,5,1,4
BFA,Burkina Faso,LUX,Luxembourg,2017,8,1,7
BFA,Burkina Faso,MEX,Mexico,2010,1,0,1
BFA,Burkina Faso,MEX,Mexico,2011,1,0,1
BFA,Burkina Faso,MEX,Mexico,2012,0,0,0
BFA,Burkina Faso,MEX,Mexico,2013,0,0,0
BFA,Burkina Faso,MEX,Mexico,2014,2,0,2
BFA,Burkina Faso,MEX,Mexico,2015,1,0,1
BFA,Burkina Faso,MEX,Mexico,2017,1,0,1
BFA,Burkina Faso,NLD,Netherlands,2008,12,9,3
BFA,Burkina Faso,NLD,Netherlands,2009,24,6,18
BFA,Burkina Faso,NLD,Netherlands,2010,11,15,-4
BFA,Burkina Faso,NLD,Netherlands,2011,23,6,17
BFA,Burkina Faso,NLD,Netherlands,2012,11,5,6
BFA,Burkina Faso,NLD,Netherlands,2013,8,4,4
BFA,Burkina Faso,NLD,Netherlands,2014,14,2,12
BFA,Burkina Faso,NLD,Netherlands,2015,12,4,8
BFA,Burkina Faso,NLD,Netherlands,2016,18,8,10
BFA,Burkina Faso,NLD,Netherlands,2017,14,5,9
BFA,Burkina Faso,NOR,Norway,2008,4,0,4
BFA,Burkina Faso,NOR,Norway,2009,3,1,2
BFA,Burkina Faso,NOR,Norway,2010,2,0,2
BFA,Burkina Faso,NOR,Norway,2011,3,0,3
BFA,Burkina Faso,NOR,Norway,2012,2,2,0
BFA,Burkina Faso,NOR,Norway,2013,3,1,2
BFA,Burkina Faso,NOR,Norway,2014,2,1,1
BFA,Burkina Faso,NOR,Norway,2015,2,1,1
BFA,Burkina Faso,NOR,Norway,2016,2,3,-1
BFA,Burkina Faso,NOR,Norway,2017,3,0,3
BFA,Burkina Faso,POL,Poland,2009,7,0,7
BFA,Burkina Faso,POL,Poland,2010,8,0,8
BFA,Burkina Faso,POL,Poland,2011,6,0,6
BFA,Burkina Faso,POL,Poland,2012,4,0,4
BFA,Burkina Faso,POL,Poland,2013,1,0,1
BFA,Burkina Faso,POL,Poland,2014,3,0,3
BFA,Burkina Faso,POL,Poland,2015,0,0,0
BFA,Burkina Faso,POL,Poland,2016,0,0,0
BFA,Burkina Faso,POL,Poland,2017,0,0,0
BFA,Burkina Faso,SVK,Slovak Republic,2008,0,0,0
BFA,Burkina Faso,ESP,Spain,2008,178,39,139
BFA,Burkina Faso,ESP,Spain,2009,138,36,102
BFA,Burkina Faso,ESP,Spain,2010,99,73,26
BFA,Burkina Faso,ESP,Spain,2011,107,93,14
BFA,Burkina Faso,ESP,Spain,2012,106,58,48
BFA,Burkina Faso,ESP,Spain,2013,86,95,-9
BFA,Burkina Faso,ESP,Spain,2014,88,47,41
BFA,Burkina Faso,ESP,Spain,2015,120,55,65
BFA,Burkina Faso,ESP,Spain,2016,94,45,49
BFA,Burkina Faso,ESP,Spain,2017,105,69,36
BFA,Burkina Faso,SWE,Sweden,2008,3,0,3
BFA,Burkina Faso,SWE,Sweden,2009,4,0,4
BFA,Burkina Faso,SWE,Sweden,2010,8,0,8
BFA,Burkina Faso,SWE,Sweden,2011,4,6,-2
BFA,Burkina Faso,SWE,Sweden,2012,12,2,10
BFA,Burkina Faso,SWE,Sweden,2013,9,3,6
BFA,Burkina Faso,SWE,Sweden,2014,0,3,-3
BFA,Burkina Faso,SWE,Sweden,2015,4,4,0
BFA,Burkina Faso,SWE,Sweden,2016,3,3,0
BFA,Burkina Faso,SWE,Sweden,2017,7,1,6
BFA,Burkina Faso,CHE,Switzerland,2010,44,25,19
BFA,Burkina Faso,CHE,Switzerland,2011,42,27,15
BFA,Burkina Faso,CHE,Switzerland,2012,51,13,38
BFA,Burkina Faso,CHE,Switzerland,2013,30,14,16
BFA,Burkina Faso,CHE,Switzerland,2014,39,18,21
BFA,Burkina Faso,CHE,Switzerland,2015,36,13,23
BFA,Burkina Faso,CHE,Switzerland,2016,32,19,13
BFA,Burkina Faso,CHE,Switzerland,2017,40,10,30
BFA,Burkina Faso,TUR,Turkey,2010,10,0,10
BFA,Burkina Faso,USA,United States,2008,238,0,238
BFA,Burkina Faso,USA,United States,2009,416,0,416
BFA,Burkina Faso,USA,United States,2010,377,0,377
BFA,Burkina Faso,USA,United States,2011,433,0,433
BFA,Burkina Faso,USA,United States,2012,558,0,558
BFA,Burkina Faso,USA,United States,2013,585,0,585
BFA,Burkina Faso,USA,United States,2014,583,0,583
BFA,Burkina Faso,USA,United States,2015,575,0,575
BFA,Burkina Faso,USA,United States,2016,642,0,642
BFA,Burkina Faso,USA,United States,2017,541,0,541
BFA,Burkina Faso,CHL,Chile,2008,0,0,0
BFA,Burkina Faso,CHL,Chile,2009,0,0,0
BFA,Burkina Faso,CHL,Chile,2010,1,0,1
BFA,Burkina Faso,CHL,Chile,2011,0,0,0
BFA,Burkina Faso,CHL,Chile,2012,0,0,0
BFA,Burkina Faso,CHL,Chile,2013,1,0,1
BFA,Burkina Faso,CHL,Chile,2014,0,0,0
BFA,Burkina Faso,CHL,Chile,2015,0,0,0
BFA,Burkina Faso,CHL,Chile,2016,0,0,0
BFA,Burkina Faso,EST,Estonia,2008,0,0,0
BFA,Burkina Faso,EST,Estonia,2009,0,0,0
BFA,Burkina Faso,EST,Estonia,2010,0,0,0
BFA,Burkina Faso,EST,Estonia,2011,0,0,0
BFA,Burkina Faso,EST,Estonia,2012,0,0,0
BFA,Burkina Faso,EST,Estonia,2013,0,0,0
BFA,Burkina Faso,EST,Estonia,2014,0,0,0
BFA,Burkina Faso,EST,Estonia,2015,0,0,0
BFA,Burkina Faso,EST,Estonia,2016,0,0,0
BFA,Burkina Faso,EST,Estonia,2017,0,0,0
BFA,Burkina Faso,SVN,Slovenia,2008,1,0,1
BFA,Burkina Faso,SVN,Slovenia,2009,1,0,1
BFA,Burkina Faso,SVN,Slovenia,2010,1,0,1
BFA,Burkina Faso,SVN,Slovenia,2015,2,0,2
BFA,Burkina Faso,SVN,Slovenia,2017,1,0,1
BDI,Burundi,AUS,Australia,2008,445,0,445
BDI,Burundi,AUS,Australia,2009,333,0,333
BDI,Burundi,AUS,Australia,2010,247,0,247
BDI,Burundi,AUS,Australia,2011,120,0,120
BDI,Burundi,AUS,Australia,2012,111,0,111
BDI,Burundi,AUS,Australia,2013,82,6,76
BDI,Burundi,AUS,Australia,2014,104,7,97
BDI,Burundi,AUS,Australia,2015,122,0,122
BDI,Burundi,AUS,Australia,2016,120,0,120
BDI,Burundi,AUS,Australia,2017,105,0,105
BDI,Burundi,AUT,Austria,2008,3,0,3
BDI,Burundi,AUT,Austria,2009,3,1,2
BDI,Burundi,AUT,Austria,2010,2,3,-1
BDI,Burundi,AUT,Austria,2011,0,0,0
BDI,Burundi,AUT,Austria,2012,6,1,5
BDI,Burundi,AUT,Austria,2013,4,1,3
BDI,Burundi,AUT,Austria,2014,0,0,0
BDI,Burundi,AUT,Austria,2015,3,0,3
BDI,Burundi,AUT,Austria,2016,6,0,6
BDI,Burundi,AUT,Austria,2017,10,0,10
BDI,Burundi,BEL,Belgium,2008,205,0,205
BDI,Burundi,BEL,Belgium,2009,212,0,212
BDI,Burundi,BEL,Belgium,2010,237,118,119
BDI,Burundi,BEL,Belgium,2011,246,85,161
BDI,Burundi,BEL,Belgium,2012,242,114,128
BDI,Burundi,BEL,Belgium,2013,203,170,33
BDI,Burundi,BEL,Belgium,2014,136,155,-19
BDI,Burundi,BEL,Belgium,2015,369,61,308
BDI,Burundi,BEL,Belgium,2016,333,53,280
BDI,Burundi,BEL,Belgium,2017,370,45,325
BDI,Burundi,CAN,Canada,2008,448,0,448
BDI,Burundi,CAN,Canada,2009,566,0,566
BDI,Burundi,CAN,Canada,2010,529,0,529
BDI,Burundi,CAN,Canada,2011,604,0,604
BDI,Burundi,CAN,Canada,2012,682,0,682
BDI,Burundi,CAN,Canada,2013,480,0,480
BDI,Burundi,CAN,Canada,2014,517,0,517
BDI,Burundi,CAN,Canada,2015,938,0,938
BDI,Burundi,CAN,Canada,2016,635,0,635
BDI,Burundi,CAN,Canada,2017,805,0,805
BDI,Burundi,CZE,Czech Republic,2009,1,0,1
BDI,Burundi,CZE,Czech Republic,2014,1,1,0
BDI,Burundi,CZE,Czech Republic,2015,1,0,1
BDI,Burundi,CZE,Czech Republic,2016,2,0,2
BDI,Burundi,DNK,Denmark,2008,26,0,26
BDI,Burundi,DNK,Denmark,2009,27,0,27
BDI,Burundi,DNK,Denmark,2010,13,2,11
BDI,Burundi,DNK,Denmark,2011,6,6,0
BDI,Burundi,DNK,Denmark,2012,3,3,0
BDI,Burundi,DNK,Denmark,2013,6,2,4
BDI,Burundi,DNK,Denmark,2014,3,2,1
BDI,Burundi,DNK,Denmark,2015,7,2,5
BDI,Burundi,DNK,Denmark,2016,10,2,8
BDI,Burundi,DNK,Denmark,2017,6,5,1
BDI,Burundi,FIN,Finland,2008,3,0,3
BDI,Burundi,FIN,Finland,2009,21,0,21
BDI,Burundi,FIN,Finland,2010,1,0,1
BDI,Burundi,FIN,Finland,2011,1,0,1
BDI,Burundi,FIN,Finland,2012,0,0,0
BDI,Burundi,FIN,Finland,2013,5,0,5
BDI,Burundi,FIN,Finland,2014,4,0,4
BDI,Burundi,FIN,Finland,2015,3,0,3
BDI,Burundi,FIN,Finland,2016,1,0,1
BDI,Burundi,FIN,Finland,2017,8,0,8
BDI,Burundi,FRA,France,2008,72,0,72
BDI,Burundi,FRA,France,2009,60,0,60
BDI,Burundi,FRA,France,2010,63,0,63
BDI,Burundi,FRA,France,2011,68,0,68
BDI,Burundi,FRA,France,2012,72,0,72
BDI,Burundi,FRA,France,2013,84,0,84
BDI,Burundi,FRA,France,2014,74,0,74
BDI,Burundi,FRA,France,2015,65,0,65
BDI,Burundi,FRA,France,2016,129,0,129
BDI,Burundi,FRA,France,2017,175,0,175
BDI,Burundi,DEU,Germany,2008,39,53,-14
BDI,Burundi,DEU,Germany,2009,36,33,3
BDI,Burundi,DEU,Germany,2010,27,28,-1
BDI,Burundi,DEU,Germany,2011,22,19,3
BDI,Burundi,DEU,Germany,2012,27,17,10
BDI,Burundi,DEU,Germany,2013,28,17,11
BDI,Burundi,DEU,Germany,2014,32,15,17
BDI,Burundi,DEU,Germany,2015,54,21,33
BDI,Burundi,DEU,Germany,2016,65,13,52
BDI,Burundi,DEU,Germany,2017,47,18,29
BDI,Burundi,HUN,Hungary,2008,0,0,0
BDI,Burundi,HUN,Hungary,2009,0,0,0
BDI,Burundi,HUN,Hungary,2010,0,0,0
BDI,Burundi,HUN,Hungary,2011,0,0,0
BDI,Burundi,HUN,Hungary,2012,0,0,0
BDI,Burundi,HUN,Hungary,2013,0,0,0
BDI,Burundi,HUN,Hungary,2014,1,0,1
BDI,Burundi,HUN,Hungary,2015,1,0,1
BDI,Burundi,HUN,Hungary,2016,0,0,0
BDI,Burundi,HUN,Hungary,2017,7,0,7
BDI,Burundi,ISL,Iceland,2008,0,0,0
BDI,Burundi,ISL,Iceland,2009,0,0,0
BDI,Burundi,ISL,Iceland,2010,0,0,0
BDI,Burundi,ISL,Iceland,2011,0,0,0
BDI,Burundi,ISL,Iceland,2012,0,0,0
BDI,Burundi,ISL,Iceland,2013,1,0,1
BDI,Burundi,ISL,Iceland,2014,0,1,-1
BDI,Burundi,ISL,Iceland,2015,0,0,0
BDI,Burundi,ISL,Iceland,2016,0,0,0
BDI,Burundi,ISL,Iceland,2017,0,0,0
BDI,Burundi,ITA,Italy,2008,45,5,40
BDI,Burundi,ITA,Italy,2009,52,6,46
BDI,Burundi,ITA,Italy,2010,37,6,31
BDI,Burundi,ITA,Italy,2011,42,2,40
BDI,Burundi,ITA,Italy,2012,60,11,49
BDI,Burundi,ITA,Italy,2013,58,7,51
BDI,Burundi,ITA,Italy,2014,36,9,27
BDI,Burundi,ITA,Italy,2015,50,8,42
BDI,Burundi,ITA,Italy,2016,57,0,57
BDI,Burundi,ITA,Italy,2017,60,2,58
BDI,Burundi,JPN,Japan,2008,35,35,0
BDI,Burundi,JPN,Japan,2009,26,26,0
BDI,Burundi,JPN,Japan,2010,99,24,75
BDI,Burundi,JPN,Japan,2011,26,26,0
BDI,Burundi,JPN,Japan,2012,59,59,0
BDI,Burundi,JPN,Japan,2013,44,42,2
BDI,Burundi,JPN,Japan,2014,31,31,0
BDI,Burundi,JPN,Japan,2015,49,46,3
BDI,Burundi,JPN,Japan,2016,48,44,4
BDI,Burundi,JPN,Japan,2017,29,29,0
BDI,Burundi,KOR,Korea,2008,2,1,1
BDI,Burundi,KOR,Korea,2009,3,1,2
BDI,Burundi,KOR,Korea,2010,6,3,3
BDI,Burundi,KOR,Korea,2011,11,3,8
BDI,Burundi,KOR,Korea,2012,8,9,-1
BDI,Burundi,KOR,Korea,2013,13,5,8
BDI,Burundi,KOR,Korea,2014,26,5,21
BDI,Burundi,KOR,Korea,2015,22,8,14
BDI,Burundi,KOR,Korea,2016,17,14,3
BDI,Burundi,KOR,Korea,2017,15,12,3
BDI,Burundi,LUX,Luxembourg,2008,1,11,-10
BDI,Burundi,LUX,Luxembourg,2009,4,0,4
BDI,Burundi,LUX,Luxembourg,2010,1,0,1
BDI,Burundi,LUX,Luxembourg,2011,3,1,2
BDI,Burundi,LUX,Luxembourg,2012,2,1,1
BDI,Burundi,LUX,Luxembourg,2013,2,2,0
BDI,Burundi,LUX,Luxembourg,2014,2,1,1
BDI,Burundi,LUX,Luxembourg,2015,1,0,1
BDI,Burundi,LUX,Luxembourg,2016,7,1,6
BDI,Burundi,LUX,Luxembourg,2017,2,2,0
BDI,Burundi,MEX,Mexico,2012,1,0,1
BDI,Burundi,MEX,Mexico,2013,2,0,2
BDI,Burundi,MEX,Mexico,2014,1,0,1
BDI,Burundi,MEX,Mexico,2015,2,0,2
BDI,Burundi,NLD,Netherlands,2008,41,4,37
BDI,Burundi,NLD,Netherlands,2009,48,0,48
BDI,Burundi,NLD,Netherlands,2010,29,10,19
BDI,Burundi,NLD,Netherlands,2011,5,4,1
BDI,Burundi,NLD,Netherlands,2012,13,16,-3
BDI,Burundi,NLD,Netherlands,2013,15,9,6
BDI,Burundi,NLD,Netherlands,2014,18,7,11
BDI,Burundi,NLD,Netherlands,2015,16,5,11
BDI,Burundi,NLD,Netherlands,2016,23,0,23
BDI,Burundi,NLD,Netherlands,2017,27,4,23
BDI,Burundi,NZL,New Zealand,2008,10,0,10
BDI,Burundi,NZL,New Zealand,2009,35,0,35
BDI,Burundi,NZL,New Zealand,2010,14,1,13
BDI,Burundi,NZL,New Zealand,2011,9,0,9
BDI,Burundi,NZL,New Zealand,2012,8,0,8
BDI,Burundi,NZL,New Zealand,2013,2,0,2
BDI,Burundi,NZL,New Zealand,2014,1,0,1
BDI,Burundi,NZL,New Zealand,2015,5,0,5
BDI,Burundi,NZL,New Zealand,2016,2,0,2
BDI,Burundi,NZL,New Zealand,2017,4,0,4
BDI,Burundi,NOR,Norway,2008,51,8,43
BDI,Burundi,NOR,Norway,2009,80,13,67
BDI,Burundi,NOR,Norway,2010,34,7,27
BDI,Burundi,NOR,Norway,2011,46,5,41
BDI,Burundi,NOR,Norway,2012,43,12,31
BDI,Burundi,NOR,Norway,2013,29,8,21
BDI,Burundi,NOR,Norway,2014,18,1,17
BDI,Burundi,NOR,Norway,2015,45,5,40
BDI,Burundi,NOR,Norway,2016,28,3,25
BDI,Burundi,NOR,Norway,2017,17,3,14
BDI,Burundi,POL,Poland,2009,3,0,3
BDI,Burundi,POL,Poland,2010,0,0,0
BDI,Burundi,POL,Poland,2011,2,0,2
BDI,Burundi,POL,Poland,2012,3,0,3
BDI,Burundi,POL,Poland,2013,2,0,2
BDI,Burundi,POL,Poland,2014,0,0,0
BDI,Burundi,POL,Poland,2015,0,0,0
BDI,Burundi,POL,Poland,2016,3,0,3
BDI,Burundi,POL,Poland,2017,2,0,2
BDI,Burundi,SVK,Slovak Republic,2008,0,0,0
BDI,Burundi,ESP,Spain,2008,12,6,6
BDI,Burundi,ESP,Spain,2009,8,2,6
BDI,Burundi,ESP,Spain,2010,7,9,-2
BDI,Burundi,ESP,Spain,2011,15,18,-3
BDI,Burundi,ESP,Spain,2012,9,2,7
BDI,Burundi,ESP,Spain,2013,9,4,5
BDI,Burundi,ESP,Spain,2014,8,0,8
BDI,Burundi,ESP,Spain,2015,15,1,14
BDI,Burundi,ESP,Spain,2016,14,6,8
BDI,Burundi,ESP,Spain,2017,10,4,6
BDI,Burundi,SWE,Sweden,2008,202,4,198
BDI,Burundi,SWE,Sweden,2009,159,2,157
BDI,Burundi,SWE,Sweden,2010,107,6,101
BDI,Burundi,SWE,Sweden,2011,86,9,77
BDI,Burundi,SWE,Sweden,2012,98,4,94
BDI,Burundi,SWE,Sweden,2013,62,7,55
BDI,Burundi,SWE,Sweden,2014,73,1,72
BDI,Burundi,SWE,Sweden,2015,63,7,56
BDI,Burundi,SWE,Sweden,2016,94,5,89
BDI,Burundi,SWE,Sweden,2017,124,2,122
BDI,Burundi,CHE,Switzerland,2010,19,11,8
BDI,Burundi,CHE,Switzerland,2011,18,12,6
BDI,Burundi,CHE,Switzerland,2012,11,7,4
BDI,Burundi,CHE,Switzerland,2013,11,7,4
BDI,Burundi,CHE,Switzerland,2014,12,2,10
BDI,Burundi,CHE,Switzerland,2015,13,5,8
BDI,Burundi,CHE,Switzerland,2016,19,0,19
BDI,Burundi,CHE,Switzerland,2017,27,4,23
BDI,Burundi,USA,United States,2008,255,0,255
BDI,Burundi,USA,United States,2009,1505,0,1505
BDI,Burundi,USA,United States,2010,841,0,841
BDI,Burundi,USA,United States,2011,593,0,593
BDI,Burundi,USA,United States,2012,535,0,535
BDI,Burundi,USA,United States,2013,260,0,260
BDI,Burundi,USA,United States,2014,273,0,273
BDI,Burundi,USA,United States,2015,351,0,351
BDI,Burundi,USA,United States,2016,415,0,415
BDI,Burundi,USA,United States,2017,1094,0,1094
BDI,Burundi,CHL,Chile,2008,0,0,0
BDI,Burundi,CHL,Chile,2009,1,0,1
BDI,Burundi,CHL,Chile,2010,0,0,0
BDI,Burundi,CHL,Chile,2011,0,0,0
BDI,Burundi,CHL,Chile,2012,0,0,0
BDI,Burundi,CHL,Chile,2013,0,0,0
BDI,Burundi,CHL,Chile,2014,0,0,0
BDI,Burundi,CHL,Chile,2015,0,0,0
BDI,Burundi,CHL,Chile,2016,0,0,0
BDI,Burundi,EST,Estonia,2008,0,0,0
BDI,Burundi,EST,Estonia,2009,0,0,0
BDI,Burundi,EST,Estonia,2010,0,0,0
BDI,Burundi,EST,Estonia,2011,0,0,0
BDI,Burundi,EST,Estonia,2012,0,0,0
BDI,Burundi,EST,Estonia,2013,0,0,0
BDI,Burundi,EST,Estonia,2014,0,0,0
BDI,Burundi,EST,Estonia,2015,0,0,0
BDI,Burundi,EST,Estonia,2016,0,0,0
BDI,Burundi,EST,Estonia,2017,0,0,0
BDI,Burundi,SVN,Slovenia,2017,1,0,1
KHM,Cambodia,AUS,Australia,2008,654,163,491
KHM,Cambodia,AUS,Australia,2009,727,100,627
KHM,Cambodia,AUS,Australia,2010,873,99,774
KHM,Cambodia,AUS,Australia,2011,773,101,672
KHM,Cambodia,AUS,Australia,2012,779,85,694
KHM,Cambodia,AUS,Australia,2013,754,128,626
KHM,Cambodia,AUS,Australia,2014,812,110,702
KHM,Cambodia,AUS,Australia,2015,763,100,663
KHM,Cambodia,AUS,Australia,2016,826,100,726
KHM,Cambodia,AUS,Australia,2017,674,0,674
KHM,Cambodia,AUT,Austria,2008,32,16,16
KHM,Cambodia,AUT,Austria,2009,19,7,12
KHM,Cambodia,AUT,Austria,2010,7,4,3
KHM,Cambodia,AUT,Austria,2011,20,8,12
KHM,Cambodia,AUT,Austria,2012,15,6,9
KHM,Cambodia,AUT,Austria,2013,16,7,9
KHM,Cambodia,AUT,Austria,2014,15,6,9
KHM,Cambodia,AUT,Austria,2015,22,7,15
KHM,Cambodia,AUT,Austria,2016,22,6,16
KHM,Cambodia,AUT,Austria,2017,19,11,8
KHM,Cambodia,BEL,Belgium,2008,42,0,42
KHM,Cambodia,BEL,Belgium,2009,46,0,46
KHM,Cambodia,BEL,Belgium,2010,57,12,45
KHM,Cambodia,BEL,Belgium,2011,40,0,40
KHM,Cambodia,BEL,Belgium,2012,28,18,10
KHM,Cambodia,BEL,Belgium,2013,29,20,9
KHM,Cambodia,BEL,Belgium,2014,27,15,12
KHM,Cambodia,BEL,Belgium,2015,26,8,18
KHM,Cambodia,BEL,Belgium,2016,32,9,23
KHM,Cambodia,BEL,Belgium,2017,27,11,16
KHM,Cambodia,CAN,Canada,2008,354,0,354
KHM,Cambodia,CAN,Canada,2009,203,0,203
KHM,Cambodia,CAN,Canada,2010,200,0,200
KHM,Cambodia,CAN,Canada,2011,196,0,196
KHM,Cambodia,CAN,Canada,2012,233,0,233
KHM,Cambodia,CAN,Canada,2013,289,0,289
KHM,Cambodia,CAN,Canada,2014,237,0,237
KHM,Cambodia,CAN,Canada,2015,205,0,205
KHM,Cambodia,CAN,Canada,2016,250,0,250
KHM,Cambodia,CAN,Canada,2017,225,0,225
KHM,Cambodia,CZE,Czech Republic,2008,5,0,5
KHM,Cambodia,CZE,Czech Republic,2009,3,0,3
KHM,Cambodia,CZE,Czech Republic,2010,2,0,2
KHM,Cambodia,CZE,Czech Republic,2011,3,0,3
KHM,Cambodia,CZE,Czech Republic,2012,10,3,7
KHM,Cambodia,CZE,Czech Republic,2013,6,4,2
KHM,Cambodia,CZE,Czech Republic,2014,13,5,8
KHM,Cambodia,CZE,Czech Republic,2015,10,6,4
KHM,Cambodia,CZE,Czech Republic,2016,15,8,7
KHM,Cambodia,CZE,Czech Republic,2017,7,5,2
KHM,Cambodia,DNK,Denmark,2008,7,5,2
KHM,Cambodia,DNK,Denmark,2009,12,2,10
KHM,Cambodia,DNK,Denmark,2010,17,2,15
KHM,Cambodia,DNK,Denmark,2011,10,0,10
KHM,Cambodia,DNK,Denmark,2012,14,1,13
KHM,Cambodia,DNK,Denmark,2013,7,2,5
KHM,Cambodia,DNK,Denmark,2014,11,2,9
KHM,Cambodia,DNK,Denmark,2015,10,5,5
KHM,Cambodia,DNK,Denmark,2016,10,5,5
KHM,Cambodia,DNK,Denmark,2017,18,2,16
KHM,Cambodia,FIN,Finland,2008,3,1,2
KHM,Cambodia,FIN,Finland,2009,6,0,6
KHM,Cambodia,FIN,Finland,2010,11,0,11
KHM,Cambodia,FIN,Finland,2011,9,0,9
KHM,Cambodia,FIN,Finland,2012,6,1,5
KHM,Cambodia,FIN,Finland,2013,11,0,11
KHM,Cambodia,FIN,Finland,2014,16,1,15
KHM,Cambodia,FIN,Finland,2015,12,0,12
KHM,Cambodia,FIN,Finland,2016,10,2,8
KHM,Cambodia,FIN,Finland,2017,6,0,6
KHM,Cambodia,FRA,France,2008,436,0,436
KHM,Cambodia,FRA,France,2009,568,0,568
KHM,Cambodia,FRA,France,2010,532,0,532
KHM,Cambodia,FRA,France,2011,424,0,424
KHM,Cambodia,FRA,France,2012,422,0,422
KHM,Cambodia,FRA,France,2013,435,0,435
KHM,Cambodia,FRA,France,2014,478,0,478
KHM,Cambodia,FRA,France,2015,391,0,391
KHM,Cambodia,FRA,France,2016,335,0,335
KHM,Cambodia,FRA,France,2017,314,0,314
KHM,Cambodia,DEU,Germany,2008,86,54,32
KHM,Cambodia,DEU,Germany,2009,73,60,13
KHM,Cambodia,DEU,Germany,2010,74,67,7
KHM,Cambodia,DEU,Germany,2011,100,55,45
KHM,Cambodia,DEU,Germany,2012,100,40,60
KHM,Cambodia,DEU,Germany,2013,102,31,71
KHM,Cambodia,DEU,Germany,2014,103,38,65
KHM,Cambodia,DEU,Germany,2015,101,55,46
KHM,Cambodia,DEU,Germany,2016,104,36,68
KHM,Cambodia,DEU,Germany,2017,118,43,75
KHM,Cambodia,HUN,Hungary,2008,1,0,1
KHM,Cambodia,HUN,Hungary,2009,3,0,3
KHM,Cambodia,HUN,Hungary,2010,1,0,1
KHM,Cambodia,HUN,Hungary,2011,3,0,3
KHM,Cambodia,HUN,Hungary,2012,0,0,0
KHM,Cambodia,HUN,Hungary,2013,1,0,1
KHM,Cambodia,HUN,Hungary,2014,2,0,2
KHM,Cambodia,HUN,Hungary,2015,2,0,2
KHM,Cambodia,HUN,Hungary,2016,13,0,13
KHM,Cambodia,HUN,Hungary,2017,10,0,10
KHM,Cambodia,ISL,Iceland,2008,0,1,-1
KHM,Cambodia,ISL,Iceland,2009,0,0,0
KHM,Cambodia,ISL,Iceland,2010,0,0,0
KHM,Cambodia,ISL,Iceland,2011,0,0,0
KHM,Cambodia,ISL,Iceland,2012,0,0,0
KHM,Cambodia,ISL,Iceland,2013,0,0,0
KHM,Cambodia,ISL,Iceland,2014,0,0,0
KHM,Cambodia,ISL,Iceland,2015,0,0,0
KHM,Cambodia,ISL,Iceland,2016,0,0,0
KHM,Cambodia,ISL,Iceland,2017,0,0,0
KHM,Cambodia,ITA,Italy,2008,153,4,149
KHM,Cambodia,ITA,Italy,2009,94,4,90
KHM,Cambodia,ITA,Italy,2010,81,0,81
KHM,Cambodia,ITA,Italy,2011,69,2,67
KHM,Cambodia,ITA,Italy,2012,24,1,23
KHM,Cambodia,ITA,Italy,2013,21,2,19
KHM,Cambodia,ITA,Italy,2014,11,2,9
KHM,Cambodia,ITA,Italy,2015,18,5,13
KHM,Cambodia,ITA,Italy,2016,12,0,12
KHM,Cambodia,ITA,Italy,2017,16,1,15
KHM,Cambodia,JPN,Japan,2008,918,789,129
KHM,Cambodia,JPN,Japan,2009,1092,909,183
KHM,Cambodia,JPN,Japan,2010,1097,1004,93
KHM,Cambodia,JPN,Japan,2011,1131,980,151
KHM,Cambodia,JPN,Japan,2012,1099,947,152
KHM,Cambodia,JPN,Japan,2013,1299,997,302
KHM,Cambodia,JPN,Japan,2014,2342,1283,1059
KHM,Cambodia,JPN,Japan,2015,3726,1662,2064
KHM,Cambodia,JPN,Japan,2016,4213,1835,2378
KHM,Cambodia,JPN,Japan,2017,4767,2297,2470
KHM,Cambodia,KOR,Korea,2008,3420,814,2606
KHM,Cambodia,KOR,Korea,2009,2591,941,1650
KHM,Cambodia,KOR,Korea,2010,3679,733,2946
KHM,Cambodia,KOR,Korea,2011,6444,982,5462
KHM,Cambodia,KOR,Korea,2012,9523,1960,7563
KHM,Cambodia,KOR,Korea,2013,10496,2859,7637
KHM,Cambodia,KOR,Korea,2014,9493,2917,6576
KHM,Cambodia,KOR,Korea,2015,9564,4569,4995
KHM,Cambodia,KOR,Korea,2016,10248,7172,3076
KHM,Cambodia,KOR,Korea,2017,9523,8071,1452
KHM,Cambodia,LUX,Luxembourg,2008,0,0,0
KHM,Cambodia,LUX,Luxembourg,2009,2,1,1
KHM,Cambodia,LUX,Luxembourg,2010,2,1,1
KHM,Cambodia,LUX,Luxembourg,2011,3,0,3
KHM,Cambodia,LUX,Luxembourg,2012,2,2,0
KHM,Cambodia,LUX,Luxembourg,2013,2,1,1
KHM,Cambodia,LUX,Luxembourg,2014,1,2,-1
KHM,Cambodia,LUX,Luxembourg,2015,3,1,2
KHM,Cambodia,LUX,Luxembourg,2016,3,1,2
KHM,Cambodia,LUX,Luxembourg,2017,2,2,0
KHM,Cambodia,MEX,Mexico,2012,0,0,0
KHM,Cambodia,MEX,Mexico,2013,0,0,0
KHM,Cambodia,MEX,Mexico,2014,0,0,0
KHM,Cambodia,MEX,Mexico,2016,1,0,1
KHM,Cambodia,MEX,Mexico,2017,3,0,3
KHM,Cambodia,NLD,Netherlands,2008,13,4,9
KHM,Cambodia,NLD,Netherlands,2009,15,4,11
KHM,Cambodia,NLD,Netherlands,2010,15,9,6
KHM,Cambodia,NLD,Netherlands,2011,10,7,3
KHM,Cambodia,NLD,Netherlands,2012,14,1,13
KHM,Cambodia,NLD,Netherlands,2013,11,6,5
KHM,Cambodia,NLD,Netherlands,2014,26,2,24
KHM,Cambodia,NLD,Netherlands,2015,18,5,13
KHM,Cambodia,NLD,Netherlands,2016,19,9,10
KHM,Cambodia,NLD,Netherlands,2017,12,5,7
KHM,Cambodia,NZL,New Zealand,2008,245,25,220
KHM,Cambodia,NZL,New Zealand,2009,199,14,185
KHM,Cambodia,NZL,New Zealand,2010,181,34,147
KHM,Cambodia,NZL,New Zealand,2011,236,25,211
KHM,Cambodia,NZL,New Zealand,2012,183,22,161
KHM,Cambodia,NZL,New Zealand,2013,222,34,188
KHM,Cambodia,NZL,New Zealand,2014,169,37,132
KHM,Cambodia,NZL,New Zealand,2015,184,28,156
KHM,Cambodia,NZL,New Zealand,2016,210,36,174
KHM,Cambodia,NZL,New Zealand,2017,197,60,137
KHM,Cambodia,NOR,Norway,2008,13,7,6
KHM,Cambodia,NOR,Norway,2009,19,4,15
KHM,Cambodia,NOR,Norway,2010,10,3,7
KHM,Cambodia,NOR,Norway,2011,26,8,18
KHM,Cambodia,NOR,Norway,2012,15,8,7
KHM,Cambodia,NOR,Norway,2013,26,2,24
KHM,Cambodia,NOR,Norway,2014,17,2,15
KHM,Cambodia,NOR,Norway,2015,26,10,16
KHM,Cambodia,NOR,Norway,2016,23,13,10
KHM,Cambodia,NOR,Norway,2017,14,3,11
KHM,Cambodia,POL,Poland,2009,2,0,2
KHM,Cambodia,POL,Poland,2010,4,0,4
KHM,Cambodia,POL,Poland,2011,9,0,9
KHM,Cambodia,POL,Poland,2012,11,0,11
KHM,Cambodia,POL,Poland,2013,6,0,6
KHM,Cambodia,POL,Poland,2014,6,0,6
KHM,Cambodia,POL,Poland,2015,4,0,4
KHM,Cambodia,POL,Poland,2016,9,0,9
KHM,Cambodia,POL,Poland,2017,5,0,5
KHM,Cambodia,SVK,Slovak Republic,2008,0,0,0
KHM,Cambodia,SVK,Slovak Republic,2010,1,0,1
KHM,Cambodia,ESP,Spain,2008,10,1,9
KHM,Cambodia,ESP,Spain,2009,4,4,0
KHM,Cambodia,ESP,Spain,2010,1,4,-3
KHM,Cambodia,ESP,Spain,2011,8,4,4
KHM,Cambodia,ESP,Spain,2012,10,0,10
KHM,Cambodia,ESP,Spain,2013,7,1,6
KHM,Cambodia,ESP,Spain,2014,3,1,2
KHM,Cambodia,ESP,Spain,2015,12,0,12
KHM,Cambodia,ESP,Spain,2016,8,4,4
KHM,Cambodia,ESP,Spain,2017,11,5,6
KHM,Cambodia,SWE,Sweden,2008,25,2,23
KHM,Cambodia,SWE,Sweden,2009,35,1,34
KHM,Cambodia,SWE,Sweden,2010,30,0,30
KHM,Cambodia,SWE,Sweden,2011,26,2,24
KHM,Cambodia,SWE,Sweden,2012,19,6,13
KHM,Cambodia,SWE,Sweden,2013,38,2,36
KHM,Cambodia,SWE,Sweden,2014,35,7,28
KHM,Cambodia,SWE,Sweden,2015,34,8,26
KHM,Cambodia,SWE,Sweden,2016,28,6,22
KHM,Cambodia,SWE,Sweden,2017,26,3,23
KHM,Cambodia,CHE,Switzerland,2010,37,9,28
KHM,Cambodia,CHE,Switzerland,2011,25,6,19
KHM,Cambodia,CHE,Switzerland,2012,26,9,17
KHM,Cambodia,CHE,Switzerland,2013,39,12,27
KHM,Cambodia,CHE,Switzerland,2014,34,11,23
KHM,Cambodia,CHE,Switzerland,2015,42,10,32
KHM,Cambodia,CHE,Switzerland,2016,36,6,30
KHM,Cambodia,CHE,Switzerland,2017,41,19,22
KHM,Cambodia,TUR,Turkey,2010,3,0,3
KHM,Cambodia,USA,United States,2008,3713,0,3713
KHM,Cambodia,USA,United States,2009,3771,0,3771
KHM,Cambodia,USA,United States,2010,2986,0,2986
KHM,Cambodia,USA,United States,2011,2745,0,2745
KHM,Cambodia,USA,United States,2012,2473,0,2473
KHM,Cambodia,USA,United States,2013,2624,0,2624
KHM,Cambodia,USA,United States,2014,2536,0,2536
KHM,Cambodia,USA,United States,2015,1868,0,1868
KHM,Cambodia,USA,United States,2016,3173,0,3173
KHM,Cambodia,USA,United States,2017,4056,0,4056
KHM,Cambodia,CHL,Chile,2008,0,0,0
KHM,Cambodia,CHL,Chile,2009,0,0,0
KHM,Cambodia,CHL,Chile,2010,0,0,0
KHM,Cambodia,CHL,Chile,2011,0,0,0
KHM,Cambodia,CHL,Chile,2012,1,0,1
KHM,Cambodia,CHL,Chile,2013,0,0,0
KHM,Cambodia,CHL,Chile,2014,0,0,0
KHM,Cambodia,CHL,Chile,2015,0,0,0
KHM,Cambodia,CHL,Chile,2016,0,0,0
KHM,Cambodia,EST,Estonia,2008,0,0,0
KHM,Cambodia,EST,Estonia,2009,0,0,0
KHM,Cambodia,EST,Estonia,2010,0,0,0
KHM,Cambodia,EST,Estonia,2011,0,0,0
KHM,Cambodia,EST,Estonia,2012,0,0,0
KHM,Cambodia,EST,Estonia,2013,0,0,0
KHM,Cambodia,EST,Estonia,2014,0,0,0
KHM,Cambodia,EST,Estonia,2015,2,0,2
KHM,Cambodia,EST,Estonia,2016,1,0,1
KHM,Cambodia,EST,Estonia,2017,1,0,1
KHM,Cambodia,SVN,Slovenia,2008,1,0,1
KHM,Cambodia,SVN,Slovenia,2012,1,0,1
CMR,Cameroon,AUS,Australia,2008,27,0,27
CMR,Cameroon,AUS,Australia,2009,15,5,10
CMR,Cameroon,AUS,Australia,2010,21,0,21
CMR,Cameroon,AUS,Australia,2011,41,0,41
CMR,Cameroon,AUS,Australia,2012,13,0,13
CMR,Cameroon,AUS,Australia,2013,8,7,1
CMR,Cameroon,AUS,Australia,2014,12,5,7
CMR,Cameroon,AUS,Australia,2015,26,0,26
CMR,Cameroon,AUS,Australia,2016,18,0,18
CMR,Cameroon,AUS,Australia,2017,11,0,11
CMR,Cameroon,AUT,Austria,2008,65,34,31
CMR,Cameroon,AUT,Austria,2009,51,31,20
CMR,Cameroon,AUT,Austria,2010,59,43,16
CMR,Cameroon,AUT,Austria,2011,50,41,9
CMR,Cameroon,AUT,Austria,2012,82,36,46
CMR,Cameroon,AUT,Austria,2013,65,47,18
CMR,Cameroon,AUT,Austria,2014,48,21,27
CMR,Cameroon,AUT,Austria,2015,93,26,67
CMR,Cameroon,AUT,Austria,2016,72,40,32
CMR,Cameroon,AUT,Austria,2017,85,49,36
CMR,Cameroon,BEL,Belgium,2008,1220,124,1096
CMR,Cameroon,BEL,Belgium,2009,1176,192,984
CMR,Cameroon,BEL,Belgium,2010,1233,187,1046
CMR,Cameroon,BEL,Belgium,2011,1292,278,1014
CMR,Cameroon,BEL,Belgium,2012,1775,502,1273
CMR,Cameroon,BEL,Belgium,2013,1346,618,728
CMR,Cameroon,BEL,Belgium,2014,1435,592,843
CMR,Cameroon,BEL,Belgium,2015,1504,527,977
CMR,Cameroon,BEL,Belgium,2016,1562,385,1177
CMR,Cameroon,BEL,Belgium,2017,1668,311,1357
CMR,Cameroon,CAN,Canada,2008,1277,0,1277
CMR,Cameroon,CAN,Canada,2009,1343,0,1343
CMR,Cameroon,CAN,Canada,2010,1801,0,1801
CMR,Cameroon,CAN,Canada,2011,1635,0,1635
CMR,Cameroon,CAN,Canada,2012,2503,0,2503
CMR,Cameroon,CAN,Canada,2013,2438,0,2438
CMR,Cameroon,CAN,Canada,2014,2107,0,2107
CMR,Cameroon,CAN,Canada,2015,2034,0,2034
CMR,Cameroon,CAN,Canada,2016,2110,0,2110
CMR,Cameroon,CAN,Canada,2017,2285,0,2285
CMR,Cameroon,CZE,Czech Republic,2008,12,0,12
CMR,Cameroon,CZE,Czech Republic,2009,23,0,23
CMR,Cameroon,CZE,Czech Republic,2010,9,0,9
CMR,Cameroon,CZE,Czech Republic,2011,3,0,3
CMR,Cameroon,CZE,Czech Republic,2012,6,4,2
CMR,Cameroon,CZE,Czech Republic,2013,10,1,9
CMR,Cameroon,CZE,Czech Republic,2014,15,8,7
CMR,Cameroon,CZE,Czech Republic,2015,8,6,2
CMR,Cameroon,CZE,Czech Republic,2016,5,4,1
CMR,Cameroon,DNK,Denmark,2008,68,23,45
CMR,Cameroon,DNK,Denmark,2009,84,20,64
CMR,Cameroon,DNK,Denmark,2010,96,42,54
CMR,Cameroon,DNK,Denmark,2011,105,46,59
CMR,Cameroon,DNK,Denmark,2012,62,49,13
CMR,Cameroon,DNK,Denmark,2013,93,68,25
CMR,Cameroon,DNK,Denmark,2014,99,68,31
CMR,Cameroon,DNK,Denmark,2015,88,54,34
CMR,Cameroon,DNK,Denmark,2016,87,56,31
CMR,Cameroon,DNK,Denmark,2017,71,71,0
CMR,Cameroon,FIN,Finland,2008,111,5,106
CMR,Cameroon,FIN,Finland,2009,58,3,55
CMR,Cameroon,FIN,Finland,2010,60,7,53
CMR,Cameroon,FIN,Finland,2011,49,4,45
CMR,Cameroon,FIN,Finland,2012,66,8,58
CMR,Cameroon,FIN,Finland,2013,76,8,68
CMR,Cameroon,FIN,Finland,2014,117,12,105
CMR,Cameroon,FIN,Finland,2015,67,4,63
CMR,Cameroon,FIN,Finland,2016,112,6,106
CMR,Cameroon,FIN,Finland,2017,87,4,83
CMR,Cameroon,FRA,France,2008,3828,0,3828
CMR,Cameroon,FRA,France,2009,3867,0,3867
CMR,Cameroon,FRA,France,2010,3599,0,3599
CMR,Cameroon,FRA,France,2011,3583,0,3583
CMR,Cameroon,FRA,France,2012,3764,0,3764
CMR,Cameroon,FRA,France,2013,3787,0,3787
CMR,Cameroon,FRA,France,2014,4072,0,4072
CMR,Cameroon,FRA,France,2015,3164,0,3164
CMR,Cameroon,FRA,France,2016,3197,0,3197
CMR,Cameroon,FRA,France,2017,3418,0,3418
CMR,Cameroon,DEU,Germany,2008,1392,1389,3
CMR,Cameroon,DEU,Germany,2009,1784,1186,598
CMR,Cameroon,DEU,Germany,2010,1786,1120,666
CMR,Cameroon,DEU,Germany,2011,2037,1003,1034
CMR,Cameroon,DEU,Germany,2012,2010,807,1203
CMR,Cameroon,DEU,Germany,2013,2427,924,1503
CMR,Cameroon,DEU,Germany,2014,2810,969,1841
CMR,Cameroon,DEU,Germany,2015,3189,980,2209
CMR,Cameroon,DEU,Germany,2016,3109,1301,1808
CMR,Cameroon,DEU,Germany,2017,2583,1095,1488
CMR,Cameroon,HUN,Hungary,2008,51,7,44
CMR,Cameroon,HUN,Hungary,2009,60,8,52
CMR,Cameroon,HUN,Hungary,2010,33,11,22
CMR,Cameroon,HUN,Hungary,2011,33,2,31
CMR,Cameroon,HUN,Hungary,2012,60,9,51
CMR,Cameroon,HUN,Hungary,2013,58,21,37
CMR,Cameroon,HUN,Hungary,2014,51,20,31
CMR,Cameroon,HUN,Hungary,2015,63,25,38
CMR,Cameroon,HUN,Hungary,2016,95,22,73
CMR,Cameroon,HUN,Hungary,2017,80,0,80
CMR,Cameroon,ISL,Iceland,2008,2,2,0
CMR,Cameroon,ISL,Iceland,2009,2,1,1
CMR,Cameroon,ISL,Iceland,2010,3,1,2
CMR,Cameroon,ISL,Iceland,2011,1,0,1
CMR,Cameroon,ISL,Iceland,2012,3,1,2
CMR,Cameroon,ISL,Iceland,2013,2,3,-1
CMR,Cameroon,ISL,Iceland,2014,1,1,0
CMR,Cameroon,ISL,Iceland,2015,3,2,1
CMR,Cameroon,ISL,Iceland,2016,4,1,3
CMR,Cameroon,ISL,Iceland,2017,1,3,-2
CMR,Cameroon,ITA,Italy,2008,964,24,940
CMR,Cameroon,ITA,Italy,2009,1141,32,1109
CMR,Cameroon,ITA,Italy,2010,1226,48,1178
CMR,Cameroon,ITA,Italy,2011,983,62,921
CMR,Cameroon,ITA,Italy,2012,1262,58,1204
CMR,Cameroon,ITA,Italy,2013,1117,76,1041
CMR,Cameroon,ITA,Italy,2014,816,68,748
CMR,Cameroon,ITA,Italy,2015,821,68,753
CMR,Cameroon,ITA,Italy,2016,1242,0,1242
CMR,Cameroon,ITA,Italy,2017,2006,88,1918
CMR,Cameroon,JPN,Japan,2008,136,106,30
CMR,Cameroon,JPN,Japan,2009,119,92,27
CMR,Cameroon,JPN,Japan,2010,145,125,20
CMR,Cameroon,JPN,Japan,2011,84,84,0
CMR,Cameroon,JPN,Japan,2012,146,125,21
CMR,Cameroon,JPN,Japan,2013,144,103,41
CMR,Cameroon,JPN,Japan,2014,126,106,20
CMR,Cameroon,JPN,Japan,2015,131,121,10
CMR,Cameroon,JPN,Japan,2016,138,104,34
CMR,Cameroon,JPN,Japan,2017,209,140,69
CMR,Cameroon,KOR,Korea,2008,49,20,29
CMR,Cameroon,KOR,Korea,2009,72,28,44
CMR,Cameroon,KOR,Korea,2010,75,40,35
CMR,Cameroon,KOR,Korea,2011,88,54,34
CMR,Cameroon,KOR,Korea,2012,213,70,143
CMR,Cameroon,KOR,Korea,2013,199,74,125
CMR,Cameroon,KOR,Korea,2014,166,86,80
CMR,Cameroon,KOR,Korea,2015,157,102,55
CMR,Cameroon,KOR,Korea,2016,252,139,113
CMR,Cameroon,KOR,Korea,2017,240,147,93
CMR,Cameroon,LUX,Luxembourg,2008,37,8,29
CMR,Cameroon,LUX,Luxembourg,2009,63,12,51
CMR,Cameroon,LUX,Luxembourg,2010,56,16,40
CMR,Cameroon,LUX,Luxembourg,2011,63,9,54
CMR,Cameroon,LUX,Luxembourg,2012,46,23,23
CMR,Cameroon,LUX,Luxembourg,2013,37,25,12
CMR,Cameroon,LUX,Luxembourg,2014,59,15,44
CMR,Cameroon,LUX,Luxembourg,2015,77,24,53
CMR,Cameroon,LUX,Luxembourg,2016,70,14,56
CMR,Cameroon,LUX,Luxembourg,2017,114,23,91
CMR,Cameroon,MEX,Mexico,2008,12,0,12
CMR,Cameroon,MEX,Mexico,2009,19,0,19
CMR,Cameroon,MEX,Mexico,2010,31,0,31
CMR,Cameroon,MEX,Mexico,2011,14,0,14
CMR,Cameroon,MEX,Mexico,2012,6,0,6
CMR,Cameroon,MEX,Mexico,2013,29,0,29
CMR,Cameroon,MEX,Mexico,2014,23,0,23
CMR,Cameroon,MEX,Mexico,2015,12,0,12
CMR,Cameroon,MEX,Mexico,2016,15,0,15
CMR,Cameroon,MEX,Mexico,2017,14,0,14
CMR,Cameroon,NLD,Netherlands,2008,109,79,30
CMR,Cameroon,NLD,Netherlands,2009,160,64,96
CMR,Cameroon,NLD,Netherlands,2010,134,82,52
CMR,Cameroon,NLD,Netherlands,2011,118,104,14
CMR,Cameroon,NLD,Netherlands,2012,99,73,26
CMR,Cameroon,NLD,Netherlands,2013,76,80,-4
CMR,Cameroon,NLD,Netherlands,2014,76,61,15
CMR,Cameroon,NLD,Netherlands,2015,68,45,23
CMR,Cameroon,NLD,Netherlands,2016,68,46,22
CMR,Cameroon,NLD,Netherlands,2017,95,29,66
CMR,Cameroon,NZL,New Zealand,2008,3,0,3
CMR,Cameroon,NZL,New Zealand,2009,0,0,0
CMR,Cameroon,NZL,New Zealand,2010,0,1,-1
CMR,Cameroon,NZL,New Zealand,2011,1,2,-1
CMR,Cameroon,NZL,New Zealand,2012,1,0,1
CMR,Cameroon,NZL,New Zealand,2014,4,0,4
CMR,Cameroon,NZL,New Zealand,2015,7,0,7
CMR,Cameroon,NZL,New Zealand,2016,9,2,7
CMR,Cameroon,NZL,New Zealand,2017,3,1,2
CMR,Cameroon,NOR,Norway,2008,44,15,29
CMR,Cameroon,NOR,Norway,2009,60,30,30
CMR,Cameroon,NOR,Norway,2010,64,18,46
CMR,Cameroon,NOR,Norway,2011,53,36,17
CMR,Cameroon,NOR,Norway,2012,46,29,17
CMR,Cameroon,NOR,Norway,2013,40,32,8
CMR,Cameroon,NOR,Norway,2014,53,28,25
CMR,Cameroon,NOR,Norway,2015,56,20,36
CMR,Cameroon,NOR,Norway,2016,37,20,17
CMR,Cameroon,NOR,Norway,2017,56,21,35
CMR,Cameroon,POL,Poland,2008,97,0,97
CMR,Cameroon,POL,Poland,2009,130,0,130
CMR,Cameroon,POL,Poland,2010,120,0,120
CMR,Cameroon,POL,Poland,2011,132,0,132
CMR,Cameroon,POL,Poland,2012,130,0,130
CMR,Cameroon,POL,Poland,2013,108,0,108
CMR,Cameroon,POL,Poland,2014,60,0,60
CMR,Cameroon,POL,Poland,2015,96,0,96
CMR,Cameroon,POL,Poland,2016,81,0,81
CMR,Cameroon,POL,Poland,2017,65,0,65
CMR,Cameroon,SVK,Slovak Republic,2008,1,0,1
CMR,Cameroon,SVK,Slovak Republic,2009,7,2,5
CMR,Cameroon,SVK,Slovak Republic,2010,3,2,1
CMR,Cameroon,SVK,Slovak Republic,2011,3,2,1
CMR,Cameroon,ESP,Spain,2008,807,262,545
CMR,Cameroon,ESP,Spain,2009,595,437,158
CMR,Cameroon,ESP,Spain,2010,520,512,8
CMR,Cameroon,ESP,Spain,2011,511,697,-186
CMR,Cameroon,ESP,Spain,2012,480,683,-203
CMR,Cameroon,ESP,Spain,2013,470,770,-300
CMR,Cameroon,ESP,Spain,2014,467,444,23
CMR,Cameroon,ESP,Spain,2015,443,352,91
CMR,Cameroon,ESP,Spain,2016,480,336,144
CMR,Cameroon,ESP,Spain,2017,620,415,205
CMR,Cameroon,SWE,Sweden,2008,282,84,198
CMR,Cameroon,SWE,Sweden,2009,263,49,214
CMR,Cameroon,SWE,Sweden,2010,117,64,53
CMR,Cameroon,SWE,Sweden,2011,92,106,-14
CMR,Cameroon,SWE,Sweden,2012,91,116,-25
CMR,Cameroon,SWE,Sweden,2013,105,70,35
CMR,Cameroon,SWE,Sweden,2014,115,69,46
CMR,Cameroon,SWE,Sweden,2015,111,128,-17
CMR,Cameroon,SWE,Sweden,2016,107,31,76
CMR,Cameroon,SWE,Sweden,2017,127,17,110
CMR,Cameroon,CHE,Switzerland,2010,396,103,293
CMR,Cameroon,CHE,Switzerland,2011,299,93,206
CMR,Cameroon,CHE,Switzerland,2012,256,54,202
CMR,Cameroon,CHE,Switzerland,2013,260,95,165
CMR,Cameroon,CHE,Switzerland,2014,239,58,181
CMR,Cameroon,CHE,Switzerland,2015,277,50,227
CMR,Cameroon,CHE,Switzerland,2016,251,66,185
CMR,Cameroon,CHE,Switzerland,2017,242,63,179
CMR,Cameroon,TUR,Turkey,2010,17,0,17
CMR,Cameroon,TUR,Turkey,2016,304,121,183
CMR,Cameroon,TUR,Turkey,2017,280,183,97
CMR,Cameroon,GBR,United Kingdom,2014,1000,0,1000
CMR,Cameroon,USA,United States,2008,3771,0,3771
CMR,Cameroon,USA,United States,2009,3463,0,3463
CMR,Cameroon,USA,United States,2010,4161,0,4161
CMR,Cameroon,USA,United States,2011,4754,0,4754
CMR,Cameroon,USA,United States,2012,3815,0,3815
CMR,Cameroon,USA,United States,2013,3908,0,3908
CMR,Cameroon,USA,United States,2014,3943,0,3943
CMR,Cameroon,USA,United States,2015,4374,0,4374
CMR,Cameroon,USA,United States,2016,4899,0,4899
CMR,Cameroon,USA,United States,2017,4668,0,4668
CMR,Cameroon,CHL,Chile,2008,7,0,7
CMR,Cameroon,CHL,Chile,2009,3,0,3
CMR,Cameroon,CHL,Chile,2010,7,0,7
CMR,Cameroon,CHL,Chile,2011,4,0,4
CMR,Cameroon,CHL,Chile,2012,0,0,0
CMR,Cameroon,CHL,Chile,2013,4,0,4
CMR,Cameroon,CHL,Chile,2014,4,0,4
CMR,Cameroon,CHL,Chile,2015,2,0,2
CMR,Cameroon,CHL,Chile,2016,6,0,6
CMR,Cameroon,EST,Estonia,2008,0,0,0
CMR,Cameroon,EST,Estonia,2009,1,0,1
CMR,Cameroon,EST,Estonia,2010,0,0,0
CMR,Cameroon,EST,Estonia,2011,1,0,1
CMR,Cameroon,EST,Estonia,2012,2,0,2
CMR,Cameroon,EST,Estonia,2013,1,0,1
CMR,Cameroon,EST,Estonia,2014,2,0,2
CMR,Cameroon,EST,Estonia,2015,12,0,12
CMR,Cameroon,EST,Estonia,2016,15,0,15
CMR,Cameroon,EST,Estonia,2017,29,0,29
CMR,Cameroon,SVN,Slovenia,2008,4,0,4
CMR,Cameroon,SVN,Slovenia,2009,5,0,5
CMR,Cameroon,SVN,Slovenia,2010,3,0,3
CMR,Cameroon,SVN,Slovenia,2011,6,1,5
CMR,Cameroon,SVN,Slovenia,2012,1,0,1
CMR,Cameroon,SVN,Slovenia,2013,3,0,3
CMR,Cameroon,SVN,Slovenia,2014,1,0,1
CMR,Cameroon,SVN,Slovenia,2015,1,1,0
CMR,Cameroon,SVN,Slovenia,2016,4,1,3
CMR,Cameroon,SVN,Slovenia,2017,4,0,4
CAN,Canada,AUS,Australia,2008,1727,1018,709
CAN,Canada,AUS,Australia,2009,1895,1018,877
CAN,Canada,AUS,Australia,2010,1938,933,1005
CAN,Canada,AUS,Australia,2011,1740,849,891
CAN,Canada,AUS,Australia,2012,2011,982,1029
CAN,Canada,AUS,Australia,2013,1999,1120,879
CAN,Canada,AUS,Australia,2014,2073,1295,778
CAN,Canada,AUS,Australia,2015,2039,1414,625
CAN,Canada,AUS,Australia,2016,1962,1695,267
CAN,Canada,AUS,Australia,2017,1946,1865,81
CAN,Canada,AUT,Austria,2008,328,91,237
CAN,Canada,AUT,Austria,2009,298,109,189
CAN,Canada,AUT,Austria,2010,283,124,159
CAN,Canada,AUT,Austria,2011,362,84,278
CAN,Canada,AUT,Austria,2012,393,102,291
CAN,Canada,AUT,Austria,2013,387,90,297
CAN,Canada,AUT,Austria,2014,384,98,286
CAN,Canada,AUT,Austria,2015,463,118,345
CAN,Canada,AUT,Austria,2016,420,100,320
CAN,Canada,AUT,Austria,2017,474,105,369
CAN,Canada,BEL,Belgium,2008,653,335,318
CAN,Canada,BEL,Belgium,2009,677,358,319
CAN,Canada,BEL,Belgium,2010,710,363,347
CAN,Canada,BEL,Belgium,2011,717,332,385
CAN,Canada,BEL,Belgium,2012,615,401,214
CAN,Canada,BEL,Belgium,2013,674,379,295
CAN,Canada,BEL,Belgium,2014,477,356,121
CAN,Canada,BEL,Belgium,2015,459,359,100
CAN,Canada,BEL,Belgium,2016,520,455,65
CAN,Canada,BEL,Belgium,2017,432,505,-73
CAN,Canada,CAN,Canada,2008,0,0,0
CAN,Canada,CAN,Canada,2009,0,0,0
CAN,Canada,CAN,Canada,2010,0,0,0
CAN,Canada,CAN,Canada,2011,0,0,0
CAN,Canada,CAN,Canada,2012,0,0,0
CAN,Canada,CAN,Canada,2013,0,0,0
CAN,Canada,CAN,Canada,2014,0,0,0
CAN,Canada,CAN,Canada,2016,0,0,0
CAN,Canada,CAN,Canada,2017,0,0,0
CAN,Canada,CZE,Czech Republic,2008,211,104,107
CAN,Canada,CZE,Czech Republic,2009,156,159,-3
CAN,Canada,CZE,Czech Republic,2010,160,168,-8
CAN,Canada,CZE,Czech Republic,2011,130,128,2
CAN,Canada,CZE,Czech Republic,2012,107,173,-66
CAN,Canada,CZE,Czech Republic,2013,112,174,-62
CAN,Canada,CZE,Czech Republic,2014,110,224,-114
CAN,Canada,CZE,Czech Republic,2015,84,281,-197
CAN,Canada,CZE,Czech Republic,2016,114,325,-211
CAN,Canada,CZE,Czech Republic,2017,125,315,-190
CAN,Canada,DNK,Denmark,2008,262,108,154
CAN,Canada,DNK,Denmark,2009,227,81,146
CAN,Canada,DNK,Denmark,2010,232,92,140
CAN,Canada,DNK,Denmark,2011,227,93,134
CAN,Canada,DNK,Denmark,2012,215,93,122
CAN,Canada,DNK,Denmark,2013,247,81,166
CAN,Canada,DNK,Denmark,2014,297,69,228
CAN,Canada,DNK,Denmark,2015,279,75,204
CAN,Canada,DNK,Denmark,2016,295,80,215
CAN,Canada,DNK,Denmark,2017,309,95,214
CAN,Canada,FIN,Finland,2008,75,89,-14
CAN,Canada,FIN,Finland,2009,57,63,-6
CAN,Canada,FIN,Finland,2010,59,63,-4
CAN,Canada,FIN,Finland,2011,72,72,0
CAN,Canada,FIN,Finland,2012,62,62,0
CAN,Canada,FIN,Finland,2013,81,76,5
CAN,Canada,FIN,Finland,2014,63,68,-5
CAN,Canada,FIN,Finland,2015,76,83,-7
CAN,Canada,FIN,Finland,2016,59,80,-21
CAN,Canada,FIN,Finland,2017,74,105,-31
CAN,Canada,FRA,France,2008,1167,4532,-3365
CAN,Canada,FRA,France,2009,1068,5051,-3983
CAN,Canada,FRA,France,2010,1085,4646,-3561
CAN,Canada,FRA,France,2011,1089,4080,-2991
CAN,Canada,FRA,France,2012,1085,6270,-5185
CAN,Canada,FRA,France,2013,1058,5623,-4565
CAN,Canada,FRA,France,2014,1108,4716,-3608
CAN,Canada,FRA,France,2015,1327,5807,-4480
CAN,Canada,FRA,France,2016,1240,6350,-5110
CAN,Canada,FRA,France,2017,1178,6600,-5422
CAN,Canada,DEU,Germany,2008,2862,3833,-971
CAN,Canada,DEU,Germany,2009,2653,3886,-1233
CAN,Canada,DEU,Germany,2010,2891,2955,-64
CAN,Canada,DEU,Germany,2011,3138,2015,1123
CAN,Canada,DEU,Germany,2012,3269,1699,1570
CAN,Canada,DEU,Germany,2013,3308,1216,2092
CAN,Canada,DEU,Germany,2014,3516,1273,2243
CAN,Canada,DEU,Germany,2015,3453,1248,2205
CAN,Canada,DEU,Germany,2016,3372,1210,2162
CAN,Canada,DEU,Germany,2017,3330,1140,2190
CAN,Canada,HUN,Hungary,2008,177,382,-205
CAN,Canada,HUN,Hungary,2009,172,312,-140
CAN,Canada,HUN,Hungary,2010,172,354,-182
CAN,Canada,HUN,Hungary,2011,180,287,-107
CAN,Canada,HUN,Hungary,2012,173,300,-127
CAN,Canada,HUN,Hungary,2013,169,423,-254
CAN,Canada,HUN,Hungary,2014,148,536,-388
CAN,Canada,HUN,Hungary,2015,214,770,-556
CAN,Canada,HUN,Hungary,2016,189,520,-331
CAN,Canada,HUN,Hungary,2017,226,695,-469
CAN,Canada,ISL,Iceland,2008,70,13,57
CAN,Canada,ISL,Iceland,2009,33,15,18
CAN,Canada,ISL,Iceland,2010,42,30,12
CAN,Canada,ISL,Iceland,2011,38,38,0
CAN,Canada,ISL,Iceland,2012,51,42,9
CAN,Canada,ISL,Iceland,2013,56,72,-16
CAN,Canada,ISL,Iceland,2014,55,38,17
CAN,Canada,ISL,Iceland,2015,58,32,26
CAN,Canada,ISL,Iceland,2016,76,15,61
CAN,Canada,ISL,Iceland,2017,56,25,31
CAN,Canada,ITA,Italy,2008,306,370,-64
CAN,Canada,ITA,Italy,2009,275,429,-154
CAN,Canada,ITA,Italy,2010,301,434,-133
CAN,Canada,ITA,Italy,2011,285,374,-89
CAN,Canada,ITA,Italy,2012,252,438,-186
CAN,Canada,ITA,Italy,2013,209,545,-336
CAN,Canada,ITA,Italy,2014,209,652,-443
CAN,Canada,ITA,Italy,2015,204,832,-628
CAN,Canada,ITA,Italy,2016,211,980,-769
CAN,Canada,ITA,Italy,2017,250,1030,-780
CAN,Canada,JPN,Japan,2008,3631,1284,2347
CAN,Canada,JPN,Japan,2009,2743,1193,1550
CAN,Canada,JPN,Japan,2010,2696,1167,1529
CAN,Canada,JPN,Japan,2011,2062,1265,797
CAN,Canada,JPN,Japan,2012,2203,1210,993
CAN,Canada,JPN,Japan,2013,2157,983,1174
CAN,Canada,JPN,Japan,2014,2290,1127,1163
CAN,Canada,JPN,Japan,2015,2348,995,1353
CAN,Canada,JPN,Japan,2016,2724,1035,1689
CAN,Canada,JPN,Japan,2017,2651,1080,1571
CAN,Canada,KOR,Korea,2008,6402,7291,-889
CAN,Canada,KOR,Korea,2009,6490,5873,617
CAN,Canada,KOR,Korea,2010,6505,5537,968
CAN,Canada,KOR,Korea,2011,5956,4588,1368
CAN,Canada,KOR,Korea,2012,6012,5315,697
CAN,Canada,KOR,Korea,2013,5635,4509,1126
CAN,Canada,KOR,Korea,2014,5454,4458,996
CAN,Canada,KOR,Korea,2015,5270,4091,1179
CAN,Canada,KOR,Korea,2016,5271,4010,1261
CAN,Canada,KOR,Korea,2017,4588,3975,613
CAN,Canada,LUX,Luxembourg,2008,83,3,80
CAN,Canada,LUX,Luxembourg,2009,42,5,37
CAN,Canada,LUX,Luxembourg,2010,43,8,35
CAN,Canada,LUX,Luxembourg,2011,61,11,50
CAN,Canada,LUX,Luxembourg,2012,58,6,52
CAN,Canada,LUX,Luxembourg,2013,92,7,85
CAN,Canada,LUX,Luxembourg,2014,73,8,65
CAN,Canada,LUX,Luxembourg,2015,83,8,75
CAN,Canada,LUX,Luxembourg,2016,63,5,58
CAN,Canada,LUX,Luxembourg,2017,83,5,78
CAN,Canada,MEX,Mexico,2008,397,2853,-2456
CAN,Canada,MEX,Mexico,2009,586,3092,-2506
CAN,Canada,MEX,Mexico,2010,748,3861,-3113
CAN,Canada,MEX,Mexico,2011,849,3947,-3098
CAN,Canada,MEX,Mexico,2012,830,4227,-3397
CAN,Canada,MEX,Mexico,2013,3465,3995,-530
CAN,Canada,MEX,Mexico,2014,1964,4477,-2513
CAN,Canada,MEX,Mexico,2015,1785,3231,-1446
CAN,Canada,MEX,Mexico,2016,1676,3400,-1724
CAN,Canada,MEX,Mexico,2017,1296,3135,-1839
CAN,Canada,NLD,Netherlands,2008,809,818,-9
CAN,Canada,NLD,Netherlands,2009,755,786,-31
CAN,Canada,NLD,Netherlands,2010,806,759,47
CAN,Canada,NLD,Netherlands,2011,824,585,239
CAN,Canada,NLD,Netherlands,2012,912,502,410
CAN,Canada,NLD,Netherlands,2013,965,395,570
CAN,Canada,NLD,Netherlands,2014,963,422,541
CAN,Canada,NLD,Netherlands,2015,1085,532,553
CAN,Canada,NLD,Netherlands,2016,1137,515,622
CAN,Canada,NLD,Netherlands,2017,1263,495,768
CAN,Canada,NZL,New Zealand,2008,1090,480,610
CAN,Canada,NZL,New Zealand,2009,1008,520,488
CAN,Canada,NZL,New Zealand,2010,1046,489,557
CAN,Canada,NZL,New Zealand,2011,1105,375,730
CAN,Canada,NZL,New Zealand,2012,1072,417,655
CAN,Canada,NZL,New Zealand,2013,1116,415,701
CAN,Canada,NZL,New Zealand,2014,1271,396,875
CAN,Canada,NZL,New Zealand,2015,1548,331,1217
CAN,Canada,NZL,New Zealand,2016,1680,500,1180
CAN,Canada,NZL,New Zealand,2017,1783,405,1378
CAN,Canada,NOR,Norway,2008,267,66,201
CAN,Canada,NOR,Norway,2009,271,75,196
CAN,Canada,NOR,Norway,2010,265,46,219
CAN,Canada,NOR,Norway,2011,233,49,184
CAN,Canada,NOR,Norway,2012,300,53,247
CAN,Canada,NOR,Norway,2013,217,59,158
CAN,Canada,NOR,Norway,2014,222,46,176
CAN,Canada,NOR,Norway,2015,220,50,170
CAN,Canada,NOR,Norway,2016,236,80,156
CAN,Canada,NOR,Norway,2017,231,70,161
CAN,Canada,POL,Poland,2008,164,1267,-1103
CAN,Canada,POL,Poland,2009,205,1013,-808
CAN,Canada,POL,Poland,2010,178,795,-617
CAN,Canada,POL,Poland,2011,200,720,-520
CAN,Canada,POL,Poland,2012,214,779,-565
CAN,Canada,POL,Poland,2013,198,853,-655
CAN,Canada,POL,Poland,2014,92,773,-681
CAN,Canada,POL,Poland,2015,226,981,-755
CAN,Canada,POL,Poland,2016,195,1000,-805
CAN,Canada,POL,Poland,2017,159,1005,-846
CAN,Canada,PRT,Portugal,2008,55,664,-609
CAN,Canada,PRT,Portugal,2009,49,622,-573
CAN,Canada,PRT,Portugal,2010,67,629,-562
CAN,Canada,PRT,Portugal,2011,46,528,-482
CAN,Canada,PRT,Portugal,2012,64,560,-496
CAN,Canada,PRT,Portugal,2013,59,630,-571
CAN,Canada,PRT,Portugal,2014,59,637,-578
CAN,Canada,PRT,Portugal,2015,64,821,-757
CAN,Canada,PRT,Portugal,2016,76,845,-769
CAN,Canada,PRT,Portugal,2017,142,785,-643
CAN,Canada,SVK,Slovak Republic,2008,5,125,-120
CAN,Canada,SVK,Slovak Republic,2009,2,128,-126
CAN,Canada,SVK,Slovak Republic,2010,1,135,-134
CAN,Canada,SVK,Slovak Republic,2011,4,134,-130
CAN,Canada,SVK,Slovak Republic,2012,3,136,-133
CAN,Canada,SVK,Slovak Republic,2013,2,105,-103
CAN,Canada,SVK,Slovak Republic,2014,4,161,-157
CAN,Canada,SVK,Slovak Republic,2015,1,208,-207
CAN,Canada,SVK,Slovak Republic,2016,3,270,-267
CAN,Canada,SVK,Slovak Republic,2017,5,260,-255
CAN,Canada,ESP,Spain,2008,417,168,249
CAN,Canada,ESP,Spain,2009,407,195,212
CAN,Canada,ESP,Spain,2010,493,174,319
CAN,Canada,ESP,Spain,2011,662,179,483
CAN,Canada,ESP,Spain,2012,636,259,377
CAN,Canada,ESP,Spain,2013,678,330,348
CAN,Canada,ESP,Spain,2014,684,494,190
CAN,Canada,ESP,Spain,2015,713,709,4
CAN,Canada,ESP,Spain,2016,731,645,86
CAN,Canada,ESP,Spain,2017,883,675,208
CAN,Canada,SWE,Sweden,2008,268,165,103
CAN,Canada,SWE,Sweden,2009,344,167,177
CAN,Canada,SWE,Sweden,2010,336,159,177
CAN,Canada,SWE,Sweden,2011,280,133,147
CAN,Canada,SWE,Sweden,2012,338,140,198
CAN,Canada,SWE,Sweden,2013,301,140,161
CAN,Canada,SWE,Sweden,2014,311,157,154
CAN,Canada,SWE,Sweden,2015,330,176,154
CAN,Canada,SWE,Sweden,2016,316,175,141
CAN,Canada,SWE,Sweden,2017,370,175,195
CAN,Canada,CHE,Switzerland,2010,1080,285,795
CAN,Canada,CHE,Switzerland,2011,1000,266,734
CAN,Canada,CHE,Switzerland,2012,903,243,660
CAN,Canada,CHE,Switzerland,2013,806,200,606
CAN,Canada,CHE,Switzerland,2014,779,203,576
CAN,Canada,CHE,Switzerland,2015,923,236,687
CAN,Canada,CHE,Switzerland,2016,715,215,500
CAN,Canada,CHE,Switzerland,2017,786,190,596
CAN,Canada,TUR,Turkey,2010,136,1492,-1356
CAN,Canada,TUR,Turkey,2016,366,920,-554
CAN,Canada,TUR,Turkey,2017,454,1110,-656
CAN,Canada,GBR,United Kingdom,2008,7000,8975,-1975
CAN,Canada,GBR,United Kingdom,2010,6000,8715,-2715
CAN,Canada,GBR,United Kingdom,2011,9000,6128,2872
CAN,Canada,GBR,United Kingdom,2012,7000,6171,829
CAN,Canada,GBR,United Kingdom,2013,6000,5814,186
CAN,Canada,GBR,United Kingdom,2014,11000,5759,5241
CAN,Canada,GBR,United Kingdom,2015,6000,5450,550
CAN,Canada,GBR,United Kingdom,2016,6000,5810,190
CAN,Canada,GBR,United Kingdom,2017,6000,5295,705
CAN,Canada,USA,United States,2008,15109,10186,4923
CAN,Canada,USA,United States,2009,16140,8994,7146
CAN,Canada,USA,United States,2010,13328,8139,5189
CAN,Canada,USA,United States,2011,12800,7671,5129
CAN,Canada,USA,United States,2012,12932,7870,5062
CAN,Canada,USA,United States,2013,13181,8485,4696
CAN,Canada,USA,United States,2014,11586,8491,3095
CAN,Canada,USA,United States,2015,12673,7521,5152
CAN,Canada,USA,United States,2016,12793,8410,4383
CAN,Canada,USA,United States,2017,11484,9100,2384
CAN,Canada,CHL,Chile,2008,185,350,-165
CAN,Canada,CHL,Chile,2009,170,375,-205
CAN,Canada,CHL,Chile,2010,210,340,-130
CAN,Canada,CHL,Chile,2011,241,174,67
CAN,Canada,CHL,Chile,2012,284,291,-7
CAN,Canada,CHL,Chile,2013,209,273,-64
CAN,Canada,CHL,Chile,2014,196,299,-103
CAN,Canada,CHL,Chile,2015,158,258,-100
CAN,Canada,CHL,Chile,2016,129,245,-116
CAN,Canada,EST,Estonia,2008,8,34,-26
CAN,Canada,EST,Estonia,2009,5,26,-21
CAN,Canada,EST,Estonia,2010,5,28,-23
CAN,Canada,EST,Estonia,2011,11,15,-4
CAN,Canada,EST,Estonia,2012,3,26,-23
CAN,Canada,EST,Estonia,2013,6,45,-39
CAN,Canada,EST,Estonia,2014,7,32,-25
CAN,Canada,EST,Estonia,2015,14,53,-39
CAN,Canada,EST,Estonia,2016,10,55,-45
CAN,Canada,EST,Estonia,2017,32,35,-3
CAN,Canada,ISR,Israel,2008,264,2559,-2295
CAN,Canada,ISR,Israel,2009,283,2316,-2033
CAN,Canada,ISR,Israel,2010,271,2755,-2484
CAN,Canada,ISR,Israel,2011,212,1967,-1755
CAN,Canada,ISR,Israel,2012,236,2132,-1896
CAN,Canada,ISR,Israel,2013,228,1945,-1717
CAN,Canada,ISR,Israel,2014,265,1899,-1634
CAN,Canada,ISR,Israel,2015,338,2132,-1794
CAN,Canada,ISR,Israel,2016,296,2400,-2104
CAN,Canada,ISR,Israel,2017,280,1865,-1585
CAN,Canada,SVN,Slovenia,2008,22,18,4
CAN,Canada,SVN,Slovenia,2009,21,27,-6
CAN,Canada,SVN,Slovenia,2010,35,12,23
CAN,Canada,SVN,Slovenia,2011,35,13,22
CAN,Canada,SVN,Slovenia,2012,15,36,-21
CAN,Canada,SVN,Slovenia,2013,3,20,-17
CAN,Canada,SVN,Slovenia,2014,8,30,-22
CAN,Canada,SVN,Slovenia,2015,19,41,-22
CAN,Canada,SVN,Slovenia,2016,16,35,-19
CAN,Canada,SVN,Slovenia,2017,27,50,-23
CPV,Cape Verde,AUS,Australia,2008,0,0,0
CPV,Cape Verde,AUS,Australia,2009,0,0,0
CPV,Cape Verde,AUS,Australia,2010,0,0,0
CPV,Cape Verde,AUS,Australia,2011,1,0,1
CPV,Cape Verde,AUS,Australia,2012,0,0,0
CPV,Cape Verde,AUS,Australia,2013,2,0,2
CPV,Cape Verde,AUS,Australia,2014,0,0,0
CPV,Cape Verde,AUS,Australia,2015,0,0,0
CPV,Cape Verde,AUS,Australia,2016,0,0,0
CPV,Cape Verde,AUS,Australia,2017,0,0,0
CPV,Cape Verde,AUT,Austria,2008,0,3,-3
CPV,Cape Verde,AUT,Austria,2009,4,0,4
CPV,Cape Verde,AUT,Austria,2010,4,3,1
CPV,Cape Verde,AUT,Austria,2011,0,2,-2
CPV,Cape Verde,AUT,Austria,2012,0,0,0
CPV,Cape Verde,AUT,Austria,2013,4,4,0
CPV,Cape Verde,AUT,Austria,2014,5,2,3
CPV,Cape Verde,AUT,Austria,2015,6,2,4
CPV,Cape Verde,AUT,Austria,2016,5,7,-2
CPV,Cape Verde,AUT,Austria,2017,9,2,7
CPV,Cape Verde,BEL,Belgium,2008,21,0,21
CPV,Cape Verde,BEL,Belgium,2009,24,0,24
CPV,Cape Verde,BEL,Belgium,2010,20,3,17
CPV,Cape Verde,BEL,Belgium,2011,28,0,28
CPV,Cape Verde,BEL,Belgium,2012,25,6,19
CPV,Cape Verde,BEL,Belgium,2013,21,19,2
CPV,Cape Verde,BEL,Belgium,2014,31,8,23
CPV,Cape Verde,BEL,Belgium,2015,30,3,27
CPV,Cape Verde,BEL,Belgium,2016,30,9,21
CPV,Cape Verde,BEL,Belgium,2017,33,7,26
CPV,Cape Verde,CAN,Canada,2008,5,0,5
CPV,Cape Verde,CAN,Canada,2009,1,0,1
CPV,Cape Verde,CAN,Canada,2010,3,0,3
CPV,Cape Verde,CAN,Canada,2011,3,0,3
CPV,Cape Verde,CAN,Canada,2012,6,0,6
CPV,Cape Verde,CAN,Canada,2013,2,0,2
CPV,Cape Verde,CAN,Canada,2014,0,0,0
CPV,Cape Verde,CAN,Canada,2015,0,0,0
CPV,Cape Verde,CAN,Canada,2016,0,0,0
CPV,Cape Verde,CAN,Canada,2017,0,0,0
CPV,Cape Verde,CZE,Czech Republic,2008,1,0,1
CPV,Cape Verde,CZE,Czech Republic,2009,1,0,1
CPV,Cape Verde,CZE,Czech Republic,2010,2,0,2
CPV,Cape Verde,CZE,Czech Republic,2013,2,2,0
CPV,Cape Verde,CZE,Czech Republic,2014,2,0,2
CPV,Cape Verde,CZE,Czech Republic,2015,2,0,2
CPV,Cape Verde,CZE,Czech Republic,2016,4,0,4
CPV,Cape Verde,DNK,Denmark,2008,2,0,2
CPV,Cape Verde,DNK,Denmark,2009,2,0,2
CPV,Cape Verde,DNK,Denmark,2010,1,0,1
CPV,Cape Verde,DNK,Denmark,2011,1,0,1
CPV,Cape Verde,DNK,Denmark,2012,1,0,1
CPV,Cape Verde,DNK,Denmark,2013,1,0,1
CPV,Cape Verde,DNK,Denmark,2014,1,0,1
CPV,Cape Verde,DNK,Denmark,2015,0,0,0
CPV,Cape Verde,DNK,Denmark,2016,1,0,1
CPV,Cape Verde,DNK,Denmark,2017,1,1,0
CPV,Cape Verde,FIN,Finland,2008,0,0,0
CPV,Cape Verde,FIN,Finland,2009,0,0,0
CPV,Cape Verde,FIN,Finland,2010,1,0,1
CPV,Cape Verde,FIN,Finland,2011,1,0,1
CPV,Cape Verde,FIN,Finland,2012,2,0,2
CPV,Cape Verde,FIN,Finland,2013,1,2,-1
CPV,Cape Verde,FIN,Finland,2014,2,1,1
CPV,Cape Verde,FIN,Finland,2015,1,0,1
CPV,Cape Verde,FIN,Finland,2016,0,0,0
CPV,Cape Verde,FIN,Finland,2017,0,0,0
CPV,Cape Verde,FRA,France,2008,620,0,620
CPV,Cape Verde,FRA,France,2009,702,0,702
CPV,Cape Verde,FRA,France,2010,729,0,729
CPV,Cape Verde,FRA,France,2011,660,0,660
CPV,Cape Verde,FRA,France,2012,776,0,776
CPV,Cape Verde,FRA,France,2013,1077,0,1077
CPV,Cape Verde,FRA,France,2014,998,0,998
CPV,Cape Verde,FRA,France,2015,1056,0,1056
CPV,Cape Verde,FRA,France,2016,990,0,990
CPV,Cape Verde,FRA,France,2017,879,0,879
CPV,Cape Verde,DEU,Germany,2008,24,29,-5
CPV,Cape Verde,DEU,Germany,2009,29,42,-13
CPV,Cape Verde,DEU,Germany,2010,26,23,3
CPV,Cape Verde,DEU,Germany,2011,29,28,1
CPV,Cape Verde,DEU,Germany,2012,30,26,4
CPV,Cape Verde,DEU,Germany,2013,45,19,26
CPV,Cape Verde,DEU,Germany,2014,28,11,17
CPV,Cape Verde,DEU,Germany,2015,32,15,17
CPV,Cape Verde,DEU,Germany,2016,25,15,10
CPV,Cape Verde,DEU,Germany,2017,35,12,23
CPV,Cape Verde,HUN,Hungary,2008,0,0,0
CPV,Cape Verde,HUN,Hungary,2009,1,0,1
CPV,Cape Verde,HUN,Hungary,2010,0,0,0
CPV,Cape Verde,HUN,Hungary,2011,0,0,0
CPV,Cape Verde,HUN,Hungary,2012,1,0,1
CPV,Cape Verde,HUN,Hungary,2013,0,0,0
CPV,Cape Verde,HUN,Hungary,2014,2,0,2
CPV,Cape Verde,HUN,Hungary,2015,3,1,2
CPV,Cape Verde,HUN,Hungary,2016,1,0,1
CPV,Cape Verde,HUN,Hungary,2017,1,0,1
CPV,Cape Verde,ISL,Iceland,2008,5,0,5
CPV,Cape Verde,ISL,Iceland,2009,1,1,0
CPV,Cape Verde,ISL,Iceland,2010,0,3,-3
CPV,Cape Verde,ISL,Iceland,2011,0,1,-1
CPV,Cape Verde,ISL,Iceland,2012,1,3,-2
CPV,Cape Verde,ISL,Iceland,2013,2,0,2
CPV,Cape Verde,ISL,Iceland,2014,2,0,2
CPV,Cape Verde,ISL,Iceland,2015,2,1,1
CPV,Cape Verde,ISL,Iceland,2016,1,1,0
CPV,Cape Verde,ISL,Iceland,2017,2,2,0
CPV,Cape Verde,ITA,Italy,2008,179,4,175
CPV,Cape Verde,ITA,Italy,2009,236,4,232
CPV,Cape Verde,ITA,Italy,2010,224,8,216
CPV,Cape Verde,ITA,Italy,2011,216,12,204
CPV,Cape Verde,ITA,Italy,2012,221,14,207
CPV,Cape Verde,ITA,Italy,2013,165,9,156
CPV,Cape Verde,ITA,Italy,2014,117,11,106
CPV,Cape Verde,ITA,Italy,2015,107,6,101
CPV,Cape Verde,ITA,Italy,2016,112,0,112
CPV,Cape Verde,ITA,Italy,2017,102,10,92
CPV,Cape Verde,JPN,Japan,2008,15,14,1
CPV,Cape Verde,JPN,Japan,2009,4,4,0
CPV,Cape Verde,JPN,Japan,2010,9,8,1
CPV,Cape Verde,JPN,Japan,2011,7,7,0
CPV,Cape Verde,JPN,Japan,2012,16,16,0
CPV,Cape Verde,JPN,Japan,2013,16,15,1
CPV,Cape Verde,JPN,Japan,2014,16,13,3
CPV,Cape Verde,JPN,Japan,2015,16,16,0
CPV,Cape Verde,JPN,Japan,2016,11,9,2
CPV,Cape Verde,JPN,Japan,2017,6,7,-1
CPV,Cape Verde,KOR,Korea,2008,1,0,1
CPV,Cape Verde,KOR,Korea,2009,0,0,0
CPV,Cape Verde,KOR,Korea,2010,0,0,0
CPV,Cape Verde,KOR,Korea,2011,0,0,0
CPV,Cape Verde,KOR,Korea,2012,1,0,1
CPV,Cape Verde,KOR,Korea,2013,0,0,0
CPV,Cape Verde,KOR,Korea,2014,0,0,0
CPV,Cape Verde,KOR,Korea,2015,0,0,0
CPV,Cape Verde,KOR,Korea,2016,0,0,0
CPV,Cape Verde,KOR,Korea,2017,1,1,0
CPV,Cape Verde,LUX,Luxembourg,2008,189,52,137
CPV,Cape Verde,LUX,Luxembourg,2009,196,33,163
CPV,Cape Verde,LUX,Luxembourg,2010,158,32,126
CPV,Cape Verde,LUX,Luxembourg,2011,167,23,144
CPV,Cape Verde,LUX,Luxembourg,2012,161,36,125
CPV,Cape Verde,LUX,Luxembourg,2013,185,32,153
CPV,Cape Verde,LUX,Luxembourg,2014,168,22,146
CPV,Cape Verde,LUX,Luxembourg,2015,156,38,118
CPV,Cape Verde,LUX,Luxembourg,2016,156,35,121
CPV,Cape Verde,LUX,Luxembourg,2017,147,45,102
CPV,Cape Verde,MEX,Mexico,2012,0,0,0
CPV,Cape Verde,MEX,Mexico,2013,0,0,0
CPV,Cape Verde,MEX,Mexico,2014,0,0,0
CPV,Cape Verde,MEX,Mexico,2016,3,0,3
CPV,Cape Verde,NLD,Netherlands,2008,167,51,116
CPV,Cape Verde,NLD,Netherlands,2009,102,16,86
CPV,Cape Verde,NLD,Netherlands,2010,75,17,58
CPV,Cape Verde,NLD,Netherlands,2011,53,28,25
CPV,Cape Verde,NLD,Netherlands,2012,63,25,38
CPV,Cape Verde,NLD,Netherlands,2013,57,12,45
CPV,Cape Verde,NLD,Netherlands,2014,72,28,44
CPV,Cape Verde,NLD,Netherlands,2015,50,18,32
CPV,Cape Verde,NLD,Netherlands,2016,52,20,32
CPV,Cape Verde,NLD,Netherlands,2017,45,24,21
CPV,Cape Verde,NOR,Norway,2008,3,0,3
CPV,Cape Verde,NOR,Norway,2009,7,0,7
CPV,Cape Verde,NOR,Norway,2010,5,1,4
CPV,Cape Verde,NOR,Norway,2011,5,2,3
CPV,Cape Verde,NOR,Norway,2012,7,2,5
CPV,Cape Verde,NOR,Norway,2013,2,2,0
CPV,Cape Verde,NOR,Norway,2014,2,1,1
CPV,Cape Verde,NOR,Norway,2015,6,2,4
CPV,Cape Verde,NOR,Norway,2016,3,1,2
CPV,Cape Verde,NOR,Norway,2017,2,1,1
CPV,Cape Verde,POL,Poland,2009,10,0,10
CPV,Cape Verde,POL,Poland,2010,1,0,1
CPV,Cape Verde,POL,Poland,2011,0,0,0
CPV,Cape Verde,POL,Poland,2012,0,0,0
CPV,Cape Verde,POL,Poland,2013,0,0,0
CPV,Cape Verde,POL,Poland,2014,0,0,0
CPV,Cape Verde,POL,Poland,2015,0,0,0
CPV,Cape Verde,POL,Poland,2016,0,0,0
CPV,Cape Verde,POL,Poland,2017,0,0,0
CPV,Cape Verde,PRT,Portugal,2008,5260,0,5260
CPV,Cape Verde,PRT,Portugal,2009,4575,0,4575
CPV,Cape Verde,PRT,Portugal,2010,4223,0,4223
CPV,Cape Verde,PRT,Portugal,2011,4610,0,4610
CPV,Cape Verde,PRT,Portugal,2012,3431,0,3431
CPV,Cape Verde,PRT,Portugal,2013,2738,0,2738
CPV,Cape Verde,PRT,Portugal,2014,2185,0,2185
CPV,Cape Verde,PRT,Portugal,2015,2025,0,2025
CPV,Cape Verde,PRT,Portugal,2016,1991,0,1991
CPV,Cape Verde,PRT,Portugal,2017,2060,0,2060
CPV,Cape Verde,SVK,Slovak Republic,2008,0,0,0
CPV,Cape Verde,SVK,Slovak Republic,2011,1,0,1
CPV,Cape Verde,ESP,Spain,2008,445,181,264
CPV,Cape Verde,ESP,Spain,2009,320,155,165
CPV,Cape Verde,ESP,Spain,2010,183,162,21
CPV,Cape Verde,ESP,Spain,2011,203,159,44
CPV,Cape Verde,ESP,Spain,2012,140,105,35
CPV,Cape Verde,ESP,Spain,2013,149,125,24
CPV,Cape Verde,ESP,Spain,2014,138,83,55
CPV,Cape Verde,ESP,Spain,2015,157,103,54
CPV,Cape Verde,ESP,Spain,2016,139,123,16
CPV,Cape Verde,ESP,Spain,2017,136,139,-3
CPV,Cape Verde,SWE,Sweden,2008,5,1,4
CPV,Cape Verde,SWE,Sweden,2009,5,1,4
CPV,Cape Verde,SWE,Sweden,2010,9,0,9
CPV,Cape Verde,SWE,Sweden,2011,8,0,8
CPV,Cape Verde,SWE,Sweden,2012,11,0,11
CPV,Cape Verde,SWE,Sweden,2013,1,1,0
CPV,Cape Verde,SWE,Sweden,2014,7,1,6
CPV,Cape Verde,SWE,Sweden,2015,10,2,8
CPV,Cape Verde,SWE,Sweden,2016,4,1,3
CPV,Cape Verde,SWE,Sweden,2017,10,0,10
CPV,Cape Verde,CHE,Switzerland,2010,45,6,39
CPV,Cape Verde,CHE,Switzerland,2011,60,10,50
CPV,Cape Verde,CHE,Switzerland,2012,45,9,36
CPV,Cape Verde,CHE,Switzerland,2013,45,9,36
CPV,Cape Verde,CHE,Switzerland,2014,50,9,41
CPV,Cape Verde,CHE,Switzerland,2015,38,9,29
CPV,Cape Verde,CHE,Switzerland,2016,46,7,39
CPV,Cape Verde,CHE,Switzerland,2017,49,3,46
CPV,Cape Verde,USA,United States,2008,1916,0,1916
CPV,Cape Verde,USA,United States,2009,2238,0,2238
CPV,Cape Verde,USA,United States,2010,1668,0,1668
CPV,Cape Verde,USA,United States,2011,1808,0,1808
CPV,Cape Verde,USA,United States,2012,1684,0,1684
CPV,Cape Verde,USA,United States,2013,1673,0,1673
CPV,Cape Verde,USA,United States,2014,1154,0,1154
CPV,Cape Verde,USA,United States,2015,1253,0,1253
CPV,Cape Verde,USA,United States,2016,2242,0,2242
CPV,Cape Verde,USA,United States,2017,2618,0,2618
CPV,Cape Verde,CHL,Chile,2008,0,0,0
CPV,Cape Verde,CHL,Chile,2009,0,0,0
CPV,Cape Verde,CHL,Chile,2010,0,0,0
CPV,Cape Verde,CHL,Chile,2011,0,0,0
CPV,Cape Verde,CHL,Chile,2012,0,0,0
CPV,Cape Verde,CHL,Chile,2013,0,0,0
CPV,Cape Verde,CHL,Chile,2014,0,0,0
CPV,Cape Verde,CHL,Chile,2015,0,0,0
CPV,Cape Verde,CHL,Chile,2016,0,0,0
CPV,Cape Verde,EST,Estonia,2008,0,0,0
CPV,Cape Verde,EST,Estonia,2009,0,0,0
CPV,Cape Verde,EST,Estonia,2010,0,0,0
CPV,Cape Verde,EST,Estonia,2011,0,0,0
CPV,Cape Verde,EST,Estonia,2012,1,0,1
CPV,Cape Verde,EST,Estonia,2013,0,0,0
CPV,Cape Verde,EST,Estonia,2014,0,0,0
CPV,Cape Verde,EST,Estonia,2015,0,0,0
CPV,Cape Verde,EST,Estonia,2016,1,0,1
CPV,Cape Verde,EST,Estonia,2017,0,0,0
CPV,Cape Verde,SVN,Slovenia,2008,1,0,1
CPV,Cape Verde,SVN,Slovenia,2010,1,0,1
CPV,Cape Verde,SVN,Slovenia,2011,2,0,2
CPV,Cape Verde,SVN,Slovenia,2013,3,0,3
CAF,Central African Republic,AUS,Australia,2008,13,0,13
CAF,Central African Republic,AUS,Australia,2009,0,0,0
CAF,Central African Republic,AUS,Australia,2010,1,0,1
CAF,Central African Republic,AUS,Australia,2011,2,0,2
CAF,Central African Republic,AUS,Australia,2012,1,0,1
CAF,Central African Republic,AUS,Australia,2013,0,0,0
CAF,Central African Republic,AUS,Australia,2014,0,0,0
CAF,Central African Republic,AUS,Australia,2015,0,0,0
CAF,Central African Republic,AUS,Australia,2016,0,0,0
CAF,Central African Republic,AUS,Australia,2017,0,0,0
CAF,Central African Republic,AUT,Austria,2008,0,1,-1
CAF,Central African Republic,AUT,Austria,2009,1,1,0
CAF,Central African Republic,AUT,Austria,2010,1,1,0
CAF,Central African Republic,AUT,Austria,2011,0,1,-1
CAF,Central African Republic,AUT,Austria,2012,0,0,0
CAF,Central African Republic,AUT,Austria,2013,1,1,0
CAF,Central African Republic,AUT,Austria,2014,0,0,0
CAF,Central African Republic,AUT,Austria,2015,2,0,2
CAF,Central African Republic,AUT,Austria,2016,3,2,1
CAF,Central African Republic,AUT,Austria,2017,2,2,0
CAF,Central African Republic,BEL,Belgium,2008,7,0,7
CAF,Central African Republic,BEL,Belgium,2009,17,0,17
CAF,Central African Republic,BEL,Belgium,2010,15,7,8
CAF,Central African Republic,BEL,Belgium,2011,23,0,23
CAF,Central African Republic,BEL,Belgium,2012,19,6,13
CAF,Central African Republic,BEL,Belgium,2013,14,5,9
CAF,Central African Republic,BEL,Belgium,2014,56,6,50
CAF,Central African Republic,BEL,Belgium,2015,35,9,26
CAF,Central African Republic,BEL,Belgium,2016,37,5,32
CAF,Central African Republic,BEL,Belgium,2017,22,6,16
CAF,Central African Republic,CAN,Canada,2008,28,0,28
CAF,Central African Republic,CAN,Canada,2009,19,0,19
CAF,Central African Republic,CAN,Canada,2010,25,0,25
CAF,Central African Republic,CAN,Canada,2011,18,0,18
CAF,Central African Republic,CAN,Canada,2012,44,0,44
CAF,Central African Republic,CAN,Canada,2013,169,0,169
CAF,Central African Republic,CAN,Canada,2014,129,0,129
CAF,Central African Republic,CAN,Canada,2015,456,0,456
CAF,Central African Republic,CAN,Canada,2016,100,0,100
CAF,Central African Republic,CAN,Canada,2017,225,0,225
CAF,Central African Republic,DNK,Denmark,2008,0,0,0
CAF,Central African Republic,DNK,Denmark,2009,4,1,3
CAF,Central African Republic,DNK,Denmark,2012,0,0,0
CAF,Central African Republic,DNK,Denmark,2013,0,0,0
CAF,Central African Republic,DNK,Denmark,2014,12,0,12
CAF,Central African Republic,DNK,Denmark,2015,0,0,0
CAF,Central African Republic,DNK,Denmark,2016,9,0,9
CAF,Central African Republic,DNK,Denmark,2017,0,0,0
CAF,Central African Republic,FIN,Finland,2008,0,0,0
CAF,Central African Republic,FIN,Finland,2009,1,0,1
CAF,Central African Republic,FIN,Finland,2010,0,0,0
CAF,Central African Republic,FIN,Finland,2011,0,0,0
CAF,Central African Republic,FIN,Finland,2012,0,0,0
CAF,Central African Republic,FIN,Finland,2013,0,0,0
CAF,Central African Republic,FIN,Finland,2014,1,0,1
CAF,Central African Republic,FIN,Finland,2015,1,0,1
CAF,Central African Republic,FIN,Finland,2016,2,0,2
CAF,Central African Republic,FIN,Finland,2017,1,0,1
CAF,Central African Republic,FRA,France,2008,577,0,577
CAF,Central African Republic,FRA,France,2009,557,0,557
CAF,Central African Republic,FRA,France,2010,503,0,503
CAF,Central African Republic,FRA,France,2011,426,0,426
CAF,Central African Republic,FRA,France,2012,425,0,425
CAF,Central African Republic,FRA,France,2013,474,0,474
CAF,Central African Republic,FRA,France,2014,722,0,722
CAF,Central African Republic,FRA,France,2015,597,0,597
CAF,Central African Republic,FRA,France,2016,1004,0,1004
CAF,Central African Republic,FRA,France,2017,934,0,934
CAF,Central African Republic,DEU,Germany,2008,16,21,-5
CAF,Central African Republic,DEU,Germany,2009,18,43,-25
CAF,Central African Republic,DEU,Germany,2010,17,16,1
CAF,Central African Republic,DEU,Germany,2011,13,6,7
CAF,Central African Republic,DEU,Germany,2012,12,8,4
CAF,Central African Republic,DEU,Germany,2013,27,13,14
CAF,Central African Republic,DEU,Germany,2014,70,9,61
CAF,Central African Republic,DEU,Germany,2015,81,20,61
CAF,Central African Republic,DEU,Germany,2016,61,26,35
CAF,Central African Republic,DEU,Germany,2017,47,32,15
CAF,Central African Republic,HUN,Hungary,2008,0,0,0
CAF,Central African Republic,HUN,Hungary,2009,1,0,1
CAF,Central African Republic,HUN,Hungary,2010,0,0,0
CAF,Central African Republic,HUN,Hungary,2011,1,0,1
CAF,Central African Republic,HUN,Hungary,2012,0,0,0
CAF,Central African Republic,HUN,Hungary,2013,0,0,0
CAF,Central African Republic,HUN,Hungary,2014,1,0,1
CAF,Central African Republic,HUN,Hungary,2015,0,0,0
CAF,Central African Republic,HUN,Hungary,2016,8,0,8
CAF,Central African Republic,HUN,Hungary,2017,4,0,4
CAF,Central African Republic,ISL,Iceland,2016,0,0,0
CAF,Central African Republic,ISL,Iceland,2017,0,0,0
CAF,Central African Republic,ITA,Italy,2008,9,1,8
CAF,Central African Republic,ITA,Italy,2009,8,1,7
CAF,Central African Republic,ITA,Italy,2010,12,4,8
CAF,Central African Republic,ITA,Italy,2011,15,3,12
CAF,Central African Republic,ITA,Italy,2012,15,1,14
CAF,Central African Republic,ITA,Italy,2013,115,6,109
CAF,Central African Republic,ITA,Italy,2014,13,1,12
CAF,Central African Republic,ITA,Italy,2015,39,1,38
CAF,Central African Republic,ITA,Italy,2016,21,0,21
CAF,Central African Republic,ITA,Italy,2017,42,3,39
CAF,Central African Republic,JPN,Japan,2008,46,46,0
CAF,Central African Republic,JPN,Japan,2009,15,13,2
CAF,Central African Republic,JPN,Japan,2010,10,9,1
CAF,Central African Republic,JPN,Japan,2011,4,5,-1
CAF,Central African Republic,JPN,Japan,2012,15,15,0
CAF,Central African Republic,JPN,Japan,2013,2,2,0
CAF,Central African Republic,JPN,Japan,2014,4,1,3
CAF,Central African Republic,JPN,Japan,2015,4,3,1
CAF,Central African Republic,JPN,Japan,2016,2,2,0
CAF,Central African Republic,JPN,Japan,2017,5,3,2
CAF,Central African Republic,KOR,Korea,2008,0,1,-1
CAF,Central African Republic,KOR,Korea,2009,0,0,0
CAF,Central African Republic,KOR,Korea,2010,0,1,-1
CAF,Central African Republic,KOR,Korea,2011,3,1,2
CAF,Central African Republic,KOR,Korea,2012,8,5,3
CAF,Central African Republic,KOR,Korea,2013,1,1,0
CAF,Central African Republic,KOR,Korea,2014,1,0,1
CAF,Central African Republic,KOR,Korea,2015,3,1,2
CAF,Central African Republic,KOR,Korea,2016,1,3,-2
CAF,Central African Republic,KOR,Korea,2017,3,0,3
CAF,Central African Republic,LUX,Luxembourg,2008,1,0,1
CAF,Central African Republic,LUX,Luxembourg,2009,1,1,0
CAF,Central African Republic,LUX,Luxembourg,2010,0,0,0
CAF,Central African Republic,LUX,Luxembourg,2011,0,0,0
CAF,Central African Republic,LUX,Luxembourg,2012,0,1,-1
CAF,Central African Republic,LUX,Luxembourg,2013,0,0,0
CAF,Central African Republic,LUX,Luxembourg,2014,1,0,1
CAF,Central African Republic,LUX,Luxembourg,2015,4,0,4
CAF,Central African Republic,LUX,Luxembourg,2016,3,1,2
CAF,Central African Republic,LUX,Luxembourg,2017,0,0,0
CAF,Central African Republic,MEX,Mexico,2012,0,0,0
CAF,Central African Republic,MEX,Mexico,2013,0,0,0
CAF,Central African Republic,MEX,Mexico,2014,0,0,0
CAF,Central African Republic,MEX,Mexico,2015,1,0,1
CAF,Central African Republic,NLD,Netherlands,2009,1,0,1
CAF,Central African Republic,NLD,Netherlands,2010,1,0,1
CAF,Central African Republic,NLD,Netherlands,2013,1,0,1
CAF,Central African Republic,NLD,Netherlands,2014,3,0,3
CAF,Central African Republic,NLD,Netherlands,2015,3,0,3
CAF,Central African Republic,NLD,Netherlands,2016,4,2,2
CAF,Central African Republic,NLD,Netherlands,2017,7,0,7
CAF,Central African Republic,NOR,Norway,2008,3,0,3
CAF,Central African Republic,NOR,Norway,2009,0,0,0
CAF,Central African Republic,NOR,Norway,2010,0,0,0
CAF,Central African Republic,NOR,Norway,2011,0,1,-1
CAF,Central African Republic,NOR,Norway,2012,5,0,5
CAF,Central African Republic,NOR,Norway,2013,1,0,1
CAF,Central African Republic,NOR,Norway,2014,5,0,5
CAF,Central African Republic,NOR,Norway,2015,1,1,0
CAF,Central African Republic,NOR,Norway,2016,1,0,1
CAF,Central African Republic,NOR,Norway,2017,10,1,9
CAF,Central African Republic,POL,Poland,2009,0,0,0
CAF,Central African Republic,POL,Poland,2010,1,0,1
CAF,Central African Republic,POL,Poland,2011,1,0,1
CAF,Central African Republic,POL,Poland,2012,0,0,0
CAF,Central African Republic,POL,Poland,2013,1,0,1
CAF,Central African Republic,POL,Poland,2014,1,0,1
CAF,Central African Republic,POL,Poland,2015,0,0,0
CAF,Central African Republic,POL,Poland,2016,2,0,2
CAF,Central African Republic,POL,Poland,2017,0,0,0
CAF,Central African Republic,SVK,Slovak Republic,2008,0,0,0
CAF,Central African Republic,SVK,Slovak Republic,2009,2,0,2
CAF,Central African Republic,ESP,Spain,2008,7,3,4
CAF,Central African Republic,ESP,Spain,2009,17,4,13
CAF,Central African Republic,ESP,Spain,2010,7,10,-3
CAF,Central African Republic,ESP,Spain,2011,7,10,-3
CAF,Central African Republic,ESP,Spain,2012,17,5,12
CAF,Central African Republic,ESP,Spain,2013,20,4,16
CAF,Central African Republic,ESP,Spain,2014,20,3,17
CAF,Central African Republic,ESP,Spain,2015,25,4,21
CAF,Central African Republic,ESP,Spain,2016,58,5,53
CAF,Central African Republic,ESP,Spain,2017,36,10,26
CAF,Central African Republic,SWE,Sweden,2008,9,0,9
CAF,Central African Republic,SWE,Sweden,2009,4,0,4
CAF,Central African Republic,SWE,Sweden,2010,1,0,1
CAF,Central African Republic,SWE,Sweden,2011,11,2,9
CAF,Central African Republic,SWE,Sweden,2012,2,0,2
CAF,Central African Republic,SWE,Sweden,2013,14,0,14
CAF,Central African Republic,SWE,Sweden,2014,10,1,9
CAF,Central African Republic,SWE,Sweden,2015,1,0,1
CAF,Central African Republic,SWE,Sweden,2016,0,0,0
CAF,Central African Republic,SWE,Sweden,2017,8,0,8
CAF,Central African Republic,CHE,Switzerland,2010,2,1,1
CAF,Central African Republic,CHE,Switzerland,2011,4,4,0
CAF,Central African Republic,CHE,Switzerland,2012,1,1,0
CAF,Central African Republic,CHE,Switzerland,2013,4,4,0
CAF,Central African Republic,CHE,Switzerland,2014,3,1,2
CAF,Central African Republic,CHE,Switzerland,2015,3,1,2
CAF,Central African Republic,CHE,Switzerland,2016,5,0,5
CAF,Central African Republic,CHE,Switzerland,2017,4,2,2
CAF,Central African Republic,TUR,Turkey,2010,4,0,4
CAF,Central African Republic,USA,United States,2008,88,0,88
CAF,Central African Republic,USA,United States,2009,107,0,107
CAF,Central African Republic,USA,United States,2010,101,0,101
CAF,Central African Republic,USA,United States,2011,134,0,134
CAF,Central African Republic,USA,United States,2012,116,0,116
CAF,Central African Republic,USA,United States,2013,213,0,213
CAF,Central African Republic,USA,United States,2014,155,0,155
CAF,Central African Republic,USA,United States,2015,234,0,234
CAF,Central African Republic,USA,United States,2016,202,0,202
CAF,Central African Republic,USA,United States,2017,178,0,178
CAF,Central African Republic,CHL,Chile,2008,0,0,0
CAF,Central African Republic,CHL,Chile,2009,0,0,0
CAF,Central African Republic,CHL,Chile,2010,0,0,0
CAF,Central African Republic,CHL,Chile,2011,0,0,0
CAF,Central African Republic,CHL,Chile,2012,0,0,0
CAF,Central African Republic,CHL,Chile,2013,1,0,1
CAF,Central African Republic,CHL,Chile,2014,0,0,0
CAF,Central African Republic,CHL,Chile,2015,1,0,1
CAF,Central African Republic,CHL,Chile,2016,0,0,0
CAF,Central African Republic,EST,Estonia,2008,0,0,0
CAF,Central African Republic,EST,Estonia,2009,0,0,0
CAF,Central African Republic,EST,Estonia,2010,0,0,0
CAF,Central African Republic,EST,Estonia,2011,0,0,0
CAF,Central African Republic,EST,Estonia,2012,0,0,0
CAF,Central African Republic,EST,Estonia,2013,0,0,0
CAF,Central African Republic,EST,Estonia,2014,0,0,0
CAF,Central African Republic,EST,Estonia,2015,0,0,0
CAF,Central African Republic,EST,Estonia,2016,0,0,0
CAF,Central African Republic,EST,Estonia,2017,0,0,0
TCD,Chad,AUS,Australia,2008,4,0,4
TCD,Chad,AUS,Australia,2009,0,0,0
TCD,Chad,AUS,Australia,2010,5,0,5
TCD,Chad,AUS,Australia,2011,6,0,6
TCD,Chad,AUS,Australia,2012,7,0,7
TCD,Chad,AUS,Australia,2013,0,0,0
TCD,Chad,AUS,Australia,2014,0,0,0
TCD,Chad,AUS,Australia,2015,0,0,0
TCD,Chad,AUS,Australia,2016,0,0,0
TCD,Chad,AUS,Australia,2017,0,0,0
TCD,Chad,AUT,Austria,2008,1,1,0
TCD,Chad,AUT,Austria,2009,3,1,2
TCD,Chad,AUT,Austria,2010,1,2,-1
TCD,Chad,AUT,Austria,2011,5,0,5
TCD,Chad,AUT,Austria,2012,4,2,2
TCD,Chad,AUT,Austria,2013,4,2,2
TCD,Chad,AUT,Austria,2014,3,3,0
TCD,Chad,AUT,Austria,2015,6,2,4
TCD,Chad,AUT,Austria,2016,4,5,-1
TCD,Chad,AUT,Austria,2017,3,2,1
TCD,Chad,BEL,Belgium,2008,19,0,19
TCD,Chad,BEL,Belgium,2009,11,0,11
TCD,Chad,BEL,Belgium,2010,26,1,25
TCD,Chad,BEL,Belgium,2011,19,0,19
TCD,Chad,BEL,Belgium,2012,39,13,26
TCD,Chad,BEL,Belgium,2013,42,24,18
TCD,Chad,BEL,Belgium,2014,31,21,10
TCD,Chad,BEL,Belgium,2015,37,16,21
TCD,Chad,BEL,Belgium,2016,19,16,3
TCD,Chad,BEL,Belgium,2017,30,9,21
TCD,Chad,CAN,Canada,2008,95,0,95
TCD,Chad,CAN,Canada,2009,87,0,87
TCD,Chad,CAN,Canada,2010,98,0,98
TCD,Chad,CAN,Canada,2011,79,0,79
TCD,Chad,CAN,Canada,2012,97,0,97
TCD,Chad,CAN,Canada,2013,86,0,86
TCD,Chad,CAN,Canada,2014,82,0,82
TCD,Chad,CAN,Canada,2015,87,0,87
TCD,Chad,CAN,Canada,2016,100,0,100
TCD,Chad,CAN,Canada,2017,120,0,120
TCD,Chad,CZE,Czech Republic,2011,3,0,3
TCD,Chad,CZE,Czech Republic,2013,1,0,1
TCD,Chad,DNK,Denmark,2008,2,1,1
TCD,Chad,DNK,Denmark,2009,0,0,0
TCD,Chad,DNK,Denmark,2012,1,0,1
TCD,Chad,DNK,Denmark,2013,0,0,0
TCD,Chad,DNK,Denmark,2014,1,1,0
TCD,Chad,DNK,Denmark,2015,0,0,0
TCD,Chad,DNK,Denmark,2016,0,1,-1
TCD,Chad,DNK,Denmark,2017,0,0,0
TCD,Chad,FIN,Finland,2008,0,0,0
TCD,Chad,FIN,Finland,2009,0,0,0
TCD,Chad,FIN,Finland,2010,0,0,0
TCD,Chad,FIN,Finland,2011,0,0,0
TCD,Chad,FIN,Finland,2012,1,0,1
TCD,Chad,FIN,Finland,2013,0,0,0
TCD,Chad,FIN,Finland,2014,0,0,0
TCD,Chad,FIN,Finland,2015,1,0,1
TCD,Chad,FIN,Finland,2016,0,0,0
TCD,Chad,FIN,Finland,2017,0,0,0
TCD,Chad,FRA,France,2008,212,0,212
TCD,Chad,FRA,France,2009,233,0,233
TCD,Chad,FRA,France,2010,203,0,203
TCD,Chad,FRA,France,2011,180,0,180
TCD,Chad,FRA,France,2012,210,0,210
TCD,Chad,FRA,France,2013,194,0,194
TCD,Chad,FRA,France,2014,245,0,245
TCD,Chad,FRA,France,2015,187,0,187
TCD,Chad,FRA,France,2016,274,0,274
TCD,Chad,FRA,France,2017,308,0,308
TCD,Chad,DEU,Germany,2008,21,28,-7
TCD,Chad,DEU,Germany,2009,27,15,12
TCD,Chad,DEU,Germany,2010,36,19,17
TCD,Chad,DEU,Germany,2011,26,14,12
TCD,Chad,DEU,Germany,2012,82,28,54
TCD,Chad,DEU,Germany,2013,265,34,231
TCD,Chad,DEU,Germany,2014,178,76,102
TCD,Chad,DEU,Germany,2015,159,67,92
TCD,Chad,DEU,Germany,2016,180,119,61
TCD,Chad,DEU,Germany,2017,152,149,3
TCD,Chad,HUN,Hungary,2008,0,0,0
TCD,Chad,HUN,Hungary,2009,0,0,0
TCD,Chad,HUN,Hungary,2010,0,0,0
TCD,Chad,HUN,Hungary,2011,0,0,0
TCD,Chad,HUN,Hungary,2012,0,0,0
TCD,Chad,HUN,Hungary,2013,0,0,0
TCD,Chad,HUN,Hungary,2014,0,0,0
TCD,Chad,HUN,Hungary,2015,0,0,0
TCD,Chad,HUN,Hungary,2016,2,0,2
TCD,Chad,HUN,Hungary,2017,0,0,0
TCD,Chad,ISL,Iceland,2016,0,0,0
TCD,Chad,ISL,Iceland,2017,2,0,2
TCD,Chad,ITA,Italy,2008,23,0,23
TCD,Chad,ITA,Italy,2009,36,0,36
TCD,Chad,ITA,Italy,2010,13,0,13
TCD,Chad,ITA,Italy,2011,40,0,40
TCD,Chad,ITA,Italy,2012,266,0,266
TCD,Chad,ITA,Italy,2013,124,11,113
TCD,Chad,ITA,Italy,2014,20,0,20
TCD,Chad,ITA,Italy,2015,31,3,28
TCD,Chad,ITA,Italy,2016,57,0,57
TCD,Chad,ITA,Italy,2017,73,1,72
TCD,Chad,JPN,Japan,2008,4,4,0
TCD,Chad,JPN,Japan,2009,7,6,1
TCD,Chad,JPN,Japan,2010,11,11,0
TCD,Chad,JPN,Japan,2011,19,17,2
TCD,Chad,JPN,Japan,2012,28,28,0
TCD,Chad,JPN,Japan,2013,64,66,-2
TCD,Chad,JPN,Japan,2014,28,28,0
TCD,Chad,JPN,Japan,2015,23,23,0
TCD,Chad,JPN,Japan,2016,65,63,2
TCD,Chad,JPN,Japan,2017,22,19,3
TCD,Chad,KOR,Korea,2008,1,1,0
TCD,Chad,KOR,Korea,2009,1,0,1
TCD,Chad,KOR,Korea,2010,4,1,3
TCD,Chad,KOR,Korea,2011,3,0,3
TCD,Chad,KOR,Korea,2012,2,5,-3
TCD,Chad,KOR,Korea,2013,2,1,1
TCD,Chad,KOR,Korea,2014,1,3,-2
TCD,Chad,KOR,Korea,2015,1,2,-1
TCD,Chad,KOR,Korea,2016,1,0,1
TCD,Chad,KOR,Korea,2017,4,0,4
TCD,Chad,LUX,Luxembourg,2008,0,0,0
TCD,Chad,LUX,Luxembourg,2009,0,0,0
TCD,Chad,LUX,Luxembourg,2010,0,0,0
TCD,Chad,LUX,Luxembourg,2011,0,0,0
TCD,Chad,LUX,Luxembourg,2012,0,0,0
TCD,Chad,LUX,Luxembourg,2013,2,0,2
TCD,Chad,LUX,Luxembourg,2014,1,1,0
TCD,Chad,LUX,Luxembourg,2015,0,0,0
TCD,Chad,LUX,Luxembourg,2016,0,0,0
TCD,Chad,LUX,Luxembourg,2017,0,0,0
TCD,Chad,MEX,Mexico,2010,1,0,1
TCD,Chad,MEX,Mexico,2012,0,0,0
TCD,Chad,MEX,Mexico,2013,1,0,1
TCD,Chad,MEX,Mexico,2014,0,0,0
TCD,Chad,NLD,Netherlands,2011,1,1,0
TCD,Chad,NLD,Netherlands,2012,1,0,1
TCD,Chad,NLD,Netherlands,2013,3,1,2
TCD,Chad,NLD,Netherlands,2014,3,0,3
TCD,Chad,NLD,Netherlands,2015,2,3,-1
TCD,Chad,NLD,Netherlands,2016,4,-1,5
TCD,Chad,NLD,Netherlands,2017,2,2,0
TCD,Chad,NZL,New Zealand,2009,0,0,0
TCD,Chad,NZL,New Zealand,2014,1,0,1
TCD,Chad,NZL,New Zealand,2015,3,0,3
TCD,Chad,NOR,Norway,2008,0,0,0
TCD,Chad,NOR,Norway,2009,0,0,0
TCD,Chad,NOR,Norway,2010,5,0,5
TCD,Chad,NOR,Norway,2011,1,1,0
TCD,Chad,NOR,Norway,2012,1,0,1
TCD,Chad,NOR,Norway,2013,1,2,-1
TCD,Chad,NOR,Norway,2014,1,0,1
TCD,Chad,NOR,Norway,2015,1,0,1
TCD,Chad,NOR,Norway,2016,0,1,-1
TCD,Chad,NOR,Norway,2017,0,1,-1
TCD,Chad,POL,Poland,2009,1,0,1
TCD,Chad,POL,Poland,2010,2,0,2
TCD,Chad,POL,Poland,2011,1,0,1
TCD,Chad,POL,Poland,2012,3,0,3
TCD,Chad,POL,Poland,2013,2,0,2
TCD,Chad,POL,Poland,2014,1,0,1
TCD,Chad,POL,Poland,2015,0,0,0
TCD,Chad,POL,Poland,2016,2,0,2
TCD,Chad,POL,Poland,2017,1,0,1
TCD,Chad,SVK,Slovak Republic,2008,1,0,1
TCD,Chad,ESP,Spain,2008,9,5,4
TCD,Chad,ESP,Spain,2009,14,8,6
TCD,Chad,ESP,Spain,2010,14,6,8
TCD,Chad,ESP,Spain,2011,12,16,-4
TCD,Chad,ESP,Spain,2012,13,4,9
TCD,Chad,ESP,Spain,2013,26,6,20
TCD,Chad,ESP,Spain,2014,15,4,11
TCD,Chad,ESP,Spain,2015,13,11,2
TCD,Chad,ESP,Spain,2016,12,13,-1
TCD,Chad,ESP,Spain,2017,5,18,-13
TCD,Chad,SWE,Sweden,2008,4,0,4
TCD,Chad,SWE,Sweden,2009,6,1,5
TCD,Chad,SWE,Sweden,2010,2,0,2
TCD,Chad,SWE,Sweden,2011,2,0,2
TCD,Chad,SWE,Sweden,2012,6,0,6
TCD,Chad,SWE,Sweden,2013,0,0,0
TCD,Chad,SWE,Sweden,2014,2,0,2
TCD,Chad,SWE,Sweden,2015,5,0,5
TCD,Chad,SWE,Sweden,2016,9,0,9
TCD,Chad,SWE,Sweden,2017,6,0,6
TCD,Chad,CHE,Switzerland,2010,7,1,6
TCD,Chad,CHE,Switzerland,2011,1,1,0
TCD,Chad,CHE,Switzerland,2012,2,1,1
TCD,Chad,CHE,Switzerland,2013,12,2,10
TCD,Chad,CHE,Switzerland,2014,1,4,-3
TCD,Chad,CHE,Switzerland,2015,2,2,0
TCD,Chad,CHE,Switzerland,2016,2,1,1
TCD,Chad,CHE,Switzerland,2017,3,0,3
TCD,Chad,TUR,Turkey,2010,6,0,6
TCD,Chad,TUR,Turkey,2017,112,45,67
TCD,Chad,USA,United States,2008,96,0,96
TCD,Chad,USA,United States,2009,102,0,102
TCD,Chad,USA,United States,2010,120,0,120
TCD,Chad,USA,United States,2011,171,0,171
TCD,Chad,USA,United States,2012,155,0,155
TCD,Chad,USA,United States,2013,111,0,111
TCD,Chad,USA,United States,2014,119,0,119
TCD,Chad,USA,United States,2015,175,0,175
TCD,Chad,USA,United States,2016,136,0,136
TCD,Chad,USA,United States,2017,205,0,205
TCD,Chad,CHL,Chile,2008,0,0,0
TCD,Chad,CHL,Chile,2009,0,0,0
TCD,Chad,CHL,Chile,2010,0,0,0
TCD,Chad,CHL,Chile,2011,0,0,0
TCD,Chad,CHL,Chile,2012,0,0,0
TCD,Chad,CHL,Chile,2013,0,0,0
TCD,Chad,CHL,Chile,2014,0,0,0
TCD,Chad,CHL,Chile,2015,0,0,0
TCD,Chad,CHL,Chile,2016,0,0,0
TCD,Chad,EST,Estonia,2008,0,0,0
TCD,Chad,EST,Estonia,2009,0,0,0
TCD,Chad,EST,Estonia,2010,0,0,0
TCD,Chad,EST,Estonia,2011,0,0,0
TCD,Chad,EST,Estonia,2012,0,0,0
TCD,Chad,EST,Estonia,2013,0,0,0
TCD,Chad,EST,Estonia,2014,0,0,0
TCD,Chad,EST,Estonia,2015,0,0,0
TCD,Chad,EST,Estonia,2016,0,0,0
TCD,Chad,EST,Estonia,2017,0,0,0
TCD,Chad,SVN,Slovenia,2010,1,0,1
CHL,Chile,AUS,Australia,2008,181,128,53
CHL,Chile,AUS,Australia,2009,236,111,125
CHL,Chile,AUS,Australia,2010,240,124,116
CHL,Chile,AUS,Australia,2011,236,181,55
CHL,Chile,AUS,Australia,2012,234,183,51
CHL,Chile,AUS,Australia,2013,218,170,48
CHL,Chile,AUS,Australia,2014,270,147,123
CHL,Chile,AUS,Australia,2015,232,117,115
CHL,Chile,AUS,Australia,2016,236,67,169
CHL,Chile,AUS,Australia,2017,282,0,282
CHL,Chile,AUT,Austria,2008,62,20,42
CHL,Chile,AUT,Austria,2009,87,38,49
CHL,Chile,AUT,Austria,2010,75,27,48
CHL,Chile,AUT,Austria,2011,72,51,21
CHL,Chile,AUT,Austria,2012,84,34,50
CHL,Chile,AUT,Austria,2013,95,76,19
CHL,Chile,AUT,Austria,2014,102,94,8
CHL,Chile,AUT,Austria,2015,110,96,14
CHL,Chile,AUT,Austria,2016,90,30,60
CHL,Chile,AUT,Austria,2017,89,0,89
CHL,Chile,BEL,Belgium,2008,118,54,64
CHL,Chile,BEL,Belgium,2009,145,62,83
CHL,Chile,BEL,Belgium,2010,149,36,113
CHL,Chile,BEL,Belgium,2011,158,44,114
CHL,Chile,BEL,Belgium,2012,139,65,74
CHL,Chile,BEL,Belgium,2013,117,69,48
CHL,Chile,BEL,Belgium,2014,120,74,46
CHL,Chile,BEL,Belgium,2015,83,98,-15
CHL,Chile,BEL,Belgium,2016,126,40,86
CHL,Chile,BEL,Belgium,2017,120,0,120
CHL,Chile,CAN,Canada,2008,350,185,165
CHL,Chile,CAN,Canada,2009,375,170,205
CHL,Chile,CAN,Canada,2010,340,210,130
CHL,Chile,CAN,Canada,2011,174,241,-67
CHL,Chile,CAN,Canada,2012,291,284,7
CHL,Chile,CAN,Canada,2013,273,209,64
CHL,Chile,CAN,Canada,2014,299,196,103
CHL,Chile,CAN,Canada,2015,258,158,100
CHL,Chile,CAN,Canada,2016,245,129,116
CHL,Chile,CAN,Canada,2017,310,0,310
CHL,Chile,CZE,Czech Republic,2008,18,7,11
CHL,Chile,CZE,Czech Republic,2009,24,31,-7
CHL,Chile,CZE,Czech Republic,2010,19,92,-73
CHL,Chile,CZE,Czech Republic,2011,7,7,0
CHL,Chile,CZE,Czech Republic,2012,15,20,-5
CHL,Chile,CZE,Czech Republic,2013,10,58,-48
CHL,Chile,CZE,Czech Republic,2014,21,34,-13
CHL,Chile,CZE,Czech Republic,2015,20,36,-16
CHL,Chile,CZE,Czech Republic,2016,27,21,6
CHL,Chile,CZE,Czech Republic,2017,25,0,25
CHL,Chile,DNK,Denmark,2008,40,24,16
CHL,Chile,DNK,Denmark,2009,42,28,14
CHL,Chile,DNK,Denmark,2010,56,16,40
CHL,Chile,DNK,Denmark,2011,51,21,30
CHL,Chile,DNK,Denmark,2012,62,41,21
CHL,Chile,DNK,Denmark,2013,45,28,17
CHL,Chile,DNK,Denmark,2014,50,36,14
CHL,Chile,DNK,Denmark,2015,70,27,43
CHL,Chile,DNK,Denmark,2016,104,22,82
CHL,Chile,DNK,Denmark,2017,152,0,152
CHL,Chile,FIN,Finland,2008,22,20,2
CHL,Chile,FIN,Finland,2009,28,22,6
CHL,Chile,FIN,Finland,2010,23,26,-3
CHL,Chile,FIN,Finland,2011,22,23,-1
CHL,Chile,FIN,Finland,2012,18,32,-14
CHL,Chile,FIN,Finland,2013,21,41,-20
CHL,Chile,FIN,Finland,2014,14,42,-28
CHL,Chile,FIN,Finland,2015,30,15,15
CHL,Chile,FIN,Finland,2016,20,19,1
CHL,Chile,FIN,Finland,2017,37,0,37
CHL,Chile,FRA,France,2008,294,400,-106
CHL,Chile,FRA,France,2009,295,350,-55
CHL,Chile,FRA,France,2010,288,476,-188
CHL,Chile,FRA,France,2011,241,496,-255
CHL,Chile,FRA,France,2012,274,608,-334
CHL,Chile,FRA,France,2013,306,614,-308
CHL,Chile,FRA,France,2014,295,644,-349
CHL,Chile,FRA,France,2015,304,686,-382
CHL,Chile,FRA,France,2016,299,586,-287
CHL,Chile,FRA,France,2017,337,0,337
CHL,Chile,DEU,Germany,2008,868,346,522
CHL,Chile,DEU,Germany,2009,810,316,494
CHL,Chile,DEU,Germany,2010,931,341,590
CHL,Chile,DEU,Germany,2011,944,394,550
CHL,Chile,DEU,Germany,2012,945,374,571
CHL,Chile,DEU,Germany,2013,892,379,513
CHL,Chile,DEU,Germany,2014,997,517,480
CHL,Chile,DEU,Germany,2015,1389,420,969
CHL,Chile,DEU,Germany,2016,1515,262,1253
CHL,Chile,DEU,Germany,2017,1786,0,1786
CHL,Chile,HUN,Hungary,2008,6,4,2
CHL,Chile,HUN,Hungary,2009,7,14,-7
CHL,Chile,HUN,Hungary,2010,9,9,0
CHL,Chile,HUN,Hungary,2011,9,10,-1
CHL,Chile,HUN,Hungary,2012,8,12,-4
CHL,Chile,HUN,Hungary,2013,6,17,-11
CHL,Chile,HUN,Hungary,2014,8,53,-45
CHL,Chile,HUN,Hungary,2015,10,14,-4
CHL,Chile,HUN,Hungary,2016,12,6,6
CHL,Chile,HUN,Hungary,2017,34,0,34
CHL,Chile,ISL,Iceland,2008,2,2,0
CHL,Chile,ISL,Iceland,2009,2,5,-3
CHL,Chile,ISL,Iceland,2010,4,3,1
CHL,Chile,ISL,Iceland,2011,1,5,-4
CHL,Chile,ISL,Iceland,2012,2,1,1
CHL,Chile,ISL,Iceland,2013,0,1,-1
CHL,Chile,ISL,Iceland,2014,4,1,3
CHL,Chile,ISL,Iceland,2015,1,1,0
CHL,Chile,ISL,Iceland,2016,6,1,5
CHL,Chile,ISL,Iceland,2017,5,0,5
CHL,Chile,ITA,Italy,2008,339,170,169
CHL,Chile,ITA,Italy,2009,266,223,43
CHL,Chile,ITA,Italy,2010,332,446,-114
CHL,Chile,ITA,Italy,2011,285,311,-26
CHL,Chile,ITA,Italy,2012,247,307,-60
CHL,Chile,ITA,Italy,2013,234,472,-238
CHL,Chile,ITA,Italy,2014,196,429,-233
CHL,Chile,ITA,Italy,2015,189,427,-238
CHL,Chile,ITA,Italy,2016,162,416,-254
CHL,Chile,ITA,Italy,2017,201,0,201
CHL,Chile,JPN,Japan,2008,185,85,100
CHL,Chile,JPN,Japan,2009,172,107,65
CHL,Chile,JPN,Japan,2010,167,61,106
CHL,Chile,JPN,Japan,2011,139,75,64
CHL,Chile,JPN,Japan,2012,124,81,43
CHL,Chile,JPN,Japan,2013,146,60,86
CHL,Chile,JPN,Japan,2014,107,110,-3
CHL,Chile,JPN,Japan,2015,148,98,50
CHL,Chile,JPN,Japan,2016,136,93,43
CHL,Chile,JPN,Japan,2017,171,0,171
CHL,Chile,KOR,Korea,2008,32,176,-144
CHL,Chile,KOR,Korea,2009,46,202,-156
CHL,Chile,KOR,Korea,2010,49,400,-351
CHL,Chile,KOR,Korea,2011,45,332,-287
CHL,Chile,KOR,Korea,2012,42,221,-179
CHL,Chile,KOR,Korea,2013,39,153,-114
CHL,Chile,KOR,Korea,2014,68,227,-159
CHL,Chile,KOR,Korea,2015,53,382,-329
CHL,Chile,KOR,Korea,2016,50,241,-191
CHL,Chile,KOR,Korea,2017,79,0,79
CHL,Chile,LUX,Luxembourg,2008,4,1,3
CHL,Chile,LUX,Luxembourg,2009,1,1,0
CHL,Chile,LUX,Luxembourg,2010,12,0,12
CHL,Chile,LUX,Luxembourg,2011,3,0,3
CHL,Chile,LUX,Luxembourg,2012,4,0,4
CHL,Chile,LUX,Luxembourg,2013,6,0,6
CHL,Chile,LUX,Luxembourg,2014,7,2,5
CHL,Chile,LUX,Luxembourg,2015,10,3,7
CHL,Chile,LUX,Luxembourg,2016,11,0,11
CHL,Chile,LUX,Luxembourg,2017,8,0,8
CHL,Chile,MEX,Mexico,2008,251,513,-262
CHL,Chile,MEX,Mexico,2009,393,481,-88
CHL,Chile,MEX,Mexico,2010,426,507,-81
CHL,Chile,MEX,Mexico,2011,318,611,-293
CHL,Chile,MEX,Mexico,2012,256,796,-540
CHL,Chile,MEX,Mexico,2013,921,704,217
CHL,Chile,MEX,Mexico,2014,601,720,-119
CHL,Chile,MEX,Mexico,2015,432,750,-318
CHL,Chile,MEX,Mexico,2016,396,753,-357
CHL,Chile,MEX,Mexico,2017,329,0,329
CHL,Chile,NLD,Netherlands,2008,93,71,22
CHL,Chile,NLD,Netherlands,2009,122,69,53
CHL,Chile,NLD,Netherlands,2010,100,67,33
CHL,Chile,NLD,Netherlands,2011,147,53,94
CHL,Chile,NLD,Netherlands,2012,147,85,62
CHL,Chile,NLD,Netherlands,2013,132,76,56
CHL,Chile,NLD,Netherlands,2014,161,80,81
CHL,Chile,NLD,Netherlands,2015,205,75,130
CHL,Chile,NLD,Netherlands,2016,252,54,198
CHL,Chile,NLD,Netherlands,2017,266,0,266
CHL,Chile,NZL,New Zealand,2008,553,66,487
CHL,Chile,NZL,New Zealand,2009,505,50,455
CHL,Chile,NZL,New Zealand,2010,513,36,477
CHL,Chile,NZL,New Zealand,2011,515,41,474
CHL,Chile,NZL,New Zealand,2012,581,47,534
CHL,Chile,NZL,New Zealand,2013,616,48,568
CHL,Chile,NZL,New Zealand,2014,709,46,663
CHL,Chile,NZL,New Zealand,2015,762,39,723
CHL,Chile,NZL,New Zealand,2016,696,29,667
CHL,Chile,NZL,New Zealand,2017,712,0,712
CHL,Chile,NOR,Norway,2008,122,33,89
CHL,Chile,NOR,Norway,2009,136,20,116
CHL,Chile,NOR,Norway,2010,118,38,80
CHL,Chile,NOR,Norway,2011,109,59,50
CHL,Chile,NOR,Norway,2012,116,50,66
CHL,Chile,NOR,Norway,2013,94,33,61
CHL,Chile,NOR,Norway,2014,71,38,33
CHL,Chile,NOR,Norway,2015,78,31,47
CHL,Chile,NOR,Norway,2016,69,25,44
CHL,Chile,NOR,Norway,2017,72,0,72
CHL,Chile,POL,Poland,2009,18,32,-14
CHL,Chile,POL,Poland,2010,37,33,4
CHL,Chile,POL,Poland,2011,34,108,-74
CHL,Chile,POL,Poland,2012,29,36,-7
CHL,Chile,POL,Poland,2013,31,78,-47
CHL,Chile,POL,Poland,2014,20,58,-38
CHL,Chile,POL,Poland,2015,51,91,-40
CHL,Chile,POL,Poland,2016,46,61,-15
CHL,Chile,POL,Poland,2017,34,0,34
CHL,Chile,SVK,Slovak Republic,2008,1,3,-2
CHL,Chile,SVK,Slovak Republic,2009,1,6,-5
CHL,Chile,SVK,Slovak Republic,2010,4,25,-21
CHL,Chile,SVK,Slovak Republic,2012,2,12,-10
CHL,Chile,SVK,Slovak Republic,2013,1,89,-88
CHL,Chile,SVK,Slovak Republic,2015,1,6,-5
CHL,Chile,SVK,Slovak Republic,2016,1,11,-10
CHL,Chile,ESP,Spain,2008,5197,554,4643
CHL,Chile,ESP,Spain,2009,3060,580,2480
CHL,Chile,ESP,Spain,2010,2757,699,2058
CHL,Chile,ESP,Spain,2011,2669,950,1719
CHL,Chile,ESP,Spain,2012,2005,2068,-63
CHL,Chile,ESP,Spain,2013,1647,4109,-2462
CHL,Chile,ESP,Spain,2014,1885,3410,-1525
CHL,Chile,ESP,Spain,2015,2122,2519,-397
CHL,Chile,ESP,Spain,2016,2705,1860,845
CHL,Chile,ESP,Spain,2017,3452,0,3452
CHL,Chile,SWE,Sweden,2008,372,46,326
CHL,Chile,SWE,Sweden,2009,390,40,350
CHL,Chile,SWE,Sweden,2010,379,36,343
CHL,Chile,SWE,Sweden,2011,278,41,237
CHL,Chile,SWE,Sweden,2012,311,72,239
CHL,Chile,SWE,Sweden,2013,214,50,164
CHL,Chile,SWE,Sweden,2014,187,42,145
CHL,Chile,SWE,Sweden,2015,156,51,105
CHL,Chile,SWE,Sweden,2016,167,32,135
CHL,Chile,SWE,Sweden,2017,218,0,218
CHL,Chile,CHE,Switzerland,2010,230,44,186
CHL,Chile,CHE,Switzerland,2011,172,65,107
CHL,Chile,CHE,Switzerland,2012,175,65,110
CHL,Chile,CHE,Switzerland,2013,191,80,111
CHL,Chile,CHE,Switzerland,2014,168,74,94
CHL,Chile,CHE,Switzerland,2015,177,70,107
CHL,Chile,CHE,Switzerland,2016,167,44,123
CHL,Chile,CHE,Switzerland,2017,161,0,161
CHL,Chile,TUR,Turkey,2010,8,36,-28
CHL,Chile,GBR,United Kingdom,2011,1000,0,1000
CHL,Chile,GBR,United Kingdom,2012,1000,0,1000
CHL,Chile,GBR,United Kingdom,2014,2000,0,2000
CHL,Chile,USA,United States,2008,2017,1585,432
CHL,Chile,USA,United States,2009,2250,1660,590
CHL,Chile,USA,United States,2010,1950,2224,-274
CHL,Chile,USA,United States,2011,1853,2126,-273
CHL,Chile,USA,United States,2012,1673,2313,-640
CHL,Chile,USA,United States,2013,1736,2342,-606
CHL,Chile,USA,United States,2014,1581,2060,-479
CHL,Chile,USA,United States,2015,1596,1743,-147
CHL,Chile,USA,United States,2016,1698,1420,278
CHL,Chile,USA,United States,2017,1625,0,1625
CHL,Chile,CHL,Chile,2008,0,0,0
CHL,Chile,CHL,Chile,2009,0,0,0
CHL,Chile,CHL,Chile,2010,0,0,0
CHL,Chile,CHL,Chile,2011,0,0,0
CHL,Chile,CHL,Chile,2012,0,0,0
CHL,Chile,CHL,Chile,2013,0,0,0
CHL,Chile,CHL,Chile,2014,0,0,0
CHL,Chile,CHL,Chile,2015,0,0,0
CHL,Chile,CHL,Chile,2016,0,0,0
CHL,Chile,EST,Estonia,2008,2,1,1
CHL,Chile,EST,Estonia,2009,0,1,-1
CHL,Chile,EST,Estonia,2010,0,2,-2
CHL,Chile,EST,Estonia,2011,4,2,2
CHL,Chile,EST,Estonia,2012,1,0,1
CHL,Chile,EST,Estonia,2013,3,3,0
CHL,Chile,EST,Estonia,2014,0,5,-5
CHL,Chile,EST,Estonia,2015,3,8,-5
CHL,Chile,EST,Estonia,2016,5,0,5
CHL,Chile,EST,Estonia,2017,3,0,3
CHL,Chile,ISR,Israel,2008,71,32,39
CHL,Chile,ISR,Israel,2009,68,112,-44
CHL,Chile,ISR,Israel,2010,46,22,24
CHL,Chile,ISR,Israel,2011,40,26,14
CHL,Chile,ISR,Israel,2012,42,39,3
CHL,Chile,ISR,Israel,2013,52,18,34
CHL,Chile,ISR,Israel,2014,43,65,-22
CHL,Chile,ISR,Israel,2015,53,52,1
CHL,Chile,ISR,Israel,2016,54,24,30
CHL,Chile,ISR,Israel,2017,26,0,26
CHL,Chile,SVN,Slovenia,2008,2,2,0
CHL,Chile,SVN,Slovenia,2009,2,5,-3
CHL,Chile,SVN,Slovenia,2010,2,1,1
CHL,Chile,SVN,Slovenia,2011,1,11,-10
CHL,Chile,SVN,Slovenia,2012,1,8,-7
CHL,Chile,SVN,Slovenia,2013,1,7,-6
CHL,Chile,SVN,Slovenia,2015,2,7,-5
CHL,Chile,SVN,Slovenia,2017,4,0,4
CHN,China,AUS,Australia,2008,20694,2651,18043
CHN,China,AUS,Australia,2009,22297,2456,19841
CHN,China,AUS,Australia,2010,24525,3001,21524
CHN,China,AUS,Australia,2011,28718,3213,25505
CHN,China,AUS,Australia,2012,25308,2666,22642
CHN,China,AUS,Australia,2013,27898,2451,25447
CHN,China,AUS,Australia,2014,27122,2211,24911
CHN,China,AUS,Australia,2015,27924,2200,25724
CHN,China,AUS,Australia,2016,29077,2100,26977
CHN,China,AUS,Australia,2017,29277,0,29277
CHN,China,AUT,Austria,2008,1199,1102,97
CHN,China,AUT,Austria,2009,1379,1306,73
CHN,China,AUT,Austria,2010,1297,1376,-79
CHN,China,AUT,Austria,2011,1403,1222,181
CHN,China,AUT,Austria,2012,1521,1001,520
CHN,China,AUT,Austria,2013,1635,1069,566
CHN,China,AUT,Austria,2014,1800,1130,670
CHN,China,AUT,Austria,2015,2053,1202,851
CHN,China,AUT,Austria,2016,1947,1357,590
CHN,China,AUT,Austria,2017,1862,1581,281
CHN,China,BEL,Belgium,2008,1270,983,287
CHN,China,BEL,Belgium,2009,1344,951,393
CHN,China,BEL,Belgium,2010,1614,755,859
CHN,China,BEL,Belgium,2011,1577,957,620
CHN,China,BEL,Belgium,2012,1711,1004,707
CHN,China,BEL,Belgium,2013,1766,1015,751
CHN,China,BEL,Belgium,2014,1182,753,429
CHN,China,BEL,Belgium,2015,1236,762,474
CHN,China,BEL,Belgium,2016,1472,661,811
CHN,China,BEL,Belgium,2017,1346,604,742
CHN,China,CAN,Canada,2008,30030,0,30030
CHN,China,CAN,Canada,2009,29617,0,29617
CHN,China,CAN,Canada,2010,30378,0,30378
CHN,China,CAN,Canada,2011,28491,0,28491
CHN,China,CAN,Canada,2012,33009,0,33009
CHN,China,CAN,Canada,2013,34115,0,34115
CHN,China,CAN,Canada,2014,24626,0,24626
CHN,China,CAN,Canada,2015,19531,0,19531
CHN,China,CAN,Canada,2016,26855,0,26855
CHN,China,CAN,Canada,2017,30280,0,30280
CHN,China,CZE,Czech Republic,2008,940,5,935
CHN,China,CZE,Czech Republic,2009,592,2,590
CHN,China,CZE,Czech Republic,2010,459,6,453
CHN,China,CZE,Czech Republic,2011,325,2,323
CHN,China,CZE,Czech Republic,2012,400,251,149
CHN,China,CZE,Czech Republic,2013,376,454,-78
CHN,China,CZE,Czech Republic,2014,496,351,145
CHN,China,CZE,Czech Republic,2015,469,341,128
CHN,China,CZE,Czech Republic,2016,551,405,146
CHN,China,CZE,Czech Republic,2017,823,288,535
CHN,China,DNK,Denmark,2008,1272,776,496
CHN,China,DNK,Denmark,2009,950,942,8
CHN,China,DNK,Denmark,2010,791,1006,-215
CHN,China,DNK,Denmark,2011,777,951,-174
CHN,China,DNK,Denmark,2012,833,952,-119
CHN,China,DNK,Denmark,2013,1156,947,209
CHN,China,DNK,Denmark,2014,1164,1011,153
CHN,China,DNK,Denmark,2015,1288,1116,172
CHN,China,DNK,Denmark,2016,1375,1312,63
CHN,China,DNK,Denmark,2017,1225,1585,-360
CHN,China,FIN,Finland,2008,963,278,685
CHN,China,FIN,Finland,2009,771,195,576
CHN,China,FIN,Finland,2010,566,149,417
CHN,China,FIN,Finland,2011,763,135,628
CHN,China,FIN,Finland,2012,748,240,508
CHN,China,FIN,Finland,2013,807,224,583
CHN,China,FIN,Finland,2014,696,206,490
CHN,China,FIN,Finland,2015,732,233,499
CHN,China,FIN,Finland,2016,768,289,479
CHN,China,FIN,Finland,2017,711,267,444
CHN,China,FRA,France,2008,5241,0,5241
CHN,China,FRA,France,2009,5453,0,5453
CHN,China,FRA,France,2010,5720,0,5720
CHN,China,FRA,France,2011,5540,0,5540
CHN,China,FRA,France,2012,6256,0,6256
CHN,China,FRA,France,2013,7600,0,7600
CHN,China,FRA,France,2014,7596,0,7596
CHN,China,FRA,France,2015,4991,0,4991
CHN,China,FRA,France,2016,5309,0,5309
CHN,China,FRA,France,2017,4644,0,4644
CHN,China,DEU,Germany,2008,14293,13647,646
CHN,China,DEU,Germany,2009,15369,14762,607
CHN,China,DEU,Germany,2010,16248,14094,2154
CHN,China,DEU,Germany,2011,18276,12853,5423
CHN,China,DEU,Germany,2012,19740,12359,7381
CHN,China,DEU,Germany,2013,22350,14571,7779
CHN,China,DEU,Germany,2014,23163,14132,9031
CHN,China,DEU,Germany,2015,25511,15592,9919
CHN,China,DEU,Germany,2016,26632,17247,9385
CHN,China,DEU,Germany,2017,26590,17100,9490
CHN,China,HUN,Hungary,2008,1523,172,1351
CHN,China,HUN,Hungary,2009,1282,148,1134
CHN,China,HUN,Hungary,2010,1141,211,930
CHN,China,HUN,Hungary,2011,883,226,657
CHN,China,HUN,Hungary,2012,1137,224,913
CHN,China,HUN,Hungary,2013,2165,330,1835
CHN,China,HUN,Hungary,2014,4718,343,4375
CHN,China,HUN,Hungary,2015,3524,418,3106
CHN,China,HUN,Hungary,2016,1461,344,1117
CHN,China,HUN,Hungary,2017,2259,391,1868
CHN,China,ISL,Iceland,2008,69,214,-145
CHN,China,ISL,Iceland,2009,64,49,15
CHN,China,ISL,Iceland,2010,76,43,33
CHN,China,ISL,Iceland,2011,61,80,-19
CHN,China,ISL,Iceland,2012,50,19,31
CHN,China,ISL,Iceland,2013,36,50,-14
CHN,China,ISL,Iceland,2014,67,40,27
CHN,China,ISL,Iceland,2015,60,37,23
CHN,China,ISL,Iceland,2016,64,54,10
CHN,China,ISL,Iceland,2017,84,46,38
CHN,China,ITA,Italy,2008,12791,728,12063
CHN,China,ITA,Italy,2009,16843,879,15964
CHN,China,ITA,Italy,2010,22866,1517,21349
CHN,China,ITA,Italy,2011,20055,1672,18383
CHN,China,ITA,Italy,2012,20463,1773,18690
CHN,China,ITA,Italy,2013,17592,1943,15649
CHN,China,ITA,Italy,2014,15828,1987,13841
CHN,China,ITA,Italy,2015,14866,1799,13067
CHN,China,ITA,Italy,2016,12366,0,12366
CHN,China,ITA,Italy,2017,11253,1920,9333
CHN,China,JPN,Japan,2008,134178,71766,62412
CHN,China,JPN,Japan,2009,121227,79478,41749
CHN,China,JPN,Japan,2010,107930,81470,26460
CHN,China,JPN,Japan,2011,100358,84196,16162
CHN,China,JPN,Japan,2012,106957,65201,41756
CHN,China,JPN,Japan,2013,93003,64387,28616
CHN,China,JPN,Japan,2014,98630,65405,33225
CHN,China,JPN,Japan,2015,100571,64618,35953
CHN,China,JPN,Japan,2016,103294,58773,44521
CHN,China,JPN,Japan,2017,109763,61792,47971
CHN,China,KOR,Korea,2008,161734,99387,62347
CHN,China,KOR,Korea,2009,117563,121473,-3910
CHN,China,KOR,Korea,2010,155252,91351,63901
CHN,China,KOR,Korea,2011,149208,94714,54494
CHN,China,KOR,Korea,2012,127289,139657,-12368
CHN,China,KOR,Korea,2013,178606,131219,47387
CHN,China,KOR,Korea,2014,192858,135939,56919
CHN,China,KOR,Korea,2015,177001,135284,41717
CHN,China,KOR,Korea,2016,165494,147443,18051
CHN,China,KOR,Korea,2017,156848,156123,725
CHN,China,LUX,Luxembourg,2008,100,49,51
CHN,China,LUX,Luxembourg,2009,139,62,77
CHN,China,LUX,Luxembourg,2010,149,48,101
CHN,China,LUX,Luxembourg,2011,150,48,102
CHN,China,LUX,Luxembourg,2012,187,78,109
CHN,China,LUX,Luxembourg,2013,431,86,345
CHN,China,LUX,Luxembourg,2014,344,80,264
CHN,China,LUX,Luxembourg,2015,448,102,346
CHN,China,LUX,Luxembourg,2016,421,108,313
CHN,China,LUX,Luxembourg,2017,459,130,329
CHN,China,MEX,Mexico,2008,1327,0,1327
CHN,China,MEX,Mexico,2009,1958,0,1958
CHN,China,MEX,Mexico,2010,1736,0,1736
CHN,China,MEX,Mexico,2011,1149,0,1149
CHN,China,MEX,Mexico,2012,841,0,841
CHN,China,MEX,Mexico,2013,5222,0,5222
CHN,China,MEX,Mexico,2014,2619,0,2619
CHN,China,MEX,Mexico,2015,2226,0,2226
CHN,China,MEX,Mexico,2016,2127,0,2127
CHN,China,MEX,Mexico,2017,1454,0,1454
CHN,China,NLD,Netherlands,2008,4234,1861,2373
CHN,China,NLD,Netherlands,2009,4346,2076,2270
CHN,China,NLD,Netherlands,2010,4466,2547,1919
CHN,China,NLD,Netherlands,2011,5495,2801,2694
CHN,China,NLD,Netherlands,2012,5184,3065,2119
CHN,China,NLD,Netherlands,2013,4744,3293,1451
CHN,China,NLD,Netherlands,2014,4837,3609,1228
CHN,China,NLD,Netherlands,2015,5406,3600,1806
CHN,China,NLD,Netherlands,2016,5734,4011,1723
CHN,China,NLD,Netherlands,2017,6450,4218,2232
CHN,China,NZL,New Zealand,2008,4736,2157,2579
CHN,China,NZL,New Zealand,2009,5627,1995,3632
CHN,China,NZL,New Zealand,2010,5843,2374,3469
CHN,China,NZL,New Zealand,2011,7166,2433,4733
CHN,China,NZL,New Zealand,2012,7623,2279,5344
CHN,China,NZL,New Zealand,2013,7932,2223,5709
CHN,China,NZL,New Zealand,2014,9127,2099,7028
CHN,China,NZL,New Zealand,2015,10706,1930,8776
CHN,China,NZL,New Zealand,2016,12145,1955,10190
CHN,China,NZL,New Zealand,2017,12200,2552,9648
CHN,China,NOR,Norway,2008,837,314,523
CHN,China,NOR,Norway,2009,849,339,510
CHN,China,NOR,Norway,2010,955,490,465
CHN,China,NOR,Norway,2011,1103,644,459
CHN,China,NOR,Norway,2012,994,553,441
CHN,China,NOR,Norway,2013,930,567,363
CHN,China,NOR,Norway,2014,906,545,361
CHN,China,NOR,Norway,2015,903,555,348
CHN,China,NOR,Norway,2016,760,594,166
CHN,China,NOR,Norway,2017,748,391,357
CHN,China,POL,Poland,2008,1235,0,1235
CHN,China,POL,Poland,2009,2001,0,2001
CHN,China,POL,Poland,2010,2267,0,2267
CHN,China,POL,Poland,2011,2785,0,2785
CHN,China,POL,Poland,2012,2911,0,2911
CHN,China,POL,Poland,2013,2997,0,2997
CHN,China,POL,Poland,2014,1630,0,1630
CHN,China,POL,Poland,2015,3759,0,3759
CHN,China,POL,Poland,2016,3939,0,3939
CHN,China,POL,Poland,2017,4172,0,4172
CHN,China,PRT,Portugal,2008,2046,0,2046
CHN,China,PRT,Portugal,2009,1947,0,1947
CHN,China,PRT,Portugal,2010,1653,0,1653
CHN,China,PRT,Portugal,2011,1507,0,1507
CHN,China,PRT,Portugal,2012,1362,0,1362
CHN,China,PRT,Portugal,2013,1863,0,1863
CHN,China,PRT,Portugal,2014,3728,0,3728
CHN,China,PRT,Portugal,2015,2576,0,2576
CHN,China,PRT,Portugal,2016,2839,0,2839
CHN,China,PRT,Portugal,2017,2600,0,2600
CHN,China,SVK,Slovak Republic,2008,26,1,25
CHN,China,SVK,Slovak Republic,2009,19,3,16
CHN,China,SVK,Slovak Republic,2010,29,99,-70
CHN,China,SVK,Slovak Republic,2011,64,3,61
CHN,China,SVK,Slovak Republic,2012,71,0,71
CHN,China,SVK,Slovak Republic,2013,36,2,34
CHN,China,SVK,Slovak Republic,2014,24,3,21
CHN,China,SVK,Slovak Republic,2015,28,0,28
CHN,China,SVK,Slovak Republic,2016,18,0,18
CHN,China,SVK,Slovak Republic,2017,19,0,19
CHN,China,ESP,Spain,2008,20080,7042,13038
CHN,China,ESP,Spain,2009,11881,9205,2676
CHN,China,ESP,Spain,2010,10473,10442,31
CHN,China,ESP,Spain,2011,10706,13369,-2663
CHN,China,ESP,Spain,2012,9184,14096,-4912
CHN,China,ESP,Spain,2013,9127,15422,-6295
CHN,China,ESP,Spain,2014,9410,10365,-955
CHN,China,ESP,Spain,2015,10134,7560,2574
CHN,China,ESP,Spain,2016,10215,7291,2924
CHN,China,ESP,Spain,2017,11494,7860,3634
CHN,China,SWE,Sweden,2008,2677,532,2145
CHN,China,SWE,Sweden,2009,3098,376,2722
CHN,China,SWE,Sweden,2010,3186,549,2637
CHN,China,SWE,Sweden,2011,2619,1047,1572
CHN,China,SWE,Sweden,2012,2453,1379,1074
CHN,China,SWE,Sweden,2013,2075,1015,1060
CHN,China,SWE,Sweden,2014,2351,1681,670
CHN,China,SWE,Sweden,2015,2326,2712,-386
CHN,China,SWE,Sweden,2016,2180,1032,1148
CHN,China,SWE,Sweden,2017,2697,1039,1658
CHN,China,CHE,Switzerland,2010,1945,1253,692
CHN,China,CHE,Switzerland,2011,2136,1138,998
CHN,China,CHE,Switzerland,2012,2362,1309,1053
CHN,China,CHE,Switzerland,2013,2870,1591,1279
CHN,China,CHE,Switzerland,2014,2930,1706,1224
CHN,China,CHE,Switzerland,2015,3265,1899,1366
CHN,China,CHE,Switzerland,2016,3180,2236,944
CHN,China,CHE,Switzerland,2017,3138,2347,791
CHN,China,TUR,Turkey,2010,788,0,788
CHN,China,TUR,Turkey,2016,8281,3057,5224
CHN,China,TUR,Turkey,2017,5189,6322,-1133
CHN,China,GBR,United Kingdom,2008,18000,8000,10000
CHN,China,GBR,United Kingdom,2009,22000,10000,12000
CHN,China,GBR,United Kingdom,2010,28000,11000,17000
CHN,China,GBR,United Kingdom,2011,45000,11000,34000
CHN,China,GBR,United Kingdom,2012,41000,14000,27000
CHN,China,GBR,United Kingdom,2013,46000,14000,32000
CHN,China,GBR,United Kingdom,2014,39000,18000,21000
CHN,China,GBR,United Kingdom,2015,43000,12000,31000
CHN,China,GBR,United Kingdom,2016,35000,12000,23000
CHN,China,GBR,United Kingdom,2017,58000,15000,43000
CHN,China,USA,United States,2008,80271,0,80271
CHN,China,USA,United States,2009,64238,0,64238
CHN,China,USA,United States,2010,70863,0,70863
CHN,China,USA,United States,2011,87016,0,87016
CHN,China,USA,United States,2012,81784,0,81784
CHN,China,USA,United States,2013,71798,0,71798
CHN,China,USA,United States,2014,76089,0,76089
CHN,China,USA,United States,2015,74558,0,74558
CHN,China,USA,United States,2016,81772,0,81772
CHN,China,USA,United States,2017,71565,0,71565
CHN,China,CHL,Chile,2008,825,0,825
CHN,China,CHL,Chile,2009,867,0,867
CHN,China,CHL,Chile,2010,822,0,822
CHN,China,CHL,Chile,2011,1015,0,1015
CHN,China,CHL,Chile,2012,1042,0,1042
CHN,China,CHL,Chile,2013,1093,0,1093
CHN,China,CHL,Chile,2014,1401,0,1401
CHN,China,CHL,Chile,2015,1703,0,1703
CHN,China,CHL,Chile,2016,1682,0,1682
CHN,China,EST,Estonia,2008,43,0,43
CHN,China,EST,Estonia,2009,87,0,87
CHN,China,EST,Estonia,2010,26,0,26
CHN,China,EST,Estonia,2011,32,0,32
CHN,China,EST,Estonia,2012,22,0,22
CHN,China,EST,Estonia,2013,50,0,50
CHN,China,EST,Estonia,2014,12,0,12
CHN,China,EST,Estonia,2015,55,0,55
CHN,China,EST,Estonia,2016,59,0,59
CHN,China,EST,Estonia,2017,66,0,66
CHN,China,SVN,Slovenia,2008,198,0,198
CHN,China,SVN,Slovenia,2009,395,0,395
CHN,China,SVN,Slovenia,2010,164,0,164
CHN,China,SVN,Slovenia,2011,167,33,134
CHN,China,SVN,Slovenia,2012,119,26,93
CHN,China,SVN,Slovenia,2013,105,9,96
CHN,China,SVN,Slovenia,2014,119,4,115
CHN,China,SVN,Slovenia,2015,143,18,125
CHN,China,SVN,Slovenia,2016,124,17,107
CHN,China,SVN,Slovenia,2017,158,17,141
COL,Colombia,AUS,Australia,2008,467,62,405
COL,Colombia,AUS,Australia,2009,515,79,436
COL,Colombia,AUS,Australia,2010,768,79,689
COL,Colombia,AUS,Australia,2011,765,97,668
COL,Colombia,AUS,Australia,2012,930,114,816
COL,Colombia,AUS,Australia,2013,1136,131,1005
COL,Colombia,AUS,Australia,2014,982,160,822
COL,Colombia,AUS,Australia,2015,939,100,839
COL,Colombia,AUS,Australia,2016,1006,200,806
COL,Colombia,AUS,Australia,2017,1066,0,1066
COL,Colombia,AUT,Austria,2008,106,46,60
COL,Colombia,AUT,Austria,2009,104,59,45
COL,Colombia,AUT,Austria,2010,92,65,27
COL,Colombia,AUT,Austria,2011,119,77,42
COL,Colombia,AUT,Austria,2012,148,97,51
COL,Colombia,AUT,Austria,2013,147,83,64
COL,Colombia,AUT,Austria,2014,134,97,37
COL,Colombia,AUT,Austria,2015,158,67,91
COL,Colombia,AUT,Austria,2016,200,102,98
COL,Colombia,AUT,Austria,2017,227,129,98
COL,Colombia,BEL,Belgium,2008,257,0,257
COL,Colombia,BEL,Belgium,2009,237,0,237
COL,Colombia,BEL,Belgium,2010,357,119,238
COL,Colombia,BEL,Belgium,2011,322,124,198
COL,Colombia,BEL,Belgium,2012,317,159,158
COL,Colombia,BEL,Belgium,2013,289,182,107
COL,Colombia,BEL,Belgium,2014,232,112,120
COL,Colombia,BEL,Belgium,2015,242,118,124
COL,Colombia,BEL,Belgium,2016,282,119,163
COL,Colombia,BEL,Belgium,2017,360,105,255
COL,Colombia,CAN,Canada,2008,5449,0,5449
COL,Colombia,CAN,Canada,2009,4652,0,4652
COL,Colombia,CAN,Canada,2010,5218,0,5218
COL,Colombia,CAN,Canada,2011,4366,0,4366
COL,Colombia,CAN,Canada,2012,3736,0,3736
COL,Colombia,CAN,Canada,2013,3632,0,3632
COL,Colombia,CAN,Canada,2014,2859,0,2859
COL,Colombia,CAN,Canada,2015,2181,0,2181
COL,Colombia,CAN,Canada,2016,2440,0,2440
COL,Colombia,CAN,Canada,2017,2230,0,2230
COL,Colombia,CZE,Czech Republic,2008,20,1,19
COL,Colombia,CZE,Czech Republic,2009,25,0,25
COL,Colombia,CZE,Czech Republic,2010,27,0,27
COL,Colombia,CZE,Czech Republic,2011,30,0,30
COL,Colombia,CZE,Czech Republic,2012,27,10,17
COL,Colombia,CZE,Czech Republic,2013,33,16,17
COL,Colombia,CZE,Czech Republic,2014,45,25,20
COL,Colombia,CZE,Czech Republic,2015,29,23,6
COL,Colombia,CZE,Czech Republic,2016,28,24,4
COL,Colombia,CZE,Czech Republic,2017,59,15,44
COL,Colombia,DNK,Denmark,2008,72,20,52
COL,Colombia,DNK,Denmark,2009,57,30,27
COL,Colombia,DNK,Denmark,2010,63,45,18
COL,Colombia,DNK,Denmark,2011,46,39,7
COL,Colombia,DNK,Denmark,2012,61,51,10
COL,Colombia,DNK,Denmark,2013,273,57,216
COL,Colombia,DNK,Denmark,2014,149,56,93
COL,Colombia,DNK,Denmark,2015,75,56,19
COL,Colombia,DNK,Denmark,2016,87,91,-4
COL,Colombia,DNK,Denmark,2017,98,138,-40
COL,Colombia,FIN,Finland,2008,29,8,21
COL,Colombia,FIN,Finland,2009,20,8,12
COL,Colombia,FIN,Finland,2010,24,3,21
COL,Colombia,FIN,Finland,2011,28,1,27
COL,Colombia,FIN,Finland,2012,50,9,41
COL,Colombia,FIN,Finland,2013,33,9,24
COL,Colombia,FIN,Finland,2014,36,2,34
COL,Colombia,FIN,Finland,2015,35,10,25
COL,Colombia,FIN,Finland,2016,44,3,41
COL,Colombia,FIN,Finland,2017,27,11,16
COL,Colombia,FRA,France,2008,907,0,907
COL,Colombia,FRA,France,2009,955,0,955
COL,Colombia,FRA,France,2010,989,0,989
COL,Colombia,FRA,France,2011,1043,0,1043
COL,Colombia,FRA,France,2012,1030,0,1030
COL,Colombia,FRA,France,2013,1046,0,1046
COL,Colombia,FRA,France,2014,977,0,977
COL,Colombia,FRA,France,2015,778,0,778
COL,Colombia,FRA,France,2016,693,0,693
COL,Colombia,FRA,France,2017,842,0,842
COL,Colombia,DEU,Germany,2008,1707,1407,300
COL,Colombia,DEU,Germany,2009,1902,1500,402
COL,Colombia,DEU,Germany,2010,1954,1487,467
COL,Colombia,DEU,Germany,2011,2358,1411,947
COL,Colombia,DEU,Germany,2012,2561,1450,1111
COL,Colombia,DEU,Germany,2013,2790,1716,1074
COL,Colombia,DEU,Germany,2014,2672,1797,875
COL,Colombia,DEU,Germany,2015,2751,1786,965
COL,Colombia,DEU,Germany,2016,3225,1980,1245
COL,Colombia,DEU,Germany,2017,3424,1694,1730
COL,Colombia,HUN,Hungary,2008,34,0,34
COL,Colombia,HUN,Hungary,2009,22,0,22
COL,Colombia,HUN,Hungary,2010,36,3,33
COL,Colombia,HUN,Hungary,2011,26,1,25
COL,Colombia,HUN,Hungary,2012,17,1,16
COL,Colombia,HUN,Hungary,2013,19,3,16
COL,Colombia,HUN,Hungary,2014,28,4,24
COL,Colombia,HUN,Hungary,2015,30,2,28
COL,Colombia,HUN,Hungary,2016,34,1,33
COL,Colombia,HUN,Hungary,2017,73,0,73
COL,Colombia,ISL,Iceland,2008,5,8,-3
COL,Colombia,ISL,Iceland,2009,9,4,5
COL,Colombia,ISL,Iceland,2010,6,2,4
COL,Colombia,ISL,Iceland,2011,4,2,2
COL,Colombia,ISL,Iceland,2012,11,3,8
COL,Colombia,ISL,Iceland,2013,8,4,4
COL,Colombia,ISL,Iceland,2014,8,4,4
COL,Colombia,ISL,Iceland,2015,7,5,2
COL,Colombia,ISL,Iceland,2016,16,2,14
COL,Colombia,ISL,Iceland,2017,10,11,-1
COL,Colombia,ITA,Italy,2008,2160,163,1997
COL,Colombia,ITA,Italy,2009,2068,201,1867
COL,Colombia,ITA,Italy,2010,2132,145,1987
COL,Colombia,ITA,Italy,2011,1772,182,1590
COL,Colombia,ITA,Italy,2012,1525,214,1311
COL,Colombia,ITA,Italy,2013,1178,182,996
COL,Colombia,ITA,Italy,2014,854,221,633
COL,Colombia,ITA,Italy,2015,773,185,588
COL,Colombia,ITA,Italy,2016,841,0,841
COL,Colombia,ITA,Italy,2017,1056,153,903
COL,Colombia,JPN,Japan,2008,329,246,83
COL,Colombia,JPN,Japan,2009,355,310,45
COL,Colombia,JPN,Japan,2010,370,355,15
COL,Colombia,JPN,Japan,2011,414,373,41
COL,Colombia,JPN,Japan,2012,388,340,48
COL,Colombia,JPN,Japan,2013,356,304,52
COL,Colombia,JPN,Japan,2014,388,332,56
COL,Colombia,JPN,Japan,2015,364,287,77
COL,Colombia,JPN,Japan,2016,432,322,110
COL,Colombia,JPN,Japan,2017,324,237,87
COL,Colombia,KOR,Korea,2008,88,74,14
COL,Colombia,KOR,Korea,2009,91,80,11
COL,Colombia,KOR,Korea,2010,106,98,8
COL,Colombia,KOR,Korea,2011,104,88,16
COL,Colombia,KOR,Korea,2012,121,114,7
COL,Colombia,KOR,Korea,2013,117,98,19
COL,Colombia,KOR,Korea,2014,153,154,-1
COL,Colombia,KOR,Korea,2015,107,118,-11
COL,Colombia,KOR,Korea,2016,120,112,8
COL,Colombia,KOR,Korea,2017,132,138,-6
COL,Colombia,LUX,Luxembourg,2008,9,1,8
COL,Colombia,LUX,Luxembourg,2009,14,3,11
COL,Colombia,LUX,Luxembourg,2010,10,1,9
COL,Colombia,LUX,Luxembourg,2011,9,1,8
COL,Colombia,LUX,Luxembourg,2012,21,4,17
COL,Colombia,LUX,Luxembourg,2013,21,3,18
COL,Colombia,LUX,Luxembourg,2014,17,0,17
COL,Colombia,LUX,Luxembourg,2015,19,8,11
COL,Colombia,LUX,Luxembourg,2016,22,8,14
COL,Colombia,LUX,Luxembourg,2017,44,10,34
COL,Colombia,MEX,Mexico,2008,1051,0,1051
COL,Colombia,MEX,Mexico,2009,1898,0,1898
COL,Colombia,MEX,Mexico,2010,2312,0,2312
COL,Colombia,MEX,Mexico,2011,1806,0,1806
COL,Colombia,MEX,Mexico,2012,1411,0,1411
COL,Colombia,MEX,Mexico,2013,3186,0,3186
COL,Colombia,MEX,Mexico,2014,2488,0,2488
COL,Colombia,MEX,Mexico,2015,2050,0,2050
COL,Colombia,MEX,Mexico,2016,2197,0,2197
COL,Colombia,MEX,Mexico,2017,2162,0,2162
COL,Colombia,NLD,Netherlands,2008,364,172,192
COL,Colombia,NLD,Netherlands,2009,445,184,261
COL,Colombia,NLD,Netherlands,2010,458,238,220
COL,Colombia,NLD,Netherlands,2011,450,276,174
COL,Colombia,NLD,Netherlands,2012,411,258,153
COL,Colombia,NLD,Netherlands,2013,484,332,152
COL,Colombia,NLD,Netherlands,2014,416,288,128
COL,Colombia,NLD,Netherlands,2015,438,304,134
COL,Colombia,NLD,Netherlands,2016,514,283,231
COL,Colombia,NLD,Netherlands,2017,587,376,211
COL,Colombia,NZL,New Zealand,2008,75,16,59
COL,Colombia,NZL,New Zealand,2009,94,26,68
COL,Colombia,NZL,New Zealand,2010,130,31,99
COL,Colombia,NZL,New Zealand,2011,162,20,142
COL,Colombia,NZL,New Zealand,2012,123,36,87
COL,Colombia,NZL,New Zealand,2013,109,25,84
COL,Colombia,NZL,New Zealand,2014,257,40,217
COL,Colombia,NZL,New Zealand,2015,189,40,149
COL,Colombia,NZL,New Zealand,2016,195,40,155
COL,Colombia,NZL,New Zealand,2017,288,80,208
COL,Colombia,NOR,Norway,2008,105,17,88
COL,Colombia,NOR,Norway,2009,58,34,24
COL,Colombia,NOR,Norway,2010,75,36,39
COL,Colombia,NOR,Norway,2011,126,37,89
COL,Colombia,NOR,Norway,2012,144,46,98
COL,Colombia,NOR,Norway,2013,154,41,113
COL,Colombia,NOR,Norway,2014,99,36,63
COL,Colombia,NOR,Norway,2015,76,44,32
COL,Colombia,NOR,Norway,2016,116,57,59
COL,Colombia,NOR,Norway,2017,106,34,72
COL,Colombia,POL,Poland,2008,61,0,61
COL,Colombia,POL,Poland,2009,49,0,49
COL,Colombia,POL,Poland,2010,57,0,57
COL,Colombia,POL,Poland,2011,68,0,68
COL,Colombia,POL,Poland,2012,77,0,77
COL,Colombia,POL,Poland,2013,71,0,71
COL,Colombia,POL,Poland,2014,32,0,32
COL,Colombia,POL,Poland,2015,83,0,83
COL,Colombia,POL,Poland,2016,66,0,66
COL,Colombia,POL,Poland,2017,96,0,96
COL,Colombia,SVK,Slovak Republic,2008,2,0,2
COL,Colombia,SVK,Slovak Republic,2009,3,3,0
COL,Colombia,SVK,Slovak Republic,2010,7,2,5
COL,Colombia,SVK,Slovak Republic,2011,1,1,0
COL,Colombia,SVK,Slovak Republic,2012,1,0,1
COL,Colombia,SVK,Slovak Republic,2013,1,0,1
COL,Colombia,SVK,Slovak Republic,2014,1,0,1
COL,Colombia,SVK,Slovak Republic,2016,1,0,1
COL,Colombia,SVK,Slovak Republic,2017,1,0,1
COL,Colombia,ESP,Spain,2008,36040,9824,26216
COL,Colombia,ESP,Spain,2009,20409,13448,6961
COL,Colombia,ESP,Spain,2010,13664,14633,-969
COL,Colombia,ESP,Spain,2011,13161,15787,-2626
COL,Colombia,ESP,Spain,2012,9955,16763,-6808
COL,Colombia,ESP,Spain,2013,8688,19426,-10738
COL,Colombia,ESP,Spain,2014,8451,11152,-2701
COL,Colombia,ESP,Spain,2015,9368,7273,2095
COL,Colombia,ESP,Spain,2016,22594,6274,16320
COL,Colombia,ESP,Spain,2017,34210,7879,26331
COL,Colombia,SWE,Sweden,2008,297,53,244
COL,Colombia,SWE,Sweden,2009,246,37,209
COL,Colombia,SWE,Sweden,2010,269,32,237
COL,Colombia,SWE,Sweden,2011,224,55,169
COL,Colombia,SWE,Sweden,2012,304,56,248
COL,Colombia,SWE,Sweden,2013,396,48,348
COL,Colombia,SWE,Sweden,2014,204,61,143
COL,Colombia,SWE,Sweden,2015,284,107,177
COL,Colombia,SWE,Sweden,2016,172,59,113
COL,Colombia,SWE,Sweden,2017,235,40,195
COL,Colombia,CHE,Switzerland,2010,499,161,338
COL,Colombia,CHE,Switzerland,2011,459,195,264
COL,Colombia,CHE,Switzerland,2012,462,202,260
COL,Colombia,CHE,Switzerland,2013,464,205,259
COL,Colombia,CHE,Switzerland,2014,424,160,264
COL,Colombia,CHE,Switzerland,2015,419,199,220
COL,Colombia,CHE,Switzerland,2016,414,180,234
COL,Colombia,CHE,Switzerland,2017,476,179,297
COL,Colombia,TUR,Turkey,2010,30,0,30
COL,Colombia,TUR,Turkey,2016,144,114,30
COL,Colombia,TUR,Turkey,2017,157,110,47
COL,Colombia,GBR,United Kingdom,2011,2000,1000,1000
COL,Colombia,GBR,United Kingdom,2014,1000,0,1000
COL,Colombia,GBR,United Kingdom,2015,1000,0,1000
COL,Colombia,USA,United States,2008,30213,0,30213
COL,Colombia,USA,United States,2009,27849,0,27849
COL,Colombia,USA,United States,2010,22406,0,22406
COL,Colombia,USA,United States,2011,22635,0,22635
COL,Colombia,USA,United States,2012,20931,0,20931
COL,Colombia,USA,United States,2013,21131,0,21131
COL,Colombia,USA,United States,2014,18175,0,18175
COL,Colombia,USA,United States,2015,17316,0,17316
COL,Colombia,USA,United States,2016,18610,0,18610
COL,Colombia,USA,United States,2017,17956,0,17956
COL,Colombia,CHL,Chile,2008,3155,0,3155
COL,Colombia,CHL,Chile,2009,4143,0,4143
COL,Colombia,CHL,Chile,2010,5469,0,5469
COL,Colombia,CHL,Chile,2011,9423,0,9423
COL,Colombia,CHL,Chile,2012,12123,0,12123
COL,Colombia,CHL,Chile,2013,16680,0,16680
COL,Colombia,CHL,Chile,2014,15387,0,15387
COL,Colombia,CHL,Chile,2015,19523,0,19523
COL,Colombia,CHL,Chile,2016,26870,0,26870
COL,Colombia,EST,Estonia,2008,2,0,2
COL,Colombia,EST,Estonia,2009,4,0,4
COL,Colombia,EST,Estonia,2010,1,0,1
COL,Colombia,EST,Estonia,2011,0,0,0
COL,Colombia,EST,Estonia,2012,1,0,1
COL,Colombia,EST,Estonia,2013,3,0,3
COL,Colombia,EST,Estonia,2014,1,0,1
COL,Colombia,EST,Estonia,2015,11,0,11
COL,Colombia,EST,Estonia,2016,5,0,5
COL,Colombia,EST,Estonia,2017,9,0,9
COL,Colombia,ISR,Israel,2008,55,0,55
COL,Colombia,ISR,Israel,2009,52,0,52
COL,Colombia,ISR,Israel,2010,47,0,47
COL,Colombia,ISR,Israel,2011,90,0,90
COL,Colombia,ISR,Israel,2012,44,0,44
COL,Colombia,ISR,Israel,2013,62,0,62
COL,Colombia,ISR,Israel,2014,55,0,55
COL,Colombia,ISR,Israel,2015,98,0,98
COL,Colombia,ISR,Israel,2016,81,0,81
COL,Colombia,ISR,Israel,2017,74,0,74
COL,Colombia,SVN,Slovenia,2008,7,0,7
COL,Colombia,SVN,Slovenia,2009,8,0,8
COL,Colombia,SVN,Slovenia,2010,11,0,11
COL,Colombia,SVN,Slovenia,2011,16,6,10
COL,Colombia,SVN,Slovenia,2012,2,1,1
COL,Colombia,SVN,Slovenia,2013,1,0,1
COL,Colombia,SVN,Slovenia,2014,1,0,1
COL,Colombia,SVN,Slovenia,2015,7,0,7
COL,Colombia,SVN,Slovenia,2016,2,0,2
COL,Colombia,SVN,Slovenia,2017,14,0,14
COM,Comoros,AUS,Australia,2008,0,0,0
COM,Comoros,AUS,Australia,2009,0,0,0
COM,Comoros,AUS,Australia,2010,1,0,1
COM,Comoros,AUS,Australia,2011,1,0,1
COM,Comoros,AUS,Australia,2012,0,0,0
COM,Comoros,AUS,Australia,2013,1,0,1
COM,Comoros,AUS,Australia,2014,0,0,0
COM,Comoros,AUS,Australia,2015,0,0,0
COM,Comoros,AUS,Australia,2017,0,0,0
COM,Comoros,AUT,Austria,2008,0,0,0
COM,Comoros,AUT,Austria,2009,0,0,0
COM,Comoros,AUT,Austria,2010,0,0,0
COM,Comoros,AUT,Austria,2011,1,0,1
COM,Comoros,AUT,Austria,2012,0,0,0
COM,Comoros,AUT,Austria,2013,1,0,1
COM,Comoros,AUT,Austria,2014,2,0,2
COM,Comoros,AUT,Austria,2015,2,2,0
COM,Comoros,AUT,Austria,2016,1,1,0
COM,Comoros,AUT,Austria,2017,0,0,0
COM,Comoros,BEL,Belgium,2008,1,0,1
COM,Comoros,BEL,Belgium,2009,2,0,2
COM,Comoros,BEL,Belgium,2010,6,0,6
COM,Comoros,BEL,Belgium,2012,4,1,3
COM,Comoros,BEL,Belgium,2013,1,3,-2
COM,Comoros,BEL,Belgium,2014,9,1,8
COM,Comoros,BEL,Belgium,2015,3,2,1
COM,Comoros,BEL,Belgium,2016,3,4,-1
COM,Comoros,BEL,Belgium,2017,6,2,4
COM,Comoros,CAN,Canada,2008,3,0,3
COM,Comoros,CAN,Canada,2009,19,0,19
COM,Comoros,CAN,Canada,2010,22,0,22
COM,Comoros,CAN,Canada,2011,14,0,14
COM,Comoros,CAN,Canada,2012,18,0,18
COM,Comoros,CAN,Canada,2013,22,0,22
COM,Comoros,CAN,Canada,2014,8,0,8
COM,Comoros,CAN,Canada,2015,11,0,11
COM,Comoros,CAN,Canada,2016,10,0,10
COM,Comoros,CAN,Canada,2017,10,0,10
COM,Comoros,DNK,Denmark,2008,3,0,3
COM,Comoros,DNK,Denmark,2009,0,0,0
COM,Comoros,DNK,Denmark,2012,0,0,0
COM,Comoros,DNK,Denmark,2013,0,0,0
COM,Comoros,DNK,Denmark,2014,0,0,0
COM,Comoros,DNK,Denmark,2015,1,0,1
COM,Comoros,DNK,Denmark,2016,1,0,1
COM,Comoros,DNK,Denmark,2017,0,0,0
COM,Comoros,FIN,Finland,2008,0,0,0
COM,Comoros,FIN,Finland,2009,0,0,0
COM,Comoros,FIN,Finland,2010,0,0,0
COM,Comoros,FIN,Finland,2011,0,0,0
COM,Comoros,FIN,Finland,2012,0,0,0
COM,Comoros,FIN,Finland,2013,0,0,0
COM,Comoros,FIN,Finland,2014,0,0,0
COM,Comoros,FIN,Finland,2015,0,0,0
COM,Comoros,FIN,Finland,2016,0,0,0
COM,Comoros,FIN,Finland,2017,0,0,0
COM,Comoros,FRA,France,2008,3075,0,3075
COM,Comoros,FRA,France,2009,3307,0,3307
COM,Comoros,FRA,France,2010,2875,0,2875
COM,Comoros,FRA,France,2011,2502,0,2502
COM,Comoros,FRA,France,2012,3067,0,3067
COM,Comoros,FRA,France,2013,4845,0,4845
COM,Comoros,FRA,France,2014,5633,0,5633
COM,Comoros,FRA,France,2015,7342,0,7342
COM,Comoros,FRA,France,2016,3869,0,3869
COM,Comoros,FRA,France,2017,4159,0,4159
COM,Comoros,DEU,Germany,2008,6,4,2
COM,Comoros,DEU,Germany,2009,8,10,-2
COM,Comoros,DEU,Germany,2010,11,4,7
COM,Comoros,DEU,Germany,2011,4,3,1
COM,Comoros,DEU,Germany,2012,2,1,1
COM,Comoros,DEU,Germany,2013,23,21,2
COM,Comoros,DEU,Germany,2014,23,9,14
COM,Comoros,DEU,Germany,2015,37,6,31
COM,Comoros,DEU,Germany,2016,25,21,4
COM,Comoros,DEU,Germany,2017,18,22,-4
COM,Comoros,HUN,Hungary,2008,0,0,0
COM,Comoros,HUN,Hungary,2009,0,0,0
COM,Comoros,HUN,Hungary,2010,0,0,0
COM,Comoros,HUN,Hungary,2011,0,0,0
COM,Comoros,HUN,Hungary,2012,0,0,0
COM,Comoros,HUN,Hungary,2013,0,0,0
COM,Comoros,HUN,Hungary,2014,0,0,0
COM,Comoros,HUN,Hungary,2015,2,0,2
COM,Comoros,HUN,Hungary,2016,6,0,6
COM,Comoros,HUN,Hungary,2017,4,0,4
COM,Comoros,ISL,Iceland,2008,0,0,0
COM,Comoros,ISL,Iceland,2009,0,0,0
COM,Comoros,ISL,Iceland,2010,1,1,0
COM,Comoros,ISL,Iceland,2011,0,0,0
COM,Comoros,ISL,Iceland,2012,0,0,0
COM,Comoros,ISL,Iceland,2013,0,0,0
COM,Comoros,ISL,Iceland,2014,0,0,0
COM,Comoros,ISL,Iceland,2015,1,1,0
COM,Comoros,ISL,Iceland,2016,0,0,0
COM,Comoros,ISL,Iceland,2017,0,0,0
COM,Comoros,ITA,Italy,2008,3,0,3
COM,Comoros,ITA,Italy,2009,2,0,2
COM,Comoros,ITA,Italy,2010,0,0,0
COM,Comoros,ITA,Italy,2011,2,1,1
COM,Comoros,ITA,Italy,2012,4,0,4
COM,Comoros,ITA,Italy,2013,1,0,1
COM,Comoros,ITA,Italy,2014,17,1,16
COM,Comoros,ITA,Italy,2015,0,0,0
COM,Comoros,ITA,Italy,2016,2,0,2
COM,Comoros,ITA,Italy,2017,1,0,1
COM,Comoros,JPN,Japan,2008,9,9,0
COM,Comoros,JPN,Japan,2009,6,6,0
COM,Comoros,JPN,Japan,2010,8,8,0
COM,Comoros,JPN,Japan,2011,8,7,1
COM,Comoros,JPN,Japan,2012,27,27,0
COM,Comoros,JPN,Japan,2013,33,34,-1
COM,Comoros,JPN,Japan,2014,24,24,0
COM,Comoros,JPN,Japan,2015,12,10,2
COM,Comoros,JPN,Japan,2016,12,12,0
COM,Comoros,JPN,Japan,2017,21,18,3
COM,Comoros,KOR,Korea,2008,0,0,0
COM,Comoros,KOR,Korea,2009,0,0,0
COM,Comoros,KOR,Korea,2010,0,0,0
COM,Comoros,KOR,Korea,2011,0,0,0
COM,Comoros,KOR,Korea,2012,1,2,-1
COM,Comoros,KOR,Korea,2013,1,0,1
COM,Comoros,KOR,Korea,2014,4,2,2
COM,Comoros,KOR,Korea,2015,4,6,-2
COM,Comoros,KOR,Korea,2016,5,1,4
COM,Comoros,KOR,Korea,2017,2,2,0
COM,Comoros,LUX,Luxembourg,2008,1,0,1
COM,Comoros,LUX,Luxembourg,2009,0,1,-1
COM,Comoros,LUX,Luxembourg,2010,1,0,1
COM,Comoros,LUX,Luxembourg,2011,1,0,1
COM,Comoros,LUX,Luxembourg,2012,1,0,1
COM,Comoros,LUX,Luxembourg,2013,0,1,-1
COM,Comoros,LUX,Luxembourg,2014,1,0,1
COM,Comoros,LUX,Luxembourg,2015,1,0,1
COM,Comoros,LUX,Luxembourg,2016,1,0,1
COM,Comoros,LUX,Luxembourg,2017,3,0,3
COM,Comoros,MEX,Mexico,2012,0,0,0
COM,Comoros,MEX,Mexico,2013,0,0,0
COM,Comoros,MEX,Mexico,2014,0,0,0
COM,Comoros,NLD,Netherlands,2009,1,0,1
COM,Comoros,NLD,Netherlands,2016,1,0,1
COM,Comoros,NLD,Netherlands,2017,1,0,1
COM,Comoros,NOR,Norway,2008,0,0,0
COM,Comoros,NOR,Norway,2009,0,0,0
COM,Comoros,NOR,Norway,2010,0,0,0
COM,Comoros,NOR,Norway,2011,0,0,0
COM,Comoros,NOR,Norway,2012,0,0,0
COM,Comoros,NOR,Norway,2013,0,0,0
COM,Comoros,NOR,Norway,2014,0,0,0
COM,Comoros,NOR,Norway,2015,0,0,0
COM,Comoros,NOR,Norway,2016,0,0,0
COM,Comoros,NOR,Norway,2017,0,0,0
COM,Comoros,POL,Poland,2009,0,0,0
COM,Comoros,POL,Poland,2010,1,0,1
COM,Comoros,POL,Poland,2011,0,0,0
COM,Comoros,POL,Poland,2012,1,0,1
COM,Comoros,POL,Poland,2013,1,0,1
COM,Comoros,POL,Poland,2014,4,0,4
COM,Comoros,POL,Poland,2015,0,0,0
COM,Comoros,POL,Poland,2016,2,0,2
COM,Comoros,POL,Poland,2017,0,0,0
COM,Comoros,SVK,Slovak Republic,2008,0,0,0
COM,Comoros,SVK,Slovak Republic,2010,10,0,10
COM,Comoros,ESP,Spain,2008,0,1,-1
COM,Comoros,ESP,Spain,2009,1,0,1
COM,Comoros,ESP,Spain,2010,3,0,3
COM,Comoros,ESP,Spain,2011,0,0,0
COM,Comoros,ESP,Spain,2012,1,1,0
COM,Comoros,ESP,Spain,2013,5,0,5
COM,Comoros,ESP,Spain,2014,1,1,0
COM,Comoros,ESP,Spain,2015,1,1,0
COM,Comoros,ESP,Spain,2016,4,0,4
COM,Comoros,ESP,Spain,2017,1,0,1
COM,Comoros,SWE,Sweden,2008,0,0,0
COM,Comoros,SWE,Sweden,2009,0,0,0
COM,Comoros,SWE,Sweden,2010,1,0,1
COM,Comoros,SWE,Sweden,2011,0,0,0
COM,Comoros,SWE,Sweden,2012,0,0,0
COM,Comoros,SWE,Sweden,2013,4,0,4
COM,Comoros,SWE,Sweden,2014,0,0,0
COM,Comoros,SWE,Sweden,2015,1,0,1
COM,Comoros,SWE,Sweden,2016,0,0,0
COM,Comoros,SWE,Sweden,2017,0,0,0
COM,Comoros,CHE,Switzerland,2010,0,0,0
COM,Comoros,CHE,Switzerland,2011,1,0,1
COM,Comoros,CHE,Switzerland,2012,2,1,1
COM,Comoros,CHE,Switzerland,2013,0,0,0
COM,Comoros,CHE,Switzerland,2015,3,0,3
COM,Comoros,CHE,Switzerland,2016,3,0,3
COM,Comoros,CHE,Switzerland,2017,0,1,-1
COM,Comoros,USA,United States,2008,3,0,3
COM,Comoros,USA,United States,2009,3,0,3
COM,Comoros,USA,United States,2010,4,0,4
COM,Comoros,USA,United States,2011,8,0,8
COM,Comoros,USA,United States,2012,10,0,10
COM,Comoros,USA,United States,2013,3,0,3
COM,Comoros,USA,United States,2014,9,0,9
COM,Comoros,USA,United States,2015,5,0,5
COM,Comoros,USA,United States,2016,4,0,4
COM,Comoros,USA,United States,2017,4,0,4
COM,Comoros,CHL,Chile,2008,0,0,0
COM,Comoros,CHL,Chile,2009,0,0,0
COM,Comoros,CHL,Chile,2010,0,0,0
COM,Comoros,CHL,Chile,2011,0,0,0
COM,Comoros,CHL,Chile,2012,1,0,1
COM,Comoros,CHL,Chile,2013,0,0,0
COM,Comoros,CHL,Chile,2014,0,0,0
COM,Comoros,CHL,Chile,2015,0,0,0
COM,Comoros,CHL,Chile,2016,0,0,0
COM,Comoros,EST,Estonia,2008,0,0,0
COM,Comoros,EST,Estonia,2009,0,0,0
COM,Comoros,EST,Estonia,2010,0,0,0
COM,Comoros,EST,Estonia,2011,0,0,0
COM,Comoros,EST,Estonia,2012,0,0,0
COM,Comoros,EST,Estonia,2013,0,0,0
COM,Comoros,EST,Estonia,2014,0,0,0
COM,Comoros,EST,Estonia,2015,0,0,0
COM,Comoros,EST,Estonia,2016,0,0,0
COM,Comoros,EST,Estonia,2017,0,0,0
COM,Comoros,SVN,Slovenia,2009,1,0,1
COG,Congo,AUS,Australia,2008,113,0,113
COG,Congo,AUS,Australia,2009,127,5,122
COG,Congo,AUS,Australia,2010,138,0,138
COG,Congo,AUS,Australia,2011,110,5,105
COG,Congo,AUS,Australia,2012,209,0,209
COG,Congo,AUS,Australia,2013,51,0,51
COG,Congo,AUS,Australia,2014,33,5,28
COG,Congo,AUS,Australia,2015,41,0,41
COG,Congo,AUS,Australia,2016,10,0,10
COG,Congo,AUS,Australia,2017,44,0,44
COG,Congo,AUT,Austria,2008,28,16,12
COG,Congo,AUT,Austria,2009,42,7,35
COG,Congo,AUT,Austria,2010,34,12,22
COG,Congo,AUT,Austria,2011,44,17,27
COG,Congo,AUT,Austria,2012,35,8,27
COG,Congo,AUT,Austria,2013,34,14,20
COG,Congo,AUT,Austria,2014,39,14,25
COG,Congo,AUT,Austria,2015,50,8,42
COG,Congo,AUT,Austria,2016,46,17,29
COG,Congo,AUT,Austria,2017,45,26,19
COG,Congo,BEL,Belgium,2008,74,0,74
COG,Congo,BEL,Belgium,2009,79,0,79
COG,Congo,BEL,Belgium,2010,68,28,40
COG,Congo,BEL,Belgium,2011,71,0,71
COG,Congo,BEL,Belgium,2012,81,39,42
COG,Congo,BEL,Belgium,2013,51,44,7
COG,Congo,BEL,Belgium,2014,31,43,-12
COG,Congo,BEL,Belgium,2015,30,46,-16
COG,Congo,BEL,Belgium,2016,51,22,29
COG,Congo,BEL,Belgium,2017,45,19,26
COG,Congo,CAN,Canada,2008,72,0,72
COG,Congo,CAN,Canada,2009,69,0,69
COG,Congo,CAN,Canada,2010,75,0,75
COG,Congo,CAN,Canada,2011,81,0,81
COG,Congo,CAN,Canada,2012,91,0,91
COG,Congo,CAN,Canada,2013,114,0,114
COG,Congo,CAN,Canada,2014,84,0,84
COG,Congo,CAN,Canada,2015,131,0,131
COG,Congo,CAN,Canada,2016,140,0,140
COG,Congo,CAN,Canada,2017,130,0,130
COG,Congo,CZE,Czech Republic,2008,6,0,6
COG,Congo,CZE,Czech Republic,2009,3,0,3
COG,Congo,CZE,Czech Republic,2010,9,0,9
COG,Congo,CZE,Czech Republic,2011,4,0,4
COG,Congo,CZE,Czech Republic,2012,2,0,2
COG,Congo,CZE,Czech Republic,2013,4,0,4
COG,Congo,CZE,Czech Republic,2014,2,0,2
COG,Congo,CZE,Czech Republic,2015,3,0,3
COG,Congo,CZE,Czech Republic,2016,2,0,2
COG,Congo,DNK,Denmark,2008,60,8,52
COG,Congo,DNK,Denmark,2009,32,8,24
COG,Congo,DNK,Denmark,2010,61,2,59
COG,Congo,DNK,Denmark,2011,43,13,30
COG,Congo,DNK,Denmark,2012,21,4,17
COG,Congo,DNK,Denmark,2013,9,9,0
COG,Congo,DNK,Denmark,2014,8,0,8
COG,Congo,DNK,Denmark,2015,23,1,22
COG,Congo,DNK,Denmark,2016,7,2,5
COG,Congo,DNK,Denmark,2017,6,9,-3
COG,Congo,FIN,Finland,2008,4,1,3
COG,Congo,FIN,Finland,2009,11,0,11
COG,Congo,FIN,Finland,2010,15,2,13
COG,Congo,FIN,Finland,2011,8,0,8
COG,Congo,FIN,Finland,2012,3,0,3
COG,Congo,FIN,Finland,2013,13,0,13
COG,Congo,FIN,Finland,2014,2,0,2
COG,Congo,FIN,Finland,2015,3,0,3
COG,Congo,FIN,Finland,2016,1,1,0
COG,Congo,FIN,Finland,2017,1,0,1
COG,Congo,FRA,France,2008,2211,0,2211
COG,Congo,FRA,France,2009,2321,0,2321
COG,Congo,FRA,France,2010,2229,0,2229
COG,Congo,FRA,France,2011,2146,0,2146
COG,Congo,FRA,France,2012,2194,0,2194
COG,Congo,FRA,France,2013,2251,0,2251
COG,Congo,FRA,France,2014,2175,0,2175
COG,Congo,FRA,France,2015,2015,0,2015
COG,Congo,FRA,France,2016,1967,0,1967
COG,Congo,FRA,France,2017,2020,0,2020
COG,Congo,DEU,Germany,2008,270,337,-67
COG,Congo,DEU,Germany,2009,265,325,-60
COG,Congo,DEU,Germany,2010,289,320,-31
COG,Congo,DEU,Germany,2011,258,253,5
COG,Congo,DEU,Germany,2012,310,257,53
COG,Congo,DEU,Germany,2013,199,123,76
COG,Congo,DEU,Germany,2014,243,142,101
COG,Congo,DEU,Germany,2015,268,143,125
COG,Congo,DEU,Germany,2016,207,149,58
COG,Congo,DEU,Germany,2017,175,127,48
COG,Congo,HUN,Hungary,2008,2,0,2
COG,Congo,HUN,Hungary,2009,2,0,2
COG,Congo,HUN,Hungary,2010,1,0,1
COG,Congo,HUN,Hungary,2011,0,0,0
COG,Congo,HUN,Hungary,2012,3,0,3
COG,Congo,HUN,Hungary,2013,8,0,8
COG,Congo,HUN,Hungary,2014,1,0,1
COG,Congo,HUN,Hungary,2015,5,0,5
COG,Congo,HUN,Hungary,2016,5,0,5
COG,Congo,HUN,Hungary,2017,6,0,6
COG,Congo,ISL,Iceland,2008,0,0,0
COG,Congo,ISL,Iceland,2009,1,0,1
COG,Congo,ISL,Iceland,2010,0,1,-1
COG,Congo,ISL,Iceland,2011,0,0,0
COG,Congo,ISL,Iceland,2012,0,0,0
COG,Congo,ISL,Iceland,2013,0,0,0
COG,Congo,ISL,Iceland,2014,0,0,0
COG,Congo,ISL,Iceland,2015,1,1,0
COG,Congo,ISL,Iceland,2016,0,0,0
COG,Congo,ISL,Iceland,2017,0,0,0
COG,Congo,ITA,Italy,2008,352,41,311
COG,Congo,ITA,Italy,2009,371,47,324
COG,Congo,ITA,Italy,2010,367,14,353
COG,Congo,ITA,Italy,2011,260,26,234
COG,Congo,ITA,Italy,2012,335,33,302
COG,Congo,ITA,Italy,2013,194,15,179
COG,Congo,ITA,Italy,2014,211,31,180
COG,Congo,ITA,Italy,2015,210,31,179
COG,Congo,ITA,Italy,2016,297,0,297
COG,Congo,ITA,Italy,2017,241,17,224
COG,Congo,JPN,Japan,2008,100,200,-100
COG,Congo,JPN,Japan,2009,10,19,-9
COG,Congo,JPN,Japan,2010,16,32,-16
COG,Congo,JPN,Japan,2011,19,28,-9
COG,Congo,JPN,Japan,2012,30,26,4
COG,Congo,JPN,Japan,2013,30,25,5
COG,Congo,JPN,Japan,2014,23,23,0
COG,Congo,JPN,Japan,2015,16,17,-1
COG,Congo,JPN,Japan,2016,22,21,1
COG,Congo,JPN,Japan,2017,25,12,13
COG,Congo,KOR,Korea,2008,5,4,1
COG,Congo,KOR,Korea,2009,6,9,-3
COG,Congo,KOR,Korea,2010,5,3,2
COG,Congo,KOR,Korea,2011,8,5,3
COG,Congo,KOR,Korea,2012,1,5,-4
COG,Congo,KOR,Korea,2013,5,3,2
COG,Congo,KOR,Korea,2014,33,8,25
COG,Congo,KOR,Korea,2015,9,22,-13
COG,Congo,KOR,Korea,2016,4,32,-28
COG,Congo,KOR,Korea,2017,2,2,0
COG,Congo,LUX,Luxembourg,2008,6,4,2
COG,Congo,LUX,Luxembourg,2009,8,3,5
COG,Congo,LUX,Luxembourg,2010,6,3,3
COG,Congo,LUX,Luxembourg,2011,6,1,5
COG,Congo,LUX,Luxembourg,2012,3,2,1
COG,Congo,LUX,Luxembourg,2013,5,3,2
COG,Congo,LUX,Luxembourg,2014,3,4,-1
COG,Congo,LUX,Luxembourg,2015,4,2,2
COG,Congo,LUX,Luxembourg,2016,2,2,0
COG,Congo,LUX,Luxembourg,2017,3,1,2
COG,Congo,MEX,Mexico,2008,7,0,7
COG,Congo,MEX,Mexico,2009,8,0,8
COG,Congo,MEX,Mexico,2010,4,0,4
COG,Congo,MEX,Mexico,2011,14,0,14
COG,Congo,MEX,Mexico,2012,8,0,8
COG,Congo,MEX,Mexico,2013,19,0,19
COG,Congo,MEX,Mexico,2014,11,0,11
COG,Congo,MEX,Mexico,2015,7,0,7
COG,Congo,MEX,Mexico,2016,7,0,7
COG,Congo,MEX,Mexico,2017,2,0,2
COG,Congo,NLD,Netherlands,2008,39,21,18
COG,Congo,NLD,Netherlands,2009,61,9,52
COG,Congo,NLD,Netherlands,2010,39,19,20
COG,Congo,NLD,Netherlands,2011,42,20,22
COG,Congo,NLD,Netherlands,2012,47,18,29
COG,Congo,NLD,Netherlands,2013,45,13,32
COG,Congo,NLD,Netherlands,2014,73,17,56
COG,Congo,NLD,Netherlands,2015,73,26,47
COG,Congo,NLD,Netherlands,2016,30,17,13
COG,Congo,NLD,Netherlands,2017,22,11,11
COG,Congo,NZL,New Zealand,2008,39,0,39
COG,Congo,NZL,New Zealand,2009,24,1,23
COG,Congo,NZL,New Zealand,2010,9,0,9
COG,Congo,NZL,New Zealand,2011,3,1,2
COG,Congo,NZL,New Zealand,2012,3,1,2
COG,Congo,NZL,New Zealand,2015,1,0,1
COG,Congo,NZL,New Zealand,2016,2,0,2
COG,Congo,NZL,New Zealand,2017,2,1,1
COG,Congo,NOR,Norway,2008,9,9,0
COG,Congo,NOR,Norway,2009,75,3,72
COG,Congo,NOR,Norway,2010,99,10,89
COG,Congo,NOR,Norway,2011,67,12,55
COG,Congo,NOR,Norway,2012,62,11,51
COG,Congo,NOR,Norway,2013,246,31,215
COG,Congo,NOR,Norway,2014,158,14,144
COG,Congo,NOR,Norway,2015,247,13,234
COG,Congo,NOR,Norway,2016,51,11,40
COG,Congo,NOR,Norway,2017,84,7,77
COG,Congo,POL,Poland,2008,56,0,56
COG,Congo,POL,Poland,2009,85,0,85
COG,Congo,POL,Poland,2010,63,0,63
COG,Congo,POL,Poland,2011,53,0,53
COG,Congo,POL,Poland,2012,51,0,51
COG,Congo,POL,Poland,2013,49,0,49
COG,Congo,POL,Poland,2014,22,0,22
COG,Congo,POL,Poland,2015,44,0,44
COG,Congo,POL,Poland,2016,53,0,53
COG,Congo,POL,Poland,2017,56,0,56
COG,Congo,SVK,Slovak Republic,2008,1,1,0
COG,Congo,SVK,Slovak Republic,2009,3,0,3
COG,Congo,SVK,Slovak Republic,2011,1,0,1
COG,Congo,SVK,Slovak Republic,2013,1,0,1
COG,Congo,SVK,Slovak Republic,2015,1,0,1
COG,Congo,SVK,Slovak Republic,2017,1,0,1
COG,Congo,ESP,Spain,2008,186,106,80
COG,Congo,ESP,Spain,2009,136,138,-2
COG,Congo,ESP,Spain,2010,98,159,-61
COG,Congo,ESP,Spain,2011,125,157,-32
COG,Congo,ESP,Spain,2012,111,156,-45
COG,Congo,ESP,Spain,2013,138,144,-6
COG,Congo,ESP,Spain,2014,132,92,40
COG,Congo,ESP,Spain,2015,120,57,63
COG,Congo,ESP,Spain,2016,136,61,75
COG,Congo,ESP,Spain,2017,145,126,19
COG,Congo,SWE,Sweden,2008,67,4,63
COG,Congo,SWE,Sweden,2009,62,2,60
COG,Congo,SWE,Sweden,2010,54,2,52
COG,Congo,SWE,Sweden,2011,68,4,64
COG,Congo,SWE,Sweden,2012,50,1,49
COG,Congo,SWE,Sweden,2013,42,5,37
COG,Congo,SWE,Sweden,2014,19,3,16
COG,Congo,SWE,Sweden,2015,23,6,17
COG,Congo,SWE,Sweden,2016,24,5,19
COG,Congo,SWE,Sweden,2017,18,2,16
COG,Congo,CHE,Switzerland,2010,19,5,14
COG,Congo,CHE,Switzerland,2011,23,7,16
COG,Congo,CHE,Switzerland,2012,20,5,15
COG,Congo,CHE,Switzerland,2013,26,8,18
COG,Congo,CHE,Switzerland,2014,10,3,7
COG,Congo,CHE,Switzerland,2015,8,8,0
COG,Congo,CHE,Switzerland,2016,18,4,14
COG,Congo,CHE,Switzerland,2017,13,3,10
COG,Congo,TUR,Turkey,2010,16,0,16
COG,Congo,GBR,United Kingdom,2011,1000,0,1000
COG,Congo,GBR,United Kingdom,2014,1000,0,1000
COG,Congo,USA,United States,2008,950,0,950
COG,Congo,USA,United States,2009,1563,0,1563
COG,Congo,USA,United States,2010,968,0,968
COG,Congo,USA,United States,2011,1371,0,1371
COG,Congo,USA,United States,2012,1461,0,1461
COG,Congo,USA,United States,2013,1059,0,1059
COG,Congo,USA,United States,2014,552,0,552
COG,Congo,USA,United States,2015,496,0,496
COG,Congo,USA,United States,2016,625,0,625
COG,Congo,USA,United States,2017,632,0,632
COG,Congo,CHL,Chile,2008,0,0,0
COG,Congo,CHL,Chile,2009,0,0,0
COG,Congo,CHL,Chile,2010,1,0,1
COG,Congo,CHL,Chile,2011,0,0,0
COG,Congo,CHL,Chile,2012,3,0,3
COG,Congo,CHL,Chile,2013,0,0,0
COG,Congo,CHL,Chile,2014,0,0,0
COG,Congo,CHL,Chile,2015,0,0,0
COG,Congo,CHL,Chile,2016,0,0,0
COG,Congo,EST,Estonia,2008,0,0,0
COG,Congo,EST,Estonia,2009,0,0,0
COG,Congo,EST,Estonia,2010,0,0,0
COG,Congo,EST,Estonia,2011,0,0,0
COG,Congo,EST,Estonia,2012,0,0,0
COG,Congo,EST,Estonia,2013,0,0,0
COG,Congo,EST,Estonia,2014,0,0,0
COG,Congo,EST,Estonia,2015,0,0,0
COG,Congo,EST,Estonia,2016,0,0,0
COG,Congo,EST,Estonia,2017,1,0,1
COK,Cook Islands,AUS,Australia,2008,0,17,-17
COK,Cook Islands,AUS,Australia,2009,0,12,-12
COK,Cook Islands,AUS,Australia,2010,0,5,-5
COK,Cook Islands,AUS,Australia,2011,0,7,-7
COK,Cook Islands,AUS,Australia,2012,0,11,-11
COK,Cook Islands,AUS,Australia,2013,0,12,-12
COK,Cook Islands,AUS,Australia,2014,0,8,-8
COK,Cook Islands,AUS,Australia,2015,0,0,0
COK,Cook Islands,AUS,Australia,2016,0,0,0
COK,Cook Islands,AUS,Australia,2017,0,0,0
COK,Cook Islands,AUT,Austria,2014,0,0,0
COK,Cook Islands,AUT,Austria,2015,0,0,0
COK,Cook Islands,AUT,Austria,2016,0,0,0
COK,Cook Islands,AUT,Austria,2017,0,0,0
COK,Cook Islands,BEL,Belgium,2010,0,0,0
COK,Cook Islands,CAN,Canada,2008,0,0,0
COK,Cook Islands,CAN,Canada,2009,0,0,0
COK,Cook Islands,CAN,Canada,2010,0,0,0
COK,Cook Islands,CAN,Canada,2011,0,0,0
COK,Cook Islands,CAN,Canada,2012,0,0,0
COK,Cook Islands,CAN,Canada,2013,0,0,0
COK,Cook Islands,CAN,Canada,2014,0,0,0
COK,Cook Islands,CAN,Canada,2015,0,0,0
COK,Cook Islands,CAN,Canada,2016,0,0,0
COK,Cook Islands,CAN,Canada,2017,0,0,0
COK,Cook Islands,DNK,Denmark,2015,0,0,0
COK,Cook Islands,DNK,Denmark,2016,0,0,0
COK,Cook Islands,FIN,Finland,2008,0,0,0
COK,Cook Islands,FIN,Finland,2009,0,0,0
COK,Cook Islands,FIN,Finland,2010,0,0,0
COK,Cook Islands,FIN,Finland,2011,0,0,0
COK,Cook Islands,FIN,Finland,2012,0,0,0
COK,Cook Islands,FIN,Finland,2013,0,0,0
COK,Cook Islands,FIN,Finland,2014,0,0,0
COK,Cook Islands,FIN,Finland,2015,0,0,0
COK,Cook Islands,FIN,Finland,2016,0,0,0
COK,Cook Islands,FIN,Finland,2017,0,0,0
COK,Cook Islands,FRA,France,2008,0,0,0
COK,Cook Islands,FRA,France,2009,0,0,0
COK,Cook Islands,FRA,France,2010,0,0,0
COK,Cook Islands,FRA,France,2011,0,0,0
COK,Cook Islands,FRA,France,2012,0,0,0
COK,Cook Islands,FRA,France,2013,0,0,0
COK,Cook Islands,FRA,France,2014,0,0,0
COK,Cook Islands,FRA,France,2015,0,0,0
COK,Cook Islands,FRA,France,2016,0,0,0
COK,Cook Islands,FRA,France,2017,0,0,0
COK,Cook Islands,DEU,Germany,2008,0,0,0
COK,Cook Islands,DEU,Germany,2009,0,0,0
COK,Cook Islands,DEU,Germany,2010,2,0,2
COK,Cook Islands,DEU,Germany,2011,0,0,0
COK,Cook Islands,DEU,Germany,2012,0,1,-1
COK,Cook Islands,DEU,Germany,2013,0,0,0
COK,Cook Islands,DEU,Germany,2014,0,0,0
COK,Cook Islands,DEU,Germany,2015,0,0,0
COK,Cook Islands,DEU,Germany,2016,0,0,0
COK,Cook Islands,DEU,Germany,2017,0,0,0
COK,Cook Islands,HUN,Hungary,2008,0,0,0
COK,Cook Islands,HUN,Hungary,2009,0,0,0
COK,Cook Islands,HUN,Hungary,2010,0,0,0
COK,Cook Islands,HUN,Hungary,2011,0,0,0
COK,Cook Islands,HUN,Hungary,2012,0,0,0
COK,Cook Islands,HUN,Hungary,2013,0,0,0
COK,Cook Islands,HUN,Hungary,2014,0,0,0
COK,Cook Islands,HUN,Hungary,2015,0,0,0
COK,Cook Islands,HUN,Hungary,2016,0,0,0
COK,Cook Islands,HUN,Hungary,2017,0,0,0
COK,Cook Islands,ISL,Iceland,2016,0,0,0
COK,Cook Islands,ISL,Iceland,2017,0,0,0
COK,Cook Islands,JPN,Japan,2008,0,0,0
COK,Cook Islands,JPN,Japan,2009,0,0,0
COK,Cook Islands,JPN,Japan,2010,0,0,0
COK,Cook Islands,JPN,Japan,2011,0,0,0
COK,Cook Islands,JPN,Japan,2012,0,0,0
COK,Cook Islands,JPN,Japan,2013,0,0,0
COK,Cook Islands,JPN,Japan,2014,0,0,0
COK,Cook Islands,JPN,Japan,2015,0,0,0
COK,Cook Islands,JPN,Japan,2016,0,0,0
COK,Cook Islands,JPN,Japan,2017,0,0,0
COK,Cook Islands,KOR,Korea,2008,0,0,0
COK,Cook Islands,KOR,Korea,2009,0,0,0
COK,Cook Islands,KOR,Korea,2010,0,0,0
COK,Cook Islands,KOR,Korea,2011,0,0,0
COK,Cook Islands,KOR,Korea,2012,0,0,0
COK,Cook Islands,KOR,Korea,2013,0,0,0
COK,Cook Islands,KOR,Korea,2014,0,0,0
COK,Cook Islands,KOR,Korea,2015,0,0,0
COK,Cook Islands,KOR,Korea,2016,0,0,0
COK,Cook Islands,KOR,Korea,2017,0,0,0
COK,Cook Islands,LUX,Luxembourg,2008,0,0,0
COK,Cook Islands,LUX,Luxembourg,2009,0,0,0
COK,Cook Islands,LUX,Luxembourg,2010,0,0,0
COK,Cook Islands,LUX,Luxembourg,2011,0,0,0
COK,Cook Islands,LUX,Luxembourg,2012,0,0,0
COK,Cook Islands,LUX,Luxembourg,2013,0,0,0
COK,Cook Islands,LUX,Luxembourg,2014,0,0,0
COK,Cook Islands,LUX,Luxembourg,2015,0,0,0
COK,Cook Islands,LUX,Luxembourg,2016,0,0,0
COK,Cook Islands,LUX,Luxembourg,2017,0,0,0
COK,Cook Islands,MEX,Mexico,2008,3,0,3
COK,Cook Islands,MEX,Mexico,2012,0,0,0
COK,Cook Islands,MEX,Mexico,2013,0,0,0
COK,Cook Islands,MEX,Mexico,2014,0,0,0
COK,Cook Islands,NOR,Norway,2008,0,0,0
COK,Cook Islands,NOR,Norway,2009,0,0,0
COK,Cook Islands,NOR,Norway,2010,0,0,0
COK,Cook Islands,NOR,Norway,2011,0,0,0
COK,Cook Islands,NOR,Norway,2012,0,0,0
COK,Cook Islands,NOR,Norway,2013,0,0,0
COK,Cook Islands,NOR,Norway,2014,0,0,0
COK,Cook Islands,NOR,Norway,2015,0,0,0
COK,Cook Islands,NOR,Norway,2016,0,0,0
COK,Cook Islands,NOR,Norway,2017,0,0,0
COK,Cook Islands,POL,Poland,2009,0,0,0
COK,Cook Islands,POL,Poland,2010,0,0,0
COK,Cook Islands,POL,Poland,2011,0,0,0
COK,Cook Islands,POL,Poland,2012,0,0,0
COK,Cook Islands,POL,Poland,2013,0,0,0
COK,Cook Islands,POL,Poland,2014,0,0,0
COK,Cook Islands,POL,Poland,2015,0,0,0
COK,Cook Islands,POL,Poland,2016,0,0,0
COK,Cook Islands,POL,Poland,2017,0,0,0
COK,Cook Islands,SVK,Slovak Republic,2008,0,0,0
COK,Cook Islands,ESP,Spain,2008,2,0,2
COK,Cook Islands,ESP,Spain,2009,4,0,4
COK,Cook Islands,ESP,Spain,2010,2,0,2
COK,Cook Islands,ESP,Spain,2011,1,1,0
COK,Cook Islands,ESP,Spain,2012,4,0,4
COK,Cook Islands,ESP,Spain,2013,4,0,4
COK,Cook Islands,ESP,Spain,2014,0,0,0
COK,Cook Islands,ESP,Spain,2015,0,0,0
COK,Cook Islands,ESP,Spain,2016,1,0,1
COK,Cook Islands,ESP,Spain,2017,4,0,4
COK,Cook Islands,SWE,Sweden,2008,0,0,0
COK,Cook Islands,SWE,Sweden,2009,0,0,0
COK,Cook Islands,SWE,Sweden,2010,0,0,0
COK,Cook Islands,SWE,Sweden,2011,0,0,0
COK,Cook Islands,SWE,Sweden,2012,0,0,0
COK,Cook Islands,SWE,Sweden,2013,0,0,0
COK,Cook Islands,SWE,Sweden,2014,0,0,0
COK,Cook Islands,SWE,Sweden,2015,0,0,0
COK,Cook Islands,USA,United States,2011,3,0,3
COK,Cook Islands,USA,United States,2012,0,0,0
COK,Cook Islands,USA,United States,2013,0,0,0
COK,Cook Islands,USA,United States,2014,0,0,0
COK,Cook Islands,CHL,Chile,2008,0,0,0
COK,Cook Islands,CHL,Chile,2009,0,0,0
COK,Cook Islands,CHL,Chile,2010,0,0,0
COK,Cook Islands,CHL,Chile,2011,0,0,0
COK,Cook Islands,CHL,Chile,2012,0,0,0
COK,Cook Islands,CHL,Chile,2013,0,0,0
COK,Cook Islands,CHL,Chile,2014,0,0,0
COK,Cook Islands,CHL,Chile,2015,0,0,0
COK,Cook Islands,CHL,Chile,2016,0,0,0
COK,Cook Islands,EST,Estonia,2017,0,0,0
CRI,Costa Rica,AUS,Australia,2008,7,0,7
CRI,Costa Rica,AUS,Australia,2009,3,5,-2
CRI,Costa Rica,AUS,Australia,2010,10,0,10
CRI,Costa Rica,AUS,Australia,2011,14,0,14
CRI,Costa Rica,AUS,Australia,2012,14,5,9
CRI,Costa Rica,AUS,Australia,2013,17,8,9
CRI,Costa Rica,AUS,Australia,2014,11,7,4
CRI,Costa Rica,AUS,Australia,2015,11,0,11
CRI,Costa Rica,AUS,Australia,2016,12,0,12
CRI,Costa Rica,AUS,Australia,2017,11,0,11
CRI,Costa Rica,AUT,Austria,2008,14,21,-7
CRI,Costa Rica,AUT,Austria,2009,24,16,8
CRI,Costa Rica,AUT,Austria,2010,16,17,-1
CRI,Costa Rica,AUT,Austria,2011,17,9,8
CRI,Costa Rica,AUT,Austria,2012,14,10,4
CRI,Costa Rica,AUT,Austria,2013,21,15,6
CRI,Costa Rica,AUT,Austria,2014,21,10,11
CRI,Costa Rica,AUT,Austria,2015,27,21,6
CRI,Costa Rica,AUT,Austria,2016,28,12,16
CRI,Costa Rica,AUT,Austria,2017,37,25,12
CRI,Costa Rica,BEL,Belgium,2008,25,0,25
CRI,Costa Rica,BEL,Belgium,2009,28,0,28
CRI,Costa Rica,BEL,Belgium,2010,37,9,28
CRI,Costa Rica,BEL,Belgium,2011,27,0,27
CRI,Costa Rica,BEL,Belgium,2012,37,34,3
CRI,Costa Rica,BEL,Belgium,2013,29,26,3
CRI,Costa Rica,BEL,Belgium,2014,12,11,1
CRI,Costa Rica,BEL,Belgium,2015,19,13,6
CRI,Costa Rica,BEL,Belgium,2016,31,8,23
CRI,Costa Rica,BEL,Belgium,2017,29,16,13
CRI,Costa Rica,CAN,Canada,2008,246,0,246
CRI,Costa Rica,CAN,Canada,2009,217,0,217
CRI,Costa Rica,CAN,Canada,2010,190,0,190
CRI,Costa Rica,CAN,Canada,2011,148,0,148
CRI,Costa Rica,CAN,Canada,2012,183,0,183
CRI,Costa Rica,CAN,Canada,2013,122,0,122
CRI,Costa Rica,CAN,Canada,2014,165,0,165
CRI,Costa Rica,CAN,Canada,2015,121,0,121
CRI,Costa Rica,CAN,Canada,2016,135,0,135
CRI,Costa Rica,CAN,Canada,2017,135,0,135
CRI,Costa Rica,CZE,Czech Republic,2008,3,0,3
CRI,Costa Rica,CZE,Czech Republic,2009,19,0,19
CRI,Costa Rica,CZE,Czech Republic,2010,10,0,10
CRI,Costa Rica,CZE,Czech Republic,2011,15,0,15
CRI,Costa Rica,CZE,Czech Republic,2012,3,2,1
CRI,Costa Rica,CZE,Czech Republic,2013,12,3,9
CRI,Costa Rica,CZE,Czech Republic,2014,15,4,11
CRI,Costa Rica,CZE,Czech Republic,2015,9,6,3
CRI,Costa Rica,CZE,Czech Republic,2016,16,5,11
CRI,Costa Rica,CZE,Czech Republic,2017,44,5,39
CRI,Costa Rica,DNK,Denmark,2008,9,5,4
CRI,Costa Rica,DNK,Denmark,2009,12,14,-2
CRI,Costa Rica,DNK,Denmark,2010,14,15,-1
CRI,Costa Rica,DNK,Denmark,2011,22,9,13
CRI,Costa Rica,DNK,Denmark,2012,9,16,-7
CRI,Costa Rica,DNK,Denmark,2013,10,11,-1
CRI,Costa Rica,DNK,Denmark,2014,14,17,-3
CRI,Costa Rica,DNK,Denmark,2015,14,16,-2
CRI,Costa Rica,DNK,Denmark,2016,12,19,-7
CRI,Costa Rica,DNK,Denmark,2017,14,33,-19
CRI,Costa Rica,FIN,Finland,2008,2,2,0
CRI,Costa Rica,FIN,Finland,2009,6,1,5
CRI,Costa Rica,FIN,Finland,2010,6,0,6
CRI,Costa Rica,FIN,Finland,2011,5,1,4
CRI,Costa Rica,FIN,Finland,2012,6,3,3
CRI,Costa Rica,FIN,Finland,2013,4,4,0
CRI,Costa Rica,FIN,Finland,2014,7,2,5
CRI,Costa Rica,FIN,Finland,2015,4,2,2
CRI,Costa Rica,FIN,Finland,2016,5,3,2
CRI,Costa Rica,FIN,Finland,2017,6,1,5
CRI,Costa Rica,FRA,France,2008,39,0,39
CRI,Costa Rica,FRA,France,2009,34,0,34
CRI,Costa Rica,FRA,France,2010,31,0,31
CRI,Costa Rica,FRA,France,2011,35,0,35
CRI,Costa Rica,FRA,France,2012,44,0,44
CRI,Costa Rica,FRA,France,2013,38,0,38
CRI,Costa Rica,FRA,France,2014,70,0,70
CRI,Costa Rica,FRA,France,2015,81,0,81
CRI,Costa Rica,FRA,France,2016,67,0,67
CRI,Costa Rica,FRA,France,2017,70,0,70
CRI,Costa Rica,DEU,Germany,2008,180,168,12
CRI,Costa Rica,DEU,Germany,2009,239,210,29
CRI,Costa Rica,DEU,Germany,2010,222,182,40
CRI,Costa Rica,DEU,Germany,2011,219,154,65
CRI,Costa Rica,DEU,Germany,2012,242,144,98
CRI,Costa Rica,DEU,Germany,2013,270,181,89
CRI,Costa Rica,DEU,Germany,2014,271,170,101
CRI,Costa Rica,DEU,Germany,2015,323,186,137
CRI,Costa Rica,DEU,Germany,2016,320,197,123
CRI,Costa Rica,DEU,Germany,2017,333,214,119
CRI,Costa Rica,HUN,Hungary,2008,2,0,2
CRI,Costa Rica,HUN,Hungary,2009,2,0,2
CRI,Costa Rica,HUN,Hungary,2010,4,2,2
CRI,Costa Rica,HUN,Hungary,2011,4,1,3
CRI,Costa Rica,HUN,Hungary,2012,5,1,4
CRI,Costa Rica,HUN,Hungary,2013,10,0,10
CRI,Costa Rica,HUN,Hungary,2014,9,1,8
CRI,Costa Rica,HUN,Hungary,2015,6,4,2
CRI,Costa Rica,HUN,Hungary,2016,8,2,6
CRI,Costa Rica,HUN,Hungary,2017,6,0,6
CRI,Costa Rica,ISL,Iceland,2008,1,4,-3
CRI,Costa Rica,ISL,Iceland,2009,2,3,-1
CRI,Costa Rica,ISL,Iceland,2010,2,2,0
CRI,Costa Rica,ISL,Iceland,2011,1,2,-1
CRI,Costa Rica,ISL,Iceland,2012,0,0,0
CRI,Costa Rica,ISL,Iceland,2013,2,0,2
CRI,Costa Rica,ISL,Iceland,2014,1,1,0
CRI,Costa Rica,ISL,Iceland,2015,2,1,1
CRI,Costa Rica,ISL,Iceland,2016,7,0,7
CRI,Costa Rica,ISL,Iceland,2017,2,2,0
CRI,Costa Rica,ITA,Italy,2008,78,10,68
CRI,Costa Rica,ITA,Italy,2009,56,14,42
CRI,Costa Rica,ITA,Italy,2010,68,8,60
CRI,Costa Rica,ITA,Italy,2011,61,12,49
CRI,Costa Rica,ITA,Italy,2012,66,6,60
CRI,Costa Rica,ITA,Italy,2013,44,4,40
CRI,Costa Rica,ITA,Italy,2014,48,6,42
CRI,Costa Rica,ITA,Italy,2015,48,3,45
CRI,Costa Rica,ITA,Italy,2016,48,0,48
CRI,Costa Rica,ITA,Italy,2017,61,8,53
CRI,Costa Rica,JPN,Japan,2008,77,75,2
CRI,Costa Rica,JPN,Japan,2009,89,86,3
CRI,Costa Rica,JPN,Japan,2010,98,95,3
CRI,Costa Rica,JPN,Japan,2011,85,85,0
CRI,Costa Rica,JPN,Japan,2012,59,50,9
CRI,Costa Rica,JPN,Japan,2013,82,76,6
CRI,Costa Rica,JPN,Japan,2014,70,62,8
CRI,Costa Rica,JPN,Japan,2015,78,75,3
CRI,Costa Rica,JPN,Japan,2016,90,79,11
CRI,Costa Rica,JPN,Japan,2017,74,68,6
CRI,Costa Rica,KOR,Korea,2008,8,7,1
CRI,Costa Rica,KOR,Korea,2009,13,6,7
CRI,Costa Rica,KOR,Korea,2010,11,11,0
CRI,Costa Rica,KOR,Korea,2011,11,12,-1
CRI,Costa Rica,KOR,Korea,2012,13,10,3
CRI,Costa Rica,KOR,Korea,2013,12,8,4
CRI,Costa Rica,KOR,Korea,2014,8,13,-5
CRI,Costa Rica,KOR,Korea,2015,23,11,12
CRI,Costa Rica,KOR,Korea,2016,28,17,11
CRI,Costa Rica,KOR,Korea,2017,15,29,-14
CRI,Costa Rica,LUX,Luxembourg,2008,2,0,2
CRI,Costa Rica,LUX,Luxembourg,2009,1,2,-1
CRI,Costa Rica,LUX,Luxembourg,2010,1,1,0
CRI,Costa Rica,LUX,Luxembourg,2011,1,1,0
CRI,Costa Rica,LUX,Luxembourg,2012,2,0,2
CRI,Costa Rica,LUX,Luxembourg,2013,2,0,2
CRI,Costa Rica,LUX,Luxembourg,2014,1,0,1
CRI,Costa Rica,LUX,Luxembourg,2015,0,0,0
CRI,Costa Rica,LUX,Luxembourg,2016,2,2,0
CRI,Costa Rica,LUX,Luxembourg,2017,5,0,5
CRI,Costa Rica,MEX,Mexico,2008,101,0,101
CRI,Costa Rica,MEX,Mexico,2009,138,0,138
CRI,Costa Rica,MEX,Mexico,2010,162,0,162
CRI,Costa Rica,MEX,Mexico,2011,139,0,139
CRI,Costa Rica,MEX,Mexico,2012,114,0,114
CRI,Costa Rica,MEX,Mexico,2013,408,0,408
CRI,Costa Rica,MEX,Mexico,2014,264,0,264
CRI,Costa Rica,MEX,Mexico,2015,238,0,238
CRI,Costa Rica,MEX,Mexico,2016,220,0,220
CRI,Costa Rica,MEX,Mexico,2017,180,0,180
CRI,Costa Rica,NLD,Netherlands,2008,39,22,17
CRI,Costa Rica,NLD,Netherlands,2009,45,31,14
CRI,Costa Rica,NLD,Netherlands,2010,52,28,24
CRI,Costa Rica,NLD,Netherlands,2011,41,24,17
CRI,Costa Rica,NLD,Netherlands,2012,62,42,20
CRI,Costa Rica,NLD,Netherlands,2013,39,45,-6
CRI,Costa Rica,NLD,Netherlands,2014,61,33,28
CRI,Costa Rica,NLD,Netherlands,2015,62,37,25
CRI,Costa Rica,NLD,Netherlands,2016,64,38,26
CRI,Costa Rica,NLD,Netherlands,2017,63,24,39
CRI,Costa Rica,NZL,New Zealand,2008,19,2,17
CRI,Costa Rica,NZL,New Zealand,2009,9,3,6
CRI,Costa Rica,NZL,New Zealand,2010,6,6,0
CRI,Costa Rica,NZL,New Zealand,2011,14,6,8
CRI,Costa Rica,NZL,New Zealand,2012,11,1,10
CRI,Costa Rica,NZL,New Zealand,2013,10,1,9
CRI,Costa Rica,NZL,New Zealand,2014,3,4,-1
CRI,Costa Rica,NZL,New Zealand,2015,3,1,2
CRI,Costa Rica,NZL,New Zealand,2016,13,1,12
CRI,Costa Rica,NZL,New Zealand,2017,11,2,9
CRI,Costa Rica,NOR,Norway,2008,13,5,8
CRI,Costa Rica,NOR,Norway,2009,14,16,-2
CRI,Costa Rica,NOR,Norway,2010,5,13,-8
CRI,Costa Rica,NOR,Norway,2011,17,12,5
CRI,Costa Rica,NOR,Norway,2012,10,9,1
CRI,Costa Rica,NOR,Norway,2013,18,5,13
CRI,Costa Rica,NOR,Norway,2014,18,7,11
CRI,Costa Rica,NOR,Norway,2015,10,13,-3
CRI,Costa Rica,NOR,Norway,2016,12,10,2
CRI,Costa Rica,NOR,Norway,2017,13,0,13
CRI,Costa Rica,POL,Poland,2009,4,0,4
CRI,Costa Rica,POL,Poland,2010,11,0,11
CRI,Costa Rica,POL,Poland,2011,10,0,10
CRI,Costa Rica,POL,Poland,2012,15,0,15
CRI,Costa Rica,POL,Poland,2013,12,0,12
CRI,Costa Rica,POL,Poland,2014,5,0,5
CRI,Costa Rica,POL,Poland,2015,10,0,10
CRI,Costa Rica,POL,Poland,2016,18,0,18
CRI,Costa Rica,POL,Poland,2017,19,0,19
CRI,Costa Rica,SVK,Slovak Republic,2008,2,0,2
CRI,Costa Rica,SVK,Slovak Republic,2009,1,1,0
CRI,Costa Rica,SVK,Slovak Republic,2010,1,0,1
CRI,Costa Rica,SVK,Slovak Republic,2013,3,0,3
CRI,Costa Rica,SVK,Slovak Republic,2015,3,0,3
CRI,Costa Rica,ESP,Spain,2008,415,157,258
CRI,Costa Rica,ESP,Spain,2009,297,249,48
CRI,Costa Rica,ESP,Spain,2010,285,250,35
CRI,Costa Rica,ESP,Spain,2011,404,277,127
CRI,Costa Rica,ESP,Spain,2012,350,234,116
CRI,Costa Rica,ESP,Spain,2013,354,376,-22
CRI,Costa Rica,ESP,Spain,2014,408,217,191
CRI,Costa Rica,ESP,Spain,2015,425,160,265
CRI,Costa Rica,ESP,Spain,2016,601,181,420
CRI,Costa Rica,ESP,Spain,2017,731,288,443
CRI,Costa Rica,SWE,Sweden,2008,26,3,23
CRI,Costa Rica,SWE,Sweden,2009,16,2,14
CRI,Costa Rica,SWE,Sweden,2010,20,5,15
CRI,Costa Rica,SWE,Sweden,2011,19,8,11
CRI,Costa Rica,SWE,Sweden,2012,26,11,15
CRI,Costa Rica,SWE,Sweden,2013,23,10,13
CRI,Costa Rica,SWE,Sweden,2014,9,5,4
CRI,Costa Rica,SWE,Sweden,2015,18,13,5
CRI,Costa Rica,SWE,Sweden,2016,23,6,17
CRI,Costa Rica,SWE,Sweden,2017,16,7,9
CRI,Costa Rica,CHE,Switzerland,2010,66,26,40
CRI,Costa Rica,CHE,Switzerland,2011,65,22,43
CRI,Costa Rica,CHE,Switzerland,2012,62,30,32
CRI,Costa Rica,CHE,Switzerland,2013,57,32,25
CRI,Costa Rica,CHE,Switzerland,2014,45,52,-7
CRI,Costa Rica,CHE,Switzerland,2015,65,30,35
CRI,Costa Rica,CHE,Switzerland,2016,81,29,52
CRI,Costa Rica,CHE,Switzerland,2017,68,35,33
CRI,Costa Rica,USA,United States,2008,2090,0,2090
CRI,Costa Rica,USA,United States,2009,2384,0,2384
CRI,Costa Rica,USA,United States,2010,2164,0,2164
CRI,Costa Rica,USA,United States,2011,2135,0,2135
CRI,Costa Rica,USA,United States,2012,2020,0,2020
CRI,Costa Rica,USA,United States,2013,2114,0,2114
CRI,Costa Rica,USA,United States,2014,1966,0,1966
CRI,Costa Rica,USA,United States,2015,2029,0,2029
CRI,Costa Rica,USA,United States,2016,2224,0,2224
CRI,Costa Rica,USA,United States,2017,2184,0,2184
CRI,Costa Rica,CHL,Chile,2008,50,0,50
CRI,Costa Rica,CHL,Chile,2009,44,0,44
CRI,Costa Rica,CHL,Chile,2010,62,0,62
CRI,Costa Rica,CHL,Chile,2011,95,0,95
CRI,Costa Rica,CHL,Chile,2012,92,0,92
CRI,Costa Rica,CHL,Chile,2013,80,0,80
CRI,Costa Rica,CHL,Chile,2014,105,0,105
CRI,Costa Rica,CHL,Chile,2015,108,0,108
CRI,Costa Rica,CHL,Chile,2016,89,0,89
CRI,Costa Rica,EST,Estonia,2008,0,0,0
CRI,Costa Rica,EST,Estonia,2009,0,0,0
CRI,Costa Rica,EST,Estonia,2010,0,0,0
CRI,Costa Rica,EST,Estonia,2011,1,0,1
CRI,Costa Rica,EST,Estonia,2012,1,0,1
CRI,Costa Rica,EST,Estonia,2013,0,0,0
CRI,Costa Rica,EST,Estonia,2014,0,0,0
CRI,Costa Rica,EST,Estonia,2015,2,0,2
CRI,Costa Rica,EST,Estonia,2016,0,0,0
CRI,Costa Rica,EST,Estonia,2017,2,0,2
CRI,Costa Rica,SVN,Slovenia,2008,1,0,1
CRI,Costa Rica,SVN,Slovenia,2009,2,0,2
CRI,Costa Rica,SVN,Slovenia,2013,1,0,1
CRI,Costa Rica,SVN,Slovenia,2015,1,0,1
CIV,Côte d'Ivoire,AUS,Australia,2008,8,0,8
CIV,Côte d'Ivoire,AUS,Australia,2009,12,5,7
CIV,Côte d'Ivoire,AUS,Australia,2010,4,0,4
CIV,Côte d'Ivoire,AUS,Australia,2011,4,0,4
CIV,Côte d'Ivoire,AUS,Australia,2012,16,0,16
CIV,Côte d'Ivoire,AUS,Australia,2013,7,0,7
CIV,Côte d'Ivoire,AUS,Australia,2014,9,0,9
CIV,Côte d'Ivoire,AUS,Australia,2015,5,0,5
CIV,Côte d'Ivoire,AUS,Australia,2016,6,0,6
CIV,Côte d'Ivoire,AUS,Australia,2017,6,0,6
CIV,Côte d'Ivoire,AUT,Austria,2008,22,13,9
CIV,Côte d'Ivoire,AUT,Austria,2009,13,10,3
CIV,Côte d'Ivoire,AUT,Austria,2010,24,18,6
CIV,Côte d'Ivoire,AUT,Austria,2011,31,12,19
CIV,Côte d'Ivoire,AUT,Austria,2012,24,10,14
CIV,Côte d'Ivoire,AUT,Austria,2013,32,3,29
CIV,Côte d'Ivoire,AUT,Austria,2014,30,14,16
CIV,Côte d'Ivoire,AUT,Austria,2015,37,15,22
CIV,Côte d'Ivoire,AUT,Austria,2016,32,21,11
CIV,Côte d'Ivoire,AUT,Austria,2017,28,22,6
CIV,Côte d'Ivoire,BEL,Belgium,2008,236,0,236
CIV,Côte d'Ivoire,BEL,Belgium,2009,240,0,240
CIV,Côte d'Ivoire,BEL,Belgium,2010,286,75,211
CIV,Côte d'Ivoire,BEL,Belgium,2011,334,0,334
CIV,Côte d'Ivoire,BEL,Belgium,2012,429,142,287
CIV,Côte d'Ivoire,BEL,Belgium,2013,322,223,99
CIV,Côte d'Ivoire,BEL,Belgium,2014,292,214,78
CIV,Côte d'Ivoire,BEL,Belgium,2015,309,142,167
CIV,Côte d'Ivoire,BEL,Belgium,2016,280,88,192
CIV,Côte d'Ivoire,BEL,Belgium,2017,335,69,266
CIV,Côte d'Ivoire,CAN,Canada,2008,646,0,646
CIV,Côte d'Ivoire,CAN,Canada,2009,668,0,668
CIV,Côte d'Ivoire,CAN,Canada,2010,1066,0,1066
CIV,Côte d'Ivoire,CAN,Canada,2011,636,0,636
CIV,Côte d'Ivoire,CAN,Canada,2012,1023,0,1023
CIV,Côte d'Ivoire,CAN,Canada,2013,1170,0,1170
CIV,Côte d'Ivoire,CAN,Canada,2014,1521,0,1521
CIV,Côte d'Ivoire,CAN,Canada,2015,1361,0,1361
CIV,Côte d'Ivoire,CAN,Canada,2016,1765,0,1765
CIV,Côte d'Ivoire,CAN,Canada,2017,1400,0,1400
CIV,Côte d'Ivoire,CZE,Czech Republic,2008,7,0,7
CIV,Côte d'Ivoire,CZE,Czech Republic,2009,6,0,6
CIV,Côte d'Ivoire,CZE,Czech Republic,2010,2,1,1
CIV,Côte d'Ivoire,CZE,Czech Republic,2011,5,0,5
CIV,Côte d'Ivoire,CZE,Czech Republic,2012,4,3,1
CIV,Côte d'Ivoire,CZE,Czech Republic,2013,1,2,-1
CIV,Côte d'Ivoire,CZE,Czech Republic,2014,8,1,7
CIV,Côte d'Ivoire,CZE,Czech Republic,2015,5,3,2
CIV,Côte d'Ivoire,CZE,Czech Republic,2016,3,3,0
CIV,Côte d'Ivoire,CZE,Czech Republic,2017,5,1,4
CIV,Côte d'Ivoire,DNK,Denmark,2008,10,4,6
CIV,Côte d'Ivoire,DNK,Denmark,2009,13,7,6
CIV,Côte d'Ivoire,DNK,Denmark,2010,23,4,19
CIV,Côte d'Ivoire,DNK,Denmark,2011,5,3,2
CIV,Côte d'Ivoire,DNK,Denmark,2012,12,5,7
CIV,Côte d'Ivoire,DNK,Denmark,2013,18,1,17
CIV,Côte d'Ivoire,DNK,Denmark,2014,18,1,17
CIV,Côte d'Ivoire,DNK,Denmark,2015,13,4,9
CIV,Côte d'Ivoire,DNK,Denmark,2016,9,7,2
CIV,Côte d'Ivoire,DNK,Denmark,2017,7,8,-1
CIV,Côte d'Ivoire,FIN,Finland,2008,4,0,4
CIV,Côte d'Ivoire,FIN,Finland,2009,9,1,8
CIV,Côte d'Ivoire,FIN,Finland,2010,4,0,4
CIV,Côte d'Ivoire,FIN,Finland,2011,8,0,8
CIV,Côte d'Ivoire,FIN,Finland,2012,4,1,3
CIV,Côte d'Ivoire,FIN,Finland,2013,8,1,7
CIV,Côte d'Ivoire,FIN,Finland,2014,6,2,4
CIV,Côte d'Ivoire,FIN,Finland,2015,10,1,9
CIV,Côte d'Ivoire,FIN,Finland,2016,2,0,2
CIV,Côte d'Ivoire,FIN,Finland,2017,3,2,1
CIV,Côte d'Ivoire,FRA,France,2008,3419,0,3419
CIV,Côte d'Ivoire,FRA,France,2009,3463,0,3463
CIV,Côte d'Ivoire,FRA,France,2010,3307,0,3307
CIV,Côte d'Ivoire,FRA,France,2011,3228,0,3228
CIV,Côte d'Ivoire,FRA,France,2012,3362,0,3362
CIV,Côte d'Ivoire,FRA,France,2013,3619,0,3619
CIV,Côte d'Ivoire,FRA,France,2014,4341,0,4341
CIV,Côte d'Ivoire,FRA,France,2015,3676,0,3676
CIV,Côte d'Ivoire,FRA,France,2016,3888,0,3888
CIV,Côte d'Ivoire,FRA,France,2017,4177,0,4177
CIV,Côte d'Ivoire,DEU,Germany,2008,258,251,7
CIV,Côte d'Ivoire,DEU,Germany,2009,236,200,36
CIV,Côte d'Ivoire,DEU,Germany,2010,234,173,61
CIV,Côte d'Ivoire,DEU,Germany,2011,362,174,188
CIV,Côte d'Ivoire,DEU,Germany,2012,329,199,130
CIV,Côte d'Ivoire,DEU,Germany,2013,562,189,373
CIV,Côte d'Ivoire,DEU,Germany,2014,563,289,274
CIV,Côte d'Ivoire,DEU,Germany,2015,1324,310,1014
CIV,Côte d'Ivoire,DEU,Germany,2016,1692,494,1198
CIV,Côte d'Ivoire,DEU,Germany,2017,1604,751,853
CIV,Côte d'Ivoire,HUN,Hungary,2008,6,0,6
CIV,Côte d'Ivoire,HUN,Hungary,2009,8,0,8
CIV,Côte d'Ivoire,HUN,Hungary,2010,4,2,2
CIV,Côte d'Ivoire,HUN,Hungary,2011,6,2,4
CIV,Côte d'Ivoire,HUN,Hungary,2012,1,0,1
CIV,Côte d'Ivoire,HUN,Hungary,2013,4,2,2
CIV,Côte d'Ivoire,HUN,Hungary,2014,11,0,11
CIV,Côte d'Ivoire,HUN,Hungary,2015,7,0,7
CIV,Côte d'Ivoire,HUN,Hungary,2016,9,0,9
CIV,Côte d'Ivoire,HUN,Hungary,2017,9,0,9
CIV,Côte d'Ivoire,ISL,Iceland,2008,0,0,0
CIV,Côte d'Ivoire,ISL,Iceland,2009,0,0,0
CIV,Côte d'Ivoire,ISL,Iceland,2010,0,0,0
CIV,Côte d'Ivoire,ISL,Iceland,2011,0,0,0
CIV,Côte d'Ivoire,ISL,Iceland,2012,0,0,0
CIV,Côte d'Ivoire,ISL,Iceland,2013,0,0,0
CIV,Côte d'Ivoire,ISL,Iceland,2014,0,0,0
CIV,Côte d'Ivoire,ISL,Iceland,2015,0,0,0
CIV,Côte d'Ivoire,ISL,Iceland,2016,3,0,3
CIV,Côte d'Ivoire,ISL,Iceland,2017,0,0,0
CIV,Côte d'Ivoire,ITA,Italy,2008,2255,96,2159
CIV,Côte d'Ivoire,ITA,Italy,2009,1970,116,1854
CIV,Côte d'Ivoire,ITA,Italy,2010,1915,86,1829
CIV,Côte d'Ivoire,ITA,Italy,2011,1734,119,1615
CIV,Côte d'Ivoire,ITA,Italy,2012,2715,114,2601
CIV,Côte d'Ivoire,ITA,Italy,2013,1800,177,1623
CIV,Côte d'Ivoire,ITA,Italy,2014,1272,210,1062
CIV,Côte d'Ivoire,ITA,Italy,2015,2046,165,1881
CIV,Côte d'Ivoire,ITA,Italy,2016,3536,0,3536
CIV,Côte d'Ivoire,ITA,Italy,2017,6528,156,6372
CIV,Côte d'Ivoire,JPN,Japan,2008,94,84,10
CIV,Côte d'Ivoire,JPN,Japan,2009,87,78,9
CIV,Côte d'Ivoire,JPN,Japan,2010,83,74,9
CIV,Côte d'Ivoire,JPN,Japan,2011,32,16,16
CIV,Côte d'Ivoire,JPN,Japan,2012,103,104,-1
CIV,Côte d'Ivoire,JPN,Japan,2013,168,155,13
CIV,Côte d'Ivoire,JPN,Japan,2014,120,114,6
CIV,Côte d'Ivoire,JPN,Japan,2015,144,126,18
CIV,Côte d'Ivoire,JPN,Japan,2016,149,142,7
CIV,Côte d'Ivoire,JPN,Japan,2017,124,108,16
CIV,Côte d'Ivoire,KOR,Korea,2008,34,19,15
CIV,Côte d'Ivoire,KOR,Korea,2009,11,16,-5
CIV,Côte d'Ivoire,KOR,Korea,2010,23,18,5
CIV,Côte d'Ivoire,KOR,Korea,2011,22,36,-14
CIV,Côte d'Ivoire,KOR,Korea,2012,23,28,-5
CIV,Côte d'Ivoire,KOR,Korea,2013,20,13,7
CIV,Côte d'Ivoire,KOR,Korea,2014,29,12,17
CIV,Côte d'Ivoire,KOR,Korea,2015,38,22,16
CIV,Côte d'Ivoire,KOR,Korea,2016,32,29,3
CIV,Côte d'Ivoire,KOR,Korea,2017,35,37,-2
CIV,Côte d'Ivoire,LUX,Luxembourg,2008,7,7,0
CIV,Côte d'Ivoire,LUX,Luxembourg,2009,19,2,17
CIV,Côte d'Ivoire,LUX,Luxembourg,2010,16,1,15
CIV,Côte d'Ivoire,LUX,Luxembourg,2011,18,2,16
CIV,Côte d'Ivoire,LUX,Luxembourg,2012,15,2,13
CIV,Côte d'Ivoire,LUX,Luxembourg,2013,20,5,15
CIV,Côte d'Ivoire,LUX,Luxembourg,2014,23,9,14
CIV,Côte d'Ivoire,LUX,Luxembourg,2015,18,9,9
CIV,Côte d'Ivoire,LUX,Luxembourg,2016,28,3,25
CIV,Côte d'Ivoire,LUX,Luxembourg,2017,36,5,31
CIV,Côte d'Ivoire,MEX,Mexico,2008,1,0,1
CIV,Côte d'Ivoire,MEX,Mexico,2009,1,0,1
CIV,Côte d'Ivoire,MEX,Mexico,2011,8,0,8
CIV,Côte d'Ivoire,MEX,Mexico,2012,4,0,4
CIV,Côte d'Ivoire,MEX,Mexico,2013,4,0,4
CIV,Côte d'Ivoire,MEX,Mexico,2014,1,0,1
CIV,Côte d'Ivoire,MEX,Mexico,2015,3,0,3
CIV,Côte d'Ivoire,MEX,Mexico,2016,7,0,7
CIV,Côte d'Ivoire,MEX,Mexico,2017,4,0,4
CIV,Côte d'Ivoire,NLD,Netherlands,2008,33,7,26
CIV,Côte d'Ivoire,NLD,Netherlands,2009,39,4,35
CIV,Côte d'Ivoire,NLD,Netherlands,2010,26,13,13
CIV,Côte d'Ivoire,NLD,Netherlands,2011,25,9,16
CIV,Côte d'Ivoire,NLD,Netherlands,2012,29,9,20
CIV,Côte d'Ivoire,NLD,Netherlands,2013,27,22,5
CIV,Côte d'Ivoire,NLD,Netherlands,2014,46,14,32
CIV,Côte d'Ivoire,NLD,Netherlands,2015,33,6,27
CIV,Côte d'Ivoire,NLD,Netherlands,2016,18,20,-2
CIV,Côte d'Ivoire,NLD,Netherlands,2017,25,7,18
CIV,Côte d'Ivoire,NZL,New Zealand,2011,0,0,0
CIV,Côte d'Ivoire,NZL,New Zealand,2014,1,0,1
CIV,Côte d'Ivoire,NOR,Norway,2008,18,3,15
CIV,Côte d'Ivoire,NOR,Norway,2009,18,10,8
CIV,Côte d'Ivoire,NOR,Norway,2010,15,6,9
CIV,Côte d'Ivoire,NOR,Norway,2011,14,13,1
CIV,Côte d'Ivoire,NOR,Norway,2012,24,7,17
CIV,Côte d'Ivoire,NOR,Norway,2013,19,9,10
CIV,Côte d'Ivoire,NOR,Norway,2014,13,10,3
CIV,Côte d'Ivoire,NOR,Norway,2015,12,4,8
CIV,Côte d'Ivoire,NOR,Norway,2016,10,4,6
CIV,Côte d'Ivoire,NOR,Norway,2017,22,3,19
CIV,Côte d'Ivoire,POL,Poland,2009,4,0,4
CIV,Côte d'Ivoire,POL,Poland,2010,10,0,10
CIV,Côte d'Ivoire,POL,Poland,2011,8,0,8
CIV,Côte d'Ivoire,POL,Poland,2012,7,0,7
CIV,Côte d'Ivoire,POL,Poland,2013,8,0,8
CIV,Côte d'Ivoire,POL,Poland,2014,5,0,5
CIV,Côte d'Ivoire,POL,Poland,2015,12,0,12
CIV,Côte d'Ivoire,POL,Poland,2016,10,0,10
CIV,Côte d'Ivoire,POL,Poland,2017,11,0,11
CIV,Côte d'Ivoire,SVK,Slovak Republic,2008,3,1,2
CIV,Côte d'Ivoire,SVK,Slovak Republic,2009,1,0,1
CIV,Côte d'Ivoire,SVK,Slovak Republic,2010,4,0,4
CIV,Côte d'Ivoire,ESP,Spain,2008,563,131,432
CIV,Côte d'Ivoire,ESP,Spain,2009,462,178,284
CIV,Côte d'Ivoire,ESP,Spain,2010,241,256,-15
CIV,Côte d'Ivoire,ESP,Spain,2011,307,377,-70
CIV,Côte d'Ivoire,ESP,Spain,2012,242,327,-85
CIV,Côte d'Ivoire,ESP,Spain,2013,234,311,-77
CIV,Côte d'Ivoire,ESP,Spain,2014,182,220,-38
CIV,Côte d'Ivoire,ESP,Spain,2015,243,148,95
CIV,Côte d'Ivoire,ESP,Spain,2016,362,125,237
CIV,Côte d'Ivoire,ESP,Spain,2017,634,175,459
CIV,Côte d'Ivoire,SWE,Sweden,2008,41,3,38
CIV,Côte d'Ivoire,SWE,Sweden,2009,65,0,65
CIV,Côte d'Ivoire,SWE,Sweden,2010,50,5,45
CIV,Côte d'Ivoire,SWE,Sweden,2011,62,3,59
CIV,Côte d'Ivoire,SWE,Sweden,2012,55,3,52
CIV,Côte d'Ivoire,SWE,Sweden,2013,50,4,46
CIV,Côte d'Ivoire,SWE,Sweden,2014,68,2,66
CIV,Côte d'Ivoire,SWE,Sweden,2015,50,6,44
CIV,Côte d'Ivoire,SWE,Sweden,2016,39,1,38
CIV,Côte d'Ivoire,SWE,Sweden,2017,34,4,30
CIV,Côte d'Ivoire,CHE,Switzerland,2010,166,50,116
CIV,Côte d'Ivoire,CHE,Switzerland,2011,135,39,96
CIV,Côte d'Ivoire,CHE,Switzerland,2012,147,40,107
CIV,Côte d'Ivoire,CHE,Switzerland,2013,109,36,73
CIV,Côte d'Ivoire,CHE,Switzerland,2014,136,37,99
CIV,Côte d'Ivoire,CHE,Switzerland,2015,134,45,89
CIV,Côte d'Ivoire,CHE,Switzerland,2016,120,35,85
CIV,Côte d'Ivoire,CHE,Switzerland,2017,98,42,56
CIV,Côte d'Ivoire,TUR,Turkey,2010,2,0,2
CIV,Côte d'Ivoire,TUR,Turkey,2016,107,37,70
CIV,Côte d'Ivoire,TUR,Turkey,2017,0,0,0
CIV,Côte d'Ivoire,USA,United States,2008,1645,0,1645
CIV,Côte d'Ivoire,USA,United States,2009,2159,0,2159
CIV,Côte d'Ivoire,USA,United States,2010,1621,0,1621
CIV,Côte d'Ivoire,USA,United States,2011,1302,0,1302
CIV,Côte d'Ivoire,USA,United States,2012,1760,0,1760
CIV,Côte d'Ivoire,USA,United States,2013,1486,0,1486
CIV,Côte d'Ivoire,USA,United States,2014,1477,0,1477
CIV,Côte d'Ivoire,USA,United States,2015,1497,0,1497
CIV,Côte d'Ivoire,USA,United States,2016,1617,0,1617
CIV,Côte d'Ivoire,USA,United States,2017,1810,0,1810
CIV,Côte d'Ivoire,CHL,Chile,2008,2,0,2
CIV,Côte d'Ivoire,CHL,Chile,2009,2,0,2
CIV,Côte d'Ivoire,CHL,Chile,2010,3,0,3
CIV,Côte d'Ivoire,CHL,Chile,2011,0,0,0
CIV,Côte d'Ivoire,CHL,Chile,2012,0,0,0
CIV,Côte d'Ivoire,CHL,Chile,2013,0,0,0
CIV,Côte d'Ivoire,CHL,Chile,2014,0,0,0
CIV,Côte d'Ivoire,CHL,Chile,2015,0,0,0
CIV,Côte d'Ivoire,CHL,Chile,2016,1,0,1
CIV,Côte d'Ivoire,EST,Estonia,2008,0,0,0
CIV,Côte d'Ivoire,EST,Estonia,2009,1,0,1
CIV,Côte d'Ivoire,EST,Estonia,2010,0,0,0
CIV,Côte d'Ivoire,EST,Estonia,2011,0,0,0
CIV,Côte d'Ivoire,EST,Estonia,2012,0,0,0
CIV,Côte d'Ivoire,EST,Estonia,2013,2,0,2
CIV,Côte d'Ivoire,EST,Estonia,2014,0,0,0
CIV,Côte d'Ivoire,EST,Estonia,2015,0,0,0
CIV,Côte d'Ivoire,EST,Estonia,2016,0,0,0
CIV,Côte d'Ivoire,EST,Estonia,2017,1,0,1
CIV,Côte d'Ivoire,SVN,Slovenia,2010,1,0,1
HRV,Croatia,AUS,Australia,2008,92,408,-316
HRV,Croatia,AUS,Australia,2009,127,360,-233
HRV,Croatia,AUS,Australia,2010,102,355,-253
HRV,Croatia,AUS,Australia,2011,94,284,-190
HRV,Croatia,AUS,Australia,2012,110,327,-217
HRV,Croatia,AUS,Australia,2013,102,292,-190
HRV,Croatia,AUS,Australia,2014,128,342,-214
HRV,Croatia,AUS,Australia,2015,153,300,-147
HRV,Croatia,AUS,Australia,2016,116,300,-184
HRV,Croatia,AUS,Australia,2017,132,0,132
HRV,Croatia,AUT,Austria,2008,2022,1980,42
HRV,Croatia,AUT,Austria,2009,1937,2057,-120
HRV,Croatia,AUT,Austria,2010,1894,1876,18
HRV,Croatia,AUT,Austria,2011,1908,1678,230
HRV,Croatia,AUT,Austria,2012,2008,1547,461
HRV,Croatia,AUT,Austria,2013,4183,1357,2826
HRV,Croatia,AUT,Austria,2014,6036,2014,4022
HRV,Croatia,AUT,Austria,2015,5832,2614,3218
HRV,Croatia,AUT,Austria,2016,5097,2530,2567
HRV,Croatia,AUT,Austria,2017,5082,2381,2701
HRV,Croatia,BEL,Belgium,2008,135,0,135
HRV,Croatia,BEL,Belgium,2009,129,0,129
HRV,Croatia,BEL,Belgium,2010,146,66,80
HRV,Croatia,BEL,Belgium,2011,193,0,193
HRV,Croatia,BEL,Belgium,2012,208,105,103
HRV,Croatia,BEL,Belgium,2013,315,140,175
HRV,Croatia,BEL,Belgium,2014,345,93,252
HRV,Croatia,BEL,Belgium,2015,384,128,256
HRV,Croatia,BEL,Belgium,2016,351,87,264
HRV,Croatia,BEL,Belgium,2017,382,107,275
HRV,Croatia,CAN,Canada,2008,131,0,131
HRV,Croatia,CAN,Canada,2009,92,0,92
HRV,Croatia,CAN,Canada,2010,91,0,91
HRV,Croatia,CAN,Canada,2011,135,0,135
HRV,Croatia,CAN,Canada,2012,112,0,112
HRV,Croatia,CAN,Canada,2013,125,0,125
HRV,Croatia,CAN,Canada,2014,293,0,293
HRV,Croatia,CAN,Canada,2015,500,0,500
HRV,Croatia,CAN,Canada,2016,635,0,635
HRV,Croatia,CAN,Canada,2017,580,0,580
HRV,Croatia,CZE,Czech Republic,2008,196,6,190
HRV,Croatia,CZE,Czech Republic,2009,89,1,88
HRV,Croatia,CZE,Czech Republic,2010,129,3,126
HRV,Croatia,CZE,Czech Republic,2011,129,1,128
HRV,Croatia,CZE,Czech Republic,2012,134,52,82
HRV,Croatia,CZE,Czech Republic,2013,129,145,-16
HRV,Croatia,CZE,Czech Republic,2014,149,65,84
HRV,Croatia,CZE,Czech Republic,2015,134,72,62
HRV,Croatia,CZE,Czech Republic,2016,119,34,85
HRV,Croatia,CZE,Czech Republic,2017,181,298,-117
HRV,Croatia,DNK,Denmark,2008,35,14,21
HRV,Croatia,DNK,Denmark,2009,23,13,10
HRV,Croatia,DNK,Denmark,2010,21,11,10
HRV,Croatia,DNK,Denmark,2011,32,20,12
HRV,Croatia,DNK,Denmark,2012,35,26,9
HRV,Croatia,DNK,Denmark,2013,122,29,93
HRV,Croatia,DNK,Denmark,2014,306,41,265
HRV,Croatia,DNK,Denmark,2015,358,71,287
HRV,Croatia,DNK,Denmark,2016,422,212,210
HRV,Croatia,DNK,Denmark,2017,366,189,177
HRV,Croatia,FIN,Finland,2008,16,3,13
HRV,Croatia,FIN,Finland,2009,16,6,10
HRV,Croatia,FIN,Finland,2010,15,2,13
HRV,Croatia,FIN,Finland,2011,20,3,17
HRV,Croatia,FIN,Finland,2012,18,2,16
HRV,Croatia,FIN,Finland,2013,32,1,31
HRV,Croatia,FIN,Finland,2014,54,6,48
HRV,Croatia,FIN,Finland,2015,58,5,53
HRV,Croatia,FIN,Finland,2016,34,16,18
HRV,Croatia,FIN,Finland,2017,45,18,27
HRV,Croatia,FRA,France,2008,116,0,116
HRV,Croatia,FRA,France,2009,104,0,104
HRV,Croatia,FRA,France,2010,114,0,114
HRV,Croatia,FRA,France,2011,102,0,102
HRV,Croatia,FRA,France,2012,150,0,150
HRV,Croatia,FRA,France,2013,195,0,195
HRV,Croatia,FRA,France,2014,149,0,149
HRV,Croatia,FRA,France,2015,290,0,290
HRV,Croatia,FRA,France,2016,281,0,281
HRV,Croatia,FRA,France,2017,436,0,436
HRV,Croatia,DEU,Germany,2008,8732,11816,-3084
HRV,Croatia,DEU,Germany,2009,9129,12063,-2934
HRV,Croatia,DEU,Germany,2010,10198,11184,-986
HRV,Croatia,DEU,Germany,2011,11484,11859,-375
HRV,Croatia,DEU,Germany,2012,12887,11847,1040
HRV,Croatia,DEU,Germany,2013,25772,12635,13137
HRV,Croatia,DEU,Germany,2014,46090,17535,28555
HRV,Croatia,DEU,Germany,2015,60980,21321,39659
HRV,Croatia,DEU,Germany,2016,62109,27474,34635
HRV,Croatia,DEU,Germany,2017,58603,25800,32803
HRV,Croatia,HUN,Hungary,2008,417,34,383
HRV,Croatia,HUN,Hungary,2009,140,186,-46
HRV,Croatia,HUN,Hungary,2010,178,211,-33
HRV,Croatia,HUN,Hungary,2011,221,61,160
HRV,Croatia,HUN,Hungary,2012,175,54,121
HRV,Croatia,HUN,Hungary,2013,165,64,101
HRV,Croatia,HUN,Hungary,2014,219,7,212
HRV,Croatia,HUN,Hungary,2015,210,8,202
HRV,Croatia,HUN,Hungary,2016,149,0,149
HRV,Croatia,HUN,Hungary,2017,189,2,187
HRV,Croatia,ISL,Iceland,2008,8,9,-1
HRV,Croatia,ISL,Iceland,2009,1,7,-6
HRV,Croatia,ISL,Iceland,2010,1,1,0
HRV,Croatia,ISL,Iceland,2011,2,3,-1
HRV,Croatia,ISL,Iceland,2012,4,2,2
HRV,Croatia,ISL,Iceland,2013,8,3,5
HRV,Croatia,ISL,Iceland,2014,16,7,9
HRV,Croatia,ISL,Iceland,2015,25,7,18
HRV,Croatia,ISL,Iceland,2016,109,8,101
HRV,Croatia,ISL,Iceland,2017,233,11,222
HRV,Croatia,ITA,Italy,2008,852,290,562
HRV,Croatia,ITA,Italy,2009,680,358,322
HRV,Croatia,ITA,Italy,2010,730,257,473
HRV,Croatia,ITA,Italy,2011,559,213,346
HRV,Croatia,ITA,Italy,2012,437,350,87
HRV,Croatia,ITA,Italy,2013,665,261,404
HRV,Croatia,ITA,Italy,2014,765,351,414
HRV,Croatia,ITA,Italy,2015,673,369,304
HRV,Croatia,ITA,Italy,2016,694,0,694
HRV,Croatia,ITA,Italy,2017,678,308,370
HRV,Croatia,JPN,Japan,2008,79,67,12
HRV,Croatia,JPN,Japan,2009,58,67,-9
HRV,Croatia,JPN,Japan,2010,75,68,7
HRV,Croatia,JPN,Japan,2011,55,45,10
HRV,Croatia,JPN,Japan,2012,74,55,19
HRV,Croatia,JPN,Japan,2013,58,63,-5
HRV,Croatia,JPN,Japan,2014,135,115,20
HRV,Croatia,JPN,Japan,2015,146,73,73
HRV,Croatia,JPN,Japan,2016,86,78,8
HRV,Croatia,JPN,Japan,2017,69,77,-8
HRV,Croatia,KOR,Korea,2008,39,54,-15
HRV,Croatia,KOR,Korea,2009,43,58,-15
HRV,Croatia,KOR,Korea,2010,24,37,-13
HRV,Croatia,KOR,Korea,2011,45,35,10
HRV,Croatia,KOR,Korea,2012,41,39,2
HRV,Croatia,KOR,Korea,2013,47,50,-3
HRV,Croatia,KOR,Korea,2014,27,57,-30
HRV,Croatia,KOR,Korea,2015,25,54,-29
HRV,Croatia,KOR,Korea,2016,35,34,1
HRV,Croatia,KOR,Korea,2017,29,51,-22
HRV,Croatia,LUX,Luxembourg,2008,8,7,1
HRV,Croatia,LUX,Luxembourg,2009,13,8,5
HRV,Croatia,LUX,Luxembourg,2010,37,7,30
HRV,Croatia,LUX,Luxembourg,2011,39,5,34
HRV,Croatia,LUX,Luxembourg,2012,77,3,74
HRV,Croatia,LUX,Luxembourg,2013,83,25,58
HRV,Croatia,LUX,Luxembourg,2014,140,22,118
HRV,Croatia,LUX,Luxembourg,2015,131,33,98
HRV,Croatia,LUX,Luxembourg,2016,182,48,134
HRV,Croatia,LUX,Luxembourg,2017,146,43,103
HRV,Croatia,MEX,Mexico,2008,5,0,5
HRV,Croatia,MEX,Mexico,2009,16,0,16
HRV,Croatia,MEX,Mexico,2010,5,0,5
HRV,Croatia,MEX,Mexico,2011,3,0,3
HRV,Croatia,MEX,Mexico,2012,5,0,5
HRV,Croatia,MEX,Mexico,2013,12,0,12
HRV,Croatia,MEX,Mexico,2014,12,0,12
HRV,Croatia,MEX,Mexico,2015,6,0,6
HRV,Croatia,MEX,Mexico,2016,12,0,12
HRV,Croatia,MEX,Mexico,2017,10,0,10
HRV,Croatia,NLD,Netherlands,2009,116,75,41
HRV,Croatia,NLD,Netherlands,2010,140,89,51
HRV,Croatia,NLD,Netherlands,2011,147,116,31
HRV,Croatia,NLD,Netherlands,2012,188,174,14
HRV,Croatia,NLD,Netherlands,2013,361,132,229
HRV,Croatia,NLD,Netherlands,2014,489,218,271
HRV,Croatia,NLD,Netherlands,2015,455,251,204
HRV,Croatia,NLD,Netherlands,2016,487,281,206
HRV,Croatia,NLD,Netherlands,2017,568,338,230
HRV,Croatia,NZL,New Zealand,2008,14,11,3
HRV,Croatia,NZL,New Zealand,2009,4,6,-2
HRV,Croatia,NZL,New Zealand,2010,10,3,7
HRV,Croatia,NZL,New Zealand,2011,4,3,1
HRV,Croatia,NZL,New Zealand,2012,19,4,15
HRV,Croatia,NZL,New Zealand,2013,22,8,14
HRV,Croatia,NZL,New Zealand,2014,37,6,31
HRV,Croatia,NZL,New Zealand,2015,85,10,75
HRV,Croatia,NZL,New Zealand,2016,94,19,75
HRV,Croatia,NZL,New Zealand,2017,75,14,61
HRV,Croatia,NOR,Norway,2008,82,16,66
HRV,Croatia,NOR,Norway,2009,55,17,38
HRV,Croatia,NOR,Norway,2010,67,20,47
HRV,Croatia,NOR,Norway,2011,151,31,120
HRV,Croatia,NOR,Norway,2012,158,19,139
HRV,Croatia,NOR,Norway,2013,114,40,74
HRV,Croatia,NOR,Norway,2014,476,40,436
HRV,Croatia,NOR,Norway,2015,584,104,480
HRV,Croatia,NOR,Norway,2016,568,61,507
HRV,Croatia,NOR,Norway,2017,519,53,466
HRV,Croatia,POL,Poland,2008,57,0,57
HRV,Croatia,POL,Poland,2009,74,0,74
HRV,Croatia,POL,Poland,2010,66,0,66
HRV,Croatia,POL,Poland,2011,76,0,76
HRV,Croatia,POL,Poland,2012,95,0,95
HRV,Croatia,POL,Poland,2013,118,0,118
HRV,Croatia,POL,Poland,2014,81,0,81
HRV,Croatia,POL,Poland,2015,147,0,147
HRV,Croatia,POL,Poland,2016,100,0,100
HRV,Croatia,POL,Poland,2017,121,0,121
HRV,Croatia,SVK,Slovak Republic,2008,4,33,-29
HRV,Croatia,SVK,Slovak Republic,2009,5,26,-21
HRV,Croatia,SVK,Slovak Republic,2010,10,26,-16
HRV,Croatia,SVK,Slovak Republic,2011,7,1,6
HRV,Croatia,SVK,Slovak Republic,2012,10,1,9
HRV,Croatia,SVK,Slovak Republic,2013,136,0,136
HRV,Croatia,SVK,Slovak Republic,2014,72,2,70
HRV,Croatia,SVK,Slovak Republic,2015,153,1,152
HRV,Croatia,SVK,Slovak Republic,2016,131,5,126
HRV,Croatia,SVK,Slovak Republic,2017,90,0,90
HRV,Croatia,ESP,Spain,2008,189,175,14
HRV,Croatia,ESP,Spain,2009,165,169,-4
HRV,Croatia,ESP,Spain,2010,132,205,-73
HRV,Croatia,ESP,Spain,2011,171,213,-42
HRV,Croatia,ESP,Spain,2012,177,92,85
HRV,Croatia,ESP,Spain,2013,208,113,95
HRV,Croatia,ESP,Spain,2014,236,84,152
HRV,Croatia,ESP,Spain,2015,294,72,222
HRV,Croatia,ESP,Spain,2016,322,90,232
HRV,Croatia,ESP,Spain,2017,415,173,242
HRV,Croatia,SWE,Sweden,2008,136,34,102
HRV,Croatia,SWE,Sweden,2009,170,21,149
HRV,Croatia,SWE,Sweden,2010,142,39,103
HRV,Croatia,SWE,Sweden,2011,152,36,116
HRV,Croatia,SWE,Sweden,2012,179,40,139
HRV,Croatia,SWE,Sweden,2013,495,28,467
HRV,Croatia,SWE,Sweden,2014,1174,55,1119
HRV,Croatia,SWE,Sweden,2015,1450,76,1374
HRV,Croatia,SWE,Sweden,2016,1569,118,1451
HRV,Croatia,SWE,Sweden,2017,1554,160,1394
HRV,Croatia,CHE,Switzerland,2010,426,463,-37
HRV,Croatia,CHE,Switzerland,2011,508,408,100
HRV,Croatia,CHE,Switzerland,2012,484,421,63
HRV,Croatia,CHE,Switzerland,2013,412,538,-126
HRV,Croatia,CHE,Switzerland,2014,481,325,156
HRV,Croatia,CHE,Switzerland,2015,485,367,118
HRV,Croatia,CHE,Switzerland,2016,499,401,98
HRV,Croatia,CHE,Switzerland,2017,567,451,116
HRV,Croatia,TUR,Turkey,2010,30,0,30
HRV,Croatia,GBR,United Kingdom,2014,1000,0,1000
HRV,Croatia,GBR,United Kingdom,2015,1000,0,1000
HRV,Croatia,USA,United States,2008,455,0,455
HRV,Croatia,USA,United States,2009,496,0,496
HRV,Croatia,USA,United States,2010,357,0,357
HRV,Croatia,USA,United States,2011,349,0,349
HRV,Croatia,USA,United States,2012,336,0,336
HRV,Croatia,USA,United States,2013,353,0,353
HRV,Croatia,USA,United States,2014,297,0,297
HRV,Croatia,USA,United States,2015,348,0,348
HRV,Croatia,USA,United States,2016,388,0,388
HRV,Croatia,USA,United States,2017,375,0,375
HRV,Croatia,CHL,Chile,2008,50,0,50
HRV,Croatia,CHL,Chile,2009,11,0,11
HRV,Croatia,CHL,Chile,2010,7,0,7
HRV,Croatia,CHL,Chile,2011,11,0,11
HRV,Croatia,CHL,Chile,2012,18,0,18
HRV,Croatia,CHL,Chile,2013,6,0,6
HRV,Croatia,CHL,Chile,2014,10,0,10
HRV,Croatia,CHL,Chile,2015,14,0,14
HRV,Croatia,CHL,Chile,2016,26,0,26
HRV,Croatia,EST,Estonia,2008,0,0,0
HRV,Croatia,EST,Estonia,2009,0,0,0
HRV,Croatia,EST,Estonia,2010,0,0,0
HRV,Croatia,EST,Estonia,2011,0,0,0
HRV,Croatia,EST,Estonia,2012,2,0,2
HRV,Croatia,EST,Estonia,2013,1,0,1
HRV,Croatia,EST,Estonia,2014,0,0,0
HRV,Croatia,EST,Estonia,2015,14,0,14
HRV,Croatia,EST,Estonia,2016,13,0,13
HRV,Croatia,EST,Estonia,2017,11,0,11
HRV,Croatia,SVN,Slovenia,2008,2265,555,1710
HRV,Croatia,SVN,Slovenia,2009,1976,751,1225
HRV,Croatia,SVN,Slovenia,2010,1777,828,949
HRV,Croatia,SVN,Slovenia,2011,1904,235,1669
HRV,Croatia,SVN,Slovenia,2012,2246,209,2037
HRV,Croatia,SVN,Slovenia,2013,752,113,639
HRV,Croatia,SVN,Slovenia,2014,2373,136,2237
HRV,Croatia,SVN,Slovenia,2015,1593,144,1449
HRV,Croatia,SVN,Slovenia,2016,1608,241,1367
HRV,Croatia,SVN,Slovenia,2017,1491,207,1284
CUB,Cuba,AUS,Australia,2008,38,5,33
CUB,Cuba,AUS,Australia,2009,38,6,32
CUB,Cuba,AUS,Australia,2010,33,0,33
CUB,Cuba,AUS,Australia,2011,19,5,14
CUB,Cuba,AUS,Australia,2012,56,11,45
CUB,Cuba,AUS,Australia,2013,54,0,54
CUB,Cuba,AUS,Australia,2014,19,7,12
CUB,Cuba,AUS,Australia,2015,19,0,19
CUB,Cuba,AUS,Australia,2016,15,0,15
CUB,Cuba,AUS,Australia,2017,32,0,32
CUB,Cuba,AUT,Austria,2008,66,48,18
CUB,Cuba,AUT,Austria,2009,62,32,30
CUB,Cuba,AUT,Austria,2010,43,38,5
CUB,Cuba,AUT,Austria,2011,60,35,25
CUB,Cuba,AUT,Austria,2012,54,32,22
CUB,Cuba,AUT,Austria,2013,86,45,41
CUB,Cuba,AUT,Austria,2014,77,45,32
CUB,Cuba,AUT,Austria,2015,73,49,24
CUB,Cuba,AUT,Austria,2016,64,48,16
CUB,Cuba,AUT,Austria,2017,81,37,44
CUB,Cuba,BEL,Belgium,2008,115,0,115
CUB,Cuba,BEL,Belgium,2009,110,0,110
CUB,Cuba,BEL,Belgium,2010,118,28,90
CUB,Cuba,BEL,Belgium,2011,100,0,100
CUB,Cuba,BEL,Belgium,2012,83,45,38
CUB,Cuba,BEL,Belgium,2013,84,38,46
CUB,Cuba,BEL,Belgium,2014,82,27,55
CUB,Cuba,BEL,Belgium,2015,69,36,33
CUB,Cuba,BEL,Belgium,2016,66,29,37
CUB,Cuba,BEL,Belgium,2017,82,23,59
CUB,Cuba,CAN,Canada,2008,1300,0,1300
CUB,Cuba,CAN,Canada,2009,1426,0,1426
CUB,Cuba,CAN,Canada,2010,961,0,961
CUB,Cuba,CAN,Canada,2011,961,0,961
CUB,Cuba,CAN,Canada,2012,1301,0,1301
CUB,Cuba,CAN,Canada,2013,1402,0,1402
CUB,Cuba,CAN,Canada,2014,1079,0,1079
CUB,Cuba,CAN,Canada,2015,827,0,827
CUB,Cuba,CAN,Canada,2016,1120,0,1120
CUB,Cuba,CAN,Canada,2017,875,0,875
CUB,Cuba,CZE,Czech Republic,2008,56,2,54
CUB,Cuba,CZE,Czech Republic,2009,25,1,24
CUB,Cuba,CZE,Czech Republic,2010,20,7,13
CUB,Cuba,CZE,Czech Republic,2011,22,20,2
CUB,Cuba,CZE,Czech Republic,2012,30,9,21
CUB,Cuba,CZE,Czech Republic,2013,42,10,32
CUB,Cuba,CZE,Czech Republic,2014,43,27,16
CUB,Cuba,CZE,Czech Republic,2015,65,21,44
CUB,Cuba,CZE,Czech Republic,2016,64,39,25
CUB,Cuba,CZE,Czech Republic,2017,37,73,-36
CUB,Cuba,DNK,Denmark,2008,35,2,33
CUB,Cuba,DNK,Denmark,2009,24,10,14
CUB,Cuba,DNK,Denmark,2010,22,7,15
CUB,Cuba,DNK,Denmark,2011,19,6,13
CUB,Cuba,DNK,Denmark,2012,19,11,8
CUB,Cuba,DNK,Denmark,2013,25,14,11
CUB,Cuba,DNK,Denmark,2014,28,4,24
CUB,Cuba,DNK,Denmark,2015,15,9,6
CUB,Cuba,DNK,Denmark,2016,22,14,8
CUB,Cuba,DNK,Denmark,2017,21,8,13
CUB,Cuba,FIN,Finland,2008,21,4,17
CUB,Cuba,FIN,Finland,2009,28,4,24
CUB,Cuba,FIN,Finland,2010,29,4,25
CUB,Cuba,FIN,Finland,2011,24,3,21
CUB,Cuba,FIN,Finland,2012,30,7,23
CUB,Cuba,FIN,Finland,2013,35,4,31
CUB,Cuba,FIN,Finland,2014,40,5,35
CUB,Cuba,FIN,Finland,2015,33,6,27
CUB,Cuba,FIN,Finland,2016,24,5,19
CUB,Cuba,FIN,Finland,2017,21,5,16
CUB,Cuba,FRA,France,2008,257,0,257
CUB,Cuba,FRA,France,2009,234,0,234
CUB,Cuba,FRA,France,2010,268,0,268
CUB,Cuba,FRA,France,2011,258,0,258
CUB,Cuba,FRA,France,2012,205,0,205
CUB,Cuba,FRA,France,2013,277,0,277
CUB,Cuba,FRA,France,2014,286,0,286
CUB,Cuba,FRA,France,2015,273,0,273
CUB,Cuba,FRA,France,2016,262,0,262
CUB,Cuba,FRA,France,2017,232,0,232
CUB,Cuba,DEU,Germany,2008,701,672,29
CUB,Cuba,DEU,Germany,2009,676,633,43
CUB,Cuba,DEU,Germany,2010,641,505,136
CUB,Cuba,DEU,Germany,2011,700,440,260
CUB,Cuba,DEU,Germany,2012,720,424,296
CUB,Cuba,DEU,Germany,2013,818,470,348
CUB,Cuba,DEU,Germany,2014,751,476,275
CUB,Cuba,DEU,Germany,2015,753,435,318
CUB,Cuba,DEU,Germany,2016,743,516,227
CUB,Cuba,DEU,Germany,2017,701,375,326
CUB,Cuba,HUN,Hungary,2008,26,0,26
CUB,Cuba,HUN,Hungary,2009,24,2,22
CUB,Cuba,HUN,Hungary,2010,13,7,6
CUB,Cuba,HUN,Hungary,2011,18,2,16
CUB,Cuba,HUN,Hungary,2012,21,3,18
CUB,Cuba,HUN,Hungary,2013,20,1,19
CUB,Cuba,HUN,Hungary,2014,37,5,32
CUB,Cuba,HUN,Hungary,2015,19,7,12
CUB,Cuba,HUN,Hungary,2016,20,3,17
CUB,Cuba,HUN,Hungary,2017,22,0,22
CUB,Cuba,ISL,Iceland,2008,6,3,3
CUB,Cuba,ISL,Iceland,2009,4,3,1
CUB,Cuba,ISL,Iceland,2010,2,0,2
CUB,Cuba,ISL,Iceland,2011,1,1,0
CUB,Cuba,ISL,Iceland,2012,5,0,5
CUB,Cuba,ISL,Iceland,2013,5,0,5
CUB,Cuba,ISL,Iceland,2014,7,2,5
CUB,Cuba,ISL,Iceland,2015,4,2,2
CUB,Cuba,ISL,Iceland,2016,3,4,-1
CUB,Cuba,ISL,Iceland,2017,4,1,3
CUB,Cuba,ITA,Italy,2008,2802,116,2686
CUB,Cuba,ITA,Italy,2009,2274,137,2137
CUB,Cuba,ITA,Italy,2010,2088,120,1968
CUB,Cuba,ITA,Italy,2011,2067,113,1954
CUB,Cuba,ITA,Italy,2012,1847,116,1731
CUB,Cuba,ITA,Italy,2013,1811,197,1614
CUB,Cuba,ITA,Italy,2014,1692,209,1483
CUB,Cuba,ITA,Italy,2015,1747,236,1511
CUB,Cuba,ITA,Italy,2016,1655,0,1655
CUB,Cuba,ITA,Italy,2017,1736,204,1532
CUB,Cuba,JPN,Japan,2008,175,156,19
CUB,Cuba,JPN,Japan,2009,169,158,11
CUB,Cuba,JPN,Japan,2010,172,179,-7
CUB,Cuba,JPN,Japan,2011,130,114,16
CUB,Cuba,JPN,Japan,2012,119,102,17
CUB,Cuba,JPN,Japan,2013,220,204,16
CUB,Cuba,JPN,Japan,2014,87,74,13
CUB,Cuba,JPN,Japan,2015,130,119,11
CUB,Cuba,JPN,Japan,2016,135,103,32
CUB,Cuba,JPN,Japan,2017,154,120,34
CUB,Cuba,KOR,Korea,2008,7,4,3
CUB,Cuba,KOR,Korea,2009,4,4,0
CUB,Cuba,KOR,Korea,2010,3,2,1
CUB,Cuba,KOR,Korea,2011,6,3,3
CUB,Cuba,KOR,Korea,2012,5,5,0
CUB,Cuba,KOR,Korea,2013,9,4,5
CUB,Cuba,KOR,Korea,2014,7,4,3
CUB,Cuba,KOR,Korea,2015,17,13,4
CUB,Cuba,KOR,Korea,2016,18,15,3
CUB,Cuba,KOR,Korea,2017,6,12,-6
CUB,Cuba,LUX,Luxembourg,2008,14,2,12
CUB,Cuba,LUX,Luxembourg,2009,4,9,-5
CUB,Cuba,LUX,Luxembourg,2010,12,1,11
CUB,Cuba,LUX,Luxembourg,2011,5,2,3
CUB,Cuba,LUX,Luxembourg,2012,9,3,6
CUB,Cuba,LUX,Luxembourg,2013,11,4,7
CUB,Cuba,LUX,Luxembourg,2014,9,2,7
CUB,Cuba,LUX,Luxembourg,2015,11,5,6
CUB,Cuba,LUX,Luxembourg,2016,12,1,11
CUB,Cuba,LUX,Luxembourg,2017,6,4,2
CUB,Cuba,MEX,Mexico,2008,970,0,970
CUB,Cuba,MEX,Mexico,2009,1735,0,1735
CUB,Cuba,MEX,Mexico,2010,1847,0,1847
CUB,Cuba,MEX,Mexico,2011,1722,0,1722
CUB,Cuba,MEX,Mexico,2012,1833,0,1833
CUB,Cuba,MEX,Mexico,2013,3249,0,3249
CUB,Cuba,MEX,Mexico,2014,2674,0,2674
CUB,Cuba,MEX,Mexico,2015,2611,0,2611
CUB,Cuba,MEX,Mexico,2016,2416,0,2416
CUB,Cuba,MEX,Mexico,2017,2129,0,2129
CUB,Cuba,NLD,Netherlands,2008,57,36,21
CUB,Cuba,NLD,Netherlands,2009,74,28,46
CUB,Cuba,NLD,Netherlands,2010,79,34,45
CUB,Cuba,NLD,Netherlands,2011,47,22,25
CUB,Cuba,NLD,Netherlands,2012,47,34,13
CUB,Cuba,NLD,Netherlands,2013,49,23,26
CUB,Cuba,NLD,Netherlands,2014,53,28,25
CUB,Cuba,NLD,Netherlands,2015,48,24,24
CUB,Cuba,NLD,Netherlands,2016,40,33,7
CUB,Cuba,NLD,Netherlands,2017,52,23,29
CUB,Cuba,NZL,New Zealand,2008,5,0,5
CUB,Cuba,NZL,New Zealand,2009,3,0,3
CUB,Cuba,NZL,New Zealand,2010,2,1,1
CUB,Cuba,NZL,New Zealand,2011,8,1,7
CUB,Cuba,NZL,New Zealand,2012,1,3,-2
CUB,Cuba,NZL,New Zealand,2013,8,0,8
CUB,Cuba,NZL,New Zealand,2014,2,0,2
CUB,Cuba,NZL,New Zealand,2015,11,4,7
CUB,Cuba,NZL,New Zealand,2016,6,1,5
CUB,Cuba,NZL,New Zealand,2017,3,5,-2
CUB,Cuba,NOR,Norway,2008,65,9,56
CUB,Cuba,NOR,Norway,2009,57,18,39
CUB,Cuba,NOR,Norway,2010,53,22,31
CUB,Cuba,NOR,Norway,2011,71,23,48
CUB,Cuba,NOR,Norway,2012,45,20,25
CUB,Cuba,NOR,Norway,2013,65,12,53
CUB,Cuba,NOR,Norway,2014,46,21,25
CUB,Cuba,NOR,Norway,2015,53,19,34
CUB,Cuba,NOR,Norway,2016,55,17,38
CUB,Cuba,NOR,Norway,2017,43,14,29
CUB,Cuba,POL,Poland,2009,32,0,32
CUB,Cuba,POL,Poland,2010,39,0,39
CUB,Cuba,POL,Poland,2011,55,0,55
CUB,Cuba,POL,Poland,2012,59,0,59
CUB,Cuba,POL,Poland,2013,61,0,61
CUB,Cuba,POL,Poland,2014,28,0,28
CUB,Cuba,POL,Poland,2015,65,0,65
CUB,Cuba,POL,Poland,2016,44,0,44
CUB,Cuba,POL,Poland,2017,51,0,51
CUB,Cuba,SVK,Slovak Republic,2008,10,3,7
CUB,Cuba,SVK,Slovak Republic,2009,4,6,-2
CUB,Cuba,SVK,Slovak Republic,2010,3,7,-4
CUB,Cuba,SVK,Slovak Republic,2011,7,2,5
CUB,Cuba,SVK,Slovak Republic,2012,7,0,7
CUB,Cuba,SVK,Slovak Republic,2013,1,0,1
CUB,Cuba,SVK,Slovak Republic,2014,1,0,1
CUB,Cuba,SVK,Slovak Republic,2015,3,0,3
CUB,Cuba,SVK,Slovak Republic,2016,1,0,1
CUB,Cuba,SVK,Slovak Republic,2017,1,0,1
CUB,Cuba,ESP,Spain,2008,8911,1740,7171
CUB,Cuba,ESP,Spain,2009,5634,2164,3470
CUB,Cuba,ESP,Spain,2010,6114,2272,3842
CUB,Cuba,ESP,Spain,2011,7399,2088,5311
CUB,Cuba,ESP,Spain,2012,5730,2420,3310
CUB,Cuba,ESP,Spain,2013,5116,3076,2040
CUB,Cuba,ESP,Spain,2014,4608,2105,2503
CUB,Cuba,ESP,Spain,2015,4853,1633,3220
CUB,Cuba,ESP,Spain,2016,5871,1544,4327
CUB,Cuba,ESP,Spain,2017,7991,2007,5984
CUB,Cuba,SWE,Sweden,2008,145,19,126
CUB,Cuba,SWE,Sweden,2009,131,12,119
CUB,Cuba,SWE,Sweden,2010,106,23,83
CUB,Cuba,SWE,Sweden,2011,100,23,77
CUB,Cuba,SWE,Sweden,2012,97,21,76
CUB,Cuba,SWE,Sweden,2013,100,13,87
CUB,Cuba,SWE,Sweden,2014,95,32,63
CUB,Cuba,SWE,Sweden,2015,82,17,65
CUB,Cuba,SWE,Sweden,2016,101,17,84
CUB,Cuba,SWE,Sweden,2017,93,17,76
CUB,Cuba,CHE,Switzerland,2010,193,57,136
CUB,Cuba,CHE,Switzerland,2011,160,55,105
CUB,Cuba,CHE,Switzerland,2012,134,60,74
CUB,Cuba,CHE,Switzerland,2013,172,49,123
CUB,Cuba,CHE,Switzerland,2014,123,63,60
CUB,Cuba,CHE,Switzerland,2015,141,52,89
CUB,Cuba,CHE,Switzerland,2016,141,50,91
CUB,Cuba,CHE,Switzerland,2017,126,49,77
CUB,Cuba,TUR,Turkey,2010,4,0,4
CUB,Cuba,TUR,Turkey,2016,248,84,164
CUB,Cuba,TUR,Turkey,2017,192,176,16
CUB,Cuba,GBR,United Kingdom,2014,1000,0,1000
CUB,Cuba,USA,United States,2008,49500,0,49500
CUB,Cuba,USA,United States,2009,38954,0,38954
CUB,Cuba,USA,United States,2010,33573,0,33573
CUB,Cuba,USA,United States,2011,36452,0,36452
CUB,Cuba,USA,United States,2012,32820,0,32820
CUB,Cuba,USA,United States,2013,32219,0,32219
CUB,Cuba,USA,United States,2014,46679,0,46679
CUB,Cuba,USA,United States,2015,54396,0,54396
CUB,Cuba,USA,United States,2016,66516,0,66516
CUB,Cuba,USA,United States,2017,65028,0,65028
CUB,Cuba,CHL,Chile,2008,333,0,333
CUB,Cuba,CHL,Chile,2009,270,0,270
CUB,Cuba,CHL,Chile,2010,313,0,313
CUB,Cuba,CHL,Chile,2011,251,0,251
CUB,Cuba,CHL,Chile,2012,267,0,267
CUB,Cuba,CHL,Chile,2013,339,0,339
CUB,Cuba,CHL,Chile,2014,479,0,479
CUB,Cuba,CHL,Chile,2015,777,0,777
CUB,Cuba,CHL,Chile,2016,721,0,721
CUB,Cuba,EST,Estonia,2008,0,0,0
CUB,Cuba,EST,Estonia,2009,1,0,1
CUB,Cuba,EST,Estonia,2010,0,0,0
CUB,Cuba,EST,Estonia,2011,0,0,0
CUB,Cuba,EST,Estonia,2012,0,0,0
CUB,Cuba,EST,Estonia,2013,0,0,0
CUB,Cuba,EST,Estonia,2014,0,0,0
CUB,Cuba,EST,Estonia,2015,1,0,1
CUB,Cuba,EST,Estonia,2016,5,0,5
CUB,Cuba,EST,Estonia,2017,2,0,2
CUB,Cuba,ISR,Israel,2008,63,0,63
CUB,Cuba,ISR,Israel,2009,41,0,41
CUB,Cuba,ISR,Israel,2010,36,0,36
CUB,Cuba,ISR,Israel,2011,54,0,54
CUB,Cuba,ISR,Israel,2012,64,0,64
CUB,Cuba,ISR,Israel,2013,72,0,72
CUB,Cuba,ISR,Israel,2014,104,0,104
CUB,Cuba,ISR,Israel,2015,41,0,41
CUB,Cuba,ISR,Israel,2016,11,0,11
CUB,Cuba,ISR,Israel,2017,5,0,5
CUB,Cuba,SVN,Slovenia,2008,16,0,16
CUB,Cuba,SVN,Slovenia,2009,3,0,3
CUB,Cuba,SVN,Slovenia,2011,1,0,1
CUB,Cuba,SVN,Slovenia,2012,1,4,-3
CUB,Cuba,SVN,Slovenia,2013,2,0,2
CUB,Cuba,SVN,Slovenia,2015,8,2,6
CUB,Cuba,SVN,Slovenia,2016,2,0,2
CUB,Cuba,SVN,Slovenia,2017,6,0,6
CYP,Cyprus,AUS,Australia,2008,12,133,-121
CYP,Cyprus,AUS,Australia,2009,8,117,-109
CYP,Cyprus,AUS,Australia,2010,17,106,-89
CYP,Cyprus,AUS,Australia,2011,15,100,-85
CYP,Cyprus,AUS,Australia,2012,14,78,-64
CYP,Cyprus,AUS,Australia,2013,24,89,-65
CYP,Cyprus,AUS,Australia,2014,49,100,-51
CYP,Cyprus,AUS,Australia,2015,34,100,-66
CYP,Cyprus,AUS,Australia,2016,30,100,-70
CYP,Cyprus,AUS,Australia,2017,35,0,35
CYP,Cyprus,AUT,Austria,2008,25,14,11
CYP,Cyprus,AUT,Austria,2009,27,18,9
CYP,Cyprus,AUT,Austria,2010,26,24,2
CYP,Cyprus,AUT,Austria,2011,19,16,3
CYP,Cyprus,AUT,Austria,2012,22,21,1
CYP,Cyprus,AUT,Austria,2013,51,28,23
CYP,Cyprus,AUT,Austria,2014,38,34,4
CYP,Cyprus,AUT,Austria,2015,31,23,8
CYP,Cyprus,AUT,Austria,2016,43,21,22
CYP,Cyprus,AUT,Austria,2017,32,33,-1
CYP,Cyprus,BEL,Belgium,2008,52,0,52
CYP,Cyprus,BEL,Belgium,2009,69,0,69
CYP,Cyprus,BEL,Belgium,2010,69,45,24
CYP,Cyprus,BEL,Belgium,2011,45,0,45
CYP,Cyprus,BEL,Belgium,2012,56,50,6
CYP,Cyprus,BEL,Belgium,2013,78,37,41
CYP,Cyprus,BEL,Belgium,2014,69,37,32
CYP,Cyprus,BEL,Belgium,2015,60,43,17
CYP,Cyprus,BEL,Belgium,2016,62,33,29
CYP,Cyprus,BEL,Belgium,2017,50,30,20
CYP,Cyprus,CAN,Canada,2008,7,0,7
CYP,Cyprus,CAN,Canada,2009,6,0,6
CYP,Cyprus,CAN,Canada,2010,18,0,18
CYP,Cyprus,CAN,Canada,2011,6,0,6
CYP,Cyprus,CAN,Canada,2012,12,0,12
CYP,Cyprus,CAN,Canada,2013,16,0,16
CYP,Cyprus,CAN,Canada,2014,28,0,28
CYP,Cyprus,CAN,Canada,2015,27,0,27
CYP,Cyprus,CAN,Canada,2016,15,0,15
CYP,Cyprus,CAN,Canada,2017,15,0,15
CYP,Cyprus,CZE,Czech Republic,2008,9,0,9
CYP,Cyprus,CZE,Czech Republic,2009,9,1,8
CYP,Cyprus,CZE,Czech Republic,2010,9,1,8
CYP,Cyprus,CZE,Czech Republic,2011,6,1,5
CYP,Cyprus,CZE,Czech Republic,2012,2,0,2
CYP,Cyprus,CZE,Czech Republic,2013,6,4,2
CYP,Cyprus,CZE,Czech Republic,2014,9,3,6
CYP,Cyprus,CZE,Czech Republic,2015,6,0,6
CYP,Cyprus,CZE,Czech Republic,2016,8,0,8
CYP,Cyprus,CZE,Czech Republic,2017,17,0,17
CYP,Cyprus,DNK,Denmark,2008,3,5,-2
CYP,Cyprus,DNK,Denmark,2009,4,5,-1
CYP,Cyprus,DNK,Denmark,2010,4,8,-4
CYP,Cyprus,DNK,Denmark,2011,10,6,4
CYP,Cyprus,DNK,Denmark,2012,12,7,5
CYP,Cyprus,DNK,Denmark,2013,16,10,6
CYP,Cyprus,DNK,Denmark,2014,26,11,15
CYP,Cyprus,DNK,Denmark,2015,27,10,17
CYP,Cyprus,DNK,Denmark,2016,31,12,19
CYP,Cyprus,DNK,Denmark,2017,25,23,2
CYP,Cyprus,FIN,Finland,2008,3,0,3
CYP,Cyprus,FIN,Finland,2009,2,2,0
CYP,Cyprus,FIN,Finland,2010,7,1,6
CYP,Cyprus,FIN,Finland,2011,7,0,7
CYP,Cyprus,FIN,Finland,2012,3,3,0
CYP,Cyprus,FIN,Finland,2013,12,2,10
CYP,Cyprus,FIN,Finland,2014,8,3,5
CYP,Cyprus,FIN,Finland,2015,12,3,9
CYP,Cyprus,FIN,Finland,2016,5,5,0
CYP,Cyprus,FIN,Finland,2017,7,4,3
CYP,Cyprus,FRA,France,2008,0,0,0
CYP,Cyprus,FRA,France,2009,0,0,0
CYP,Cyprus,FRA,France,2010,0,0,0
CYP,Cyprus,FRA,France,2011,0,0,0
CYP,Cyprus,FRA,France,2012,0,0,0
CYP,Cyprus,FRA,France,2013,48,0,48
CYP,Cyprus,FRA,France,2014,16,0,16
CYP,Cyprus,FRA,France,2015,110,0,110
CYP,Cyprus,FRA,France,2016,65,0,65
CYP,Cyprus,FRA,France,2017,24,0,24
CYP,Cyprus,DEU,Germany,2008,134,127,7
CYP,Cyprus,DEU,Germany,2009,155,135,20
CYP,Cyprus,DEU,Germany,2010,171,119,52
CYP,Cyprus,DEU,Germany,2011,273,109,164
CYP,Cyprus,DEU,Germany,2012,380,120,260
CYP,Cyprus,DEU,Germany,2013,511,186,325
CYP,Cyprus,DEU,Germany,2014,531,292,239
CYP,Cyprus,DEU,Germany,2015,465,277,188
CYP,Cyprus,DEU,Germany,2016,492,274,218
CYP,Cyprus,DEU,Germany,2017,465,290,175
CYP,Cyprus,HUN,Hungary,2008,37,15,22
CYP,Cyprus,HUN,Hungary,2009,28,7,21
CYP,Cyprus,HUN,Hungary,2010,18,11,7
CYP,Cyprus,HUN,Hungary,2011,32,0,32
CYP,Cyprus,HUN,Hungary,2012,27,39,-12
CYP,Cyprus,HUN,Hungary,2013,24,13,11
CYP,Cyprus,HUN,Hungary,2014,15,20,-5
CYP,Cyprus,HUN,Hungary,2015,8,16,-8
CYP,Cyprus,HUN,Hungary,2016,23,18,5
CYP,Cyprus,HUN,Hungary,2017,25,0,25
CYP,Cyprus,ISL,Iceland,2008,1,1,0
CYP,Cyprus,ISL,Iceland,2009,2,1,1
CYP,Cyprus,ISL,Iceland,2010,1,2,-1
CYP,Cyprus,ISL,Iceland,2011,0,0,0
CYP,Cyprus,ISL,Iceland,2012,0,0,0
CYP,Cyprus,ISL,Iceland,2013,0,1,-1
CYP,Cyprus,ISL,Iceland,2014,0,0,0
CYP,Cyprus,ISL,Iceland,2015,0,0,0
CYP,Cyprus,ISL,Iceland,2016,2,0,2
CYP,Cyprus,ISL,Iceland,2017,4,0,4
CYP,Cyprus,ITA,Italy,2008,18,4,14
CYP,Cyprus,ITA,Italy,2009,22,3,19
CYP,Cyprus,ITA,Italy,2010,10,2,8
CYP,Cyprus,ITA,Italy,2011,17,2,15
CYP,Cyprus,ITA,Italy,2012,15,1,14
CYP,Cyprus,ITA,Italy,2013,17,1,16
CYP,Cyprus,ITA,Italy,2014,13,2,11
CYP,Cyprus,ITA,Italy,2015,20,6,14
CYP,Cyprus,ITA,Italy,2016,21,0,21
CYP,Cyprus,ITA,Italy,2017,23,6,17
CYP,Cyprus,JPN,Japan,2008,8,5,3
CYP,Cyprus,JPN,Japan,2009,3,4,-1
CYP,Cyprus,JPN,Japan,2010,6,2,4
CYP,Cyprus,JPN,Japan,2011,3,3,0
CYP,Cyprus,JPN,Japan,2012,3,6,-3
CYP,Cyprus,JPN,Japan,2013,11,5,6
CYP,Cyprus,JPN,Japan,2014,11,4,7
CYP,Cyprus,JPN,Japan,2015,11,9,2
CYP,Cyprus,JPN,Japan,2016,15,9,6
CYP,Cyprus,JPN,Japan,2017,14,6,8
CYP,Cyprus,KOR,Korea,2008,4,1,3
CYP,Cyprus,KOR,Korea,2009,1,1,0
CYP,Cyprus,KOR,Korea,2010,5,3,2
CYP,Cyprus,KOR,Korea,2011,9,0,9
CYP,Cyprus,KOR,Korea,2012,6,5,1
CYP,Cyprus,KOR,Korea,2013,2,4,-2
CYP,Cyprus,KOR,Korea,2014,3,4,-1
CYP,Cyprus,KOR,Korea,2015,6,5,1
CYP,Cyprus,KOR,Korea,2016,8,3,5
CYP,Cyprus,KOR,Korea,2017,3,5,-2
CYP,Cyprus,LUX,Luxembourg,2008,5,2,3
CYP,Cyprus,LUX,Luxembourg,2009,10,0,10
CYP,Cyprus,LUX,Luxembourg,2010,8,1,7
CYP,Cyprus,LUX,Luxembourg,2011,11,1,10
CYP,Cyprus,LUX,Luxembourg,2012,11,4,7
CYP,Cyprus,LUX,Luxembourg,2013,11,3,8
CYP,Cyprus,LUX,Luxembourg,2014,24,8,16
CYP,Cyprus,LUX,Luxembourg,2015,15,7,8
CYP,Cyprus,LUX,Luxembourg,2016,21,12,9
CYP,Cyprus,LUX,Luxembourg,2017,24,12,12
CYP,Cyprus,MEX,Mexico,2008,1,0,1
CYP,Cyprus,MEX,Mexico,2010,1,0,1
CYP,Cyprus,MEX,Mexico,2011,2,0,2
CYP,Cyprus,MEX,Mexico,2012,2,0,2
CYP,Cyprus,MEX,Mexico,2013,2,0,2
CYP,Cyprus,MEX,Mexico,2014,2,0,2
CYP,Cyprus,MEX,Mexico,2015,2,0,2
CYP,Cyprus,NLD,Netherlands,2008,50,37,13
CYP,Cyprus,NLD,Netherlands,2009,53,25,28
CYP,Cyprus,NLD,Netherlands,2010,66,38,28
CYP,Cyprus,NLD,Netherlands,2011,94,41,53
CYP,Cyprus,NLD,Netherlands,2012,104,61,43
CYP,Cyprus,NLD,Netherlands,2013,129,98,31
CYP,Cyprus,NLD,Netherlands,2014,137,99,38
CYP,Cyprus,NLD,Netherlands,2015,161,97,64
CYP,Cyprus,NLD,Netherlands,2016,216,118,98
CYP,Cyprus,NLD,Netherlands,2017,296,135,161
CYP,Cyprus,NZL,New Zealand,2008,2,1,1
CYP,Cyprus,NZL,New Zealand,2009,0,0,0
CYP,Cyprus,NZL,New Zealand,2010,3,1,2
CYP,Cyprus,NZL,New Zealand,2011,2,3,-1
CYP,Cyprus,NZL,New Zealand,2012,3,0,3
CYP,Cyprus,NZL,New Zealand,2013,2,2,0
CYP,Cyprus,NZL,New Zealand,2014,1,0,1
CYP,Cyprus,NZL,New Zealand,2015,4,1,3
CYP,Cyprus,NZL,New Zealand,2016,1,2,-1
CYP,Cyprus,NZL,New Zealand,2017,2,1,1
CYP,Cyprus,NOR,Norway,2008,5,0,5
CYP,Cyprus,NOR,Norway,2009,5,2,3
CYP,Cyprus,NOR,Norway,2010,9,2,7
CYP,Cyprus,NOR,Norway,2011,8,4,4
CYP,Cyprus,NOR,Norway,2012,7,5,2
CYP,Cyprus,NOR,Norway,2013,17,3,14
CYP,Cyprus,NOR,Norway,2014,20,5,15
CYP,Cyprus,NOR,Norway,2015,18,5,13
CYP,Cyprus,NOR,Norway,2016,13,6,7
CYP,Cyprus,NOR,Norway,2017,10,7,3
CYP,Cyprus,POL,Poland,2008,6,0,6
CYP,Cyprus,POL,Poland,2009,7,0,7
CYP,Cyprus,POL,Poland,2010,8,0,8
CYP,Cyprus,POL,Poland,2011,6,0,6
CYP,Cyprus,POL,Poland,2012,8,0,8
CYP,Cyprus,POL,Poland,2013,8,0,8
CYP,Cyprus,POL,Poland,2014,8,0,8
CYP,Cyprus,POL,Poland,2015,8,0,8
CYP,Cyprus,POL,Poland,2016,6,0,6
CYP,Cyprus,POL,Poland,2017,8,0,8
CYP,Cyprus,SVK,Slovak Republic,2008,2,0,2
CYP,Cyprus,SVK,Slovak Republic,2009,6,0,6
CYP,Cyprus,SVK,Slovak Republic,2010,4,1,3
CYP,Cyprus,SVK,Slovak Republic,2011,2,0,2
CYP,Cyprus,SVK,Slovak Republic,2012,2,0,2
CYP,Cyprus,SVK,Slovak Republic,2013,1,0,1
CYP,Cyprus,SVK,Slovak Republic,2014,3,0,3
CYP,Cyprus,SVK,Slovak Republic,2015,2,0,2
CYP,Cyprus,SVK,Slovak Republic,2016,3,0,3
CYP,Cyprus,SVK,Slovak Republic,2017,1,0,1
CYP,Cyprus,ESP,Spain,2008,30,6,24
CYP,Cyprus,ESP,Spain,2009,20,14,6
CYP,Cyprus,ESP,Spain,2010,27,21,6
CYP,Cyprus,ESP,Spain,2011,32,16,16
CYP,Cyprus,ESP,Spain,2012,34,11,23
CYP,Cyprus,ESP,Spain,2013,42,12,30
CYP,Cyprus,ESP,Spain,2014,48,19,29
CYP,Cyprus,ESP,Spain,2015,52,6,46
CYP,Cyprus,ESP,Spain,2016,66,7,59
CYP,Cyprus,ESP,Spain,2017,64,28,36
CYP,Cyprus,SWE,Sweden,2008,41,6,35
CYP,Cyprus,SWE,Sweden,2009,22,9,13
CYP,Cyprus,SWE,Sweden,2010,20,11,9
CYP,Cyprus,SWE,Sweden,2011,23,14,9
CYP,Cyprus,SWE,Sweden,2012,24,12,12
CYP,Cyprus,SWE,Sweden,2013,51,8,43
CYP,Cyprus,SWE,Sweden,2014,33,11,22
CYP,Cyprus,SWE,Sweden,2015,54,13,41
CYP,Cyprus,SWE,Sweden,2016,46,14,32
CYP,Cyprus,SWE,Sweden,2017,53,13,40
CYP,Cyprus,CHE,Switzerland,2008,25,16,9
CYP,Cyprus,CHE,Switzerland,2009,44,24,20
CYP,Cyprus,CHE,Switzerland,2010,31,18,13
CYP,Cyprus,CHE,Switzerland,2011,44,34,10
CYP,Cyprus,CHE,Switzerland,2012,67,25,42
CYP,Cyprus,CHE,Switzerland,2013,87,15,72
CYP,Cyprus,CHE,Switzerland,2014,67,34,33
CYP,Cyprus,CHE,Switzerland,2015,95,42,53
CYP,Cyprus,CHE,Switzerland,2016,92,33,59
CYP,Cyprus,CHE,Switzerland,2017,117,59,58
CYP,Cyprus,TUR,Turkey,2010,4,0,4
CYP,Cyprus,GBR,United Kingdom,2013,2000,0,2000
CYP,Cyprus,GBR,United Kingdom,2017,9000,0,9000
CYP,Cyprus,USA,United States,2008,141,0,141
CYP,Cyprus,USA,United States,2009,142,0,142
CYP,Cyprus,USA,United States,2010,122,0,122
CYP,Cyprus,USA,United States,2011,101,0,101
CYP,Cyprus,USA,United States,2012,107,0,107
CYP,Cyprus,USA,United States,2013,126,0,126
CYP,Cyprus,USA,United States,2014,129,0,129
CYP,Cyprus,USA,United States,2015,113,0,113
CYP,Cyprus,USA,United States,2016,131,0,131
CYP,Cyprus,USA,United States,2017,117,0,117
CYP,Cyprus,CHL,Chile,2008,0,0,0
CYP,Cyprus,CHL,Chile,2009,0,0,0
CYP,Cyprus,CHL,Chile,2010,0,0,0
CYP,Cyprus,CHL,Chile,2011,2,0,2
CYP,Cyprus,CHL,Chile,2012,0,0,0
CYP,Cyprus,CHL,Chile,2013,1,0,1
CYP,Cyprus,CHL,Chile,2014,1,0,1
CYP,Cyprus,CHL,Chile,2015,3,0,3
CYP,Cyprus,CHL,Chile,2016,1,0,1
CYP,Cyprus,EST,Estonia,2008,1,0,1
CYP,Cyprus,EST,Estonia,2009,2,0,2
CYP,Cyprus,EST,Estonia,2010,0,0,0
CYP,Cyprus,EST,Estonia,2011,0,0,0
CYP,Cyprus,EST,Estonia,2012,1,0,1
CYP,Cyprus,EST,Estonia,2013,0,0,0
CYP,Cyprus,EST,Estonia,2014,0,0,0
CYP,Cyprus,EST,Estonia,2015,4,0,4
CYP,Cyprus,EST,Estonia,2016,5,0,5
CYP,Cyprus,EST,Estonia,2017,1,0,1
CYP,Cyprus,SVN,Slovenia,2008,2,0,2
CYP,Cyprus,SVN,Slovenia,2009,1,0,1
CYP,Cyprus,SVN,Slovenia,2012,7,0,7
CYP,Cyprus,SVN,Slovenia,2013,5,0,5
CYP,Cyprus,SVN,Slovenia,2014,4,1,3
CYP,Cyprus,SVN,Slovenia,2015,3,0,3
CYP,Cyprus,SVN,Slovenia,2016,2,0,2
CYP,Cyprus,SVN,Slovenia,2017,6,0,6
CZE,Czech Republic,AUS,Australia,2008,202,112,90
CZE,Czech Republic,AUS,Australia,2009,188,67,121
CZE,Czech Republic,AUS,Australia,2010,162,67,95
CZE,Czech Republic,AUS,Australia,2011,175,36,139
CZE,Czech Republic,AUS,Australia,2012,194,52,142
CZE,Czech Republic,AUS,Australia,2013,218,56,162
CZE,Czech Republic,AUS,Australia,2014,226,75,151
CZE,Czech Republic,AUS,Australia,2015,225,62,163
CZE,Czech Republic,AUS,Australia,2016,218,67,151
CZE,Czech Republic,AUS,Australia,2017,218,75,143
CZE,Czech Republic,AUT,Austria,2008,1323,503,820
CZE,Czech Republic,AUT,Austria,2009,1251,386,865
CZE,Czech Republic,AUT,Austria,2010,1144,385,759
CZE,Czech Republic,AUT,Austria,2011,1565,326,1239
CZE,Czech Republic,AUT,Austria,2012,1755,188,1567
CZE,Czech Republic,AUT,Austria,2013,1815,207,1608
CZE,Czech Republic,AUT,Austria,2014,1834,116,1718
CZE,Czech Republic,AUT,Austria,2015,1760,123,1637
CZE,Czech Republic,AUT,Austria,2016,1527,127,1400
CZE,Czech Republic,AUT,Austria,2017,1591,118,1473
CZE,Czech Republic,BEL,Belgium,2008,526,57,469
CZE,Czech Republic,BEL,Belgium,2009,525,38,487
CZE,Czech Republic,BEL,Belgium,2010,556,48,508
CZE,Czech Republic,BEL,Belgium,2011,560,36,524
CZE,Czech Republic,BEL,Belgium,2012,498,43,455
CZE,Czech Republic,BEL,Belgium,2013,500,61,439
CZE,Czech Republic,BEL,Belgium,2014,388,47,341
CZE,Czech Republic,BEL,Belgium,2015,341,45,296
CZE,Czech Republic,BEL,Belgium,2016,292,58,234
CZE,Czech Republic,BEL,Belgium,2017,316,51,265
CZE,Czech Republic,CAN,Canada,2008,104,211,-107
CZE,Czech Republic,CAN,Canada,2009,159,156,3
CZE,Czech Republic,CAN,Canada,2010,168,160,8
CZE,Czech Republic,CAN,Canada,2011,128,130,-2
CZE,Czech Republic,CAN,Canada,2012,173,107,66
CZE,Czech Republic,CAN,Canada,2013,174,112,62
CZE,Czech Republic,CAN,Canada,2014,224,110,114
CZE,Czech Republic,CAN,Canada,2015,281,84,197
CZE,Czech Republic,CAN,Canada,2016,325,114,211
CZE,Czech Republic,CAN,Canada,2017,315,125,190
CZE,Czech Republic,DNK,Denmark,2008,146,24,122
CZE,Czech Republic,DNK,Denmark,2009,131,31,100
CZE,Czech Republic,DNK,Denmark,2010,131,29,102
CZE,Czech Republic,DNK,Denmark,2011,166,32,134
CZE,Czech Republic,DNK,Denmark,2012,155,19,136
CZE,Czech Republic,DNK,Denmark,2013,165,28,137
CZE,Czech Republic,DNK,Denmark,2014,270,30,240
CZE,Czech Republic,DNK,Denmark,2015,338,20,318
CZE,Czech Republic,DNK,Denmark,2016,373,27,346
CZE,Czech Republic,DNK,Denmark,2017,332,24,308
CZE,Czech Republic,FIN,Finland,2008,41,39,2
CZE,Czech Republic,FIN,Finland,2009,50,18,32
CZE,Czech Republic,FIN,Finland,2010,45,27,18
CZE,Czech Republic,FIN,Finland,2011,47,14,33
CZE,Czech Republic,FIN,Finland,2012,62,24,38
CZE,Czech Republic,FIN,Finland,2013,51,22,29
CZE,Czech Republic,FIN,Finland,2014,70,34,36
CZE,Czech Republic,FIN,Finland,2015,69,24,45
CZE,Czech Republic,FIN,Finland,2016,69,39,30
CZE,Czech Republic,FIN,Finland,2017,71,36,35
CZE,Czech Republic,FRA,France,2008,0,286,-286
CZE,Czech Republic,FRA,France,2009,0,306,-306
CZE,Czech Republic,FRA,France,2010,0,267,-267
CZE,Czech Republic,FRA,France,2011,0,187,-187
CZE,Czech Republic,FRA,France,2012,0,215,-215
CZE,Czech Republic,FRA,France,2013,640,233,407
CZE,Czech Republic,FRA,France,2014,525,273,252
CZE,Czech Republic,FRA,France,2015,518,252,266
CZE,Czech Republic,FRA,France,2016,406,285,121
CZE,Czech Republic,FRA,France,2017,553,240,313
CZE,Czech Republic,DEU,Germany,2008,6309,4308,2001
CZE,Czech Republic,DEU,Germany,2009,5924,1975,3949
CZE,Czech Republic,DEU,Germany,2010,6063,2002,4061
CZE,Czech Republic,DEU,Germany,2011,8255,1338,6917
CZE,Czech Republic,DEU,Germany,2012,9221,1319,7902
CZE,Czech Republic,DEU,Germany,2013,9963,1676,8287
CZE,Czech Republic,DEU,Germany,2014,10776,1613,9163
CZE,Czech Republic,DEU,Germany,2015,10974,1123,9851
CZE,Czech Republic,DEU,Germany,2016,9618,1040,8578
CZE,Czech Republic,DEU,Germany,2017,9384,637,8747
CZE,Czech Republic,HUN,Hungary,2008,54,68,-14
CZE,Czech Republic,HUN,Hungary,2009,89,76,13
CZE,Czech Republic,HUN,Hungary,2010,70,81,-11
CZE,Czech Republic,HUN,Hungary,2011,56,88,-32
CZE,Czech Republic,HUN,Hungary,2012,63,123,-60
CZE,Czech Republic,HUN,Hungary,2013,64,374,-310
CZE,Czech Republic,HUN,Hungary,2014,60,709,-649
CZE,Czech Republic,HUN,Hungary,2015,65,776,-711
CZE,Czech Republic,HUN,Hungary,2016,79,911,-832
CZE,Czech Republic,HUN,Hungary,2017,68,1238,-1170
CZE,Czech Republic,ISL,Iceland,2008,111,3,108
CZE,Czech Republic,ISL,Iceland,2009,58,2,56
CZE,Czech Republic,ISL,Iceland,2010,40,2,38
CZE,Czech Republic,ISL,Iceland,2011,38,4,34
CZE,Czech Republic,ISL,Iceland,2012,26,0,26
CZE,Czech Republic,ISL,Iceland,2013,62,1,61
CZE,Czech Republic,ISL,Iceland,2014,114,2,112
CZE,Czech Republic,ISL,Iceland,2015,142,1,141
CZE,Czech Republic,ISL,Iceland,2016,197,5,192
CZE,Czech Republic,ISL,Iceland,2017,320,3,317
CZE,Czech Republic,ITA,Italy,2008,620,303,317
CZE,Czech Republic,ITA,Italy,2009,555,230,325
CZE,Czech Republic,ITA,Italy,2010,496,185,311
CZE,Czech Republic,ITA,Italy,2011,428,163,265
CZE,Czech Republic,ITA,Italy,2012,389,249,140
CZE,Czech Republic,ITA,Italy,2013,257,338,-81
CZE,Czech Republic,ITA,Italy,2014,253,357,-104
CZE,Czech Republic,ITA,Italy,2015,211,378,-167
CZE,Czech Republic,ITA,Italy,2016,212,425,-213
CZE,Czech Republic,ITA,Italy,2017,195,411,-216
CZE,Czech Republic,JPN,Japan,2008,915,594,321
CZE,Czech Republic,JPN,Japan,2009,720,372,348
CZE,Czech Republic,JPN,Japan,2010,512,320,192
CZE,Czech Republic,JPN,Japan,2011,618,230,388
CZE,Czech Republic,JPN,Japan,2012,400,417,-17
CZE,Czech Republic,JPN,Japan,2013,1062,367,695
CZE,Czech Republic,JPN,Japan,2014,410,375,35
CZE,Czech Republic,JPN,Japan,2015,867,320,547
CZE,Czech Republic,JPN,Japan,2016,704,341,363
CZE,Czech Republic,JPN,Japan,2017,695,428,267
CZE,Czech Republic,KOR,Korea,2008,62,726,-664
CZE,Czech Republic,KOR,Korea,2009,76,333,-257
CZE,Czech Republic,KOR,Korea,2010,67,364,-297
CZE,Czech Republic,KOR,Korea,2011,64,364,-300
CZE,Czech Republic,KOR,Korea,2012,76,404,-328
CZE,Czech Republic,KOR,Korea,2013,117,359,-242
CZE,Czech Republic,KOR,Korea,2014,93,368,-275
CZE,Czech Republic,KOR,Korea,2015,107,443,-336
CZE,Czech Republic,KOR,Korea,2016,111,469,-358
CZE,Czech Republic,KOR,Korea,2017,120,552,-432
CZE,Czech Republic,LUX,Luxembourg,2008,111,4,107
CZE,Czech Republic,LUX,Luxembourg,2009,94,0,94
CZE,Czech Republic,LUX,Luxembourg,2010,88,1,87
CZE,Czech Republic,LUX,Luxembourg,2011,109,1,108
CZE,Czech Republic,LUX,Luxembourg,2012,81,2,79
CZE,Czech Republic,LUX,Luxembourg,2013,63,2,61
CZE,Czech Republic,LUX,Luxembourg,2014,87,1,86
CZE,Czech Republic,LUX,Luxembourg,2015,100,2,98
CZE,Czech Republic,LUX,Luxembourg,2016,80,2,78
CZE,Czech Republic,LUX,Luxembourg,2017,94,1,93
CZE,Czech Republic,MEX,Mexico,2008,33,102,-69
CZE,Czech Republic,MEX,Mexico,2009,44,117,-73
CZE,Czech Republic,MEX,Mexico,2010,38,88,-50
CZE,Czech Republic,MEX,Mexico,2011,18,80,-62
CZE,Czech Republic,MEX,Mexico,2012,27,67,-40
CZE,Czech Republic,MEX,Mexico,2013,94,64,30
CZE,Czech Republic,MEX,Mexico,2014,49,99,-50
CZE,Czech Republic,MEX,Mexico,2015,34,123,-89
CZE,Czech Republic,MEX,Mexico,2016,36,103,-67
CZE,Czech Republic,MEX,Mexico,2017,24,138,-114
CZE,Czech Republic,NLD,Netherlands,2008,660,390,270
CZE,Czech Republic,NLD,Netherlands,2009,596,183,413
CZE,Czech Republic,NLD,Netherlands,2010,701,153,548
CZE,Czech Republic,NLD,Netherlands,2011,647,128,519
CZE,Czech Republic,NLD,Netherlands,2012,616,110,506
CZE,Czech Republic,NLD,Netherlands,2013,722,137,585
CZE,Czech Republic,NLD,Netherlands,2014,816,126,690
CZE,Czech Republic,NLD,Netherlands,2015,747,116,631
CZE,Czech Republic,NLD,Netherlands,2016,777,137,640
CZE,Czech Republic,NLD,Netherlands,2017,854,126,728
CZE,Czech Republic,NZL,New Zealand,2008,315,28,287
CZE,Czech Republic,NZL,New Zealand,2009,323,22,301
CZE,Czech Republic,NZL,New Zealand,2010,448,23,425
CZE,Czech Republic,NZL,New Zealand,2011,659,14,645
CZE,Czech Republic,NZL,New Zealand,2012,783,12,771
CZE,Czech Republic,NZL,New Zealand,2013,683,23,660
CZE,Czech Republic,NZL,New Zealand,2014,766,22,744
CZE,Czech Republic,NZL,New Zealand,2015,737,18,719
CZE,Czech Republic,NZL,New Zealand,2016,816,26,790
CZE,Czech Republic,NZL,New Zealand,2017,788,39,749
CZE,Czech Republic,NOR,Norway,2008,185,22,163
CZE,Czech Republic,NOR,Norway,2009,195,11,184
CZE,Czech Republic,NOR,Norway,2010,238,14,224
CZE,Czech Republic,NOR,Norway,2011,252,10,242
CZE,Czech Republic,NOR,Norway,2012,253,19,234
CZE,Czech Republic,NOR,Norway,2013,277,37,240
CZE,Czech Republic,NOR,Norway,2014,256,33,223
CZE,Czech Republic,NOR,Norway,2015,209,23,186
CZE,Czech Republic,NOR,Norway,2016,163,17,146
CZE,Czech Republic,NOR,Norway,2017,137,24,113
CZE,Czech Republic,POL,Poland,2008,146,1223,-1077
CZE,Czech Republic,POL,Poland,2009,176,858,-682
CZE,Czech Republic,POL,Poland,2010,195,723,-528
CZE,Czech Republic,POL,Poland,2011,205,612,-407
CZE,Czech Republic,POL,Poland,2012,185,576,-391
CZE,Czech Republic,POL,Poland,2013,215,587,-372
CZE,Czech Republic,POL,Poland,2014,216,640,-424
CZE,Czech Republic,POL,Poland,2015,223,606,-383
CZE,Czech Republic,POL,Poland,2016,229,740,-511
CZE,Czech Republic,POL,Poland,2017,223,779,-556
CZE,Czech Republic,SVK,Slovak Republic,2008,1037,7592,-6555
CZE,Czech Republic,SVK,Slovak Republic,2009,1037,5609,-4572
CZE,Czech Republic,SVK,Slovak Republic,2010,786,5086,-4300
CZE,Czech Republic,SVK,Slovak Republic,2011,600,4368,-3768
CZE,Czech Republic,SVK,Slovak Republic,2012,462,4825,-4363
CZE,Czech Republic,SVK,Slovak Republic,2013,402,6475,-6073
CZE,Czech Republic,SVK,Slovak Republic,2014,414,6903,-6489
CZE,Czech Republic,SVK,Slovak Republic,2015,589,6682,-6093
CZE,Czech Republic,SVK,Slovak Republic,2016,545,6706,-6161
CZE,Czech Republic,SVK,Slovak Republic,2017,475,6328,-5853
CZE,Czech Republic,ESP,Spain,2008,792,98,694
CZE,Czech Republic,ESP,Spain,2009,671,65,606
CZE,Czech Republic,ESP,Spain,2010,670,112,558
CZE,Czech Republic,ESP,Spain,2011,685,74,611
CZE,Czech Republic,ESP,Spain,2012,605,103,502
CZE,Czech Republic,ESP,Spain,2013,531,131,400
CZE,Czech Republic,ESP,Spain,2014,606,145,461
CZE,Czech Republic,ESP,Spain,2015,618,112,506
CZE,Czech Republic,ESP,Spain,2016,556,141,415
CZE,Czech Republic,ESP,Spain,2017,606,151,455
CZE,Czech Republic,SWE,Sweden,2008,325,46,279
CZE,Czech Republic,SWE,Sweden,2009,198,43,155
CZE,Czech Republic,SWE,Sweden,2010,164,59,105
CZE,Czech Republic,SWE,Sweden,2011,189,65,124
CZE,Czech Republic,SWE,Sweden,2012,200,67,133
CZE,Czech Republic,SWE,Sweden,2013,209,49,160
CZE,Czech Republic,SWE,Sweden,2014,210,66,144
CZE,Czech Republic,SWE,Sweden,2015,238,83,155
CZE,Czech Republic,SWE,Sweden,2016,227,86,141
CZE,Czech Republic,SWE,Sweden,2017,225,111,114
CZE,Czech Republic,CHE,Switzerland,2008,698,49,649
CZE,Czech Republic,CHE,Switzerland,2009,558,32,526
CZE,Czech Republic,CHE,Switzerland,2010,529,35,494
CZE,Czech Republic,CHE,Switzerland,2011,916,18,898
CZE,Czech Republic,CHE,Switzerland,2012,779,25,754
CZE,Czech Republic,CHE,Switzerland,2013,733,27,706
CZE,Czech Republic,CHE,Switzerland,2014,1267,34,1233
CZE,Czech Republic,CHE,Switzerland,2015,1152,31,1121
CZE,Czech Republic,CHE,Switzerland,2016,1029,33,996
CZE,Czech Republic,CHE,Switzerland,2017,1007,43,964
CZE,Czech Republic,TUR,Turkey,2010,50,489,-439
CZE,Czech Republic,TUR,Turkey,2016,161,451,-290
CZE,Czech Republic,TUR,Turkey,2017,109,600,-491
CZE,Czech Republic,GBR,United Kingdom,2011,4000,276,3724
CZE,Czech Republic,GBR,United Kingdom,2012,2000,262,1738
CZE,Czech Republic,GBR,United Kingdom,2013,2000,355,1645
CZE,Czech Republic,GBR,United Kingdom,2014,3000,366,2634
CZE,Czech Republic,GBR,United Kingdom,2015,4000,323,3677
CZE,Czech Republic,USA,United States,2008,227,2217,-1990
CZE,Czech Republic,USA,United States,2009,146,2464,-2318
CZE,Czech Republic,USA,United States,2010,190,1680,-1490
CZE,Czech Republic,USA,United States,2011,303,1321,-1018
CZE,Czech Republic,USA,United States,2012,677,1081,-404
CZE,Czech Republic,USA,United States,2013,676,812,-136
CZE,Czech Republic,USA,United States,2014,606,916,-310
CZE,Czech Republic,USA,United States,2015,637,832,-195
CZE,Czech Republic,USA,United States,2016,650,1063,-413
CZE,Czech Republic,USA,United States,2017,582,1073,-491
CZE,Czech Republic,CHL,Chile,2008,7,18,-11
CZE,Czech Republic,CHL,Chile,2009,31,24,7
CZE,Czech Republic,CHL,Chile,2010,92,19,73
CZE,Czech Republic,CHL,Chile,2011,7,7,0
CZE,Czech Republic,CHL,Chile,2012,20,15,5
CZE,Czech Republic,CHL,Chile,2013,58,10,48
CZE,Czech Republic,CHL,Chile,2014,34,21,13
CZE,Czech Republic,CHL,Chile,2015,36,20,16
CZE,Czech Republic,CHL,Chile,2016,21,27,-6
CZE,Czech Republic,EST,Estonia,2008,17,10,7
CZE,Czech Republic,EST,Estonia,2009,22,14,8
CZE,Czech Republic,EST,Estonia,2010,10,12,-2
CZE,Czech Republic,EST,Estonia,2011,1,13,-12
CZE,Czech Republic,EST,Estonia,2012,0,13,-13
CZE,Czech Republic,EST,Estonia,2013,1,20,-19
CZE,Czech Republic,EST,Estonia,2014,0,16,-16
CZE,Czech Republic,EST,Estonia,2015,77,23,54
CZE,Czech Republic,EST,Estonia,2016,79,15,64
CZE,Czech Republic,EST,Estonia,2017,113,10,103
CZE,Czech Republic,SVN,Slovenia,2008,113,23,90
CZE,Czech Republic,SVN,Slovenia,2009,171,31,140
CZE,Czech Republic,SVN,Slovenia,2010,28,18,10
CZE,Czech Republic,SVN,Slovenia,2011,180,16,164
CZE,Czech Republic,SVN,Slovenia,2012,212,13,199
CZE,Czech Republic,SVN,Slovenia,2013,200,28,172
CZE,Czech Republic,SVN,Slovenia,2014,228,42,186
CZE,Czech Republic,SVN,Slovenia,2015,233,29,204
CZE,Czech Republic,SVN,Slovenia,2016,262,30,232
CZE,Czech Republic,SVN,Slovenia,2017,197,38,159
PRK,Democratic People's Republic of Korea,AUS,Australia,2009,0,96,-96
PRK,Democratic People's Republic of Korea,AUS,Australia,2010,0,109,-109
PRK,Democratic People's Republic of Korea,AUS,Australia,2011,0,114,-114
PRK,Democratic People's Republic of Korea,AUS,Australia,2012,0,101,-101
PRK,Democratic People's Republic of Korea,AUS,Australia,2013,0,79,-79
PRK,Democratic People's Republic of Korea,AUS,Australia,2014,0,69,-69
PRK,Democratic People's Republic of Korea,AUS,Australia,2015,0,0,0
PRK,Democratic People's Republic of Korea,AUS,Australia,2016,0,100,-100
PRK,Democratic People's Republic of Korea,AUS,Australia,2017,0,0,0
PRK,Democratic People's Republic of Korea,AUT,Austria,2008,11,27,-16
PRK,Democratic People's Republic of Korea,AUT,Austria,2009,9,46,-37
PRK,Democratic People's Republic of Korea,AUT,Austria,2010,14,17,-3
PRK,Democratic People's Republic of Korea,AUT,Austria,2011,12,15,-3
PRK,Democratic People's Republic of Korea,AUT,Austria,2012,14,12,2
PRK,Democratic People's Republic of Korea,AUT,Austria,2013,29,9,20
PRK,Democratic People's Republic of Korea,AUT,Austria,2014,27,10,17
PRK,Democratic People's Republic of Korea,AUT,Austria,2015,42,16,26
PRK,Democratic People's Republic of Korea,AUT,Austria,2016,35,28,7
PRK,Democratic People's Republic of Korea,AUT,Austria,2017,20,15,5
PRK,Democratic People's Republic of Korea,BEL,Belgium,2008,2,0,2
PRK,Democratic People's Republic of Korea,BEL,Belgium,2009,0,0,0
PRK,Democratic People's Republic of Korea,BEL,Belgium,2010,1,1,0
PRK,Democratic People's Republic of Korea,BEL,Belgium,2012,113,8,105
PRK,Democratic People's Republic of Korea,BEL,Belgium,2013,40,95,-55
PRK,Democratic People's Republic of Korea,BEL,Belgium,2014,3,48,-45
PRK,Democratic People's Republic of Korea,BEL,Belgium,2015,1,14,-13
PRK,Democratic People's Republic of Korea,BEL,Belgium,2017,2,2,0
PRK,Democratic People's Republic of Korea,CAN,Canada,2008,19,0,19
PRK,Democratic People's Republic of Korea,CAN,Canada,2009,11,0,11
PRK,Democratic People's Republic of Korea,CAN,Canada,2010,45,0,45
PRK,Democratic People's Republic of Korea,CAN,Canada,2011,97,0,97
PRK,Democratic People's Republic of Korea,CAN,Canada,2012,66,0,66
PRK,Democratic People's Republic of Korea,CAN,Canada,2013,17,0,17
PRK,Democratic People's Republic of Korea,CAN,Canada,2014,13,0,13
PRK,Democratic People's Republic of Korea,CAN,Canada,2015,12,0,12
PRK,Democratic People's Republic of Korea,CAN,Canada,2016,10,0,10
PRK,Democratic People's Republic of Korea,CAN,Canada,2017,10,0,10
PRK,Democratic People's Republic of Korea,CZE,Czech Republic,2008,2,0,2
PRK,Democratic People's Republic of Korea,CZE,Czech Republic,2009,1,0,1
PRK,Democratic People's Republic of Korea,CZE,Czech Republic,2010,4,0,4
PRK,Democratic People's Republic of Korea,CZE,Czech Republic,2011,2,0,2
PRK,Democratic People's Republic of Korea,CZE,Czech Republic,2012,4,2,2
PRK,Democratic People's Republic of Korea,CZE,Czech Republic,2013,1,5,-4
PRK,Democratic People's Republic of Korea,DNK,Denmark,2008,10,6,4
PRK,Democratic People's Republic of Korea,DNK,Denmark,2009,9,19,-10
PRK,Democratic People's Republic of Korea,DNK,Denmark,2010,8,12,-4
PRK,Democratic People's Republic of Korea,DNK,Denmark,2011,9,8,1
PRK,Democratic People's Republic of Korea,DNK,Denmark,2012,15,12,3
PRK,Democratic People's Republic of Korea,DNK,Denmark,2013,18,10,8
PRK,Democratic People's Republic of Korea,DNK,Denmark,2014,15,23,-8
PRK,Democratic People's Republic of Korea,DNK,Denmark,2015,16,32,-16
PRK,Democratic People's Republic of Korea,DNK,Denmark,2016,29,29,0
PRK,Democratic People's Republic of Korea,DNK,Denmark,2017,10,35,-25
PRK,Democratic People's Republic of Korea,FIN,Finland,2008,0,0,0
PRK,Democratic People's Republic of Korea,FIN,Finland,2009,0,0,0
PRK,Democratic People's Republic of Korea,FIN,Finland,2010,0,0,0
PRK,Democratic People's Republic of Korea,FIN,Finland,2011,0,0,0
PRK,Democratic People's Republic of Korea,FIN,Finland,2012,0,0,0
PRK,Democratic People's Republic of Korea,FIN,Finland,2013,3,0,3
PRK,Democratic People's Republic of Korea,FIN,Finland,2014,0,0,0
PRK,Democratic People's Republic of Korea,FIN,Finland,2015,1,0,1
PRK,Democratic People's Republic of Korea,FIN,Finland,2016,0,0,0
PRK,Democratic People's Republic of Korea,FIN,Finland,2017,0,0,0
PRK,Democratic People's Republic of Korea,FRA,France,2008,24,0,24
PRK,Democratic People's Republic of Korea,FRA,France,2009,38,0,38
PRK,Democratic People's Republic of Korea,FRA,France,2010,12,0,12
PRK,Democratic People's Republic of Korea,FRA,France,2011,14,0,14
PRK,Democratic People's Republic of Korea,FRA,France,2012,15,0,15
PRK,Democratic People's Republic of Korea,FRA,France,2013,9,0,9
PRK,Democratic People's Republic of Korea,FRA,France,2014,11,0,11
PRK,Democratic People's Republic of Korea,FRA,France,2015,7,0,7
PRK,Democratic People's Republic of Korea,FRA,France,2016,15,0,15
PRK,Democratic People's Republic of Korea,FRA,France,2017,9,0,9
PRK,Democratic People's Republic of Korea,DEU,Germany,2008,213,443,-230
PRK,Democratic People's Republic of Korea,DEU,Germany,2009,265,397,-132
PRK,Democratic People's Republic of Korea,DEU,Germany,2010,258,131,127
PRK,Democratic People's Republic of Korea,DEU,Germany,2011,225,232,-7
PRK,Democratic People's Republic of Korea,DEU,Germany,2012,229,163,66
PRK,Democratic People's Republic of Korea,DEU,Germany,2013,285,181,104
PRK,Democratic People's Republic of Korea,DEU,Germany,2014,263,199,64
PRK,Democratic People's Republic of Korea,DEU,Germany,2015,291,169,122
PRK,Democratic People's Republic of Korea,DEU,Germany,2016,160,164,-4
PRK,Democratic People's Republic of Korea,DEU,Germany,2017,181,136,45
PRK,Democratic People's Republic of Korea,HUN,Hungary,2008,12,0,12
PRK,Democratic People's Republic of Korea,HUN,Hungary,2009,0,0,0
PRK,Democratic People's Republic of Korea,HUN,Hungary,2010,1,0,1
PRK,Democratic People's Republic of Korea,HUN,Hungary,2011,0,0,0
PRK,Democratic People's Republic of Korea,HUN,Hungary,2012,0,0,0
PRK,Democratic People's Republic of Korea,HUN,Hungary,2013,1,0,1
PRK,Democratic People's Republic of Korea,HUN,Hungary,2014,0,0,0
PRK,Democratic People's Republic of Korea,HUN,Hungary,2015,0,0,0
PRK,Democratic People's Republic of Korea,HUN,Hungary,2016,0,0,0
PRK,Democratic People's Republic of Korea,HUN,Hungary,2017,1,0,1
PRK,Democratic People's Republic of Korea,ISL,Iceland,2008,0,0,0
PRK,Democratic People's Republic of Korea,ISL,Iceland,2009,2,0,2
PRK,Democratic People's Republic of Korea,ISL,Iceland,2010,0,2,-2
PRK,Democratic People's Republic of Korea,ISL,Iceland,2011,0,0,0
PRK,Democratic People's Republic of Korea,ISL,Iceland,2012,0,0,0
PRK,Democratic People's Republic of Korea,ISL,Iceland,2013,0,0,0
PRK,Democratic People's Republic of Korea,ISL,Iceland,2014,0,0,0
PRK,Democratic People's Republic of Korea,ISL,Iceland,2015,0,0,0
PRK,Democratic People's Republic of Korea,ISL,Iceland,2016,1,0,1
PRK,Democratic People's Republic of Korea,ISL,Iceland,2017,0,0,0
PRK,Democratic People's Republic of Korea,ITA,Italy,2008,10,0,10
PRK,Democratic People's Republic of Korea,ITA,Italy,2009,19,0,19
PRK,Democratic People's Republic of Korea,ITA,Italy,2010,21,2,19
PRK,Democratic People's Republic of Korea,ITA,Italy,2011,24,1,23
PRK,Democratic People's Republic of Korea,ITA,Italy,2012,27,29,-2
PRK,Democratic People's Republic of Korea,ITA,Italy,2013,21,8,13
PRK,Democratic People's Republic of Korea,ITA,Italy,2014,7,0,7
PRK,Democratic People's Republic of Korea,ITA,Italy,2015,8,0,8
PRK,Democratic People's Republic of Korea,ITA,Italy,2016,14,0,14
PRK,Democratic People's Republic of Korea,ITA,Italy,2017,19,0,19
PRK,Democratic People's Republic of Korea,JPN,Japan,2008,7,0,7
PRK,Democratic People's Republic of Korea,JPN,Japan,2009,1,0,1
PRK,Democratic People's Republic of Korea,JPN,Japan,2010,1,0,1
PRK,Democratic People's Republic of Korea,JPN,Japan,2011,11,9,2
PRK,Democratic People's Republic of Korea,JPN,Japan,2012,2,0,2
PRK,Democratic People's Republic of Korea,JPN,Japan,2013,1,0,1
PRK,Democratic People's Republic of Korea,JPN,Japan,2014,0,0,0
PRK,Democratic People's Republic of Korea,JPN,Japan,2015,0,0,0
PRK,Democratic People's Republic of Korea,JPN,Japan,2016,0,0,0
PRK,Democratic People's Republic of Korea,JPN,Japan,2017,0,0,0
PRK,Democratic People's Republic of Korea,KOR,Korea,2008,0,0,0
PRK,Democratic People's Republic of Korea,KOR,Korea,2009,0,0,0
PRK,Democratic People's Republic of Korea,KOR,Korea,2010,0,0,0
PRK,Democratic People's Republic of Korea,KOR,Korea,2011,0,0,0
PRK,Democratic People's Republic of Korea,KOR,Korea,2012,0,0,0
PRK,Democratic People's Republic of Korea,KOR,Korea,2013,0,0,0
PRK,Democratic People's Republic of Korea,KOR,Korea,2014,0,0,0
PRK,Democratic People's Republic of Korea,KOR,Korea,2015,0,0,0
PRK,Democratic People's Republic of Korea,KOR,Korea,2016,0,0,0
PRK,Democratic People's Republic of Korea,KOR,Korea,2017,0,0,0
PRK,Democratic People's Republic of Korea,LUX,Luxembourg,2008,3,0,3
PRK,Democratic People's Republic of Korea,LUX,Luxembourg,2009,0,0,0
PRK,Democratic People's Republic of Korea,LUX,Luxembourg,2010,0,11,-11
PRK,Democratic People's Republic of Korea,LUX,Luxembourg,2011,1,0,1
PRK,Democratic People's Republic of Korea,LUX,Luxembourg,2012,1,1,0
PRK,Democratic People's Republic of Korea,LUX,Luxembourg,2013,9,1,8
PRK,Democratic People's Republic of Korea,LUX,Luxembourg,2014,0,0,0
PRK,Democratic People's Republic of Korea,LUX,Luxembourg,2015,0,0,0
PRK,Democratic People's Republic of Korea,LUX,Luxembourg,2016,0,5,-5
PRK,Democratic People's Republic of Korea,LUX,Luxembourg,2017,2,0,2
PRK,Democratic People's Republic of Korea,MEX,Mexico,2008,4,0,4
PRK,Democratic People's Republic of Korea,MEX,Mexico,2009,4,0,4
PRK,Democratic People's Republic of Korea,MEX,Mexico,2010,5,0,5
PRK,Democratic People's Republic of Korea,MEX,Mexico,2011,1,0,1
PRK,Democratic People's Republic of Korea,MEX,Mexico,2012,1,0,1
PRK,Democratic People's Republic of Korea,MEX,Mexico,2013,0,0,0
PRK,Democratic People's Republic of Korea,MEX,Mexico,2014,0,0,0
PRK,Democratic People's Republic of Korea,MEX,Mexico,2015,3,0,3
PRK,Democratic People's Republic of Korea,MEX,Mexico,2017,1,0,1
PRK,Democratic People's Republic of Korea,NLD,Netherlands,2008,2,386,-384
PRK,Democratic People's Republic of Korea,NLD,Netherlands,2010,2,496,-494
PRK,Democratic People's Republic of Korea,NLD,Netherlands,2011,13,583,-570
PRK,Democratic People's Republic of Korea,NLD,Netherlands,2014,27,5,22
PRK,Democratic People's Republic of Korea,NLD,Netherlands,2015,1,14,-13
PRK,Democratic People's Republic of Korea,NLD,Netherlands,2016,1,1,0
PRK,Democratic People's Republic of Korea,NLD,Netherlands,2017,2,3,-1
PRK,Democratic People's Republic of Korea,NZL,New Zealand,2009,0,2,-2
PRK,Democratic People's Republic of Korea,NOR,Norway,2008,0,4,-4
PRK,Democratic People's Republic of Korea,NOR,Norway,2009,4,0,4
PRK,Democratic People's Republic of Korea,NOR,Norway,2010,0,4,-4
PRK,Democratic People's Republic of Korea,NOR,Norway,2011,4,0,4
PRK,Democratic People's Republic of Korea,NOR,Norway,2012,1,0,1
PRK,Democratic People's Republic of Korea,NOR,Norway,2013,1,1,0
PRK,Democratic People's Republic of Korea,NOR,Norway,2014,1,1,0
PRK,Democratic People's Republic of Korea,NOR,Norway,2015,0,1,-1
PRK,Democratic People's Republic of Korea,NOR,Norway,2016,0,0,0
PRK,Democratic People's Republic of Korea,NOR,Norway,2017,0,0,0
PRK,Democratic People's Republic of Korea,POL,Poland,2009,152,0,152
PRK,Democratic People's Republic of Korea,POL,Poland,2010,151,0,151
PRK,Democratic People's Republic of Korea,POL,Poland,2011,280,0,280
PRK,Democratic People's Republic of Korea,POL,Poland,2012,187,0,187
PRK,Democratic People's Republic of Korea,POL,Poland,2013,283,0,283
PRK,Democratic People's Republic of Korea,POL,Poland,2014,130,0,130
PRK,Democratic People's Republic of Korea,POL,Poland,2015,356,0,356
PRK,Democratic People's Republic of Korea,POL,Poland,2016,349,0,349
PRK,Democratic People's Republic of Korea,POL,Poland,2017,128,0,128
PRK,Democratic People's Republic of Korea,SVK,Slovak Republic,2008,0,0,0
PRK,Democratic People's Republic of Korea,ESP,Spain,2008,10,3,7
PRK,Democratic People's Republic of Korea,ESP,Spain,2009,8,8,0
PRK,Democratic People's Republic of Korea,ESP,Spain,2010,14,2,12
PRK,Democratic People's Republic of Korea,ESP,Spain,2011,8,6,2
PRK,Democratic People's Republic of Korea,ESP,Spain,2012,6,4,2
PRK,Democratic People's Republic of Korea,ESP,Spain,2013,10,5,5
PRK,Democratic People's Republic of Korea,ESP,Spain,2014,9,0,9
PRK,Democratic People's Republic of Korea,ESP,Spain,2015,8,4,4
PRK,Democratic People's Republic of Korea,ESP,Spain,2016,8,4,4
PRK,Democratic People's Republic of Korea,ESP,Spain,2017,17,11,6
PRK,Democratic People's Republic of Korea,SWE,Sweden,2008,5,0,5
PRK,Democratic People's Republic of Korea,SWE,Sweden,2009,10,1,9
PRK,Democratic People's Republic of Korea,SWE,Sweden,2010,1,1,0
PRK,Democratic People's Republic of Korea,SWE,Sweden,2011,4,1,3
PRK,Democratic People's Republic of Korea,SWE,Sweden,2012,0,4,-4
PRK,Democratic People's Republic of Korea,SWE,Sweden,2013,3,0,3
PRK,Democratic People's Republic of Korea,SWE,Sweden,2014,0,1,-1
PRK,Democratic People's Republic of Korea,SWE,Sweden,2015,2,0,2
PRK,Democratic People's Republic of Korea,SWE,Sweden,2016,5,2,3
PRK,Democratic People's Republic of Korea,SWE,Sweden,2017,0,0,0
PRK,Democratic People's Republic of Korea,CHE,Switzerland,2010,13,1,12
PRK,Democratic People's Republic of Korea,CHE,Switzerland,2011,1,2,-1
PRK,Democratic People's Republic of Korea,CHE,Switzerland,2012,4,0,4
PRK,Democratic People's Republic of Korea,CHE,Switzerland,2013,5,6,-1
PRK,Democratic People's Republic of Korea,CHE,Switzerland,2014,0,4,-4
PRK,Democratic People's Republic of Korea,CHE,Switzerland,2015,0,1,-1
PRK,Democratic People's Republic of Korea,CHE,Switzerland,2016,2,4,-2
PRK,Democratic People's Republic of Korea,CHE,Switzerland,2017,2,5,-3
PRK,Democratic People's Republic of Korea,TUR,Turkey,2010,3,0,3
PRK,Democratic People's Republic of Korea,USA,United States,2009,67,0,67
PRK,Democratic People's Republic of Korea,USA,United States,2010,35,0,35
PRK,Democratic People's Republic of Korea,USA,United States,2011,36,0,36
PRK,Democratic People's Republic of Korea,USA,United States,2012,49,0,49
PRK,Democratic People's Republic of Korea,USA,United States,2013,48,0,48
PRK,Democratic People's Republic of Korea,USA,United States,2014,142,0,142
PRK,Democratic People's Republic of Korea,USA,United States,2015,55,0,55
PRK,Democratic People's Republic of Korea,USA,United States,2016,47,0,47
PRK,Democratic People's Republic of Korea,USA,United States,2017,32,0,32
PRK,Democratic People's Republic of Korea,CHL,Chile,2008,14,0,14
PRK,Democratic People's Republic of Korea,CHL,Chile,2009,40,0,40
PRK,Democratic People's Republic of Korea,CHL,Chile,2010,4,0,4
PRK,Democratic People's Republic of Korea,CHL,Chile,2011,9,0,9
PRK,Democratic People's Republic of Korea,CHL,Chile,2012,6,0,6
PRK,Democratic People's Republic of Korea,CHL,Chile,2013,3,0,3
PRK,Democratic People's Republic of Korea,CHL,Chile,2014,3,0,3
PRK,Democratic People's Republic of Korea,CHL,Chile,2015,0,0,0
PRK,Democratic People's Republic of Korea,CHL,Chile,2016,0,0,0
PRK,Democratic People's Republic of Korea,EST,Estonia,2008,0,0,0
PRK,Democratic People's Republic of Korea,EST,Estonia,2009,0,0,0
PRK,Democratic People's Republic of Korea,EST,Estonia,2010,0,0,0
PRK,Democratic People's Republic of Korea,EST,Estonia,2011,0,0,0
PRK,Democratic People's Republic of Korea,EST,Estonia,2012,0,0,0
PRK,Democratic People's Republic of Korea,EST,Estonia,2013,0,0,0
PRK,Democratic People's Republic of Korea,EST,Estonia,2014,0,0,0
PRK,Democratic People's Republic of Korea,EST,Estonia,2015,0,0,0
PRK,Democratic People's Republic of Korea,EST,Estonia,2016,0,0,0
PRK,Democratic People's Republic of Korea,EST,Estonia,2017,0,0,0
COD,Democratic Republic of the Congo,AUS,Australia,2008,456,0,456
COD,Democratic Republic of the Congo,AUS,Australia,2009,218,0,218
COD,Democratic Republic of the Congo,AUS,Australia,2010,404,8,396
COD,Democratic Republic of the Congo,AUS,Australia,2011,359,7,352
COD,Democratic Republic of the Congo,AUS,Australia,2012,420,8,412
COD,Democratic Republic of the Congo,AUS,Australia,2013,266,6,260
COD,Democratic Republic of the Congo,AUS,Australia,2014,572,6,566
COD,Democratic Republic of the Congo,AUS,Australia,2015,416,0,416
COD,Democratic Republic of the Congo,AUS,Australia,2016,719,0,719
COD,Democratic Republic of the Congo,AUS,Australia,2017,372,0,372
COD,Democratic Republic of the Congo,AUT,Austria,2008,39,6,33
COD,Democratic Republic of the Congo,AUT,Austria,2009,34,21,13
COD,Democratic Republic of the Congo,AUT,Austria,2010,39,19,20
COD,Democratic Republic of the Congo,AUT,Austria,2011,34,19,15
COD,Democratic Republic of the Congo,AUT,Austria,2012,36,17,19
COD,Democratic Republic of the Congo,AUT,Austria,2013,39,8,31
COD,Democratic Republic of the Congo,AUT,Austria,2014,44,14,30
COD,Democratic Republic of the Congo,AUT,Austria,2015,36,13,23
COD,Democratic Republic of the Congo,AUT,Austria,2016,31,17,14
COD,Democratic Republic of the Congo,AUT,Austria,2017,31,17,14
COD,Democratic Republic of the Congo,BEL,Belgium,2008,1164,300,864
COD,Democratic Republic of the Congo,BEL,Belgium,2009,1231,203,1028
COD,Democratic Republic of the Congo,BEL,Belgium,2010,1403,310,1093
COD,Democratic Republic of the Congo,BEL,Belgium,2011,1522,382,1140
COD,Democratic Republic of the Congo,BEL,Belgium,2012,2432,722,1710
COD,Democratic Republic of the Congo,BEL,Belgium,2013,2028,1076,952
COD,Democratic Republic of the Congo,BEL,Belgium,2014,1516,1314,202
COD,Democratic Republic of the Congo,BEL,Belgium,2015,1608,976,632
COD,Democratic Republic of the Congo,BEL,Belgium,2016,1348,651,697
COD,Democratic Republic of the Congo,BEL,Belgium,2017,1581,512,1069
COD,Democratic Republic of the Congo,CAN,Canada,2008,1395,0,1395
COD,Democratic Republic of the Congo,CAN,Canada,2009,1580,0,1580
COD,Democratic Republic of the Congo,CAN,Canada,2010,1237,0,1237
COD,Democratic Republic of the Congo,CAN,Canada,2011,1217,0,1217
COD,Democratic Republic of the Congo,CAN,Canada,2012,1711,0,1711
COD,Democratic Republic of the Congo,CAN,Canada,2013,2050,0,2050
COD,Democratic Republic of the Congo,CAN,Canada,2014,1749,0,1749
COD,Democratic Republic of the Congo,CAN,Canada,2015,1714,0,1714
COD,Democratic Republic of the Congo,CAN,Canada,2016,2550,0,2550
COD,Democratic Republic of the Congo,CAN,Canada,2017,2400,0,2400
COD,Democratic Republic of the Congo,CZE,Czech Republic,2008,13,0,13
COD,Democratic Republic of the Congo,CZE,Czech Republic,2009,5,0,5
COD,Democratic Republic of the Congo,CZE,Czech Republic,2010,10,0,10
COD,Democratic Republic of the Congo,CZE,Czech Republic,2011,8,0,8
COD,Democratic Republic of the Congo,CZE,Czech Republic,2012,7,4,3
COD,Democratic Republic of the Congo,CZE,Czech Republic,2013,9,7,2
COD,Democratic Republic of the Congo,CZE,Czech Republic,2014,9,8,1
COD,Democratic Republic of the Congo,CZE,Czech Republic,2015,7,7,0
COD,Democratic Republic of the Congo,CZE,Czech Republic,2016,6,9,-3
COD,Democratic Republic of the Congo,CZE,Czech Republic,2017,5,7,-2
COD,Democratic Republic of the Congo,DNK,Denmark,2008,169,1,168
COD,Democratic Republic of the Congo,DNK,Denmark,2009,25,2,23
COD,Democratic Republic of the Congo,DNK,Denmark,2010,99,3,96
COD,Democratic Republic of the Congo,DNK,Denmark,2011,107,8,99
COD,Democratic Republic of the Congo,DNK,Denmark,2012,167,1,166
COD,Democratic Republic of the Congo,DNK,Denmark,2013,53,4,49
COD,Democratic Republic of the Congo,DNK,Denmark,2014,186,4,182
COD,Democratic Republic of the Congo,DNK,Denmark,2015,265,17,248
COD,Democratic Republic of the Congo,DNK,Denmark,2016,53,15,38
COD,Democratic Republic of the Congo,DNK,Denmark,2017,55,19,36
COD,Democratic Republic of the Congo,FIN,Finland,2008,168,6,162
COD,Democratic Republic of the Congo,FIN,Finland,2009,159,0,159
COD,Democratic Republic of the Congo,FIN,Finland,2010,194,5,189
COD,Democratic Republic of the Congo,FIN,Finland,2011,103,1,102
COD,Democratic Republic of the Congo,FIN,Finland,2012,308,1,307
COD,Democratic Republic of the Congo,FIN,Finland,2013,86,3,83
COD,Democratic Republic of the Congo,FIN,Finland,2014,238,9,229
COD,Democratic Republic of the Congo,FIN,Finland,2015,240,5,235
COD,Democratic Republic of the Congo,FIN,Finland,2016,249,8,241
COD,Democratic Republic of the Congo,FIN,Finland,2017,47,11,36
COD,Democratic Republic of the Congo,FRA,France,2008,3723,0,3723
COD,Democratic Republic of the Congo,FRA,France,2009,3521,0,3521
COD,Democratic Republic of the Congo,FRA,France,2010,3409,0,3409
COD,Democratic Republic of the Congo,FRA,France,2011,3558,0,3558
COD,Democratic Republic of the Congo,FRA,France,2012,3881,0,3881
COD,Democratic Republic of the Congo,FRA,France,2013,4296,0,4296
COD,Democratic Republic of the Congo,FRA,France,2014,4342,0,4342
COD,Democratic Republic of the Congo,FRA,France,2015,4172,0,4172
COD,Democratic Republic of the Congo,FRA,France,2016,4438,0,4438
COD,Democratic Republic of the Congo,FRA,France,2017,4345,0,4345
COD,Democratic Republic of the Congo,DEU,Germany,2008,223,195,28
COD,Democratic Republic of the Congo,DEU,Germany,2009,290,200,90
COD,Democratic Republic of the Congo,DEU,Germany,2010,258,286,-28
COD,Democratic Republic of the Congo,DEU,Germany,2011,188,167,21
COD,Democratic Republic of the Congo,DEU,Germany,2012,190,145,45
COD,Democratic Republic of the Congo,DEU,Germany,2013,337,291,46
COD,Democratic Republic of the Congo,DEU,Germany,2014,233,212,21
COD,Democratic Republic of the Congo,DEU,Germany,2015,335,212,123
COD,Democratic Republic of the Congo,DEU,Germany,2016,368,243,125
COD,Democratic Republic of the Congo,DEU,Germany,2017,435,214,221
COD,Democratic Republic of the Congo,HUN,Hungary,2008,1,0,1
COD,Democratic Republic of the Congo,HUN,Hungary,2009,0,0,0
COD,Democratic Republic of the Congo,HUN,Hungary,2010,2,0,2
COD,Democratic Republic of the Congo,HUN,Hungary,2011,1,0,1
COD,Democratic Republic of the Congo,HUN,Hungary,2012,2,0,2
COD,Democratic Republic of the Congo,HUN,Hungary,2013,1,0,1
COD,Democratic Republic of the Congo,HUN,Hungary,2014,5,0,5
COD,Democratic Republic of the Congo,HUN,Hungary,2015,2,1,1
COD,Democratic Republic of the Congo,HUN,Hungary,2016,14,0,14
COD,Democratic Republic of the Congo,HUN,Hungary,2017,15,0,15
COD,Democratic Republic of the Congo,ISL,Iceland,2008,0,0,0
COD,Democratic Republic of the Congo,ISL,Iceland,2009,0,0,0
COD,Democratic Republic of the Congo,ISL,Iceland,2010,0,0,0
COD,Democratic Republic of the Congo,ISL,Iceland,2011,0,0,0
COD,Democratic Republic of the Congo,ISL,Iceland,2012,0,0,0
COD,Democratic Republic of the Congo,ISL,Iceland,2016,0,0,0
COD,Democratic Republic of the Congo,ISL,Iceland,2017,0,0,0
COD,Democratic Republic of the Congo,ITA,Italy,2008,233,9,224
COD,Democratic Republic of the Congo,ITA,Italy,2009,232,11,221
COD,Democratic Republic of the Congo,ITA,Italy,2010,236,11,225
COD,Democratic Republic of the Congo,ITA,Italy,2011,236,19,217
COD,Democratic Republic of the Congo,ITA,Italy,2012,323,23,300
COD,Democratic Republic of the Congo,ITA,Italy,2013,192,5,187
COD,Democratic Republic of the Congo,ITA,Italy,2014,214,22,192
COD,Democratic Republic of the Congo,ITA,Italy,2015,213,13,200
COD,Democratic Republic of the Congo,ITA,Italy,2016,278,0,278
COD,Democratic Republic of the Congo,ITA,Italy,2017,249,23,226
COD,Democratic Republic of the Congo,JPN,Japan,2008,70,65,5
COD,Democratic Republic of the Congo,JPN,Japan,2009,41,28,13
COD,Democratic Republic of the Congo,JPN,Japan,2010,111,108,3
COD,Democratic Republic of the Congo,JPN,Japan,2011,90,94,-4
COD,Democratic Republic of the Congo,JPN,Japan,2012,138,26,112
COD,Democratic Republic of the Congo,JPN,Japan,2013,157,144,13
COD,Democratic Republic of the Congo,JPN,Japan,2014,167,142,25
COD,Democratic Republic of the Congo,JPN,Japan,2015,220,192,28
COD,Democratic Republic of the Congo,JPN,Japan,2016,152,138,14
COD,Democratic Republic of the Congo,JPN,Japan,2017,164,137,27
COD,Democratic Republic of the Congo,KOR,Korea,2008,14,17,-3
COD,Democratic Republic of the Congo,KOR,Korea,2009,8,14,-6
COD,Democratic Republic of the Congo,KOR,Korea,2010,46,21,25
COD,Democratic Republic of the Congo,KOR,Korea,2011,29,14,15
COD,Democratic Republic of the Congo,KOR,Korea,2012,30,31,-1
COD,Democratic Republic of the Congo,KOR,Korea,2013,26,19,7
COD,Democratic Republic of the Congo,KOR,Korea,2014,33,24,9
COD,Democratic Republic of the Congo,KOR,Korea,2015,32,25,7
COD,Democratic Republic of the Congo,KOR,Korea,2016,24,17,7
COD,Democratic Republic of the Congo,KOR,Korea,2017,43,19,24
COD,Democratic Republic of the Congo,LUX,Luxembourg,2008,9,11,-2
COD,Democratic Republic of the Congo,LUX,Luxembourg,2009,10,3,7
COD,Democratic Republic of the Congo,LUX,Luxembourg,2010,15,7,8
COD,Democratic Republic of the Congo,LUX,Luxembourg,2011,22,2,20
COD,Democratic Republic of the Congo,LUX,Luxembourg,2012,12,7,5
COD,Democratic Republic of the Congo,LUX,Luxembourg,2013,22,7,15
COD,Democratic Republic of the Congo,LUX,Luxembourg,2014,13,4,9
COD,Democratic Republic of the Congo,LUX,Luxembourg,2015,23,4,19
COD,Democratic Republic of the Congo,LUX,Luxembourg,2016,30,10,20
COD,Democratic Republic of the Congo,LUX,Luxembourg,2017,17,8,9
COD,Democratic Republic of the Congo,MEX,Mexico,2008,1,0,1
COD,Democratic Republic of the Congo,MEX,Mexico,2009,3,0,3
COD,Democratic Republic of the Congo,MEX,Mexico,2010,2,0,2
COD,Democratic Republic of the Congo,MEX,Mexico,2011,27,0,27
COD,Democratic Republic of the Congo,MEX,Mexico,2012,10,0,10
COD,Democratic Republic of the Congo,MEX,Mexico,2013,18,0,18
COD,Democratic Republic of the Congo,MEX,Mexico,2014,12,0,12
COD,Democratic Republic of the Congo,MEX,Mexico,2015,9,0,9
COD,Democratic Republic of the Congo,MEX,Mexico,2016,21,0,21
COD,Democratic Republic of the Congo,MEX,Mexico,2017,7,0,7
COD,Democratic Republic of the Congo,NLD,Netherlands,2009,13,11,2
COD,Democratic Republic of the Congo,NLD,Netherlands,2010,35,39,-4
COD,Democratic Republic of the Congo,NLD,Netherlands,2011,27,19,8
COD,Democratic Republic of the Congo,NLD,Netherlands,2012,26,16,10
COD,Democratic Republic of the Congo,NLD,Netherlands,2013,40,11,29
COD,Democratic Republic of the Congo,NLD,Netherlands,2014,18,14,4
COD,Democratic Republic of the Congo,NLD,Netherlands,2015,98,10,88
COD,Democratic Republic of the Congo,NLD,Netherlands,2016,91,10,81
COD,Democratic Republic of the Congo,NLD,Netherlands,2017,48,10,38
COD,Democratic Republic of the Congo,NZL,New Zealand,2008,10,0,10
COD,Democratic Republic of the Congo,NZL,New Zealand,2009,42,0,42
COD,Democratic Republic of the Congo,NZL,New Zealand,2010,19,0,19
COD,Democratic Republic of the Congo,NZL,New Zealand,2011,6,1,5
COD,Democratic Republic of the Congo,NZL,New Zealand,2012,3,0,3
COD,Democratic Republic of the Congo,NZL,New Zealand,2013,12,0,12
COD,Democratic Republic of the Congo,NZL,New Zealand,2014,7,1,6
COD,Democratic Republic of the Congo,NZL,New Zealand,2015,12,0,12
COD,Democratic Republic of the Congo,NZL,New Zealand,2016,4,0,4
COD,Democratic Republic of the Congo,NZL,New Zealand,2017,13,0,13
COD,Democratic Republic of the Congo,NOR,Norway,2008,83,5,78
COD,Democratic Republic of the Congo,NOR,Norway,2009,19,5,14
COD,Democratic Republic of the Congo,NOR,Norway,2010,14,6,8
COD,Democratic Republic of the Congo,NOR,Norway,2011,29,7,22
COD,Democratic Republic of the Congo,NOR,Norway,2012,30,10,20
COD,Democratic Republic of the Congo,NOR,Norway,2013,35,2,33
COD,Democratic Republic of the Congo,NOR,Norway,2014,24,3,21
COD,Democratic Republic of the Congo,NOR,Norway,2015,19,17,2
COD,Democratic Republic of the Congo,NOR,Norway,2016,14,8,6
COD,Democratic Republic of the Congo,NOR,Norway,2017,11,12,-1
COD,Democratic Republic of the Congo,POL,Poland,2008,26,0,26
COD,Democratic Republic of the Congo,POL,Poland,2009,21,0,21
COD,Democratic Republic of the Congo,POL,Poland,2010,15,0,15
COD,Democratic Republic of the Congo,POL,Poland,2011,14,0,14
COD,Democratic Republic of the Congo,POL,Poland,2012,13,0,13
COD,Democratic Republic of the Congo,POL,Poland,2013,9,0,9
COD,Democratic Republic of the Congo,POL,Poland,2014,6,0,6
COD,Democratic Republic of the Congo,POL,Poland,2015,8,0,8
COD,Democratic Republic of the Congo,POL,Poland,2016,10,0,10
COD,Democratic Republic of the Congo,POL,Poland,2017,16,0,16
COD,Democratic Republic of the Congo,SVK,Slovak Republic,2008,1,1,0
COD,Democratic Republic of the Congo,SVK,Slovak Republic,2009,4,4,0
COD,Democratic Republic of the Congo,SVK,Slovak Republic,2010,3,1,2
COD,Democratic Republic of the Congo,ESP,Spain,2008,105,57,48
COD,Democratic Republic of the Congo,ESP,Spain,2009,104,76,28
COD,Democratic Republic of the Congo,ESP,Spain,2010,66,95,-29
COD,Democratic Republic of the Congo,ESP,Spain,2011,68,130,-62
COD,Democratic Republic of the Congo,ESP,Spain,2012,78,118,-40
COD,Democratic Republic of the Congo,ESP,Spain,2013,82,72,10
COD,Democratic Republic of the Congo,ESP,Spain,2014,70,77,-7
COD,Democratic Republic of the Congo,ESP,Spain,2015,52,59,-7
COD,Democratic Republic of the Congo,ESP,Spain,2016,97,42,55
COD,Democratic Republic of the Congo,ESP,Spain,2017,61,70,-9
COD,Democratic Republic of the Congo,SWE,Sweden,2008,201,5,196
COD,Democratic Republic of the Congo,SWE,Sweden,2009,198,2,196
COD,Democratic Republic of the Congo,SWE,Sweden,2010,186,10,176
COD,Democratic Republic of the Congo,SWE,Sweden,2011,196,14,182
COD,Democratic Republic of the Congo,SWE,Sweden,2012,197,6,191
COD,Democratic Republic of the Congo,SWE,Sweden,2013,289,13,276
COD,Democratic Republic of the Congo,SWE,Sweden,2014,336,17,319
COD,Democratic Republic of the Congo,SWE,Sweden,2015,347,16,331
COD,Democratic Republic of the Congo,SWE,Sweden,2016,432,7,425
COD,Democratic Republic of the Congo,SWE,Sweden,2017,660,4,656
COD,Democratic Republic of the Congo,CHE,Switzerland,2010,362,30,332
COD,Democratic Republic of the Congo,CHE,Switzerland,2012,208,31,177
COD,Democratic Republic of the Congo,CHE,Switzerland,2013,239,22,217
COD,Democratic Republic of the Congo,CHE,Switzerland,2014,301,29,272
COD,Democratic Republic of the Congo,CHE,Switzerland,2015,247,11,236
COD,Democratic Republic of the Congo,CHE,Switzerland,2016,209,34,175
COD,Democratic Republic of the Congo,CHE,Switzerland,2017,200,13,187
COD,Democratic Republic of the Congo,TUR,Turkey,2017,172,59,113
COD,Democratic Republic of the Congo,USA,United States,2008,1261,0,1261
COD,Democratic Republic of the Congo,USA,United States,2009,2122,0,2122
COD,Democratic Republic of the Congo,USA,United States,2010,1764,0,1764
COD,Democratic Republic of the Congo,USA,United States,2011,2424,0,2424
COD,Democratic Republic of the Congo,USA,United States,2012,3731,0,3731
COD,Democratic Republic of the Congo,USA,United States,2013,2792,0,2792
COD,Democratic Republic of the Congo,USA,United States,2014,4347,0,4347
COD,Democratic Republic of the Congo,USA,United States,2015,5345,0,5345
COD,Democratic Republic of the Congo,USA,United States,2016,6791,0,6791
COD,Democratic Republic of the Congo,USA,United States,2017,8709,0,8709
COD,Democratic Republic of the Congo,CHL,Chile,2008,5,0,5
COD,Democratic Republic of the Congo,CHL,Chile,2009,4,0,4
COD,Democratic Republic of the Congo,CHL,Chile,2010,5,0,5
COD,Democratic Republic of the Congo,CHL,Chile,2011,4,0,4
COD,Democratic Republic of the Congo,CHL,Chile,2012,13,0,13
COD,Democratic Republic of the Congo,CHL,Chile,2013,2,0,2
COD,Democratic Republic of the Congo,CHL,Chile,2014,8,0,8
COD,Democratic Republic of the Congo,CHL,Chile,2015,5,0,5
COD,Democratic Republic of the Congo,CHL,Chile,2016,3,0,3
COD,Democratic Republic of the Congo,EST,Estonia,2008,0,0,0
COD,Democratic Republic of the Congo,EST,Estonia,2009,0,0,0
COD,Democratic Republic of the Congo,EST,Estonia,2010,0,0,0
COD,Democratic Republic of the Congo,EST,Estonia,2011,0,0,0
COD,Democratic Republic of the Congo,EST,Estonia,2012,0,0,0
COD,Democratic Republic of the Congo,EST,Estonia,2013,0,0,0
COD,Democratic Republic of the Congo,EST,Estonia,2014,0,0,0
COD,Democratic Republic of the Congo,EST,Estonia,2015,3,0,3
COD,Democratic Republic of the Congo,EST,Estonia,2016,2,0,2
COD,Democratic Republic of the Congo,EST,Estonia,2017,3,0,3
COD,Democratic Republic of the Congo,SVN,Slovenia,2013,1,0,1
DNK,Denmark,AUS,Australia,2008,213,201,12
DNK,Denmark,AUS,Australia,2009,161,197,-36
DNK,Denmark,AUS,Australia,2010,139,244,-105
DNK,Denmark,AUS,Australia,2011,141,277,-136
DNK,Denmark,AUS,Australia,2012,142,249,-107
DNK,Denmark,AUS,Australia,2013,167,240,-73
DNK,Denmark,AUS,Australia,2014,135,310,-175
DNK,Denmark,AUS,Australia,2015,148,348,-200
DNK,Denmark,AUS,Australia,2016,124,376,-252
DNK,Denmark,AUS,Australia,2017,142,337,-195
DNK,Denmark,AUT,Austria,2008,151,90,61
DNK,Denmark,AUT,Austria,2009,175,131,44
DNK,Denmark,AUT,Austria,2010,152,145,7
DNK,Denmark,AUT,Austria,2011,164,140,24
DNK,Denmark,AUT,Austria,2012,162,110,52
DNK,Denmark,AUT,Austria,2013,190,121,69
DNK,Denmark,AUT,Austria,2014,173,144,29
DNK,Denmark,AUT,Austria,2015,166,135,31
DNK,Denmark,AUT,Austria,2016,225,140,85
DNK,Denmark,AUT,Austria,2017,175,159,16
DNK,Denmark,BEL,Belgium,2008,271,111,160
DNK,Denmark,BEL,Belgium,2009,258,84,174
DNK,Denmark,BEL,Belgium,2010,247,100,147
DNK,Denmark,BEL,Belgium,2011,295,112,183
DNK,Denmark,BEL,Belgium,2012,257,156,101
DNK,Denmark,BEL,Belgium,2013,241,120,121
DNK,Denmark,BEL,Belgium,2014,230,126,104
DNK,Denmark,BEL,Belgium,2015,221,141,80
DNK,Denmark,BEL,Belgium,2016,254,184,70
DNK,Denmark,BEL,Belgium,2017,200,198,2
DNK,Denmark,CAN,Canada,2008,108,262,-154
DNK,Denmark,CAN,Canada,2009,81,227,-146
DNK,Denmark,CAN,Canada,2010,92,232,-140
DNK,Denmark,CAN,Canada,2011,93,227,-134
DNK,Denmark,CAN,Canada,2012,93,215,-122
DNK,Denmark,CAN,Canada,2013,81,247,-166
DNK,Denmark,CAN,Canada,2014,69,297,-228
DNK,Denmark,CAN,Canada,2015,75,279,-204
DNK,Denmark,CAN,Canada,2016,80,295,-215
DNK,Denmark,CAN,Canada,2017,95,309,-214
DNK,Denmark,CZE,Czech Republic,2008,24,146,-122
DNK,Denmark,CZE,Czech Republic,2009,31,131,-100
DNK,Denmark,CZE,Czech Republic,2010,29,131,-102
DNK,Denmark,CZE,Czech Republic,2011,32,166,-134
DNK,Denmark,CZE,Czech Republic,2012,19,155,-136
DNK,Denmark,CZE,Czech Republic,2013,28,165,-137
DNK,Denmark,CZE,Czech Republic,2014,30,270,-240
DNK,Denmark,CZE,Czech Republic,2015,20,338,-318
DNK,Denmark,CZE,Czech Republic,2016,27,373,-346
DNK,Denmark,CZE,Czech Republic,2017,24,332,-308
DNK,Denmark,DNK,Denmark,2015,0,0,0
DNK,Denmark,DNK,Denmark,2016,0,0,0
DNK,Denmark,FIN,Finland,2008,76,286,-210
DNK,Denmark,FIN,Finland,2009,42,197,-155
DNK,Denmark,FIN,Finland,2010,62,192,-130
DNK,Denmark,FIN,Finland,2011,52,226,-174
DNK,Denmark,FIN,Finland,2012,46,242,-196
DNK,Denmark,FIN,Finland,2013,54,247,-193
DNK,Denmark,FIN,Finland,2014,69,294,-225
DNK,Denmark,FIN,Finland,2015,67,377,-310
DNK,Denmark,FIN,Finland,2016,72,374,-302
DNK,Denmark,FIN,Finland,2017,75,469,-394
DNK,Denmark,FRA,France,2008,0,630,-630
DNK,Denmark,FRA,France,2009,0,583,-583
DNK,Denmark,FRA,France,2010,0,665,-665
DNK,Denmark,FRA,France,2011,0,696,-696
DNK,Denmark,FRA,France,2012,0,673,-673
DNK,Denmark,FRA,France,2013,344,735,-391
DNK,Denmark,FRA,France,2014,254,746,-492
DNK,Denmark,FRA,France,2015,352,840,-488
DNK,Denmark,FRA,France,2016,294,868,-574
DNK,Denmark,FRA,France,2017,255,840,-585
DNK,Denmark,DEU,Germany,2008,2188,3029,-841
DNK,Denmark,DEU,Germany,2009,2167,2155,12
DNK,Denmark,DEU,Germany,2010,2171,1904,267
DNK,Denmark,DEU,Germany,2011,2315,1882,433
DNK,Denmark,DEU,Germany,2012,2322,1799,523
DNK,Denmark,DEU,Germany,2013,2522,1785,737
DNK,Denmark,DEU,Germany,2014,2342,1966,376
DNK,Denmark,DEU,Germany,2015,2249,2039,210
DNK,Denmark,DEU,Germany,2016,2253,2114,139
DNK,Denmark,DEU,Germany,2017,2108,2259,-151
DNK,Denmark,HUN,Hungary,2008,45,407,-362
DNK,Denmark,HUN,Hungary,2009,50,419,-369
DNK,Denmark,HUN,Hungary,2010,57,441,-384
DNK,Denmark,HUN,Hungary,2011,36,449,-413
DNK,Denmark,HUN,Hungary,2012,36,721,-685
DNK,Denmark,HUN,Hungary,2013,39,770,-731
DNK,Denmark,HUN,Hungary,2014,32,854,-822
DNK,Denmark,HUN,Hungary,2015,33,771,-738
DNK,Denmark,HUN,Hungary,2016,22,741,-719
DNK,Denmark,HUN,Hungary,2017,41,748,-707
DNK,Denmark,ISL,Iceland,2008,177,1109,-932
DNK,Denmark,ISL,Iceland,2009,88,1003,-915
DNK,Denmark,ISL,Iceland,2010,97,911,-814
DNK,Denmark,ISL,Iceland,2011,121,621,-500
DNK,Denmark,ISL,Iceland,2012,112,638,-526
DNK,Denmark,ISL,Iceland,2013,147,561,-414
DNK,Denmark,ISL,Iceland,2014,136,684,-548
DNK,Denmark,ISL,Iceland,2015,159,816,-657
DNK,Denmark,ISL,Iceland,2016,180,844,-664
DNK,Denmark,ISL,Iceland,2017,181,733,-552
DNK,Denmark,ITA,Italy,2008,198,538,-340
DNK,Denmark,ITA,Italy,2009,159,556,-397
DNK,Denmark,ITA,Italy,2010,143,669,-526
DNK,Denmark,ITA,Italy,2011,150,706,-556
DNK,Denmark,ITA,Italy,2012,153,899,-746
DNK,Denmark,ITA,Italy,2013,94,1066,-972
DNK,Denmark,ITA,Italy,2014,105,1390,-1285
DNK,Denmark,ITA,Italy,2015,108,1483,-1375
DNK,Denmark,ITA,Italy,2016,91,1487,-1396
DNK,Denmark,ITA,Italy,2017,110,1463,-1353
DNK,Denmark,JPN,Japan,2008,223,168,55
DNK,Denmark,JPN,Japan,2009,353,154,199
DNK,Denmark,JPN,Japan,2010,263,121,142
DNK,Denmark,JPN,Japan,2011,247,161,86
DNK,Denmark,JPN,Japan,2012,317,186,131
DNK,Denmark,JPN,Japan,2013,323,184,139
DNK,Denmark,JPN,Japan,2014,346,187,159
DNK,Denmark,JPN,Japan,2015,446,220,226
DNK,Denmark,JPN,Japan,2016,433,183,250
DNK,Denmark,JPN,Japan,2017,582,207,375
DNK,Denmark,KOR,Korea,2008,63,78,-15
DNK,Denmark,KOR,Korea,2009,64,75,-11
DNK,Denmark,KOR,Korea,2010,70,50,20
DNK,Denmark,KOR,Korea,2011,98,84,14
DNK,Denmark,KOR,Korea,2012,157,111,46
DNK,Denmark,KOR,Korea,2013,165,98,67
DNK,Denmark,KOR,Korea,2014,162,121,41
DNK,Denmark,KOR,Korea,2015,169,0,169
DNK,Denmark,KOR,Korea,2016,171,132,39
DNK,Denmark,KOR,Korea,2017,185,167,18
DNK,Denmark,LUX,Luxembourg,2008,130,4,126
DNK,Denmark,LUX,Luxembourg,2009,124,6,118
DNK,Denmark,LUX,Luxembourg,2010,98,7,91
DNK,Denmark,LUX,Luxembourg,2011,104,1,103
DNK,Denmark,LUX,Luxembourg,2012,122,4,118
DNK,Denmark,LUX,Luxembourg,2013,140,5,135
DNK,Denmark,LUX,Luxembourg,2014,97,10,87
DNK,Denmark,LUX,Luxembourg,2015,92,9,83
DNK,Denmark,LUX,Luxembourg,2016,93,13,80
DNK,Denmark,LUX,Luxembourg,2017,104,15,89
DNK,Denmark,MEX,Mexico,2008,18,88,-70
DNK,Denmark,MEX,Mexico,2009,36,94,-58
DNK,Denmark,MEX,Mexico,2010,19,97,-78
DNK,Denmark,MEX,Mexico,2011,14,98,-84
DNK,Denmark,MEX,Mexico,2012,15,106,-91
DNK,Denmark,MEX,Mexico,2013,53,128,-75
DNK,Denmark,MEX,Mexico,2014,42,127,-85
DNK,Denmark,MEX,Mexico,2015,19,99,-80
DNK,Denmark,MEX,Mexico,2016,33,143,-110
DNK,Denmark,MEX,Mexico,2017,23,152,-129
DNK,Denmark,NLD,Netherlands,2008,415,398,17
DNK,Denmark,NLD,Netherlands,2009,328,347,-19
DNK,Denmark,NLD,Netherlands,2010,394,391,3
DNK,Denmark,NLD,Netherlands,2011,441,441,0
DNK,Denmark,NLD,Netherlands,2012,481,415,66
DNK,Denmark,NLD,Netherlands,2013,480,463,17
DNK,Denmark,NLD,Netherlands,2014,522,523,-1
DNK,Denmark,NLD,Netherlands,2015,507,663,-156
DNK,Denmark,NLD,Netherlands,2016,666,598,68
DNK,Denmark,NLD,Netherlands,2017,704,625,79
DNK,Denmark,NZL,New Zealand,2008,119,52,67
DNK,Denmark,NZL,New Zealand,2009,107,37,70
DNK,Denmark,NZL,New Zealand,2010,108,42,66
DNK,Denmark,NZL,New Zealand,2011,121,64,57
DNK,Denmark,NZL,New Zealand,2012,116,62,54
DNK,Denmark,NZL,New Zealand,2013,108,65,43
DNK,Denmark,NZL,New Zealand,2014,130,54,76
DNK,Denmark,NZL,New Zealand,2015,134,64,70
DNK,Denmark,NZL,New Zealand,2016,134,62,72
DNK,Denmark,NZL,New Zealand,2017,181,80,101
DNK,Denmark,NOR,Norway,2008,1345,1420,-75
DNK,Denmark,NOR,Norway,2009,1288,1291,-3
DNK,Denmark,NOR,Norway,2010,1373,1378,-5
DNK,Denmark,NOR,Norway,2011,1590,1495,95
DNK,Denmark,NOR,Norway,2012,1779,1356,423
DNK,Denmark,NOR,Norway,2013,2018,1445,573
DNK,Denmark,NOR,Norway,2014,1705,1713,-8
DNK,Denmark,NOR,Norway,2015,1395,1562,-167
DNK,Denmark,NOR,Norway,2016,1268,1524,-256
DNK,Denmark,NOR,Norway,2017,1168,1459,-291
DNK,Denmark,POL,Poland,2008,93,6529,-6436
DNK,Denmark,POL,Poland,2009,131,3383,-3252
DNK,Denmark,POL,Poland,2010,90,2928,-2838
DNK,Denmark,POL,Poland,2011,109,3158,-3049
DNK,Denmark,POL,Poland,2012,90,3313,-3223
DNK,Denmark,POL,Poland,2013,97,3623,-3526
DNK,Denmark,POL,Poland,2014,96,3990,-3894
DNK,Denmark,POL,Poland,2015,88,4085,-3997
DNK,Denmark,POL,Poland,2016,99,3777,-3678
DNK,Denmark,POL,Poland,2017,73,3719,-3646
DNK,Denmark,SVK,Slovak Republic,2008,29,316,-287
DNK,Denmark,SVK,Slovak Republic,2009,39,172,-133
DNK,Denmark,SVK,Slovak Republic,2010,37,188,-151
DNK,Denmark,SVK,Slovak Republic,2011,14,233,-219
DNK,Denmark,SVK,Slovak Republic,2012,6,334,-328
DNK,Denmark,SVK,Slovak Republic,2013,7,346,-339
DNK,Denmark,SVK,Slovak Republic,2014,9,499,-490
DNK,Denmark,SVK,Slovak Republic,2015,7,650,-643
DNK,Denmark,SVK,Slovak Republic,2016,5,557,-552
DNK,Denmark,SVK,Slovak Republic,2017,5,557,-552
DNK,Denmark,ESP,Spain,2008,728,481,247
DNK,Denmark,ESP,Spain,2009,586,466,120
DNK,Denmark,ESP,Spain,2010,639,685,-46
DNK,Denmark,ESP,Spain,2011,658,754,-96
DNK,Denmark,ESP,Spain,2012,773,890,-117
DNK,Denmark,ESP,Spain,2013,668,1005,-337
DNK,Denmark,ESP,Spain,2014,707,1084,-377
DNK,Denmark,ESP,Spain,2015,707,1030,-323
DNK,Denmark,ESP,Spain,2016,737,1110,-373
DNK,Denmark,ESP,Spain,2017,896,1136,-240
DNK,Denmark,SWE,Sweden,2008,4129,1268,2861
DNK,Denmark,SWE,Sweden,2009,3761,1141,2620
DNK,Denmark,SWE,Sweden,2010,3437,1125,2312
DNK,Denmark,SWE,Sweden,2011,3196,1138,2058
DNK,Denmark,SWE,Sweden,2012,2633,1115,1518
DNK,Denmark,SWE,Sweden,2013,2495,1299,1196
DNK,Denmark,SWE,Sweden,2014,2025,1377,648
DNK,Denmark,SWE,Sweden,2015,2130,1324,806
DNK,Denmark,SWE,Sweden,2016,2120,1422,698
DNK,Denmark,SWE,Sweden,2017,1913,1544,369
DNK,Denmark,CHE,Switzerland,2008,562,93,469
DNK,Denmark,CHE,Switzerland,2009,496,70,426
DNK,Denmark,CHE,Switzerland,2010,572,103,469
DNK,Denmark,CHE,Switzerland,2011,511,88,423
DNK,Denmark,CHE,Switzerland,2012,493,99,394
DNK,Denmark,CHE,Switzerland,2013,470,89,381
DNK,Denmark,CHE,Switzerland,2014,446,140,306
DNK,Denmark,CHE,Switzerland,2015,422,128,294
DNK,Denmark,CHE,Switzerland,2016,403,152,251
DNK,Denmark,CHE,Switzerland,2017,381,123,258
DNK,Denmark,TUR,Turkey,2010,207,561,-354
DNK,Denmark,TUR,Turkey,2016,321,438,-117
DNK,Denmark,TUR,Turkey,2017,343,611,-268
DNK,Denmark,GBR,United Kingdom,2012,1000,1035,-35
DNK,Denmark,GBR,United Kingdom,2013,2000,1139,861
DNK,Denmark,GBR,United Kingdom,2014,1000,1229,-229
DNK,Denmark,GBR,United Kingdom,2015,5000,1404,3596
DNK,Denmark,USA,United States,2008,498,913,-415
DNK,Denmark,USA,United States,2009,603,746,-143
DNK,Denmark,USA,United States,2010,518,864,-346
DNK,Denmark,USA,United States,2011,459,872,-413
DNK,Denmark,USA,United States,2012,459,897,-438
DNK,Denmark,USA,United States,2013,506,917,-411
DNK,Denmark,USA,United States,2014,514,1021,-507
DNK,Denmark,USA,United States,2015,609,1120,-511
DNK,Denmark,USA,United States,2016,521,1135,-614
DNK,Denmark,USA,United States,2017,461,1209,-748
DNK,Denmark,CHL,Chile,2008,24,40,-16
DNK,Denmark,CHL,Chile,2009,28,42,-14
DNK,Denmark,CHL,Chile,2010,16,56,-40
DNK,Denmark,CHL,Chile,2011,21,51,-30
DNK,Denmark,CHL,Chile,2012,41,62,-21
DNK,Denmark,CHL,Chile,2013,28,45,-17
DNK,Denmark,CHL,Chile,2014,36,50,-14
DNK,Denmark,CHL,Chile,2015,27,70,-43
DNK,Denmark,CHL,Chile,2016,22,104,-82
DNK,Denmark,EST,Estonia,2008,13,162,-149
DNK,Denmark,EST,Estonia,2009,11,142,-131
DNK,Denmark,EST,Estonia,2010,9,190,-181
DNK,Denmark,EST,Estonia,2011,0,214,-214
DNK,Denmark,EST,Estonia,2012,1,249,-248
DNK,Denmark,EST,Estonia,2013,2,209,-207
DNK,Denmark,EST,Estonia,2014,0,193,-193
DNK,Denmark,EST,Estonia,2015,25,170,-145
DNK,Denmark,EST,Estonia,2016,31,151,-120
DNK,Denmark,EST,Estonia,2017,31,126,-95
DNK,Denmark,SVN,Slovenia,2008,13,60,-47
DNK,Denmark,SVN,Slovenia,2009,10,45,-35
DNK,Denmark,SVN,Slovenia,2010,5,44,-39
DNK,Denmark,SVN,Slovenia,2011,9,46,-37
DNK,Denmark,SVN,Slovenia,2012,13,69,-56
DNK,Denmark,SVN,Slovenia,2013,9,59,-50
DNK,Denmark,SVN,Slovenia,2014,10,45,-35
DNK,Denmark,SVN,Slovenia,2015,8,72,-64
DNK,Denmark,SVN,Slovenia,2016,9,54,-45
DNK,Denmark,SVN,Slovenia,2017,19,65,-46
DJI,Djibouti,AUS,Australia,2008,1,0,1
DJI,Djibouti,AUS,Australia,2009,3,0,3
DJI,Djibouti,AUS,Australia,2010,4,0,4
DJI,Djibouti,AUS,Australia,2011,11,0,11
DJI,Djibouti,AUS,Australia,2012,13,0,13
DJI,Djibouti,AUS,Australia,2013,1,0,1
DJI,Djibouti,AUS,Australia,2014,6,0,6
DJI,Djibouti,AUS,Australia,2015,0,0,0
DJI,Djibouti,AUS,Australia,2016,6,0,6
DJI,Djibouti,AUS,Australia,2017,6,0,6
DJI,Djibouti,AUT,Austria,2008,0,0,0
DJI,Djibouti,AUT,Austria,2009,0,0,0
DJI,Djibouti,AUT,Austria,2010,0,0,0
DJI,Djibouti,AUT,Austria,2011,2,0,2
DJI,Djibouti,AUT,Austria,2012,0,0,0
DJI,Djibouti,AUT,Austria,2013,0,2,-2
DJI,Djibouti,AUT,Austria,2014,0,0,0
DJI,Djibouti,AUT,Austria,2015,1,0,1
DJI,Djibouti,AUT,Austria,2016,1,1,0
DJI,Djibouti,AUT,Austria,2017,0,0,0
DJI,Djibouti,BEL,Belgium,2008,14,0,14
DJI,Djibouti,BEL,Belgium,2009,28,0,28
DJI,Djibouti,BEL,Belgium,2010,28,5,23
DJI,Djibouti,BEL,Belgium,2012,123,26,97
DJI,Djibouti,BEL,Belgium,2013,149,22,127
DJI,Djibouti,BEL,Belgium,2014,139,42,97
DJI,Djibouti,BEL,Belgium,2015,126,44,82
DJI,Djibouti,BEL,Belgium,2016,119,23,96
DJI,Djibouti,BEL,Belgium,2017,87,28,59
DJI,Djibouti,CAN,Canada,2008,47,0,47
DJI,Djibouti,CAN,Canada,2009,70,0,70
DJI,Djibouti,CAN,Canada,2010,123,0,123
DJI,Djibouti,CAN,Canada,2011,127,0,127
DJI,Djibouti,CAN,Canada,2012,164,0,164
DJI,Djibouti,CAN,Canada,2013,204,0,204
DJI,Djibouti,CAN,Canada,2014,99,0,99
DJI,Djibouti,CAN,Canada,2015,147,0,147
DJI,Djibouti,CAN,Canada,2016,270,0,270
DJI,Djibouti,CAN,Canada,2017,185,0,185
DJI,Djibouti,DNK,Denmark,2008,1,0,1
DJI,Djibouti,DNK,Denmark,2009,0,0,0
DJI,Djibouti,DNK,Denmark,2012,0,0,0
DJI,Djibouti,DNK,Denmark,2013,0,0,0
DJI,Djibouti,DNK,Denmark,2014,1,0,1
DJI,Djibouti,DNK,Denmark,2015,0,0,0
DJI,Djibouti,DNK,Denmark,2016,2,0,2
DJI,Djibouti,DNK,Denmark,2017,1,0,1
DJI,Djibouti,FIN,Finland,2008,0,0,0
DJI,Djibouti,FIN,Finland,2009,1,0,1
DJI,Djibouti,FIN,Finland,2010,0,0,0
DJI,Djibouti,FIN,Finland,2011,1,0,1
DJI,Djibouti,FIN,Finland,2012,1,0,1
DJI,Djibouti,FIN,Finland,2013,0,1,-1
DJI,Djibouti,FIN,Finland,2014,0,0,0
DJI,Djibouti,FIN,Finland,2015,5,0,5
DJI,Djibouti,FIN,Finland,2016,0,0,0
DJI,Djibouti,FIN,Finland,2017,1,0,1
DJI,Djibouti,FRA,France,2008,109,0,109
DJI,Djibouti,FRA,France,2009,107,0,107
DJI,Djibouti,FRA,France,2010,99,0,99
DJI,Djibouti,FRA,France,2011,100,0,100
DJI,Djibouti,FRA,France,2012,120,0,120
DJI,Djibouti,FRA,France,2013,104,0,104
DJI,Djibouti,FRA,France,2014,118,0,118
DJI,Djibouti,FRA,France,2015,107,0,107
DJI,Djibouti,FRA,France,2016,127,0,127
DJI,Djibouti,FRA,France,2017,119,0,119
DJI,Djibouti,DEU,Germany,2008,5,10,-5
DJI,Djibouti,DEU,Germany,2009,11,11,0
DJI,Djibouti,DEU,Germany,2010,12,11,1
DJI,Djibouti,DEU,Germany,2011,6,2,4
DJI,Djibouti,DEU,Germany,2012,12,6,6
DJI,Djibouti,DEU,Germany,2013,20,9,11
DJI,Djibouti,DEU,Germany,2014,26,6,20
DJI,Djibouti,DEU,Germany,2015,16,14,2
DJI,Djibouti,DEU,Germany,2016,24,12,12
DJI,Djibouti,DEU,Germany,2017,24,8,16
DJI,Djibouti,HUN,Hungary,2008,0,0,0
DJI,Djibouti,HUN,Hungary,2009,0,0,0
DJI,Djibouti,HUN,Hungary,2010,0,0,0
DJI,Djibouti,HUN,Hungary,2011,0,0,0
DJI,Djibouti,HUN,Hungary,2012,0,0,0
DJI,Djibouti,HUN,Hungary,2013,0,0,0
DJI,Djibouti,HUN,Hungary,2014,0,0,0
DJI,Djibouti,HUN,Hungary,2015,0,0,0
DJI,Djibouti,HUN,Hungary,2016,0,0,0
DJI,Djibouti,HUN,Hungary,2017,0,0,0
DJI,Djibouti,ISL,Iceland,2008,0,0,0
DJI,Djibouti,ISL,Iceland,2009,2,2,0
DJI,Djibouti,ISL,Iceland,2010,1,1,0
DJI,Djibouti,ISL,Iceland,2011,0,0,0
DJI,Djibouti,ISL,Iceland,2012,1,0,1
DJI,Djibouti,ISL,Iceland,2013,2,0,2
DJI,Djibouti,ISL,Iceland,2014,2,6,-4
DJI,Djibouti,ISL,Iceland,2015,4,2,2
DJI,Djibouti,ISL,Iceland,2016,3,4,-1
DJI,Djibouti,ISL,Iceland,2017,2,2,0
DJI,Djibouti,ITA,Italy,2008,1,0,1
DJI,Djibouti,ITA,Italy,2009,1,0,1
DJI,Djibouti,ITA,Italy,2010,3,0,3
DJI,Djibouti,ITA,Italy,2011,2,0,2
DJI,Djibouti,ITA,Italy,2012,0,0,0
DJI,Djibouti,ITA,Italy,2013,2,0,2
DJI,Djibouti,ITA,Italy,2014,2,0,2
DJI,Djibouti,ITA,Italy,2015,1,0,1
DJI,Djibouti,ITA,Italy,2016,2,0,2
DJI,Djibouti,JPN,Japan,2008,48,48,0
DJI,Djibouti,JPN,Japan,2009,25,27,-2
DJI,Djibouti,JPN,Japan,2010,81,78,3
DJI,Djibouti,JPN,Japan,2011,31,34,-3
DJI,Djibouti,JPN,Japan,2012,39,39,0
DJI,Djibouti,JPN,Japan,2013,55,53,2
DJI,Djibouti,JPN,Japan,2014,44,42,2
DJI,Djibouti,JPN,Japan,2015,52,52,0
DJI,Djibouti,JPN,Japan,2016,51,47,4
DJI,Djibouti,JPN,Japan,2017,43,39,4
DJI,Djibouti,KOR,Korea,2008,1,1,0
DJI,Djibouti,KOR,Korea,2009,1,1,0
DJI,Djibouti,KOR,Korea,2010,1,1,0
DJI,Djibouti,KOR,Korea,2011,0,0,0
DJI,Djibouti,KOR,Korea,2012,0,4,-4
DJI,Djibouti,KOR,Korea,2013,0,0,0
DJI,Djibouti,KOR,Korea,2014,0,0,0
DJI,Djibouti,KOR,Korea,2015,0,0,0
DJI,Djibouti,KOR,Korea,2016,1,0,1
DJI,Djibouti,KOR,Korea,2017,0,1,-1
DJI,Djibouti,LUX,Luxembourg,2008,2,0,2
DJI,Djibouti,LUX,Luxembourg,2009,2,0,2
DJI,Djibouti,LUX,Luxembourg,2010,0,1,-1
DJI,Djibouti,LUX,Luxembourg,2011,0,0,0
DJI,Djibouti,LUX,Luxembourg,2012,0,0,0
DJI,Djibouti,LUX,Luxembourg,2013,0,1,-1
DJI,Djibouti,LUX,Luxembourg,2014,0,0,0
DJI,Djibouti,LUX,Luxembourg,2015,0,0,0
DJI,Djibouti,LUX,Luxembourg,2016,1,0,1
DJI,Djibouti,LUX,Luxembourg,2017,0,1,-1
DJI,Djibouti,MEX,Mexico,2012,0,0,0
DJI,Djibouti,MEX,Mexico,2013,0,0,0
DJI,Djibouti,MEX,Mexico,2014,0,0,0
DJI,Djibouti,NLD,Netherlands,2008,0,0,0
DJI,Djibouti,NLD,Netherlands,2009,2,0,2
DJI,Djibouti,NLD,Netherlands,2010,1,1,0
DJI,Djibouti,NLD,Netherlands,2011,2,0,2
DJI,Djibouti,NLD,Netherlands,2013,0,-1,1
DJI,Djibouti,NLD,Netherlands,2014,1,0,1
DJI,Djibouti,NLD,Netherlands,2015,4,0,4
DJI,Djibouti,NLD,Netherlands,2016,2,0,2
DJI,Djibouti,NLD,Netherlands,2017,5,0,5
DJI,Djibouti,NZL,New Zealand,2008,3,0,3
DJI,Djibouti,NZL,New Zealand,2009,1,0,1
DJI,Djibouti,NZL,New Zealand,2010,0,0,0
DJI,Djibouti,NZL,New Zealand,2011,1,0,1
DJI,Djibouti,NZL,New Zealand,2012,0,0,0
DJI,Djibouti,NOR,Norway,2008,6,0,6
DJI,Djibouti,NOR,Norway,2009,3,0,3
DJI,Djibouti,NOR,Norway,2010,6,1,5
DJI,Djibouti,NOR,Norway,2011,5,0,5
DJI,Djibouti,NOR,Norway,2012,6,4,2
DJI,Djibouti,NOR,Norway,2013,4,3,1
DJI,Djibouti,NOR,Norway,2014,6,2,4
DJI,Djibouti,NOR,Norway,2015,5,2,3
DJI,Djibouti,NOR,Norway,2016,2,4,-2
DJI,Djibouti,NOR,Norway,2017,3,8,-5
DJI,Djibouti,POL,Poland,2009,0,0,0
DJI,Djibouti,POL,Poland,2010,0,0,0
DJI,Djibouti,POL,Poland,2011,0,0,0
DJI,Djibouti,POL,Poland,2012,0,0,0
DJI,Djibouti,POL,Poland,2013,0,0,0
DJI,Djibouti,POL,Poland,2014,0,0,0
DJI,Djibouti,POL,Poland,2015,0,0,0
DJI,Djibouti,POL,Poland,2016,0,0,0
DJI,Djibouti,POL,Poland,2017,0,0,0
DJI,Djibouti,SVK,Slovak Republic,2008,0,0,0
DJI,Djibouti,ESP,Spain,2008,1,0,1
DJI,Djibouti,ESP,Spain,2009,1,0,1
DJI,Djibouti,ESP,Spain,2010,1,2,-1
DJI,Djibouti,ESP,Spain,2011,3,0,3
DJI,Djibouti,ESP,Spain,2012,1,2,-1
DJI,Djibouti,ESP,Spain,2013,0,0,0
DJI,Djibouti,ESP,Spain,2014,1,0,1
DJI,Djibouti,ESP,Spain,2015,0,1,-1
DJI,Djibouti,ESP,Spain,2016,2,0,2
DJI,Djibouti,SWE,Sweden,2008,7,0,7
DJI,Djibouti,SWE,Sweden,2009,8,0,8
DJI,Djibouti,SWE,Sweden,2010,8,1,7
DJI,Djibouti,SWE,Sweden,2011,8,0,8
DJI,Djibouti,SWE,Sweden,2012,28,1,27
DJI,Djibouti,SWE,Sweden,2013,22,0,22
DJI,Djibouti,SWE,Sweden,2014,24,2,22
DJI,Djibouti,SWE,Sweden,2015,36,2,34
DJI,Djibouti,SWE,Sweden,2016,47,0,47
DJI,Djibouti,SWE,Sweden,2017,47,3,44
DJI,Djibouti,CHE,Switzerland,2010,0,1,-1
DJI,Djibouti,CHE,Switzerland,2011,2,0,2
DJI,Djibouti,CHE,Switzerland,2012,4,0,4
DJI,Djibouti,CHE,Switzerland,2013,3,1,2
DJI,Djibouti,CHE,Switzerland,2014,2,0,2
DJI,Djibouti,CHE,Switzerland,2015,1,0,1
DJI,Djibouti,CHE,Switzerland,2016,2,0,2
DJI,Djibouti,CHE,Switzerland,2017,3,0,3
DJI,Djibouti,TUR,Turkey,2010,2,0,2
DJI,Djibouti,TUR,Turkey,2016,122,46,76
DJI,Djibouti,TUR,Turkey,2017,153,76,77
DJI,Djibouti,USA,United States,2008,39,0,39
DJI,Djibouti,USA,United States,2009,54,0,54
DJI,Djibouti,USA,United States,2010,37,0,37
DJI,Djibouti,USA,United States,2011,56,0,56
DJI,Djibouti,USA,United States,2012,106,0,106
DJI,Djibouti,USA,United States,2013,90,0,90
DJI,Djibouti,USA,United States,2014,190,0,190
DJI,Djibouti,USA,United States,2015,370,0,370
DJI,Djibouti,USA,United States,2016,281,0,281
DJI,Djibouti,USA,United States,2017,222,0,222
DJI,Djibouti,CHL,Chile,2008,0,0,0
DJI,Djibouti,CHL,Chile,2009,0,0,0
DJI,Djibouti,CHL,Chile,2010,0,0,0
DJI,Djibouti,CHL,Chile,2011,0,0,0
DJI,Djibouti,CHL,Chile,2012,0,0,0
DJI,Djibouti,CHL,Chile,2013,0,0,0
DJI,Djibouti,CHL,Chile,2014,0,0,0
DJI,Djibouti,CHL,Chile,2015,0,0,0
DJI,Djibouti,CHL,Chile,2016,1,0,1
DJI,Djibouti,EST,Estonia,2008,0,0,0
DJI,Djibouti,EST,Estonia,2009,0,0,0
DJI,Djibouti,EST,Estonia,2010,0,0,0
DJI,Djibouti,EST,Estonia,2011,0,0,0
DJI,Djibouti,EST,Estonia,2012,0,0,0
DJI,Djibouti,EST,Estonia,2013,0,0,0
DJI,Djibouti,EST,Estonia,2014,0,0,0
DJI,Djibouti,EST,Estonia,2015,0,0,0
DJI,Djibouti,EST,Estonia,2016,0,0,0
DJI,Djibouti,EST,Estonia,2017,0,0,0
DMA,Dominica,AUS,Australia,2008,3,0,3
DMA,Dominica,AUS,Australia,2009,1,0,1
DMA,Dominica,AUS,Australia,2010,0,0,0
DMA,Dominica,AUS,Australia,2011,0,0,0
DMA,Dominica,AUS,Australia,2012,0,0,0
DMA,Dominica,AUS,Australia,2013,4,0,4
DMA,Dominica,AUS,Australia,2014,0,0,0
DMA,Dominica,AUS,Australia,2015,0,0,0
DMA,Dominica,AUS,Australia,2016,0,0,0
DMA,Dominica,AUS,Australia,2017,3,0,3
DMA,Dominica,AUT,Austria,2008,4,2,2
DMA,Dominica,AUT,Austria,2009,3,2,1
DMA,Dominica,AUT,Austria,2010,1,0,1
DMA,Dominica,AUT,Austria,2011,2,2,0
DMA,Dominica,AUT,Austria,2012,4,1,3
DMA,Dominica,AUT,Austria,2013,3,0,3
DMA,Dominica,AUT,Austria,2014,1,0,1
DMA,Dominica,AUT,Austria,2015,4,0,4
DMA,Dominica,AUT,Austria,2016,6,0,6
DMA,Dominica,AUT,Austria,2017,6,5,1
DMA,Dominica,BEL,Belgium,2008,9,0,9
DMA,Dominica,BEL,Belgium,2009,3,0,3
DMA,Dominica,BEL,Belgium,2010,10,1,9
DMA,Dominica,BEL,Belgium,2012,7,1,6
DMA,Dominica,BEL,Belgium,2013,7,2,5
DMA,Dominica,BEL,Belgium,2014,8,2,6
DMA,Dominica,BEL,Belgium,2015,6,1,5
DMA,Dominica,BEL,Belgium,2016,4,1,3
DMA,Dominica,BEL,Belgium,2017,9,0,9
DMA,Dominica,CAN,Canada,2008,60,0,60
DMA,Dominica,CAN,Canada,2009,59,0,59
DMA,Dominica,CAN,Canada,2010,43,0,43
DMA,Dominica,CAN,Canada,2011,36,0,36
DMA,Dominica,CAN,Canada,2012,43,0,43
DMA,Dominica,CAN,Canada,2013,48,0,48
DMA,Dominica,CAN,Canada,2014,34,0,34
DMA,Dominica,CAN,Canada,2015,28,0,28
DMA,Dominica,CAN,Canada,2016,30,0,30
DMA,Dominica,CAN,Canada,2017,35,0,35
DMA,Dominica,CZE,Czech Republic,2010,1,0,1
DMA,Dominica,DNK,Denmark,2008,0,1,-1
DMA,Dominica,DNK,Denmark,2009,0,0,0
DMA,Dominica,DNK,Denmark,2012,1,0,1
DMA,Dominica,DNK,Denmark,2013,1,0,1
DMA,Dominica,DNK,Denmark,2014,1,0,1
DMA,Dominica,DNK,Denmark,2015,0,0,0
DMA,Dominica,DNK,Denmark,2016,0,0,0
DMA,Dominica,DNK,Denmark,2017,0,0,0
DMA,Dominica,FIN,Finland,2008,0,0,0
DMA,Dominica,FIN,Finland,2009,0,0,0
DMA,Dominica,FIN,Finland,2010,0,0,0
DMA,Dominica,FIN,Finland,2011,1,0,1
DMA,Dominica,FIN,Finland,2012,0,0,0
DMA,Dominica,FIN,Finland,2013,0,0,0
DMA,Dominica,FIN,Finland,2014,0,0,0
DMA,Dominica,FIN,Finland,2015,1,0,1
DMA,Dominica,FIN,Finland,2016,0,0,0
DMA,Dominica,FIN,Finland,2017,2,0,2
DMA,Dominica,FRA,France,2008,90,0,90
DMA,Dominica,FRA,France,2009,108,0,108
DMA,Dominica,FRA,France,2010,116,0,116
DMA,Dominica,FRA,France,2011,137,0,137
DMA,Dominica,FRA,France,2012,116,0,116
DMA,Dominica,FRA,France,2013,121,0,121
DMA,Dominica,FRA,France,2014,129,0,129
DMA,Dominica,FRA,France,2015,95,0,95
DMA,Dominica,FRA,France,2016,135,0,135
DMA,Dominica,FRA,France,2017,141,0,141
DMA,Dominica,DEU,Germany,2008,57,38,19
DMA,Dominica,DEU,Germany,2009,71,34,37
DMA,Dominica,DEU,Germany,2010,69,45,24
DMA,Dominica,DEU,Germany,2011,68,25,43
DMA,Dominica,DEU,Germany,2012,56,27,29
DMA,Dominica,DEU,Germany,2013,57,30,27
DMA,Dominica,DEU,Germany,2014,53,25,28
DMA,Dominica,DEU,Germany,2015,46,29,17
DMA,Dominica,DEU,Germany,2016,33,25,8
DMA,Dominica,DEU,Germany,2017,30,12,18
DMA,Dominica,HUN,Hungary,2008,0,0,0
DMA,Dominica,HUN,Hungary,2009,0,0,0
DMA,Dominica,HUN,Hungary,2010,0,0,0
DMA,Dominica,HUN,Hungary,2011,0,0,0
DMA,Dominica,HUN,Hungary,2012,0,0,0
DMA,Dominica,HUN,Hungary,2013,0,0,0
DMA,Dominica,HUN,Hungary,2014,0,0,0
DMA,Dominica,HUN,Hungary,2015,0,0,0
DMA,Dominica,HUN,Hungary,2016,2,0,2
DMA,Dominica,HUN,Hungary,2017,3,0,3
DMA,Dominica,ISL,Iceland,2008,0,0,0
DMA,Dominica,ISL,Iceland,2009,0,0,0
DMA,Dominica,ISL,Iceland,2010,1,1,0
DMA,Dominica,ISL,Iceland,2011,0,0,0
DMA,Dominica,ISL,Iceland,2012,0,0,0
DMA,Dominica,ISL,Iceland,2013,0,0,0
DMA,Dominica,ISL,Iceland,2014,1,0,1
DMA,Dominica,ISL,Iceland,2015,2,1,1
DMA,Dominica,ISL,Iceland,2016,0,1,-1
DMA,Dominica,ISL,Iceland,2017,0,0,0
DMA,Dominica,ITA,Italy,2008,119,5,114
DMA,Dominica,ITA,Italy,2009,121,7,114
DMA,Dominica,ITA,Italy,2010,140,4,136
DMA,Dominica,ITA,Italy,2011,106,5,101
DMA,Dominica,ITA,Italy,2012,153,7,146
DMA,Dominica,ITA,Italy,2013,74,8,66
DMA,Dominica,ITA,Italy,2014,85,12,73
DMA,Dominica,ITA,Italy,2015,60,5,55
DMA,Dominica,ITA,Italy,2016,72,0,72
DMA,Dominica,ITA,Italy,2017,72,4,68
DMA,Dominica,JPN,Japan,2008,25,22,3
DMA,Dominica,JPN,Japan,2009,6,9,-3
DMA,Dominica,JPN,Japan,2010,10,12,-2
DMA,Dominica,JPN,Japan,2011,10,7,3
DMA,Dominica,JPN,Japan,2012,6,10,-4
DMA,Dominica,JPN,Japan,2013,10,9,1
DMA,Dominica,JPN,Japan,2014,11,12,-1
DMA,Dominica,JPN,Japan,2015,17,17,0
DMA,Dominica,JPN,Japan,2016,6,4,2
DMA,Dominica,JPN,Japan,2017,9,9,0
DMA,Dominica,KOR,Korea,2008,2,0,2
DMA,Dominica,KOR,Korea,2009,0,2,-2
DMA,Dominica,KOR,Korea,2010,1,0,1
DMA,Dominica,KOR,Korea,2011,0,2,-2
DMA,Dominica,KOR,Korea,2012,2,2,0
DMA,Dominica,KOR,Korea,2013,0,1,-1
DMA,Dominica,KOR,Korea,2014,1,0,1
DMA,Dominica,KOR,Korea,2015,0,1,-1
DMA,Dominica,KOR,Korea,2016,0,1,-1
DMA,Dominica,KOR,Korea,2017,1,0,1
DMA,Dominica,LUX,Luxembourg,2008,0,0,0
DMA,Dominica,LUX,Luxembourg,2009,1,0,1
DMA,Dominica,LUX,Luxembourg,2010,0,0,0
DMA,Dominica,LUX,Luxembourg,2011,0,0,0
DMA,Dominica,LUX,Luxembourg,2012,0,0,0
DMA,Dominica,LUX,Luxembourg,2013,0,0,0
DMA,Dominica,LUX,Luxembourg,2014,0,0,0
DMA,Dominica,LUX,Luxembourg,2015,0,0,0
DMA,Dominica,LUX,Luxembourg,2016,0,0,0
DMA,Dominica,LUX,Luxembourg,2017,0,0,0
DMA,Dominica,MEX,Mexico,2008,2,0,2
DMA,Dominica,MEX,Mexico,2009,4,0,4
DMA,Dominica,MEX,Mexico,2010,11,0,11
DMA,Dominica,MEX,Mexico,2011,3,0,3
DMA,Dominica,MEX,Mexico,2012,5,0,5
DMA,Dominica,MEX,Mexico,2013,4,0,4
DMA,Dominica,MEX,Mexico,2014,4,0,4
DMA,Dominica,MEX,Mexico,2015,2,0,2
DMA,Dominica,MEX,Mexico,2016,2,0,2
DMA,Dominica,MEX,Mexico,2017,1,0,1
DMA,Dominica,NLD,Netherlands,2008,1,0,1
DMA,Dominica,NLD,Netherlands,2009,1,2,-1
DMA,Dominica,NLD,Netherlands,2010,2,2,0
DMA,Dominica,NLD,Netherlands,2012,1,0,1
DMA,Dominica,NLD,Netherlands,2013,2,0,2
DMA,Dominica,NLD,Netherlands,2014,1,1,0
DMA,Dominica,NLD,Netherlands,2016,0,1,-1
DMA,Dominica,NLD,Netherlands,2017,1,0,1
DMA,Dominica,NZL,New Zealand,2008,2,0,2
DMA,Dominica,NZL,New Zealand,2009,1,1,0
DMA,Dominica,NZL,New Zealand,2013,2,0,2
DMA,Dominica,NZL,New Zealand,2016,7,0,7
DMA,Dominica,NZL,New Zealand,2017,1,0,1
DMA,Dominica,NOR,Norway,2008,0,0,0
DMA,Dominica,NOR,Norway,2009,0,8,-8
DMA,Dominica,NOR,Norway,2010,0,0,0
DMA,Dominica,NOR,Norway,2011,55,0,55
DMA,Dominica,NOR,Norway,2012,0,0,0
DMA,Dominica,NOR,Norway,2013,4,0,4
DMA,Dominica,NOR,Norway,2014,0,0,0
DMA,Dominica,NOR,Norway,2015,0,0,0
DMA,Dominica,NOR,Norway,2016,0,0,0
DMA,Dominica,NOR,Norway,2017,0,0,0
DMA,Dominica,POL,Poland,2009,0,0,0
DMA,Dominica,POL,Poland,2010,0,0,0
DMA,Dominica,POL,Poland,2011,0,0,0
DMA,Dominica,POL,Poland,2012,0,0,0
DMA,Dominica,POL,Poland,2013,0,0,0
DMA,Dominica,POL,Poland,2014,0,0,0
DMA,Dominica,POL,Poland,2015,0,0,0
DMA,Dominica,POL,Poland,2016,2,0,2
DMA,Dominica,POL,Poland,2017,5,0,5
DMA,Dominica,SVK,Slovak Republic,2008,0,0,0
DMA,Dominica,ESP,Spain,2008,165,23,142
DMA,Dominica,ESP,Spain,2009,71,20,51
DMA,Dominica,ESP,Spain,2010,56,17,39
DMA,Dominica,ESP,Spain,2011,73,38,35
DMA,Dominica,ESP,Spain,2012,99,15,84
DMA,Dominica,ESP,Spain,2013,94,13,81
DMA,Dominica,ESP,Spain,2014,90,10,80
DMA,Dominica,ESP,Spain,2015,85,7,78
DMA,Dominica,ESP,Spain,2016,74,10,64
DMA,Dominica,ESP,Spain,2017,60,18,42
DMA,Dominica,SWE,Sweden,2008,2,0,2
DMA,Dominica,SWE,Sweden,2009,0,0,0
DMA,Dominica,SWE,Sweden,2010,0,0,0
DMA,Dominica,SWE,Sweden,2011,0,1,-1
DMA,Dominica,SWE,Sweden,2012,0,0,0
DMA,Dominica,SWE,Sweden,2013,0,0,0
DMA,Dominica,SWE,Sweden,2014,0,0,0
DMA,Dominica,SWE,Sweden,2015,0,0,0
DMA,Dominica,SWE,Sweden,2016,2,0,2
DMA,Dominica,SWE,Sweden,2017,2,0,2
DMA,Dominica,CHE,Switzerland,2010,0,0,0
DMA,Dominica,CHE,Switzerland,2011,1,1,0
DMA,Dominica,CHE,Switzerland,2012,4,1,3
DMA,Dominica,CHE,Switzerland,2013,1,0,1
DMA,Dominica,CHE,Switzerland,2014,0,0,0
DMA,Dominica,CHE,Switzerland,2015,2,0,2
DMA,Dominica,CHE,Switzerland,2016,1,0,1
DMA,Dominica,CHE,Switzerland,2017,4,1,3
DMA,Dominica,USA,United States,2008,454,0,454
DMA,Dominica,USA,United States,2009,484,0,484
DMA,Dominica,USA,United States,2010,366,0,366
DMA,Dominica,USA,United States,2011,287,0,287
DMA,Dominica,USA,United States,2012,125,0,125
DMA,Dominica,USA,United States,2013,244,0,244
DMA,Dominica,USA,United States,2014,345,0,345
DMA,Dominica,USA,United States,2015,229,0,229
DMA,Dominica,USA,United States,2016,298,0,298
DMA,Dominica,USA,United States,2017,510,0,510
DMA,Dominica,CHL,Chile,2008,0,0,0
DMA,Dominica,CHL,Chile,2009,0,0,0
DMA,Dominica,CHL,Chile,2010,0,0,0
DMA,Dominica,CHL,Chile,2011,0,0,0
DMA,Dominica,CHL,Chile,2012,0,0,0
DMA,Dominica,CHL,Chile,2013,0,0,0
DMA,Dominica,CHL,Chile,2014,1,0,1
DMA,Dominica,CHL,Chile,2015,0,0,0
DMA,Dominica,CHL,Chile,2016,0,0,0
DMA,Dominica,EST,Estonia,2008,0,0,0
DMA,Dominica,EST,Estonia,2009,0,0,0
DMA,Dominica,EST,Estonia,2010,0,0,0
DMA,Dominica,EST,Estonia,2011,0,0,0
DMA,Dominica,EST,Estonia,2012,0,0,0
DMA,Dominica,EST,Estonia,2013,0,0,0
DMA,Dominica,EST,Estonia,2014,0,0,0
DMA,Dominica,EST,Estonia,2015,0,0,0
DMA,Dominica,EST,Estonia,2016,0,0,0
DMA,Dominica,EST,Estonia,2017,0,0,0
DOM,Dominican Republic,AUS,Australia,2008,10,0,10
DOM,Dominican Republic,AUS,Australia,2009,8,0,8
DOM,Dominican Republic,AUS,Australia,2010,4,0,4
DOM,Dominican Republic,AUS,Australia,2011,10,0,10
DOM,Dominican Republic,AUS,Australia,2012,8,0,8
DOM,Dominican Republic,AUS,Australia,2013,14,0,14
DOM,Dominican Republic,AUS,Australia,2014,9,5,4
DOM,Dominican Republic,AUS,Australia,2015,5,0,5
DOM,Dominican Republic,AUS,Australia,2017,8,0,8
DOM,Dominican Republic,AUT,Austria,2008,178,99,79
DOM,Dominican Republic,AUT,Austria,2009,155,102,53
DOM,Dominican Republic,AUT,Austria,2010,138,104,34
DOM,Dominican Republic,AUT,Austria,2011,137,66,71
DOM,Dominican Republic,AUT,Austria,2012,106,103,3
DOM,Dominican Republic,AUT,Austria,2013,139,80,59
DOM,Dominican Republic,AUT,Austria,2014,141,60,81
DOM,Dominican Republic,AUT,Austria,2015,97,63,34
DOM,Dominican Republic,AUT,Austria,2016,104,59,45
DOM,Dominican Republic,AUT,Austria,2017,111,73,38
DOM,Dominican Republic,BEL,Belgium,2008,130,0,130
DOM,Dominican Republic,BEL,Belgium,2009,131,0,131
DOM,Dominican Republic,BEL,Belgium,2010,128,22,106
DOM,Dominican Republic,BEL,Belgium,2011,137,0,137
DOM,Dominican Republic,BEL,Belgium,2012,116,46,70
DOM,Dominican Republic,BEL,Belgium,2013,141,43,98
DOM,Dominican Republic,BEL,Belgium,2014,99,28,71
DOM,Dominican Republic,BEL,Belgium,2015,110,34,76
DOM,Dominican Republic,BEL,Belgium,2016,106,25,81
DOM,Dominican Republic,BEL,Belgium,2017,83,24,59
DOM,Dominican Republic,CAN,Canada,2008,430,0,430
DOM,Dominican Republic,CAN,Canada,2009,362,0,362
DOM,Dominican Republic,CAN,Canada,2010,455,0,455
DOM,Dominican Republic,CAN,Canada,2011,735,0,735
DOM,Dominican Republic,CAN,Canada,2012,604,0,604
DOM,Dominican Republic,CAN,Canada,2013,589,0,589
DOM,Dominican Republic,CAN,Canada,2014,445,0,445
DOM,Dominican Republic,CAN,Canada,2015,602,0,602
DOM,Dominican Republic,CAN,Canada,2016,605,0,605
DOM,Dominican Republic,CAN,Canada,2017,655,0,655
DOM,Dominican Republic,CZE,Czech Republic,2008,7,0,7
DOM,Dominican Republic,CZE,Czech Republic,2009,4,0,4
DOM,Dominican Republic,CZE,Czech Republic,2010,2,0,2
DOM,Dominican Republic,CZE,Czech Republic,2011,3,0,3
DOM,Dominican Republic,CZE,Czech Republic,2012,7,0,7
DOM,Dominican Republic,CZE,Czech Republic,2013,3,2,1
DOM,Dominican Republic,CZE,Czech Republic,2014,7,3,4
DOM,Dominican Republic,CZE,Czech Republic,2015,9,2,7
DOM,Dominican Republic,CZE,Czech Republic,2016,6,3,3
DOM,Dominican Republic,CZE,Czech Republic,2017,7,1,6
DOM,Dominican Republic,DNK,Denmark,2008,6,3,3
DOM,Dominican Republic,DNK,Denmark,2009,5,4,1
DOM,Dominican Republic,DNK,Denmark,2010,8,3,5
DOM,Dominican Republic,DNK,Denmark,2011,12,2,10
DOM,Dominican Republic,DNK,Denmark,2012,5,1,4
DOM,Dominican Republic,DNK,Denmark,2013,6,6,0
DOM,Dominican Republic,DNK,Denmark,2014,6,2,4
DOM,Dominican Republic,DNK,Denmark,2015,8,3,5
DOM,Dominican Republic,DNK,Denmark,2016,5,4,1
DOM,Dominican Republic,DNK,Denmark,2017,9,3,6
DOM,Dominican Republic,FIN,Finland,2008,10,1,9
DOM,Dominican Republic,FIN,Finland,2009,8,0,8
DOM,Dominican Republic,FIN,Finland,2010,9,0,9
DOM,Dominican Republic,FIN,Finland,2011,15,3,12
DOM,Dominican Republic,FIN,Finland,2012,11,0,11
DOM,Dominican Republic,FIN,Finland,2013,12,4,8
DOM,Dominican Republic,FIN,Finland,2014,7,0,7
DOM,Dominican Republic,FIN,Finland,2015,8,0,8
DOM,Dominican Republic,FIN,Finland,2016,5,0,5
DOM,Dominican Republic,FIN,Finland,2017,7,0,7
DOM,Dominican Republic,FRA,France,2008,296,0,296
DOM,Dominican Republic,FRA,France,2009,343,0,343
DOM,Dominican Republic,FRA,France,2010,482,0,482
DOM,Dominican Republic,FRA,France,2011,462,0,462
DOM,Dominican Republic,FRA,France,2012,445,0,445
DOM,Dominican Republic,FRA,France,2013,434,0,434
DOM,Dominican Republic,FRA,France,2014,509,0,509
DOM,Dominican Republic,FRA,France,2015,547,0,547
DOM,Dominican Republic,FRA,France,2016,547,0,547
DOM,Dominican Republic,FRA,France,2017,503,0,503
DOM,Dominican Republic,DEU,Germany,2008,497,442,55
DOM,Dominican Republic,DEU,Germany,2009,530,359,171
DOM,Dominican Republic,DEU,Germany,2010,568,381,187
DOM,Dominican Republic,DEU,Germany,2011,591,320,271
DOM,Dominican Republic,DEU,Germany,2012,613,292,321
DOM,Dominican Republic,DEU,Germany,2013,715,364,351
DOM,Dominican Republic,DEU,Germany,2014,564,338,226
DOM,Dominican Republic,DEU,Germany,2015,596,339,257
DOM,Dominican Republic,DEU,Germany,2016,598,352,246
DOM,Dominican Republic,DEU,Germany,2017,539,294,245
DOM,Dominican Republic,HUN,Hungary,2008,2,0,2
DOM,Dominican Republic,HUN,Hungary,2009,3,0,3
DOM,Dominican Republic,HUN,Hungary,2010,7,1,6
DOM,Dominican Republic,HUN,Hungary,2011,2,0,2
DOM,Dominican Republic,HUN,Hungary,2012,1,1,0
DOM,Dominican Republic,HUN,Hungary,2013,1,2,-1
DOM,Dominican Republic,HUN,Hungary,2014,3,0,3
DOM,Dominican Republic,HUN,Hungary,2015,2,0,2
DOM,Dominican Republic,HUN,Hungary,2016,3,1,2
DOM,Dominican Republic,HUN,Hungary,2017,4,0,4
DOM,Dominican Republic,ISL,Iceland,2008,4,0,4
DOM,Dominican Republic,ISL,Iceland,2009,0,0,0
DOM,Dominican Republic,ISL,Iceland,2010,4,1,3
DOM,Dominican Republic,ISL,Iceland,2011,3,0,3
DOM,Dominican Republic,ISL,Iceland,2012,2,1,1
DOM,Dominican Republic,ISL,Iceland,2013,4,1,3
DOM,Dominican Republic,ISL,Iceland,2014,1,0,1
DOM,Dominican Republic,ISL,Iceland,2015,8,1,7
DOM,Dominican Republic,ISL,Iceland,2016,5,1,4
DOM,Dominican Republic,ISL,Iceland,2017,8,0,8
DOM,Dominican Republic,ITA,Italy,2008,3082,118,2964
DOM,Dominican Republic,ITA,Italy,2009,3319,147,3172
DOM,Dominican Republic,ITA,Italy,2010,2742,144,2598
DOM,Dominican Republic,ITA,Italy,2011,2240,150,2090
DOM,Dominican Republic,ITA,Italy,2012,2565,184,2381
DOM,Dominican Republic,ITA,Italy,2013,2194,204,1990
DOM,Dominican Republic,ITA,Italy,2014,1718,229,1489
DOM,Dominican Republic,ITA,Italy,2015,1124,192,932
DOM,Dominican Republic,ITA,Italy,2016,1439,0,1439
DOM,Dominican Republic,ITA,Italy,2017,1816,181,1635
DOM,Dominican Republic,JPN,Japan,2008,105,80,25
DOM,Dominican Republic,JPN,Japan,2009,127,113,14
DOM,Dominican Republic,JPN,Japan,2010,88,77,11
DOM,Dominican Republic,JPN,Japan,2011,89,88,1
DOM,Dominican Republic,JPN,Japan,2012,70,61,9
DOM,Dominican Republic,JPN,Japan,2013,84,71,13
DOM,Dominican Republic,JPN,Japan,2014,106,76,30
DOM,Dominican Republic,JPN,Japan,2015,105,75,30
DOM,Dominican Republic,JPN,Japan,2016,93,63,30
DOM,Dominican Republic,JPN,Japan,2017,94,75,19
DOM,Dominican Republic,KOR,Korea,2008,16,13,3
DOM,Dominican Republic,KOR,Korea,2009,23,18,5
DOM,Dominican Republic,KOR,Korea,2010,16,19,-3
DOM,Dominican Republic,KOR,Korea,2011,15,14,1
DOM,Dominican Republic,KOR,Korea,2012,18,18,0
DOM,Dominican Republic,KOR,Korea,2013,27,19,8
DOM,Dominican Republic,KOR,Korea,2014,25,19,6
DOM,Dominican Republic,KOR,Korea,2015,29,30,-1
DOM,Dominican Republic,KOR,Korea,2016,38,35,3
DOM,Dominican Republic,KOR,Korea,2017,27,40,-13
DOM,Dominican Republic,LUX,Luxembourg,2008,14,9,5
DOM,Dominican Republic,LUX,Luxembourg,2009,17,4,13
DOM,Dominican Republic,LUX,Luxembourg,2010,15,2,13
DOM,Dominican Republic,LUX,Luxembourg,2011,20,5,15
DOM,Dominican Republic,LUX,Luxembourg,2012,11,7,4
DOM,Dominican Republic,LUX,Luxembourg,2013,17,5,12
DOM,Dominican Republic,LUX,Luxembourg,2014,12,9,3
DOM,Dominican Republic,LUX,Luxembourg,2015,17,1,16
DOM,Dominican Republic,LUX,Luxembourg,2016,24,7,17
DOM,Dominican Republic,LUX,Luxembourg,2017,23,7,16
DOM,Dominican Republic,MEX,Mexico,2008,120,0,120
DOM,Dominican Republic,MEX,Mexico,2009,244,0,244
DOM,Dominican Republic,MEX,Mexico,2010,195,0,195
DOM,Dominican Republic,MEX,Mexico,2011,184,0,184
DOM,Dominican Republic,MEX,Mexico,2012,154,0,154
DOM,Dominican Republic,MEX,Mexico,2013,467,0,467
DOM,Dominican Republic,MEX,Mexico,2014,343,0,343
DOM,Dominican Republic,MEX,Mexico,2015,310,0,310
DOM,Dominican Republic,MEX,Mexico,2016,314,0,314
DOM,Dominican Republic,MEX,Mexico,2017,313,0,313
DOM,Dominican Republic,NLD,Netherlands,2008,115,45,70
DOM,Dominican Republic,NLD,Netherlands,2009,154,22,132
DOM,Dominican Republic,NLD,Netherlands,2010,148,38,110
DOM,Dominican Republic,NLD,Netherlands,2011,142,41,101
DOM,Dominican Republic,NLD,Netherlands,2012,105,56,49
DOM,Dominican Republic,NLD,Netherlands,2013,94,40,54
DOM,Dominican Republic,NLD,Netherlands,2014,107,43,64
DOM,Dominican Republic,NLD,Netherlands,2015,88,25,63
DOM,Dominican Republic,NLD,Netherlands,2016,85,31,54
DOM,Dominican Republic,NLD,Netherlands,2017,91,38,53
DOM,Dominican Republic,NZL,New Zealand,2008,1,0,1
DOM,Dominican Republic,NZL,New Zealand,2009,2,1,1
DOM,Dominican Republic,NZL,New Zealand,2011,0,0,0
DOM,Dominican Republic,NZL,New Zealand,2012,3,0,3
DOM,Dominican Republic,NZL,New Zealand,2013,1,0,1
DOM,Dominican Republic,NZL,New Zealand,2015,3,0,3
DOM,Dominican Republic,NZL,New Zealand,2016,1,1,0
DOM,Dominican Republic,NOR,Norway,2008,28,8,20
DOM,Dominican Republic,NOR,Norway,2009,42,6,36
DOM,Dominican Republic,NOR,Norway,2010,37,17,20
DOM,Dominican Republic,NOR,Norway,2011,0,7,-7
DOM,Dominican Republic,NOR,Norway,2012,39,7,32
DOM,Dominican Republic,NOR,Norway,2013,44,9,35
DOM,Dominican Republic,NOR,Norway,2014,29,9,20
DOM,Dominican Republic,NOR,Norway,2015,35,13,22
DOM,Dominican Republic,NOR,Norway,2016,47,8,39
DOM,Dominican Republic,NOR,Norway,2017,37,12,25
DOM,Dominican Republic,POL,Poland,2009,14,0,14
DOM,Dominican Republic,POL,Poland,2010,16,0,16
DOM,Dominican Republic,POL,Poland,2011,19,0,19
DOM,Dominican Republic,POL,Poland,2012,16,0,16
DOM,Dominican Republic,POL,Poland,2013,15,0,15
DOM,Dominican Republic,POL,Poland,2014,10,0,10
DOM,Dominican Republic,POL,Poland,2015,12,0,12
DOM,Dominican Republic,POL,Poland,2016,10,0,10
DOM,Dominican Republic,POL,Poland,2017,13,0,13
DOM,Dominican Republic,SVK,Slovak Republic,2008,1,1,0
DOM,Dominican Republic,SVK,Slovak Republic,2009,1,0,1
DOM,Dominican Republic,SVK,Slovak Republic,2010,1,0,1
DOM,Dominican Republic,SVK,Slovak Republic,2011,1,0,1
DOM,Dominican Republic,SVK,Slovak Republic,2013,1,0,1
DOM,Dominican Republic,SVK,Slovak Republic,2015,3,0,3
DOM,Dominican Republic,SVK,Slovak Republic,2016,2,0,2
DOM,Dominican Republic,SVK,Slovak Republic,2017,1,0,1
DOM,Dominican Republic,ESP,Spain,2008,16211,2576,13635
DOM,Dominican Republic,ESP,Spain,2009,9486,3304,6182
DOM,Dominican Republic,ESP,Spain,2010,6907,3822,3085
DOM,Dominican Republic,ESP,Spain,2011,10359,4498,5861
DOM,Dominican Republic,ESP,Spain,2012,9974,5304,4670
DOM,Dominican Republic,ESP,Spain,2013,8117,7047,1070
DOM,Dominican Republic,ESP,Spain,2014,7675,4930,2745
DOM,Dominican Republic,ESP,Spain,2015,6705,3422,3283
DOM,Dominican Republic,ESP,Spain,2016,8058,3146,4912
DOM,Dominican Republic,ESP,Spain,2017,9277,3131,6146
DOM,Dominican Republic,SWE,Sweden,2008,44,13,31
DOM,Dominican Republic,SWE,Sweden,2009,42,8,34
DOM,Dominican Republic,SWE,Sweden,2010,41,5,36
DOM,Dominican Republic,SWE,Sweden,2011,21,8,13
DOM,Dominican Republic,SWE,Sweden,2012,40,11,29
DOM,Dominican Republic,SWE,Sweden,2013,42,6,36
DOM,Dominican Republic,SWE,Sweden,2014,33,9,24
DOM,Dominican Republic,SWE,Sweden,2015,22,8,14
DOM,Dominican Republic,SWE,Sweden,2016,35,2,33
DOM,Dominican Republic,SWE,Sweden,2017,30,8,22
DOM,Dominican Republic,CHE,Switzerland,2010,419,120,299
DOM,Dominican Republic,CHE,Switzerland,2011,406,129,277
DOM,Dominican Republic,CHE,Switzerland,2012,394,121,273
DOM,Dominican Republic,CHE,Switzerland,2013,459,165,294
DOM,Dominican Republic,CHE,Switzerland,2014,338,133,205
DOM,Dominican Republic,CHE,Switzerland,2015,396,104,292
DOM,Dominican Republic,CHE,Switzerland,2016,354,142,212
DOM,Dominican Republic,CHE,Switzerland,2017,300,129,171
DOM,Dominican Republic,TUR,Turkey,2010,5,0,5
DOM,Dominican Republic,USA,United States,2008,31879,0,31879
DOM,Dominican Republic,USA,United States,2009,49414,0,49414
DOM,Dominican Republic,USA,United States,2010,53870,0,53870
DOM,Dominican Republic,USA,United States,2011,46109,0,46109
DOM,Dominican Republic,USA,United States,2012,41566,0,41566
DOM,Dominican Republic,USA,United States,2013,41311,0,41311
DOM,Dominican Republic,USA,United States,2014,44577,0,44577
DOM,Dominican Republic,USA,United States,2015,50610,0,50610
DOM,Dominican Republic,USA,United States,2016,61161,0,61161
DOM,Dominican Republic,USA,United States,2017,58520,0,58520
DOM,Dominican Republic,CHL,Chile,2008,244,0,244
DOM,Dominican Republic,CHL,Chile,2009,367,0,367
DOM,Dominican Republic,CHL,Chile,2010,753,0,753
DOM,Dominican Republic,CHL,Chile,2011,1223,0,1223
DOM,Dominican Republic,CHL,Chile,2012,2948,0,2948
DOM,Dominican Republic,CHL,Chile,2013,706,0,706
DOM,Dominican Republic,CHL,Chile,2014,351,0,351
DOM,Dominican Republic,CHL,Chile,2015,564,0,564
DOM,Dominican Republic,CHL,Chile,2016,812,0,812
DOM,Dominican Republic,EST,Estonia,2008,0,0,0
DOM,Dominican Republic,EST,Estonia,2009,0,0,0
DOM,Dominican Republic,EST,Estonia,2010,0,0,0
DOM,Dominican Republic,EST,Estonia,2011,0,0,0
DOM,Dominican Republic,EST,Estonia,2012,0,0,0
DOM,Dominican Republic,EST,Estonia,2013,0,0,0
DOM,Dominican Republic,EST,Estonia,2014,0,0,0
DOM,Dominican Republic,EST,Estonia,2015,2,0,2
DOM,Dominican Republic,EST,Estonia,2016,0,0,0
DOM,Dominican Republic,EST,Estonia,2017,0,0,0
DOM,Dominican Republic,SVN,Slovenia,2008,86,0,86
DOM,Dominican Republic,SVN,Slovenia,2009,72,0,72
DOM,Dominican Republic,SVN,Slovenia,2010,30,0,30
DOM,Dominican Republic,SVN,Slovenia,2011,49,13,36
DOM,Dominican Republic,SVN,Slovenia,2012,8,3,5
DOM,Dominican Republic,SVN,Slovenia,2013,7,5,2
DOM,Dominican Republic,SVN,Slovenia,2015,9,4,5
DOM,Dominican Republic,SVN,Slovenia,2016,3,1,2
DOM,Dominican Republic,SVN,Slovenia,2017,10,2,8
ECU,Ecuador,AUS,Australia,2008,39,26,13
ECU,Ecuador,AUS,Australia,2009,45,21,24
ECU,Ecuador,AUS,Australia,2010,46,13,33
ECU,Ecuador,AUS,Australia,2011,39,19,20
ECU,Ecuador,AUS,Australia,2012,40,26,14
ECU,Ecuador,AUS,Australia,2013,34,35,-1
ECU,Ecuador,AUS,Australia,2014,51,28,23
ECU,Ecuador,AUS,Australia,2015,33,0,33
ECU,Ecuador,AUS,Australia,2016,41,0,41
ECU,Ecuador,AUS,Australia,2017,33,0,33
ECU,Ecuador,AUT,Austria,2008,35,26,9
ECU,Ecuador,AUT,Austria,2009,41,30,11
ECU,Ecuador,AUT,Austria,2010,48,29,19
ECU,Ecuador,AUT,Austria,2011,42,41,1
ECU,Ecuador,AUT,Austria,2012,54,28,26
ECU,Ecuador,AUT,Austria,2013,56,36,20
ECU,Ecuador,AUT,Austria,2014,41,38,3
ECU,Ecuador,AUT,Austria,2015,39,19,20
ECU,Ecuador,AUT,Austria,2016,38,21,17
ECU,Ecuador,AUT,Austria,2017,26,23,3
ECU,Ecuador,BEL,Belgium,2008,351,0,351
ECU,Ecuador,BEL,Belgium,2009,490,0,490
ECU,Ecuador,BEL,Belgium,2010,858,101,757
ECU,Ecuador,BEL,Belgium,2011,399,0,399
ECU,Ecuador,BEL,Belgium,2012,298,99,199
ECU,Ecuador,BEL,Belgium,2013,209,122,87
ECU,Ecuador,BEL,Belgium,2014,120,88,32
ECU,Ecuador,BEL,Belgium,2015,133,87,46
ECU,Ecuador,BEL,Belgium,2016,166,98,68
ECU,Ecuador,BEL,Belgium,2017,164,72,92
ECU,Ecuador,CAN,Canada,2008,437,0,437
ECU,Ecuador,CAN,Canada,2009,373,0,373
ECU,Ecuador,CAN,Canada,2010,353,0,353
ECU,Ecuador,CAN,Canada,2011,348,0,348
ECU,Ecuador,CAN,Canada,2012,279,0,279
ECU,Ecuador,CAN,Canada,2013,418,0,418
ECU,Ecuador,CAN,Canada,2014,334,0,334
ECU,Ecuador,CAN,Canada,2015,215,0,215
ECU,Ecuador,CAN,Canada,2016,250,0,250
ECU,Ecuador,CAN,Canada,2017,210,0,210
ECU,Ecuador,CZE,Czech Republic,2008,15,0,15
ECU,Ecuador,CZE,Czech Republic,2009,4,0,4
ECU,Ecuador,CZE,Czech Republic,2010,6,0,6
ECU,Ecuador,CZE,Czech Republic,2011,6,0,6
ECU,Ecuador,CZE,Czech Republic,2012,6,4,2
ECU,Ecuador,CZE,Czech Republic,2013,7,9,-2
ECU,Ecuador,CZE,Czech Republic,2014,8,4,4
ECU,Ecuador,CZE,Czech Republic,2015,6,5,1
ECU,Ecuador,CZE,Czech Republic,2016,11,4,7
ECU,Ecuador,CZE,Czech Republic,2017,22,10,12
ECU,Ecuador,DNK,Denmark,2008,19,8,11
ECU,Ecuador,DNK,Denmark,2009,20,11,9
ECU,Ecuador,DNK,Denmark,2010,21,9,12
ECU,Ecuador,DNK,Denmark,2011,12,19,-7
ECU,Ecuador,DNK,Denmark,2012,18,13,5
ECU,Ecuador,DNK,Denmark,2013,25,19,6
ECU,Ecuador,DNK,Denmark,2014,24,18,6
ECU,Ecuador,DNK,Denmark,2015,21,21,0
ECU,Ecuador,DNK,Denmark,2016,20,16,4
ECU,Ecuador,DNK,Denmark,2017,17,22,-5
ECU,Ecuador,FIN,Finland,2008,11,3,8
ECU,Ecuador,FIN,Finland,2009,21,1,20
ECU,Ecuador,FIN,Finland,2010,13,1,12
ECU,Ecuador,FIN,Finland,2011,14,2,12
ECU,Ecuador,FIN,Finland,2012,14,6,8
ECU,Ecuador,FIN,Finland,2013,12,1,11
ECU,Ecuador,FIN,Finland,2014,4,8,-4
ECU,Ecuador,FIN,Finland,2015,10,3,7
ECU,Ecuador,FIN,Finland,2016,12,2,10
ECU,Ecuador,FIN,Finland,2017,9,3,6
ECU,Ecuador,FRA,France,2008,227,0,227
ECU,Ecuador,FRA,France,2009,221,0,221
ECU,Ecuador,FRA,France,2010,230,0,230
ECU,Ecuador,FRA,France,2011,191,0,191
ECU,Ecuador,FRA,France,2012,195,0,195
ECU,Ecuador,FRA,France,2013,217,0,217
ECU,Ecuador,FRA,France,2014,179,0,179
ECU,Ecuador,FRA,France,2015,142,0,142
ECU,Ecuador,FRA,France,2016,151,0,151
ECU,Ecuador,FRA,France,2017,172,0,172
ECU,Ecuador,DEU,Germany,2008,578,490,88
ECU,Ecuador,DEU,Germany,2009,600,498,102
ECU,Ecuador,DEU,Germany,2010,666,478,188
ECU,Ecuador,DEU,Germany,2011,710,441,269
ECU,Ecuador,DEU,Germany,2012,815,438,377
ECU,Ecuador,DEU,Germany,2013,795,500,295
ECU,Ecuador,DEU,Germany,2014,713,486,227
ECU,Ecuador,DEU,Germany,2015,776,493,283
ECU,Ecuador,DEU,Germany,2016,830,460,370
ECU,Ecuador,DEU,Germany,2017,835,434,401
ECU,Ecuador,HUN,Hungary,2008,11,2,9
ECU,Ecuador,HUN,Hungary,2009,2,2,0
ECU,Ecuador,HUN,Hungary,2010,8,3,5
ECU,Ecuador,HUN,Hungary,2011,5,1,4
ECU,Ecuador,HUN,Hungary,2012,7,0,7
ECU,Ecuador,HUN,Hungary,2013,3,0,3
ECU,Ecuador,HUN,Hungary,2014,6,1,5
ECU,Ecuador,HUN,Hungary,2015,49,1,48
ECU,Ecuador,HUN,Hungary,2016,43,0,43
ECU,Ecuador,HUN,Hungary,2017,61,0,61
ECU,Ecuador,ISL,Iceland,2008,0,2,-2
ECU,Ecuador,ISL,Iceland,2009,3,1,2
ECU,Ecuador,ISL,Iceland,2010,3,5,-2
ECU,Ecuador,ISL,Iceland,2011,7,0,7
ECU,Ecuador,ISL,Iceland,2012,1,1,0
ECU,Ecuador,ISL,Iceland,2013,3,1,2
ECU,Ecuador,ISL,Iceland,2014,2,2,0
ECU,Ecuador,ISL,Iceland,2015,3,1,2
ECU,Ecuador,ISL,Iceland,2016,2,2,0
ECU,Ecuador,ISL,Iceland,2017,3,1,2
ECU,Ecuador,ITA,Italy,2008,6874,293,6581
ECU,Ecuador,ITA,Italy,2009,6324,334,5990
ECU,Ecuador,ITA,Italy,2010,6168,434,5734
ECU,Ecuador,ITA,Italy,2011,4164,411,3753
ECU,Ecuador,ITA,Italy,2012,3037,537,2500
ECU,Ecuador,ITA,Italy,2013,1926,777,1149
ECU,Ecuador,ITA,Italy,2014,1120,744,376
ECU,Ecuador,ITA,Italy,2015,814,599,215
ECU,Ecuador,ITA,Italy,2016,717,0,717
ECU,Ecuador,ITA,Italy,2017,1022,240,782
ECU,Ecuador,JPN,Japan,2008,106,89,17
ECU,Ecuador,JPN,Japan,2009,156,132,24
ECU,Ecuador,JPN,Japan,2010,220,222,-2
ECU,Ecuador,JPN,Japan,2011,118,99,19
ECU,Ecuador,JPN,Japan,2012,153,139,14
ECU,Ecuador,JPN,Japan,2013,100,89,11
ECU,Ecuador,JPN,Japan,2014,130,120,10
ECU,Ecuador,JPN,Japan,2015,144,137,7
ECU,Ecuador,JPN,Japan,2016,117,100,17
ECU,Ecuador,JPN,Japan,2017,147,120,27
ECU,Ecuador,KOR,Korea,2008,46,39,7
ECU,Ecuador,KOR,Korea,2009,37,43,-6
ECU,Ecuador,KOR,Korea,2010,46,35,11
ECU,Ecuador,KOR,Korea,2011,54,41,13
ECU,Ecuador,KOR,Korea,2012,61,71,-10
ECU,Ecuador,KOR,Korea,2013,73,48,25
ECU,Ecuador,KOR,Korea,2014,104,74,30
ECU,Ecuador,KOR,Korea,2015,106,79,27
ECU,Ecuador,KOR,Korea,2016,110,93,17
ECU,Ecuador,KOR,Korea,2017,107,96,11
ECU,Ecuador,LUX,Luxembourg,2008,4,10,-6
ECU,Ecuador,LUX,Luxembourg,2009,6,3,3
ECU,Ecuador,LUX,Luxembourg,2010,13,1,12
ECU,Ecuador,LUX,Luxembourg,2011,5,1,4
ECU,Ecuador,LUX,Luxembourg,2012,1,3,-2
ECU,Ecuador,LUX,Luxembourg,2013,11,0,11
ECU,Ecuador,LUX,Luxembourg,2014,7,3,4
ECU,Ecuador,LUX,Luxembourg,2015,3,1,2
ECU,Ecuador,LUX,Luxembourg,2016,4,3,1
ECU,Ecuador,LUX,Luxembourg,2017,4,2,2
ECU,Ecuador,MEX,Mexico,2008,130,0,130
ECU,Ecuador,MEX,Mexico,2009,226,0,226
ECU,Ecuador,MEX,Mexico,2010,232,0,232
ECU,Ecuador,MEX,Mexico,2011,169,0,169
ECU,Ecuador,MEX,Mexico,2012,182,0,182
ECU,Ecuador,MEX,Mexico,2013,507,0,507
ECU,Ecuador,MEX,Mexico,2014,377,0,377
ECU,Ecuador,MEX,Mexico,2015,262,0,262
ECU,Ecuador,MEX,Mexico,2016,304,0,304
ECU,Ecuador,MEX,Mexico,2017,232,0,232
ECU,Ecuador,NLD,Netherlands,2008,128,64,64
ECU,Ecuador,NLD,Netherlands,2009,111,53,58
ECU,Ecuador,NLD,Netherlands,2010,132,74,58
ECU,Ecuador,NLD,Netherlands,2011,122,62,60
ECU,Ecuador,NLD,Netherlands,2012,126,86,40
ECU,Ecuador,NLD,Netherlands,2013,128,79,49
ECU,Ecuador,NLD,Netherlands,2014,131,73,58
ECU,Ecuador,NLD,Netherlands,2015,156,99,57
ECU,Ecuador,NLD,Netherlands,2016,135,90,45
ECU,Ecuador,NLD,Netherlands,2017,137,116,21
ECU,Ecuador,NZL,New Zealand,2008,4,0,4
ECU,Ecuador,NZL,New Zealand,2009,16,3,13
ECU,Ecuador,NZL,New Zealand,2010,12,4,8
ECU,Ecuador,NZL,New Zealand,2011,23,3,20
ECU,Ecuador,NZL,New Zealand,2012,16,5,11
ECU,Ecuador,NZL,New Zealand,2013,21,3,18
ECU,Ecuador,NZL,New Zealand,2014,37,3,34
ECU,Ecuador,NZL,New Zealand,2015,16,5,11
ECU,Ecuador,NZL,New Zealand,2016,16,3,13
ECU,Ecuador,NZL,New Zealand,2017,25,4,21
ECU,Ecuador,NOR,Norway,2008,31,12,19
ECU,Ecuador,NOR,Norway,2009,26,0,26
ECU,Ecuador,NOR,Norway,2010,17,12,5
ECU,Ecuador,NOR,Norway,2011,22,17,5
ECU,Ecuador,NOR,Norway,2012,25,16,9
ECU,Ecuador,NOR,Norway,2013,33,16,17
ECU,Ecuador,NOR,Norway,2014,25,10,15
ECU,Ecuador,NOR,Norway,2015,16,3,13
ECU,Ecuador,NOR,Norway,2016,14,11,3
ECU,Ecuador,NOR,Norway,2017,16,7,9
ECU,Ecuador,POL,Poland,2008,25,0,25
ECU,Ecuador,POL,Poland,2009,28,0,28
ECU,Ecuador,POL,Poland,2010,17,0,17
ECU,Ecuador,POL,Poland,2011,19,0,19
ECU,Ecuador,POL,Poland,2012,19,0,19
ECU,Ecuador,POL,Poland,2013,14,0,14
ECU,Ecuador,POL,Poland,2014,7,0,7
ECU,Ecuador,POL,Poland,2015,15,0,15
ECU,Ecuador,POL,Poland,2016,10,0,10
ECU,Ecuador,POL,Poland,2017,21,0,21
ECU,Ecuador,SVK,Slovak Republic,2008,1,4,-3
ECU,Ecuador,SVK,Slovak Republic,2009,2,1,1
ECU,Ecuador,SVK,Slovak Republic,2010,3,1,2
ECU,Ecuador,SVK,Slovak Republic,2011,1,0,1
ECU,Ecuador,SVK,Slovak Republic,2013,2,0,2
ECU,Ecuador,SVK,Slovak Republic,2014,1,0,1
ECU,Ecuador,SVK,Slovak Republic,2015,2,0,2
ECU,Ecuador,SVK,Slovak Republic,2017,1,0,1
ECU,Ecuador,ESP,Spain,2008,32464,12964,19500
ECU,Ecuador,ESP,Spain,2009,13512,18108,-4596
ECU,Ecuador,ESP,Spain,2010,6939,21112,-14173
ECU,Ecuador,ESP,Spain,2011,6523,21097,-14574
ECU,Ecuador,ESP,Spain,2012,5581,21280,-15699
ECU,Ecuador,ESP,Spain,2013,5262,23245,-17983
ECU,Ecuador,ESP,Spain,2014,4943,13031,-8088
ECU,Ecuador,ESP,Spain,2015,5252,7750,-2498
ECU,Ecuador,ESP,Spain,2016,6762,6235,527
ECU,Ecuador,ESP,Spain,2017,8954,8068,886
ECU,Ecuador,SWE,Sweden,2008,106,11,95
ECU,Ecuador,SWE,Sweden,2009,97,10,87
ECU,Ecuador,SWE,Sweden,2010,112,17,95
ECU,Ecuador,SWE,Sweden,2011,90,10,80
ECU,Ecuador,SWE,Sweden,2012,82,21,61
ECU,Ecuador,SWE,Sweden,2013,59,11,48
ECU,Ecuador,SWE,Sweden,2014,59,28,31
ECU,Ecuador,SWE,Sweden,2015,66,34,32
ECU,Ecuador,SWE,Sweden,2016,36,17,19
ECU,Ecuador,SWE,Sweden,2017,46,13,33
ECU,Ecuador,CHE,Switzerland,2010,345,75,270
ECU,Ecuador,CHE,Switzerland,2011,326,77,249
ECU,Ecuador,CHE,Switzerland,2012,281,73,208
ECU,Ecuador,CHE,Switzerland,2013,290,77,213
ECU,Ecuador,CHE,Switzerland,2014,203,69,134
ECU,Ecuador,CHE,Switzerland,2015,203,81,122
ECU,Ecuador,CHE,Switzerland,2016,202,70,132
ECU,Ecuador,CHE,Switzerland,2017,204,58,146
ECU,Ecuador,TUR,Turkey,2010,7,0,7
ECU,Ecuador,USA,United States,2008,11663,0,11663
ECU,Ecuador,USA,United States,2009,12128,0,12128
ECU,Ecuador,USA,United States,2010,11492,0,11492
ECU,Ecuador,USA,United States,2011,11103,0,11103
ECU,Ecuador,USA,United States,2012,9342,0,9342
ECU,Ecuador,USA,United States,2013,10591,0,10591
ECU,Ecuador,USA,United States,2014,10960,0,10960
ECU,Ecuador,USA,United States,2015,10187,0,10187
ECU,Ecuador,USA,United States,2016,10757,0,10757
ECU,Ecuador,USA,United States,2017,10594,0,10594
ECU,Ecuador,CHL,Chile,2008,2030,0,2030
ECU,Ecuador,CHL,Chile,2009,1804,0,1804
ECU,Ecuador,CHL,Chile,2010,1573,0,1573
ECU,Ecuador,CHL,Chile,2011,1890,0,1890
ECU,Ecuador,CHL,Chile,2012,2048,0,2048
ECU,Ecuador,CHL,Chile,2013,2256,0,2256
ECU,Ecuador,CHL,Chile,2014,2190,0,2190
ECU,Ecuador,CHL,Chile,2015,2844,0,2844
ECU,Ecuador,CHL,Chile,2016,4318,0,4318
ECU,Ecuador,EST,Estonia,2008,0,0,0
ECU,Ecuador,EST,Estonia,2009,1,0,1
ECU,Ecuador,EST,Estonia,2010,0,0,0
ECU,Ecuador,EST,Estonia,2011,0,0,0
ECU,Ecuador,EST,Estonia,2012,1,0,1
ECU,Ecuador,EST,Estonia,2013,0,0,0
ECU,Ecuador,EST,Estonia,2014,1,0,1
ECU,Ecuador,EST,Estonia,2015,2,0,2
ECU,Ecuador,EST,Estonia,2016,3,0,3
ECU,Ecuador,EST,Estonia,2017,2,0,2
ECU,Ecuador,SVN,Slovenia,2008,1,0,1
ECU,Ecuador,SVN,Slovenia,2009,2,0,2
ECU,Ecuador,SVN,Slovenia,2010,1,0,1
ECU,Ecuador,SVN,Slovenia,2014,1,0,1
ECU,Ecuador,SVN,Slovenia,2015,3,0,3
EGY,Egypt,AUS,Australia,2008,703,159,544
EGY,Egypt,AUS,Australia,2009,878,155,723
EGY,Egypt,AUS,Australia,2010,955,147,808
EGY,Egypt,AUS,Australia,2011,898,154,744
EGY,Egypt,AUS,Australia,2012,948,143,805
EGY,Egypt,AUS,Australia,2013,1307,178,1129
EGY,Egypt,AUS,Australia,2014,1362,214,1148
EGY,Egypt,AUS,Australia,2015,1225,200,1025
EGY,Egypt,AUS,Australia,2016,1274,200,1074
EGY,Egypt,AUS,Australia,2017,1423,0,1423
EGY,Egypt,AUT,Austria,2008,494,374,120
EGY,Egypt,AUT,Austria,2009,478,389,89
EGY,Egypt,AUT,Austria,2010,409,376,33
EGY,Egypt,AUT,Austria,2011,520,337,183
EGY,Egypt,AUT,Austria,2012,623,344,279
EGY,Egypt,AUT,Austria,2013,664,351,313
EGY,Egypt,AUT,Austria,2014,610,344,266
EGY,Egypt,AUT,Austria,2015,654,321,333
EGY,Egypt,AUT,Austria,2016,629,364,265
EGY,Egypt,AUT,Austria,2017,705,355,350
EGY,Egypt,BEL,Belgium,2008,257,0,257
EGY,Egypt,BEL,Belgium,2009,291,0,291
EGY,Egypt,BEL,Belgium,2010,268,31,237
EGY,Egypt,BEL,Belgium,2011,303,0,303
EGY,Egypt,BEL,Belgium,2012,312,141,171
EGY,Egypt,BEL,Belgium,2013,387,218,169
EGY,Egypt,BEL,Belgium,2014,294,152,142
EGY,Egypt,BEL,Belgium,2015,245,170,75
EGY,Egypt,BEL,Belgium,2016,314,109,205
EGY,Egypt,BEL,Belgium,2017,322,86,236
EGY,Egypt,CAN,Canada,2008,3347,0,3347
EGY,Egypt,CAN,Canada,2009,3495,0,3495
EGY,Egypt,CAN,Canada,2010,5982,0,5982
EGY,Egypt,CAN,Canada,2011,4663,0,4663
EGY,Egypt,CAN,Canada,2012,5550,0,5550
EGY,Egypt,CAN,Canada,2013,4165,0,4165
EGY,Egypt,CAN,Canada,2014,3159,0,3159
EGY,Egypt,CAN,Canada,2015,3762,0,3762
EGY,Egypt,CAN,Canada,2016,3090,0,3090
EGY,Egypt,CAN,Canada,2017,2865,0,2865
EGY,Egypt,CZE,Czech Republic,2008,97,0,97
EGY,Egypt,CZE,Czech Republic,2009,106,0,106
EGY,Egypt,CZE,Czech Republic,2010,80,1,79
EGY,Egypt,CZE,Czech Republic,2011,58,0,58
EGY,Egypt,CZE,Czech Republic,2012,83,27,56
EGY,Egypt,CZE,Czech Republic,2013,81,34,47
EGY,Egypt,CZE,Czech Republic,2014,140,54,86
EGY,Egypt,CZE,Czech Republic,2015,101,50,51
EGY,Egypt,CZE,Czech Republic,2016,128,50,78
EGY,Egypt,CZE,Czech Republic,2017,204,37,167
EGY,Egypt,DNK,Denmark,2008,47,23,24
EGY,Egypt,DNK,Denmark,2009,69,20,49
EGY,Egypt,DNK,Denmark,2010,48,28,20
EGY,Egypt,DNK,Denmark,2011,78,26,52
EGY,Egypt,DNK,Denmark,2012,60,23,37
EGY,Egypt,DNK,Denmark,2013,106,52,54
EGY,Egypt,DNK,Denmark,2014,105,26,79
EGY,Egypt,DNK,Denmark,2015,93,60,33
EGY,Egypt,DNK,Denmark,2016,87,64,23
EGY,Egypt,DNK,Denmark,2017,110,75,35
EGY,Egypt,FIN,Finland,2008,50,8,42
EGY,Egypt,FIN,Finland,2009,67,4,63
EGY,Egypt,FIN,Finland,2010,60,14,46
EGY,Egypt,FIN,Finland,2011,60,4,56
EGY,Egypt,FIN,Finland,2012,86,16,70
EGY,Egypt,FIN,Finland,2013,78,8,70
EGY,Egypt,FIN,Finland,2014,89,10,79
EGY,Egypt,FIN,Finland,2015,79,16,63
EGY,Egypt,FIN,Finland,2016,102,25,77
EGY,Egypt,FIN,Finland,2017,82,20,62
EGY,Egypt,FRA,France,2008,871,0,871
EGY,Egypt,FRA,France,2009,1008,0,1008
EGY,Egypt,FRA,France,2010,918,0,918
EGY,Egypt,FRA,France,2011,1018,0,1018
EGY,Egypt,FRA,France,2012,1208,0,1208
EGY,Egypt,FRA,France,2013,1249,0,1249
EGY,Egypt,FRA,France,2014,1445,0,1445
EGY,Egypt,FRA,France,2015,1216,0,1216
EGY,Egypt,FRA,France,2016,1298,0,1298
EGY,Egypt,FRA,France,2017,1255,0,1255
EGY,Egypt,DEU,Germany,2008,1847,1599,248
EGY,Egypt,DEU,Germany,2009,1906,1770,136
EGY,Egypt,DEU,Germany,2010,2057,1676,381
EGY,Egypt,DEU,Germany,2011,2254,1607,647
EGY,Egypt,DEU,Germany,2012,2916,1573,1343
EGY,Egypt,DEU,Germany,2013,5465,1962,3503
EGY,Egypt,DEU,Germany,2014,4650,2101,2549
EGY,Egypt,DEU,Germany,2015,5831,2564,3267
EGY,Egypt,DEU,Germany,2016,6723,2887,3836
EGY,Egypt,DEU,Germany,2017,5913,2753,3160
EGY,Egypt,GRC,Greece,2008,1404,0,1404
EGY,Egypt,GRC,Greece,2009,1400,0,1400
EGY,Egypt,GRC,Greece,2010,1084,0,1084
EGY,Egypt,GRC,Greece,2011,908,0,908
EGY,Egypt,HUN,Hungary,2008,96,2,94
EGY,Egypt,HUN,Hungary,2009,114,5,109
EGY,Egypt,HUN,Hungary,2010,81,9,72
EGY,Egypt,HUN,Hungary,2011,79,14,65
EGY,Egypt,HUN,Hungary,2012,127,5,122
EGY,Egypt,HUN,Hungary,2013,129,16,113
EGY,Egypt,HUN,Hungary,2014,155,27,128
EGY,Egypt,HUN,Hungary,2015,143,40,103
EGY,Egypt,HUN,Hungary,2016,154,26,128
EGY,Egypt,HUN,Hungary,2017,186,0,186
EGY,Egypt,ISL,Iceland,2008,3,1,2
EGY,Egypt,ISL,Iceland,2009,3,1,2
EGY,Egypt,ISL,Iceland,2010,3,3,0
EGY,Egypt,ISL,Iceland,2011,4,0,4
EGY,Egypt,ISL,Iceland,2012,5,0,5
EGY,Egypt,ISL,Iceland,2013,0,1,-1
EGY,Egypt,ISL,Iceland,2014,2,1,1
EGY,Egypt,ISL,Iceland,2015,7,1,6
EGY,Egypt,ISL,Iceland,2016,4,1,3
EGY,Egypt,ISL,Iceland,2017,0,1,-1
EGY,Egypt,ITA,Italy,2008,5274,111,5163
EGY,Egypt,ITA,Italy,2009,7977,137,7840
EGY,Egypt,ITA,Italy,2010,9345,333,9012
EGY,Egypt,ITA,Italy,2011,9572,304,9268
EGY,Egypt,ITA,Italy,2012,8623,449,8174
EGY,Egypt,ITA,Italy,2013,9754,360,9394
EGY,Egypt,ITA,Italy,2014,8665,434,8231
EGY,Egypt,ITA,Italy,2015,7448,446,7002
EGY,Egypt,ITA,Italy,2016,6631,0,6631
EGY,Egypt,ITA,Italy,2017,7709,375,7334
EGY,Egypt,JPN,Japan,2008,857,659,198
EGY,Egypt,JPN,Japan,2009,625,615,10
EGY,Egypt,JPN,Japan,2010,635,802,-167
EGY,Egypt,JPN,Japan,2011,521,592,-71
EGY,Egypt,JPN,Japan,2012,831,694,137
EGY,Egypt,JPN,Japan,2013,893,552,341
EGY,Egypt,JPN,Japan,2014,870,619,251
EGY,Egypt,JPN,Japan,2015,957,659,298
EGY,Egypt,JPN,Japan,2016,1130,824,306
EGY,Egypt,JPN,Japan,2017,924,773,151
EGY,Egypt,KOR,Korea,2008,351,431,-80
EGY,Egypt,KOR,Korea,2009,275,387,-112
EGY,Egypt,KOR,Korea,2010,387,286,101
EGY,Egypt,KOR,Korea,2011,529,349,180
EGY,Egypt,KOR,Korea,2012,419,299,120
EGY,Egypt,KOR,Korea,2013,863,342,521
EGY,Egypt,KOR,Korea,2014,1171,489,682
EGY,Egypt,KOR,Korea,2015,1024,551,473
EGY,Egypt,KOR,Korea,2016,1127,668,459
EGY,Egypt,KOR,Korea,2017,991,635,356
EGY,Egypt,LUX,Luxembourg,2008,15,0,15
EGY,Egypt,LUX,Luxembourg,2009,9,2,7
EGY,Egypt,LUX,Luxembourg,2010,10,8,2
EGY,Egypt,LUX,Luxembourg,2011,13,2,11
EGY,Egypt,LUX,Luxembourg,2012,17,1,16
EGY,Egypt,LUX,Luxembourg,2013,25,9,16
EGY,Egypt,LUX,Luxembourg,2014,20,8,12
EGY,Egypt,LUX,Luxembourg,2015,15,10,5
EGY,Egypt,LUX,Luxembourg,2016,43,6,37
EGY,Egypt,LUX,Luxembourg,2017,50,10,40
EGY,Egypt,MEX,Mexico,2008,20,0,20
EGY,Egypt,MEX,Mexico,2009,31,0,31
EGY,Egypt,MEX,Mexico,2010,26,0,26
EGY,Egypt,MEX,Mexico,2011,30,0,30
EGY,Egypt,MEX,Mexico,2012,31,0,31
EGY,Egypt,MEX,Mexico,2013,56,0,56
EGY,Egypt,MEX,Mexico,2014,37,0,37
EGY,Egypt,MEX,Mexico,2015,40,0,40
EGY,Egypt,MEX,Mexico,2016,36,0,36
EGY,Egypt,MEX,Mexico,2017,41,0,41
EGY,Egypt,NLD,Netherlands,2008,356,162,194
EGY,Egypt,NLD,Netherlands,2009,568,207,361
EGY,Egypt,NLD,Netherlands,2010,425,164,261
EGY,Egypt,NLD,Netherlands,2011,394,164,230
EGY,Egypt,NLD,Netherlands,2012,410,192,218
EGY,Egypt,NLD,Netherlands,2013,525,226,299
EGY,Egypt,NLD,Netherlands,2014,562,164,398
EGY,Egypt,NLD,Netherlands,2015,451,206,245
EGY,Egypt,NLD,Netherlands,2016,655,243,412
EGY,Egypt,NLD,Netherlands,2017,821,218,603
EGY,Egypt,NZL,New Zealand,2008,58,9,49
EGY,Egypt,NZL,New Zealand,2009,48,9,39
EGY,Egypt,NZL,New Zealand,2010,46,13,33
EGY,Egypt,NZL,New Zealand,2011,53,5,48
EGY,Egypt,NZL,New Zealand,2012,63,12,51
EGY,Egypt,NZL,New Zealand,2013,69,12,57
EGY,Egypt,NZL,New Zealand,2014,120,7,113
EGY,Egypt,NZL,New Zealand,2015,127,7,120
EGY,Egypt,NZL,New Zealand,2016,165,19,146
EGY,Egypt,NZL,New Zealand,2017,138,13,125
EGY,Egypt,NOR,Norway,2008,51,17,34
EGY,Egypt,NOR,Norway,2009,62,15,47
EGY,Egypt,NOR,Norway,2010,55,21,34
EGY,Egypt,NOR,Norway,2011,79,38,41
EGY,Egypt,NOR,Norway,2012,105,20,85
EGY,Egypt,NOR,Norway,2013,89,38,51
EGY,Egypt,NOR,Norway,2014,106,32,74
EGY,Egypt,NOR,Norway,2015,68,50,18
EGY,Egypt,NOR,Norway,2016,87,38,49
EGY,Egypt,NOR,Norway,2017,99,17,82
EGY,Egypt,POL,Poland,2008,249,0,249
EGY,Egypt,POL,Poland,2009,339,0,339
EGY,Egypt,POL,Poland,2010,441,0,441
EGY,Egypt,POL,Poland,2011,483,0,483
EGY,Egypt,POL,Poland,2012,500,0,500
EGY,Egypt,POL,Poland,2013,532,0,532
EGY,Egypt,POL,Poland,2014,267,0,267
EGY,Egypt,POL,Poland,2015,553,0,553
EGY,Egypt,POL,Poland,2016,513,0,513
EGY,Egypt,POL,Poland,2017,540,0,540
EGY,Egypt,SVK,Slovak Republic,2008,15,9,6
EGY,Egypt,SVK,Slovak Republic,2009,14,4,10
EGY,Egypt,SVK,Slovak Republic,2010,11,6,5
EGY,Egypt,SVK,Slovak Republic,2011,9,2,7
EGY,Egypt,SVK,Slovak Republic,2012,10,0,10
EGY,Egypt,SVK,Slovak Republic,2013,6,0,6
EGY,Egypt,SVK,Slovak Republic,2014,4,0,4
EGY,Egypt,SVK,Slovak Republic,2015,12,0,12
EGY,Egypt,SVK,Slovak Republic,2016,4,0,4
EGY,Egypt,SVK,Slovak Republic,2017,12,2,10
EGY,Egypt,ESP,Spain,2008,435,223,212
EGY,Egypt,ESP,Spain,2009,297,286,11
EGY,Egypt,ESP,Spain,2010,304,286,18
EGY,Egypt,ESP,Spain,2011,356,436,-80
EGY,Egypt,ESP,Spain,2012,456,362,94
EGY,Egypt,ESP,Spain,2013,487,425,62
EGY,Egypt,ESP,Spain,2014,549,264,285
EGY,Egypt,ESP,Spain,2015,537,278,259
EGY,Egypt,ESP,Spain,2016,520,314,206
EGY,Egypt,ESP,Spain,2017,591,402,189
EGY,Egypt,SWE,Sweden,2008,230,28,202
EGY,Egypt,SWE,Sweden,2009,314,16,298
EGY,Egypt,SWE,Sweden,2010,406,55,351
EGY,Egypt,SWE,Sweden,2011,673,49,624
EGY,Egypt,SWE,Sweden,2012,648,35,613
EGY,Egypt,SWE,Sweden,2013,501,70,431
EGY,Egypt,SWE,Sweden,2014,485,135,350
EGY,Egypt,SWE,Sweden,2015,517,145,372
EGY,Egypt,SWE,Sweden,2016,537,99,438
EGY,Egypt,SWE,Sweden,2017,693,97,596
EGY,Egypt,CHE,Switzerland,2010,249,123,126
EGY,Egypt,CHE,Switzerland,2011,275,115,160
EGY,Egypt,CHE,Switzerland,2012,250,116,134
EGY,Egypt,CHE,Switzerland,2013,309,132,177
EGY,Egypt,CHE,Switzerland,2014,288,149,139
EGY,Egypt,CHE,Switzerland,2015,286,118,168
EGY,Egypt,CHE,Switzerland,2016,281,136,145
EGY,Egypt,CHE,Switzerland,2017,308,118,190
EGY,Egypt,TUR,Turkey,2010,60,0,60
EGY,Egypt,TUR,Turkey,2016,4094,873,3221
EGY,Egypt,TUR,Turkey,2017,8582,1250,7332
EGY,Egypt,GBR,United Kingdom,2011,1000,0,1000
EGY,Egypt,GBR,United Kingdom,2012,1000,0,1000
EGY,Egypt,GBR,United Kingdom,2013,2000,1000,1000
EGY,Egypt,GBR,United Kingdom,2014,1000,0,1000
EGY,Egypt,GBR,United Kingdom,2015,1000,1000,0
EGY,Egypt,USA,United States,2008,8712,0,8712
EGY,Egypt,USA,United States,2009,8844,0,8844
EGY,Egypt,USA,United States,2010,8978,0,8978
EGY,Egypt,USA,United States,2011,7778,0,7778
EGY,Egypt,USA,United States,2012,8988,0,8988
EGY,Egypt,USA,United States,2013,10294,0,10294
EGY,Egypt,USA,United States,2014,11477,0,11477
EGY,Egypt,USA,United States,2015,12085,0,12085
EGY,Egypt,USA,United States,2016,12045,0,12045
EGY,Egypt,USA,United States,2017,9834,0,9834
EGY,Egypt,CHL,Chile,2008,3,0,3
EGY,Egypt,CHL,Chile,2009,6,0,6
EGY,Egypt,CHL,Chile,2010,3,0,3
EGY,Egypt,CHL,Chile,2011,4,0,4
EGY,Egypt,CHL,Chile,2012,11,0,11
EGY,Egypt,CHL,Chile,2013,5,0,5
EGY,Egypt,CHL,Chile,2014,8,0,8
EGY,Egypt,CHL,Chile,2015,17,0,17
EGY,Egypt,CHL,Chile,2016,22,0,22
EGY,Egypt,EST,Estonia,2008,7,0,7
EGY,Egypt,EST,Estonia,2009,5,0,5
EGY,Egypt,EST,Estonia,2010,10,0,10
EGY,Egypt,EST,Estonia,2011,9,0,9
EGY,Egypt,EST,Estonia,2012,5,0,5
EGY,Egypt,EST,Estonia,2013,12,0,12
EGY,Egypt,EST,Estonia,2014,3,0,3
EGY,Egypt,EST,Estonia,2015,27,0,27
EGY,Egypt,EST,Estonia,2016,21,0,21
EGY,Egypt,EST,Estonia,2017,21,0,21
EGY,Egypt,SVN,Slovenia,2008,26,0,26
EGY,Egypt,SVN,Slovenia,2009,12,0,12
EGY,Egypt,SVN,Slovenia,2010,8,0,8
EGY,Egypt,SVN,Slovenia,2011,6,0,6
EGY,Egypt,SVN,Slovenia,2012,9,1,8
EGY,Egypt,SVN,Slovenia,2013,6,1,5
EGY,Egypt,SVN,Slovenia,2014,3,0,3
EGY,Egypt,SVN,Slovenia,2015,7,0,7
EGY,Egypt,SVN,Slovenia,2016,6,0,6
EGY,Egypt,SVN,Slovenia,2017,18,0,18
SLV,El Salvador,AUS,Australia,2008,53,59,-6
SLV,El Salvador,AUS,Australia,2009,52,59,-7
SLV,El Salvador,AUS,Australia,2010,59,35,24
SLV,El Salvador,AUS,Australia,2011,51,49,2
SLV,El Salvador,AUS,Australia,2012,38,39,-1
SLV,El Salvador,AUS,Australia,2013,40,48,-8
SLV,El Salvador,AUS,Australia,2014,41,51,-10
SLV,El Salvador,AUS,Australia,2015,30,0,30
SLV,El Salvador,AUS,Australia,2016,38,0,38
SLV,El Salvador,AUS,Australia,2017,39,0,39
SLV,El Salvador,AUT,Austria,2008,8,1,7
SLV,El Salvador,AUT,Austria,2009,3,4,-1
SLV,El Salvador,AUT,Austria,2010,3,3,0
SLV,El Salvador,AUT,Austria,2011,7,4,3
SLV,El Salvador,AUT,Austria,2012,10,2,8
SLV,El Salvador,AUT,Austria,2013,15,8,7
SLV,El Salvador,AUT,Austria,2014,7,7,0
SLV,El Salvador,AUT,Austria,2015,12,4,8
SLV,El Salvador,AUT,Austria,2016,11,2,9
SLV,El Salvador,AUT,Austria,2017,8,10,-2
SLV,El Salvador,BEL,Belgium,2008,11,0,11
SLV,El Salvador,BEL,Belgium,2009,17,0,17
SLV,El Salvador,BEL,Belgium,2010,26,2,24
SLV,El Salvador,BEL,Belgium,2012,35,3,32
SLV,El Salvador,BEL,Belgium,2013,32,6,26
SLV,El Salvador,BEL,Belgium,2014,34,21,13
SLV,El Salvador,BEL,Belgium,2015,50,5,45
SLV,El Salvador,BEL,Belgium,2016,97,9,88
SLV,El Salvador,BEL,Belgium,2017,135,10,125
SLV,El Salvador,CAN,Canada,2008,1114,0,1114
SLV,El Salvador,CAN,Canada,2009,841,0,841
SLV,El Salvador,CAN,Canada,2010,768,0,768
SLV,El Salvador,CAN,Canada,2011,690,0,690
SLV,El Salvador,CAN,Canada,2012,641,0,641
SLV,El Salvador,CAN,Canada,2013,637,0,637
SLV,El Salvador,CAN,Canada,2014,700,0,700
SLV,El Salvador,CAN,Canada,2015,656,0,656
SLV,El Salvador,CAN,Canada,2016,625,0,625
SLV,El Salvador,CAN,Canada,2017,720,0,720
SLV,El Salvador,CZE,Czech Republic,2008,2,0,2
SLV,El Salvador,CZE,Czech Republic,2009,2,0,2
SLV,El Salvador,CZE,Czech Republic,2010,2,0,2
SLV,El Salvador,CZE,Czech Republic,2011,1,0,1
SLV,El Salvador,CZE,Czech Republic,2013,13,1,12
SLV,El Salvador,CZE,Czech Republic,2014,6,9,-3
SLV,El Salvador,CZE,Czech Republic,2015,2,5,-3
SLV,El Salvador,DNK,Denmark,2008,4,0,4
SLV,El Salvador,DNK,Denmark,2009,1,0,1
SLV,El Salvador,DNK,Denmark,2010,7,1,6
SLV,El Salvador,DNK,Denmark,2011,3,2,1
SLV,El Salvador,DNK,Denmark,2012,1,1,0
SLV,El Salvador,DNK,Denmark,2013,5,0,5
SLV,El Salvador,DNK,Denmark,2014,1,7,-6
SLV,El Salvador,DNK,Denmark,2015,5,1,4
SLV,El Salvador,DNK,Denmark,2016,7,0,7
SLV,El Salvador,DNK,Denmark,2017,1,1,0
SLV,El Salvador,FIN,Finland,2008,0,0,0
SLV,El Salvador,FIN,Finland,2009,2,1,1
SLV,El Salvador,FIN,Finland,2010,4,0,4
SLV,El Salvador,FIN,Finland,2011,2,0,2
SLV,El Salvador,FIN,Finland,2012,4,0,4
SLV,El Salvador,FIN,Finland,2013,2,1,1
SLV,El Salvador,FIN,Finland,2014,5,2,3
SLV,El Salvador,FIN,Finland,2015,2,1,1
SLV,El Salvador,FIN,Finland,2016,7,0,7
SLV,El Salvador,FIN,Finland,2017,6,0,6
SLV,El Salvador,FRA,France,2008,25,0,25
SLV,El Salvador,FRA,France,2009,39,0,39
SLV,El Salvador,FRA,France,2010,39,0,39
SLV,El Salvador,FRA,France,2011,51,0,51
SLV,El Salvador,FRA,France,2012,55,0,55
SLV,El Salvador,FRA,France,2013,64,0,64
SLV,El Salvador,FRA,France,2014,52,0,52
SLV,El Salvador,FRA,France,2015,52,0,52
SLV,El Salvador,FRA,France,2016,50,0,50
SLV,El Salvador,FRA,France,2017,44,0,44
SLV,El Salvador,DEU,Germany,2008,73,64,9
SLV,El Salvador,DEU,Germany,2009,101,61,40
SLV,El Salvador,DEU,Germany,2010,96,64,32
SLV,El Salvador,DEU,Germany,2011,138,62,76
SLV,El Salvador,DEU,Germany,2012,138,73,65
SLV,El Salvador,DEU,Germany,2013,126,77,49
SLV,El Salvador,DEU,Germany,2014,145,78,67
SLV,El Salvador,DEU,Germany,2015,179,66,113
SLV,El Salvador,DEU,Germany,2016,237,118,119
SLV,El Salvador,DEU,Germany,2017,216,88,128
SLV,El Salvador,HUN,Hungary,2008,3,1,2
SLV,El Salvador,HUN,Hungary,2009,1,0,1
SLV,El Salvador,HUN,Hungary,2010,3,0,3
SLV,El Salvador,HUN,Hungary,2011,1,0,1
SLV,El Salvador,HUN,Hungary,2012,4,0,4
SLV,El Salvador,HUN,Hungary,2013,1,0,1
SLV,El Salvador,HUN,Hungary,2014,1,0,1
SLV,El Salvador,HUN,Hungary,2015,4,0,4
SLV,El Salvador,HUN,Hungary,2016,2,0,2
SLV,El Salvador,HUN,Hungary,2017,4,0,4
SLV,El Salvador,ISL,Iceland,2008,3,4,-1
SLV,El Salvador,ISL,Iceland,2009,3,2,1
SLV,El Salvador,ISL,Iceland,2010,4,4,0
SLV,El Salvador,ISL,Iceland,2011,4,3,1
SLV,El Salvador,ISL,Iceland,2012,2,0,2
SLV,El Salvador,ISL,Iceland,2013,2,2,0
SLV,El Salvador,ISL,Iceland,2014,1,3,-2
SLV,El Salvador,ISL,Iceland,2015,0,2,-2
SLV,El Salvador,ISL,Iceland,2016,9,1,8
SLV,El Salvador,ISL,Iceland,2017,2,1,1
SLV,El Salvador,ITA,Italy,2008,433,5,428
SLV,El Salvador,ITA,Italy,2009,691,6,685
SLV,El Salvador,ITA,Italy,2010,1535,8,1527
SLV,El Salvador,ITA,Italy,2011,1359,14,1345
SLV,El Salvador,ITA,Italy,2012,1036,20,1016
SLV,El Salvador,ITA,Italy,2013,990,15,975
SLV,El Salvador,ITA,Italy,2014,822,27,795
SLV,El Salvador,ITA,Italy,2015,669,29,640
SLV,El Salvador,ITA,Italy,2016,767,0,767
SLV,El Salvador,ITA,Italy,2017,1211,15,1196
SLV,El Salvador,JPN,Japan,2008,57,54,3
SLV,El Salvador,JPN,Japan,2009,82,81,1
SLV,El Salvador,JPN,Japan,2010,115,109,6
SLV,El Salvador,JPN,Japan,2011,96,93,3
SLV,El Salvador,JPN,Japan,2012,102,101,1
SLV,El Salvador,JPN,Japan,2013,88,82,6
SLV,El Salvador,JPN,Japan,2014,88,83,5
SLV,El Salvador,JPN,Japan,2015,110,108,2
SLV,El Salvador,JPN,Japan,2016,75,67,8
SLV,El Salvador,JPN,Japan,2017,74,66,8
SLV,El Salvador,KOR,Korea,2008,18,5,13
SLV,El Salvador,KOR,Korea,2009,13,3,10
SLV,El Salvador,KOR,Korea,2010,19,7,12
SLV,El Salvador,KOR,Korea,2011,10,21,-11
SLV,El Salvador,KOR,Korea,2012,11,16,-5
SLV,El Salvador,KOR,Korea,2013,13,9,4
SLV,El Salvador,KOR,Korea,2014,16,12,4
SLV,El Salvador,KOR,Korea,2015,21,18,3
SLV,El Salvador,KOR,Korea,2016,15,12,3
SLV,El Salvador,KOR,Korea,2017,23,16,7
SLV,El Salvador,LUX,Luxembourg,2008,8,0,8
SLV,El Salvador,LUX,Luxembourg,2009,2,1,1
SLV,El Salvador,LUX,Luxembourg,2010,0,0,0
SLV,El Salvador,LUX,Luxembourg,2011,1,0,1
SLV,El Salvador,LUX,Luxembourg,2012,4,0,4
SLV,El Salvador,LUX,Luxembourg,2013,4,3,1
SLV,El Salvador,LUX,Luxembourg,2014,3,6,-3
SLV,El Salvador,LUX,Luxembourg,2015,6,1,5
SLV,El Salvador,LUX,Luxembourg,2016,9,2,7
SLV,El Salvador,LUX,Luxembourg,2017,2,1,1
SLV,El Salvador,MEX,Mexico,2008,457,0,457
SLV,El Salvador,MEX,Mexico,2009,796,0,796
SLV,El Salvador,MEX,Mexico,2010,708,0,708
SLV,El Salvador,MEX,Mexico,2011,694,0,694
SLV,El Salvador,MEX,Mexico,2012,361,0,361
SLV,El Salvador,MEX,Mexico,2013,1613,0,1613
SLV,El Salvador,MEX,Mexico,2014,1210,0,1210
SLV,El Salvador,MEX,Mexico,2015,1136,0,1136
SLV,El Salvador,MEX,Mexico,2016,1772,0,1772
SLV,El Salvador,MEX,Mexico,2017,2260,0,2260
SLV,El Salvador,NLD,Netherlands,2008,11,3,8
SLV,El Salvador,NLD,Netherlands,2009,8,7,1
SLV,El Salvador,NLD,Netherlands,2010,11,3,8
SLV,El Salvador,NLD,Netherlands,2011,22,6,16
SLV,El Salvador,NLD,Netherlands,2012,11,3,8
SLV,El Salvador,NLD,Netherlands,2013,12,8,4
SLV,El Salvador,NLD,Netherlands,2014,15,8,7
SLV,El Salvador,NLD,Netherlands,2015,22,10,12
SLV,El Salvador,NLD,Netherlands,2016,21,22,-1
SLV,El Salvador,NLD,Netherlands,2017,26,10,16
SLV,El Salvador,NZL,New Zealand,2008,4,4,0
SLV,El Salvador,NZL,New Zealand,2009,3,0,3
SLV,El Salvador,NZL,New Zealand,2010,2,2,0
SLV,El Salvador,NZL,New Zealand,2011,1,0,1
SLV,El Salvador,NZL,New Zealand,2012,6,0,6
SLV,El Salvador,NZL,New Zealand,2013,2,1,1
SLV,El Salvador,NZL,New Zealand,2014,4,2,2
SLV,El Salvador,NZL,New Zealand,2015,2,0,2
SLV,El Salvador,NZL,New Zealand,2016,1,0,1
SLV,El Salvador,NZL,New Zealand,2017,4,0,4
SLV,El Salvador,NOR,Norway,2008,11,3,8
SLV,El Salvador,NOR,Norway,2009,3,2,1
SLV,El Salvador,NOR,Norway,2010,7,2,5
SLV,El Salvador,NOR,Norway,2011,5,2,3
SLV,El Salvador,NOR,Norway,2012,15,1,14
SLV,El Salvador,NOR,Norway,2013,7,4,3
SLV,El Salvador,NOR,Norway,2014,15,2,13
SLV,El Salvador,NOR,Norway,2015,6,2,4
SLV,El Salvador,NOR,Norway,2016,7,3,4
SLV,El Salvador,NOR,Norway,2017,6,1,5
SLV,El Salvador,POL,Poland,2009,1,0,1
SLV,El Salvador,POL,Poland,2010,3,0,3
SLV,El Salvador,POL,Poland,2011,5,0,5
SLV,El Salvador,POL,Poland,2012,8,0,8
SLV,El Salvador,POL,Poland,2013,12,0,12
SLV,El Salvador,POL,Poland,2014,4,0,4
SLV,El Salvador,POL,Poland,2015,12,0,12
SLV,El Salvador,POL,Poland,2016,4,0,4
SLV,El Salvador,POL,Poland,2017,13,0,13
SLV,El Salvador,SVK,Slovak Republic,2008,0,0,0
SLV,El Salvador,SVK,Slovak Republic,2011,1,0,1
SLV,El Salvador,SVK,Slovak Republic,2013,1,0,1
SLV,El Salvador,SVK,Slovak Republic,2014,1,0,1
SLV,El Salvador,ESP,Spain,2008,1035,289,746
SLV,El Salvador,ESP,Spain,2009,742,354,388
SLV,El Salvador,ESP,Spain,2010,831,398,433
SLV,El Salvador,ESP,Spain,2011,1047,471,576
SLV,El Salvador,ESP,Spain,2012,861,495,366
SLV,El Salvador,ESP,Spain,2013,715,720,-5
SLV,El Salvador,ESP,Spain,2014,976,375,601
SLV,El Salvador,ESP,Spain,2015,1291,261,1030
SLV,El Salvador,ESP,Spain,2016,1972,311,1661
SLV,El Salvador,ESP,Spain,2017,2810,371,2439
SLV,El Salvador,SWE,Sweden,2008,50,7,43
SLV,El Salvador,SWE,Sweden,2009,50,0,50
SLV,El Salvador,SWE,Sweden,2010,63,9,54
SLV,El Salvador,SWE,Sweden,2011,51,2,49
SLV,El Salvador,SWE,Sweden,2012,80,8,72
SLV,El Salvador,SWE,Sweden,2013,64,6,58
SLV,El Salvador,SWE,Sweden,2014,63,3,60
SLV,El Salvador,SWE,Sweden,2015,63,4,59
SLV,El Salvador,SWE,Sweden,2016,62,6,56
SLV,El Salvador,SWE,Sweden,2017,69,4,65
SLV,El Salvador,CHE,Switzerland,2010,40,8,32
SLV,El Salvador,CHE,Switzerland,2011,30,13,17
SLV,El Salvador,CHE,Switzerland,2012,27,14,13
SLV,El Salvador,CHE,Switzerland,2013,27,6,21
SLV,El Salvador,CHE,Switzerland,2014,22,13,9
SLV,El Salvador,CHE,Switzerland,2015,20,16,4
SLV,El Salvador,CHE,Switzerland,2016,31,5,26
SLV,El Salvador,CHE,Switzerland,2017,31,6,25
SLV,El Salvador,USA,United States,2008,19659,0,19659
SLV,El Salvador,USA,United States,2009,19909,0,19909
SLV,El Salvador,USA,United States,2010,18806,0,18806
SLV,El Salvador,USA,United States,2011,18667,0,18667
SLV,El Salvador,USA,United States,2012,16256,0,16256
SLV,El Salvador,USA,United States,2013,18260,0,18260
SLV,El Salvador,USA,United States,2014,19273,0,19273
SLV,El Salvador,USA,United States,2015,19487,0,19487
SLV,El Salvador,USA,United States,2016,23449,0,23449
SLV,El Salvador,USA,United States,2017,25109,0,25109
SLV,El Salvador,CHL,Chile,2008,73,0,73
SLV,El Salvador,CHL,Chile,2009,57,0,57
SLV,El Salvador,CHL,Chile,2010,84,0,84
SLV,El Salvador,CHL,Chile,2011,103,0,103
SLV,El Salvador,CHL,Chile,2012,110,0,110
SLV,El Salvador,CHL,Chile,2013,87,0,87
SLV,El Salvador,CHL,Chile,2014,76,0,76
SLV,El Salvador,CHL,Chile,2015,150,0,150
SLV,El Salvador,CHL,Chile,2016,146,0,146
SLV,El Salvador,EST,Estonia,2008,0,0,0
SLV,El Salvador,EST,Estonia,2009,0,0,0
SLV,El Salvador,EST,Estonia,2010,0,0,0
SLV,El Salvador,EST,Estonia,2011,0,0,0
SLV,El Salvador,EST,Estonia,2012,0,0,0
SLV,El Salvador,EST,Estonia,2013,0,0,0
SLV,El Salvador,EST,Estonia,2014,0,0,0
SLV,El Salvador,EST,Estonia,2015,1,0,1
SLV,El Salvador,EST,Estonia,2016,0,0,0
SLV,El Salvador,EST,Estonia,2017,0,0,0
SLV,El Salvador,SVN,Slovenia,2008,1,0,1
GNQ,Equatorial Guinea,AUS,Australia,2009,0,0,0
GNQ,Equatorial Guinea,AUS,Australia,2010,0,0,0
GNQ,Equatorial Guinea,AUS,Australia,2011,0,0,0
GNQ,Equatorial Guinea,AUS,Australia,2012,1,0,1
GNQ,Equatorial Guinea,AUS,Australia,2013,4,0,4
GNQ,Equatorial Guinea,AUS,Australia,2014,0,0,0
GNQ,Equatorial Guinea,AUS,Australia,2015,0,0,0
GNQ,Equatorial Guinea,AUS,Australia,2016,0,0,0
GNQ,Equatorial Guinea,AUS,Australia,2017,0,0,0
GNQ,Equatorial Guinea,AUT,Austria,2008,1,1,0
GNQ,Equatorial Guinea,AUT,Austria,2009,0,2,-2
GNQ,Equatorial Guinea,AUT,Austria,2010,1,1,0
GNQ,Equatorial Guinea,AUT,Austria,2011,0,2,-2
GNQ,Equatorial Guinea,AUT,Austria,2012,1,0,1
GNQ,Equatorial Guinea,AUT,Austria,2013,1,0,1
GNQ,Equatorial Guinea,AUT,Austria,2014,0,0,0
GNQ,Equatorial Guinea,AUT,Austria,2015,4,3,1
GNQ,Equatorial Guinea,AUT,Austria,2016,0,0,0
GNQ,Equatorial Guinea,AUT,Austria,2017,1,1,0
GNQ,Equatorial Guinea,BEL,Belgium,2008,2,0,2
GNQ,Equatorial Guinea,BEL,Belgium,2009,0,0,0
GNQ,Equatorial Guinea,BEL,Belgium,2010,5,1,4
GNQ,Equatorial Guinea,BEL,Belgium,2012,10,2,8
GNQ,Equatorial Guinea,BEL,Belgium,2013,8,7,1
GNQ,Equatorial Guinea,BEL,Belgium,2014,6,3,3
GNQ,Equatorial Guinea,BEL,Belgium,2015,5,5,0
GNQ,Equatorial Guinea,BEL,Belgium,2016,6,0,6
GNQ,Equatorial Guinea,BEL,Belgium,2017,12,2,10
GNQ,Equatorial Guinea,CAN,Canada,2008,1,0,1
GNQ,Equatorial Guinea,CAN,Canada,2009,5,0,5
GNQ,Equatorial Guinea,CAN,Canada,2010,4,0,4
GNQ,Equatorial Guinea,CAN,Canada,2011,4,0,4
GNQ,Equatorial Guinea,CAN,Canada,2012,4,0,4
GNQ,Equatorial Guinea,CAN,Canada,2013,11,0,11
GNQ,Equatorial Guinea,CAN,Canada,2014,2,0,2
GNQ,Equatorial Guinea,CAN,Canada,2015,0,0,0
GNQ,Equatorial Guinea,CAN,Canada,2016,5,0,5
GNQ,Equatorial Guinea,CAN,Canada,2017,0,0,0
GNQ,Equatorial Guinea,DNK,Denmark,2008,0,0,0
GNQ,Equatorial Guinea,DNK,Denmark,2009,1,0,1
GNQ,Equatorial Guinea,DNK,Denmark,2013,0,0,0
GNQ,Equatorial Guinea,DNK,Denmark,2014,1,0,1
GNQ,Equatorial Guinea,DNK,Denmark,2015,1,0,1
GNQ,Equatorial Guinea,DNK,Denmark,2016,0,0,0
GNQ,Equatorial Guinea,DNK,Denmark,2017,0,0,0
GNQ,Equatorial Guinea,FIN,Finland,2008,1,0,1
GNQ,Equatorial Guinea,FIN,Finland,2009,3,0,3
GNQ,Equatorial Guinea,FIN,Finland,2010,0,0,0
GNQ,Equatorial Guinea,FIN,Finland,2011,1,0,1
GNQ,Equatorial Guinea,FIN,Finland,2012,0,0,0
GNQ,Equatorial Guinea,FIN,Finland,2013,1,0,1
GNQ,Equatorial Guinea,FIN,Finland,2014,0,0,0
GNQ,Equatorial Guinea,FIN,Finland,2015,0,0,0
GNQ,Equatorial Guinea,FIN,Finland,2016,0,0,0
GNQ,Equatorial Guinea,FIN,Finland,2017,0,0,0
GNQ,Equatorial Guinea,FRA,France,2008,17,0,17
GNQ,Equatorial Guinea,FRA,France,2009,17,0,17
GNQ,Equatorial Guinea,FRA,France,2010,23,0,23
GNQ,Equatorial Guinea,FRA,France,2011,16,0,16
GNQ,Equatorial Guinea,FRA,France,2012,16,0,16
GNQ,Equatorial Guinea,FRA,France,2013,27,0,27
GNQ,Equatorial Guinea,FRA,France,2014,27,0,27
GNQ,Equatorial Guinea,FRA,France,2015,18,0,18
GNQ,Equatorial Guinea,FRA,France,2016,24,0,24
GNQ,Equatorial Guinea,FRA,France,2017,42,0,42
GNQ,Equatorial Guinea,DEU,Germany,2008,6,2,4
GNQ,Equatorial Guinea,DEU,Germany,2009,12,5,7
GNQ,Equatorial Guinea,DEU,Germany,2010,27,10,17
GNQ,Equatorial Guinea,DEU,Germany,2011,10,12,-2
GNQ,Equatorial Guinea,DEU,Germany,2012,8,11,-3
GNQ,Equatorial Guinea,DEU,Germany,2013,12,15,-3
GNQ,Equatorial Guinea,DEU,Germany,2014,21,5,16
GNQ,Equatorial Guinea,DEU,Germany,2015,34,20,14
GNQ,Equatorial Guinea,DEU,Germany,2016,20,6,14
GNQ,Equatorial Guinea,DEU,Germany,2017,16,12,4
GNQ,Equatorial Guinea,HUN,Hungary,2008,0,0,0
GNQ,Equatorial Guinea,HUN,Hungary,2009,0,0,0
GNQ,Equatorial Guinea,HUN,Hungary,2010,0,0,0
GNQ,Equatorial Guinea,HUN,Hungary,2011,0,0,0
GNQ,Equatorial Guinea,HUN,Hungary,2012,0,0,0
GNQ,Equatorial Guinea,HUN,Hungary,2013,0,0,0
GNQ,Equatorial Guinea,HUN,Hungary,2014,0,0,0
GNQ,Equatorial Guinea,HUN,Hungary,2015,1,0,1
GNQ,Equatorial Guinea,HUN,Hungary,2016,0,0,0
GNQ,Equatorial Guinea,HUN,Hungary,2017,0,0,0
GNQ,Equatorial Guinea,ISL,Iceland,2008,0,0,0
GNQ,Equatorial Guinea,ISL,Iceland,2009,0,0,0
GNQ,Equatorial Guinea,ISL,Iceland,2010,0,0,0
GNQ,Equatorial Guinea,ISL,Iceland,2011,2,0,2
GNQ,Equatorial Guinea,ISL,Iceland,2012,0,0,0
GNQ,Equatorial Guinea,ISL,Iceland,2013,0,0,0
GNQ,Equatorial Guinea,ISL,Iceland,2014,0,0,0
GNQ,Equatorial Guinea,ISL,Iceland,2015,0,0,0
GNQ,Equatorial Guinea,ISL,Iceland,2016,3,0,3
GNQ,Equatorial Guinea,ISL,Iceland,2017,1,0,1
GNQ,Equatorial Guinea,ITA,Italy,2008,5,0,5
GNQ,Equatorial Guinea,ITA,Italy,2009,4,0,4
GNQ,Equatorial Guinea,ITA,Italy,2010,14,0,14
GNQ,Equatorial Guinea,ITA,Italy,2011,11,0,11
GNQ,Equatorial Guinea,ITA,Italy,2012,10,0,10
GNQ,Equatorial Guinea,ITA,Italy,2013,16,0,16
GNQ,Equatorial Guinea,ITA,Italy,2014,9,0,9
GNQ,Equatorial Guinea,ITA,Italy,2015,16,1,15
GNQ,Equatorial Guinea,ITA,Italy,2016,16,0,16
GNQ,Equatorial Guinea,ITA,Italy,2017,35,0,35
GNQ,Equatorial Guinea,JPN,Japan,2008,20,21,-1
GNQ,Equatorial Guinea,JPN,Japan,2009,3,3,0
GNQ,Equatorial Guinea,JPN,Japan,2010,9,9,0
GNQ,Equatorial Guinea,JPN,Japan,2011,4,4,0
GNQ,Equatorial Guinea,JPN,Japan,2012,19,19,0
GNQ,Equatorial Guinea,JPN,Japan,2013,10,10,0
GNQ,Equatorial Guinea,JPN,Japan,2014,0,0,0
GNQ,Equatorial Guinea,JPN,Japan,2015,9,9,0
GNQ,Equatorial Guinea,JPN,Japan,2016,3,2,1
GNQ,Equatorial Guinea,JPN,Japan,2017,4,0,4
GNQ,Equatorial Guinea,KOR,Korea,2008,2,1,1
GNQ,Equatorial Guinea,KOR,Korea,2009,1,0,1
GNQ,Equatorial Guinea,KOR,Korea,2010,3,3,0
GNQ,Equatorial Guinea,KOR,Korea,2011,1,1,0
GNQ,Equatorial Guinea,KOR,Korea,2012,4,6,-2
GNQ,Equatorial Guinea,KOR,Korea,2013,2,0,2
GNQ,Equatorial Guinea,KOR,Korea,2014,0,0,0
GNQ,Equatorial Guinea,KOR,Korea,2015,0,0,0
GNQ,Equatorial Guinea,KOR,Korea,2016,2,1,1
GNQ,Equatorial Guinea,KOR,Korea,2017,1,2,-1
GNQ,Equatorial Guinea,LUX,Luxembourg,2008,0,0,0
GNQ,Equatorial Guinea,LUX,Luxembourg,2009,0,0,0
GNQ,Equatorial Guinea,LUX,Luxembourg,2010,1,0,1
GNQ,Equatorial Guinea,LUX,Luxembourg,2011,0,0,0
GNQ,Equatorial Guinea,LUX,Luxembourg,2012,0,0,0
GNQ,Equatorial Guinea,LUX,Luxembourg,2013,0,0,0
GNQ,Equatorial Guinea,LUX,Luxembourg,2014,0,0,0
GNQ,Equatorial Guinea,LUX,Luxembourg,2015,0,0,0
GNQ,Equatorial Guinea,LUX,Luxembourg,2016,1,0,1
GNQ,Equatorial Guinea,LUX,Luxembourg,2017,0,1,-1
GNQ,Equatorial Guinea,MEX,Mexico,2010,2,0,2
GNQ,Equatorial Guinea,MEX,Mexico,2011,2,0,2
GNQ,Equatorial Guinea,MEX,Mexico,2012,0,0,0
GNQ,Equatorial Guinea,MEX,Mexico,2013,2,0,2
GNQ,Equatorial Guinea,MEX,Mexico,2014,0,0,0
GNQ,Equatorial Guinea,MEX,Mexico,2015,2,0,2
GNQ,Equatorial Guinea,MEX,Mexico,2016,3,0,3
GNQ,Equatorial Guinea,MEX,Mexico,2017,3,0,3
GNQ,Equatorial Guinea,NLD,Netherlands,2008,0,0,0
GNQ,Equatorial Guinea,NLD,Netherlands,2009,2,0,2
GNQ,Equatorial Guinea,NLD,Netherlands,2014,3,0,3
GNQ,Equatorial Guinea,NOR,Norway,2008,0,0,0
GNQ,Equatorial Guinea,NOR,Norway,2009,1,0,1
GNQ,Equatorial Guinea,NOR,Norway,2010,0,0,0
GNQ,Equatorial Guinea,NOR,Norway,2011,0,0,0
GNQ,Equatorial Guinea,NOR,Norway,2012,1,1,0
GNQ,Equatorial Guinea,NOR,Norway,2013,1,0,1
GNQ,Equatorial Guinea,NOR,Norway,2014,0,0,0
GNQ,Equatorial Guinea,NOR,Norway,2015,0,0,0
GNQ,Equatorial Guinea,NOR,Norway,2016,0,0,0
GNQ,Equatorial Guinea,NOR,Norway,2017,0,0,0
GNQ,Equatorial Guinea,POL,Poland,2009,0,0,0
GNQ,Equatorial Guinea,POL,Poland,2010,0,0,0
GNQ,Equatorial Guinea,POL,Poland,2011,2,0,2
GNQ,Equatorial Guinea,POL,Poland,2012,3,0,3
GNQ,Equatorial Guinea,POL,Poland,2013,5,0,5
GNQ,Equatorial Guinea,POL,Poland,2014,1,0,1
GNQ,Equatorial Guinea,POL,Poland,2015,0,0,0
GNQ,Equatorial Guinea,POL,Poland,2016,2,0,2
GNQ,Equatorial Guinea,POL,Poland,2017,1,0,1
GNQ,Equatorial Guinea,SVK,Slovak Republic,2008,0,0,0
GNQ,Equatorial Guinea,SVK,Slovak Republic,2010,1,1,0
GNQ,Equatorial Guinea,ESP,Spain,2008,2177,1465,712
GNQ,Equatorial Guinea,ESP,Spain,2009,1463,1691,-228
GNQ,Equatorial Guinea,ESP,Spain,2010,1320,1863,-543
GNQ,Equatorial Guinea,ESP,Spain,2011,1185,1904,-719
GNQ,Equatorial Guinea,ESP,Spain,2012,1070,1482,-412
GNQ,Equatorial Guinea,ESP,Spain,2013,1053,1784,-731
GNQ,Equatorial Guinea,ESP,Spain,2014,1220,1035,185
GNQ,Equatorial Guinea,ESP,Spain,2015,1506,673,833
GNQ,Equatorial Guinea,ESP,Spain,2016,1691,805,886
GNQ,Equatorial Guinea,ESP,Spain,2017,1696,1235,461
GNQ,Equatorial Guinea,SWE,Sweden,2008,0,0,0
GNQ,Equatorial Guinea,SWE,Sweden,2009,0,0,0
GNQ,Equatorial Guinea,SWE,Sweden,2010,2,1,1
GNQ,Equatorial Guinea,SWE,Sweden,2011,8,0,8
GNQ,Equatorial Guinea,SWE,Sweden,2012,0,0,0
GNQ,Equatorial Guinea,SWE,Sweden,2013,1,0,1
GNQ,Equatorial Guinea,SWE,Sweden,2014,1,2,-1
GNQ,Equatorial Guinea,SWE,Sweden,2015,4,2,2
GNQ,Equatorial Guinea,SWE,Sweden,2016,2,0,2
GNQ,Equatorial Guinea,SWE,Sweden,2017,1,0,1
GNQ,Equatorial Guinea,CHE,Switzerland,2010,0,1,-1
GNQ,Equatorial Guinea,CHE,Switzerland,2011,6,1,5
GNQ,Equatorial Guinea,CHE,Switzerland,2012,3,0,3
GNQ,Equatorial Guinea,CHE,Switzerland,2013,0,0,0
GNQ,Equatorial Guinea,CHE,Switzerland,2014,3,0,3
GNQ,Equatorial Guinea,CHE,Switzerland,2015,3,0,3
GNQ,Equatorial Guinea,CHE,Switzerland,2016,3,0,3
GNQ,Equatorial Guinea,CHE,Switzerland,2017,3,1,2
GNQ,Equatorial Guinea,USA,United States,2008,16,0,16
GNQ,Equatorial Guinea,USA,United States,2009,32,0,32
GNQ,Equatorial Guinea,USA,United States,2010,12,0,12
GNQ,Equatorial Guinea,USA,United States,2011,13,0,13
GNQ,Equatorial Guinea,USA,United States,2012,20,0,20
GNQ,Equatorial Guinea,USA,United States,2013,18,0,18
GNQ,Equatorial Guinea,USA,United States,2014,15,0,15
GNQ,Equatorial Guinea,USA,United States,2015,25,0,25
GNQ,Equatorial Guinea,USA,United States,2016,18,0,18
GNQ,Equatorial Guinea,USA,United States,2017,20,0,20
GNQ,Equatorial Guinea,CHL,Chile,2008,0,0,0
GNQ,Equatorial Guinea,CHL,Chile,2009,0,0,0
GNQ,Equatorial Guinea,CHL,Chile,2010,0,0,0
GNQ,Equatorial Guinea,CHL,Chile,2011,1,0,1
GNQ,Equatorial Guinea,CHL,Chile,2012,0,0,0
GNQ,Equatorial Guinea,CHL,Chile,2013,0,0,0
GNQ,Equatorial Guinea,CHL,Chile,2014,1,0,1
GNQ,Equatorial Guinea,CHL,Chile,2015,0,0,0
GNQ,Equatorial Guinea,CHL,Chile,2016,0,0,0
GNQ,Equatorial Guinea,EST,Estonia,2008,0,0,0
GNQ,Equatorial Guinea,EST,Estonia,2009,0,0,0
GNQ,Equatorial Guinea,EST,Estonia,2010,0,0,0
GNQ,Equatorial Guinea,EST,Estonia,2011,0,0,0
GNQ,Equatorial Guinea,EST,Estonia,2012,0,0,0
GNQ,Equatorial Guinea,EST,Estonia,2013,0,0,0
GNQ,Equatorial Guinea,EST,Estonia,2014,0,0,0
GNQ,Equatorial Guinea,EST,Estonia,2015,0,0,0
GNQ,Equatorial Guinea,EST,Estonia,2016,0,0,0
GNQ,Equatorial Guinea,EST,Estonia,2017,0,0,0
GNQ,Equatorial Guinea,SVN,Slovenia,2017,1,0,1
ERI,Eritrea,AUS,Australia,2008,220,16,204
ERI,Eritrea,AUS,Australia,2009,224,13,211
ERI,Eritrea,AUS,Australia,2010,198,22,176
ERI,Eritrea,AUS,Australia,2011,205,15,190
ERI,Eritrea,AUS,Australia,2012,420,23,397
ERI,Eritrea,AUS,Australia,2013,177,17,160
ERI,Eritrea,AUS,Australia,2014,370,16,354
ERI,Eritrea,AUS,Australia,2015,517,0,517
ERI,Eritrea,AUS,Australia,2016,395,0,395
ERI,Eritrea,AUS,Australia,2017,474,0,474
ERI,Eritrea,AUT,Austria,2008,12,2,10
ERI,Eritrea,AUT,Austria,2009,17,4,13
ERI,Eritrea,AUT,Austria,2010,8,7,1
ERI,Eritrea,AUT,Austria,2011,19,3,16
ERI,Eritrea,AUT,Austria,2012,14,6,8
ERI,Eritrea,AUT,Austria,2013,48,4,44
ERI,Eritrea,AUT,Austria,2014,97,15,82
ERI,Eritrea,AUT,Austria,2015,71,29,42
ERI,Eritrea,AUT,Austria,2016,73,22,51
ERI,Eritrea,AUT,Austria,2017,49,31,18
ERI,Eritrea,BEL,Belgium,2008,9,0,9
ERI,Eritrea,BEL,Belgium,2009,9,0,9
ERI,Eritrea,BEL,Belgium,2010,16,3,13
ERI,Eritrea,BEL,Belgium,2012,99,26,73
ERI,Eritrea,BEL,Belgium,2013,71,27,44
ERI,Eritrea,BEL,Belgium,2014,733,33,700
ERI,Eritrea,BEL,Belgium,2015,329,36,293
ERI,Eritrea,BEL,Belgium,2016,305,25,280
ERI,Eritrea,BEL,Belgium,2017,604,22,582
ERI,Eritrea,CAN,Canada,2008,797,0,797
ERI,Eritrea,CAN,Canada,2009,903,0,903
ERI,Eritrea,CAN,Canada,2010,931,0,931
ERI,Eritrea,CAN,Canada,2011,1182,0,1182
ERI,Eritrea,CAN,Canada,2012,1335,0,1335
ERI,Eritrea,CAN,Canada,2013,1719,0,1719
ERI,Eritrea,CAN,Canada,2014,1974,0,1974
ERI,Eritrea,CAN,Canada,2015,2171,0,2171
ERI,Eritrea,CAN,Canada,2016,4630,0,4630
ERI,Eritrea,CAN,Canada,2017,4680,0,4680
ERI,Eritrea,CZE,Czech Republic,2012,5,0,5
ERI,Eritrea,CZE,Czech Republic,2014,1,3,-2
ERI,Eritrea,CZE,Czech Republic,2015,1,0,1
ERI,Eritrea,CZE,Czech Republic,2016,5,0,5
ERI,Eritrea,CZE,Czech Republic,2017,2,0,2
ERI,Eritrea,DNK,Denmark,2008,4,0,4
ERI,Eritrea,DNK,Denmark,2009,7,1,6
ERI,Eritrea,DNK,Denmark,2010,23,1,22
ERI,Eritrea,DNK,Denmark,2011,40,1,39
ERI,Eritrea,DNK,Denmark,2012,32,1,31
ERI,Eritrea,DNK,Denmark,2013,87,3,84
ERI,Eritrea,DNK,Denmark,2014,235,0,235
ERI,Eritrea,DNK,Denmark,2015,2838,5,2833
ERI,Eritrea,DNK,Denmark,2016,985,15,970
ERI,Eritrea,DNK,Denmark,2017,1000,56,944
ERI,Eritrea,FIN,Finland,2008,4,0,4
ERI,Eritrea,FIN,Finland,2009,13,2,11
ERI,Eritrea,FIN,Finland,2010,10,0,10
ERI,Eritrea,FIN,Finland,2011,19,1,18
ERI,Eritrea,FIN,Finland,2012,15,0,15
ERI,Eritrea,FIN,Finland,2013,50,0,50
ERI,Eritrea,FIN,Finland,2014,9,0,9
ERI,Eritrea,FIN,Finland,2015,14,1,13
ERI,Eritrea,FIN,Finland,2016,268,0,268
ERI,Eritrea,FIN,Finland,2017,262,0,262
ERI,Eritrea,FRA,France,2008,64,0,64
ERI,Eritrea,FRA,France,2009,133,0,133
ERI,Eritrea,FRA,France,2010,251,0,251
ERI,Eritrea,FRA,France,2011,349,0,349
ERI,Eritrea,FRA,France,2012,282,0,282
ERI,Eritrea,FRA,France,2013,199,0,199
ERI,Eritrea,FRA,France,2014,169,0,169
ERI,Eritrea,FRA,France,2015,397,0,397
ERI,Eritrea,FRA,France,2016,513,0,513
ERI,Eritrea,FRA,France,2017,869,0,869
ERI,Eritrea,DEU,Germany,2008,464,285,179
ERI,Eritrea,DEU,Germany,2009,649,252,397
ERI,Eritrea,DEU,Germany,2010,868,294,574
ERI,Eritrea,DEU,Germany,2011,933,253,680
ERI,Eritrea,DEU,Germany,2012,833,289,544
ERI,Eritrea,DEU,Germany,2013,3942,389,3553
ERI,Eritrea,DEU,Germany,2014,14372,868,13504
ERI,Eritrea,DEU,Germany,2015,17796,1900,15896
ERI,Eritrea,DEU,Germany,2016,12910,3285,9625
ERI,Eritrea,DEU,Germany,2017,8409,2656,5753
ERI,Eritrea,HUN,Hungary,2008,5,0,5
ERI,Eritrea,HUN,Hungary,2009,0,1,-1
ERI,Eritrea,HUN,Hungary,2010,2,0,2
ERI,Eritrea,HUN,Hungary,2011,5,0,5
ERI,Eritrea,HUN,Hungary,2012,4,0,4
ERI,Eritrea,HUN,Hungary,2013,1,0,1
ERI,Eritrea,HUN,Hungary,2014,25,0,25
ERI,Eritrea,HUN,Hungary,2015,9,0,9
ERI,Eritrea,HUN,Hungary,2016,3,0,3
ERI,Eritrea,HUN,Hungary,2017,3,0,3
ERI,Eritrea,ISL,Iceland,2008,2,1,1
ERI,Eritrea,ISL,Iceland,2009,1,0,1
ERI,Eritrea,ISL,Iceland,2010,1,1,0
ERI,Eritrea,ISL,Iceland,2011,0,0,0
ERI,Eritrea,ISL,Iceland,2012,3,0,3
ERI,Eritrea,ISL,Iceland,2013,3,0,3
ERI,Eritrea,ISL,Iceland,2014,0,4,-4
ERI,Eritrea,ISL,Iceland,2015,4,4,0
ERI,Eritrea,ISL,Iceland,2016,0,0,0
ERI,Eritrea,ISL,Iceland,2017,2,0,2
ERI,Eritrea,ITA,Italy,2008,1210,19,1191
ERI,Eritrea,ITA,Italy,2009,1586,23,1563
ERI,Eritrea,ITA,Italy,2010,1106,36,1070
ERI,Eritrea,ITA,Italy,2011,641,35,606
ERI,Eritrea,ITA,Italy,2012,613,63,550
ERI,Eritrea,ITA,Italy,2013,807,25,782
ERI,Eritrea,ITA,Italy,2014,901,43,858
ERI,Eritrea,ITA,Italy,2015,629,52,577
ERI,Eritrea,ITA,Italy,2016,456,0,456
ERI,Eritrea,ITA,Italy,2017,538,56,482
ERI,Eritrea,JPN,Japan,2008,22,20,2
ERI,Eritrea,JPN,Japan,2009,16,15,1
ERI,Eritrea,JPN,Japan,2010,17,13,4
ERI,Eritrea,JPN,Japan,2011,13,5,8
ERI,Eritrea,JPN,Japan,2012,13,7,6
ERI,Eritrea,JPN,Japan,2013,9,10,-1
ERI,Eritrea,JPN,Japan,2014,14,11,3
ERI,Eritrea,JPN,Japan,2015,14,10,4
ERI,Eritrea,JPN,Japan,2016,12,6,6
ERI,Eritrea,JPN,Japan,2017,21,10,11
ERI,Eritrea,KOR,Korea,2008,0,1,-1
ERI,Eritrea,KOR,Korea,2009,0,0,0
ERI,Eritrea,KOR,Korea,2010,0,0,0
ERI,Eritrea,KOR,Korea,2011,2,0,2
ERI,Eritrea,KOR,Korea,2012,3,2,1
ERI,Eritrea,KOR,Korea,2013,2,2,0
ERI,Eritrea,KOR,Korea,2014,1,3,-2
ERI,Eritrea,KOR,Korea,2015,3,2,1
ERI,Eritrea,KOR,Korea,2016,4,2,2
ERI,Eritrea,KOR,Korea,2017,7,1,6
ERI,Eritrea,LUX,Luxembourg,2008,4,0,4
ERI,Eritrea,LUX,Luxembourg,2009,9,1,8
ERI,Eritrea,LUX,Luxembourg,2010,11,4,7
ERI,Eritrea,LUX,Luxembourg,2011,12,4,8
ERI,Eritrea,LUX,Luxembourg,2012,10,0,10
ERI,Eritrea,LUX,Luxembourg,2013,4,3,1
ERI,Eritrea,LUX,Luxembourg,2014,39,1,38
ERI,Eritrea,LUX,Luxembourg,2015,35,1,34
ERI,Eritrea,LUX,Luxembourg,2016,98,5,93
ERI,Eritrea,LUX,Luxembourg,2017,214,8,206
ERI,Eritrea,MEX,Mexico,2012,1,0,1
ERI,Eritrea,MEX,Mexico,2013,2,0,2
ERI,Eritrea,MEX,Mexico,2014,0,0,0
ERI,Eritrea,MEX,Mexico,2015,1,0,1
ERI,Eritrea,NLD,Netherlands,2008,31,23,8
ERI,Eritrea,NLD,Netherlands,2009,41,14,27
ERI,Eritrea,NLD,Netherlands,2010,43,18,25
ERI,Eritrea,NLD,Netherlands,2011,53,17,36
ERI,Eritrea,NLD,Netherlands,2012,41,19,22
ERI,Eritrea,NLD,Netherlands,2013,76,15,61
ERI,Eritrea,NLD,Netherlands,2014,2850,19,2831
ERI,Eritrea,NLD,Netherlands,2015,5706,37,5669
ERI,Eritrea,NLD,Netherlands,2016,5945,37,5908
ERI,Eritrea,NLD,Netherlands,2017,4676,100,4576
ERI,Eritrea,NZL,New Zealand,2008,123,0,123
ERI,Eritrea,NZL,New Zealand,2009,27,0,27
ERI,Eritrea,NZL,New Zealand,2010,17,1,16
ERI,Eritrea,NZL,New Zealand,2011,3,0,3
ERI,Eritrea,NZL,New Zealand,2012,16,1,15
ERI,Eritrea,NZL,New Zealand,2013,27,0,27
ERI,Eritrea,NZL,New Zealand,2014,29,0,29
ERI,Eritrea,NZL,New Zealand,2015,14,1,13
ERI,Eritrea,NZL,New Zealand,2016,15,0,15
ERI,Eritrea,NZL,New Zealand,2017,5,0,5
ERI,Eritrea,NOR,Norway,2008,778,8,770
ERI,Eritrea,NOR,Norway,2009,1670,16,1654
ERI,Eritrea,NOR,Norway,2010,1987,21,1966
ERI,Eritrea,NOR,Norway,2011,1974,46,1928
ERI,Eritrea,NOR,Norway,2012,2366,58,2308
ERI,Eritrea,NOR,Norway,2013,2729,73,2656
ERI,Eritrea,NOR,Norway,2014,2819,85,2734
ERI,Eritrea,NOR,Norway,2015,3276,93,3183
ERI,Eritrea,NOR,Norway,2016,2702,92,2610
ERI,Eritrea,NOR,Norway,2017,2098,85,2013
ERI,Eritrea,POL,Poland,2009,0,0,0
ERI,Eritrea,POL,Poland,2010,0,0,0
ERI,Eritrea,POL,Poland,2011,3,0,3
ERI,Eritrea,POL,Poland,2012,0,0,0
ERI,Eritrea,POL,Poland,2013,1,0,1
ERI,Eritrea,POL,Poland,2014,1,0,1
ERI,Eritrea,POL,Poland,2015,1,0,1
ERI,Eritrea,POL,Poland,2016,2,0,2
ERI,Eritrea,POL,Poland,2017,4,0,4
ERI,Eritrea,SVK,Slovak Republic,2008,0,1,-1
ERI,Eritrea,SVK,Slovak Republic,2010,1,0,1
ERI,Eritrea,SVK,Slovak Republic,2011,1,0,1
ERI,Eritrea,ESP,Spain,2008,24,3,21
ERI,Eritrea,ESP,Spain,2009,23,11,12
ERI,Eritrea,ESP,Spain,2010,14,22,-8
ERI,Eritrea,ESP,Spain,2011,6,10,-4
ERI,Eritrea,ESP,Spain,2012,29,6,23
ERI,Eritrea,ESP,Spain,2013,5,9,-4
ERI,Eritrea,ESP,Spain,2014,7,12,-5
ERI,Eritrea,ESP,Spain,2015,15,4,11
ERI,Eritrea,ESP,Spain,2016,38,0,38
ERI,Eritrea,ESP,Spain,2017,126,5,121
ERI,Eritrea,SWE,Sweden,2008,1170,16,1154
ERI,Eritrea,SWE,Sweden,2009,1398,23,1375
ERI,Eritrea,SWE,Sweden,2010,1604,18,1586
ERI,Eritrea,SWE,Sweden,2011,2128,29,2099
ERI,Eritrea,SWE,Sweden,2012,2213,73,2140
ERI,Eritrea,SWE,Sweden,2013,3338,40,3298
ERI,Eritrea,SWE,Sweden,2014,5880,70,5810
ERI,Eritrea,SWE,Sweden,2015,7558,71,7487
ERI,Eritrea,SWE,Sweden,2016,7580,23,7557
ERI,Eritrea,SWE,Sweden,2017,4752,56,4696
ERI,Eritrea,CHE,Switzerland,2010,2147,11,2136
ERI,Eritrea,CHE,Switzerland,2011,2394,17,2377
ERI,Eritrea,CHE,Switzerland,2012,1129,31,1098
ERI,Eritrea,CHE,Switzerland,2013,1518,36,1482
ERI,Eritrea,CHE,Switzerland,2014,1817,41,1776
ERI,Eritrea,CHE,Switzerland,2015,2171,27,2144
ERI,Eritrea,CHE,Switzerland,2016,2585,29,2556
ERI,Eritrea,CHE,Switzerland,2017,2885,27,2858
ERI,Eritrea,TUR,Turkey,2010,16,0,16
ERI,Eritrea,TUR,Turkey,2017,181,21,160
ERI,Eritrea,USA,United States,2008,1270,0,1270
ERI,Eritrea,USA,United States,2009,1928,0,1928
ERI,Eritrea,USA,United States,2010,1656,0,1656
ERI,Eritrea,USA,United States,2011,2102,0,2102
ERI,Eritrea,USA,United States,2012,2643,0,2643
ERI,Eritrea,USA,United States,2013,2138,0,2138
ERI,Eritrea,USA,United States,2014,2002,0,2002
ERI,Eritrea,USA,United States,2015,2220,0,2220
ERI,Eritrea,USA,United States,2016,2267,0,2267
ERI,Eritrea,USA,United States,2017,2449,0,2449
ERI,Eritrea,CHL,Chile,2008,0,0,0
ERI,Eritrea,CHL,Chile,2009,0,0,0
ERI,Eritrea,CHL,Chile,2010,0,0,0
ERI,Eritrea,CHL,Chile,2011,0,0,0
ERI,Eritrea,CHL,Chile,2012,0,0,0
ERI,Eritrea,CHL,Chile,2013,0,0,0
ERI,Eritrea,CHL,Chile,2014,0,0,0
ERI,Eritrea,CHL,Chile,2015,0,0,0
ERI,Eritrea,CHL,Chile,2016,2,0,2
ERI,Eritrea,EST,Estonia,2008,0,0,0
ERI,Eritrea,EST,Estonia,2009,0,0,0
ERI,Eritrea,EST,Estonia,2010,0,0,0
ERI,Eritrea,EST,Estonia,2011,0,0,0
ERI,Eritrea,EST,Estonia,2012,0,0,0
ERI,Eritrea,EST,Estonia,2013,0,0,0
ERI,Eritrea,EST,Estonia,2014,0,0,0
ERI,Eritrea,EST,Estonia,2015,0,0,0
ERI,Eritrea,EST,Estonia,2016,0,0,0
ERI,Eritrea,EST,Estonia,2017,0,0,0
ERI,Eritrea,SVN,Slovenia,2013,1,0,1
ERI,Eritrea,SVN,Slovenia,2014,1,0,1
ERI,Eritrea,SVN,Slovenia,2017,1,0,1
EST,Estonia,AUS,Australia,2008,30,4,26
EST,Estonia,AUS,Australia,2009,38,8,30
EST,Estonia,AUS,Australia,2010,54,2,52
EST,Estonia,AUS,Australia,2011,69,7,62
EST,Estonia,AUS,Australia,2012,61,7,54
EST,Estonia,AUS,Australia,2013,104,6,98
EST,Estonia,AUS,Australia,2014,121,8,113
EST,Estonia,AUS,Australia,2015,135,6,129
EST,Estonia,AUS,Australia,2016,172,17,155
EST,Estonia,AUS,Australia,2017,142,18,124
EST,Estonia,AUT,Austria,2008,66,12,54
EST,Estonia,AUT,Austria,2009,62,11,51
EST,Estonia,AUT,Austria,2010,83,10,73
EST,Estonia,AUT,Austria,2011,83,0,83
EST,Estonia,AUT,Austria,2012,98,0,98
EST,Estonia,AUT,Austria,2013,131,1,130
EST,Estonia,AUT,Austria,2014,115,0,115
EST,Estonia,AUT,Austria,2015,126,31,95
EST,Estonia,AUT,Austria,2016,111,40,71
EST,Estonia,AUT,Austria,2017,105,44,61
EST,Estonia,BEL,Belgium,2008,153,11,142
EST,Estonia,BEL,Belgium,2009,116,9,107
EST,Estonia,BEL,Belgium,2010,185,6,179
EST,Estonia,BEL,Belgium,2011,157,0,157
EST,Estonia,BEL,Belgium,2012,131,0,131
EST,Estonia,BEL,Belgium,2013,171,0,171
EST,Estonia,BEL,Belgium,2014,107,1,106
EST,Estonia,BEL,Belgium,2015,123,50,73
EST,Estonia,BEL,Belgium,2016,101,43,58
EST,Estonia,BEL,Belgium,2017,109,43,66
EST,Estonia,CAN,Canada,2008,34,8,26
EST,Estonia,CAN,Canada,2009,26,5,21
EST,Estonia,CAN,Canada,2010,28,5,23
EST,Estonia,CAN,Canada,2011,15,11,4
EST,Estonia,CAN,Canada,2012,26,3,23
EST,Estonia,CAN,Canada,2013,45,6,39
EST,Estonia,CAN,Canada,2014,32,7,25
EST,Estonia,CAN,Canada,2015,53,14,39
EST,Estonia,CAN,Canada,2016,55,10,45
EST,Estonia,CAN,Canada,2017,35,32,3
EST,Estonia,CZE,Czech Republic,2008,10,17,-7
EST,Estonia,CZE,Czech Republic,2009,14,22,-8
EST,Estonia,CZE,Czech Republic,2010,12,10,2
EST,Estonia,CZE,Czech Republic,2011,13,1,12
EST,Estonia,CZE,Czech Republic,2012,13,0,13
EST,Estonia,CZE,Czech Republic,2013,20,1,19
EST,Estonia,CZE,Czech Republic,2014,16,0,16
EST,Estonia,CZE,Czech Republic,2015,23,77,-54
EST,Estonia,CZE,Czech Republic,2016,15,79,-64
EST,Estonia,CZE,Czech Republic,2017,10,113,-103
EST,Estonia,DNK,Denmark,2008,162,13,149
EST,Estonia,DNK,Denmark,2009,142,11,131
EST,Estonia,DNK,Denmark,2010,190,9,181
EST,Estonia,DNK,Denmark,2011,214,0,214
EST,Estonia,DNK,Denmark,2012,249,1,248
EST,Estonia,DNK,Denmark,2013,209,2,207
EST,Estonia,DNK,Denmark,2014,193,0,193
EST,Estonia,DNK,Denmark,2015,170,25,145
EST,Estonia,DNK,Denmark,2016,151,31,120
EST,Estonia,DNK,Denmark,2017,126,31,95
EST,Estonia,FIN,Finland,2008,3038,303,2735
EST,Estonia,FIN,Finland,2009,3176,314,2862
EST,Estonia,FIN,Finland,2010,3909,162,3747
EST,Estonia,FIN,Finland,2011,4704,18,4686
EST,Estonia,FIN,Finland,2012,6041,22,6019
EST,Estonia,FIN,Finland,2013,5856,34,5822
EST,Estonia,FIN,Finland,2014,4663,23,4640
EST,Estonia,FIN,Finland,2015,3355,899,2456
EST,Estonia,FIN,Finland,2016,2596,899,1697
EST,Estonia,FIN,Finland,2017,2176,938,1238
EST,Estonia,FRA,France,2008,0,48,-48
EST,Estonia,FRA,France,2009,0,58,-58
EST,Estonia,FRA,France,2010,0,46,-46
EST,Estonia,FRA,France,2011,0,1,-1
EST,Estonia,FRA,France,2012,0,2,-2
EST,Estonia,FRA,France,2013,160,7,153
EST,Estonia,FRA,France,2014,99,1,98
EST,Estonia,FRA,France,2015,114,185,-71
EST,Estonia,FRA,France,2016,200,206,-6
EST,Estonia,FRA,France,2017,58,270,-212
EST,Estonia,DEU,Germany,2008,621,123,498
EST,Estonia,DEU,Germany,2009,842,104,738
EST,Estonia,DEU,Germany,2010,1110,34,1076
EST,Estonia,DEU,Germany,2011,1419,8,1411
EST,Estonia,DEU,Germany,2012,1290,10,1280
EST,Estonia,DEU,Germany,2013,1336,9,1327
EST,Estonia,DEU,Germany,2014,1120,10,1110
EST,Estonia,DEU,Germany,2015,991,402,589
EST,Estonia,DEU,Germany,2016,882,456,426
EST,Estonia,DEU,Germany,2017,806,495,311
EST,Estonia,HUN,Hungary,2008,13,14,-1
EST,Estonia,HUN,Hungary,2009,16,21,-5
EST,Estonia,HUN,Hungary,2010,10,7,3
EST,Estonia,HUN,Hungary,2011,18,0,18
EST,Estonia,HUN,Hungary,2012,15,1,14
EST,Estonia,HUN,Hungary,2013,14,1,13
EST,Estonia,HUN,Hungary,2014,22,3,19
EST,Estonia,HUN,Hungary,2015,19,44,-25
EST,Estonia,HUN,Hungary,2016,14,43,-29
EST,Estonia,HUN,Hungary,2017,17,68,-51
EST,Estonia,ISL,Iceland,2008,30,0,30
EST,Estonia,ISL,Iceland,2009,17,3,14
EST,Estonia,ISL,Iceland,2010,29,0,29
EST,Estonia,ISL,Iceland,2011,18,0,18
EST,Estonia,ISL,Iceland,2012,7,1,6
EST,Estonia,ISL,Iceland,2013,22,0,22
EST,Estonia,ISL,Iceland,2014,11,0,11
EST,Estonia,ISL,Iceland,2015,15,4,11
EST,Estonia,ISL,Iceland,2016,21,1,20
EST,Estonia,ISL,Iceland,2017,32,4,28
EST,Estonia,ITA,Italy,2008,136,50,86
EST,Estonia,ITA,Italy,2009,110,59,51
EST,Estonia,ITA,Italy,2010,124,34,90
EST,Estonia,ITA,Italy,2011,91,3,88
EST,Estonia,ITA,Italy,2012,93,3,90
EST,Estonia,ITA,Italy,2013,71,7,64
EST,Estonia,ITA,Italy,2014,68,3,65
EST,Estonia,ITA,Italy,2015,86,198,-112
EST,Estonia,ITA,Italy,2016,70,242,-172
EST,Estonia,ITA,Italy,2017,74,316,-242
EST,Estonia,JPN,Japan,2008,71,5,66
EST,Estonia,JPN,Japan,2009,106,12,94
EST,Estonia,JPN,Japan,2010,62,4,58
EST,Estonia,JPN,Japan,2011,71,10,61
EST,Estonia,JPN,Japan,2012,86,8,78
EST,Estonia,JPN,Japan,2013,80,10,70
EST,Estonia,JPN,Japan,2014,87,4,83
EST,Estonia,JPN,Japan,2015,505,21,484
EST,Estonia,JPN,Japan,2016,371,27,344
EST,Estonia,JPN,Japan,2017,98,38,60
EST,Estonia,KOR,Korea,2008,5,0,5
EST,Estonia,KOR,Korea,2009,0,4,-4
EST,Estonia,KOR,Korea,2010,9,3,6
EST,Estonia,KOR,Korea,2011,13,2,11
EST,Estonia,KOR,Korea,2012,14,1,13
EST,Estonia,KOR,Korea,2013,11,32,-21
EST,Estonia,KOR,Korea,2014,10,3,7
EST,Estonia,KOR,Korea,2015,10,16,-6
EST,Estonia,KOR,Korea,2016,13,20,-7
EST,Estonia,KOR,Korea,2017,13,26,-13
EST,Estonia,LUX,Luxembourg,2008,71,0,71
EST,Estonia,LUX,Luxembourg,2009,34,1,33
EST,Estonia,LUX,Luxembourg,2010,60,0,60
EST,Estonia,LUX,Luxembourg,2011,55,0,55
EST,Estonia,LUX,Luxembourg,2012,59,0,59
EST,Estonia,LUX,Luxembourg,2013,53,0,53
EST,Estonia,LUX,Luxembourg,2014,45,0,45
EST,Estonia,LUX,Luxembourg,2015,43,1,42
EST,Estonia,LUX,Luxembourg,2016,41,0,41
EST,Estonia,LUX,Luxembourg,2017,52,1,51
EST,Estonia,MEX,Mexico,2008,3,1,2
EST,Estonia,MEX,Mexico,2009,4,6,-2
EST,Estonia,MEX,Mexico,2010,1,2,-1
EST,Estonia,MEX,Mexico,2011,1,3,-2
EST,Estonia,MEX,Mexico,2012,3,8,-5
EST,Estonia,MEX,Mexico,2013,9,10,-1
EST,Estonia,MEX,Mexico,2014,8,10,-2
EST,Estonia,MEX,Mexico,2015,1,13,-12
EST,Estonia,MEX,Mexico,2016,6,26,-20
EST,Estonia,MEX,Mexico,2017,2,22,-20
EST,Estonia,NLD,Netherlands,2008,132,15,117
EST,Estonia,NLD,Netherlands,2009,168,20,148
EST,Estonia,NLD,Netherlands,2010,312,12,300
EST,Estonia,NLD,Netherlands,2011,349,0,349
EST,Estonia,NLD,Netherlands,2012,297,2,295
EST,Estonia,NLD,Netherlands,2013,284,2,282
EST,Estonia,NLD,Netherlands,2014,301,0,301
EST,Estonia,NLD,Netherlands,2015,213,51,162
EST,Estonia,NLD,Netherlands,2016,253,67,186
EST,Estonia,NLD,Netherlands,2017,287,66,221
EST,Estonia,NZL,New Zealand,2008,14,0,14
EST,Estonia,NZL,New Zealand,2009,31,3,28
EST,Estonia,NZL,New Zealand,2010,37,0,37
EST,Estonia,NZL,New Zealand,2011,54,0,54
EST,Estonia,NZL,New Zealand,2012,62,2,60
EST,Estonia,NZL,New Zealand,2013,73,1,72
EST,Estonia,NZL,New Zealand,2014,58,1,57
EST,Estonia,NZL,New Zealand,2015,80,3,77
EST,Estonia,NZL,New Zealand,2016,55,1,54
EST,Estonia,NZL,New Zealand,2017,97,3,94
EST,Estonia,NOR,Norway,2008,535,11,524
EST,Estonia,NOR,Norway,2009,510,19,491
EST,Estonia,NOR,Norway,2010,1008,8,1000
EST,Estonia,NOR,Norway,2011,1027,2,1025
EST,Estonia,NOR,Norway,2012,908,2,906
EST,Estonia,NOR,Norway,2013,643,0,643
EST,Estonia,NOR,Norway,2014,579,1,578
EST,Estonia,NOR,Norway,2015,453,34,419
EST,Estonia,NOR,Norway,2016,267,39,228
EST,Estonia,NOR,Norway,2017,252,43,209
EST,Estonia,POL,Poland,2008,11,31,-20
EST,Estonia,POL,Poland,2009,13,47,-34
EST,Estonia,POL,Poland,2010,5,12,-7
EST,Estonia,POL,Poland,2011,20,3,17
EST,Estonia,POL,Poland,2012,15,2,13
EST,Estonia,POL,Poland,2013,12,2,10
EST,Estonia,POL,Poland,2014,12,4,8
EST,Estonia,POL,Poland,2015,24,110,-86
EST,Estonia,POL,Poland,2016,23,83,-60
EST,Estonia,POL,Poland,2017,22,92,-70
EST,Estonia,SVK,Slovak Republic,2008,7,3,4
EST,Estonia,SVK,Slovak Republic,2009,5,4,1
EST,Estonia,SVK,Slovak Republic,2010,8,1,7
EST,Estonia,SVK,Slovak Republic,2011,7,0,7
EST,Estonia,SVK,Slovak Republic,2012,4,1,3
EST,Estonia,SVK,Slovak Republic,2013,3,2,1
EST,Estonia,SVK,Slovak Republic,2014,2,1,1
EST,Estonia,SVK,Slovak Republic,2015,1,43,-42
EST,Estonia,SVK,Slovak Republic,2016,4,60,-56
EST,Estonia,SVK,Slovak Republic,2017,1,69,-68
EST,Estonia,ESP,Spain,2008,177,40,137
EST,Estonia,ESP,Spain,2009,178,38,140
EST,Estonia,ESP,Spain,2010,215,8,207
EST,Estonia,ESP,Spain,2011,230,0,230
EST,Estonia,ESP,Spain,2012,287,1,286
EST,Estonia,ESP,Spain,2013,321,2,319
EST,Estonia,ESP,Spain,2014,282,1,281
EST,Estonia,ESP,Spain,2015,334,143,191
EST,Estonia,ESP,Spain,2016,362,157,205
EST,Estonia,ESP,Spain,2017,393,199,194
EST,Estonia,SWE,Sweden,2008,389,63,326
EST,Estonia,SWE,Sweden,2009,558,71,487
EST,Estonia,SWE,Sweden,2010,491,28,463
EST,Estonia,SWE,Sweden,2011,494,4,490
EST,Estonia,SWE,Sweden,2012,542,4,538
EST,Estonia,SWE,Sweden,2013,547,4,543
EST,Estonia,SWE,Sweden,2014,513,11,502
EST,Estonia,SWE,Sweden,2015,535,139,396
EST,Estonia,SWE,Sweden,2016,419,129,290
EST,Estonia,SWE,Sweden,2017,414,199,215
EST,Estonia,CHE,Switzerland,2008,84,3,81
EST,Estonia,CHE,Switzerland,2009,79,2,77
EST,Estonia,CHE,Switzerland,2010,89,2,87
EST,Estonia,CHE,Switzerland,2011,141,0,141
EST,Estonia,CHE,Switzerland,2012,134,0,134
EST,Estonia,CHE,Switzerland,2013,108,0,108
EST,Estonia,CHE,Switzerland,2014,170,0,170
EST,Estonia,CHE,Switzerland,2015,118,14,104
EST,Estonia,CHE,Switzerland,2016,134,17,117
EST,Estonia,CHE,Switzerland,2017,89,16,73
EST,Estonia,TUR,Turkey,2010,21,17,4
EST,Estonia,GBR,United Kingdom,2011,2000,0,2000
EST,Estonia,GBR,United Kingdom,2012,1000,2,998
EST,Estonia,GBR,United Kingdom,2013,1000,9,991
EST,Estonia,USA,United States,2008,287,31,256
EST,Estonia,USA,United States,2009,282,70,212
EST,Estonia,USA,United States,2010,260,10,250
EST,Estonia,USA,United States,2011,191,46,145
EST,Estonia,USA,United States,2012,227,53,174
EST,Estonia,USA,United States,2013,211,75,136
EST,Estonia,USA,United States,2014,220,63,157
EST,Estonia,USA,United States,2015,189,98,91
EST,Estonia,USA,United States,2016,211,111,100
EST,Estonia,USA,United States,2017,176,118,58
EST,Estonia,CHL,Chile,2008,1,2,-1
EST,Estonia,CHL,Chile,2009,1,0,1
EST,Estonia,CHL,Chile,2010,2,0,2
EST,Estonia,CHL,Chile,2011,2,4,-2
EST,Estonia,CHL,Chile,2012,0,1,-1
EST,Estonia,CHL,Chile,2013,3,3,0
EST,Estonia,CHL,Chile,2014,5,0,5
EST,Estonia,CHL,Chile,2015,8,3,5
EST,Estonia,CHL,Chile,2016,0,5,-5
EST,Estonia,SVN,Slovenia,2008,4,3,1
EST,Estonia,SVN,Slovenia,2009,8,2,6
EST,Estonia,SVN,Slovenia,2011,8,0,8
EST,Estonia,SVN,Slovenia,2012,14,0,14
EST,Estonia,SVN,Slovenia,2013,8,0,8
EST,Estonia,SVN,Slovenia,2014,15,0,15
EST,Estonia,SVN,Slovenia,2015,11,6,5
EST,Estonia,SVN,Slovenia,2016,8,14,-6
EST,Estonia,SVN,Slovenia,2017,16,15,1
ETH,Ethiopia,AUS,Australia,2008,476,68,408
ETH,Ethiopia,AUS,Australia,2009,716,52,664
ETH,Ethiopia,AUS,Australia,2010,800,50,750
ETH,Ethiopia,AUS,Australia,2011,714,50,664
ETH,Ethiopia,AUS,Australia,2012,781,80,701
ETH,Ethiopia,AUS,Australia,2013,429,52,377
ETH,Ethiopia,AUS,Australia,2014,659,71,588
ETH,Ethiopia,AUS,Australia,2015,740,100,640
ETH,Ethiopia,AUS,Australia,2016,680,100,580
ETH,Ethiopia,AUS,Australia,2017,753,0,753
ETH,Ethiopia,AUT,Austria,2008,98,38,60
ETH,Ethiopia,AUT,Austria,2009,103,59,44
ETH,Ethiopia,AUT,Austria,2010,80,48,32
ETH,Ethiopia,AUT,Austria,2011,63,80,-17
ETH,Ethiopia,AUT,Austria,2012,78,46,32
ETH,Ethiopia,AUT,Austria,2013,63,41,22
ETH,Ethiopia,AUT,Austria,2014,85,50,35
ETH,Ethiopia,AUT,Austria,2015,108,44,64
ETH,Ethiopia,AUT,Austria,2016,125,61,64
ETH,Ethiopia,AUT,Austria,2017,80,50,30
ETH,Ethiopia,BEL,Belgium,2008,160,0,160
ETH,Ethiopia,BEL,Belgium,2009,177,0,177
ETH,Ethiopia,BEL,Belgium,2010,183,100,83
ETH,Ethiopia,BEL,Belgium,2011,181,0,181
ETH,Ethiopia,BEL,Belgium,2012,201,149,52
ETH,Ethiopia,BEL,Belgium,2013,165,136,29
ETH,Ethiopia,BEL,Belgium,2014,178,138,40
ETH,Ethiopia,BEL,Belgium,2015,179,125,54
ETH,Ethiopia,BEL,Belgium,2016,170,119,51
ETH,Ethiopia,BEL,Belgium,2017,185,87,98
ETH,Ethiopia,CAN,Canada,2008,1611,0,1611
ETH,Ethiopia,CAN,Canada,2009,1287,0,1287
ETH,Ethiopia,CAN,Canada,2010,1865,0,1865
ETH,Ethiopia,CAN,Canada,2011,2163,0,2163
ETH,Ethiopia,CAN,Canada,2012,1859,0,1859
ETH,Ethiopia,CAN,Canada,2013,1608,0,1608
ETH,Ethiopia,CAN,Canada,2014,1339,0,1339
ETH,Ethiopia,CAN,Canada,2015,1365,0,1365
ETH,Ethiopia,CAN,Canada,2016,1940,0,1940
ETH,Ethiopia,CAN,Canada,2017,1915,0,1915
ETH,Ethiopia,CZE,Czech Republic,2008,13,1,12
ETH,Ethiopia,CZE,Czech Republic,2009,14,0,14
ETH,Ethiopia,CZE,Czech Republic,2010,21,0,21
ETH,Ethiopia,CZE,Czech Republic,2011,12,0,12
ETH,Ethiopia,CZE,Czech Republic,2012,16,10,6
ETH,Ethiopia,CZE,Czech Republic,2013,10,17,-7
ETH,Ethiopia,CZE,Czech Republic,2014,25,9,16
ETH,Ethiopia,CZE,Czech Republic,2015,16,14,2
ETH,Ethiopia,CZE,Czech Republic,2016,13,13,0
ETH,Ethiopia,CZE,Czech Republic,2017,20,12,8
ETH,Ethiopia,DNK,Denmark,2008,82,14,68
ETH,Ethiopia,DNK,Denmark,2009,102,25,77
ETH,Ethiopia,DNK,Denmark,2010,60,27,33
ETH,Ethiopia,DNK,Denmark,2011,80,15,65
ETH,Ethiopia,DNK,Denmark,2012,90,21,69
ETH,Ethiopia,DNK,Denmark,2013,80,28,52
ETH,Ethiopia,DNK,Denmark,2014,69,32,37
ETH,Ethiopia,DNK,Denmark,2015,100,45,55
ETH,Ethiopia,DNK,Denmark,2016,81,78,3
ETH,Ethiopia,DNK,Denmark,2017,72,44,28
ETH,Ethiopia,FIN,Finland,2008,201,7,194
ETH,Ethiopia,FIN,Finland,2009,113,6,107
ETH,Ethiopia,FIN,Finland,2010,69,9,60
ETH,Ethiopia,FIN,Finland,2011,106,6,100
ETH,Ethiopia,FIN,Finland,2012,111,13,98
ETH,Ethiopia,FIN,Finland,2013,98,13,85
ETH,Ethiopia,FIN,Finland,2014,101,11,90
ETH,Ethiopia,FIN,Finland,2015,65,19,46
ETH,Ethiopia,FIN,Finland,2016,118,19,99
ETH,Ethiopia,FIN,Finland,2017,63,16,47
ETH,Ethiopia,FRA,France,2008,124,0,124
ETH,Ethiopia,FRA,France,2009,144,0,144
ETH,Ethiopia,FRA,France,2010,154,0,154
ETH,Ethiopia,FRA,France,2011,136,0,136
ETH,Ethiopia,FRA,France,2012,116,0,116
ETH,Ethiopia,FRA,France,2013,137,0,137
ETH,Ethiopia,FRA,France,2014,126,0,126
ETH,Ethiopia,FRA,France,2015,128,0,128
ETH,Ethiopia,FRA,France,2016,133,0,133
ETH,Ethiopia,FRA,France,2017,373,0,373
ETH,Ethiopia,DEU,Germany,2008,719,596,123
ETH,Ethiopia,DEU,Germany,2009,789,634,155
ETH,Ethiopia,DEU,Germany,2010,931,570,361
ETH,Ethiopia,DEU,Germany,2011,1051,436,615
ETH,Ethiopia,DEU,Germany,2012,1124,497,627
ETH,Ethiopia,DEU,Germany,2013,1337,580,757
ETH,Ethiopia,DEU,Germany,2014,1782,688,1094
ETH,Ethiopia,DEU,Germany,2015,3341,723,2618
ETH,Ethiopia,DEU,Germany,2016,3101,1152,1949
ETH,Ethiopia,DEU,Germany,2017,1511,1276,235
ETH,Ethiopia,HUN,Hungary,2008,22,2,20
ETH,Ethiopia,HUN,Hungary,2009,24,2,22
ETH,Ethiopia,HUN,Hungary,2010,29,0,29
ETH,Ethiopia,HUN,Hungary,2011,15,7,8
ETH,Ethiopia,HUN,Hungary,2012,34,1,33
ETH,Ethiopia,HUN,Hungary,2013,8,0,8
ETH,Ethiopia,HUN,Hungary,2014,20,6,14
ETH,Ethiopia,HUN,Hungary,2015,18,1,17
ETH,Ethiopia,HUN,Hungary,2016,42,2,40
ETH,Ethiopia,HUN,Hungary,2017,46,0,46
ETH,Ethiopia,ISL,Iceland,2008,10,5,5
ETH,Ethiopia,ISL,Iceland,2009,4,9,-5
ETH,Ethiopia,ISL,Iceland,2010,8,7,1
ETH,Ethiopia,ISL,Iceland,2011,5,4,1
ETH,Ethiopia,ISL,Iceland,2012,7,1,6
ETH,Ethiopia,ISL,Iceland,2013,6,3,3
ETH,Ethiopia,ISL,Iceland,2014,10,11,-1
ETH,Ethiopia,ISL,Iceland,2015,6,4,2
ETH,Ethiopia,ISL,Iceland,2016,8,3,5
ETH,Ethiopia,ISL,Iceland,2017,10,7,3
ETH,Ethiopia,ITA,Italy,2008,1009,17,992
ETH,Ethiopia,ITA,Italy,2009,978,20,958
ETH,Ethiopia,ITA,Italy,2010,830,33,797
ETH,Ethiopia,ITA,Italy,2011,749,18,731
ETH,Ethiopia,ITA,Italy,2012,837,53,784
ETH,Ethiopia,ITA,Italy,2013,691,43,648
ETH,Ethiopia,ITA,Italy,2014,541,54,487
ETH,Ethiopia,ITA,Italy,2015,418,42,376
ETH,Ethiopia,ITA,Italy,2016,352,0,352
ETH,Ethiopia,ITA,Italy,2017,450,30,420
ETH,Ethiopia,JPN,Japan,2008,155,125,30
ETH,Ethiopia,JPN,Japan,2009,145,109,36
ETH,Ethiopia,JPN,Japan,2010,190,176,14
ETH,Ethiopia,JPN,Japan,2011,191,188,3
ETH,Ethiopia,JPN,Japan,2012,246,217,29
ETH,Ethiopia,JPN,Japan,2013,262,250,12
ETH,Ethiopia,JPN,Japan,2014,253,203,50
ETH,Ethiopia,JPN,Japan,2015,297,205,92
ETH,Ethiopia,JPN,Japan,2016,238,223,15
ETH,Ethiopia,JPN,Japan,2017,252,224,28
ETH,Ethiopia,KOR,Korea,2008,34,17,17
ETH,Ethiopia,KOR,Korea,2009,25,23,2
ETH,Ethiopia,KOR,Korea,2010,52,30,22
ETH,Ethiopia,KOR,Korea,2011,86,36,50
ETH,Ethiopia,KOR,Korea,2012,170,54,116
ETH,Ethiopia,KOR,Korea,2013,171,83,88
ETH,Ethiopia,KOR,Korea,2014,130,91,39
ETH,Ethiopia,KOR,Korea,2015,159,116,43
ETH,Ethiopia,KOR,Korea,2016,206,92,114
ETH,Ethiopia,KOR,Korea,2017,215,125,90
ETH,Ethiopia,LUX,Luxembourg,2008,10,3,7
ETH,Ethiopia,LUX,Luxembourg,2009,9,2,7
ETH,Ethiopia,LUX,Luxembourg,2010,8,6,2
ETH,Ethiopia,LUX,Luxembourg,2011,9,3,6
ETH,Ethiopia,LUX,Luxembourg,2012,7,5,2
ETH,Ethiopia,LUX,Luxembourg,2013,4,3,1
ETH,Ethiopia,LUX,Luxembourg,2014,19,0,19
ETH,Ethiopia,LUX,Luxembourg,2015,23,5,18
ETH,Ethiopia,LUX,Luxembourg,2016,18,4,14
ETH,Ethiopia,LUX,Luxembourg,2017,18,7,11
ETH,Ethiopia,MEX,Mexico,2009,1,0,1
ETH,Ethiopia,MEX,Mexico,2010,2,0,2
ETH,Ethiopia,MEX,Mexico,2011,2,0,2
ETH,Ethiopia,MEX,Mexico,2012,0,0,0
ETH,Ethiopia,MEX,Mexico,2013,2,0,2
ETH,Ethiopia,MEX,Mexico,2014,2,0,2
ETH,Ethiopia,MEX,Mexico,2015,2,0,2
ETH,Ethiopia,MEX,Mexico,2016,2,0,2
ETH,Ethiopia,MEX,Mexico,2017,1,0,1
ETH,Ethiopia,NLD,Netherlands,2008,266,177,89
ETH,Ethiopia,NLD,Netherlands,2009,274,122,152
ETH,Ethiopia,NLD,Netherlands,2010,281,261,20
ETH,Ethiopia,NLD,Netherlands,2011,237,198,39
ETH,Ethiopia,NLD,Netherlands,2012,248,146,102
ETH,Ethiopia,NLD,Netherlands,2013,244,281,-37
ETH,Ethiopia,NLD,Netherlands,2014,230,184,46
ETH,Ethiopia,NLD,Netherlands,2015,263,195,68
ETH,Ethiopia,NLD,Netherlands,2016,358,217,141
ETH,Ethiopia,NLD,Netherlands,2017,243,198,45
ETH,Ethiopia,NZL,New Zealand,2008,70,1,69
ETH,Ethiopia,NZL,New Zealand,2009,42,2,40
ETH,Ethiopia,NZL,New Zealand,2010,73,0,73
ETH,Ethiopia,NZL,New Zealand,2011,48,1,47
ETH,Ethiopia,NZL,New Zealand,2012,73,1,72
ETH,Ethiopia,NZL,New Zealand,2013,49,3,46
ETH,Ethiopia,NZL,New Zealand,2014,56,3,53
ETH,Ethiopia,NZL,New Zealand,2015,61,3,58
ETH,Ethiopia,NZL,New Zealand,2016,37,5,32
ETH,Ethiopia,NZL,New Zealand,2017,29,4,25
ETH,Ethiopia,NOR,Norway,2008,425,64,361
ETH,Ethiopia,NOR,Norway,2009,631,99,532
ETH,Ethiopia,NOR,Norway,2010,479,91,388
ETH,Ethiopia,NOR,Norway,2011,508,150,358
ETH,Ethiopia,NOR,Norway,2012,540,98,442
ETH,Ethiopia,NOR,Norway,2013,582,114,468
ETH,Ethiopia,NOR,Norway,2014,544,100,444
ETH,Ethiopia,NOR,Norway,2015,675,123,552
ETH,Ethiopia,NOR,Norway,2016,568,126,442
ETH,Ethiopia,NOR,Norway,2017,435,73,362
ETH,Ethiopia,POL,Poland,2009,25,0,25
ETH,Ethiopia,POL,Poland,2010,28,0,28
ETH,Ethiopia,POL,Poland,2011,28,0,28
ETH,Ethiopia,POL,Poland,2012,20,0,20
ETH,Ethiopia,POL,Poland,2013,25,0,25
ETH,Ethiopia,POL,Poland,2014,9,0,9
ETH,Ethiopia,POL,Poland,2015,15,0,15
ETH,Ethiopia,POL,Poland,2016,18,0,18
ETH,Ethiopia,POL,Poland,2017,12,0,12
ETH,Ethiopia,SVK,Slovak Republic,2008,1,0,1
ETH,Ethiopia,SVK,Slovak Republic,2009,1,0,1
ETH,Ethiopia,SVK,Slovak Republic,2010,1,1,0
ETH,Ethiopia,SVK,Slovak Republic,2011,2,0,2
ETH,Ethiopia,SVK,Slovak Republic,2013,1,0,1
ETH,Ethiopia,ESP,Spain,2008,276,30,246
ETH,Ethiopia,ESP,Spain,2009,354,35,319
ETH,Ethiopia,ESP,Spain,2010,245,46,199
ETH,Ethiopia,ESP,Spain,2011,220,78,142
ETH,Ethiopia,ESP,Spain,2012,190,32,158
ETH,Ethiopia,ESP,Spain,2013,141,60,81
ETH,Ethiopia,ESP,Spain,2014,98,57,41
ETH,Ethiopia,ESP,Spain,2015,102,37,65
ETH,Ethiopia,ESP,Spain,2016,62,20,42
ETH,Ethiopia,ESP,Spain,2017,70,61,9
ETH,Ethiopia,SWE,Sweden,2008,518,48,470
ETH,Ethiopia,SWE,Sweden,2009,795,16,779
ETH,Ethiopia,SWE,Sweden,2010,958,72,886
ETH,Ethiopia,SWE,Sweden,2011,654,69,585
ETH,Ethiopia,SWE,Sweden,2012,662,128,534
ETH,Ethiopia,SWE,Sweden,2013,597,80,517
ETH,Ethiopia,SWE,Sweden,2014,774,148,626
ETH,Ethiopia,SWE,Sweden,2015,731,236,495
ETH,Ethiopia,SWE,Sweden,2016,1260,65,1195
ETH,Ethiopia,SWE,Sweden,2017,1518,60,1458
ETH,Ethiopia,CHE,Switzerland,2010,322,28,294
ETH,Ethiopia,CHE,Switzerland,2011,260,21,239
ETH,Ethiopia,CHE,Switzerland,2012,237,23,214
ETH,Ethiopia,CHE,Switzerland,2013,224,22,202
ETH,Ethiopia,CHE,Switzerland,2014,206,31,175
ETH,Ethiopia,CHE,Switzerland,2015,211,24,187
ETH,Ethiopia,CHE,Switzerland,2016,198,28,170
ETH,Ethiopia,CHE,Switzerland,2017,223,26,197
ETH,Ethiopia,TUR,Turkey,2010,31,0,31
ETH,Ethiopia,TUR,Turkey,2016,494,242,252
ETH,Ethiopia,TUR,Turkey,2017,551,311,240
ETH,Ethiopia,GBR,United Kingdom,2011,1000,0,1000
ETH,Ethiopia,USA,United States,2008,12917,0,12917
ETH,Ethiopia,USA,United States,2009,15462,0,15462
ETH,Ethiopia,USA,United States,2010,14266,0,14266
ETH,Ethiopia,USA,United States,2011,13793,0,13793
ETH,Ethiopia,USA,United States,2012,14544,0,14544
ETH,Ethiopia,USA,United States,2013,13097,0,13097
ETH,Ethiopia,USA,United States,2014,12300,0,12300
ETH,Ethiopia,USA,United States,2015,11394,0,11394
ETH,Ethiopia,USA,United States,2016,13232,0,13232
ETH,Ethiopia,USA,United States,2017,14637,0,14637
ETH,Ethiopia,CHL,Chile,2008,1,0,1
ETH,Ethiopia,CHL,Chile,2009,0,0,0
ETH,Ethiopia,CHL,Chile,2010,0,0,0
ETH,Ethiopia,CHL,Chile,2011,1,0,1
ETH,Ethiopia,CHL,Chile,2012,0,0,0
ETH,Ethiopia,CHL,Chile,2013,4,0,4
ETH,Ethiopia,CHL,Chile,2014,0,0,0
ETH,Ethiopia,CHL,Chile,2015,0,0,0
ETH,Ethiopia,CHL,Chile,2016,2,0,2
ETH,Ethiopia,EST,Estonia,2008,2,0,2
ETH,Ethiopia,EST,Estonia,2009,0,0,0
ETH,Ethiopia,EST,Estonia,2010,3,0,3
ETH,Ethiopia,EST,Estonia,2011,1,0,1
ETH,Ethiopia,EST,Estonia,2012,0,0,0
ETH,Ethiopia,EST,Estonia,2013,0,0,0
ETH,Ethiopia,EST,Estonia,2014,1,0,1
ETH,Ethiopia,EST,Estonia,2015,2,0,2
ETH,Ethiopia,EST,Estonia,2016,1,0,1
ETH,Ethiopia,EST,Estonia,2017,3,0,3
ETH,Ethiopia,ISR,Israel,2008,1582,0,1582
ETH,Ethiopia,ISR,Israel,2009,239,0,239
ETH,Ethiopia,ISR,Israel,2010,1655,0,1655
ETH,Ethiopia,ISR,Israel,2011,2666,0,2666
ETH,Ethiopia,ISR,Israel,2012,2432,0,2432
ETH,Ethiopia,ISR,Israel,2013,1355,0,1355
ETH,Ethiopia,ISR,Israel,2014,211,0,211
ETH,Ethiopia,ISR,Israel,2015,91,0,91
ETH,Ethiopia,ISR,Israel,2016,40,0,40
ETH,Ethiopia,ISR,Israel,2017,37,0,37
ETH,Ethiopia,SVN,Slovenia,2008,1,0,1
ETH,Ethiopia,SVN,Slovenia,2009,8,0,8
ETH,Ethiopia,SVN,Slovenia,2010,3,0,3
ETH,Ethiopia,SVN,Slovenia,2011,1,1,0
ETH,Ethiopia,SVN,Slovenia,2012,3,0,3
ETH,Ethiopia,SVN,Slovenia,2013,3,0,3
ETH,Ethiopia,SVN,Slovenia,2014,2,0,2
ETH,Ethiopia,SVN,Slovenia,2015,2,0,2
ETH,Ethiopia,SVN,Slovenia,2016,1,0,1
ETH,Ethiopia,SVN,Slovenia,2017,8,0,8
FJI,Fiji,AUS,Australia,2008,1841,247,1594
FJI,Fiji,AUS,Australia,2009,1863,212,1651
FJI,Fiji,AUS,Australia,2010,1492,212,1280
FJI,Fiji,AUS,Australia,2011,1351,190,1161
FJI,Fiji,AUS,Australia,2012,1446,184,1262
FJI,Fiji,AUS,Australia,2013,1223,204,1019
FJI,Fiji,AUS,Australia,2014,1279,216,1063
FJI,Fiji,AUS,Australia,2015,996,200,796
FJI,Fiji,AUS,Australia,2016,904,200,704
FJI,Fiji,AUS,Australia,2017,768,0,768
FJI,Fiji,AUT,Austria,2008,3,1,2
FJI,Fiji,AUT,Austria,2009,0,2,-2
FJI,Fiji,AUT,Austria,2010,5,0,5
FJI,Fiji,AUT,Austria,2011,1,0,1
FJI,Fiji,AUT,Austria,2012,5,3,2
FJI,Fiji,AUT,Austria,2013,0,0,0
FJI,Fiji,AUT,Austria,2014,1,1,0
FJI,Fiji,AUT,Austria,2015,1,2,-1
FJI,Fiji,AUT,Austria,2016,7,0,7
FJI,Fiji,AUT,Austria,2017,1,3,-2
FJI,Fiji,BEL,Belgium,2008,2,0,2
FJI,Fiji,BEL,Belgium,2009,3,0,3
FJI,Fiji,BEL,Belgium,2010,3,0,3
FJI,Fiji,BEL,Belgium,2012,3,0,3
FJI,Fiji,BEL,Belgium,2013,3,4,-1
FJI,Fiji,BEL,Belgium,2014,1,1,0
FJI,Fiji,BEL,Belgium,2015,4,3,1
FJI,Fiji,BEL,Belgium,2016,2,5,-3
FJI,Fiji,BEL,Belgium,2017,2,0,2
FJI,Fiji,CAN,Canada,2008,321,0,321
FJI,Fiji,CAN,Canada,2009,311,0,311
FJI,Fiji,CAN,Canada,2010,398,0,398
FJI,Fiji,CAN,Canada,2011,316,0,316
FJI,Fiji,CAN,Canada,2012,270,0,270
FJI,Fiji,CAN,Canada,2013,228,0,228
FJI,Fiji,CAN,Canada,2014,254,0,254
FJI,Fiji,CAN,Canada,2015,222,0,222
FJI,Fiji,CAN,Canada,2016,190,0,190
FJI,Fiji,CAN,Canada,2017,155,0,155
FJI,Fiji,CZE,Czech Republic,2009,1,0,1
FJI,Fiji,CZE,Czech Republic,2012,1,0,1
FJI,Fiji,CZE,Czech Republic,2014,1,0,1
FJI,Fiji,CZE,Czech Republic,2015,1,0,1
FJI,Fiji,DNK,Denmark,2008,0,0,0
FJI,Fiji,DNK,Denmark,2009,0,1,-1
FJI,Fiji,DNK,Denmark,2010,1,0,1
FJI,Fiji,DNK,Denmark,2012,0,0,0
FJI,Fiji,DNK,Denmark,2013,2,2,0
FJI,Fiji,DNK,Denmark,2014,1,2,-1
FJI,Fiji,DNK,Denmark,2015,4,0,4
FJI,Fiji,DNK,Denmark,2016,1,0,1
FJI,Fiji,DNK,Denmark,2017,3,0,3
FJI,Fiji,FIN,Finland,2008,0,0,0
FJI,Fiji,FIN,Finland,2009,0,0,0
FJI,Fiji,FIN,Finland,2010,0,0,0
FJI,Fiji,FIN,Finland,2011,0,0,0
FJI,Fiji,FIN,Finland,2012,0,0,0
FJI,Fiji,FIN,Finland,2013,0,0,0
FJI,Fiji,FIN,Finland,2014,1,0,1
FJI,Fiji,FIN,Finland,2015,1,0,1
FJI,Fiji,FIN,Finland,2016,0,0,0
FJI,Fiji,FIN,Finland,2017,0,0,0
FJI,Fiji,FRA,France,2008,13,0,13
FJI,Fiji,FRA,France,2009,27,0,27
FJI,Fiji,FRA,France,2010,24,0,24
FJI,Fiji,FRA,France,2011,27,0,27
FJI,Fiji,FRA,France,2012,15,0,15
FJI,Fiji,FRA,France,2013,18,0,18
FJI,Fiji,FRA,France,2014,34,0,34
FJI,Fiji,FRA,France,2015,47,0,47
FJI,Fiji,FRA,France,2016,45,0,45
FJI,Fiji,FRA,France,2017,31,0,31
FJI,Fiji,DEU,Germany,2008,14,10,4
FJI,Fiji,DEU,Germany,2009,30,12,18
FJI,Fiji,DEU,Germany,2010,28,27,1
FJI,Fiji,DEU,Germany,2011,32,10,22
FJI,Fiji,DEU,Germany,2012,23,10,13
FJI,Fiji,DEU,Germany,2013,21,20,1
FJI,Fiji,DEU,Germany,2014,19,16,3
FJI,Fiji,DEU,Germany,2015,22,40,-18
FJI,Fiji,DEU,Germany,2016,12,10,2
FJI,Fiji,DEU,Germany,2017,6,8,-2
FJI,Fiji,HUN,Hungary,2008,1,0,1
FJI,Fiji,HUN,Hungary,2009,0,0,0
FJI,Fiji,HUN,Hungary,2010,0,0,0
FJI,Fiji,HUN,Hungary,2011,0,0,0
FJI,Fiji,HUN,Hungary,2012,0,0,0
FJI,Fiji,HUN,Hungary,2013,0,0,0
FJI,Fiji,HUN,Hungary,2014,1,0,1
FJI,Fiji,HUN,Hungary,2015,1,0,1
FJI,Fiji,HUN,Hungary,2016,1,0,1
FJI,Fiji,HUN,Hungary,2017,0,0,0
FJI,Fiji,ISL,Iceland,2008,0,0,0
FJI,Fiji,ISL,Iceland,2009,2,1,1
FJI,Fiji,ISL,Iceland,2010,0,1,-1
FJI,Fiji,ISL,Iceland,2011,0,0,0
FJI,Fiji,ISL,Iceland,2012,0,0,0
FJI,Fiji,ISL,Iceland,2013,0,0,0
FJI,Fiji,ISL,Iceland,2014,0,0,0
FJI,Fiji,ISL,Iceland,2015,0,0,0
FJI,Fiji,ISL,Iceland,2016,0,0,0
FJI,Fiji,ISL,Iceland,2017,0,0,0
FJI,Fiji,ITA,Italy,2008,3,0,3
FJI,Fiji,ITA,Italy,2009,1,0,1
FJI,Fiji,ITA,Italy,2010,4,3,1
FJI,Fiji,ITA,Italy,2011,4,1,3
FJI,Fiji,ITA,Italy,2012,0,0,0
FJI,Fiji,ITA,Italy,2013,8,0,8
FJI,Fiji,ITA,Italy,2014,2,2,0
FJI,Fiji,ITA,Italy,2015,0,0,0
FJI,Fiji,ITA,Italy,2016,1,0,1
FJI,Fiji,JPN,Japan,2008,104,90,14
FJI,Fiji,JPN,Japan,2009,122,100,22
FJI,Fiji,JPN,Japan,2010,111,98,13
FJI,Fiji,JPN,Japan,2011,129,108,21
FJI,Fiji,JPN,Japan,2012,154,155,-1
FJI,Fiji,JPN,Japan,2013,141,113,28
FJI,Fiji,JPN,Japan,2014,152,141,11
FJI,Fiji,JPN,Japan,2015,167,159,8
FJI,Fiji,JPN,Japan,2016,185,154,31
FJI,Fiji,JPN,Japan,2017,198,167,31
FJI,Fiji,KOR,Korea,2008,17,13,4
FJI,Fiji,KOR,Korea,2009,21,11,10
FJI,Fiji,KOR,Korea,2010,32,11,21
FJI,Fiji,KOR,Korea,2011,22,17,5
FJI,Fiji,KOR,Korea,2012,28,32,-4
FJI,Fiji,KOR,Korea,2013,24,21,3
FJI,Fiji,KOR,Korea,2014,19,12,7
FJI,Fiji,KOR,Korea,2015,16,17,-1
FJI,Fiji,KOR,Korea,2016,15,15,0
FJI,Fiji,KOR,Korea,2017,26,23,3
FJI,Fiji,LUX,Luxembourg,2008,0,0,0
FJI,Fiji,LUX,Luxembourg,2009,0,0,0
FJI,Fiji,LUX,Luxembourg,2010,0,0,0
FJI,Fiji,LUX,Luxembourg,2011,0,0,0
FJI,Fiji,LUX,Luxembourg,2012,0,0,0
FJI,Fiji,LUX,Luxembourg,2013,0,0,0
FJI,Fiji,LUX,Luxembourg,2014,0,0,0
FJI,Fiji,LUX,Luxembourg,2015,0,0,0
FJI,Fiji,LUX,Luxembourg,2016,0,0,0
FJI,Fiji,LUX,Luxembourg,2017,0,0,0
FJI,Fiji,MEX,Mexico,2012,0,0,0
FJI,Fiji,MEX,Mexico,2013,0,0,0
FJI,Fiji,MEX,Mexico,2014,0,0,0
FJI,Fiji,MEX,Mexico,2015,1,0,1
FJI,Fiji,MEX,Mexico,2016,2,0,2
FJI,Fiji,MEX,Mexico,2017,1,0,1
FJI,Fiji,NLD,Netherlands,2008,2,2,0
FJI,Fiji,NLD,Netherlands,2009,1,-1,2
FJI,Fiji,NLD,Netherlands,2011,1,0,1
FJI,Fiji,NLD,Netherlands,2012,8,4,4
FJI,Fiji,NLD,Netherlands,2013,1,1,0
FJI,Fiji,NLD,Netherlands,2014,3,2,1
FJI,Fiji,NLD,Netherlands,2015,3,2,1
FJI,Fiji,NLD,Netherlands,2016,3,2,1
FJI,Fiji,NLD,Netherlands,2017,0,-4,4
FJI,Fiji,NZL,New Zealand,2008,3059,315,2744
FJI,Fiji,NZL,New Zealand,2009,2717,576,2141
FJI,Fiji,NZL,New Zealand,2010,1290,724,566
FJI,Fiji,NZL,New Zealand,2011,1057,607,450
FJI,Fiji,NZL,New Zealand,2012,1206,470,736
FJI,Fiji,NZL,New Zealand,2013,1198,392,806
FJI,Fiji,NZL,New Zealand,2014,1345,332,1013
FJI,Fiji,NZL,New Zealand,2015,1407,339,1068
FJI,Fiji,NZL,New Zealand,2016,1903,292,1611
FJI,Fiji,NZL,New Zealand,2017,1685,355,1330
FJI,Fiji,NOR,Norway,2008,7,0,7
FJI,Fiji,NOR,Norway,2009,1,0,1
FJI,Fiji,NOR,Norway,2010,1,2,-1
FJI,Fiji,NOR,Norway,2011,0,1,-1
FJI,Fiji,NOR,Norway,2012,2,0,2
FJI,Fiji,NOR,Norway,2013,1,1,0
FJI,Fiji,NOR,Norway,2014,0,1,-1
FJI,Fiji,NOR,Norway,2015,1,0,1
FJI,Fiji,NOR,Norway,2016,0,1,-1
FJI,Fiji,NOR,Norway,2017,0,0,0
FJI,Fiji,POL,Poland,2009,0,0,0
FJI,Fiji,POL,Poland,2010,0,0,0
FJI,Fiji,POL,Poland,2011,0,0,0
FJI,Fiji,POL,Poland,2012,0,0,0
FJI,Fiji,POL,Poland,2013,0,0,0
FJI,Fiji,POL,Poland,2014,0,0,0
FJI,Fiji,POL,Poland,2015,0,0,0
FJI,Fiji,POL,Poland,2016,1,0,1
FJI,Fiji,POL,Poland,2017,1,0,1
FJI,Fiji,SVK,Slovak Republic,2008,0,0,0
FJI,Fiji,ESP,Spain,2008,6,0,6
FJI,Fiji,ESP,Spain,2009,0,2,-2
FJI,Fiji,ESP,Spain,2010,0,3,-3
FJI,Fiji,ESP,Spain,2011,0,0,0
FJI,Fiji,ESP,Spain,2012,1,0,1
FJI,Fiji,ESP,Spain,2013,0,0,0
FJI,Fiji,ESP,Spain,2014,0,0,0
FJI,Fiji,ESP,Spain,2015,2,1,1
FJI,Fiji,ESP,Spain,2016,3,0,3
FJI,Fiji,ESP,Spain,2017,3,0,3
FJI,Fiji,SWE,Sweden,2008,2,0,2
FJI,Fiji,SWE,Sweden,2009,5,0,5
FJI,Fiji,SWE,Sweden,2010,2,0,2
FJI,Fiji,SWE,Sweden,2011,1,0,1
FJI,Fiji,SWE,Sweden,2012,0,0,0
FJI,Fiji,SWE,Sweden,2013,1,0,1
FJI,Fiji,SWE,Sweden,2014,1,1,0
FJI,Fiji,SWE,Sweden,2015,1,2,-1
FJI,Fiji,SWE,Sweden,2016,3,0,3
FJI,Fiji,SWE,Sweden,2017,0,0,0
FJI,Fiji,CHE,Switzerland,2010,2,0,2
FJI,Fiji,CHE,Switzerland,2011,2,3,-1
FJI,Fiji,CHE,Switzerland,2012,5,1,4
FJI,Fiji,CHE,Switzerland,2013,5,1,4
FJI,Fiji,CHE,Switzerland,2014,1,1,0
FJI,Fiji,CHE,Switzerland,2015,2,0,2
FJI,Fiji,CHE,Switzerland,2016,4,3,1
FJI,Fiji,CHE,Switzerland,2017,6,3,3
FJI,Fiji,USA,United States,2008,1176,0,1176
FJI,Fiji,USA,United States,2009,1194,0,1194
FJI,Fiji,USA,United States,2010,1201,0,1201
FJI,Fiji,USA,United States,2011,1041,0,1041
FJI,Fiji,USA,United States,2012,853,0,853
FJI,Fiji,USA,United States,2013,895,0,895
FJI,Fiji,USA,United States,2014,802,0,802
FJI,Fiji,USA,United States,2015,875,0,875
FJI,Fiji,USA,United States,2016,866,0,866
FJI,Fiji,USA,United States,2017,805,0,805
FJI,Fiji,CHL,Chile,2008,0,0,0
FJI,Fiji,CHL,Chile,2009,2,0,2
FJI,Fiji,CHL,Chile,2010,0,0,0
FJI,Fiji,CHL,Chile,2011,0,0,0
FJI,Fiji,CHL,Chile,2012,0,0,0
FJI,Fiji,CHL,Chile,2013,0,0,0
FJI,Fiji,CHL,Chile,2014,0,0,0
FJI,Fiji,CHL,Chile,2015,1,0,1
FJI,Fiji,CHL,Chile,2016,0,0,0
FJI,Fiji,EST,Estonia,2008,0,0,0
FJI,Fiji,EST,Estonia,2009,0,0,0
FJI,Fiji,EST,Estonia,2010,0,0,0
FJI,Fiji,EST,Estonia,2011,0,0,0
FJI,Fiji,EST,Estonia,2012,0,0,0
FJI,Fiji,EST,Estonia,2013,0,0,0
FJI,Fiji,EST,Estonia,2014,0,0,0
FJI,Fiji,EST,Estonia,2015,0,0,0
FJI,Fiji,EST,Estonia,2016,0,0,0
FJI,Fiji,EST,Estonia,2017,0,0,0
FJI,Fiji,SVN,Slovenia,2013,7,0,7
FIN,Finland,AUS,Australia,2008,133,78,55
FIN,Finland,AUS,Australia,2009,122,61,61
FIN,Finland,AUS,Australia,2010,136,51,85
FIN,Finland,AUS,Australia,2011,129,41,88
FIN,Finland,AUS,Australia,2012,166,55,111
FIN,Finland,AUS,Australia,2013,156,61,95
FIN,Finland,AUS,Australia,2014,153,75,78
FIN,Finland,AUS,Australia,2015,145,58,87
FIN,Finland,AUS,Australia,2016,133,76,57
FIN,Finland,AUS,Australia,2017,157,71,86
FIN,Finland,AUT,Austria,2008,275,39,236
FIN,Finland,AUT,Austria,2009,265,32,233
FIN,Finland,AUT,Austria,2010,311,33,278
FIN,Finland,AUT,Austria,2011,303,29,274
FIN,Finland,AUT,Austria,2012,328,39,289
FIN,Finland,AUT,Austria,2013,349,26,323
FIN,Finland,AUT,Austria,2014,365,32,333
FIN,Finland,AUT,Austria,2015,364,30,334
FIN,Finland,AUT,Austria,2016,380,55,325
FIN,Finland,AUT,Austria,2017,386,41,345
FIN,Finland,BEL,Belgium,2008,456,43,413
FIN,Finland,BEL,Belgium,2009,404,32,372
FIN,Finland,BEL,Belgium,2010,396,24,372
FIN,Finland,BEL,Belgium,2011,361,43,318
FIN,Finland,BEL,Belgium,2012,335,41,294
FIN,Finland,BEL,Belgium,2013,370,40,330
FIN,Finland,BEL,Belgium,2014,243,34,209
FIN,Finland,BEL,Belgium,2015,239,56,183
FIN,Finland,BEL,Belgium,2016,275,42,233
FIN,Finland,BEL,Belgium,2017,306,41,265
FIN,Finland,CAN,Canada,2008,89,75,14
FIN,Finland,CAN,Canada,2009,63,57,6
FIN,Finland,CAN,Canada,2010,63,59,4
FIN,Finland,CAN,Canada,2011,72,72,0
FIN,Finland,CAN,Canada,2012,62,62,0
FIN,Finland,CAN,Canada,2013,76,81,-5
FIN,Finland,CAN,Canada,2014,68,63,5
FIN,Finland,CAN,Canada,2015,83,76,7
FIN,Finland,CAN,Canada,2016,80,59,21
FIN,Finland,CAN,Canada,2017,105,74,31
FIN,Finland,CZE,Czech Republic,2008,39,41,-2
FIN,Finland,CZE,Czech Republic,2009,18,50,-32
FIN,Finland,CZE,Czech Republic,2010,27,45,-18
FIN,Finland,CZE,Czech Republic,2011,14,47,-33
FIN,Finland,CZE,Czech Republic,2012,24,62,-38
FIN,Finland,CZE,Czech Republic,2013,22,51,-29
FIN,Finland,CZE,Czech Republic,2014,34,70,-36
FIN,Finland,CZE,Czech Republic,2015,24,69,-45
FIN,Finland,CZE,Czech Republic,2016,39,69,-30
FIN,Finland,CZE,Czech Republic,2017,36,71,-35
FIN,Finland,DNK,Denmark,2008,286,76,210
FIN,Finland,DNK,Denmark,2009,197,42,155
FIN,Finland,DNK,Denmark,2010,192,62,130
FIN,Finland,DNK,Denmark,2011,226,52,174
FIN,Finland,DNK,Denmark,2012,242,46,196
FIN,Finland,DNK,Denmark,2013,247,54,193
FIN,Finland,DNK,Denmark,2014,294,69,225
FIN,Finland,DNK,Denmark,2015,377,67,310
FIN,Finland,DNK,Denmark,2016,374,72,302
FIN,Finland,DNK,Denmark,2017,469,75,394
FIN,Finland,FIN,Finland,2008,0,0,0
FIN,Finland,FIN,Finland,2009,0,0,0
FIN,Finland,FIN,Finland,2010,0,0,0
FIN,Finland,FIN,Finland,2011,0,0,0
FIN,Finland,FIN,Finland,2012,0,0,0
FIN,Finland,FIN,Finland,2013,0,0,0
FIN,Finland,FIN,Finland,2014,0,0,0
FIN,Finland,FIN,Finland,2015,0,0,0
FIN,Finland,FIN,Finland,2016,0,0,0
FIN,Finland,FIN,Finland,2017,0,0,0
FIN,Finland,FRA,France,2008,0,223,-223
FIN,Finland,FRA,France,2009,0,172,-172
FIN,Finland,FRA,France,2010,0,175,-175
FIN,Finland,FRA,France,2011,0,176,-176
FIN,Finland,FRA,France,2012,0,190,-190
FIN,Finland,FRA,France,2013,450,203,247
FIN,Finland,FRA,France,2014,278,260,18
FIN,Finland,FRA,France,2015,272,226,46
FIN,Finland,FRA,France,2016,288,255,33
FIN,Finland,FRA,France,2017,154,238,-84
FIN,Finland,DEU,Germany,2008,1836,447,1389
FIN,Finland,DEU,Germany,2009,1847,347,1500
FIN,Finland,DEU,Germany,2010,1901,296,1605
FIN,Finland,DEU,Germany,2011,2158,307,1851
FIN,Finland,DEU,Germany,2012,2190,303,1887
FIN,Finland,DEU,Germany,2013,2212,299,1913
FIN,Finland,DEU,Germany,2014,2268,294,1974
FIN,Finland,DEU,Germany,2015,2241,301,1940
FIN,Finland,DEU,Germany,2016,2195,318,1877
FIN,Finland,DEU,Germany,2017,2136,284,1852
FIN,Finland,HUN,Hungary,2008,73,325,-252
FIN,Finland,HUN,Hungary,2009,56,182,-126
FIN,Finland,HUN,Hungary,2010,63,171,-108
FIN,Finland,HUN,Hungary,2011,56,277,-221
FIN,Finland,HUN,Hungary,2012,62,251,-189
FIN,Finland,HUN,Hungary,2013,65,247,-182
FIN,Finland,HUN,Hungary,2014,65,184,-119
FIN,Finland,HUN,Hungary,2015,97,196,-99
FIN,Finland,HUN,Hungary,2016,74,151,-77
FIN,Finland,HUN,Hungary,2017,80,130,-50
FIN,Finland,ISL,Iceland,2008,36,20,16
FIN,Finland,ISL,Iceland,2009,37,29,8
FIN,Finland,ISL,Iceland,2010,31,15,16
FIN,Finland,ISL,Iceland,2011,31,11,20
FIN,Finland,ISL,Iceland,2012,23,10,13
FIN,Finland,ISL,Iceland,2013,30,11,19
FIN,Finland,ISL,Iceland,2014,40,18,22
FIN,Finland,ISL,Iceland,2015,34,16,18
FIN,Finland,ISL,Iceland,2016,48,21,27
FIN,Finland,ISL,Iceland,2017,50,21,29
FIN,Finland,ITA,Italy,2008,198,199,-1
FIN,Finland,ITA,Italy,2009,169,144,25
FIN,Finland,ITA,Italy,2010,122,157,-35
FIN,Finland,ITA,Italy,2011,117,161,-44
FIN,Finland,ITA,Italy,2012,111,218,-107
FIN,Finland,ITA,Italy,2013,104,199,-95
FIN,Finland,ITA,Italy,2014,87,310,-223
FIN,Finland,ITA,Italy,2015,101,308,-207
FIN,Finland,ITA,Italy,2016,97,272,-175
FIN,Finland,ITA,Italy,2017,97,266,-169
FIN,Finland,JPN,Japan,2008,407,152,255
FIN,Finland,JPN,Japan,2009,413,140,273
FIN,Finland,JPN,Japan,2010,529,94,435
FIN,Finland,JPN,Japan,2011,443,115,328
FIN,Finland,JPN,Japan,2012,427,110,317
FIN,Finland,JPN,Japan,2013,506,116,390
FIN,Finland,JPN,Japan,2014,492,108,384
FIN,Finland,JPN,Japan,2015,715,90,625
FIN,Finland,JPN,Japan,2016,703,132,571
FIN,Finland,JPN,Japan,2017,802,158,644
FIN,Finland,KOR,Korea,2008,88,55,33
FIN,Finland,KOR,Korea,2009,89,58,31
FIN,Finland,KOR,Korea,2010,149,55,94
FIN,Finland,KOR,Korea,2011,152,95,57
FIN,Finland,KOR,Korea,2012,158,65,93
FIN,Finland,KOR,Korea,2013,171,64,107
FIN,Finland,KOR,Korea,2014,181,68,113
FIN,Finland,KOR,Korea,2015,180,69,111
FIN,Finland,KOR,Korea,2016,205,105,100
FIN,Finland,KOR,Korea,2017,169,100,69
FIN,Finland,LUX,Luxembourg,2008,86,1,85
FIN,Finland,LUX,Luxembourg,2009,61,0,61
FIN,Finland,LUX,Luxembourg,2010,82,1,81
FIN,Finland,LUX,Luxembourg,2011,126,2,124
FIN,Finland,LUX,Luxembourg,2012,61,1,60
FIN,Finland,LUX,Luxembourg,2013,75,0,75
FIN,Finland,LUX,Luxembourg,2014,99,0,99
FIN,Finland,LUX,Luxembourg,2015,118,2,116
FIN,Finland,LUX,Luxembourg,2016,111,2,109
FIN,Finland,LUX,Luxembourg,2017,94,0,94
FIN,Finland,MEX,Mexico,2008,9,53,-44
FIN,Finland,MEX,Mexico,2009,18,58,-40
FIN,Finland,MEX,Mexico,2010,12,53,-41
FIN,Finland,MEX,Mexico,2011,23,78,-55
FIN,Finland,MEX,Mexico,2012,11,69,-58
FIN,Finland,MEX,Mexico,2013,37,62,-25
FIN,Finland,MEX,Mexico,2014,24,65,-41
FIN,Finland,MEX,Mexico,2015,25,75,-50
FIN,Finland,MEX,Mexico,2016,18,75,-57
FIN,Finland,MEX,Mexico,2017,15,80,-65
FIN,Finland,NLD,Netherlands,2008,471,124,347
FIN,Finland,NLD,Netherlands,2009,475,73,402
FIN,Finland,NLD,Netherlands,2010,541,83,458
FIN,Finland,NLD,Netherlands,2011,651,80,571
FIN,Finland,NLD,Netherlands,2012,665,91,574
FIN,Finland,NLD,Netherlands,2013,592,74,518
FIN,Finland,NLD,Netherlands,2014,688,112,576
FIN,Finland,NLD,Netherlands,2015,832,109,723
FIN,Finland,NLD,Netherlands,2016,1044,104,940
FIN,Finland,NLD,Netherlands,2017,1117,103,1014
FIN,Finland,NZL,New Zealand,2008,110,16,94
FIN,Finland,NZL,New Zealand,2009,106,15,91
FIN,Finland,NZL,New Zealand,2010,111,7,104
FIN,Finland,NZL,New Zealand,2011,114,17,97
FIN,Finland,NZL,New Zealand,2012,107,8,99
FIN,Finland,NZL,New Zealand,2013,112,12,100
FIN,Finland,NZL,New Zealand,2014,100,16,84
FIN,Finland,NZL,New Zealand,2015,126,24,102
FIN,Finland,NZL,New Zealand,2016,190,15,175
FIN,Finland,NZL,New Zealand,2017,221,15,206
FIN,Finland,NOR,Norway,2008,718,55,663
FIN,Finland,NOR,Norway,2009,565,71,494
FIN,Finland,NOR,Norway,2010,558,65,493
FIN,Finland,NOR,Norway,2011,546,67,479
FIN,Finland,NOR,Norway,2012,474,55,419
FIN,Finland,NOR,Norway,2013,517,70,447
FIN,Finland,NOR,Norway,2014,578,51,527
FIN,Finland,NOR,Norway,2015,528,80,448
FIN,Finland,NOR,Norway,2016,467,78,389
FIN,Finland,NOR,Norway,2017,429,94,335
FIN,Finland,POL,Poland,2008,126,562,-436
FIN,Finland,POL,Poland,2009,53,321,-268
FIN,Finland,POL,Poland,2010,60,250,-190
FIN,Finland,POL,Poland,2011,89,325,-236
FIN,Finland,POL,Poland,2012,81,538,-457
FIN,Finland,POL,Poland,2013,111,506,-395
FIN,Finland,POL,Poland,2014,111,513,-402
FIN,Finland,POL,Poland,2015,135,395,-260
FIN,Finland,POL,Poland,2016,136,432,-296
FIN,Finland,POL,Poland,2017,91,355,-264
FIN,Finland,SVK,Slovak Republic,2008,16,71,-55
FIN,Finland,SVK,Slovak Republic,2009,11,40,-29
FIN,Finland,SVK,Slovak Republic,2010,22,19,3
FIN,Finland,SVK,Slovak Republic,2011,10,37,-27
FIN,Finland,SVK,Slovak Republic,2012,10,44,-34
FIN,Finland,SVK,Slovak Republic,2013,8,41,-33
FIN,Finland,SVK,Slovak Republic,2014,3,51,-48
FIN,Finland,SVK,Slovak Republic,2015,12,57,-45
FIN,Finland,SVK,Slovak Republic,2016,10,91,-81
FIN,Finland,SVK,Slovak Republic,2017,7,54,-47
FIN,Finland,ESP,Spain,2008,707,208,499
FIN,Finland,ESP,Spain,2009,670,126,544
FIN,Finland,ESP,Spain,2010,931,143,788
FIN,Finland,ESP,Spain,2011,967,183,784
FIN,Finland,ESP,Spain,2012,912,258,654
FIN,Finland,ESP,Spain,2013,868,396,472
FIN,Finland,ESP,Spain,2014,881,445,436
FIN,Finland,ESP,Spain,2015,855,284,571
FIN,Finland,ESP,Spain,2016,910,269,641
FIN,Finland,ESP,Spain,2017,1077,243,834
FIN,Finland,SWE,Sweden,2008,2405,884,1521
FIN,Finland,SWE,Sweden,2009,2398,836,1562
FIN,Finland,SWE,Sweden,2010,2300,671,1629
FIN,Finland,SWE,Sweden,2011,2331,674,1657
FIN,Finland,SWE,Sweden,2012,2329,593,1736
FIN,Finland,SWE,Sweden,2013,2306,624,1682
FIN,Finland,SWE,Sweden,2014,2635,604,2031
FIN,Finland,SWE,Sweden,2015,2811,547,2264
FIN,Finland,SWE,Sweden,2016,3047,579,2468
FIN,Finland,SWE,Sweden,2017,2885,584,2301
FIN,Finland,CHE,Switzerland,2008,570,47,523
FIN,Finland,CHE,Switzerland,2009,491,32,459
FIN,Finland,CHE,Switzerland,2010,469,38,431
FIN,Finland,CHE,Switzerland,2011,490,35,455
FIN,Finland,CHE,Switzerland,2012,377,53,324
FIN,Finland,CHE,Switzerland,2013,418,25,393
FIN,Finland,CHE,Switzerland,2014,461,40,421
FIN,Finland,CHE,Switzerland,2015,405,41,364
FIN,Finland,CHE,Switzerland,2016,394,47,347
FIN,Finland,CHE,Switzerland,2017,390,37,353
FIN,Finland,TUR,Turkey,2010,28,277,-249
FIN,Finland,TUR,Turkey,2016,138,311,-173
FIN,Finland,TUR,Turkey,2017,186,325,-139
FIN,Finland,GBR,United Kingdom,2011,1000,344,656
FIN,Finland,GBR,United Kingdom,2012,2000,385,1615
FIN,Finland,GBR,United Kingdom,2013,1000,354,646
FIN,Finland,GBR,United Kingdom,2014,2000,421,1579
FIN,Finland,GBR,United Kingdom,2015,2000,343,1657
FIN,Finland,USA,United States,2008,302,301,1
FIN,Finland,USA,United States,2009,423,278,145
FIN,Finland,USA,United States,2010,397,290,107
FIN,Finland,USA,United States,2011,363,316,47
FIN,Finland,USA,United States,2012,348,287,61
FIN,Finland,USA,United States,2013,331,311,20
FIN,Finland,USA,United States,2014,350,371,-21
FIN,Finland,USA,United States,2015,407,352,55
FIN,Finland,USA,United States,2016,489,381,108
FIN,Finland,USA,United States,2017,439,375,64
FIN,Finland,CHL,Chile,2008,20,22,-2
FIN,Finland,CHL,Chile,2009,22,28,-6
FIN,Finland,CHL,Chile,2010,26,23,3
FIN,Finland,CHL,Chile,2011,23,22,1
FIN,Finland,CHL,Chile,2012,32,18,14
FIN,Finland,CHL,Chile,2013,41,21,20
FIN,Finland,CHL,Chile,2014,42,14,28
FIN,Finland,CHL,Chile,2015,15,30,-15
FIN,Finland,CHL,Chile,2016,19,20,-1
FIN,Finland,EST,Estonia,2008,303,3038,-2735
FIN,Finland,EST,Estonia,2009,314,3176,-2862
FIN,Finland,EST,Estonia,2010,162,3909,-3747
FIN,Finland,EST,Estonia,2011,18,4704,-4686
FIN,Finland,EST,Estonia,2012,22,6041,-6019
FIN,Finland,EST,Estonia,2013,34,5856,-5822
FIN,Finland,EST,Estonia,2014,23,4663,-4640
FIN,Finland,EST,Estonia,2015,899,3355,-2456
FIN,Finland,EST,Estonia,2016,899,2596,-1697
FIN,Finland,EST,Estonia,2017,938,2176,-1238
FIN,Finland,SVN,Slovenia,2008,38,19,19
FIN,Finland,SVN,Slovenia,2009,3,16,-13
FIN,Finland,SVN,Slovenia,2011,45,11,34
FIN,Finland,SVN,Slovenia,2012,38,5,33
FIN,Finland,SVN,Slovenia,2013,59,13,46
FIN,Finland,SVN,Slovenia,2014,40,20,20
FIN,Finland,SVN,Slovenia,2015,45,19,26
FIN,Finland,SVN,Slovenia,2016,66,28,38
FIN,Finland,SVN,Slovenia,2017,54,18,36
FRA,France,AUS,Australia,2008,848,409,439
FRA,France,AUS,Australia,2009,1041,458,583
FRA,France,AUS,Australia,2010,1167,394,773
FRA,France,AUS,Australia,2011,1241,497,744
FRA,France,AUS,Australia,2012,1393,496,897
FRA,France,AUS,Australia,2013,1512,429,1083
FRA,France,AUS,Australia,2014,1661,464,1197
FRA,France,AUS,Australia,2015,1616,553,1063
FRA,France,AUS,Australia,2016,1620,567,1053
FRA,France,AUS,Australia,2017,1654,621,1033
FRA,France,AUT,Austria,2008,960,0,960
FRA,France,AUT,Austria,2009,867,0,867
FRA,France,AUT,Austria,2010,880,0,880
FRA,France,AUT,Austria,2011,917,0,917
FRA,France,AUT,Austria,2012,1144,0,1144
FRA,France,AUT,Austria,2013,1156,353,803
FRA,France,AUT,Austria,2014,1196,410,786
FRA,France,AUT,Austria,2015,1199,414,785
FRA,France,AUT,Austria,2016,1318,307,1011
FRA,France,AUT,Austria,2017,1350,371,979
FRA,France,BEL,Belgium,2008,14086,0,14086
FRA,France,BEL,Belgium,2009,12272,0,12272
FRA,France,BEL,Belgium,2010,13500,0,13500
FRA,France,BEL,Belgium,2011,13847,0,13847
FRA,France,BEL,Belgium,2012,13338,0,13338
FRA,France,BEL,Belgium,2013,13603,6642,6961
FRA,France,BEL,Belgium,2014,11969,6493,5476
FRA,France,BEL,Belgium,2015,11977,6429,5548
FRA,France,BEL,Belgium,2016,11073,6701,4372
FRA,France,BEL,Belgium,2017,11183,6552,4631
FRA,France,CAN,Canada,2008,4532,1167,3365
FRA,France,CAN,Canada,2009,5051,1068,3983
FRA,France,CAN,Canada,2010,4646,1085,3561
FRA,France,CAN,Canada,2011,4080,1089,2991
FRA,France,CAN,Canada,2012,6270,1085,5185
FRA,France,CAN,Canada,2013,5623,1058,4565
FRA,France,CAN,Canada,2014,4716,1108,3608
FRA,France,CAN,Canada,2015,5807,1327,4480
FRA,France,CAN,Canada,2016,6350,1240,5110
FRA,France,CAN,Canada,2017,6600,1178,5422
FRA,France,CZE,Czech Republic,2008,286,0,286
FRA,France,CZE,Czech Republic,2009,306,0,306
FRA,France,CZE,Czech Republic,2010,267,0,267
FRA,France,CZE,Czech Republic,2011,187,0,187
FRA,France,CZE,Czech Republic,2012,215,0,215
FRA,France,CZE,Czech Republic,2013,233,640,-407
FRA,France,CZE,Czech Republic,2014,273,525,-252
FRA,France,CZE,Czech Republic,2015,252,518,-266
FRA,France,CZE,Czech Republic,2016,285,406,-121
FRA,France,CZE,Czech Republic,2017,240,553,-313
FRA,France,DNK,Denmark,2008,630,0,630
FRA,France,DNK,Denmark,2009,583,0,583
FRA,France,DNK,Denmark,2010,665,0,665
FRA,France,DNK,Denmark,2011,696,0,696
FRA,France,DNK,Denmark,2012,673,0,673
FRA,France,DNK,Denmark,2013,735,344,391
FRA,France,DNK,Denmark,2014,746,254,492
FRA,France,DNK,Denmark,2015,840,352,488
FRA,France,DNK,Denmark,2016,868,294,574
FRA,France,DNK,Denmark,2017,840,255,585
FRA,France,FIN,Finland,2008,223,0,223
FRA,France,FIN,Finland,2009,172,0,172
FRA,France,FIN,Finland,2010,175,0,175
FRA,France,FIN,Finland,2011,176,0,176
FRA,France,FIN,Finland,2012,190,0,190
FRA,France,FIN,Finland,2013,203,450,-247
FRA,France,FIN,Finland,2014,260,278,-18
FRA,France,FIN,Finland,2015,226,272,-46
FRA,France,FIN,Finland,2016,255,288,-33
FRA,France,FIN,Finland,2017,238,154,84
FRA,France,FRA,France,2008,0,0,0
FRA,France,FRA,France,2009,0,0,0
FRA,France,FRA,France,2010,0,0,0
FRA,France,FRA,France,2011,0,0,0
FRA,France,FRA,France,2012,0,0,0
FRA,France,FRA,France,2013,0,0,0
FRA,France,FRA,France,2014,0,0,0
FRA,France,FRA,France,2015,0,0,0
FRA,France,FRA,France,2016,0,0,0
FRA,France,FRA,France,2017,0,0,0
FRA,France,DEU,Germany,2008,12979,0,12979
FRA,France,DEU,Germany,2009,12858,0,12858
FRA,France,DEU,Germany,2010,13349,0,13349
FRA,France,DEU,Germany,2011,13830,0,13830
FRA,France,DEU,Germany,2012,14458,0,14458
FRA,France,DEU,Germany,2013,15215,7738,7477
FRA,France,DEU,Germany,2014,15723,6420,9303
FRA,France,DEU,Germany,2015,14908,7119,7789
FRA,France,DEU,Germany,2016,15518,6190,9328
FRA,France,DEU,Germany,2017,14895,5683,9212
FRA,France,HUN,Hungary,2008,376,0,376
FRA,France,HUN,Hungary,2009,387,0,387
FRA,France,HUN,Hungary,2010,344,0,344
FRA,France,HUN,Hungary,2011,328,0,328
FRA,France,HUN,Hungary,2012,315,0,315
FRA,France,HUN,Hungary,2013,310,640,-330
FRA,France,HUN,Hungary,2014,397,849,-452
FRA,France,HUN,Hungary,2015,376,634,-258
FRA,France,HUN,Hungary,2016,378,686,-308
FRA,France,HUN,Hungary,2017,414,567,-153
FRA,France,ISL,Iceland,2008,102,0,102
FRA,France,ISL,Iceland,2009,71,0,71
FRA,France,ISL,Iceland,2010,105,0,105
FRA,France,ISL,Iceland,2011,53,0,53
FRA,France,ISL,Iceland,2012,47,0,47
FRA,France,ISL,Iceland,2013,107,0,107
FRA,France,ISL,Iceland,2014,132,0,132
FRA,France,ISL,Iceland,2015,134,1,133
FRA,France,ISL,Iceland,2016,151,0,151
FRA,France,ISL,Iceland,2017,200,0,200
FRA,France,ITA,Italy,2008,2497,0,2497
FRA,France,ITA,Italy,2009,2345,0,2345
FRA,France,ITA,Italy,2010,2012,0,2012
FRA,France,ITA,Italy,2011,1892,0,1892
FRA,France,ITA,Italy,2012,1896,0,1896
FRA,France,ITA,Italy,2013,1846,12171,-10325
FRA,France,ITA,Italy,2014,1729,12689,-10960
FRA,France,ITA,Italy,2015,1703,13247,-11544
FRA,France,ITA,Italy,2016,1777,13883,-12106
FRA,France,ITA,Italy,2017,1960,13578,-11618
FRA,France,JPN,Japan,2008,4537,1531,3006
FRA,France,JPN,Japan,2009,3931,1604,2327
FRA,France,JPN,Japan,2010,3984,1471,2513
FRA,France,JPN,Japan,2011,2911,1598,1313
FRA,France,JPN,Japan,2012,3955,1518,2437
FRA,France,JPN,Japan,2013,4481,1552,2929
FRA,France,JPN,Japan,2014,4532,1647,2885
FRA,France,JPN,Japan,2015,4990,1588,3402
FRA,France,JPN,Japan,2016,5556,1515,4041
FRA,France,JPN,Japan,2017,5527,1566,3961
FRA,France,KOR,Korea,2008,1044,526,518
FRA,France,KOR,Korea,2009,1009,485,524
FRA,France,KOR,Korea,2010,1160,493,667
FRA,France,KOR,Korea,2011,1295,557,738
FRA,France,KOR,Korea,2012,1367,541,826
FRA,France,KOR,Korea,2013,1735,540,1195
FRA,France,KOR,Korea,2014,1940,559,1381
FRA,France,KOR,Korea,2015,1821,517,1304
FRA,France,KOR,Korea,2016,1957,601,1356
FRA,France,KOR,Korea,2017,1971,614,1357
FRA,France,LUX,Luxembourg,2008,3201,0,3201
FRA,France,LUX,Luxembourg,2009,2730,0,2730
FRA,France,LUX,Luxembourg,2010,2909,0,2909
FRA,France,LUX,Luxembourg,2011,3227,0,3227
FRA,France,LUX,Luxembourg,2012,3523,0,3523
FRA,France,LUX,Luxembourg,2013,3501,554,2947
FRA,France,LUX,Luxembourg,2014,3897,663,3234
FRA,France,LUX,Luxembourg,2015,4119,916,3203
FRA,France,LUX,Luxembourg,2016,3962,1195,2767
FRA,France,LUX,Luxembourg,2017,4183,387,3796
FRA,France,MEX,Mexico,2008,357,618,-261
FRA,France,MEX,Mexico,2009,512,733,-221
FRA,France,MEX,Mexico,2010,565,787,-222
FRA,France,MEX,Mexico,2011,466,763,-297
FRA,France,MEX,Mexico,2012,379,714,-335
FRA,France,MEX,Mexico,2013,1432,724,708
FRA,France,MEX,Mexico,2014,1025,767,258
FRA,France,MEX,Mexico,2015,721,842,-121
FRA,France,MEX,Mexico,2016,673,882,-209
FRA,France,MEX,Mexico,2017,620,820,-200
FRA,France,NLD,Netherlands,2008,3029,0,3029
FRA,France,NLD,Netherlands,2009,2872,0,2872
FRA,France,NLD,Netherlands,2010,2928,0,2928
FRA,France,NLD,Netherlands,2011,2930,0,2930
FRA,France,NLD,Netherlands,2012,2980,0,2980
FRA,France,NLD,Netherlands,2013,3166,2678,488
FRA,France,NLD,Netherlands,2014,3644,2063,1581
FRA,France,NLD,Netherlands,2015,4038,2142,1896
FRA,France,NLD,Netherlands,2016,4522,1858,2664
FRA,France,NLD,Netherlands,2017,4981,1662,3319
FRA,France,NZL,New Zealand,2008,1075,122,953
FRA,France,NZL,New Zealand,2009,1422,118,1304
FRA,France,NZL,New Zealand,2010,1429,118,1311
FRA,France,NZL,New Zealand,2011,1860,130,1730
FRA,France,NZL,New Zealand,2012,1883,146,1737
FRA,France,NZL,New Zealand,2013,2718,128,2590
FRA,France,NZL,New Zealand,2014,3787,177,3610
FRA,France,NZL,New Zealand,2015,4481,172,4309
FRA,France,NZL,New Zealand,2016,5028,180,4848
FRA,France,NZL,New Zealand,2017,5263,184,5079
FRA,France,NOR,Norway,2008,750,0,750
FRA,France,NOR,Norway,2009,664,0,664
FRA,France,NOR,Norway,2010,819,0,819
FRA,France,NOR,Norway,2011,865,0,865
FRA,France,NOR,Norway,2012,731,0,731
FRA,France,NOR,Norway,2013,832,0,832
FRA,France,NOR,Norway,2014,831,0,831
FRA,France,NOR,Norway,2015,746,6,740
FRA,France,NOR,Norway,2016,641,14,627
FRA,France,NOR,Norway,2017,623,7,616
FRA,France,POL,Poland,2008,559,0,559
FRA,France,POL,Poland,2009,560,0,560
FRA,France,POL,Poland,2010,496,0,496
FRA,France,POL,Poland,2011,586,0,586
FRA,France,POL,Poland,2012,591,0,591
FRA,France,POL,Poland,2013,572,3474,-2902
FRA,France,POL,Poland,2014,572,3094,-2522
FRA,France,POL,Poland,2015,619,2831,-2212
FRA,France,POL,Poland,2016,588,2272,-1684
FRA,France,POL,Poland,2017,539,2381,-1842
FRA,France,PRT,Portugal,2008,732,0,732
FRA,France,PRT,Portugal,2009,718,0,718
FRA,France,PRT,Portugal,2010,696,0,696
FRA,France,PRT,Portugal,2011,666,0,666
FRA,France,PRT,Portugal,2012,537,0,537
FRA,France,PRT,Portugal,2013,703,18804,-18101
FRA,France,PRT,Portugal,2014,1930,14733,-12803
FRA,France,PRT,Portugal,2015,2495,11615,-9120
FRA,France,PRT,Portugal,2016,3475,12377,-8902
FRA,France,PRT,Portugal,2017,4662,8315,-3653
FRA,France,SVK,Slovak Republic,2008,154,0,154
FRA,France,SVK,Slovak Republic,2009,163,0,163
FRA,France,SVK,Slovak Republic,2010,118,0,118
FRA,France,SVK,Slovak Republic,2011,100,0,100
FRA,France,SVK,Slovak Republic,2012,51,0,51
FRA,France,SVK,Slovak Republic,2013,50,656,-606
FRA,France,SVK,Slovak Republic,2014,52,289,-237
FRA,France,SVK,Slovak Republic,2015,77,271,-194
FRA,France,SVK,Slovak Republic,2016,78,395,-317
FRA,France,SVK,Slovak Republic,2017,68,390,-322
FRA,France,ESP,Spain,2008,8898,0,8898
FRA,France,ESP,Spain,2009,7742,0,7742
FRA,France,ESP,Spain,2010,7788,0,7788
FRA,France,ESP,Spain,2011,7807,0,7807
FRA,France,ESP,Spain,2012,7431,0,7431
FRA,France,ESP,Spain,2013,7287,13665,-6378
FRA,France,ESP,Spain,2014,8095,12874,-4779
FRA,France,ESP,Spain,2015,9020,12363,-3343
FRA,France,ESP,Spain,2016,9338,10658,-1320
FRA,France,ESP,Spain,2017,11410,10849,561
FRA,France,SWE,Sweden,2008,957,0,957
FRA,France,SWE,Sweden,2009,847,0,847
FRA,France,SWE,Sweden,2010,723,0,723
FRA,France,SWE,Sweden,2011,852,0,852
FRA,France,SWE,Sweden,2012,737,0,737
FRA,France,SWE,Sweden,2013,823,568,255
FRA,France,SWE,Sweden,2014,846,587,259
FRA,France,SWE,Sweden,2015,1001,860,141
FRA,France,SWE,Sweden,2016,1060,728,332
FRA,France,SWE,Sweden,2017,1212,560,652
FRA,France,CHE,Switzerland,2008,13687,0,13687
FRA,France,CHE,Switzerland,2009,10897,0,10897
FRA,France,CHE,Switzerland,2010,11548,0,11548
FRA,France,CHE,Switzerland,2011,11463,0,11463
FRA,France,CHE,Switzerland,2012,11382,0,11382
FRA,France,CHE,Switzerland,2013,13463,0,13463
FRA,France,CHE,Switzerland,2014,13839,0,13839
FRA,France,CHE,Switzerland,2015,14767,22,14745
FRA,France,CHE,Switzerland,2016,13790,48,13742
FRA,France,CHE,Switzerland,2017,14070,31,14039
FRA,France,TUR,Turkey,2010,420,5695,-5275
FRA,France,TUR,Turkey,2016,866,4981,-4115
FRA,France,TUR,Turkey,2017,789,4929,-4140
FRA,France,GBR,United Kingdom,2009,14000,0,14000
FRA,France,GBR,United Kingdom,2010,11000,0,11000
FRA,France,GBR,United Kingdom,2011,17000,0,17000
FRA,France,GBR,United Kingdom,2012,14000,0,14000
FRA,France,GBR,United Kingdom,2013,15000,10448,4552
FRA,France,GBR,United Kingdom,2014,24000,9341,14659
FRA,France,GBR,United Kingdom,2015,15000,9760,5240
FRA,France,GBR,United Kingdom,2016,25000,11567,13433
FRA,France,GBR,United Kingdom,2017,14000,10001,3999
FRA,France,USA,United States,2008,4935,2806,2129
FRA,France,USA,United States,2009,4569,3464,1105
FRA,France,USA,United States,2010,3919,2954,965
FRA,France,USA,United States,2011,3653,3092,561
FRA,France,USA,United States,2012,3862,3082,780
FRA,France,USA,United States,2013,4425,3105,1320
FRA,France,USA,United States,2014,4284,3142,1142
FRA,France,USA,United States,2015,4693,4350,343
FRA,France,USA,United States,2016,5159,4541,618
FRA,France,USA,United States,2017,4782,4320,462
FRA,France,CHL,Chile,2008,400,294,106
FRA,France,CHL,Chile,2009,350,295,55
FRA,France,CHL,Chile,2010,476,288,188
FRA,France,CHL,Chile,2011,496,241,255
FRA,France,CHL,Chile,2012,608,274,334
FRA,France,CHL,Chile,2013,614,306,308
FRA,France,CHL,Chile,2014,644,295,349
FRA,France,CHL,Chile,2015,686,304,382
FRA,France,CHL,Chile,2016,586,299,287
FRA,France,EST,Estonia,2008,48,0,48
FRA,France,EST,Estonia,2009,58,0,58
FRA,France,EST,Estonia,2010,46,0,46
FRA,France,EST,Estonia,2011,1,0,1
FRA,France,EST,Estonia,2012,2,0,2
FRA,France,EST,Estonia,2013,7,160,-153
FRA,France,EST,Estonia,2014,1,99,-98
FRA,France,EST,Estonia,2015,185,114,71
FRA,France,EST,Estonia,2016,206,200,6
FRA,France,EST,Estonia,2017,270,58,212
FRA,France,ISR,Israel,2008,1563,151,1412
FRA,France,ISR,Israel,2009,1557,170,1387
FRA,France,ISR,Israel,2010,1775,147,1628
FRA,France,ISR,Israel,2011,1619,140,1479
FRA,France,ISR,Israel,2012,1653,155,1498
FRA,France,ISR,Israel,2013,2904,145,2759
FRA,France,ISR,Israel,2014,6547,153,6394
FRA,France,ISR,Israel,2015,6628,141,6487
FRA,France,ISR,Israel,2016,4239,156,4083
FRA,France,ISR,Israel,2017,3157,144,3013
FRA,France,SVN,Slovenia,2008,130,0,130
FRA,France,SVN,Slovenia,2009,117,0,117
FRA,France,SVN,Slovenia,2010,2,0,2
FRA,France,SVN,Slovenia,2011,117,0,117
FRA,France,SVN,Slovenia,2012,126,0,126
FRA,France,SVN,Slovenia,2013,221,231,-10
FRA,France,SVN,Slovenia,2014,151,127,24
FRA,France,SVN,Slovenia,2015,178,191,-13
FRA,France,SVN,Slovenia,2016,191,59,132
FRA,France,SVN,Slovenia,2017,178,124,54
GAB,Gabon,AUS,Australia,2008,6,0,6
GAB,Gabon,AUS,Australia,2009,0,0,0
GAB,Gabon,AUS,Australia,2010,0,0,0
GAB,Gabon,AUS,Australia,2011,0,0,0
GAB,Gabon,AUS,Australia,2012,0,0,0
GAB,Gabon,AUS,Australia,2013,1,0,1
GAB,Gabon,AUS,Australia,2014,0,0,0
GAB,Gabon,AUS,Australia,2015,0,0,0
GAB,Gabon,AUS,Australia,2017,3,0,3
GAB,Gabon,AUT,Austria,2008,1,0,1
GAB,Gabon,AUT,Austria,2009,8,4,4
GAB,Gabon,AUT,Austria,2010,8,4,4
GAB,Gabon,AUT,Austria,2011,7,3,4
GAB,Gabon,AUT,Austria,2012,6,3,3
GAB,Gabon,AUT,Austria,2013,5,2,3
GAB,Gabon,AUT,Austria,2014,5,3,2
GAB,Gabon,AUT,Austria,2015,9,8,1
GAB,Gabon,AUT,Austria,2016,9,2,7
GAB,Gabon,AUT,Austria,2017,2,5,-3
GAB,Gabon,BEL,Belgium,2008,39,0,39
GAB,Gabon,BEL,Belgium,2009,38,0,38
GAB,Gabon,BEL,Belgium,2010,27,33,-6
GAB,Gabon,BEL,Belgium,2012,26,20,6
GAB,Gabon,BEL,Belgium,2013,32,26,6
GAB,Gabon,BEL,Belgium,2014,33,21,12
GAB,Gabon,BEL,Belgium,2015,45,20,25
GAB,Gabon,BEL,Belgium,2016,50,9,41
GAB,Gabon,BEL,Belgium,2017,47,8,39
GAB,Gabon,CAN,Canada,2008,86,0,86
GAB,Gabon,CAN,Canada,2009,86,0,86
GAB,Gabon,CAN,Canada,2010,64,0,64
GAB,Gabon,CAN,Canada,2011,63,0,63
GAB,Gabon,CAN,Canada,2012,74,0,74
GAB,Gabon,CAN,Canada,2013,90,0,90
GAB,Gabon,CAN,Canada,2014,68,0,68
GAB,Gabon,CAN,Canada,2015,57,0,57
GAB,Gabon,CAN,Canada,2016,50,0,50
GAB,Gabon,CAN,Canada,2017,45,0,45
GAB,Gabon,CZE,Czech Republic,2012,1,0,1
GAB,Gabon,CZE,Czech Republic,2014,3,0,3
GAB,Gabon,DNK,Denmark,2008,2,1,1
GAB,Gabon,DNK,Denmark,2009,0,0,0
GAB,Gabon,DNK,Denmark,2010,2,1,1
GAB,Gabon,DNK,Denmark,2012,0,1,-1
GAB,Gabon,DNK,Denmark,2013,0,0,0
GAB,Gabon,DNK,Denmark,2014,1,0,1
GAB,Gabon,DNK,Denmark,2015,0,0,0
GAB,Gabon,DNK,Denmark,2016,0,0,0
GAB,Gabon,DNK,Denmark,2017,1,0,1
GAB,Gabon,FIN,Finland,2008,0,0,0
GAB,Gabon,FIN,Finland,2009,0,0,0
GAB,Gabon,FIN,Finland,2010,0,0,0
GAB,Gabon,FIN,Finland,2011,1,0,1
GAB,Gabon,FIN,Finland,2012,0,0,0
GAB,Gabon,FIN,Finland,2013,0,0,0
GAB,Gabon,FIN,Finland,2014,0,0,0
GAB,Gabon,FIN,Finland,2015,1,0,1
GAB,Gabon,FIN,Finland,2016,0,0,0
GAB,Gabon,FIN,Finland,2017,1,0,1
GAB,Gabon,FRA,France,2008,648,0,648
GAB,Gabon,FRA,France,2009,656,0,656
GAB,Gabon,FRA,France,2010,712,0,712
GAB,Gabon,FRA,France,2011,693,0,693
GAB,Gabon,FRA,France,2012,754,0,754
GAB,Gabon,FRA,France,2013,773,0,773
GAB,Gabon,FRA,France,2014,795,0,795
GAB,Gabon,FRA,France,2015,519,0,519
GAB,Gabon,FRA,France,2016,576,0,576
GAB,Gabon,FRA,France,2017,682,0,682
GAB,Gabon,DEU,Germany,2008,51,47,4
GAB,Gabon,DEU,Germany,2009,80,43,37
GAB,Gabon,DEU,Germany,2010,38,34,4
GAB,Gabon,DEU,Germany,2011,33,38,-5
GAB,Gabon,DEU,Germany,2012,32,42,-10
GAB,Gabon,DEU,Germany,2013,38,31,7
GAB,Gabon,DEU,Germany,2014,37,36,1
GAB,Gabon,DEU,Germany,2015,61,33,28
GAB,Gabon,DEU,Germany,2016,70,44,26
GAB,Gabon,DEU,Germany,2017,66,30,36
GAB,Gabon,HUN,Hungary,2008,1,0,1
GAB,Gabon,HUN,Hungary,2009,1,1,0
GAB,Gabon,HUN,Hungary,2010,0,1,-1
GAB,Gabon,HUN,Hungary,2011,2,0,2
GAB,Gabon,HUN,Hungary,2012,0,1,-1
GAB,Gabon,HUN,Hungary,2013,0,0,0
GAB,Gabon,HUN,Hungary,2014,6,0,6
GAB,Gabon,HUN,Hungary,2015,5,1,4
GAB,Gabon,HUN,Hungary,2016,2,0,2
GAB,Gabon,HUN,Hungary,2017,2,0,2
GAB,Gabon,ISL,Iceland,2008,0,0,0
GAB,Gabon,ISL,Iceland,2009,1,0,1
GAB,Gabon,ISL,Iceland,2010,0,0,0
GAB,Gabon,ISL,Iceland,2011,0,0,0
GAB,Gabon,ISL,Iceland,2012,1,0,1
GAB,Gabon,ISL,Iceland,2016,0,0,0
GAB,Gabon,ISL,Iceland,2017,1,1,0
GAB,Gabon,ITA,Italy,2008,14,0,14
GAB,Gabon,ITA,Italy,2009,25,0,25
GAB,Gabon,ITA,Italy,2010,28,1,27
GAB,Gabon,ITA,Italy,2011,9,1,8
GAB,Gabon,ITA,Italy,2012,41,0,41
GAB,Gabon,ITA,Italy,2013,41,0,41
GAB,Gabon,ITA,Italy,2014,20,0,20
GAB,Gabon,ITA,Italy,2015,58,2,56
GAB,Gabon,ITA,Italy,2016,42,0,42
GAB,Gabon,ITA,Italy,2017,60,0,60
GAB,Gabon,JPN,Japan,2008,148,146,2
GAB,Gabon,JPN,Japan,2009,31,33,-2
GAB,Gabon,JPN,Japan,2010,93,89,4
GAB,Gabon,JPN,Japan,2011,41,46,-5
GAB,Gabon,JPN,Japan,2012,66,64,2
GAB,Gabon,JPN,Japan,2013,132,129,3
GAB,Gabon,JPN,Japan,2014,35,36,-1
GAB,Gabon,JPN,Japan,2015,73,60,13
GAB,Gabon,JPN,Japan,2016,35,31,4
GAB,Gabon,JPN,Japan,2017,39,35,4
GAB,Gabon,KOR,Korea,2008,14,5,9
GAB,Gabon,KOR,Korea,2009,14,10,4
GAB,Gabon,KOR,Korea,2010,19,7,12
GAB,Gabon,KOR,Korea,2011,28,11,17
GAB,Gabon,KOR,Korea,2012,16,17,-1
GAB,Gabon,KOR,Korea,2013,13,9,4
GAB,Gabon,KOR,Korea,2014,11,6,5
GAB,Gabon,KOR,Korea,2015,11,11,0
GAB,Gabon,KOR,Korea,2016,15,12,3
GAB,Gabon,KOR,Korea,2017,10,13,-3
GAB,Gabon,LUX,Luxembourg,2008,3,0,3
GAB,Gabon,LUX,Luxembourg,2009,2,1,1
GAB,Gabon,LUX,Luxembourg,2010,0,0,0
GAB,Gabon,LUX,Luxembourg,2011,3,1,2
GAB,Gabon,LUX,Luxembourg,2012,1,0,1
GAB,Gabon,LUX,Luxembourg,2013,1,0,1
GAB,Gabon,LUX,Luxembourg,2014,3,0,3
GAB,Gabon,LUX,Luxembourg,2015,3,1,2
GAB,Gabon,LUX,Luxembourg,2016,18,2,16
GAB,Gabon,LUX,Luxembourg,2017,7,7,0
GAB,Gabon,MEX,Mexico,2012,0,0,0
GAB,Gabon,MEX,Mexico,2013,1,0,1
GAB,Gabon,MEX,Mexico,2014,0,0,0
GAB,Gabon,MEX,Mexico,2016,1,0,1
GAB,Gabon,NLD,Netherlands,2008,4,11,-7
GAB,Gabon,NLD,Netherlands,2009,3,7,-4
GAB,Gabon,NLD,Netherlands,2010,13,10,3
GAB,Gabon,NLD,Netherlands,2011,1,2,-1
GAB,Gabon,NLD,Netherlands,2012,1,2,-1
GAB,Gabon,NLD,Netherlands,2013,7,5,2
GAB,Gabon,NLD,Netherlands,2014,9,9,0
GAB,Gabon,NLD,Netherlands,2015,9,10,-1
GAB,Gabon,NLD,Netherlands,2016,7,2,5
GAB,Gabon,NLD,Netherlands,2017,2,7,-5
GAB,Gabon,NZL,New Zealand,2010,1,0,1
GAB,Gabon,NZL,New Zealand,2011,0,0,0
GAB,Gabon,NOR,Norway,2008,0,0,0
GAB,Gabon,NOR,Norway,2009,0,1,-1
GAB,Gabon,NOR,Norway,2010,0,0,0
GAB,Gabon,NOR,Norway,2011,0,0,0
GAB,Gabon,NOR,Norway,2012,6,1,5
GAB,Gabon,NOR,Norway,2013,3,1,2
GAB,Gabon,NOR,Norway,2014,2,7,-5
GAB,Gabon,NOR,Norway,2015,1,0,1
GAB,Gabon,NOR,Norway,2016,2,1,1
GAB,Gabon,NOR,Norway,2017,0,0,0
GAB,Gabon,POL,Poland,2009,1,0,1
GAB,Gabon,POL,Poland,2010,1,0,1
GAB,Gabon,POL,Poland,2011,0,0,0
GAB,Gabon,POL,Poland,2012,0,0,0
GAB,Gabon,POL,Poland,2013,1,0,1
GAB,Gabon,POL,Poland,2014,2,0,2
GAB,Gabon,POL,Poland,2015,0,0,0
GAB,Gabon,POL,Poland,2016,2,0,2
GAB,Gabon,POL,Poland,2017,2,0,2
GAB,Gabon,SVK,Slovak Republic,2008,0,0,0
GAB,Gabon,ESP,Spain,2008,17,13,4
GAB,Gabon,ESP,Spain,2009,18,15,3
GAB,Gabon,ESP,Spain,2010,49,16,33
GAB,Gabon,ESP,Spain,2011,14,19,-5
GAB,Gabon,ESP,Spain,2012,28,9,19
GAB,Gabon,ESP,Spain,2013,23,19,4
GAB,Gabon,ESP,Spain,2014,37,9,28
GAB,Gabon,ESP,Spain,2015,29,12,17
GAB,Gabon,ESP,Spain,2016,27,8,19
GAB,Gabon,ESP,Spain,2017,27,26,1
GAB,Gabon,SWE,Sweden,2008,3,0,3
GAB,Gabon,SWE,Sweden,2009,0,0,0
GAB,Gabon,SWE,Sweden,2010,1,0,1
GAB,Gabon,SWE,Sweden,2011,4,0,4
GAB,Gabon,SWE,Sweden,2012,2,1,1
GAB,Gabon,SWE,Sweden,2013,2,1,1
GAB,Gabon,SWE,Sweden,2014,1,2,-1
GAB,Gabon,SWE,Sweden,2015,1,0,1
GAB,Gabon,SWE,Sweden,2016,2,0,2
GAB,Gabon,SWE,Sweden,2017,3,0,3
GAB,Gabon,CHE,Switzerland,2010,13,2,11
GAB,Gabon,CHE,Switzerland,2011,24,9,15
GAB,Gabon,CHE,Switzerland,2012,17,6,11
GAB,Gabon,CHE,Switzerland,2013,27,13,14
GAB,Gabon,CHE,Switzerland,2014,10,5,5
GAB,Gabon,CHE,Switzerland,2015,15,15,0
GAB,Gabon,CHE,Switzerland,2016,14,7,7
GAB,Gabon,CHE,Switzerland,2017,6,5,1
GAB,Gabon,USA,United States,2008,82,0,82
GAB,Gabon,USA,United States,2009,171,0,171
GAB,Gabon,USA,United States,2010,138,0,138
GAB,Gabon,USA,United States,2011,204,0,204
GAB,Gabon,USA,United States,2012,197,0,197
GAB,Gabon,USA,United States,2013,127,0,127
GAB,Gabon,USA,United States,2014,167,0,167
GAB,Gabon,USA,United States,2015,146,0,146
GAB,Gabon,USA,United States,2016,165,0,165
GAB,Gabon,USA,United States,2017,150,0,150
GAB,Gabon,CHL,Chile,2008,1,0,1
GAB,Gabon,CHL,Chile,2009,0,0,0
GAB,Gabon,CHL,Chile,2010,0,0,0
GAB,Gabon,CHL,Chile,2011,0,0,0
GAB,Gabon,CHL,Chile,2012,0,0,0
GAB,Gabon,CHL,Chile,2013,0,0,0
GAB,Gabon,CHL,Chile,2014,0,0,0
GAB,Gabon,CHL,Chile,2015,0,0,0
GAB,Gabon,CHL,Chile,2016,0,0,0
GAB,Gabon,EST,Estonia,2008,0,0,0
GAB,Gabon,EST,Estonia,2009,0,0,0
GAB,Gabon,EST,Estonia,2010,0,0,0
GAB,Gabon,EST,Estonia,2011,0,0,0
GAB,Gabon,EST,Estonia,2012,0,0,0
GAB,Gabon,EST,Estonia,2013,0,0,0
GAB,Gabon,EST,Estonia,2014,0,0,0
GAB,Gabon,EST,Estonia,2015,0,0,0
GAB,Gabon,EST,Estonia,2016,0,0,0
GAB,Gabon,EST,Estonia,2017,0,0,0
GAB,Gabon,SVN,Slovenia,2016,1,0,1
GMB,Gambia,AUS,Australia,2008,4,0,4
GMB,Gambia,AUS,Australia,2009,0,0,0
GMB,Gambia,AUS,Australia,2010,6,0,6
GMB,Gambia,AUS,Australia,2011,1,0,1
GMB,Gambia,AUS,Australia,2012,1,0,1
GMB,Gambia,AUS,Australia,2013,3,0,3
GMB,Gambia,AUS,Australia,2014,0,0,0
GMB,Gambia,AUS,Australia,2015,12,0,12
GMB,Gambia,AUS,Australia,2017,0,0,0
GMB,Gambia,AUT,Austria,2008,109,118,-9
GMB,Gambia,AUT,Austria,2009,155,141,14
GMB,Gambia,AUT,Austria,2010,121,127,-6
GMB,Gambia,AUT,Austria,2011,96,125,-29
GMB,Gambia,AUT,Austria,2012,103,96,7
GMB,Gambia,AUT,Austria,2013,110,73,37
GMB,Gambia,AUT,Austria,2014,140,69,71
GMB,Gambia,AUT,Austria,2015,192,83,109
GMB,Gambia,AUT,Austria,2016,280,178,102
GMB,Gambia,AUT,Austria,2017,134,164,-30
GMB,Gambia,BEL,Belgium,2008,35,0,35
GMB,Gambia,BEL,Belgium,2009,38,0,38
GMB,Gambia,BEL,Belgium,2010,26,6,20
GMB,Gambia,BEL,Belgium,2012,87,53,34
GMB,Gambia,BEL,Belgium,2013,111,48,63
GMB,Gambia,BEL,Belgium,2014,64,43,21
GMB,Gambia,BEL,Belgium,2015,94,43,51
GMB,Gambia,BEL,Belgium,2016,74,18,56
GMB,Gambia,BEL,Belgium,2017,65,17,48
GMB,Gambia,CAN,Canada,2008,25,0,25
GMB,Gambia,CAN,Canada,2009,10,0,10
GMB,Gambia,CAN,Canada,2010,37,0,37
GMB,Gambia,CAN,Canada,2011,24,0,24
GMB,Gambia,CAN,Canada,2012,18,0,18
GMB,Gambia,CAN,Canada,2013,33,0,33
GMB,Gambia,CAN,Canada,2014,36,0,36
GMB,Gambia,CAN,Canada,2015,42,0,42
GMB,Gambia,CAN,Canada,2016,50,0,50
GMB,Gambia,CAN,Canada,2017,60,0,60
GMB,Gambia,CZE,Czech Republic,2008,2,0,2
GMB,Gambia,CZE,Czech Republic,2010,1,0,1
GMB,Gambia,CZE,Czech Republic,2011,1,0,1
GMB,Gambia,CZE,Czech Republic,2012,2,0,2
GMB,Gambia,CZE,Czech Republic,2013,2,1,1
GMB,Gambia,CZE,Czech Republic,2014,2,0,2
GMB,Gambia,CZE,Czech Republic,2015,5,0,5
GMB,Gambia,CZE,Czech Republic,2016,5,0,5
GMB,Gambia,DNK,Denmark,2008,24,2,22
GMB,Gambia,DNK,Denmark,2009,22,4,18
GMB,Gambia,DNK,Denmark,2010,29,12,17
GMB,Gambia,DNK,Denmark,2011,27,2,25
GMB,Gambia,DNK,Denmark,2012,13,9,4
GMB,Gambia,DNK,Denmark,2013,22,6,16
GMB,Gambia,DNK,Denmark,2014,32,2,30
GMB,Gambia,DNK,Denmark,2015,22,4,18
GMB,Gambia,DNK,Denmark,2016,16,3,13
GMB,Gambia,DNK,Denmark,2017,16,8,8
GMB,Gambia,FIN,Finland,2008,52,5,47
GMB,Gambia,FIN,Finland,2009,45,4,41
GMB,Gambia,FIN,Finland,2010,46,3,43
GMB,Gambia,FIN,Finland,2011,56,1,55
GMB,Gambia,FIN,Finland,2012,48,4,44
GMB,Gambia,FIN,Finland,2013,50,3,47
GMB,Gambia,FIN,Finland,2014,88,7,81
GMB,Gambia,FIN,Finland,2015,45,2,43
GMB,Gambia,FIN,Finland,2016,67,6,61
GMB,Gambia,FIN,Finland,2017,57,7,50
GMB,Gambia,FRA,France,2008,104,0,104
GMB,Gambia,FRA,France,2009,89,0,89
GMB,Gambia,FRA,France,2010,101,0,101
GMB,Gambia,FRA,France,2011,104,0,104
GMB,Gambia,FRA,France,2012,118,0,118
GMB,Gambia,FRA,France,2013,118,0,118
GMB,Gambia,FRA,France,2014,142,0,142
GMB,Gambia,FRA,France,2015,134,0,134
GMB,Gambia,FRA,France,2016,132,0,132
GMB,Gambia,FRA,France,2017,195,0,195
GMB,Gambia,DEU,Germany,2008,337,201,136
GMB,Gambia,DEU,Germany,2009,349,201,148
GMB,Gambia,DEU,Germany,2010,387,232,155
GMB,Gambia,DEU,Germany,2011,400,251,149
GMB,Gambia,DEU,Germany,2012,592,271,321
GMB,Gambia,DEU,Germany,2013,1029,261,768
GMB,Gambia,DEU,Germany,2014,2441,502,1939
GMB,Gambia,DEU,Germany,2015,5484,917,4567
GMB,Gambia,DEU,Germany,2016,5608,1846,3762
GMB,Gambia,DEU,Germany,2017,3436,2132,1304
GMB,Gambia,HUN,Hungary,2008,1,0,1
GMB,Gambia,HUN,Hungary,2009,3,0,3
GMB,Gambia,HUN,Hungary,2010,1,0,1
GMB,Gambia,HUN,Hungary,2011,1,0,1
GMB,Gambia,HUN,Hungary,2012,1,0,1
GMB,Gambia,HUN,Hungary,2013,0,1,-1
GMB,Gambia,HUN,Hungary,2014,5,1,4
GMB,Gambia,HUN,Hungary,2015,1,0,1
GMB,Gambia,HUN,Hungary,2016,3,0,3
GMB,Gambia,HUN,Hungary,2017,3,0,3
GMB,Gambia,ISL,Iceland,2008,1,0,1
GMB,Gambia,ISL,Iceland,2009,0,0,0
GMB,Gambia,ISL,Iceland,2010,1,0,1
GMB,Gambia,ISL,Iceland,2011,2,1,1
GMB,Gambia,ISL,Iceland,2012,2,0,2
GMB,Gambia,ISL,Iceland,2013,2,1,1
GMB,Gambia,ISL,Iceland,2014,3,2,1
GMB,Gambia,ISL,Iceland,2015,1,0,1
GMB,Gambia,ISL,Iceland,2016,3,0,3
GMB,Gambia,ISL,Iceland,2017,1,2,-1
GMB,Gambia,ITA,Italy,2008,72,3,69
GMB,Gambia,ITA,Italy,2009,114,5,109
GMB,Gambia,ITA,Italy,2010,153,2,151
GMB,Gambia,ITA,Italy,2011,130,2,128
GMB,Gambia,ITA,Italy,2012,273,3,270
GMB,Gambia,ITA,Italy,2013,373,6,367
GMB,Gambia,ITA,Italy,2014,1653,9,1644
GMB,Gambia,ITA,Italy,2015,5108,28,5080
GMB,Gambia,ITA,Italy,2016,6624,0,6624
GMB,Gambia,ITA,Italy,2017,8688,96,8592
GMB,Gambia,JPN,Japan,2008,37,38,-1
GMB,Gambia,JPN,Japan,2009,12,12,0
GMB,Gambia,JPN,Japan,2010,27,26,1
GMB,Gambia,JPN,Japan,2011,19,19,0
GMB,Gambia,JPN,Japan,2012,20,20,0
GMB,Gambia,JPN,Japan,2013,70,18,52
GMB,Gambia,JPN,Japan,2014,17,17,0
GMB,Gambia,JPN,Japan,2015,24,23,1
GMB,Gambia,JPN,Japan,2016,26,13,13
GMB,Gambia,JPN,Japan,2017,20,14,6
GMB,Gambia,KOR,Korea,2008,1,1,0
GMB,Gambia,KOR,Korea,2009,1,1,0
GMB,Gambia,KOR,Korea,2010,5,1,4
GMB,Gambia,KOR,Korea,2011,0,0,0
GMB,Gambia,KOR,Korea,2012,5,4,1
GMB,Gambia,KOR,Korea,2013,7,3,4
GMB,Gambia,KOR,Korea,2014,9,2,7
GMB,Gambia,KOR,Korea,2015,21,3,18
GMB,Gambia,KOR,Korea,2016,18,9,9
GMB,Gambia,KOR,Korea,2017,45,6,39
GMB,Gambia,LUX,Luxembourg,2008,5,6,-1
GMB,Gambia,LUX,Luxembourg,2009,5,2,3
GMB,Gambia,LUX,Luxembourg,2010,3,3,0
GMB,Gambia,LUX,Luxembourg,2011,5,1,4
GMB,Gambia,LUX,Luxembourg,2012,13,2,11
GMB,Gambia,LUX,Luxembourg,2013,4,0,4
GMB,Gambia,LUX,Luxembourg,2014,8,4,4
GMB,Gambia,LUX,Luxembourg,2015,8,4,4
GMB,Gambia,LUX,Luxembourg,2016,13,4,9
GMB,Gambia,LUX,Luxembourg,2017,7,3,4
GMB,Gambia,MEX,Mexico,2011,1,0,1
GMB,Gambia,MEX,Mexico,2012,0,0,0
GMB,Gambia,MEX,Mexico,2013,0,0,0
GMB,Gambia,MEX,Mexico,2014,0,0,0
GMB,Gambia,MEX,Mexico,2017,3,0,3
GMB,Gambia,NLD,Netherlands,2008,43,14,29
GMB,Gambia,NLD,Netherlands,2009,41,8,33
GMB,Gambia,NLD,Netherlands,2010,54,11,43
GMB,Gambia,NLD,Netherlands,2011,50,5,45
GMB,Gambia,NLD,Netherlands,2012,24,17,7
GMB,Gambia,NLD,Netherlands,2013,33,9,24
GMB,Gambia,NLD,Netherlands,2014,59,10,49
GMB,Gambia,NLD,Netherlands,2015,70,6,64
GMB,Gambia,NLD,Netherlands,2016,83,13,70
GMB,Gambia,NLD,Netherlands,2017,83,18,65
GMB,Gambia,NZL,New Zealand,2008,2,0,2
GMB,Gambia,NZL,New Zealand,2009,1,0,1
GMB,Gambia,NZL,New Zealand,2010,1,0,1
GMB,Gambia,NZL,New Zealand,2011,1,1,0
GMB,Gambia,NZL,New Zealand,2013,1,0,1
GMB,Gambia,NZL,New Zealand,2014,1,0,1
GMB,Gambia,NZL,New Zealand,2016,1,0,1
GMB,Gambia,NOR,Norway,2008,46,11,35
GMB,Gambia,NOR,Norway,2009,49,14,35
GMB,Gambia,NOR,Norway,2010,45,14,31
GMB,Gambia,NOR,Norway,2011,36,15,21
GMB,Gambia,NOR,Norway,2012,46,14,32
GMB,Gambia,NOR,Norway,2013,33,10,23
GMB,Gambia,NOR,Norway,2014,32,7,25
GMB,Gambia,NOR,Norway,2015,42,15,27
GMB,Gambia,NOR,Norway,2016,30,6,24
GMB,Gambia,NOR,Norway,2017,31,8,23
GMB,Gambia,POL,Poland,2009,23,0,23
GMB,Gambia,POL,Poland,2010,19,0,19
GMB,Gambia,POL,Poland,2011,14,0,14
GMB,Gambia,POL,Poland,2012,25,0,25
GMB,Gambia,POL,Poland,2013,17,0,17
GMB,Gambia,POL,Poland,2014,6,0,6
GMB,Gambia,POL,Poland,2015,11,0,11
GMB,Gambia,POL,Poland,2016,14,0,14
GMB,Gambia,POL,Poland,2017,7,0,7
GMB,Gambia,SVK,Slovak Republic,2008,0,0,0
GMB,Gambia,SVK,Slovak Republic,2009,1,0,1
GMB,Gambia,SVK,Slovak Republic,2010,1,0,1
GMB,Gambia,SVK,Slovak Republic,2011,1,1,0
GMB,Gambia,ESP,Spain,2008,2552,871,1681
GMB,Gambia,ESP,Spain,2009,1731,1271,460
GMB,Gambia,ESP,Spain,2010,1482,1574,-92
GMB,Gambia,ESP,Spain,2011,1380,1847,-467
GMB,Gambia,ESP,Spain,2012,1157,1669,-512
GMB,Gambia,ESP,Spain,2013,1169,2027,-858
GMB,Gambia,ESP,Spain,2014,1190,1391,-201
GMB,Gambia,ESP,Spain,2015,1160,966,194
GMB,Gambia,ESP,Spain,2016,1271,819,452
GMB,Gambia,ESP,Spain,2017,1304,998,306
GMB,Gambia,SWE,Sweden,2008,247,16,231
GMB,Gambia,SWE,Sweden,2009,281,9,272
GMB,Gambia,SWE,Sweden,2010,290,20,270
GMB,Gambia,SWE,Sweden,2011,218,21,197
GMB,Gambia,SWE,Sweden,2012,260,26,234
GMB,Gambia,SWE,Sweden,2013,254,23,231
GMB,Gambia,SWE,Sweden,2014,234,20,214
GMB,Gambia,SWE,Sweden,2015,184,37,147
GMB,Gambia,SWE,Sweden,2016,194,16,178
GMB,Gambia,SWE,Sweden,2017,198,34,164
GMB,Gambia,CHE,Switzerland,2010,54,8,46
GMB,Gambia,CHE,Switzerland,2011,41,19,22
GMB,Gambia,CHE,Switzerland,2012,42,12,30
GMB,Gambia,CHE,Switzerland,2013,33,9,24
GMB,Gambia,CHE,Switzerland,2014,36,8,28
GMB,Gambia,CHE,Switzerland,2015,46,9,37
GMB,Gambia,CHE,Switzerland,2016,29,13,16
GMB,Gambia,CHE,Switzerland,2017,47,11,36
GMB,Gambia,TUR,Turkey,2010,4,0,4
GMB,Gambia,USA,United States,2008,739,0,739
GMB,Gambia,USA,United States,2009,978,0,978
GMB,Gambia,USA,United States,2010,859,0,859
GMB,Gambia,USA,United States,2011,972,0,972
GMB,Gambia,USA,United States,2012,1159,0,1159
GMB,Gambia,USA,United States,2013,1018,0,1018
GMB,Gambia,USA,United States,2014,1111,0,1111
GMB,Gambia,USA,United States,2015,1142,0,1142
GMB,Gambia,USA,United States,2016,1247,0,1247
GMB,Gambia,USA,United States,2017,1134,0,1134
GMB,Gambia,CHL,Chile,2008,0,0,0
GMB,Gambia,CHL,Chile,2009,0,0,0
GMB,Gambia,CHL,Chile,2010,0,0,0
GMB,Gambia,CHL,Chile,2011,1,0,1
GMB,Gambia,CHL,Chile,2012,0,0,0
GMB,Gambia,CHL,Chile,2013,0,0,0
GMB,Gambia,CHL,Chile,2014,0,0,0
GMB,Gambia,CHL,Chile,2015,0,0,0
GMB,Gambia,CHL,Chile,2016,0,0,0
GMB,Gambia,EST,Estonia,2008,0,0,0
GMB,Gambia,EST,Estonia,2009,0,0,0
GMB,Gambia,EST,Estonia,2010,0,0,0
GMB,Gambia,EST,Estonia,2011,0,0,0
GMB,Gambia,EST,Estonia,2012,0,0,0
GMB,Gambia,EST,Estonia,2013,1,0,1
GMB,Gambia,EST,Estonia,2014,0,0,0
GMB,Gambia,EST,Estonia,2015,0,0,0
GMB,Gambia,EST,Estonia,2016,1,0,1
GMB,Gambia,EST,Estonia,2017,0,0,0
GMB,Gambia,SVN,Slovenia,2009,1,0,1
GMB,Gambia,SVN,Slovenia,2010,3,0,3
GMB,Gambia,SVN,Slovenia,2011,4,0,4
GMB,Gambia,SVN,Slovenia,2013,1,0,1
GMB,Gambia,SVN,Slovenia,2015,2,0,2
GMB,Gambia,SVN,Slovenia,2017,1,0,1
GEO,Georgia,AUS,Australia,2008,10,7,3
GEO,Georgia,AUS,Australia,2009,13,7,6
GEO,Georgia,AUS,Australia,2010,19,6,13
GEO,Georgia,AUS,Australia,2011,4,0,4
GEO,Georgia,AUS,Australia,2012,10,0,10
GEO,Georgia,AUS,Australia,2013,7,0,7
GEO,Georgia,AUS,Australia,2014,12,6,6
GEO,Georgia,AUS,Australia,2015,13,0,13
GEO,Georgia,AUS,Australia,2016,11,0,11
GEO,Georgia,AUS,Australia,2017,9,0,9
GEO,Georgia,AUT,Austria,2008,513,395,118
GEO,Georgia,AUT,Austria,2009,516,504,12
GEO,Georgia,AUT,Austria,2010,341,511,-170
GEO,Georgia,AUT,Austria,2011,323,363,-40
GEO,Georgia,AUT,Austria,2012,405,346,59
GEO,Georgia,AUT,Austria,2013,399,259,140
GEO,Georgia,AUT,Austria,2014,515,269,246
GEO,Georgia,AUT,Austria,2015,538,231,307
GEO,Georgia,AUT,Austria,2016,499,328,171
GEO,Georgia,AUT,Austria,2017,583,479,104
GEO,Georgia,BEL,Belgium,2008,64,0,64
GEO,Georgia,BEL,Belgium,2009,83,0,83
GEO,Georgia,BEL,Belgium,2010,137,38,99
GEO,Georgia,BEL,Belgium,2011,99,0,99
GEO,Georgia,BEL,Belgium,2012,488,191,297
GEO,Georgia,BEL,Belgium,2013,296,412,-116
GEO,Georgia,BEL,Belgium,2014,252,356,-104
GEO,Georgia,BEL,Belgium,2015,188,284,-96
GEO,Georgia,BEL,Belgium,2016,150,164,-14
GEO,Georgia,BEL,Belgium,2017,250,85,165
GEO,Georgia,CAN,Canada,2008,112,0,112
GEO,Georgia,CAN,Canada,2009,128,0,128
GEO,Georgia,CAN,Canada,2010,126,0,126
GEO,Georgia,CAN,Canada,2011,139,0,139
GEO,Georgia,CAN,Canada,2012,148,0,148
GEO,Georgia,CAN,Canada,2013,125,0,125
GEO,Georgia,CAN,Canada,2014,102,0,102
GEO,Georgia,CAN,Canada,2015,103,0,103
GEO,Georgia,CAN,Canada,2016,120,0,120
GEO,Georgia,CAN,Canada,2017,135,0,135
GEO,Georgia,CZE,Czech Republic,2008,162,1,161
GEO,Georgia,CZE,Czech Republic,2009,151,0,151
GEO,Georgia,CZE,Czech Republic,2010,125,1,124
GEO,Georgia,CZE,Czech Republic,2011,50,2,48
GEO,Georgia,CZE,Czech Republic,2012,79,61,18
GEO,Georgia,CZE,Czech Republic,2013,64,89,-25
GEO,Georgia,CZE,Czech Republic,2014,126,75,51
GEO,Georgia,CZE,Czech Republic,2015,85,83,2
GEO,Georgia,CZE,Czech Republic,2016,73,64,9
GEO,Georgia,CZE,Czech Republic,2017,108,52,56
GEO,Georgia,DNK,Denmark,2008,11,5,6
GEO,Georgia,DNK,Denmark,2009,12,6,6
GEO,Georgia,DNK,Denmark,2010,11,8,3
GEO,Georgia,DNK,Denmark,2011,11,8,3
GEO,Georgia,DNK,Denmark,2012,4,7,-3
GEO,Georgia,DNK,Denmark,2013,10,4,6
GEO,Georgia,DNK,Denmark,2014,9,10,-1
GEO,Georgia,DNK,Denmark,2015,6,4,2
GEO,Georgia,DNK,Denmark,2016,17,7,10
GEO,Georgia,DNK,Denmark,2017,24,14,10
GEO,Georgia,FIN,Finland,2008,7,2,5
GEO,Georgia,FIN,Finland,2009,4,1,3
GEO,Georgia,FIN,Finland,2010,9,1,8
GEO,Georgia,FIN,Finland,2011,11,0,11
GEO,Georgia,FIN,Finland,2012,12,0,12
GEO,Georgia,FIN,Finland,2013,14,0,14
GEO,Georgia,FIN,Finland,2014,14,3,11
GEO,Georgia,FIN,Finland,2015,8,0,8
GEO,Georgia,FIN,Finland,2016,15,2,13
GEO,Georgia,FIN,Finland,2017,17,1,16
GEO,Georgia,FRA,France,2008,470,0,470
GEO,Georgia,FRA,France,2009,468,0,468
GEO,Georgia,FRA,France,2010,438,0,438
GEO,Georgia,FRA,France,2011,449,0,449
GEO,Georgia,FRA,France,2012,606,0,606
GEO,Georgia,FRA,France,2013,711,0,711
GEO,Georgia,FRA,France,2014,784,0,784
GEO,Georgia,FRA,France,2015,891,0,891
GEO,Georgia,FRA,France,2016,1062,0,1062
GEO,Georgia,FRA,France,2017,954,0,954
GEO,Georgia,DEU,Germany,2008,1693,2015,-322
GEO,Georgia,DEU,Germany,2009,2239,2026,213
GEO,Georgia,DEU,Germany,2010,2377,2147,230
GEO,Georgia,DEU,Germany,2011,2339,1681,658
GEO,Georgia,DEU,Germany,2012,3466,1960,1506
GEO,Georgia,DEU,Germany,2013,4481,2390,2091
GEO,Georgia,DEU,Germany,2014,5604,3266,2338
GEO,Georgia,DEU,Germany,2015,6472,3364,3108
GEO,Georgia,DEU,Germany,2016,5006,4627,379
GEO,Georgia,DEU,Germany,2017,5786,4785,1001
GEO,Georgia,GRC,Greece,2008,839,0,839
GEO,Georgia,GRC,Greece,2009,963,0,963
GEO,Georgia,GRC,Greece,2010,858,0,858
GEO,Georgia,GRC,Greece,2011,693,0,693
GEO,Georgia,HUN,Hungary,2008,45,3,42
GEO,Georgia,HUN,Hungary,2009,50,4,46
GEO,Georgia,HUN,Hungary,2010,45,2,43
GEO,Georgia,HUN,Hungary,2011,30,10,20
GEO,Georgia,HUN,Hungary,2012,37,2,35
GEO,Georgia,HUN,Hungary,2013,71,4,67
GEO,Georgia,HUN,Hungary,2014,72,3,69
GEO,Georgia,HUN,Hungary,2015,78,5,73
GEO,Georgia,HUN,Hungary,2016,115,5,110
GEO,Georgia,HUN,Hungary,2017,123,0,123
GEO,Georgia,ISL,Iceland,2008,0,5,-5
GEO,Georgia,ISL,Iceland,2009,0,3,-3
GEO,Georgia,ISL,Iceland,2010,0,0,0
GEO,Georgia,ISL,Iceland,2011,0,0,0
GEO,Georgia,ISL,Iceland,2012,0,0,0
GEO,Georgia,ISL,Iceland,2013,1,0,1
GEO,Georgia,ISL,Iceland,2014,1,0,1
GEO,Georgia,ISL,Iceland,2015,2,0,2
GEO,Georgia,ISL,Iceland,2016,1,0,1
GEO,Georgia,ISL,Iceland,2017,10,0,10
GEO,Georgia,ITA,Italy,2008,509,5,504
GEO,Georgia,ITA,Italy,2009,1165,5,1160
GEO,Georgia,ITA,Italy,2010,4008,31,3977
GEO,Georgia,ITA,Italy,2011,1772,36,1736
GEO,Georgia,ITA,Italy,2012,1706,68,1638
GEO,Georgia,ITA,Italy,2013,2294,65,2229
GEO,Georgia,ITA,Italy,2014,1574,131,1443
GEO,Georgia,ITA,Italy,2015,935,145,790
GEO,Georgia,ITA,Italy,2016,737,0,737
GEO,Georgia,ITA,Italy,2017,855,152,703
GEO,Georgia,JPN,Japan,2008,50,43,7
GEO,Georgia,JPN,Japan,2009,72,64,8
GEO,Georgia,JPN,Japan,2010,135,138,-3
GEO,Georgia,JPN,Japan,2011,46,39,7
GEO,Georgia,JPN,Japan,2012,127,128,-1
GEO,Georgia,JPN,Japan,2013,61,50,11
GEO,Georgia,JPN,Japan,2014,89,91,-2
GEO,Georgia,JPN,Japan,2015,86,79,7
GEO,Georgia,JPN,Japan,2016,105,91,14
GEO,Georgia,JPN,Japan,2017,140,143,-3
GEO,Georgia,KOR,Korea,2008,22,14,8
GEO,Georgia,KOR,Korea,2009,11,18,-7
GEO,Georgia,KOR,Korea,2010,12,9,3
GEO,Georgia,KOR,Korea,2011,5,7,-2
GEO,Georgia,KOR,Korea,2012,9,6,3
GEO,Georgia,KOR,Korea,2013,12,12,0
GEO,Georgia,KOR,Korea,2014,8,10,-2
GEO,Georgia,KOR,Korea,2015,16,10,6
GEO,Georgia,KOR,Korea,2016,12,13,-1
GEO,Georgia,KOR,Korea,2017,16,10,6
GEO,Georgia,LUX,Luxembourg,2008,3,1,2
GEO,Georgia,LUX,Luxembourg,2009,3,2,1
GEO,Georgia,LUX,Luxembourg,2010,4,3,1
GEO,Georgia,LUX,Luxembourg,2011,5,0,5
GEO,Georgia,LUX,Luxembourg,2012,8,0,8
GEO,Georgia,LUX,Luxembourg,2013,14,2,12
GEO,Georgia,LUX,Luxembourg,2014,13,4,9
GEO,Georgia,LUX,Luxembourg,2015,15,5,10
GEO,Georgia,LUX,Luxembourg,2016,28,14,14
GEO,Georgia,LUX,Luxembourg,2017,23,27,-4
GEO,Georgia,MEX,Mexico,2008,1,0,1
GEO,Georgia,MEX,Mexico,2009,1,0,1
GEO,Georgia,MEX,Mexico,2010,1,0,1
GEO,Georgia,MEX,Mexico,2011,1,0,1
GEO,Georgia,MEX,Mexico,2012,0,0,0
GEO,Georgia,MEX,Mexico,2013,3,0,3
GEO,Georgia,MEX,Mexico,2014,2,0,2
GEO,Georgia,MEX,Mexico,2015,1,0,1
GEO,Georgia,MEX,Mexico,2016,2,0,2
GEO,Georgia,NLD,Netherlands,2008,85,40,45
GEO,Georgia,NLD,Netherlands,2009,129,55,74
GEO,Georgia,NLD,Netherlands,2010,113,59,54
GEO,Georgia,NLD,Netherlands,2011,91,52,39
GEO,Georgia,NLD,Netherlands,2012,78,42,36
GEO,Georgia,NLD,Netherlands,2013,102,66,36
GEO,Georgia,NLD,Netherlands,2014,96,64,32
GEO,Georgia,NLD,Netherlands,2015,93,77,16
GEO,Georgia,NLD,Netherlands,2016,135,61,74
GEO,Georgia,NLD,Netherlands,2017,128,72,56
GEO,Georgia,NZL,New Zealand,2008,3,0,3
GEO,Georgia,NZL,New Zealand,2009,4,1,3
GEO,Georgia,NZL,New Zealand,2010,1,0,1
GEO,Georgia,NZL,New Zealand,2011,1,3,-2
GEO,Georgia,NZL,New Zealand,2012,3,0,3
GEO,Georgia,NZL,New Zealand,2013,1,1,0
GEO,Georgia,NZL,New Zealand,2016,4,0,4
GEO,Georgia,NZL,New Zealand,2017,2,1,1
GEO,Georgia,NOR,Norway,2008,22,6,16
GEO,Georgia,NOR,Norway,2009,11,3,8
GEO,Georgia,NOR,Norway,2010,18,8,10
GEO,Georgia,NOR,Norway,2011,29,14,15
GEO,Georgia,NOR,Norway,2012,45,13,32
GEO,Georgia,NOR,Norway,2013,39,26,13
GEO,Georgia,NOR,Norway,2014,24,22,2
GEO,Georgia,NOR,Norway,2015,22,21,1
GEO,Georgia,NOR,Norway,2016,19,17,2
GEO,Georgia,NOR,Norway,2017,20,12,8
GEO,Georgia,POL,Poland,2008,142,0,142
GEO,Georgia,POL,Poland,2009,173,0,173
GEO,Georgia,POL,Poland,2010,186,0,186
GEO,Georgia,POL,Poland,2011,222,0,222
GEO,Georgia,POL,Poland,2012,254,0,254
GEO,Georgia,POL,Poland,2013,209,0,209
GEO,Georgia,POL,Poland,2014,180,0,180
GEO,Georgia,POL,Poland,2015,494,0,494
GEO,Georgia,POL,Poland,2016,614,0,614
GEO,Georgia,POL,Poland,2017,653,0,653
GEO,Georgia,SVK,Slovak Republic,2008,15,3,12
GEO,Georgia,SVK,Slovak Republic,2009,23,5,18
GEO,Georgia,SVK,Slovak Republic,2010,2,9,-7
GEO,Georgia,SVK,Slovak Republic,2011,3,3,0
GEO,Georgia,SVK,Slovak Republic,2012,2,0,2
GEO,Georgia,SVK,Slovak Republic,2013,3,0,3
GEO,Georgia,SVK,Slovak Republic,2015,3,0,3
GEO,Georgia,SVK,Slovak Republic,2017,3,0,3
GEO,Georgia,ESP,Spain,2008,1851,749,1102
GEO,Georgia,ESP,Spain,2009,1013,1164,-151
GEO,Georgia,ESP,Spain,2010,933,976,-43
GEO,Georgia,ESP,Spain,2011,945,1030,-85
GEO,Georgia,ESP,Spain,2012,805,1065,-260
GEO,Georgia,ESP,Spain,2013,722,1356,-634
GEO,Georgia,ESP,Spain,2014,926,706,220
GEO,Georgia,ESP,Spain,2015,1089,559,530
GEO,Georgia,ESP,Spain,2016,1340,524,816
GEO,Georgia,ESP,Spain,2017,1861,641,1220
GEO,Georgia,SWE,Sweden,2008,56,12,44
GEO,Georgia,SWE,Sweden,2009,92,6,86
GEO,Georgia,SWE,Sweden,2010,123,6,117
GEO,Georgia,SWE,Sweden,2011,118,17,101
GEO,Georgia,SWE,Sweden,2012,118,17,101
GEO,Georgia,SWE,Sweden,2013,102,21,81
GEO,Georgia,SWE,Sweden,2014,72,29,43
GEO,Georgia,SWE,Sweden,2015,81,45,36
GEO,Georgia,SWE,Sweden,2016,105,37,68
GEO,Georgia,SWE,Sweden,2017,219,28,191
GEO,Georgia,CHE,Switzerland,2010,64,28,36
GEO,Georgia,CHE,Switzerland,2011,59,22,37
GEO,Georgia,CHE,Switzerland,2012,56,27,29
GEO,Georgia,CHE,Switzerland,2013,67,34,33
GEO,Georgia,CHE,Switzerland,2014,57,20,37
GEO,Georgia,CHE,Switzerland,2015,53,23,30
GEO,Georgia,CHE,Switzerland,2016,67,27,40
GEO,Georgia,CHE,Switzerland,2017,57,29,28
GEO,Georgia,TUR,Turkey,2010,334,0,334
GEO,Georgia,TUR,Turkey,2016,6630,4114,2516
GEO,Georgia,TUR,Turkey,2017,8373,4569,3804
GEO,Georgia,GBR,United Kingdom,2015,1000,0,1000
GEO,Georgia,USA,United States,2008,1620,0,1620
GEO,Georgia,USA,United States,2009,1578,0,1578
GEO,Georgia,USA,United States,2010,1518,0,1518
GEO,Georgia,USA,United States,2011,1490,0,1490
GEO,Georgia,USA,United States,2012,1341,0,1341
GEO,Georgia,USA,United States,2013,1368,0,1368
GEO,Georgia,USA,United States,2014,1240,0,1240
GEO,Georgia,USA,United States,2015,1410,0,1410
GEO,Georgia,USA,United States,2016,1635,0,1635
GEO,Georgia,USA,United States,2017,1629,0,1629
GEO,Georgia,CHL,Chile,2008,0,0,0
GEO,Georgia,CHL,Chile,2009,1,0,1
GEO,Georgia,CHL,Chile,2010,0,0,0
GEO,Georgia,CHL,Chile,2011,3,0,3
GEO,Georgia,CHL,Chile,2012,0,0,0
GEO,Georgia,CHL,Chile,2013,0,0,0
GEO,Georgia,CHL,Chile,2014,2,0,2
GEO,Georgia,CHL,Chile,2015,0,0,0
GEO,Georgia,CHL,Chile,2016,3,0,3
GEO,Georgia,EST,Estonia,2008,11,0,11
GEO,Georgia,EST,Estonia,2009,34,0,34
GEO,Georgia,EST,Estonia,2010,15,0,15
GEO,Georgia,EST,Estonia,2011,23,0,23
GEO,Georgia,EST,Estonia,2012,25,0,25
GEO,Georgia,EST,Estonia,2013,44,0,44
GEO,Georgia,EST,Estonia,2014,15,0,15
GEO,Georgia,EST,Estonia,2015,88,0,88
GEO,Georgia,EST,Estonia,2016,69,0,69
GEO,Georgia,EST,Estonia,2017,93,0,93
GEO,Georgia,SVN,Slovenia,2008,4,0,4
GEO,Georgia,SVN,Slovenia,2009,1,0,1
GEO,Georgia,SVN,Slovenia,2010,7,0,7
GEO,Georgia,SVN,Slovenia,2011,10,2,8
GEO,Georgia,SVN,Slovenia,2012,2,0,2
GEO,Georgia,SVN,Slovenia,2013,3,0,3
GEO,Georgia,SVN,Slovenia,2014,4,3,1
GEO,Georgia,SVN,Slovenia,2015,7,0,7
GEO,Georgia,SVN,Slovenia,2016,12,0,12
GEO,Georgia,SVN,Slovenia,2017,7,0,7
DEU,Germany,AUS,Australia,2008,1758,2157,-399
DEU,Germany,AUS,Australia,2009,2063,2079,-16
DEU,Germany,AUS,Australia,2010,2041,2225,-184
DEU,Germany,AUS,Australia,2011,1745,2461,-716
DEU,Germany,AUS,Australia,2012,1942,2382,-440
DEU,Germany,AUS,Australia,2013,1912,2610,-698
DEU,Germany,AUS,Australia,2014,1645,2612,-967
DEU,Germany,AUS,Australia,2015,1535,2888,-1353
DEU,Germany,AUS,Australia,2016,1504,2812,-1308
DEU,Germany,AUS,Australia,2017,1418,2656,-1238
DEU,Germany,AUT,Austria,2008,19206,9477,9729
DEU,Germany,AUT,Austria,2009,17553,9957,7596
DEU,Germany,AUT,Austria,2010,17966,10039,7927
DEU,Germany,AUT,Austria,2011,17410,10199,7211
DEU,Germany,AUT,Austria,2012,17774,10089,7685
DEU,Germany,AUT,Austria,2013,17743,9955,7788
DEU,Germany,AUT,Austria,2014,16757,10120,6637
DEU,Germany,AUT,Austria,2015,17028,10181,6847
DEU,Germany,AUT,Austria,2016,16103,10393,5710
DEU,Germany,AUT,Austria,2017,16234,10073,6161
DEU,Germany,BEL,Belgium,2008,3763,2038,1725
DEU,Germany,BEL,Belgium,2009,3401,1905,1496
DEU,Germany,BEL,Belgium,2010,3302,2303,999
DEU,Germany,BEL,Belgium,2011,3141,2418,723
DEU,Germany,BEL,Belgium,2012,2892,2622,270
DEU,Germany,BEL,Belgium,2013,2925,2563,362
DEU,Germany,BEL,Belgium,2014,2450,2821,-371
DEU,Germany,BEL,Belgium,2015,2455,2833,-378
DEU,Germany,BEL,Belgium,2016,2412,2930,-518
DEU,Germany,BEL,Belgium,2017,2434,2860,-426
DEU,Germany,CAN,Canada,2008,3833,2862,971
DEU,Germany,CAN,Canada,2009,3886,2653,1233
DEU,Germany,CAN,Canada,2010,2955,2891,64
DEU,Germany,CAN,Canada,2011,2015,3138,-1123
DEU,Germany,CAN,Canada,2012,1699,3269,-1570
DEU,Germany,CAN,Canada,2013,1216,3308,-2092
DEU,Germany,CAN,Canada,2014,1273,3516,-2243
DEU,Germany,CAN,Canada,2015,1248,3453,-2205
DEU,Germany,CAN,Canada,2016,1210,3372,-2162
DEU,Germany,CAN,Canada,2017,1140,3330,-2190
DEU,Germany,CZE,Czech Republic,2008,4308,6309,-2001
DEU,Germany,CZE,Czech Republic,2009,1975,5924,-3949
DEU,Germany,CZE,Czech Republic,2010,2002,6063,-4061
DEU,Germany,CZE,Czech Republic,2011,1338,8255,-6917
DEU,Germany,CZE,Czech Republic,2012,1319,9221,-7902
DEU,Germany,CZE,Czech Republic,2013,1676,9963,-8287
DEU,Germany,CZE,Czech Republic,2014,1613,10776,-9163
DEU,Germany,CZE,Czech Republic,2015,1123,10974,-9851
DEU,Germany,CZE,Czech Republic,2016,1040,9618,-8578
DEU,Germany,CZE,Czech Republic,2017,637,9384,-8747
DEU,Germany,DNK,Denmark,2008,3029,2188,841
DEU,Germany,DNK,Denmark,2009,2155,2167,-12
DEU,Germany,DNK,Denmark,2010,1904,2171,-267
DEU,Germany,DNK,Denmark,2011,1882,2315,-433
DEU,Germany,DNK,Denmark,2012,1799,2322,-523
DEU,Germany,DNK,Denmark,2013,1785,2522,-737
DEU,Germany,DNK,Denmark,2014,1966,2342,-376
DEU,Germany,DNK,Denmark,2015,2039,2249,-210
DEU,Germany,DNK,Denmark,2016,2114,2253,-139
DEU,Germany,DNK,Denmark,2017,2259,2108,151
DEU,Germany,FIN,Finland,2008,447,1836,-1389
DEU,Germany,FIN,Finland,2009,347,1847,-1500
DEU,Germany,FIN,Finland,2010,296,1901,-1605
DEU,Germany,FIN,Finland,2011,307,2158,-1851
DEU,Germany,FIN,Finland,2012,303,2190,-1887
DEU,Germany,FIN,Finland,2013,299,2212,-1913
DEU,Germany,FIN,Finland,2014,294,2268,-1974
DEU,Germany,FIN,Finland,2015,301,2241,-1940
DEU,Germany,FIN,Finland,2016,318,2195,-1877
DEU,Germany,FIN,Finland,2017,284,2136,-1852
DEU,Germany,FRA,France,2008,0,12979,-12979
DEU,Germany,FRA,France,2009,0,12858,-12858
DEU,Germany,FRA,France,2010,0,13349,-13349
DEU,Germany,FRA,France,2011,0,13830,-13830
DEU,Germany,FRA,France,2012,0,14458,-14458
DEU,Germany,FRA,France,2013,7738,15215,-7477
DEU,Germany,FRA,France,2014,6420,15723,-9303
DEU,Germany,FRA,France,2015,7119,14908,-7789
DEU,Germany,FRA,France,2016,6190,15518,-9328
DEU,Germany,FRA,France,2017,5683,14895,-9212
DEU,Germany,HUN,Hungary,2008,3201,25151,-21950
DEU,Germany,HUN,Hungary,2009,2694,25270,-22576
DEU,Germany,HUN,Hungary,2010,2420,29286,-26866
DEU,Germany,HUN,Hungary,2011,2428,41132,-38704
DEU,Germany,HUN,Hungary,2012,2073,54491,-52418
DEU,Germany,HUN,Hungary,2013,1991,59995,-58004
DEU,Germany,HUN,Hungary,2014,1952,58779,-56827
DEU,Germany,HUN,Hungary,2015,1968,58096,-56128
DEU,Germany,HUN,Hungary,2016,2282,51592,-49310
DEU,Germany,HUN,Hungary,2017,2503,48117,-45614
DEU,Germany,ISL,Iceland,2008,320,229,91
DEU,Germany,ISL,Iceland,2009,204,292,-88
DEU,Germany,ISL,Iceland,2010,192,270,-78
DEU,Germany,ISL,Iceland,2011,155,339,-184
DEU,Germany,ISL,Iceland,2012,107,221,-114
DEU,Germany,ISL,Iceland,2013,216,227,-11
DEU,Germany,ISL,Iceland,2014,214,293,-79
DEU,Germany,ISL,Iceland,2015,191,270,-79
DEU,Germany,ISL,Iceland,2016,258,270,-12
DEU,Germany,ISL,Iceland,2017,320,273,47
DEU,Germany,ITA,Italy,2008,3132,20087,-16955
DEU,Germany,ITA,Italy,2009,2538,22235,-19697
DEU,Germany,ITA,Italy,2010,2099,23894,-21795
DEU,Germany,ITA,Italy,2011,2034,28070,-26036
DEU,Germany,ITA,Italy,2012,1877,36896,-35019
DEU,Germany,ITA,Italy,2013,1668,47485,-45817
DEU,Germany,ITA,Italy,2014,1435,56700,-55265
DEU,Germany,ITA,Italy,2015,1449,57191,-55742
DEU,Germany,ITA,Italy,2016,1528,52564,-51036
DEU,Germany,ITA,Italy,2017,1745,51471,-49726
DEU,Germany,JPN,Japan,2008,4847,5847,-1000
DEU,Germany,JPN,Japan,2009,4499,5482,-983
DEU,Germany,JPN,Japan,2010,4277,5567,-1290
DEU,Germany,JPN,Japan,2011,3676,6827,-3151
DEU,Germany,JPN,Japan,2012,4141,6629,-2488
DEU,Germany,JPN,Japan,2013,4063,6755,-2692
DEU,Germany,JPN,Japan,2014,4322,6747,-2425
DEU,Germany,JPN,Japan,2015,4759,6886,-2127
DEU,Germany,JPN,Japan,2016,5333,7002,-1669
DEU,Germany,JPN,Japan,2017,5149,6942,-1793
DEU,Germany,KOR,Korea,2008,963,3915,-2952
DEU,Germany,KOR,Korea,2009,927,3771,-2844
DEU,Germany,KOR,Korea,2010,1087,4096,-3009
DEU,Germany,KOR,Korea,2011,1017,4775,-3758
DEU,Germany,KOR,Korea,2012,1241,4927,-3686
DEU,Germany,KOR,Korea,2013,1264,5524,-4260
DEU,Germany,KOR,Korea,2014,1326,6261,-4935
DEU,Germany,KOR,Korea,2015,1277,7229,-5952
DEU,Germany,KOR,Korea,2016,1422,7682,-6260
DEU,Germany,KOR,Korea,2017,1334,8154,-6820
DEU,Germany,LUX,Luxembourg,2008,1130,2231,-1101
DEU,Germany,LUX,Luxembourg,2009,1008,1985,-977
DEU,Germany,LUX,Luxembourg,2010,1008,1903,-895
DEU,Germany,LUX,Luxembourg,2011,1110,1963,-853
DEU,Germany,LUX,Luxembourg,2012,1006,2003,-997
DEU,Germany,LUX,Luxembourg,2013,1037,2253,-1216
DEU,Germany,LUX,Luxembourg,2014,1023,2390,-1367
DEU,Germany,LUX,Luxembourg,2015,1020,2680,-1660
DEU,Germany,LUX,Luxembourg,2016,945,2799,-1854
DEU,Germany,LUX,Luxembourg,2017,1026,2574,-1548
DEU,Germany,MEX,Mexico,2008,311,2899,-2588
DEU,Germany,MEX,Mexico,2009,323,2777,-2454
DEU,Germany,MEX,Mexico,2010,338,3008,-2670
DEU,Germany,MEX,Mexico,2011,268,3495,-3227
DEU,Germany,MEX,Mexico,2012,261,3485,-3224
DEU,Germany,MEX,Mexico,2013,1102,3619,-2517
DEU,Germany,MEX,Mexico,2014,625,4763,-4138
DEU,Germany,MEX,Mexico,2015,481,4592,-4111
DEU,Germany,MEX,Mexico,2016,554,4500,-3946
DEU,Germany,MEX,Mexico,2017,400,4888,-4488
DEU,Germany,NLD,Netherlands,2008,9010,11203,-2193
DEU,Germany,NLD,Netherlands,2009,8714,9441,-727
DEU,Germany,NLD,Netherlands,2010,9812,9143,669
DEU,Germany,NLD,Netherlands,2011,9604,9287,317
DEU,Germany,NLD,Netherlands,2012,8730,9164,-434
DEU,Germany,NLD,Netherlands,2013,8056,10037,-1981
DEU,Germany,NLD,Netherlands,2014,8191,10197,-2006
DEU,Germany,NLD,Netherlands,2015,8622,10512,-1890
DEU,Germany,NLD,Netherlands,2016,9449,10238,-789
DEU,Germany,NLD,Netherlands,2017,10541,9605,936
DEU,Germany,NZL,New Zealand,2008,2611,486,2125
DEU,Germany,NZL,New Zealand,2009,2588,550,2038
DEU,Germany,NZL,New Zealand,2010,2400,598,1802
DEU,Germany,NZL,New Zealand,2011,2722,606,2116
DEU,Germany,NZL,New Zealand,2012,2606,646,1960
DEU,Germany,NZL,New Zealand,2013,3338,662,2676
DEU,Germany,NZL,New Zealand,2014,3685,634,3051
DEU,Germany,NZL,New Zealand,2015,4009,711,3298
DEU,Germany,NZL,New Zealand,2016,4610,693,3917
DEU,Germany,NZL,New Zealand,2017,4496,716,3780
DEU,Germany,NOR,Norway,2008,4325,762,3563
DEU,Germany,NOR,Norway,2009,2818,631,2187
DEU,Germany,NOR,Norway,2010,2678,767,1911
DEU,Germany,NOR,Norway,2011,2315,840,1475
DEU,Germany,NOR,Norway,2012,1765,855,910
DEU,Germany,NOR,Norway,2013,1597,976,621
DEU,Germany,NOR,Norway,2014,1542,897,645
DEU,Germany,NOR,Norway,2015,1311,1022,289
DEU,Germany,NOR,Norway,2016,1260,1147,113
DEU,Germany,NOR,Norway,2017,1157,1013,144
DEU,Germany,POL,Poland,2008,2927,119867,-116940
DEU,Germany,POL,Poland,2009,1681,112027,-110346
DEU,Germany,POL,Poland,2010,1774,115587,-113813
DEU,Germany,POL,Poland,2011,1915,164705,-162790
DEU,Germany,POL,Poland,2012,2281,177758,-175477
DEU,Germany,POL,Poland,2013,1981,190424,-188443
DEU,Germany,POL,Poland,2014,1981,192172,-190191
DEU,Germany,POL,Poland,2015,2321,190834,-188513
DEU,Germany,POL,Poland,2016,2334,160677,-158343
DEU,Germany,POL,Poland,2017,2242,149663,-147421
DEU,Germany,PRT,Portugal,2008,1135,5911,-4776
DEU,Germany,PRT,Portugal,2009,1096,6779,-5683
DEU,Germany,PRT,Portugal,2010,998,6513,-5515
DEU,Germany,PRT,Portugal,2011,802,8297,-7495
DEU,Germany,PRT,Portugal,2012,649,11820,-11171
DEU,Germany,PRT,Portugal,2013,761,13635,-12874
DEU,Germany,PRT,Portugal,2014,1003,11394,-10391
DEU,Germany,PRT,Portugal,2015,1024,10145,-9121
DEU,Germany,PRT,Portugal,2016,1587,9755,-8168
DEU,Germany,PRT,Portugal,2017,1913,8952,-7039
DEU,Germany,SVK,Slovak Republic,2008,754,8749,-7995
DEU,Germany,SVK,Slovak Republic,2009,387,8499,-8112
DEU,Germany,SVK,Slovak Republic,2010,247,8590,-8343
DEU,Germany,SVK,Slovak Republic,2011,191,12224,-12033
DEU,Germany,SVK,Slovak Republic,2012,129,13892,-13763
DEU,Germany,SVK,Slovak Republic,2013,90,15038,-14948
DEU,Germany,SVK,Slovak Republic,2014,76,15518,-15442
DEU,Germany,SVK,Slovak Republic,2015,147,14541,-14394
DEU,Germany,SVK,Slovak Republic,2016,131,12507,-12376
DEU,Germany,SVK,Slovak Republic,2017,149,12239,-12090
DEU,Germany,ESP,Spain,2008,11282,7778,3504
DEU,Germany,ESP,Spain,2009,9268,8965,303
DEU,Germany,ESP,Spain,2010,8319,10657,-2338
DEU,Germany,ESP,Spain,2011,8263,16168,-7905
DEU,Germany,ESP,Spain,2012,8005,23345,-15340
DEU,Germany,ESP,Spain,2013,7241,28980,-21739
DEU,Germany,ESP,Spain,2014,6823,27072,-20249
DEU,Germany,ESP,Spain,2015,6745,23598,-16853
DEU,Germany,ESP,Spain,2016,7253,21922,-14669
DEU,Germany,ESP,Spain,2017,9097,18537,-9440
DEU,Germany,SWE,Sweden,2008,3405,2192,1213
DEU,Germany,SWE,Sweden,2009,2773,2218,555
DEU,Germany,SWE,Sweden,2010,2202,2280,-78
DEU,Germany,SWE,Sweden,2011,2205,2479,-274
DEU,Germany,SWE,Sweden,2012,2150,2615,-465
DEU,Germany,SWE,Sweden,2013,2196,2665,-469
DEU,Germany,SWE,Sweden,2014,2165,2814,-649
DEU,Germany,SWE,Sweden,2015,2293,2763,-470
DEU,Germany,SWE,Sweden,2016,2485,2541,-56
DEU,Germany,SWE,Sweden,2017,2441,2610,-169
DEU,Germany,CHE,Switzerland,2008,46385,3626,42759
DEU,Germany,CHE,Switzerland,2009,33941,3569,30372
DEU,Germany,CHE,Switzerland,2010,30745,3614,27131
DEU,Germany,CHE,Switzerland,2011,30506,3856,26650
DEU,Germany,CHE,Switzerland,2012,27123,4096,23027
DEU,Germany,CHE,Switzerland,2013,26640,4176,22464
DEU,Germany,CHE,Switzerland,2014,23752,4245,19507
DEU,Germany,CHE,Switzerland,2015,22137,4282,17855
DEU,Germany,CHE,Switzerland,2016,20891,4287,16604
DEU,Germany,CHE,Switzerland,2017,19694,4225,15469
DEU,Germany,TUR,Turkey,2010,1642,27564,-25922
DEU,Germany,TUR,Turkey,2016,8606,28639,-20033
DEU,Germany,TUR,Turkey,2017,8440,33655,-25215
DEU,Germany,GBR,United Kingdom,2008,18000,8592,9408
DEU,Germany,GBR,United Kingdom,2009,11000,8635,2365
DEU,Germany,GBR,United Kingdom,2010,7000,9173,-2173
DEU,Germany,GBR,United Kingdom,2011,13000,9767,3233
DEU,Germany,GBR,United Kingdom,2012,8000,10466,-2466
DEU,Germany,GBR,United Kingdom,2013,10000,10836,-836
DEU,Germany,GBR,United Kingdom,2014,13000,10796,2204
DEU,Germany,GBR,United Kingdom,2015,10000,10726,-726
DEU,Germany,GBR,United Kingdom,2016,9000,11489,-2489
DEU,Germany,GBR,United Kingdom,2017,12000,11456,544
DEU,Germany,USA,United States,2008,7091,17542,-10451
DEU,Germany,USA,United States,2009,7583,17706,-10123
DEU,Germany,USA,United States,2010,6888,18262,-11374
DEU,Germany,USA,United States,2011,6125,20149,-14024
DEU,Germany,USA,United States,2012,5812,19563,-13751
DEU,Germany,USA,United States,2013,6032,20531,-14499
DEU,Germany,USA,United States,2014,5584,20468,-14884
DEU,Germany,USA,United States,2015,5436,21115,-15679
DEU,Germany,USA,United States,2016,5306,20736,-15430
DEU,Germany,USA,United States,2017,4662,21121,-16459
DEU,Germany,CHL,Chile,2008,346,868,-522
DEU,Germany,CHL,Chile,2009,316,810,-494
DEU,Germany,CHL,Chile,2010,341,931,-590
DEU,Germany,CHL,Chile,2011,394,944,-550
DEU,Germany,CHL,Chile,2012,374,945,-571
DEU,Germany,CHL,Chile,2013,379,892,-513
DEU,Germany,CHL,Chile,2014,517,997,-480
DEU,Germany,CHL,Chile,2015,420,1389,-969
DEU,Germany,CHL,Chile,2016,262,1515,-1253
DEU,Germany,EST,Estonia,2008,123,621,-498
DEU,Germany,EST,Estonia,2009,104,842,-738
DEU,Germany,EST,Estonia,2010,34,1110,-1076
DEU,Germany,EST,Estonia,2011,8,1419,-1411
DEU,Germany,EST,Estonia,2012,10,1290,-1280
DEU,Germany,EST,Estonia,2013,9,1336,-1327
DEU,Germany,EST,Estonia,2014,10,1120,-1110
DEU,Germany,EST,Estonia,2015,402,991,-589
DEU,Germany,EST,Estonia,2016,456,882,-426
DEU,Germany,EST,Estonia,2017,495,806,-311
DEU,Germany,ISR,Israel,2008,86,1268,-1182
DEU,Germany,ISR,Israel,2009,96,1491,-1395
DEU,Germany,ISR,Israel,2010,119,1651,-1532
DEU,Germany,ISR,Israel,2011,97,1615,-1518
DEU,Germany,ISR,Israel,2012,100,1847,-1747
DEU,Germany,ISR,Israel,2013,79,2002,-1923
DEU,Germany,ISR,Israel,2014,91,2108,-2017
DEU,Germany,ISR,Israel,2015,114,2251,-2137
DEU,Germany,ISR,Israel,2016,138,2019,-1881
DEU,Germany,ISR,Israel,2017,155,2083,-1928
DEU,Germany,SVN,Slovenia,2008,221,1218,-997
DEU,Germany,SVN,Slovenia,2009,194,1242,-1048
DEU,Germany,SVN,Slovenia,2010,8,1591,-1583
DEU,Germany,SVN,Slovenia,2011,202,2486,-2284
DEU,Germany,SVN,Slovenia,2012,254,3592,-3338
DEU,Germany,SVN,Slovenia,2013,248,4331,-4083
DEU,Germany,SVN,Slovenia,2014,246,4515,-4269
DEU,Germany,SVN,Slovenia,2015,286,4754,-4468
DEU,Germany,SVN,Slovenia,2016,253,3348,-3095
DEU,Germany,SVN,Slovenia,2017,291,3074,-2783
GHA,Ghana,AUS,Australia,2008,187,26,161
GHA,Ghana,AUS,Australia,2009,172,24,148
GHA,Ghana,AUS,Australia,2010,263,30,233
GHA,Ghana,AUS,Australia,2011,204,38,166
GHA,Ghana,AUS,Australia,2012,251,35,216
GHA,Ghana,AUS,Australia,2013,256,42,214
GHA,Ghana,AUS,Australia,2014,254,38,216
GHA,Ghana,AUS,Australia,2015,231,0,231
GHA,Ghana,AUS,Australia,2016,240,0,240
GHA,Ghana,AUS,Australia,2017,235,0,235
GHA,Ghana,AUT,Austria,2008,72,69,3
GHA,Ghana,AUT,Austria,2009,69,73,-4
GHA,Ghana,AUT,Austria,2010,66,56,10
GHA,Ghana,AUT,Austria,2011,104,88,16
GHA,Ghana,AUT,Austria,2012,99,60,39
GHA,Ghana,AUT,Austria,2013,131,58,73
GHA,Ghana,AUT,Austria,2014,141,66,75
GHA,Ghana,AUT,Austria,2015,153,73,80
GHA,Ghana,AUT,Austria,2016,155,88,67
GHA,Ghana,AUT,Austria,2017,124,108,16
GHA,Ghana,BEL,Belgium,2008,501,0,501
GHA,Ghana,BEL,Belgium,2009,454,0,454
GHA,Ghana,BEL,Belgium,2010,595,36,559
GHA,Ghana,BEL,Belgium,2011,711,0,711
GHA,Ghana,BEL,Belgium,2012,581,80,501
GHA,Ghana,BEL,Belgium,2013,641,184,457
GHA,Ghana,BEL,Belgium,2014,525,119,406
GHA,Ghana,BEL,Belgium,2015,529,125,404
GHA,Ghana,BEL,Belgium,2016,436,83,353
GHA,Ghana,BEL,Belgium,2017,399,72,327
GHA,Ghana,CAN,Canada,2008,629,0,629
GHA,Ghana,CAN,Canada,2009,658,0,658
GHA,Ghana,CAN,Canada,2010,802,0,802
GHA,Ghana,CAN,Canada,2011,528,0,528
GHA,Ghana,CAN,Canada,2012,531,0,531
GHA,Ghana,CAN,Canada,2013,518,0,518
GHA,Ghana,CAN,Canada,2014,518,0,518
GHA,Ghana,CAN,Canada,2015,369,0,369
GHA,Ghana,CAN,Canada,2016,485,0,485
GHA,Ghana,CAN,Canada,2017,685,0,685
GHA,Ghana,CZE,Czech Republic,2008,24,0,24
GHA,Ghana,CZE,Czech Republic,2009,10,1,9
GHA,Ghana,CZE,Czech Republic,2010,6,0,6
GHA,Ghana,CZE,Czech Republic,2011,14,0,14
GHA,Ghana,CZE,Czech Republic,2012,30,8,22
GHA,Ghana,CZE,Czech Republic,2013,41,17,24
GHA,Ghana,CZE,Czech Republic,2014,74,10,64
GHA,Ghana,CZE,Czech Republic,2015,119,23,96
GHA,Ghana,CZE,Czech Republic,2016,130,31,99
GHA,Ghana,CZE,Czech Republic,2017,40,64,-24
GHA,Ghana,DNK,Denmark,2008,87,40,47
GHA,Ghana,DNK,Denmark,2009,80,53,27
GHA,Ghana,DNK,Denmark,2010,124,72,52
GHA,Ghana,DNK,Denmark,2011,89,66,23
GHA,Ghana,DNK,Denmark,2012,89,77,12
GHA,Ghana,DNK,Denmark,2013,129,90,39
GHA,Ghana,DNK,Denmark,2014,105,73,32
GHA,Ghana,DNK,Denmark,2015,153,86,67
GHA,Ghana,DNK,Denmark,2016,101,83,18
GHA,Ghana,DNK,Denmark,2017,119,118,1
GHA,Ghana,FIN,Finland,2008,159,19,140
GHA,Ghana,FIN,Finland,2009,76,15,61
GHA,Ghana,FIN,Finland,2010,67,10,57
GHA,Ghana,FIN,Finland,2011,72,3,69
GHA,Ghana,FIN,Finland,2012,160,20,140
GHA,Ghana,FIN,Finland,2013,136,13,123
GHA,Ghana,FIN,Finland,2014,159,14,145
GHA,Ghana,FIN,Finland,2015,140,9,131
GHA,Ghana,FIN,Finland,2016,116,19,97
GHA,Ghana,FIN,Finland,2017,116,18,98
GHA,Ghana,FRA,France,2008,182,0,182
GHA,Ghana,FRA,France,2009,181,0,181
GHA,Ghana,FRA,France,2010,231,0,231
GHA,Ghana,FRA,France,2011,210,0,210
GHA,Ghana,FRA,France,2012,209,0,209
GHA,Ghana,FRA,France,2013,260,0,260
GHA,Ghana,FRA,France,2014,255,0,255
GHA,Ghana,FRA,France,2015,214,0,214
GHA,Ghana,FRA,France,2016,203,0,203
GHA,Ghana,FRA,France,2017,199,0,199
GHA,Ghana,DEU,Germany,2008,976,995,-19
GHA,Ghana,DEU,Germany,2009,1427,1117,310
GHA,Ghana,DEU,Germany,2010,1521,1016,505
GHA,Ghana,DEU,Germany,2011,2016,931,1085
GHA,Ghana,DEU,Germany,2012,2356,1218,1138
GHA,Ghana,DEU,Germany,2013,3014,1381,1633
GHA,Ghana,DEU,Germany,2014,3544,1302,2242
GHA,Ghana,DEU,Germany,2015,4983,1538,3445
GHA,Ghana,DEU,Germany,2016,3890,1987,1903
GHA,Ghana,DEU,Germany,2017,3785,2197,1588
GHA,Ghana,HUN,Hungary,2008,15,0,15
GHA,Ghana,HUN,Hungary,2009,11,0,11
GHA,Ghana,HUN,Hungary,2010,10,5,5
GHA,Ghana,HUN,Hungary,2011,11,1,10
GHA,Ghana,HUN,Hungary,2012,10,3,7
GHA,Ghana,HUN,Hungary,2013,10,3,7
GHA,Ghana,HUN,Hungary,2014,9,3,6
GHA,Ghana,HUN,Hungary,2015,21,6,15
GHA,Ghana,HUN,Hungary,2016,58,2,56
GHA,Ghana,HUN,Hungary,2017,79,0,79
GHA,Ghana,ISL,Iceland,2008,4,4,0
GHA,Ghana,ISL,Iceland,2009,5,3,2
GHA,Ghana,ISL,Iceland,2010,5,4,1
GHA,Ghana,ISL,Iceland,2011,4,1,3
GHA,Ghana,ISL,Iceland,2012,10,1,9
GHA,Ghana,ISL,Iceland,2013,7,4,3
GHA,Ghana,ISL,Iceland,2014,12,8,4
GHA,Ghana,ISL,Iceland,2015,10,3,7
GHA,Ghana,ISL,Iceland,2016,19,8,11
GHA,Ghana,ISL,Iceland,2017,38,9,29
GHA,Ghana,ITA,Italy,2008,4440,146,4294
GHA,Ghana,ITA,Italy,2009,3177,178,2999
GHA,Ghana,ITA,Italy,2010,3627,253,3374
GHA,Ghana,ITA,Italy,2011,3134,208,2926
GHA,Ghana,ITA,Italy,2012,4007,210,3797
GHA,Ghana,ITA,Italy,2013,3503,233,3270
GHA,Ghana,ITA,Italy,2014,2353,253,2100
GHA,Ghana,ITA,Italy,2015,2981,245,2736
GHA,Ghana,ITA,Italy,2016,4094,0,4094
GHA,Ghana,ITA,Italy,2017,5968,236,5732
GHA,Ghana,JPN,Japan,2008,276,222,54
GHA,Ghana,JPN,Japan,2009,223,141,82
GHA,Ghana,JPN,Japan,2010,309,274,35
GHA,Ghana,JPN,Japan,2011,278,248,30
GHA,Ghana,JPN,Japan,2012,362,306,56
GHA,Ghana,JPN,Japan,2013,336,276,60
GHA,Ghana,JPN,Japan,2014,296,221,75
GHA,Ghana,JPN,Japan,2015,298,208,90
GHA,Ghana,JPN,Japan,2016,422,285,137
GHA,Ghana,JPN,Japan,2017,311,225,86
GHA,Ghana,KOR,Korea,2008,119,262,-143
GHA,Ghana,KOR,Korea,2009,93,236,-143
GHA,Ghana,KOR,Korea,2010,120,203,-83
GHA,Ghana,KOR,Korea,2011,132,212,-80
GHA,Ghana,KOR,Korea,2012,122,146,-24
GHA,Ghana,KOR,Korea,2013,158,119,39
GHA,Ghana,KOR,Korea,2014,173,108,65
GHA,Ghana,KOR,Korea,2015,283,100,183
GHA,Ghana,KOR,Korea,2016,294,138,156
GHA,Ghana,KOR,Korea,2017,389,229,160
GHA,Ghana,LUX,Luxembourg,2008,5,0,5
GHA,Ghana,LUX,Luxembourg,2009,2,2,0
GHA,Ghana,LUX,Luxembourg,2010,0,3,-3
GHA,Ghana,LUX,Luxembourg,2011,1,0,1
GHA,Ghana,LUX,Luxembourg,2012,4,1,3
GHA,Ghana,LUX,Luxembourg,2013,6,1,5
GHA,Ghana,LUX,Luxembourg,2014,5,2,3
GHA,Ghana,LUX,Luxembourg,2015,2,2,0
GHA,Ghana,LUX,Luxembourg,2016,7,3,4
GHA,Ghana,LUX,Luxembourg,2017,3,2,1
GHA,Ghana,MEX,Mexico,2008,2,0,2
GHA,Ghana,MEX,Mexico,2009,2,0,2
GHA,Ghana,MEX,Mexico,2010,3,0,3
GHA,Ghana,MEX,Mexico,2011,7,0,7
GHA,Ghana,MEX,Mexico,2012,4,0,4
GHA,Ghana,MEX,Mexico,2013,6,0,6
GHA,Ghana,MEX,Mexico,2014,3,0,3
GHA,Ghana,MEX,Mexico,2015,3,0,3
GHA,Ghana,MEX,Mexico,2016,4,0,4
GHA,Ghana,MEX,Mexico,2017,4,0,4
GHA,Ghana,NLD,Netherlands,2008,655,160,495
GHA,Ghana,NLD,Netherlands,2009,984,120,864
GHA,Ghana,NLD,Netherlands,2010,607,238,369
GHA,Ghana,NLD,Netherlands,2011,602,225,377
GHA,Ghana,NLD,Netherlands,2012,427,209,218
GHA,Ghana,NLD,Netherlands,2013,450,224,226
GHA,Ghana,NLD,Netherlands,2014,381,190,191
GHA,Ghana,NLD,Netherlands,2015,392,166,226
GHA,Ghana,NLD,Netherlands,2016,396,170,226
GHA,Ghana,NLD,Netherlands,2017,471,180,291
GHA,Ghana,NZL,New Zealand,2008,12,3,9
GHA,Ghana,NZL,New Zealand,2009,14,4,10
GHA,Ghana,NZL,New Zealand,2010,12,3,9
GHA,Ghana,NZL,New Zealand,2011,19,6,13
GHA,Ghana,NZL,New Zealand,2012,17,11,6
GHA,Ghana,NZL,New Zealand,2013,21,6,15
GHA,Ghana,NZL,New Zealand,2014,24,1,23
GHA,Ghana,NZL,New Zealand,2015,22,6,16
GHA,Ghana,NZL,New Zealand,2016,51,15,36
GHA,Ghana,NZL,New Zealand,2017,31,23,8
GHA,Ghana,NOR,Norway,2008,142,53,89
GHA,Ghana,NOR,Norway,2009,112,73,39
GHA,Ghana,NOR,Norway,2010,118,77,41
GHA,Ghana,NOR,Norway,2011,121,118,3
GHA,Ghana,NOR,Norway,2012,136,66,70
GHA,Ghana,NOR,Norway,2013,142,46,96
GHA,Ghana,NOR,Norway,2014,159,91,68
GHA,Ghana,NOR,Norway,2015,156,101,55
GHA,Ghana,NOR,Norway,2016,111,118,-7
GHA,Ghana,NOR,Norway,2017,109,65,44
GHA,Ghana,POL,Poland,2009,51,0,51
GHA,Ghana,POL,Poland,2010,50,0,50
GHA,Ghana,POL,Poland,2011,45,0,45
GHA,Ghana,POL,Poland,2012,45,0,45
GHA,Ghana,POL,Poland,2013,43,0,43
GHA,Ghana,POL,Poland,2014,23,0,23
GHA,Ghana,POL,Poland,2015,35,0,35
GHA,Ghana,POL,Poland,2016,41,0,41
GHA,Ghana,POL,Poland,2017,44,0,44
GHA,Ghana,SVK,Slovak Republic,2008,1,1,0
GHA,Ghana,SVK,Slovak Republic,2009,1,0,1
GHA,Ghana,SVK,Slovak Republic,2010,1,0,1
GHA,Ghana,SVK,Slovak Republic,2012,2,0,2
GHA,Ghana,SVK,Slovak Republic,2013,1,0,1
GHA,Ghana,SVK,Slovak Republic,2016,1,0,1
GHA,Ghana,ESP,Spain,2008,1912,989,923
GHA,Ghana,ESP,Spain,2009,1356,1372,-16
GHA,Ghana,ESP,Spain,2010,1240,1614,-374
GHA,Ghana,ESP,Spain,2011,1303,2108,-805
GHA,Ghana,ESP,Spain,2012,1108,2068,-960
GHA,Ghana,ESP,Spain,2013,1059,2061,-1002
GHA,Ghana,ESP,Spain,2014,878,1074,-196
GHA,Ghana,ESP,Spain,2015,877,985,-108
GHA,Ghana,ESP,Spain,2016,955,786,169
GHA,Ghana,ESP,Spain,2017,1233,924,309
GHA,Ghana,SWE,Sweden,2008,158,55,103
GHA,Ghana,SWE,Sweden,2009,201,23,178
GHA,Ghana,SWE,Sweden,2010,212,35,177
GHA,Ghana,SWE,Sweden,2011,216,45,171
GHA,Ghana,SWE,Sweden,2012,227,53,174
GHA,Ghana,SWE,Sweden,2013,209,35,174
GHA,Ghana,SWE,Sweden,2014,211,69,142
GHA,Ghana,SWE,Sweden,2015,207,84,123
GHA,Ghana,SWE,Sweden,2016,212,39,173
GHA,Ghana,SWE,Sweden,2017,201,31,170
GHA,Ghana,CHE,Switzerland,2010,92,31,61
GHA,Ghana,CHE,Switzerland,2011,75,32,43
GHA,Ghana,CHE,Switzerland,2012,84,31,53
GHA,Ghana,CHE,Switzerland,2013,98,25,73
GHA,Ghana,CHE,Switzerland,2014,68,40,28
GHA,Ghana,CHE,Switzerland,2015,53,20,33
GHA,Ghana,CHE,Switzerland,2016,80,32,48
GHA,Ghana,CHE,Switzerland,2017,89,30,59
GHA,Ghana,TUR,Turkey,2010,21,0,21
GHA,Ghana,TUR,Turkey,2016,326,66,260
GHA,Ghana,TUR,Turkey,2017,477,161,316
GHA,Ghana,GBR,United Kingdom,2011,2000,0,2000
GHA,Ghana,GBR,United Kingdom,2012,1000,0,1000
GHA,Ghana,GBR,United Kingdom,2013,1000,0,1000
GHA,Ghana,GBR,United Kingdom,2014,1000,0,1000
GHA,Ghana,GBR,United Kingdom,2015,2000,1000,1000
GHA,Ghana,USA,United States,2008,8195,0,8195
GHA,Ghana,USA,United States,2009,8401,0,8401
GHA,Ghana,USA,United States,2010,7429,0,7429
GHA,Ghana,USA,United States,2011,8798,0,8798
GHA,Ghana,USA,United States,2012,10592,0,10592
GHA,Ghana,USA,United States,2013,10265,0,10265
GHA,Ghana,USA,United States,2014,7115,0,7115
GHA,Ghana,USA,United States,2015,6186,0,6186
GHA,Ghana,USA,United States,2016,6949,0,6949
GHA,Ghana,USA,United States,2017,8455,0,8455
GHA,Ghana,CHL,Chile,2008,6,0,6
GHA,Ghana,CHL,Chile,2009,0,0,0
GHA,Ghana,CHL,Chile,2010,7,0,7
GHA,Ghana,CHL,Chile,2011,1,0,1
GHA,Ghana,CHL,Chile,2012,4,0,4
GHA,Ghana,CHL,Chile,2013,5,0,5
GHA,Ghana,CHL,Chile,2014,4,0,4
GHA,Ghana,CHL,Chile,2015,12,0,12
GHA,Ghana,CHL,Chile,2016,5,0,5
GHA,Ghana,EST,Estonia,2008,3,0,3
GHA,Ghana,EST,Estonia,2009,0,0,0
GHA,Ghana,EST,Estonia,2010,0,0,0
GHA,Ghana,EST,Estonia,2011,0,0,0
GHA,Ghana,EST,Estonia,2012,0,0,0
GHA,Ghana,EST,Estonia,2013,1,0,1
GHA,Ghana,EST,Estonia,2014,0,0,0
GHA,Ghana,EST,Estonia,2015,6,0,6
GHA,Ghana,EST,Estonia,2016,4,0,4
GHA,Ghana,EST,Estonia,2017,19,0,19
GHA,Ghana,SVN,Slovenia,2008,2,0,2
GHA,Ghana,SVN,Slovenia,2009,1,0,1
GHA,Ghana,SVN,Slovenia,2010,2,0,2
GHA,Ghana,SVN,Slovenia,2011,5,0,5
GHA,Ghana,SVN,Slovenia,2012,1,0,1
GHA,Ghana,SVN,Slovenia,2013,1,0,1
GHA,Ghana,SVN,Slovenia,2015,4,0,4
GHA,Ghana,SVN,Slovenia,2016,1,0,1
GHA,Ghana,SVN,Slovenia,2017,6,0,6
GRC,Greece,AUS,Australia,2008,123,0,123
GRC,Greece,AUS,Australia,2009,148,0,148
GRC,Greece,AUS,Australia,2010,123,0,123
GRC,Greece,AUS,Australia,2011,124,0,124
GRC,Greece,AUS,Australia,2012,296,0,296
GRC,Greece,AUS,Australia,2013,531,0,531
GRC,Greece,AUS,Australia,2014,604,0,604
GRC,Greece,AUS,Australia,2015,490,0,490
GRC,Greece,AUS,Australia,2016,399,0,399
GRC,Greece,AUS,Australia,2017,410,0,410
GRC,Greece,AUT,Austria,2008,364,0,364
GRC,Greece,AUT,Austria,2009,430,0,430
GRC,Greece,AUT,Austria,2010,519,0,519
GRC,Greece,AUT,Austria,2011,813,0,813
GRC,Greece,AUT,Austria,2012,1201,0,1201
GRC,Greece,AUT,Austria,2013,1362,0,1362
GRC,Greece,AUT,Austria,2014,1109,0,1109
GRC,Greece,AUT,Austria,2015,1161,0,1161
GRC,Greece,AUT,Austria,2016,1088,0,1088
GRC,Greece,AUT,Austria,2017,1172,0,1172
GRC,Greece,BEL,Belgium,2008,755,0,755
GRC,Greece,BEL,Belgium,2009,725,0,725
GRC,Greece,BEL,Belgium,2010,751,0,751
GRC,Greece,BEL,Belgium,2011,1099,0,1099
GRC,Greece,BEL,Belgium,2012,1510,0,1510
GRC,Greece,BEL,Belgium,2013,1343,0,1343
GRC,Greece,BEL,Belgium,2014,1203,0,1203
GRC,Greece,BEL,Belgium,2015,1250,0,1250
GRC,Greece,BEL,Belgium,2016,1132,0,1132
GRC,Greece,BEL,Belgium,2017,1341,0,1341
GRC,Greece,CAN,Canada,2008,106,0,106
GRC,Greece,CAN,Canada,2009,118,0,118
GRC,Greece,CAN,Canada,2010,101,0,101
GRC,Greece,CAN,Canada,2011,102,0,102
GRC,Greece,CAN,Canada,2012,146,0,146
GRC,Greece,CAN,Canada,2013,299,0,299
GRC,Greece,CAN,Canada,2014,373,0,373
GRC,Greece,CAN,Canada,2015,477,0,477
GRC,Greece,CAN,Canada,2016,435,0,435
GRC,Greece,CAN,Canada,2017,410,0,410
GRC,Greece,CZE,Czech Republic,2008,63,0,63
GRC,Greece,CZE,Czech Republic,2009,42,0,42
GRC,Greece,CZE,Czech Republic,2010,41,0,41
GRC,Greece,CZE,Czech Republic,2011,49,0,49
GRC,Greece,CZE,Czech Republic,2012,81,0,81
GRC,Greece,CZE,Czech Republic,2013,119,0,119
GRC,Greece,CZE,Czech Republic,2014,111,0,111
GRC,Greece,CZE,Czech Republic,2015,96,0,96
GRC,Greece,CZE,Czech Republic,2016,150,0,150
GRC,Greece,CZE,Czech Republic,2017,179,0,179
GRC,Greece,DNK,Denmark,2008,113,0,113
GRC,Greece,DNK,Denmark,2009,135,0,135
GRC,Greece,DNK,Denmark,2010,144,0,144
GRC,Greece,DNK,Denmark,2011,258,0,258
GRC,Greece,DNK,Denmark,2012,367,0,367
GRC,Greece,DNK,Denmark,2013,437,0,437
GRC,Greece,DNK,Denmark,2014,395,0,395
GRC,Greece,DNK,Denmark,2015,420,0,420
GRC,Greece,DNK,Denmark,2016,504,0,504
GRC,Greece,DNK,Denmark,2017,481,0,481
GRC,Greece,FIN,Finland,2008,51,0,51
GRC,Greece,FIN,Finland,2009,35,0,35
GRC,Greece,FIN,Finland,2010,51,0,51
GRC,Greece,FIN,Finland,2011,85,0,85
GRC,Greece,FIN,Finland,2012,117,0,117
GRC,Greece,FIN,Finland,2013,125,0,125
GRC,Greece,FIN,Finland,2014,145,0,145
GRC,Greece,FIN,Finland,2015,119,0,119
GRC,Greece,FIN,Finland,2016,262,0,262
GRC,Greece,FIN,Finland,2017,231,0,231
GRC,Greece,FRA,France,2008,0,0,0
GRC,Greece,FRA,France,2009,0,0,0
GRC,Greece,FRA,France,2010,0,0,0
GRC,Greece,FRA,France,2011,0,0,0
GRC,Greece,FRA,France,2012,0,0,0
GRC,Greece,FRA,France,2013,1035,0,1035
GRC,Greece,FRA,France,2014,846,0,846
GRC,Greece,FRA,France,2015,908,0,908
GRC,Greece,FRA,France,2016,951,0,951
GRC,Greece,FRA,France,2017,1169,0,1169
GRC,Greece,DEU,Germany,2008,8266,0,8266
GRC,Greece,DEU,Germany,2009,8574,0,8574
GRC,Greece,DEU,Germany,2010,12256,0,12256
GRC,Greece,DEU,Germany,2011,23043,0,23043
GRC,Greece,DEU,Germany,2012,32660,0,32660
GRC,Greece,DEU,Germany,2013,32088,0,32088
GRC,Greece,DEU,Germany,2014,28752,0,28752
GRC,Greece,DEU,Germany,2015,28256,0,28256
GRC,Greece,DEU,Germany,2016,27120,0,27120
GRC,Greece,DEU,Germany,2017,26128,0,26128
GRC,Greece,HUN,Hungary,2008,50,0,50
GRC,Greece,HUN,Hungary,2009,44,0,44
GRC,Greece,HUN,Hungary,2010,39,0,39
GRC,Greece,HUN,Hungary,2011,63,0,63
GRC,Greece,HUN,Hungary,2012,64,0,64
GRC,Greece,HUN,Hungary,2013,71,0,71
GRC,Greece,HUN,Hungary,2014,62,0,62
GRC,Greece,HUN,Hungary,2015,92,0,92
GRC,Greece,HUN,Hungary,2016,97,0,97
GRC,Greece,HUN,Hungary,2017,96,0,96
GRC,Greece,ISL,Iceland,2008,4,0,4
GRC,Greece,ISL,Iceland,2009,8,0,8
GRC,Greece,ISL,Iceland,2010,5,0,5
GRC,Greece,ISL,Iceland,2011,8,0,8
GRC,Greece,ISL,Iceland,2012,5,0,5
GRC,Greece,ISL,Iceland,2013,12,0,12
GRC,Greece,ISL,Iceland,2014,10,0,10
GRC,Greece,ISL,Iceland,2015,14,0,14
GRC,Greece,ISL,Iceland,2016,30,0,30
GRC,Greece,ISL,Iceland,2017,73,0,73
GRC,Greece,ITA,Italy,2008,413,0,413
GRC,Greece,ITA,Italy,2009,400,0,400
GRC,Greece,ITA,Italy,2010,362,0,362
GRC,Greece,ITA,Italy,2011,440,0,440
GRC,Greece,ITA,Italy,2012,561,0,561
GRC,Greece,ITA,Italy,2013,582,0,582
GRC,Greece,ITA,Italy,2014,458,0,458
GRC,Greece,ITA,Italy,2015,457,0,457
GRC,Greece,ITA,Italy,2016,454,0,454
GRC,Greece,ITA,Italy,2017,535,0,535
GRC,Greece,JPN,Japan,2008,86,0,86
GRC,Greece,JPN,Japan,2009,106,0,106
GRC,Greece,JPN,Japan,2010,125,0,125
GRC,Greece,JPN,Japan,2011,83,0,83
GRC,Greece,JPN,Japan,2012,73,0,73
GRC,Greece,JPN,Japan,2013,83,0,83
GRC,Greece,JPN,Japan,2014,93,0,93
GRC,Greece,JPN,Japan,2015,96,0,96
GRC,Greece,JPN,Japan,2016,96,0,96
GRC,Greece,JPN,Japan,2017,105,0,105
GRC,Greece,KOR,Korea,2008,139,0,139
GRC,Greece,KOR,Korea,2009,128,0,128
GRC,Greece,KOR,Korea,2010,126,0,126
GRC,Greece,KOR,Korea,2011,155,0,155
GRC,Greece,KOR,Korea,2012,137,0,137
GRC,Greece,KOR,Korea,2013,116,0,116
GRC,Greece,KOR,Korea,2014,114,0,114
GRC,Greece,KOR,Korea,2015,90,0,90
GRC,Greece,KOR,Korea,2016,135,0,135
GRC,Greece,KOR,Korea,2017,144,0,144
GRC,Greece,LUX,Luxembourg,2008,94,0,94
GRC,Greece,LUX,Luxembourg,2009,99,0,99
GRC,Greece,LUX,Luxembourg,2010,122,0,122
GRC,Greece,LUX,Luxembourg,2011,185,0,185
GRC,Greece,LUX,Luxembourg,2012,276,0,276
GRC,Greece,LUX,Luxembourg,2013,264,0,264
GRC,Greece,LUX,Luxembourg,2014,289,0,289
GRC,Greece,LUX,Luxembourg,2015,356,0,356
GRC,Greece,LUX,Luxembourg,2016,436,0,436
GRC,Greece,LUX,Luxembourg,2017,512,0,512
GRC,Greece,MEX,Mexico,2008,8,0,8
GRC,Greece,MEX,Mexico,2009,8,0,8
GRC,Greece,MEX,Mexico,2010,15,0,15
GRC,Greece,MEX,Mexico,2011,9,0,9
GRC,Greece,MEX,Mexico,2012,19,0,19
GRC,Greece,MEX,Mexico,2013,34,0,34
GRC,Greece,MEX,Mexico,2014,16,0,16
GRC,Greece,MEX,Mexico,2015,11,0,11
GRC,Greece,MEX,Mexico,2016,17,0,17
GRC,Greece,MEX,Mexico,2017,14,0,14
GRC,Greece,NLD,Netherlands,2008,1394,0,1394
GRC,Greece,NLD,Netherlands,2009,1373,0,1373
GRC,Greece,NLD,Netherlands,2010,1831,0,1831
GRC,Greece,NLD,Netherlands,2011,2651,0,2651
GRC,Greece,NLD,Netherlands,2012,3319,0,3319
GRC,Greece,NLD,Netherlands,2013,2947,0,2947
GRC,Greece,NLD,Netherlands,2014,2558,0,2558
GRC,Greece,NLD,Netherlands,2015,2806,0,2806
GRC,Greece,NLD,Netherlands,2016,3061,0,3061
GRC,Greece,NLD,Netherlands,2017,3628,0,3628
GRC,Greece,NZL,New Zealand,2008,9,0,9
GRC,Greece,NZL,New Zealand,2009,21,0,21
GRC,Greece,NZL,New Zealand,2010,10,0,10
GRC,Greece,NZL,New Zealand,2011,14,0,14
GRC,Greece,NZL,New Zealand,2012,50,0,50
GRC,Greece,NZL,New Zealand,2013,44,0,44
GRC,Greece,NZL,New Zealand,2014,19,0,19
GRC,Greece,NZL,New Zealand,2015,15,0,15
GRC,Greece,NZL,New Zealand,2016,25,0,25
GRC,Greece,NZL,New Zealand,2017,22,0,22
GRC,Greece,NOR,Norway,2008,118,0,118
GRC,Greece,NOR,Norway,2009,55,0,55
GRC,Greece,NOR,Norway,2010,110,0,110
GRC,Greece,NOR,Norway,2011,258,0,258
GRC,Greece,NOR,Norway,2012,396,0,396
GRC,Greece,NOR,Norway,2013,562,0,562
GRC,Greece,NOR,Norway,2014,519,0,519
GRC,Greece,NOR,Norway,2015,509,0,509
GRC,Greece,NOR,Norway,2016,506,0,506
GRC,Greece,NOR,Norway,2017,511,0,511
GRC,Greece,POL,Poland,2008,63,0,63
GRC,Greece,POL,Poland,2009,66,0,66
GRC,Greece,POL,Poland,2010,68,0,68
GRC,Greece,POL,Poland,2011,69,0,69
GRC,Greece,POL,Poland,2012,106,0,106
GRC,Greece,POL,Poland,2013,138,0,138
GRC,Greece,POL,Poland,2014,138,0,138
GRC,Greece,POL,Poland,2015,131,0,131
GRC,Greece,POL,Poland,2016,141,0,141
GRC,Greece,POL,Poland,2017,155,0,155
GRC,Greece,SVK,Slovak Republic,2008,33,0,33
GRC,Greece,SVK,Slovak Republic,2009,50,0,50
GRC,Greece,SVK,Slovak Republic,2010,42,0,42
GRC,Greece,SVK,Slovak Republic,2011,26,0,26
GRC,Greece,SVK,Slovak Republic,2012,15,0,15
GRC,Greece,SVK,Slovak Republic,2013,16,0,16
GRC,Greece,SVK,Slovak Republic,2014,19,0,19
GRC,Greece,SVK,Slovak Republic,2015,57,0,57
GRC,Greece,SVK,Slovak Republic,2016,48,0,48
GRC,Greece,SVK,Slovak Republic,2017,40,0,40
GRC,Greece,ESP,Spain,2008,508,0,508
GRC,Greece,ESP,Spain,2009,376,0,376
GRC,Greece,ESP,Spain,2010,372,0,372
GRC,Greece,ESP,Spain,2011,526,0,526
GRC,Greece,ESP,Spain,2012,513,0,513
GRC,Greece,ESP,Spain,2013,486,0,486
GRC,Greece,ESP,Spain,2014,455,0,455
GRC,Greece,ESP,Spain,2015,476,0,476
GRC,Greece,ESP,Spain,2016,550,0,550
GRC,Greece,ESP,Spain,2017,640,0,640
GRC,Greece,SWE,Sweden,2008,640,0,640
GRC,Greece,SWE,Sweden,2009,483,0,483
GRC,Greece,SWE,Sweden,2010,520,0,520
GRC,Greece,SWE,Sweden,2011,929,0,929
GRC,Greece,SWE,Sweden,2012,1348,0,1348
GRC,Greece,SWE,Sweden,2013,1378,0,1378
GRC,Greece,SWE,Sweden,2014,1088,0,1088
GRC,Greece,SWE,Sweden,2015,1117,0,1117
GRC,Greece,SWE,Sweden,2016,1285,0,1285
GRC,Greece,SWE,Sweden,2017,1381,0,1381
GRC,Greece,CHE,Switzerland,2008,637,0,637
GRC,Greece,CHE,Switzerland,2009,672,0,672
GRC,Greece,CHE,Switzerland,2010,741,0,741
GRC,Greece,CHE,Switzerland,2011,1084,0,1084
GRC,Greece,CHE,Switzerland,2012,1613,0,1613
GRC,Greece,CHE,Switzerland,2013,1675,0,1675
GRC,Greece,CHE,Switzerland,2014,1422,0,1422
GRC,Greece,CHE,Switzerland,2015,1530,0,1530
GRC,Greece,CHE,Switzerland,2016,1580,0,1580
GRC,Greece,CHE,Switzerland,2017,1670,0,1670
GRC,Greece,TUR,Turkey,2010,522,0,522
GRC,Greece,TUR,Turkey,2016,845,0,845
GRC,Greece,TUR,Turkey,2017,641,0,641
GRC,Greece,GBR,United Kingdom,2011,6000,0,6000
GRC,Greece,GBR,United Kingdom,2012,6000,0,6000
GRC,Greece,GBR,United Kingdom,2013,4000,0,4000
GRC,Greece,GBR,United Kingdom,2014,4000,0,4000
GRC,Greece,GBR,United Kingdom,2015,11000,0,11000
GRC,Greece,GBR,United Kingdom,2016,5000,0,5000
GRC,Greece,GBR,United Kingdom,2017,11000,0,11000
GRC,Greece,USA,United States,2008,769,0,769
GRC,Greece,USA,United States,2009,798,0,798
GRC,Greece,USA,United States,2010,745,0,745
GRC,Greece,USA,United States,2011,949,0,949
GRC,Greece,USA,United States,2012,1054,0,1054
GRC,Greece,USA,United States,2013,1361,0,1361
GRC,Greece,USA,United States,2014,1235,0,1235
GRC,Greece,USA,United States,2015,1211,0,1211
GRC,Greece,USA,United States,2016,1451,0,1451
GRC,Greece,USA,United States,2017,1314,0,1314
GRC,Greece,CHL,Chile,2008,3,0,3
GRC,Greece,CHL,Chile,2009,4,0,4
GRC,Greece,CHL,Chile,2010,8,0,8
GRC,Greece,CHL,Chile,2011,9,0,9
GRC,Greece,CHL,Chile,2012,13,0,13
GRC,Greece,CHL,Chile,2013,15,0,15
GRC,Greece,CHL,Chile,2014,20,0,20
GRC,Greece,CHL,Chile,2015,35,0,35
GRC,Greece,CHL,Chile,2016,30,0,30
GRC,Greece,EST,Estonia,2008,1,0,1
GRC,Greece,EST,Estonia,2009,6,0,6
GRC,Greece,EST,Estonia,2010,7,0,7
GRC,Greece,EST,Estonia,2011,0,0,0
GRC,Greece,EST,Estonia,2012,1,0,1
GRC,Greece,EST,Estonia,2013,2,0,2
GRC,Greece,EST,Estonia,2014,1,0,1
GRC,Greece,EST,Estonia,2015,20,0,20
GRC,Greece,EST,Estonia,2016,32,0,32
GRC,Greece,EST,Estonia,2017,52,0,52
GRC,Greece,ISR,Israel,2008,1,0,1
GRC,Greece,ISR,Israel,2009,9,0,9
GRC,Greece,ISR,Israel,2010,6,0,6
GRC,Greece,ISR,Israel,2011,8,0,8
GRC,Greece,ISR,Israel,2012,10,0,10
GRC,Greece,ISR,Israel,2013,7,0,7
GRC,Greece,ISR,Israel,2014,15,0,15
GRC,Greece,ISR,Israel,2015,24,0,24
GRC,Greece,ISR,Israel,2016,20,0,20
GRC,Greece,ISR,Israel,2017,9,0,9
GRC,Greece,SVN,Slovenia,2008,10,0,10
GRC,Greece,SVN,Slovenia,2009,10,0,10
GRC,Greece,SVN,Slovenia,2011,22,0,22
GRC,Greece,SVN,Slovenia,2012,32,0,32
GRC,Greece,SVN,Slovenia,2013,29,0,29
GRC,Greece,SVN,Slovenia,2014,29,0,29
GRC,Greece,SVN,Slovenia,2015,35,0,35
GRC,Greece,SVN,Slovenia,2016,44,0,44
GRC,Greece,SVN,Slovenia,2017,58,0,58
GRD,Grenada,AUS,Australia,2008,3,0,3
GRD,Grenada,AUS,Australia,2009,1,0,1
GRD,Grenada,AUS,Australia,2010,1,0,1
GRD,Grenada,AUS,Australia,2011,0,0,0
GRD,Grenada,AUS,Australia,2012,3,0,3
GRD,Grenada,AUS,Australia,2013,0,0,0
GRD,Grenada,AUS,Australia,2014,0,0,0
GRD,Grenada,AUS,Australia,2015,0,0,0
GRD,Grenada,AUS,Australia,2016,0,0,0
GRD,Grenada,AUS,Australia,2017,3,0,3
GRD,Grenada,AUT,Austria,2008,1,1,0
GRD,Grenada,AUT,Austria,2009,2,1,1
GRD,Grenada,AUT,Austria,2010,4,2,2
GRD,Grenada,AUT,Austria,2011,1,1,0
GRD,Grenada,AUT,Austria,2012,2,0,2
GRD,Grenada,AUT,Austria,2013,1,2,-1
GRD,Grenada,AUT,Austria,2014,1,1,0
GRD,Grenada,AUT,Austria,2015,0,0,0
GRD,Grenada,AUT,Austria,2016,1,0,1
GRD,Grenada,AUT,Austria,2017,2,0,2
GRD,Grenada,BEL,Belgium,2010,0,0,0
GRD,Grenada,BEL,Belgium,2012,2,0,2
GRD,Grenada,BEL,Belgium,2015,1,0,1
GRD,Grenada,CAN,Canada,2008,284,0,284
GRD,Grenada,CAN,Canada,2009,325,0,325
GRD,Grenada,CAN,Canada,2010,208,0,208
GRD,Grenada,CAN,Canada,2011,173,0,173
GRD,Grenada,CAN,Canada,2012,142,0,142
GRD,Grenada,CAN,Canada,2013,170,0,170
GRD,Grenada,CAN,Canada,2014,137,0,137
GRD,Grenada,CAN,Canada,2015,115,0,115
GRD,Grenada,CAN,Canada,2016,110,0,110
GRD,Grenada,CAN,Canada,2017,120,0,120
GRD,Grenada,DNK,Denmark,2008,0,1,-1
GRD,Grenada,DNK,Denmark,2009,0,0,0
GRD,Grenada,DNK,Denmark,2012,1,0,1
GRD,Grenada,DNK,Denmark,2013,1,0,1
GRD,Grenada,DNK,Denmark,2014,2,0,2
GRD,Grenada,DNK,Denmark,2015,0,0,0
GRD,Grenada,DNK,Denmark,2016,1,0,1
GRD,Grenada,DNK,Denmark,2017,0,1,-1
GRD,Grenada,FIN,Finland,2008,0,0,0
GRD,Grenada,FIN,Finland,2009,0,0,0
GRD,Grenada,FIN,Finland,2010,0,0,0
GRD,Grenada,FIN,Finland,2011,0,0,0
GRD,Grenada,FIN,Finland,2012,0,0,0
GRD,Grenada,FIN,Finland,2013,0,0,0
GRD,Grenada,FIN,Finland,2014,0,0,0
GRD,Grenada,FIN,Finland,2015,0,0,0
GRD,Grenada,FIN,Finland,2016,0,0,0
GRD,Grenada,FIN,Finland,2017,0,0,0
GRD,Grenada,FRA,France,2008,0,0,0
GRD,Grenada,FRA,France,2009,2,0,2
GRD,Grenada,FRA,France,2010,2,0,2
GRD,Grenada,FRA,France,2011,4,0,4
GRD,Grenada,FRA,France,2012,3,0,3
GRD,Grenada,FRA,France,2013,1,0,1
GRD,Grenada,FRA,France,2014,1,0,1
GRD,Grenada,FRA,France,2015,1,0,1
GRD,Grenada,FRA,France,2016,3,0,3
GRD,Grenada,FRA,France,2017,1,0,1
GRD,Grenada,DEU,Germany,2008,4,5,-1
GRD,Grenada,DEU,Germany,2009,7,6,1
GRD,Grenada,DEU,Germany,2010,4,7,-3
GRD,Grenada,DEU,Germany,2011,9,4,5
GRD,Grenada,DEU,Germany,2012,13,9,4
GRD,Grenada,DEU,Germany,2013,7,3,4
GRD,Grenada,DEU,Germany,2014,6,1,5
GRD,Grenada,DEU,Germany,2015,10,1,9
GRD,Grenada,DEU,Germany,2016,6,5,1
GRD,Grenada,DEU,Germany,2017,2,5,-3
GRD,Grenada,HUN,Hungary,2008,1,0,1
GRD,Grenada,HUN,Hungary,2009,0,0,0
GRD,Grenada,HUN,Hungary,2010,0,0,0
GRD,Grenada,HUN,Hungary,2011,0,0,0
GRD,Grenada,HUN,Hungary,2012,0,0,0
GRD,Grenada,HUN,Hungary,2013,1,1,0
GRD,Grenada,HUN,Hungary,2014,0,0,0
GRD,Grenada,HUN,Hungary,2015,0,0,0
GRD,Grenada,HUN,Hungary,2016,0,0,0
GRD,Grenada,HUN,Hungary,2017,2,0,2
GRD,Grenada,ISL,Iceland,2016,0,0,0
GRD,Grenada,ISL,Iceland,2017,0,0,0
GRD,Grenada,ITA,Italy,2008,8,0,8
GRD,Grenada,ITA,Italy,2009,3,0,3
GRD,Grenada,ITA,Italy,2010,3,0,3
GRD,Grenada,ITA,Italy,2011,0,0,0
GRD,Grenada,ITA,Italy,2012,0,0,0
GRD,Grenada,ITA,Italy,2013,1,0,1
GRD,Grenada,ITA,Italy,2015,0,0,0
GRD,Grenada,JPN,Japan,2008,4,5,-1
GRD,Grenada,JPN,Japan,2009,4,4,0
GRD,Grenada,JPN,Japan,2010,17,17,0
GRD,Grenada,JPN,Japan,2011,6,6,0
GRD,Grenada,JPN,Japan,2012,5,5,0
GRD,Grenada,JPN,Japan,2013,11,11,0
GRD,Grenada,JPN,Japan,2014,10,9,1
GRD,Grenada,JPN,Japan,2015,14,13,1
GRD,Grenada,JPN,Japan,2016,8,8,0
GRD,Grenada,JPN,Japan,2017,8,9,-1
GRD,Grenada,KOR,Korea,2008,0,0,0
GRD,Grenada,KOR,Korea,2009,0,0,0
GRD,Grenada,KOR,Korea,2010,0,0,0
GRD,Grenada,KOR,Korea,2011,0,0,0
GRD,Grenada,KOR,Korea,2012,4,2,2
GRD,Grenada,KOR,Korea,2013,3,4,-1
GRD,Grenada,KOR,Korea,2014,0,0,0
GRD,Grenada,KOR,Korea,2015,1,1,0
GRD,Grenada,KOR,Korea,2016,1,1,0
GRD,Grenada,KOR,Korea,2017,0,0,0
GRD,Grenada,LUX,Luxembourg,2008,0,0,0
GRD,Grenada,LUX,Luxembourg,2009,0,0,0
GRD,Grenada,LUX,Luxembourg,2010,0,0,0
GRD,Grenada,LUX,Luxembourg,2011,0,0,0
GRD,Grenada,LUX,Luxembourg,2012,0,0,0
GRD,Grenada,LUX,Luxembourg,2013,0,0,0
GRD,Grenada,LUX,Luxembourg,2014,0,0,0
GRD,Grenada,LUX,Luxembourg,2015,2,0,2
GRD,Grenada,LUX,Luxembourg,2016,0,0,0
GRD,Grenada,LUX,Luxembourg,2017,0,0,0
GRD,Grenada,MEX,Mexico,2008,3,0,3
GRD,Grenada,MEX,Mexico,2009,6,0,6
GRD,Grenada,MEX,Mexico,2010,5,0,5
GRD,Grenada,MEX,Mexico,2011,4,0,4
GRD,Grenada,MEX,Mexico,2012,2,0,2
GRD,Grenada,MEX,Mexico,2013,11,0,11
GRD,Grenada,MEX,Mexico,2014,4,0,4
GRD,Grenada,MEX,Mexico,2015,1,0,1
GRD,Grenada,MEX,Mexico,2016,1,0,1
GRD,Grenada,NLD,Netherlands,2008,0,1,-1
GRD,Grenada,NLD,Netherlands,2012,2,0,2
GRD,Grenada,NLD,Netherlands,2014,2,2,0
GRD,Grenada,NLD,Netherlands,2015,0,1,-1
GRD,Grenada,NLD,Netherlands,2016,2,1,1
GRD,Grenada,NLD,Netherlands,2017,2,1,1
GRD,Grenada,NZL,New Zealand,2008,1,0,1
GRD,Grenada,NZL,New Zealand,2014,3,0,3
GRD,Grenada,NZL,New Zealand,2017,1,0,1
GRD,Grenada,NOR,Norway,2008,4,0,4
GRD,Grenada,NOR,Norway,2009,0,0,0
GRD,Grenada,NOR,Norway,2010,0,0,0
GRD,Grenada,NOR,Norway,2011,0,0,0
GRD,Grenada,NOR,Norway,2012,1,1,0
GRD,Grenada,NOR,Norway,2013,0,0,0
GRD,Grenada,NOR,Norway,2014,0,0,0
GRD,Grenada,NOR,Norway,2015,0,1,-1
GRD,Grenada,NOR,Norway,2016,0,0,0
GRD,Grenada,NOR,Norway,2017,0,0,0
GRD,Grenada,POL,Poland,2009,1,0,1
GRD,Grenada,POL,Poland,2010,0,0,0
GRD,Grenada,POL,Poland,2011,0,0,0
GRD,Grenada,POL,Poland,2012,0,0,0
GRD,Grenada,POL,Poland,2013,0,0,0
GRD,Grenada,POL,Poland,2014,0,0,0
GRD,Grenada,POL,Poland,2015,0,0,0
GRD,Grenada,POL,Poland,2016,0,0,0
GRD,Grenada,POL,Poland,2017,2,0,2
GRD,Grenada,SVK,Slovak Republic,2008,1,0,1
GRD,Grenada,ESP,Spain,2008,2,1,1
GRD,Grenada,ESP,Spain,2009,0,0,0
GRD,Grenada,ESP,Spain,2010,1,0,1
GRD,Grenada,ESP,Spain,2011,3,2,1
GRD,Grenada,ESP,Spain,2012,2,1,1
GRD,Grenada,ESP,Spain,2013,7,0,7
GRD,Grenada,ESP,Spain,2014,1,1,0
GRD,Grenada,ESP,Spain,2015,4,1,3
GRD,Grenada,ESP,Spain,2016,0,0,0
GRD,Grenada,ESP,Spain,2017,8,0,8
GRD,Grenada,SWE,Sweden,2008,1,0,1
GRD,Grenada,SWE,Sweden,2009,1,1,0
GRD,Grenada,SWE,Sweden,2010,1,0,1
GRD,Grenada,SWE,Sweden,2011,0,2,-2
GRD,Grenada,SWE,Sweden,2012,3,0,3
GRD,Grenada,SWE,Sweden,2013,0,0,0
GRD,Grenada,SWE,Sweden,2014,0,0,0
GRD,Grenada,SWE,Sweden,2015,0,1,-1
GRD,Grenada,SWE,Sweden,2016,0,0,0
GRD,Grenada,SWE,Sweden,2017,1,0,1
GRD,Grenada,CHE,Switzerland,2010,0,1,-1
GRD,Grenada,CHE,Switzerland,2011,0,0,0
GRD,Grenada,CHE,Switzerland,2012,1,2,-1
GRD,Grenada,CHE,Switzerland,2013,1,1,0
GRD,Grenada,CHE,Switzerland,2015,0,1,-1
GRD,Grenada,CHE,Switzerland,2016,2,0,2
GRD,Grenada,CHE,Switzerland,2017,1,0,1
GRD,Grenada,USA,United States,2008,784,0,784
GRD,Grenada,USA,United States,2009,748,0,748
GRD,Grenada,USA,United States,2010,664,0,664
GRD,Grenada,USA,United States,2011,579,0,579
GRD,Grenada,USA,United States,2012,671,0,671
GRD,Grenada,USA,United States,2013,687,0,687
GRD,Grenada,USA,United States,2014,633,0,633
GRD,Grenada,USA,United States,2015,525,0,525
GRD,Grenada,USA,United States,2016,585,0,585
GRD,Grenada,USA,United States,2017,544,0,544
GRD,Grenada,CHL,Chile,2008,0,0,0
GRD,Grenada,CHL,Chile,2009,1,0,1
GRD,Grenada,CHL,Chile,2010,0,0,0
GRD,Grenada,CHL,Chile,2011,0,0,0
GRD,Grenada,CHL,Chile,2012,0,0,0
GRD,Grenada,CHL,Chile,2013,0,0,0
GRD,Grenada,CHL,Chile,2014,1,0,1
GRD,Grenada,CHL,Chile,2015,1,0,1
GRD,Grenada,CHL,Chile,2016,0,0,0
GRD,Grenada,EST,Estonia,2008,0,0,0
GRD,Grenada,EST,Estonia,2009,0,0,0
GRD,Grenada,EST,Estonia,2010,0,0,0
GRD,Grenada,EST,Estonia,2011,0,0,0
GRD,Grenada,EST,Estonia,2012,0,0,0
GRD,Grenada,EST,Estonia,2013,0,0,0
GRD,Grenada,EST,Estonia,2014,0,0,0
GRD,Grenada,EST,Estonia,2015,0,0,0
GRD,Grenada,EST,Estonia,2016,0,0,0
GRD,Grenada,EST,Estonia,2017,0,0,0
GUM,Guam,AUS,Australia,2009,0,0,0
GUM,Guam,AUS,Australia,2010,0,0,0
GUM,Guam,AUS,Australia,2011,0,0,0
GUM,Guam,AUS,Australia,2012,0,0,0
GUM,Guam,AUS,Australia,2013,0,0,0
GUM,Guam,AUS,Australia,2014,0,0,0
GUM,Guam,AUS,Australia,2015,0,0,0
GUM,Guam,AUS,Australia,2016,0,0,0
GUM,Guam,AUS,Australia,2017,0,0,0
GUM,Guam,AUT,Austria,2014,0,0,0
GUM,Guam,AUT,Austria,2015,0,0,0
GUM,Guam,AUT,Austria,2016,0,0,0
GUM,Guam,AUT,Austria,2017,0,0,0
GUM,Guam,BEL,Belgium,2010,0,0,0
GUM,Guam,CAN,Canada,2008,0,0,0
GUM,Guam,CAN,Canada,2009,0,0,0
GUM,Guam,CAN,Canada,2010,0,0,0
GUM,Guam,CAN,Canada,2011,0,0,0
GUM,Guam,CAN,Canada,2012,0,0,0
GUM,Guam,CAN,Canada,2013,0,0,0
GUM,Guam,CAN,Canada,2014,0,0,0
GUM,Guam,CAN,Canada,2015,0,0,0
GUM,Guam,CAN,Canada,2016,0,0,0
GUM,Guam,CAN,Canada,2017,0,0,0
GUM,Guam,DNK,Denmark,2015,0,0,0
GUM,Guam,DNK,Denmark,2016,0,0,0
GUM,Guam,FIN,Finland,2008,0,0,0
GUM,Guam,FIN,Finland,2009,0,0,0
GUM,Guam,FIN,Finland,2010,0,0,0
GUM,Guam,FIN,Finland,2011,0,0,0
GUM,Guam,FIN,Finland,2012,0,0,0
GUM,Guam,FIN,Finland,2013,0,0,0
GUM,Guam,FIN,Finland,2014,0,0,0
GUM,Guam,FIN,Finland,2015,0,0,0
GUM,Guam,FIN,Finland,2016,0,0,0
GUM,Guam,FIN,Finland,2017,0,0,0
GUM,Guam,FRA,France,2008,0,0,0
GUM,Guam,FRA,France,2009,0,0,0
GUM,Guam,FRA,France,2010,0,0,0
GUM,Guam,FRA,France,2011,0,0,0
GUM,Guam,FRA,France,2012,0,0,0
GUM,Guam,FRA,France,2013,0,0,0
GUM,Guam,FRA,France,2014,0,0,0
GUM,Guam,FRA,France,2015,0,0,0
GUM,Guam,FRA,France,2016,0,0,0
GUM,Guam,FRA,France,2017,0,0,0
GUM,Guam,HUN,Hungary,2008,0,0,0
GUM,Guam,HUN,Hungary,2009,0,0,0
GUM,Guam,HUN,Hungary,2010,0,0,0
GUM,Guam,HUN,Hungary,2011,0,0,0
GUM,Guam,HUN,Hungary,2012,0,0,0
GUM,Guam,HUN,Hungary,2013,0,0,0
GUM,Guam,HUN,Hungary,2014,0,0,0
GUM,Guam,HUN,Hungary,2015,0,0,0
GUM,Guam,HUN,Hungary,2016,0,0,0
GUM,Guam,HUN,Hungary,2017,0,0,0
GUM,Guam,ISL,Iceland,2016,0,0,0
GUM,Guam,ISL,Iceland,2017,0,0,0
GUM,Guam,JPN,Japan,2008,0,0,0
GUM,Guam,JPN,Japan,2009,0,0,0
GUM,Guam,JPN,Japan,2010,0,0,0
GUM,Guam,JPN,Japan,2011,0,0,0
GUM,Guam,JPN,Japan,2012,0,0,0
GUM,Guam,JPN,Japan,2013,0,0,0
GUM,Guam,JPN,Japan,2014,0,0,0
GUM,Guam,JPN,Japan,2015,0,0,0
GUM,Guam,JPN,Japan,2016,0,0,0
GUM,Guam,JPN,Japan,2017,0,0,0
GUM,Guam,KOR,Korea,2008,0,0,0
GUM,Guam,KOR,Korea,2009,0,0,0
GUM,Guam,KOR,Korea,2010,0,0,0
GUM,Guam,KOR,Korea,2011,0,0,0
GUM,Guam,KOR,Korea,2012,0,0,0
GUM,Guam,KOR,Korea,2013,0,0,0
GUM,Guam,KOR,Korea,2014,0,0,0
GUM,Guam,KOR,Korea,2015,0,0,0
GUM,Guam,KOR,Korea,2016,0,0,0
GUM,Guam,KOR,Korea,2017,0,0,0
GUM,Guam,LUX,Luxembourg,2008,0,0,0
GUM,Guam,LUX,Luxembourg,2009,0,0,0
GUM,Guam,LUX,Luxembourg,2010,0,0,0
GUM,Guam,LUX,Luxembourg,2011,0,0,0
GUM,Guam,LUX,Luxembourg,2012,0,0,0
GUM,Guam,LUX,Luxembourg,2013,0,0,0
GUM,Guam,LUX,Luxembourg,2014,0,0,0
GUM,Guam,LUX,Luxembourg,2015,0,0,0
GUM,Guam,LUX,Luxembourg,2016,0,0,0
GUM,Guam,LUX,Luxembourg,2017,0,0,0
GUM,Guam,MEX,Mexico,2012,0,0,0
GUM,Guam,MEX,Mexico,2013,0,0,0
GUM,Guam,MEX,Mexico,2014,0,0,0
GUM,Guam,NOR,Norway,2008,0,0,0
GUM,Guam,NOR,Norway,2009,0,0,0
GUM,Guam,NOR,Norway,2010,0,0,0
GUM,Guam,NOR,Norway,2011,0,0,0
GUM,Guam,NOR,Norway,2012,0,0,0
GUM,Guam,NOR,Norway,2013,0,0,0
GUM,Guam,NOR,Norway,2014,0,0,0
GUM,Guam,NOR,Norway,2015,0,0,0
GUM,Guam,NOR,Norway,2016,0,0,0
GUM,Guam,NOR,Norway,2017,0,0,0
GUM,Guam,POL,Poland,2009,0,0,0
GUM,Guam,POL,Poland,2010,0,0,0
GUM,Guam,POL,Poland,2011,0,0,0
GUM,Guam,POL,Poland,2012,0,0,0
GUM,Guam,POL,Poland,2013,0,0,0
GUM,Guam,POL,Poland,2014,0,0,0
GUM,Guam,POL,Poland,2015,0,0,0
GUM,Guam,POL,Poland,2016,0,0,0
GUM,Guam,POL,Poland,2017,0,0,0
GUM,Guam,ESP,Spain,2008,0,0,0
GUM,Guam,ESP,Spain,2009,0,0,0
GUM,Guam,ESP,Spain,2010,0,0,0
GUM,Guam,ESP,Spain,2011,0,0,0
GUM,Guam,ESP,Spain,2012,0,0,0
GUM,Guam,ESP,Spain,2013,0,0,0
GUM,Guam,SWE,Sweden,2008,0,0,0
GUM,Guam,SWE,Sweden,2009,0,0,0
GUM,Guam,SWE,Sweden,2010,0,0,0
GUM,Guam,SWE,Sweden,2011,0,0,0
GUM,Guam,SWE,Sweden,2012,0,0,0
GUM,Guam,SWE,Sweden,2013,0,0,0
GUM,Guam,SWE,Sweden,2014,0,0,0
GUM,Guam,SWE,Sweden,2015,0,0,0
GUM,Guam,USA,United States,2017,2,0,2
GUM,Guam,CHL,Chile,2008,0,0,0
GUM,Guam,CHL,Chile,2009,0,0,0
GUM,Guam,CHL,Chile,2010,0,0,0
GUM,Guam,CHL,Chile,2011,0,0,0
GUM,Guam,CHL,Chile,2012,0,0,0
GUM,Guam,CHL,Chile,2013,0,0,0
GUM,Guam,CHL,Chile,2014,0,0,0
GUM,Guam,CHL,Chile,2015,0,0,0
GUM,Guam,CHL,Chile,2016,0,0,0
GUM,Guam,EST,Estonia,2017,0,0,0
GTM,Guatemala,AUS,Australia,2008,12,0,12
GTM,Guatemala,AUS,Australia,2009,15,0,15
GTM,Guatemala,AUS,Australia,2010,8,0,8
GTM,Guatemala,AUS,Australia,2011,9,0,9
GTM,Guatemala,AUS,Australia,2012,14,0,14
GTM,Guatemala,AUS,Australia,2013,16,7,9
GTM,Guatemala,AUS,Australia,2014,18,0,18
GTM,Guatemala,AUS,Australia,2015,8,0,8
GTM,Guatemala,AUS,Australia,2016,10,0,10
GTM,Guatemala,AUS,Australia,2017,9,0,9
GTM,Guatemala,AUT,Austria,2008,13,9,4
GTM,Guatemala,AUT,Austria,2009,17,9,8
GTM,Guatemala,AUT,Austria,2010,16,16,0
GTM,Guatemala,AUT,Austria,2011,24,14,10
GTM,Guatemala,AUT,Austria,2012,33,11,22
GTM,Guatemala,AUT,Austria,2013,28,15,13
GTM,Guatemala,AUT,Austria,2014,32,17,15
GTM,Guatemala,AUT,Austria,2015,30,15,15
GTM,Guatemala,AUT,Austria,2016,15,19,-4
GTM,Guatemala,AUT,Austria,2017,30,10,20
GTM,Guatemala,BEL,Belgium,2008,21,0,21
GTM,Guatemala,BEL,Belgium,2009,32,0,32
GTM,Guatemala,BEL,Belgium,2010,27,11,16
GTM,Guatemala,BEL,Belgium,2012,32,12,20
GTM,Guatemala,BEL,Belgium,2013,23,15,8
GTM,Guatemala,BEL,Belgium,2014,13,11,2
GTM,Guatemala,BEL,Belgium,2015,9,11,-2
GTM,Guatemala,BEL,Belgium,2016,18,6,12
GTM,Guatemala,BEL,Belgium,2017,21,8,13
GTM,Guatemala,CAN,Canada,2008,263,0,263
GTM,Guatemala,CAN,Canada,2009,264,0,264
GTM,Guatemala,CAN,Canada,2010,265,0,265
GTM,Guatemala,CAN,Canada,2011,288,0,288
GTM,Guatemala,CAN,Canada,2012,358,0,358
GTM,Guatemala,CAN,Canada,2013,348,0,348
GTM,Guatemala,CAN,Canada,2014,317,0,317
GTM,Guatemala,CAN,Canada,2015,240,0,240
GTM,Guatemala,CAN,Canada,2016,200,0,200
GTM,Guatemala,CAN,Canada,2017,240,0,240
GTM,Guatemala,CZE,Czech Republic,2008,4,0,4
GTM,Guatemala,CZE,Czech Republic,2009,3,0,3
GTM,Guatemala,CZE,Czech Republic,2010,1,0,1
GTM,Guatemala,CZE,Czech Republic,2011,1,0,1
GTM,Guatemala,CZE,Czech Republic,2012,3,3,0
GTM,Guatemala,CZE,Czech Republic,2013,3,3,0
GTM,Guatemala,CZE,Czech Republic,2014,4,1,3
GTM,Guatemala,CZE,Czech Republic,2015,5,2,3
GTM,Guatemala,CZE,Czech Republic,2016,2,4,-2
GTM,Guatemala,CZE,Czech Republic,2017,9,3,6
GTM,Guatemala,DNK,Denmark,2008,6,3,3
GTM,Guatemala,DNK,Denmark,2009,16,1,15
GTM,Guatemala,DNK,Denmark,2010,12,8,4
GTM,Guatemala,DNK,Denmark,2011,6,8,-2
GTM,Guatemala,DNK,Denmark,2012,8,5,3
GTM,Guatemala,DNK,Denmark,2013,8,5,3
GTM,Guatemala,DNK,Denmark,2014,5,5,0
GTM,Guatemala,DNK,Denmark,2015,4,4,0
GTM,Guatemala,DNK,Denmark,2016,1,7,-6
GTM,Guatemala,DNK,Denmark,2017,10,6,4
GTM,Guatemala,FIN,Finland,2008,8,0,8
GTM,Guatemala,FIN,Finland,2009,5,0,5
GTM,Guatemala,FIN,Finland,2010,3,0,3
GTM,Guatemala,FIN,Finland,2011,2,0,2
GTM,Guatemala,FIN,Finland,2012,1,0,1
GTM,Guatemala,FIN,Finland,2013,7,0,7
GTM,Guatemala,FIN,Finland,2014,2,1,1
GTM,Guatemala,FIN,Finland,2015,2,0,2
GTM,Guatemala,FIN,Finland,2016,5,1,4
GTM,Guatemala,FIN,Finland,2017,1,0,1
GTM,Guatemala,FRA,France,2008,34,0,34
GTM,Guatemala,FRA,France,2009,26,0,26
GTM,Guatemala,FRA,France,2010,33,0,33
GTM,Guatemala,FRA,France,2011,27,0,27
GTM,Guatemala,FRA,France,2012,32,0,32
GTM,Guatemala,FRA,France,2013,39,0,39
GTM,Guatemala,FRA,France,2014,44,0,44
GTM,Guatemala,FRA,France,2015,41,0,41
GTM,Guatemala,FRA,France,2016,35,0,35
GTM,Guatemala,FRA,France,2017,35,0,35
GTM,Guatemala,DEU,Germany,2008,125,113,12
GTM,Guatemala,DEU,Germany,2009,118,101,17
GTM,Guatemala,DEU,Germany,2010,110,104,6
GTM,Guatemala,DEU,Germany,2011,129,61,68
GTM,Guatemala,DEU,Germany,2012,163,71,92
GTM,Guatemala,DEU,Germany,2013,127,85,42
GTM,Guatemala,DEU,Germany,2014,155,76,79
GTM,Guatemala,DEU,Germany,2015,155,120,35
GTM,Guatemala,DEU,Germany,2016,152,75,77
GTM,Guatemala,DEU,Germany,2017,177,67,110
GTM,Guatemala,HUN,Hungary,2008,4,0,4
GTM,Guatemala,HUN,Hungary,2009,0,0,0
GTM,Guatemala,HUN,Hungary,2010,2,0,2
GTM,Guatemala,HUN,Hungary,2011,2,0,2
GTM,Guatemala,HUN,Hungary,2012,1,0,1
GTM,Guatemala,HUN,Hungary,2013,1,0,1
GTM,Guatemala,HUN,Hungary,2014,2,0,2
GTM,Guatemala,HUN,Hungary,2015,4,1,3
GTM,Guatemala,HUN,Hungary,2016,5,0,5
GTM,Guatemala,HUN,Hungary,2017,4,0,4
GTM,Guatemala,ISL,Iceland,2008,2,0,2
GTM,Guatemala,ISL,Iceland,2009,0,1,-1
GTM,Guatemala,ISL,Iceland,2010,0,1,-1
GTM,Guatemala,ISL,Iceland,2011,0,0,0
GTM,Guatemala,ISL,Iceland,2012,2,0,2
GTM,Guatemala,ISL,Iceland,2013,1,0,1
GTM,Guatemala,ISL,Iceland,2014,0,1,-1
GTM,Guatemala,ISL,Iceland,2015,2,0,2
GTM,Guatemala,ISL,Iceland,2016,0,0,0
GTM,Guatemala,ISL,Iceland,2017,0,3,-3
GTM,Guatemala,ITA,Italy,2008,72,2,70
GTM,Guatemala,ITA,Italy,2009,62,2,60
GTM,Guatemala,ITA,Italy,2010,104,7,97
GTM,Guatemala,ITA,Italy,2011,89,1,88
GTM,Guatemala,ITA,Italy,2012,83,4,79
GTM,Guatemala,ITA,Italy,2013,72,8,64
GTM,Guatemala,ITA,Italy,2014,44,8,36
GTM,Guatemala,ITA,Italy,2015,63,7,56
GTM,Guatemala,ITA,Italy,2016,55,0,55
GTM,Guatemala,ITA,Italy,2017,54,5,49
GTM,Guatemala,JPN,Japan,2008,68,65,3
GTM,Guatemala,JPN,Japan,2009,92,94,-2
GTM,Guatemala,JPN,Japan,2010,104,99,5
GTM,Guatemala,JPN,Japan,2011,94,89,5
GTM,Guatemala,JPN,Japan,2012,90,89,1
GTM,Guatemala,JPN,Japan,2013,69,66,3
GTM,Guatemala,JPN,Japan,2014,64,57,7
GTM,Guatemala,JPN,Japan,2015,61,54,7
GTM,Guatemala,JPN,Japan,2016,71,64,7
GTM,Guatemala,JPN,Japan,2017,66,56,10
GTM,Guatemala,KOR,Korea,2008,31,18,13
GTM,Guatemala,KOR,Korea,2009,56,19,37
GTM,Guatemala,KOR,Korea,2010,37,23,14
GTM,Guatemala,KOR,Korea,2011,38,34,4
GTM,Guatemala,KOR,Korea,2012,30,20,10
GTM,Guatemala,KOR,Korea,2013,36,39,-3
GTM,Guatemala,KOR,Korea,2014,28,28,0
GTM,Guatemala,KOR,Korea,2015,19,31,-12
GTM,Guatemala,KOR,Korea,2016,16,26,-10
GTM,Guatemala,KOR,Korea,2017,19,21,-2
GTM,Guatemala,LUX,Luxembourg,2008,2,0,2
GTM,Guatemala,LUX,Luxembourg,2009,1,0,1
GTM,Guatemala,LUX,Luxembourg,2010,1,0,1
GTM,Guatemala,LUX,Luxembourg,2011,1,0,1
GTM,Guatemala,LUX,Luxembourg,2012,1,0,1
GTM,Guatemala,LUX,Luxembourg,2013,5,1,4
GTM,Guatemala,LUX,Luxembourg,2014,5,2,3
GTM,Guatemala,LUX,Luxembourg,2015,5,0,5
GTM,Guatemala,LUX,Luxembourg,2016,4,3,1
GTM,Guatemala,LUX,Luxembourg,2017,3,0,3
GTM,Guatemala,MEX,Mexico,2008,1005,0,1005
GTM,Guatemala,MEX,Mexico,2009,2080,0,2080
GTM,Guatemala,MEX,Mexico,2010,1799,0,1799
GTM,Guatemala,MEX,Mexico,2011,1271,0,1271
GTM,Guatemala,MEX,Mexico,2012,479,0,479
GTM,Guatemala,MEX,Mexico,2013,3139,0,3139
GTM,Guatemala,MEX,Mexico,2014,2640,0,2640
GTM,Guatemala,MEX,Mexico,2015,1609,0,1609
GTM,Guatemala,MEX,Mexico,2016,1670,0,1670
GTM,Guatemala,MEX,Mexico,2017,1784,0,1784
GTM,Guatemala,NLD,Netherlands,2008,30,8,22
GTM,Guatemala,NLD,Netherlands,2009,21,15,6
GTM,Guatemala,NLD,Netherlands,2010,23,11,12
GTM,Guatemala,NLD,Netherlands,2011,22,13,9
GTM,Guatemala,NLD,Netherlands,2012,37,10,27
GTM,Guatemala,NLD,Netherlands,2013,22,13,9
GTM,Guatemala,NLD,Netherlands,2014,25,14,11
GTM,Guatemala,NLD,Netherlands,2015,24,20,4
GTM,Guatemala,NLD,Netherlands,2016,19,12,7
GTM,Guatemala,NLD,Netherlands,2017,34,16,18
GTM,Guatemala,NZL,New Zealand,2008,4,0,4
GTM,Guatemala,NZL,New Zealand,2009,3,1,2
GTM,Guatemala,NZL,New Zealand,2010,6,1,5
GTM,Guatemala,NZL,New Zealand,2011,2,2,0
GTM,Guatemala,NZL,New Zealand,2012,2,2,0
GTM,Guatemala,NZL,New Zealand,2013,4,1,3
GTM,Guatemala,NZL,New Zealand,2014,5,2,3
GTM,Guatemala,NZL,New Zealand,2015,5,5,0
GTM,Guatemala,NZL,New Zealand,2016,1,1,0
GTM,Guatemala,NZL,New Zealand,2017,4,2,2
GTM,Guatemala,NOR,Norway,2008,22,13,9
GTM,Guatemala,NOR,Norway,2009,19,17,2
GTM,Guatemala,NOR,Norway,2010,22,5,17
GTM,Guatemala,NOR,Norway,2011,10,8,2
GTM,Guatemala,NOR,Norway,2012,16,6,10
GTM,Guatemala,NOR,Norway,2013,8,2,6
GTM,Guatemala,NOR,Norway,2014,10,6,4
GTM,Guatemala,NOR,Norway,2015,7,4,3
GTM,Guatemala,NOR,Norway,2016,10,1,9
GTM,Guatemala,NOR,Norway,2017,13,6,7
GTM,Guatemala,POL,Poland,2009,5,0,5
GTM,Guatemala,POL,Poland,2010,9,0,9
GTM,Guatemala,POL,Poland,2011,10,0,10
GTM,Guatemala,POL,Poland,2012,9,0,9
GTM,Guatemala,POL,Poland,2013,14,0,14
GTM,Guatemala,POL,Poland,2014,4,0,4
GTM,Guatemala,POL,Poland,2015,10,0,10
GTM,Guatemala,POL,Poland,2016,7,0,7
GTM,Guatemala,POL,Poland,2017,10,0,10
GTM,Guatemala,SVK,Slovak Republic,2008,4,0,4
GTM,Guatemala,SVK,Slovak Republic,2010,1,0,1
GTM,Guatemala,ESP,Spain,2008,962,307,655
GTM,Guatemala,ESP,Spain,2009,666,379,287
GTM,Guatemala,ESP,Spain,2010,739,350,389
GTM,Guatemala,ESP,Spain,2011,753,333,420
GTM,Guatemala,ESP,Spain,2012,628,423,205
GTM,Guatemala,ESP,Spain,2013,552,521,31
GTM,Guatemala,ESP,Spain,2014,726,272,454
GTM,Guatemala,ESP,Spain,2015,817,193,624
GTM,Guatemala,ESP,Spain,2016,998,225,773
GTM,Guatemala,ESP,Spain,2017,1420,352,1068
GTM,Guatemala,SWE,Sweden,2008,20,3,17
GTM,Guatemala,SWE,Sweden,2009,20,0,20
GTM,Guatemala,SWE,Sweden,2010,16,5,11
GTM,Guatemala,SWE,Sweden,2011,7,4,3
GTM,Guatemala,SWE,Sweden,2012,22,3,19
GTM,Guatemala,SWE,Sweden,2013,8,2,6
GTM,Guatemala,SWE,Sweden,2014,15,4,11
GTM,Guatemala,SWE,Sweden,2015,14,10,4
GTM,Guatemala,SWE,Sweden,2016,12,3,9
GTM,Guatemala,SWE,Sweden,2017,16,5,11
GTM,Guatemala,CHE,Switzerland,2010,32,12,20
GTM,Guatemala,CHE,Switzerland,2011,40,13,27
GTM,Guatemala,CHE,Switzerland,2012,40,17,23
GTM,Guatemala,CHE,Switzerland,2013,29,21,8
GTM,Guatemala,CHE,Switzerland,2014,27,17,10
GTM,Guatemala,CHE,Switzerland,2015,32,11,21
GTM,Guatemala,CHE,Switzerland,2016,29,6,23
GTM,Guatemala,CHE,Switzerland,2017,39,10,29
GTM,Guatemala,USA,United States,2008,16182,0,16182
GTM,Guatemala,USA,United States,2009,12187,0,12187
GTM,Guatemala,USA,United States,2010,10467,0,10467
GTM,Guatemala,USA,United States,2011,11092,0,11092
GTM,Guatemala,USA,United States,2012,10341,0,10341
GTM,Guatemala,USA,United States,2013,10224,0,10224
GTM,Guatemala,USA,United States,2014,10238,0,10238
GTM,Guatemala,USA,United States,2015,11773,0,11773
GTM,Guatemala,USA,United States,2016,13002,0,13002
GTM,Guatemala,USA,United States,2017,13198,0,13198
GTM,Guatemala,CHL,Chile,2008,56,0,56
GTM,Guatemala,CHL,Chile,2009,48,0,48
GTM,Guatemala,CHL,Chile,2010,65,0,65
GTM,Guatemala,CHL,Chile,2011,80,0,80
GTM,Guatemala,CHL,Chile,2012,110,0,110
GTM,Guatemala,CHL,Chile,2013,106,0,106
GTM,Guatemala,CHL,Chile,2014,57,0,57
GTM,Guatemala,CHL,Chile,2015,72,0,72
GTM,Guatemala,CHL,Chile,2016,70,0,70
GTM,Guatemala,EST,Estonia,2008,0,0,0
GTM,Guatemala,EST,Estonia,2009,1,0,1
GTM,Guatemala,EST,Estonia,2010,2,0,2
GTM,Guatemala,EST,Estonia,2011,1,0,1
GTM,Guatemala,EST,Estonia,2012,1,0,1
GTM,Guatemala,EST,Estonia,2013,0,0,0
GTM,Guatemala,EST,Estonia,2014,1,0,1
GTM,Guatemala,EST,Estonia,2015,1,0,1
GTM,Guatemala,EST,Estonia,2016,2,0,2
GTM,Guatemala,EST,Estonia,2017,0,0,0
GIN,Guinea,AUS,Australia,2008,20,0,20
GIN,Guinea,AUS,Australia,2009,14,0,14
GIN,Guinea,AUS,Australia,2010,51,0,51
GIN,Guinea,AUS,Australia,2011,17,0,17
GIN,Guinea,AUS,Australia,2012,38,0,38
GIN,Guinea,AUS,Australia,2013,23,0,23
GIN,Guinea,AUS,Australia,2014,23,0,23
GIN,Guinea,AUS,Australia,2015,14,0,14
GIN,Guinea,AUS,Australia,2016,20,0,20
GIN,Guinea,AUS,Australia,2017,52,0,52
GIN,Guinea,AUT,Austria,2008,45,24,21
GIN,Guinea,AUT,Austria,2009,68,33,35
GIN,Guinea,AUT,Austria,2010,48,38,10
GIN,Guinea,AUT,Austria,2011,62,44,18
GIN,Guinea,AUT,Austria,2012,55,54,1
GIN,Guinea,AUT,Austria,2013,60,46,14
GIN,Guinea,AUT,Austria,2014,44,30,14
GIN,Guinea,AUT,Austria,2015,43,29,14
GIN,Guinea,AUT,Austria,2016,66,23,43
GIN,Guinea,AUT,Austria,2017,70,47,23
GIN,Guinea,BEL,Belgium,2008,287,0,287
GIN,Guinea,BEL,Belgium,2009,518,0,518
GIN,Guinea,BEL,Belgium,2010,460,48,412
GIN,Guinea,BEL,Belgium,2011,659,0,659
GIN,Guinea,BEL,Belgium,2012,1894,515,1379
GIN,Guinea,BEL,Belgium,2013,1582,960,622
GIN,Guinea,BEL,Belgium,2014,1084,818,266
GIN,Guinea,BEL,Belgium,2015,1215,698,517
GIN,Guinea,BEL,Belgium,2016,1057,279,778
GIN,Guinea,BEL,Belgium,2017,1166,188,978
GIN,Guinea,CAN,Canada,2008,327,0,327
GIN,Guinea,CAN,Canada,2009,347,0,347
GIN,Guinea,CAN,Canada,2010,395,0,395
GIN,Guinea,CAN,Canada,2011,352,0,352
GIN,Guinea,CAN,Canada,2012,406,0,406
GIN,Guinea,CAN,Canada,2013,462,0,462
GIN,Guinea,CAN,Canada,2014,365,0,365
GIN,Guinea,CAN,Canada,2015,244,0,244
GIN,Guinea,CAN,Canada,2016,410,0,410
GIN,Guinea,CAN,Canada,2017,380,0,380
GIN,Guinea,CZE,Czech Republic,2008,6,0,6
GIN,Guinea,CZE,Czech Republic,2009,5,0,5
GIN,Guinea,CZE,Czech Republic,2010,2,0,2
GIN,Guinea,CZE,Czech Republic,2011,2,0,2
GIN,Guinea,CZE,Czech Republic,2012,4,2,2
GIN,Guinea,CZE,Czech Republic,2013,8,3,5
GIN,Guinea,CZE,Czech Republic,2014,11,6,5
GIN,Guinea,CZE,Czech Republic,2015,6,7,-1
GIN,Guinea,CZE,Czech Republic,2016,10,1,9
GIN,Guinea,CZE,Czech Republic,2017,2,7,-5
GIN,Guinea,DNK,Denmark,2008,2,0,2
GIN,Guinea,DNK,Denmark,2009,3,1,2
GIN,Guinea,DNK,Denmark,2010,4,0,4
GIN,Guinea,DNK,Denmark,2011,5,2,3
GIN,Guinea,DNK,Denmark,2012,2,0,2
GIN,Guinea,DNK,Denmark,2013,5,0,5
GIN,Guinea,DNK,Denmark,2014,8,2,6
GIN,Guinea,DNK,Denmark,2015,1,3,-2
GIN,Guinea,DNK,Denmark,2016,3,2,1
GIN,Guinea,DNK,Denmark,2017,3,9,-6
GIN,Guinea,FIN,Finland,2008,7,0,7
GIN,Guinea,FIN,Finland,2009,6,0,6
GIN,Guinea,FIN,Finland,2010,9,0,9
GIN,Guinea,FIN,Finland,2011,5,0,5
GIN,Guinea,FIN,Finland,2012,9,0,9
GIN,Guinea,FIN,Finland,2013,10,0,10
GIN,Guinea,FIN,Finland,2014,10,0,10
GIN,Guinea,FIN,Finland,2015,10,0,10
GIN,Guinea,FIN,Finland,2016,7,3,4
GIN,Guinea,FIN,Finland,2017,10,1,9
GIN,Guinea,FRA,France,2008,1506,0,1506
GIN,Guinea,FRA,France,2009,1483,0,1483
GIN,Guinea,FRA,France,2010,1647,0,1647
GIN,Guinea,FRA,France,2011,1661,0,1661
GIN,Guinea,FRA,France,2012,1937,0,1937
GIN,Guinea,FRA,France,2013,2045,0,2045
GIN,Guinea,FRA,France,2014,2391,0,2391
GIN,Guinea,FRA,France,2015,2282,0,2282
GIN,Guinea,FRA,France,2016,2535,0,2535
GIN,Guinea,FRA,France,2017,2625,0,2625
GIN,Guinea,DEU,Germany,2008,441,277,164
GIN,Guinea,DEU,Germany,2009,496,297,199
GIN,Guinea,DEU,Germany,2010,494,290,204
GIN,Guinea,DEU,Germany,2011,555,291,264
GIN,Guinea,DEU,Germany,2012,742,316,426
GIN,Guinea,DEU,Germany,2013,1620,436,1184
GIN,Guinea,DEU,Germany,2014,1743,627,1116
GIN,Guinea,DEU,Germany,2015,2151,718,1433
GIN,Guinea,DEU,Germany,2016,3064,1182,1882
GIN,Guinea,DEU,Germany,2017,4394,1827,2567
GIN,Guinea,HUN,Hungary,2008,0,0,0
GIN,Guinea,HUN,Hungary,2009,0,0,0
GIN,Guinea,HUN,Hungary,2010,1,0,1
GIN,Guinea,HUN,Hungary,2011,0,0,0
GIN,Guinea,HUN,Hungary,2012,0,0,0
GIN,Guinea,HUN,Hungary,2013,2,1,1
GIN,Guinea,HUN,Hungary,2014,2,0,2
GIN,Guinea,HUN,Hungary,2015,3,0,3
GIN,Guinea,HUN,Hungary,2016,14,1,13
GIN,Guinea,HUN,Hungary,2017,17,0,17
GIN,Guinea,ISL,Iceland,2008,1,0,1
GIN,Guinea,ISL,Iceland,2009,2,0,2
GIN,Guinea,ISL,Iceland,2010,2,0,2
GIN,Guinea,ISL,Iceland,2011,1,0,1
GIN,Guinea,ISL,Iceland,2012,2,0,2
GIN,Guinea,ISL,Iceland,2013,1,0,1
GIN,Guinea,ISL,Iceland,2014,0,0,0
GIN,Guinea,ISL,Iceland,2015,0,0,0
GIN,Guinea,ISL,Iceland,2016,1,1,0
GIN,Guinea,ISL,Iceland,2017,1,0,1
GIN,Guinea,ITA,Italy,2008,375,14,361
GIN,Guinea,ITA,Italy,2009,338,14,324
GIN,Guinea,ITA,Italy,2010,391,12,379
GIN,Guinea,ITA,Italy,2011,417,11,406
GIN,Guinea,ITA,Italy,2012,533,21,512
GIN,Guinea,ITA,Italy,2013,385,16,369
GIN,Guinea,ITA,Italy,2014,441,19,422
GIN,Guinea,ITA,Italy,2015,880,33,847
GIN,Guinea,ITA,Italy,2016,2297,0,2297
GIN,Guinea,ITA,Italy,2017,5396,67,5329
GIN,Guinea,JPN,Japan,2008,30,25,5
GIN,Guinea,JPN,Japan,2009,20,12,8
GIN,Guinea,JPN,Japan,2010,15,9,6
GIN,Guinea,JPN,Japan,2011,13,7,6
GIN,Guinea,JPN,Japan,2012,43,31,12
GIN,Guinea,JPN,Japan,2013,67,56,11
GIN,Guinea,JPN,Japan,2014,32,17,15
GIN,Guinea,JPN,Japan,2015,39,20,19
GIN,Guinea,JPN,Japan,2016,66,35,31
GIN,Guinea,JPN,Japan,2017,84,66,18
GIN,Guinea,KOR,Korea,2008,8,7,1
GIN,Guinea,KOR,Korea,2009,2,3,-1
GIN,Guinea,KOR,Korea,2010,4,4,0
GIN,Guinea,KOR,Korea,2011,13,2,11
GIN,Guinea,KOR,Korea,2012,21,14,7
GIN,Guinea,KOR,Korea,2013,21,7,14
GIN,Guinea,KOR,Korea,2014,21,10,11
GIN,Guinea,KOR,Korea,2015,11,8,3
GIN,Guinea,KOR,Korea,2016,39,7,32
GIN,Guinea,KOR,Korea,2017,96,15,81
GIN,Guinea,LUX,Luxembourg,2008,9,9,0
GIN,Guinea,LUX,Luxembourg,2009,11,1,10
GIN,Guinea,LUX,Luxembourg,2010,7,3,4
GIN,Guinea,LUX,Luxembourg,2011,7,2,5
GIN,Guinea,LUX,Luxembourg,2012,16,1,15
GIN,Guinea,LUX,Luxembourg,2013,12,7,5
GIN,Guinea,LUX,Luxembourg,2014,27,3,24
GIN,Guinea,LUX,Luxembourg,2015,28,8,20
GIN,Guinea,LUX,Luxembourg,2016,65,6,59
GIN,Guinea,LUX,Luxembourg,2017,37,14,23
GIN,Guinea,MEX,Mexico,2008,4,0,4
GIN,Guinea,MEX,Mexico,2009,48,0,48
GIN,Guinea,MEX,Mexico,2010,4,0,4
GIN,Guinea,MEX,Mexico,2011,4,0,4
GIN,Guinea,MEX,Mexico,2012,4,0,4
GIN,Guinea,MEX,Mexico,2013,13,0,13
GIN,Guinea,MEX,Mexico,2014,9,0,9
GIN,Guinea,MEX,Mexico,2015,15,0,15
GIN,Guinea,MEX,Mexico,2016,9,0,9
GIN,Guinea,MEX,Mexico,2017,7,0,7
GIN,Guinea,NLD,Netherlands,2008,29,6,23
GIN,Guinea,NLD,Netherlands,2009,39,6,33
GIN,Guinea,NLD,Netherlands,2010,30,5,25
GIN,Guinea,NLD,Netherlands,2011,31,20,11
GIN,Guinea,NLD,Netherlands,2012,29,11,18
GIN,Guinea,NLD,Netherlands,2013,48,5,43
GIN,Guinea,NLD,Netherlands,2014,70,15,55
GIN,Guinea,NLD,Netherlands,2015,81,13,68
GIN,Guinea,NLD,Netherlands,2016,63,5,58
GIN,Guinea,NLD,Netherlands,2017,73,15,58
GIN,Guinea,NZL,New Zealand,2008,1,0,1
GIN,Guinea,NZL,New Zealand,2009,2,0,2
GIN,Guinea,NZL,New Zealand,2011,1,0,1
GIN,Guinea,NZL,New Zealand,2012,0,0,0
GIN,Guinea,NOR,Norway,2008,8,0,8
GIN,Guinea,NOR,Norway,2009,15,0,15
GIN,Guinea,NOR,Norway,2010,18,3,15
GIN,Guinea,NOR,Norway,2011,22,1,21
GIN,Guinea,NOR,Norway,2012,14,1,13
GIN,Guinea,NOR,Norway,2013,33,0,33
GIN,Guinea,NOR,Norway,2014,5,1,4
GIN,Guinea,NOR,Norway,2015,11,2,9
GIN,Guinea,NOR,Norway,2016,9,6,3
GIN,Guinea,NOR,Norway,2017,15,6,9
GIN,Guinea,POL,Poland,2009,36,0,36
GIN,Guinea,POL,Poland,2010,18,0,18
GIN,Guinea,POL,Poland,2011,18,0,18
GIN,Guinea,POL,Poland,2012,20,0,20
GIN,Guinea,POL,Poland,2013,10,0,10
GIN,Guinea,POL,Poland,2014,15,0,15
GIN,Guinea,POL,Poland,2015,17,0,17
GIN,Guinea,POL,Poland,2016,13,0,13
GIN,Guinea,POL,Poland,2017,15,0,15
GIN,Guinea,PRT,Portugal,2008,220,0,220
GIN,Guinea,PRT,Portugal,2009,142,0,142
GIN,Guinea,PRT,Portugal,2010,222,0,222
GIN,Guinea,PRT,Portugal,2011,375,0,375
GIN,Guinea,PRT,Portugal,2012,253,0,253
GIN,Guinea,PRT,Portugal,2013,151,0,151
GIN,Guinea,PRT,Portugal,2014,132,0,132
GIN,Guinea,PRT,Portugal,2015,128,0,128
GIN,Guinea,PRT,Portugal,2016,198,0,198
GIN,Guinea,PRT,Portugal,2017,158,0,158
GIN,Guinea,SVK,Slovak Republic,2008,0,1,-1
GIN,Guinea,SVK,Slovak Republic,2010,2,0,2
GIN,Guinea,SVK,Slovak Republic,2011,1,0,1
GIN,Guinea,ESP,Spain,2008,1757,761,996
GIN,Guinea,ESP,Spain,2009,1268,1103,165
GIN,Guinea,ESP,Spain,2010,892,1209,-317
GIN,Guinea,ESP,Spain,2011,733,1512,-779
GIN,Guinea,ESP,Spain,2012,673,1268,-595
GIN,Guinea,ESP,Spain,2013,620,1420,-800
GIN,Guinea,ESP,Spain,2014,631,779,-148
GIN,Guinea,ESP,Spain,2015,709,611,98
GIN,Guinea,ESP,Spain,2016,797,587,210
GIN,Guinea,ESP,Spain,2017,752,795,-43
GIN,Guinea,SWE,Sweden,2008,31,0,31
GIN,Guinea,SWE,Sweden,2009,47,0,47
GIN,Guinea,SWE,Sweden,2010,38,2,36
GIN,Guinea,SWE,Sweden,2011,41,0,41
GIN,Guinea,SWE,Sweden,2012,52,3,49
GIN,Guinea,SWE,Sweden,2013,43,0,43
GIN,Guinea,SWE,Sweden,2014,43,2,41
GIN,Guinea,SWE,Sweden,2015,30,2,28
GIN,Guinea,SWE,Sweden,2016,42,0,42
GIN,Guinea,SWE,Sweden,2017,36,4,32
GIN,Guinea,CHE,Switzerland,2010,73,24,49
GIN,Guinea,CHE,Switzerland,2011,62,23,39
GIN,Guinea,CHE,Switzerland,2012,54,16,38
GIN,Guinea,CHE,Switzerland,2013,48,20,28
GIN,Guinea,CHE,Switzerland,2014,61,16,45
GIN,Guinea,CHE,Switzerland,2015,69,9,60
GIN,Guinea,CHE,Switzerland,2016,65,10,55
GIN,Guinea,CHE,Switzerland,2017,75,13,62
GIN,Guinea,TUR,Turkey,2010,9,0,9
GIN,Guinea,TUR,Turkey,2017,255,45,210
GIN,Guinea,USA,United States,2008,1735,0,1735
GIN,Guinea,USA,United States,2009,1725,0,1725
GIN,Guinea,USA,United States,2010,1379,0,1379
GIN,Guinea,USA,United States,2011,1555,0,1555
GIN,Guinea,USA,United States,2012,1656,0,1656
GIN,Guinea,USA,United States,2013,1518,0,1518
GIN,Guinea,USA,United States,2014,1375,0,1375
GIN,Guinea,USA,United States,2015,1389,0,1389
GIN,Guinea,USA,United States,2016,1501,0,1501
GIN,Guinea,USA,United States,2017,1348,0,1348
GIN,Guinea,CHL,Chile,2008,1,0,1
GIN,Guinea,CHL,Chile,2009,1,0,1
GIN,Guinea,CHL,Chile,2010,0,0,0
GIN,Guinea,CHL,Chile,2011,0,0,0
GIN,Guinea,CHL,Chile,2012,2,0,2
GIN,Guinea,CHL,Chile,2013,1,0,1
GIN,Guinea,CHL,Chile,2014,1,0,1
GIN,Guinea,CHL,Chile,2015,3,0,3
GIN,Guinea,CHL,Chile,2016,1,0,1
GIN,Guinea,EST,Estonia,2008,0,0,0
GIN,Guinea,EST,Estonia,2009,0,0,0
GIN,Guinea,EST,Estonia,2010,0,0,0
GIN,Guinea,EST,Estonia,2011,0,0,0
GIN,Guinea,EST,Estonia,2012,1,0,1
GIN,Guinea,EST,Estonia,2013,0,0,0
GIN,Guinea,EST,Estonia,2014,0,0,0
GIN,Guinea,EST,Estonia,2015,0,0,0
GIN,Guinea,EST,Estonia,2016,0,0,0
GIN,Guinea,EST,Estonia,2017,2,0,2
GNB,Guinea-Bissau,AUS,Australia,2008,0,0,0
GNB,Guinea-Bissau,AUS,Australia,2009,0,0,0
GNB,Guinea-Bissau,AUS,Australia,2010,0,0,0
GNB,Guinea-Bissau,AUS,Australia,2011,1,0,1
GNB,Guinea-Bissau,AUS,Australia,2012,0,0,0
GNB,Guinea-Bissau,AUS,Australia,2013,0,0,0
GNB,Guinea-Bissau,AUS,Australia,2014,0,0,0
GNB,Guinea-Bissau,AUS,Australia,2015,0,0,0
GNB,Guinea-Bissau,AUS,Australia,2017,3,0,3
GNB,Guinea-Bissau,AUT,Austria,2008,20,23,-3
GNB,Guinea-Bissau,AUT,Austria,2009,23,25,-2
GNB,Guinea-Bissau,AUT,Austria,2010,19,21,-2
GNB,Guinea-Bissau,AUT,Austria,2011,27,16,11
GNB,Guinea-Bissau,AUT,Austria,2012,11,30,-19
GNB,Guinea-Bissau,AUT,Austria,2013,23,12,11
GNB,Guinea-Bissau,AUT,Austria,2014,9,11,-2
GNB,Guinea-Bissau,AUT,Austria,2015,8,11,-3
GNB,Guinea-Bissau,AUT,Austria,2016,9,7,2
GNB,Guinea-Bissau,AUT,Austria,2017,6,5,1
GNB,Guinea-Bissau,BEL,Belgium,2008,7,0,7
GNB,Guinea-Bissau,BEL,Belgium,2009,3,0,3
GNB,Guinea-Bissau,BEL,Belgium,2010,3,2,1
GNB,Guinea-Bissau,BEL,Belgium,2012,25,14,11
GNB,Guinea-Bissau,BEL,Belgium,2013,18,15,3
GNB,Guinea-Bissau,BEL,Belgium,2014,9,13,-4
GNB,Guinea-Bissau,BEL,Belgium,2015,11,11,0
GNB,Guinea-Bissau,BEL,Belgium,2016,13,1,12
GNB,Guinea-Bissau,BEL,Belgium,2017,11,2,9
GNB,Guinea-Bissau,CAN,Canada,2008,2,0,2
GNB,Guinea-Bissau,CAN,Canada,2009,0,0,0
GNB,Guinea-Bissau,CAN,Canada,2010,2,0,2
GNB,Guinea-Bissau,CAN,Canada,2011,2,0,2
GNB,Guinea-Bissau,CAN,Canada,2012,4,0,4
GNB,Guinea-Bissau,CAN,Canada,2013,0,0,0
GNB,Guinea-Bissau,CAN,Canada,2014,4,0,4
GNB,Guinea-Bissau,CAN,Canada,2015,5,0,5
GNB,Guinea-Bissau,CAN,Canada,2016,5,0,5
GNB,Guinea-Bissau,CAN,Canada,2017,0,0,0
GNB,Guinea-Bissau,CZE,Czech Republic,2008,4,1,3
GNB,Guinea-Bissau,CZE,Czech Republic,2009,1,0,1
GNB,Guinea-Bissau,CZE,Czech Republic,2011,2,0,2
GNB,Guinea-Bissau,DNK,Denmark,2008,2,0,2
GNB,Guinea-Bissau,DNK,Denmark,2009,5,3,2
GNB,Guinea-Bissau,DNK,Denmark,2010,5,1,4
GNB,Guinea-Bissau,DNK,Denmark,2011,1,3,-2
GNB,Guinea-Bissau,DNK,Denmark,2012,3,0,3
GNB,Guinea-Bissau,DNK,Denmark,2013,5,0,5
GNB,Guinea-Bissau,DNK,Denmark,2014,6,1,5
GNB,Guinea-Bissau,DNK,Denmark,2015,3,0,3
GNB,Guinea-Bissau,DNK,Denmark,2016,1,1,0
GNB,Guinea-Bissau,DNK,Denmark,2017,0,2,-2
GNB,Guinea-Bissau,FIN,Finland,2008,0,0,0
GNB,Guinea-Bissau,FIN,Finland,2009,0,0,0
GNB,Guinea-Bissau,FIN,Finland,2010,1,0,1
GNB,Guinea-Bissau,FIN,Finland,2011,0,0,0
GNB,Guinea-Bissau,FIN,Finland,2012,0,1,-1
GNB,Guinea-Bissau,FIN,Finland,2013,1,0,1
GNB,Guinea-Bissau,FIN,Finland,2014,1,0,1
GNB,Guinea-Bissau,FIN,Finland,2015,1,0,1
GNB,Guinea-Bissau,FIN,Finland,2016,0,0,0
GNB,Guinea-Bissau,FIN,Finland,2017,0,0,0
GNB,Guinea-Bissau,FRA,France,2008,117,0,117
GNB,Guinea-Bissau,FRA,France,2009,104,0,104
GNB,Guinea-Bissau,FRA,France,2010,127,0,127
GNB,Guinea-Bissau,FRA,France,2011,110,0,110
GNB,Guinea-Bissau,FRA,France,2012,180,0,180
GNB,Guinea-Bissau,FRA,France,2013,127,0,127
GNB,Guinea-Bissau,FRA,France,2014,212,0,212
GNB,Guinea-Bissau,FRA,France,2015,224,0,224
GNB,Guinea-Bissau,FRA,France,2016,203,0,203
GNB,Guinea-Bissau,FRA,France,2017,170,0,170
GNB,Guinea-Bissau,DEU,Germany,2008,67,38,29
GNB,Guinea-Bissau,DEU,Germany,2009,65,61,4
GNB,Guinea-Bissau,DEU,Germany,2010,60,48,12
GNB,Guinea-Bissau,DEU,Germany,2011,75,44,31
GNB,Guinea-Bissau,DEU,Germany,2012,148,50,98
GNB,Guinea-Bissau,DEU,Germany,2013,299,81,218
GNB,Guinea-Bissau,DEU,Germany,2014,442,182,260
GNB,Guinea-Bissau,DEU,Germany,2015,715,287,428
GNB,Guinea-Bissau,DEU,Germany,2016,672,462,210
GNB,Guinea-Bissau,DEU,Germany,2017,460,561,-101
GNB,Guinea-Bissau,HUN,Hungary,2008,0,0,0
GNB,Guinea-Bissau,HUN,Hungary,2009,0,0,0
GNB,Guinea-Bissau,HUN,Hungary,2010,0,0,0
GNB,Guinea-Bissau,HUN,Hungary,2011,0,0,0
GNB,Guinea-Bissau,HUN,Hungary,2012,0,0,0
GNB,Guinea-Bissau,HUN,Hungary,2013,1,0,1
GNB,Guinea-Bissau,HUN,Hungary,2014,0,0,0
GNB,Guinea-Bissau,HUN,Hungary,2015,1,0,1
GNB,Guinea-Bissau,HUN,Hungary,2016,0,0,0
GNB,Guinea-Bissau,HUN,Hungary,2017,0,0,0
GNB,Guinea-Bissau,ISL,Iceland,2008,0,0,0
GNB,Guinea-Bissau,ISL,Iceland,2009,0,0,0
GNB,Guinea-Bissau,ISL,Iceland,2010,0,0,0
GNB,Guinea-Bissau,ISL,Iceland,2011,0,0,0
GNB,Guinea-Bissau,ISL,Iceland,2012,0,0,0
GNB,Guinea-Bissau,ISL,Iceland,2013,0,0,0
GNB,Guinea-Bissau,ISL,Iceland,2014,0,0,0
GNB,Guinea-Bissau,ISL,Iceland,2015,0,0,0
GNB,Guinea-Bissau,ISL,Iceland,2016,1,0,1
GNB,Guinea-Bissau,ISL,Iceland,2017,0,0,0
GNB,Guinea-Bissau,ITA,Italy,2008,30,0,30
GNB,Guinea-Bissau,ITA,Italy,2009,71,0,71
GNB,Guinea-Bissau,ITA,Italy,2010,53,2,51
GNB,Guinea-Bissau,ITA,Italy,2011,42,1,41
GNB,Guinea-Bissau,ITA,Italy,2012,115,5,110
GNB,Guinea-Bissau,ITA,Italy,2013,108,1,107
GNB,Guinea-Bissau,ITA,Italy,2014,146,6,140
GNB,Guinea-Bissau,ITA,Italy,2015,336,8,328
GNB,Guinea-Bissau,ITA,Italy,2016,501,0,501
GNB,Guinea-Bissau,ITA,Italy,2017,815,11,804
GNB,Guinea-Bissau,JPN,Japan,2008,13,12,1
GNB,Guinea-Bissau,JPN,Japan,2009,10,10,0
GNB,Guinea-Bissau,JPN,Japan,2010,24,23,1
GNB,Guinea-Bissau,JPN,Japan,2011,6,6,0
GNB,Guinea-Bissau,JPN,Japan,2012,4,4,0
GNB,Guinea-Bissau,JPN,Japan,2013,4,3,1
GNB,Guinea-Bissau,JPN,Japan,2014,4,3,1
GNB,Guinea-Bissau,JPN,Japan,2015,22,22,0
GNB,Guinea-Bissau,JPN,Japan,2016,11,10,1
GNB,Guinea-Bissau,JPN,Japan,2017,10,8,2
GNB,Guinea-Bissau,KOR,Korea,2008,1,0,1
GNB,Guinea-Bissau,KOR,Korea,2009,1,0,1
GNB,Guinea-Bissau,KOR,Korea,2010,1,0,1
GNB,Guinea-Bissau,KOR,Korea,2011,0,0,0
GNB,Guinea-Bissau,KOR,Korea,2012,1,2,-1
GNB,Guinea-Bissau,KOR,Korea,2013,0,0,0
GNB,Guinea-Bissau,KOR,Korea,2014,0,3,-3
GNB,Guinea-Bissau,KOR,Korea,2015,2,0,2
GNB,Guinea-Bissau,KOR,Korea,2016,2,0,2
GNB,Guinea-Bissau,KOR,Korea,2017,7,1,6
GNB,Guinea-Bissau,LUX,Luxembourg,2008,12,4,8
GNB,Guinea-Bissau,LUX,Luxembourg,2009,22,0,22
GNB,Guinea-Bissau,LUX,Luxembourg,2010,7,1,6
GNB,Guinea-Bissau,LUX,Luxembourg,2011,31,2,29
GNB,Guinea-Bissau,LUX,Luxembourg,2012,33,1,32
GNB,Guinea-Bissau,LUX,Luxembourg,2013,33,5,28
GNB,Guinea-Bissau,LUX,Luxembourg,2014,37,3,34
GNB,Guinea-Bissau,LUX,Luxembourg,2015,34,5,29
GNB,Guinea-Bissau,LUX,Luxembourg,2016,55,5,50
GNB,Guinea-Bissau,LUX,Luxembourg,2017,45,3,42
GNB,Guinea-Bissau,MEX,Mexico,2010,1,0,1
GNB,Guinea-Bissau,MEX,Mexico,2011,1,0,1
GNB,Guinea-Bissau,MEX,Mexico,2012,0,0,0
GNB,Guinea-Bissau,MEX,Mexico,2013,1,0,1
GNB,Guinea-Bissau,MEX,Mexico,2014,1,0,1
GNB,Guinea-Bissau,MEX,Mexico,2016,0,0,0
GNB,Guinea-Bissau,NLD,Netherlands,2008,3,0,3
GNB,Guinea-Bissau,NLD,Netherlands,2009,2,2,0
GNB,Guinea-Bissau,NLD,Netherlands,2010,2,-2,4
GNB,Guinea-Bissau,NLD,Netherlands,2011,3,4,-1
GNB,Guinea-Bissau,NLD,Netherlands,2012,1,1,0
GNB,Guinea-Bissau,NLD,Netherlands,2013,7,2,5
GNB,Guinea-Bissau,NLD,Netherlands,2014,4,2,2
GNB,Guinea-Bissau,NLD,Netherlands,2015,4,2,2
GNB,Guinea-Bissau,NLD,Netherlands,2016,7,6,1
GNB,Guinea-Bissau,NLD,Netherlands,2017,4,1,3
GNB,Guinea-Bissau,NZL,New Zealand,2012,0,0,0
GNB,Guinea-Bissau,NOR,Norway,2008,3,0,3
GNB,Guinea-Bissau,NOR,Norway,2009,0,1,-1
GNB,Guinea-Bissau,NOR,Norway,2010,1,0,1
GNB,Guinea-Bissau,NOR,Norway,2011,2,0,2
GNB,Guinea-Bissau,NOR,Norway,2012,2,0,2
GNB,Guinea-Bissau,NOR,Norway,2013,5,1,4
GNB,Guinea-Bissau,NOR,Norway,2014,0,0,0
GNB,Guinea-Bissau,NOR,Norway,2015,2,0,2
GNB,Guinea-Bissau,NOR,Norway,2016,0,0,0
GNB,Guinea-Bissau,NOR,Norway,2017,0,0,0
GNB,Guinea-Bissau,POL,Poland,2009,4,0,4
GNB,Guinea-Bissau,POL,Poland,2010,5,0,5
GNB,Guinea-Bissau,POL,Poland,2011,4,0,4
GNB,Guinea-Bissau,POL,Poland,2012,1,0,1
GNB,Guinea-Bissau,POL,Poland,2013,0,0,0
GNB,Guinea-Bissau,POL,Poland,2014,0,0,0
GNB,Guinea-Bissau,POL,Poland,2015,1,0,1
GNB,Guinea-Bissau,POL,Poland,2016,1,0,1
GNB,Guinea-Bissau,POL,Poland,2017,2,0,2
GNB,Guinea-Bissau,PRT,Portugal,2008,2455,0,2455
GNB,Guinea-Bissau,PRT,Portugal,2009,1485,0,1485
GNB,Guinea-Bissau,PRT,Portugal,2010,1567,0,1567
GNB,Guinea-Bissau,PRT,Portugal,2011,1744,0,1744
GNB,Guinea-Bissau,PRT,Portugal,2012,1620,0,1620
GNB,Guinea-Bissau,PRT,Portugal,2013,1235,0,1235
GNB,Guinea-Bissau,PRT,Portugal,2014,1239,0,1239
GNB,Guinea-Bissau,PRT,Portugal,2015,1129,0,1129
GNB,Guinea-Bissau,PRT,Portugal,2016,951,0,951
GNB,Guinea-Bissau,PRT,Portugal,2017,1120,0,1120
GNB,Guinea-Bissau,SVK,Slovak Republic,2008,0,0,0
GNB,Guinea-Bissau,ESP,Spain,2008,690,494,196
GNB,Guinea-Bissau,ESP,Spain,2009,384,568,-184
GNB,Guinea-Bissau,ESP,Spain,2010,275,545,-270
GNB,Guinea-Bissau,ESP,Spain,2011,325,477,-152
GNB,Guinea-Bissau,ESP,Spain,2012,355,418,-63
GNB,Guinea-Bissau,ESP,Spain,2013,302,499,-197
GNB,Guinea-Bissau,ESP,Spain,2014,309,314,-5
GNB,Guinea-Bissau,ESP,Spain,2015,296,179,117
GNB,Guinea-Bissau,ESP,Spain,2016,243,242,1
GNB,Guinea-Bissau,ESP,Spain,2017,265,350,-85
GNB,Guinea-Bissau,SWE,Sweden,2008,4,1,3
GNB,Guinea-Bissau,SWE,Sweden,2009,5,1,4
GNB,Guinea-Bissau,SWE,Sweden,2010,9,0,9
GNB,Guinea-Bissau,SWE,Sweden,2011,3,0,3
GNB,Guinea-Bissau,SWE,Sweden,2012,6,0,6
GNB,Guinea-Bissau,SWE,Sweden,2013,4,1,3
GNB,Guinea-Bissau,SWE,Sweden,2014,5,1,4
GNB,Guinea-Bissau,SWE,Sweden,2015,5,0,5
GNB,Guinea-Bissau,SWE,Sweden,2016,1,0,1
GNB,Guinea-Bissau,SWE,Sweden,2017,2,1,1
GNB,Guinea-Bissau,CHE,Switzerland,2010,5,1,4
GNB,Guinea-Bissau,CHE,Switzerland,2011,13,1,12
GNB,Guinea-Bissau,CHE,Switzerland,2012,11,4,7
GNB,Guinea-Bissau,CHE,Switzerland,2013,8,2,6
GNB,Guinea-Bissau,CHE,Switzerland,2014,7,1,6
GNB,Guinea-Bissau,CHE,Switzerland,2015,5,0,5
GNB,Guinea-Bissau,CHE,Switzerland,2016,7,0,7
GNB,Guinea-Bissau,CHE,Switzerland,2017,13,0,13
GNB,Guinea-Bissau,USA,United States,2008,17,0,17
GNB,Guinea-Bissau,USA,United States,2009,20,0,20
GNB,Guinea-Bissau,USA,United States,2010,30,0,30
GNB,Guinea-Bissau,USA,United States,2011,29,0,29
GNB,Guinea-Bissau,USA,United States,2012,47,0,47
GNB,Guinea-Bissau,USA,United States,2013,43,0,43
GNB,Guinea-Bissau,USA,United States,2014,30,0,30
GNB,Guinea-Bissau,USA,United States,2015,39,0,39
GNB,Guinea-Bissau,USA,United States,2016,37,0,37
GNB,Guinea-Bissau,USA,United States,2017,48,0,48
GNB,Guinea-Bissau,CHL,Chile,2008,0,0,0
GNB,Guinea-Bissau,CHL,Chile,2009,0,0,0
GNB,Guinea-Bissau,CHL,Chile,2010,0,0,0
GNB,Guinea-Bissau,CHL,Chile,2011,0,0,0
GNB,Guinea-Bissau,CHL,Chile,2012,0,0,0
GNB,Guinea-Bissau,CHL,Chile,2013,1,0,1
GNB,Guinea-Bissau,CHL,Chile,2014,0,0,0
GNB,Guinea-Bissau,CHL,Chile,2015,1,0,1
GNB,Guinea-Bissau,CHL,Chile,2016,0,0,0
GNB,Guinea-Bissau,EST,Estonia,2008,0,0,0
GNB,Guinea-Bissau,EST,Estonia,2009,0,0,0
GNB,Guinea-Bissau,EST,Estonia,2010,0,0,0
GNB,Guinea-Bissau,EST,Estonia,2011,0,0,0
GNB,Guinea-Bissau,EST,Estonia,2012,0,0,0
GNB,Guinea-Bissau,EST,Estonia,2013,0,0,0
GNB,Guinea-Bissau,EST,Estonia,2014,0,0,0
GNB,Guinea-Bissau,EST,Estonia,2015,0,0,0
GNB,Guinea-Bissau,EST,Estonia,2016,0,0,0
GNB,Guinea-Bissau,EST,Estonia,2017,0,0,0
GNB,Guinea-Bissau,SVN,Slovenia,2011,1,0,1
GNB,Guinea-Bissau,SVN,Slovenia,2017,3,0,3
GUY,Guyana,AUS,Australia,2008,2,0,2
GUY,Guyana,AUS,Australia,2009,6,0,6
GUY,Guyana,AUS,Australia,2010,2,0,2
GUY,Guyana,AUS,Australia,2011,2,0,2
GUY,Guyana,AUS,Australia,2012,6,0,6
GUY,Guyana,AUS,Australia,2013,6,9,-3
GUY,Guyana,AUS,Australia,2014,5,6,-1
GUY,Guyana,AUS,Australia,2015,0,0,0
GUY,Guyana,AUS,Australia,2017,3,0,3
GUY,Guyana,AUT,Austria,2008,0,1,-1
GUY,Guyana,AUT,Austria,2009,1,1,0
GUY,Guyana,AUT,Austria,2010,2,0,2
GUY,Guyana,AUT,Austria,2011,0,2,-2
GUY,Guyana,AUT,Austria,2012,0,0,0
GUY,Guyana,AUT,Austria,2013,0,0,0
GUY,Guyana,AUT,Austria,2014,0,1,-1
GUY,Guyana,AUT,Austria,2015,0,0,0
GUY,Guyana,AUT,Austria,2016,0,0,0
GUY,Guyana,AUT,Austria,2017,1,0,1
GUY,Guyana,BEL,Belgium,2008,4,0,4
GUY,Guyana,BEL,Belgium,2009,4,0,4
GUY,Guyana,BEL,Belgium,2010,2,3,-1
GUY,Guyana,BEL,Belgium,2012,4,2,2
GUY,Guyana,BEL,Belgium,2013,2,1,1
GUY,Guyana,BEL,Belgium,2014,7,0,7
GUY,Guyana,BEL,Belgium,2015,6,3,3
GUY,Guyana,BEL,Belgium,2016,4,1,3
GUY,Guyana,BEL,Belgium,2017,2,2,0
GUY,Guyana,CAN,Canada,2008,1137,0,1137
GUY,Guyana,CAN,Canada,2009,1180,0,1180
GUY,Guyana,CAN,Canada,2010,953,0,953
GUY,Guyana,CAN,Canada,2011,803,0,803
GUY,Guyana,CAN,Canada,2012,671,0,671
GUY,Guyana,CAN,Canada,2013,656,0,656
GUY,Guyana,CAN,Canada,2014,784,0,784
GUY,Guyana,CAN,Canada,2015,540,0,540
GUY,Guyana,CAN,Canada,2016,515,0,515
GUY,Guyana,CAN,Canada,2017,430,0,430
GUY,Guyana,CZE,Czech Republic,2010,1,0,1
GUY,Guyana,DNK,Denmark,2008,0,0,0
GUY,Guyana,DNK,Denmark,2009,0,0,0
GUY,Guyana,DNK,Denmark,2012,0,0,0
GUY,Guyana,DNK,Denmark,2013,0,0,0
GUY,Guyana,DNK,Denmark,2014,1,1,0
GUY,Guyana,DNK,Denmark,2015,0,0,0
GUY,Guyana,DNK,Denmark,2016,0,0,0
GUY,Guyana,DNK,Denmark,2017,1,0,1
GUY,Guyana,FIN,Finland,2008,0,1,-1
GUY,Guyana,FIN,Finland,2009,0,0,0
GUY,Guyana,FIN,Finland,2010,4,0,4
GUY,Guyana,FIN,Finland,2011,1,0,1
GUY,Guyana,FIN,Finland,2012,0,0,0
GUY,Guyana,FIN,Finland,2013,0,0,0
GUY,Guyana,FIN,Finland,2014,1,0,1
GUY,Guyana,FIN,Finland,2015,1,1,0
GUY,Guyana,FIN,Finland,2016,0,0,0
GUY,Guyana,FIN,Finland,2017,0,1,-1
GUY,Guyana,FRA,France,2008,119,0,119
GUY,Guyana,FRA,France,2009,124,0,124
GUY,Guyana,FRA,France,2010,194,0,194
GUY,Guyana,FRA,France,2011,129,0,129
GUY,Guyana,FRA,France,2012,161,0,161
GUY,Guyana,FRA,France,2013,234,0,234
GUY,Guyana,FRA,France,2014,184,0,184
GUY,Guyana,FRA,France,2015,162,0,162
GUY,Guyana,FRA,France,2016,146,0,146
GUY,Guyana,FRA,France,2017,111,0,111
GUY,Guyana,DEU,Germany,2008,6,9,-3
GUY,Guyana,DEU,Germany,2009,7,6,1
GUY,Guyana,DEU,Germany,2010,5,5,0
GUY,Guyana,DEU,Germany,2011,10,4,6
GUY,Guyana,DEU,Germany,2012,5,6,-1
GUY,Guyana,DEU,Germany,2013,8,7,1
GUY,Guyana,DEU,Germany,2014,8,2,6
GUY,Guyana,DEU,Germany,2015,7,10,-3
GUY,Guyana,DEU,Germany,2016,11,8,3
GUY,Guyana,DEU,Germany,2017,4,1,3
GUY,Guyana,HUN,Hungary,2008,0,0,0
GUY,Guyana,HUN,Hungary,2009,0,0,0
GUY,Guyana,HUN,Hungary,2010,0,0,0
GUY,Guyana,HUN,Hungary,2011,0,0,0
GUY,Guyana,HUN,Hungary,2012,1,0,1
GUY,Guyana,HUN,Hungary,2013,1,0,1
GUY,Guyana,HUN,Hungary,2014,0,0,0
GUY,Guyana,HUN,Hungary,2015,1,0,1
GUY,Guyana,HUN,Hungary,2016,0,0,0
GUY,Guyana,HUN,Hungary,2017,2,0,2
GUY,Guyana,ISL,Iceland,2008,0,2,-2
GUY,Guyana,ISL,Iceland,2009,0,0,0
GUY,Guyana,ISL,Iceland,2010,0,0,0
GUY,Guyana,ISL,Iceland,2011,0,0,0
GUY,Guyana,ISL,Iceland,2012,0,0,0
GUY,Guyana,ISL,Iceland,2013,0,0,0
GUY,Guyana,ISL,Iceland,2014,1,0,1
GUY,Guyana,ISL,Iceland,2015,1,0,1
GUY,Guyana,ISL,Iceland,2016,0,0,0
GUY,Guyana,ISL,Iceland,2017,0,0,0
GUY,Guyana,ITA,Italy,2008,5,0,5
GUY,Guyana,ITA,Italy,2009,1,0,1
GUY,Guyana,ITA,Italy,2010,2,0,2
GUY,Guyana,ITA,Italy,2011,3,0,3
GUY,Guyana,ITA,Italy,2012,4,0,4
GUY,Guyana,ITA,Italy,2013,5,1,4
GUY,Guyana,ITA,Italy,2014,6,0,6
GUY,Guyana,ITA,Italy,2015,4,0,4
GUY,Guyana,ITA,Italy,2016,4,0,4
GUY,Guyana,ITA,Italy,2017,4,0,4
GUY,Guyana,JPN,Japan,2008,11,11,0
GUY,Guyana,JPN,Japan,2009,6,7,-1
GUY,Guyana,JPN,Japan,2010,15,14,1
GUY,Guyana,JPN,Japan,2011,4,5,-1
GUY,Guyana,JPN,Japan,2012,17,17,0
GUY,Guyana,JPN,Japan,2013,16,15,1
GUY,Guyana,JPN,Japan,2014,18,16,2
GUY,Guyana,JPN,Japan,2015,14,14,0
GUY,Guyana,JPN,Japan,2016,11,12,-1
GUY,Guyana,JPN,Japan,2017,16,9,7
GUY,Guyana,KOR,Korea,2008,1,1,0
GUY,Guyana,KOR,Korea,2009,0,0,0
GUY,Guyana,KOR,Korea,2010,2,0,2
GUY,Guyana,KOR,Korea,2011,0,3,-3
GUY,Guyana,KOR,Korea,2012,1,3,-2
GUY,Guyana,KOR,Korea,2013,0,0,0
GUY,Guyana,KOR,Korea,2014,2,1,1
GUY,Guyana,KOR,Korea,2015,0,1,-1
GUY,Guyana,KOR,Korea,2016,2,3,-1
GUY,Guyana,KOR,Korea,2017,3,1,2
GUY,Guyana,LUX,Luxembourg,2008,0,0,0
GUY,Guyana,LUX,Luxembourg,2009,0,0,0
GUY,Guyana,LUX,Luxembourg,2010,0,0,0
GUY,Guyana,LUX,Luxembourg,2011,0,0,0
GUY,Guyana,LUX,Luxembourg,2012,0,0,0
GUY,Guyana,LUX,Luxembourg,2013,0,0,0
GUY,Guyana,LUX,Luxembourg,2014,0,0,0
GUY,Guyana,LUX,Luxembourg,2015,0,0,0
GUY,Guyana,LUX,Luxembourg,2016,0,0,0
GUY,Guyana,LUX,Luxembourg,2017,0,0,0
GUY,Guyana,MEX,Mexico,2008,1,0,1
GUY,Guyana,MEX,Mexico,2009,1,0,1
GUY,Guyana,MEX,Mexico,2012,2,0,2
GUY,Guyana,MEX,Mexico,2013,0,0,0
GUY,Guyana,MEX,Mexico,2014,3,0,3
GUY,Guyana,MEX,Mexico,2015,3,0,3
GUY,Guyana,MEX,Mexico,2016,1,0,1
GUY,Guyana,NLD,Netherlands,2008,18,7,11
GUY,Guyana,NLD,Netherlands,2009,9,1,8
GUY,Guyana,NLD,Netherlands,2010,10,5,5
GUY,Guyana,NLD,Netherlands,2011,12,2,10
GUY,Guyana,NLD,Netherlands,2012,15,7,8
GUY,Guyana,NLD,Netherlands,2013,8,7,1
GUY,Guyana,NLD,Netherlands,2014,9,7,2
GUY,Guyana,NLD,Netherlands,2015,16,2,14
GUY,Guyana,NLD,Netherlands,2016,11,5,6
GUY,Guyana,NLD,Netherlands,2017,11,9,2
GUY,Guyana,NZL,New Zealand,2008,4,0,4
GUY,Guyana,NZL,New Zealand,2009,1,1,0
GUY,Guyana,NZL,New Zealand,2010,5,3,2
GUY,Guyana,NZL,New Zealand,2011,3,1,2
GUY,Guyana,NZL,New Zealand,2012,0,0,0
GUY,Guyana,NZL,New Zealand,2013,1,1,0
GUY,Guyana,NZL,New Zealand,2015,3,0,3
GUY,Guyana,NZL,New Zealand,2016,5,0,5
GUY,Guyana,NZL,New Zealand,2017,2,3,-1
GUY,Guyana,NOR,Norway,2008,0,0,0
GUY,Guyana,NOR,Norway,2009,0,2,-2
GUY,Guyana,NOR,Norway,2010,3,2,1
GUY,Guyana,NOR,Norway,2011,0,0,0
GUY,Guyana,NOR,Norway,2012,5,0,5
GUY,Guyana,NOR,Norway,2013,1,2,-1
GUY,Guyana,NOR,Norway,2014,0,1,-1
GUY,Guyana,NOR,Norway,2015,0,0,0
GUY,Guyana,NOR,Norway,2016,2,0,2
GUY,Guyana,NOR,Norway,2017,2,0,2
GUY,Guyana,POL,Poland,2009,0,0,0
GUY,Guyana,POL,Poland,2010,0,0,0
GUY,Guyana,POL,Poland,2011,1,0,1
GUY,Guyana,POL,Poland,2012,1,0,1
GUY,Guyana,POL,Poland,2013,2,0,2
GUY,Guyana,POL,Poland,2014,1,0,1
GUY,Guyana,POL,Poland,2015,0,0,0
GUY,Guyana,POL,Poland,2016,3,0,3
GUY,Guyana,POL,Poland,2017,0,0,0
GUY,Guyana,SVK,Slovak Republic,2008,0,0,0
GUY,Guyana,ESP,Spain,2008,2,1,1
GUY,Guyana,ESP,Spain,2009,3,2,1
GUY,Guyana,ESP,Spain,2010,3,1,2
GUY,Guyana,ESP,Spain,2011,3,3,0
GUY,Guyana,ESP,Spain,2012,6,1,5
GUY,Guyana,ESP,Spain,2013,5,1,4
GUY,Guyana,ESP,Spain,2014,3,3,0
GUY,Guyana,ESP,Spain,2015,3,4,-1
GUY,Guyana,ESP,Spain,2016,4,1,3
GUY,Guyana,ESP,Spain,2017,8,3,5
GUY,Guyana,SWE,Sweden,2008,2,0,2
GUY,Guyana,SWE,Sweden,2009,1,1,0
GUY,Guyana,SWE,Sweden,2010,0,0,0
GUY,Guyana,SWE,Sweden,2011,2,0,2
GUY,Guyana,SWE,Sweden,2012,0,0,0
GUY,Guyana,SWE,Sweden,2013,3,0,3
GUY,Guyana,SWE,Sweden,2014,0,0,0
GUY,Guyana,SWE,Sweden,2015,0,1,-1
GUY,Guyana,SWE,Sweden,2016,1,0,1
GUY,Guyana,SWE,Sweden,2017,1,2,-1
GUY,Guyana,CHE,Switzerland,2010,1,3,-2
GUY,Guyana,CHE,Switzerland,2011,0,3,-3
GUY,Guyana,CHE,Switzerland,2012,2,0,2
GUY,Guyana,CHE,Switzerland,2013,1,1,0
GUY,Guyana,CHE,Switzerland,2014,0,2,-2
GUY,Guyana,CHE,Switzerland,2015,0,0,0
GUY,Guyana,CHE,Switzerland,2016,2,0,2
GUY,Guyana,CHE,Switzerland,2017,2,0,2
GUY,Guyana,USA,United States,2008,6823,0,6823
GUY,Guyana,USA,United States,2009,6670,0,6670
GUY,Guyana,USA,United States,2010,6749,0,6749
GUY,Guyana,USA,United States,2011,6599,0,6599
GUY,Guyana,USA,United States,2012,5683,0,5683
GUY,Guyana,USA,United States,2013,5897,0,5897
GUY,Guyana,USA,United States,2014,6267,0,6267
GUY,Guyana,USA,United States,2015,5543,0,5543
GUY,Guyana,USA,United States,2016,5771,0,5771
GUY,Guyana,USA,United States,2017,5468,0,5468
GUY,Guyana,CHL,Chile,2008,1,0,1
GUY,Guyana,CHL,Chile,2009,0,0,0
GUY,Guyana,CHL,Chile,2010,1,0,1
GUY,Guyana,CHL,Chile,2011,0,0,0
GUY,Guyana,CHL,Chile,2012,1,0,1
GUY,Guyana,CHL,Chile,2013,1,0,1
GUY,Guyana,CHL,Chile,2014,2,0,2
GUY,Guyana,CHL,Chile,2015,0,0,0
GUY,Guyana,CHL,Chile,2016,0,0,0
GUY,Guyana,EST,Estonia,2008,0,0,0
GUY,Guyana,EST,Estonia,2009,0,0,0
GUY,Guyana,EST,Estonia,2010,0,0,0
GUY,Guyana,EST,Estonia,2011,0,0,0
GUY,Guyana,EST,Estonia,2012,0,0,0
GUY,Guyana,EST,Estonia,2013,0,0,0
GUY,Guyana,EST,Estonia,2014,0,0,0
GUY,Guyana,EST,Estonia,2015,0,0,0
GUY,Guyana,EST,Estonia,2016,0,0,0
GUY,Guyana,EST,Estonia,2017,0,0,0
HTI,Haiti,AUS,Australia,2008,0,0,0
HTI,Haiti,AUS,Australia,2009,1,0,1
HTI,Haiti,AUS,Australia,2010,3,0,3
HTI,Haiti,AUS,Australia,2011,0,0,0
HTI,Haiti,AUS,Australia,2012,0,0,0
HTI,Haiti,AUS,Australia,2013,4,0,4
HTI,Haiti,AUS,Australia,2014,9,0,9
HTI,Haiti,AUS,Australia,2015,0,0,0
HTI,Haiti,AUS,Australia,2017,3,0,3
HTI,Haiti,AUT,Austria,2008,2,2,0
HTI,Haiti,AUT,Austria,2009,7,4,3
HTI,Haiti,AUT,Austria,2010,18,0,18
HTI,Haiti,AUT,Austria,2011,7,3,4
HTI,Haiti,AUT,Austria,2012,7,2,5
HTI,Haiti,AUT,Austria,2013,9,3,6
HTI,Haiti,AUT,Austria,2014,0,1,-1
HTI,Haiti,AUT,Austria,2015,2,3,-1
HTI,Haiti,AUT,Austria,2016,3,0,3
HTI,Haiti,AUT,Austria,2017,1,2,-1
HTI,Haiti,BEL,Belgium,2008,55,0,55
HTI,Haiti,BEL,Belgium,2009,58,0,58
HTI,Haiti,BEL,Belgium,2010,84,23,61
HTI,Haiti,BEL,Belgium,2012,37,32,5
HTI,Haiti,BEL,Belgium,2013,39,39,0
HTI,Haiti,BEL,Belgium,2014,39,31,8
HTI,Haiti,BEL,Belgium,2015,54,22,32
HTI,Haiti,BEL,Belgium,2016,44,29,15
HTI,Haiti,BEL,Belgium,2017,46,29,17
HTI,Haiti,CAN,Canada,2008,2488,0,2488
HTI,Haiti,CAN,Canada,2009,2079,0,2079
HTI,Haiti,CAN,Canada,2010,4730,0,4730
HTI,Haiti,CAN,Canada,2011,6469,0,6469
HTI,Haiti,CAN,Canada,2012,5856,0,5856
HTI,Haiti,CAN,Canada,2013,4147,0,4147
HTI,Haiti,CAN,Canada,2014,3315,0,3315
HTI,Haiti,CAN,Canada,2015,2727,0,2727
HTI,Haiti,CAN,Canada,2016,2920,0,2920
HTI,Haiti,CAN,Canada,2017,2330,0,2330
HTI,Haiti,CZE,Czech Republic,2010,1,0,1
HTI,Haiti,CZE,Czech Republic,2011,1,0,1
HTI,Haiti,CZE,Czech Republic,2012,1,0,1
HTI,Haiti,CZE,Czech Republic,2013,2,0,2
HTI,Haiti,CZE,Czech Republic,2014,1,0,1
HTI,Haiti,DNK,Denmark,2008,2,1,1
HTI,Haiti,DNK,Denmark,2009,3,0,3
HTI,Haiti,DNK,Denmark,2010,1,0,1
HTI,Haiti,DNK,Denmark,2011,1,1,0
HTI,Haiti,DNK,Denmark,2012,1,0,1
HTI,Haiti,DNK,Denmark,2013,1,2,-1
HTI,Haiti,DNK,Denmark,2014,1,0,1
HTI,Haiti,DNK,Denmark,2015,5,1,4
HTI,Haiti,DNK,Denmark,2016,1,1,0
HTI,Haiti,DNK,Denmark,2017,3,1,2
HTI,Haiti,FIN,Finland,2008,1,0,1
HTI,Haiti,FIN,Finland,2009,3,0,3
HTI,Haiti,FIN,Finland,2010,0,0,0
HTI,Haiti,FIN,Finland,2011,0,0,0
HTI,Haiti,FIN,Finland,2012,0,0,0
HTI,Haiti,FIN,Finland,2013,0,0,0
HTI,Haiti,FIN,Finland,2014,0,0,0
HTI,Haiti,FIN,Finland,2015,0,0,0
HTI,Haiti,FIN,Finland,2016,0,1,-1
HTI,Haiti,FIN,Finland,2017,0,0,0
HTI,Haiti,FRA,France,2008,2230,0,2230
HTI,Haiti,FRA,France,2009,2577,0,2577
HTI,Haiti,FRA,France,2010,4762,0,4762
HTI,Haiti,FRA,France,2011,3360,0,3360
HTI,Haiti,FRA,France,2012,3177,0,3177
HTI,Haiti,FRA,France,2013,3386,0,3386
HTI,Haiti,FRA,France,2014,3202,0,3202
HTI,Haiti,FRA,France,2015,3173,0,3173
HTI,Haiti,FRA,France,2016,2625,0,2625
HTI,Haiti,FRA,France,2017,2837,0,2837
HTI,Haiti,DEU,Germany,2008,96,15,81
HTI,Haiti,DEU,Germany,2009,55,31,24
HTI,Haiti,DEU,Germany,2010,128,28,100
HTI,Haiti,DEU,Germany,2011,95,23,72
HTI,Haiti,DEU,Germany,2012,116,47,69
HTI,Haiti,DEU,Germany,2013,132,71,61
HTI,Haiti,DEU,Germany,2014,64,42,22
HTI,Haiti,DEU,Germany,2015,53,33,20
HTI,Haiti,DEU,Germany,2016,63,31,32
HTI,Haiti,DEU,Germany,2017,49,24,25
HTI,Haiti,HUN,Hungary,2008,1,0,1
HTI,Haiti,HUN,Hungary,2009,0,0,0
HTI,Haiti,HUN,Hungary,2010,0,0,0
HTI,Haiti,HUN,Hungary,2011,0,0,0
HTI,Haiti,HUN,Hungary,2012,1,0,1
HTI,Haiti,HUN,Hungary,2013,0,0,0
HTI,Haiti,HUN,Hungary,2014,0,0,0
HTI,Haiti,HUN,Hungary,2015,1,0,1
HTI,Haiti,HUN,Hungary,2016,2,0,2
HTI,Haiti,HUN,Hungary,2017,2,0,2
HTI,Haiti,ISL,Iceland,2008,1,0,1
HTI,Haiti,ISL,Iceland,2009,4,0,4
HTI,Haiti,ISL,Iceland,2010,3,0,3
HTI,Haiti,ISL,Iceland,2011,0,0,0
HTI,Haiti,ISL,Iceland,2012,7,0,7
HTI,Haiti,ISL,Iceland,2013,0,1,-1
HTI,Haiti,ISL,Iceland,2014,0,5,-5
HTI,Haiti,ISL,Iceland,2015,0,0,0
HTI,Haiti,ISL,Iceland,2016,2,0,2
HTI,Haiti,ISL,Iceland,2017,2,1,1
HTI,Haiti,ITA,Italy,2008,27,0,27
HTI,Haiti,ITA,Italy,2009,17,0,17
HTI,Haiti,ITA,Italy,2010,59,1,58
HTI,Haiti,ITA,Italy,2011,41,4,37
HTI,Haiti,ITA,Italy,2012,34,2,32
HTI,Haiti,ITA,Italy,2013,22,2,20
HTI,Haiti,ITA,Italy,2014,45,3,42
HTI,Haiti,ITA,Italy,2015,24,7,17
HTI,Haiti,ITA,Italy,2016,37,0,37
HTI,Haiti,ITA,Italy,2017,42,2,40
HTI,Haiti,JPN,Japan,2008,22,23,-1
HTI,Haiti,JPN,Japan,2009,24,24,0
HTI,Haiti,JPN,Japan,2010,35,30,5
HTI,Haiti,JPN,Japan,2011,45,49,-4
HTI,Haiti,JPN,Japan,2012,69,67,2
HTI,Haiti,JPN,Japan,2013,34,28,6
HTI,Haiti,JPN,Japan,2014,32,34,-2
HTI,Haiti,JPN,Japan,2015,31,29,2
HTI,Haiti,JPN,Japan,2016,23,17,6
HTI,Haiti,JPN,Japan,2017,37,34,3
HTI,Haiti,KOR,Korea,2008,1,0,1
HTI,Haiti,KOR,Korea,2009,1,1,0
HTI,Haiti,KOR,Korea,2010,5,1,4
HTI,Haiti,KOR,Korea,2011,5,1,4
HTI,Haiti,KOR,Korea,2012,8,8,0
HTI,Haiti,KOR,Korea,2013,4,8,-4
HTI,Haiti,KOR,Korea,2014,4,6,-2
HTI,Haiti,KOR,Korea,2015,9,2,7
HTI,Haiti,KOR,Korea,2016,8,7,1
HTI,Haiti,KOR,Korea,2017,10,4,6
HTI,Haiti,LUX,Luxembourg,2008,1,0,1
HTI,Haiti,LUX,Luxembourg,2009,2,0,2
HTI,Haiti,LUX,Luxembourg,2010,19,0,19
HTI,Haiti,LUX,Luxembourg,2011,0,0,0
HTI,Haiti,LUX,Luxembourg,2012,2,0,2
HTI,Haiti,LUX,Luxembourg,2013,3,0,3
HTI,Haiti,LUX,Luxembourg,2014,3,0,3
HTI,Haiti,LUX,Luxembourg,2015,3,1,2
HTI,Haiti,LUX,Luxembourg,2016,0,0,0
HTI,Haiti,LUX,Luxembourg,2017,3,3,0
HTI,Haiti,MEX,Mexico,2008,28,0,28
HTI,Haiti,MEX,Mexico,2009,46,0,46
HTI,Haiti,MEX,Mexico,2010,73,0,73
HTI,Haiti,MEX,Mexico,2011,106,0,106
HTI,Haiti,MEX,Mexico,2012,53,0,53
HTI,Haiti,MEX,Mexico,2013,123,0,123
HTI,Haiti,MEX,Mexico,2014,130,0,130
HTI,Haiti,MEX,Mexico,2015,97,0,97
HTI,Haiti,MEX,Mexico,2016,131,0,131
HTI,Haiti,MEX,Mexico,2017,137,0,137
HTI,Haiti,NLD,Netherlands,2008,92,5,87
HTI,Haiti,NLD,Netherlands,2009,63,2,61
HTI,Haiti,NLD,Netherlands,2010,40,1,39
HTI,Haiti,NLD,Netherlands,2011,3,3,0
HTI,Haiti,NLD,Netherlands,2012,2,3,-1
HTI,Haiti,NLD,Netherlands,2013,9,5,4
HTI,Haiti,NLD,Netherlands,2014,23,2,21
HTI,Haiti,NLD,Netherlands,2015,11,5,6
HTI,Haiti,NLD,Netherlands,2016,9,0,9
HTI,Haiti,NLD,Netherlands,2017,16,2,14
HTI,Haiti,NZL,New Zealand,2011,1,0,1
HTI,Haiti,NZL,New Zealand,2012,0,0,0
HTI,Haiti,NZL,New Zealand,2016,1,0,1
HTI,Haiti,NOR,Norway,2008,3,0,3
HTI,Haiti,NOR,Norway,2009,2,0,2
HTI,Haiti,NOR,Norway,2010,3,1,2
HTI,Haiti,NOR,Norway,2011,1,0,1
HTI,Haiti,NOR,Norway,2012,2,1,1
HTI,Haiti,NOR,Norway,2013,4,2,2
HTI,Haiti,NOR,Norway,2014,2,3,-1
HTI,Haiti,NOR,Norway,2015,5,1,4
HTI,Haiti,NOR,Norway,2016,1,0,1
HTI,Haiti,NOR,Norway,2017,1,1,0
HTI,Haiti,POL,Poland,2009,1,0,1
HTI,Haiti,POL,Poland,2010,1,0,1
HTI,Haiti,POL,Poland,2011,2,0,2
HTI,Haiti,POL,Poland,2012,13,0,13
HTI,Haiti,POL,Poland,2013,11,0,11
HTI,Haiti,POL,Poland,2014,10,0,10
HTI,Haiti,POL,Poland,2015,9,0,9
HTI,Haiti,POL,Poland,2016,1,0,1
HTI,Haiti,POL,Poland,2017,3,0,3
HTI,Haiti,SVK,Slovak Republic,2008,0,0,0
HTI,Haiti,SVK,Slovak Republic,2011,2,0,2
HTI,Haiti,SVK,Slovak Republic,2012,1,0,1
HTI,Haiti,SVK,Slovak Republic,2014,1,0,1
HTI,Haiti,SVK,Slovak Republic,2016,1,0,1
HTI,Haiti,SVK,Slovak Republic,2017,1,0,1
HTI,Haiti,ESP,Spain,2008,64,9,55
HTI,Haiti,ESP,Spain,2009,70,9,61
HTI,Haiti,ESP,Spain,2010,62,12,50
HTI,Haiti,ESP,Spain,2011,62,21,41
HTI,Haiti,ESP,Spain,2012,68,26,42
HTI,Haiti,ESP,Spain,2013,41,49,-8
HTI,Haiti,ESP,Spain,2014,32,29,3
HTI,Haiti,ESP,Spain,2015,39,20,19
HTI,Haiti,ESP,Spain,2016,49,11,38
HTI,Haiti,ESP,Spain,2017,60,19,41
HTI,Haiti,SWE,Sweden,2008,3,1,2
HTI,Haiti,SWE,Sweden,2009,3,1,2
HTI,Haiti,SWE,Sweden,2010,7,1,6
HTI,Haiti,SWE,Sweden,2011,2,2,0
HTI,Haiti,SWE,Sweden,2012,3,0,3
HTI,Haiti,SWE,Sweden,2013,8,0,8
HTI,Haiti,SWE,Sweden,2014,0,1,-1
HTI,Haiti,SWE,Sweden,2015,1,0,1
HTI,Haiti,SWE,Sweden,2016,3,0,3
HTI,Haiti,SWE,Sweden,2017,0,0,0
HTI,Haiti,CHE,Switzerland,2010,75,12,63
HTI,Haiti,CHE,Switzerland,2011,45,14,31
HTI,Haiti,CHE,Switzerland,2012,36,7,29
HTI,Haiti,CHE,Switzerland,2013,44,9,35
HTI,Haiti,CHE,Switzerland,2014,19,7,12
HTI,Haiti,CHE,Switzerland,2015,29,2,27
HTI,Haiti,CHE,Switzerland,2016,31,7,24
HTI,Haiti,CHE,Switzerland,2017,17,8,9
HTI,Haiti,TUR,Turkey,2010,3,0,3
HTI,Haiti,USA,United States,2008,26007,0,26007
HTI,Haiti,USA,United States,2009,24280,0,24280
HTI,Haiti,USA,United States,2010,22582,0,22582
HTI,Haiti,USA,United States,2011,22111,0,22111
HTI,Haiti,USA,United States,2012,22818,0,22818
HTI,Haiti,USA,United States,2013,20351,0,20351
HTI,Haiti,USA,United States,2014,15274,0,15274
HTI,Haiti,USA,United States,2015,16967,0,16967
HTI,Haiti,USA,United States,2016,23584,0,23584
HTI,Haiti,USA,United States,2017,21824,0,21824
HTI,Haiti,CHL,Chile,2008,111,0,111
HTI,Haiti,CHL,Chile,2009,254,0,254
HTI,Haiti,CHL,Chile,2010,474,0,474
HTI,Haiti,CHL,Chile,2011,697,0,697
HTI,Haiti,CHL,Chile,2012,1103,0,1103
HTI,Haiti,CHL,Chile,2013,1215,0,1215
HTI,Haiti,CHL,Chile,2014,2206,0,2206
HTI,Haiti,CHL,Chile,2015,6363,0,6363
HTI,Haiti,CHL,Chile,2016,23009,0,23009
HTI,Haiti,EST,Estonia,2008,0,0,0
HTI,Haiti,EST,Estonia,2009,0,0,0
HTI,Haiti,EST,Estonia,2010,0,0,0
HTI,Haiti,EST,Estonia,2011,0,0,0
HTI,Haiti,EST,Estonia,2012,0,0,0
HTI,Haiti,EST,Estonia,2013,0,0,0
HTI,Haiti,EST,Estonia,2014,0,0,0
HTI,Haiti,EST,Estonia,2015,0,0,0
HTI,Haiti,EST,Estonia,2016,0,0,0
HTI,Haiti,EST,Estonia,2017,0,0,0
HTI,Haiti,SVN,Slovenia,2009,1,0,1
HTI,Haiti,SVN,Slovenia,2011,1,0,1
HND,Honduras,AUS,Australia,2008,7,0,7
HND,Honduras,AUS,Australia,2009,5,0,5
HND,Honduras,AUS,Australia,2010,4,0,4
HND,Honduras,AUS,Australia,2011,5,0,5
HND,Honduras,AUS,Australia,2012,2,0,2
HND,Honduras,AUS,Australia,2013,11,0,11
HND,Honduras,AUS,Australia,2014,6,0,6
HND,Honduras,AUS,Australia,2015,8,0,8
HND,Honduras,AUS,Australia,2017,3,0,3
HND,Honduras,AUT,Austria,2008,9,10,-1
HND,Honduras,AUT,Austria,2009,9,8,1
HND,Honduras,AUT,Austria,2010,12,6,6
HND,Honduras,AUT,Austria,2011,8,7,1
HND,Honduras,AUT,Austria,2012,6,7,-1
HND,Honduras,AUT,Austria,2013,9,3,6
HND,Honduras,AUT,Austria,2014,8,6,2
HND,Honduras,AUT,Austria,2015,11,7,4
HND,Honduras,AUT,Austria,2016,16,11,5
HND,Honduras,AUT,Austria,2017,6,7,-1
HND,Honduras,BEL,Belgium,2008,20,0,20
HND,Honduras,BEL,Belgium,2009,20,0,20
HND,Honduras,BEL,Belgium,2010,24,1,23
HND,Honduras,BEL,Belgium,2012,21,4,17
HND,Honduras,BEL,Belgium,2013,24,13,11
HND,Honduras,BEL,Belgium,2014,18,5,13
HND,Honduras,BEL,Belgium,2015,18,7,11
HND,Honduras,BEL,Belgium,2016,17,4,13
HND,Honduras,BEL,Belgium,2017,36,5,31
HND,Honduras,CAN,Canada,2008,185,0,185
HND,Honduras,CAN,Canada,2009,169,0,169
HND,Honduras,CAN,Canada,2010,385,0,385
HND,Honduras,CAN,Canada,2011,538,0,538
HND,Honduras,CAN,Canada,2012,436,0,436
HND,Honduras,CAN,Canada,2013,350,0,350
HND,Honduras,CAN,Canada,2014,402,0,402
HND,Honduras,CAN,Canada,2015,422,0,422
HND,Honduras,CAN,Canada,2016,360,0,360
HND,Honduras,CAN,Canada,2017,385,0,385
HND,Honduras,CZE,Czech Republic,2008,1,0,1
HND,Honduras,CZE,Czech Republic,2009,5,0,5
HND,Honduras,CZE,Czech Republic,2011,2,0,2
HND,Honduras,CZE,Czech Republic,2012,5,1,4
HND,Honduras,CZE,Czech Republic,2013,2,4,-2
HND,Honduras,CZE,Czech Republic,2014,9,2,7
HND,Honduras,CZE,Czech Republic,2015,2,2,0
HND,Honduras,CZE,Czech Republic,2016,6,1,5
HND,Honduras,CZE,Czech Republic,2017,5,7,-2
HND,Honduras,DNK,Denmark,2008,11,7,4
HND,Honduras,DNK,Denmark,2009,6,3,3
HND,Honduras,DNK,Denmark,2010,6,4,2
HND,Honduras,DNK,Denmark,2011,8,5,3
HND,Honduras,DNK,Denmark,2012,4,2,2
HND,Honduras,DNK,Denmark,2013,7,3,4
HND,Honduras,DNK,Denmark,2014,5,7,-2
HND,Honduras,DNK,Denmark,2015,7,4,3
HND,Honduras,DNK,Denmark,2016,10,4,6
HND,Honduras,DNK,Denmark,2017,4,2,2
HND,Honduras,FIN,Finland,2008,4,0,4
HND,Honduras,FIN,Finland,2009,3,3,0
HND,Honduras,FIN,Finland,2010,0,0,0
HND,Honduras,FIN,Finland,2011,5,0,5
HND,Honduras,FIN,Finland,2012,7,0,7
HND,Honduras,FIN,Finland,2013,3,0,3
HND,Honduras,FIN,Finland,2014,8,0,8
HND,Honduras,FIN,Finland,2015,10,2,8
HND,Honduras,FIN,Finland,2016,10,2,8
HND,Honduras,FIN,Finland,2017,11,0,11
HND,Honduras,FRA,France,2008,20,0,20
HND,Honduras,FRA,France,2009,37,0,37
HND,Honduras,FRA,France,2010,32,0,32
HND,Honduras,FRA,France,2011,31,0,31
HND,Honduras,FRA,France,2012,29,0,29
HND,Honduras,FRA,France,2013,32,0,32
HND,Honduras,FRA,France,2014,46,0,46
HND,Honduras,FRA,France,2015,24,0,24
HND,Honduras,FRA,France,2016,27,0,27
HND,Honduras,FRA,France,2017,37,0,37
HND,Honduras,DEU,Germany,2008,94,79,15
HND,Honduras,DEU,Germany,2009,108,80,28
HND,Honduras,DEU,Germany,2010,116,86,30
HND,Honduras,DEU,Germany,2011,139,55,84
HND,Honduras,DEU,Germany,2012,135,62,73
HND,Honduras,DEU,Germany,2013,156,71,85
HND,Honduras,DEU,Germany,2014,133,65,68
HND,Honduras,DEU,Germany,2015,176,60,116
HND,Honduras,DEU,Germany,2016,196,88,108
HND,Honduras,DEU,Germany,2017,201,89,112
HND,Honduras,HUN,Hungary,2008,1,1,0
HND,Honduras,HUN,Hungary,2009,2,0,2
HND,Honduras,HUN,Hungary,2010,2,0,2
HND,Honduras,HUN,Hungary,2011,3,0,3
HND,Honduras,HUN,Hungary,2012,2,0,2
HND,Honduras,HUN,Hungary,2013,0,0,0
HND,Honduras,HUN,Hungary,2014,1,0,1
HND,Honduras,HUN,Hungary,2015,2,2,0
HND,Honduras,HUN,Hungary,2016,2,0,2
HND,Honduras,HUN,Hungary,2017,1,0,1
HND,Honduras,ISL,Iceland,2008,1,2,-1
HND,Honduras,ISL,Iceland,2009,5,2,3
HND,Honduras,ISL,Iceland,2010,0,0,0
HND,Honduras,ISL,Iceland,2011,3,2,1
HND,Honduras,ISL,Iceland,2012,2,0,2
HND,Honduras,ISL,Iceland,2013,3,0,3
HND,Honduras,ISL,Iceland,2014,0,1,-1
HND,Honduras,ISL,Iceland,2015,4,2,2
HND,Honduras,ISL,Iceland,2016,8,1,7
HND,Honduras,ISL,Iceland,2017,6,1,5
HND,Honduras,ITA,Italy,2008,112,6,106
HND,Honduras,ITA,Italy,2009,140,6,134
HND,Honduras,ITA,Italy,2010,274,12,262
HND,Honduras,ITA,Italy,2011,242,7,235
HND,Honduras,ITA,Italy,2012,196,7,189
HND,Honduras,ITA,Italy,2013,209,6,203
HND,Honduras,ITA,Italy,2014,224,14,210
HND,Honduras,ITA,Italy,2015,182,7,175
HND,Honduras,ITA,Italy,2016,150,0,150
HND,Honduras,ITA,Italy,2017,201,10,191
HND,Honduras,JPN,Japan,2008,72,73,-1
HND,Honduras,JPN,Japan,2009,69,60,9
HND,Honduras,JPN,Japan,2010,27,21,6
HND,Honduras,JPN,Japan,2011,45,47,-2
HND,Honduras,JPN,Japan,2012,56,51,5
HND,Honduras,JPN,Japan,2013,71,62,9
HND,Honduras,JPN,Japan,2014,60,53,7
HND,Honduras,JPN,Japan,2015,106,92,14
HND,Honduras,JPN,Japan,2016,97,69,28
HND,Honduras,JPN,Japan,2017,105,79,26
HND,Honduras,KOR,Korea,2008,11,10,1
HND,Honduras,KOR,Korea,2009,11,7,4
HND,Honduras,KOR,Korea,2010,13,7,6
HND,Honduras,KOR,Korea,2011,14,9,5
HND,Honduras,KOR,Korea,2012,18,10,8
HND,Honduras,KOR,Korea,2013,14,12,2
HND,Honduras,KOR,Korea,2014,23,17,6
HND,Honduras,KOR,Korea,2015,18,17,1
HND,Honduras,KOR,Korea,2016,16,14,2
HND,Honduras,KOR,Korea,2017,24,13,11
HND,Honduras,LUX,Luxembourg,2008,1,0,1
HND,Honduras,LUX,Luxembourg,2009,1,0,1
HND,Honduras,LUX,Luxembourg,2010,0,0,0
HND,Honduras,LUX,Luxembourg,2011,1,0,1
HND,Honduras,LUX,Luxembourg,2012,1,0,1
HND,Honduras,LUX,Luxembourg,2013,2,1,1
HND,Honduras,LUX,Luxembourg,2014,3,1,2
HND,Honduras,LUX,Luxembourg,2015,3,0,3
HND,Honduras,LUX,Luxembourg,2016,1,0,1
HND,Honduras,LUX,Luxembourg,2017,0,0,0
HND,Honduras,MEX,Mexico,2008,765,0,765
HND,Honduras,MEX,Mexico,2009,1406,0,1406
HND,Honduras,MEX,Mexico,2010,1544,0,1544
HND,Honduras,MEX,Mexico,2011,1026,0,1026
HND,Honduras,MEX,Mexico,2012,410,0,410
HND,Honduras,MEX,Mexico,2013,2409,0,2409
HND,Honduras,MEX,Mexico,2014,2269,0,2269
HND,Honduras,MEX,Mexico,2015,1798,0,1798
HND,Honduras,MEX,Mexico,2016,2559,0,2559
HND,Honduras,MEX,Mexico,2017,2453,0,2453
HND,Honduras,NLD,Netherlands,2008,10,7,3
HND,Honduras,NLD,Netherlands,2009,23,4,19
HND,Honduras,NLD,Netherlands,2010,23,13,10
HND,Honduras,NLD,Netherlands,2011,10,5,5
HND,Honduras,NLD,Netherlands,2012,14,5,9
HND,Honduras,NLD,Netherlands,2013,15,6,9
HND,Honduras,NLD,Netherlands,2014,25,11,14
HND,Honduras,NLD,Netherlands,2015,16,8,8
HND,Honduras,NLD,Netherlands,2016,23,7,16
HND,Honduras,NLD,Netherlands,2017,20,14,6
HND,Honduras,NZL,New Zealand,2008,1,0,1
HND,Honduras,NZL,New Zealand,2010,3,1,2
HND,Honduras,NZL,New Zealand,2011,2,0,2
HND,Honduras,NZL,New Zealand,2012,2,1,1
HND,Honduras,NZL,New Zealand,2013,2,0,2
HND,Honduras,NZL,New Zealand,2014,1,0,1
HND,Honduras,NZL,New Zealand,2015,2,0,2
HND,Honduras,NZL,New Zealand,2016,2,0,2
HND,Honduras,NZL,New Zealand,2017,3,0,3
HND,Honduras,NOR,Norway,2008,7,3,4
HND,Honduras,NOR,Norway,2009,10,5,5
HND,Honduras,NOR,Norway,2010,3,3,0
HND,Honduras,NOR,Norway,2011,3,4,-1
HND,Honduras,NOR,Norway,2012,12,2,10
HND,Honduras,NOR,Norway,2013,8,1,7
HND,Honduras,NOR,Norway,2014,7,5,2
HND,Honduras,NOR,Norway,2015,8,4,4
HND,Honduras,NOR,Norway,2016,5,2,3
HND,Honduras,NOR,Norway,2017,4,2,2
HND,Honduras,POL,Poland,2009,2,0,2
HND,Honduras,POL,Poland,2010,5,0,5
HND,Honduras,POL,Poland,2011,9,0,9
HND,Honduras,POL,Poland,2012,7,0,7
HND,Honduras,POL,Poland,2013,6,0,6
HND,Honduras,POL,Poland,2014,2,0,2
HND,Honduras,POL,Poland,2015,4,0,4
HND,Honduras,POL,Poland,2016,5,0,5
HND,Honduras,POL,Poland,2017,11,0,11
HND,Honduras,SVK,Slovak Republic,2008,0,1,-1
HND,Honduras,SVK,Slovak Republic,2010,2,0,2
HND,Honduras,SVK,Slovak Republic,2011,3,1,2
HND,Honduras,SVK,Slovak Republic,2017,1,0,1
HND,Honduras,ESP,Spain,2008,4551,1320,3231
HND,Honduras,ESP,Spain,2009,3695,1608,2087
HND,Honduras,ESP,Spain,2010,4703,1715,2988
HND,Honduras,ESP,Spain,2011,6261,1897,4364
HND,Honduras,ESP,Spain,2012,5285,2455,2830
HND,Honduras,ESP,Spain,2013,4342,3817,525
HND,Honduras,ESP,Spain,2014,5681,2299,3382
HND,Honduras,ESP,Spain,2015,7632,1548,6084
HND,Honduras,ESP,Spain,2016,10895,1604,9291
HND,Honduras,ESP,Spain,2017,18234,1797,16437
HND,Honduras,SWE,Sweden,2008,6,4,2
HND,Honduras,SWE,Sweden,2009,20,1,19
HND,Honduras,SWE,Sweden,2010,14,4,10
HND,Honduras,SWE,Sweden,2011,29,9,20
HND,Honduras,SWE,Sweden,2012,13,2,11
HND,Honduras,SWE,Sweden,2013,12,4,8
HND,Honduras,SWE,Sweden,2014,8,7,1
HND,Honduras,SWE,Sweden,2015,5,6,-1
HND,Honduras,SWE,Sweden,2016,20,2,18
HND,Honduras,SWE,Sweden,2017,12,5,7
HND,Honduras,CHE,Switzerland,2010,30,7,23
HND,Honduras,CHE,Switzerland,2011,17,13,4
HND,Honduras,CHE,Switzerland,2012,24,9,15
HND,Honduras,CHE,Switzerland,2013,48,3,45
HND,Honduras,CHE,Switzerland,2014,30,12,18
HND,Honduras,CHE,Switzerland,2015,24,5,19
HND,Honduras,CHE,Switzerland,2016,28,10,18
HND,Honduras,CHE,Switzerland,2017,49,8,41
HND,Honduras,TUR,Turkey,2010,3,0,3
HND,Honduras,USA,United States,2008,6540,0,6540
HND,Honduras,USA,United States,2009,6404,0,6404
HND,Honduras,USA,United States,2010,6448,0,6448
HND,Honduras,USA,United States,2011,6133,0,6133
HND,Honduras,USA,United States,2012,6884,0,6884
HND,Honduras,USA,United States,2013,8898,0,8898
HND,Honduras,USA,United States,2014,8156,0,8156
HND,Honduras,USA,United States,2015,9274,0,9274
HND,Honduras,USA,United States,2016,13302,0,13302
HND,Honduras,USA,United States,2017,11387,0,11387
HND,Honduras,CHL,Chile,2008,51,0,51
HND,Honduras,CHL,Chile,2009,91,0,91
HND,Honduras,CHL,Chile,2010,68,0,68
HND,Honduras,CHL,Chile,2011,69,0,69
HND,Honduras,CHL,Chile,2012,76,0,76
HND,Honduras,CHL,Chile,2013,93,0,93
HND,Honduras,CHL,Chile,2014,94,0,94
HND,Honduras,CHL,Chile,2015,92,0,92
HND,Honduras,CHL,Chile,2016,99,0,99
HND,Honduras,EST,Estonia,2008,0,0,0
HND,Honduras,EST,Estonia,2009,0,0,0
HND,Honduras,EST,Estonia,2010,0,0,0
HND,Honduras,EST,Estonia,2011,1,0,1
HND,Honduras,EST,Estonia,2012,0,0,0
HND,Honduras,EST,Estonia,2013,0,0,0
HND,Honduras,EST,Estonia,2014,0,0,0
HND,Honduras,EST,Estonia,2015,0,0,0
HND,Honduras,EST,Estonia,2016,2,0,2
HND,Honduras,EST,Estonia,2017,0,0,0
HND,Honduras,SVN,Slovenia,2010,3,0,3
HKG,"Hong Kong, China",AUS,Australia,2008,1806,1417,389
HKG,"Hong Kong, China",AUS,Australia,2009,1561,990,571
HKG,"Hong Kong, China",AUS,Australia,2010,805,1178,-373
HKG,"Hong Kong, China",AUS,Australia,2011,806,1181,-375
HKG,"Hong Kong, China",AUS,Australia,2012,860,1034,-174
HKG,"Hong Kong, China",AUS,Australia,2013,1228,1022,206
HKG,"Hong Kong, China",AUS,Australia,2014,1300,908,392
HKG,"Hong Kong, China",AUS,Australia,2015,1384,800,584
HKG,"Hong Kong, China",AUS,Australia,2016,1716,700,1016
HKG,"Hong Kong, China",AUS,Australia,2017,1803,0,1803
HKG,"Hong Kong, China",AUT,Austria,2014,0,0,0
HKG,"Hong Kong, China",AUT,Austria,2015,0,0,0
HKG,"Hong Kong, China",AUT,Austria,2016,0,0,0
HKG,"Hong Kong, China",AUT,Austria,2017,0,0,0
HKG,"Hong Kong, China",BEL,Belgium,2010,0,0,0
HKG,"Hong Kong, China",CAN,Canada,2008,893,0,893
HKG,"Hong Kong, China",CAN,Canada,2009,656,0,656
HKG,"Hong Kong, China",CAN,Canada,2010,623,0,623
HKG,"Hong Kong, China",CAN,Canada,2011,586,0,586
HKG,"Hong Kong, China",CAN,Canada,2012,719,0,719
HKG,"Hong Kong, China",CAN,Canada,2013,774,0,774
HKG,"Hong Kong, China",CAN,Canada,2014,586,0,586
HKG,"Hong Kong, China",CAN,Canada,2015,630,0,630
HKG,"Hong Kong, China",CAN,Canada,2016,1210,0,1210
HKG,"Hong Kong, China",CAN,Canada,2017,1270,0,1270
HKG,"Hong Kong, China",DNK,Denmark,2015,0,0,0
HKG,"Hong Kong, China",DNK,Denmark,2016,0,0,0
HKG,"Hong Kong, China",FIN,Finland,2008,0,0,0
HKG,"Hong Kong, China",FIN,Finland,2009,0,0,0
HKG,"Hong Kong, China",FIN,Finland,2010,0,0,0
HKG,"Hong Kong, China",FIN,Finland,2011,0,0,0
HKG,"Hong Kong, China",FIN,Finland,2012,0,0,0
HKG,"Hong Kong, China",FIN,Finland,2013,0,0,0
HKG,"Hong Kong, China",FIN,Finland,2014,0,0,0
HKG,"Hong Kong, China",FIN,Finland,2015,0,0,0
HKG,"Hong Kong, China",FIN,Finland,2016,0,0,0
HKG,"Hong Kong, China",FIN,Finland,2017,0,0,0
HKG,"Hong Kong, China",FRA,France,2008,0,0,0
HKG,"Hong Kong, China",FRA,France,2009,0,0,0
HKG,"Hong Kong, China",FRA,France,2010,0,0,0
HKG,"Hong Kong, China",FRA,France,2011,0,0,0
HKG,"Hong Kong, China",FRA,France,2012,0,0,0
HKG,"Hong Kong, China",FRA,France,2013,0,0,0
HKG,"Hong Kong, China",FRA,France,2014,0,0,0
HKG,"Hong Kong, China",FRA,France,2015,0,0,0
HKG,"Hong Kong, China",FRA,France,2016,0,0,0
HKG,"Hong Kong, China",FRA,France,2017,0,0,0
HKG,"Hong Kong, China",HUN,Hungary,2008,0,0,0
HKG,"Hong Kong, China",HUN,Hungary,2009,0,0,0
HKG,"Hong Kong, China",HUN,Hungary,2010,0,0,0
HKG,"Hong Kong, China",HUN,Hungary,2011,0,0,0
HKG,"Hong Kong, China",HUN,Hungary,2012,0,0,0
HKG,"Hong Kong, China",HUN,Hungary,2013,0,0,0
HKG,"Hong Kong, China",HUN,Hungary,2014,0,0,0
HKG,"Hong Kong, China",HUN,Hungary,2015,0,0,0
HKG,"Hong Kong, China",HUN,Hungary,2016,0,0,0
HKG,"Hong Kong, China",HUN,Hungary,2017,0,0,0
HKG,"Hong Kong, China",ISL,Iceland,2008,0,0,0
HKG,"Hong Kong, China",ISL,Iceland,2009,0,0,0
HKG,"Hong Kong, China",ISL,Iceland,2010,0,0,0
HKG,"Hong Kong, China",ISL,Iceland,2011,0,0,0
HKG,"Hong Kong, China",ISL,Iceland,2012,0,0,0
HKG,"Hong Kong, China",ISL,Iceland,2013,0,0,0
HKG,"Hong Kong, China",ISL,Iceland,2014,0,0,0
HKG,"Hong Kong, China",ISL,Iceland,2015,0,0,0
HKG,"Hong Kong, China",ISL,Iceland,2016,0,0,0
HKG,"Hong Kong, China",ISL,Iceland,2017,0,0,0
HKG,"Hong Kong, China",JPN,Japan,2008,895,382,513
HKG,"Hong Kong, China",JPN,Japan,2009,906,602,304
HKG,"Hong Kong, China",JPN,Japan,2010,1097,759,338
HKG,"Hong Kong, China",JPN,Japan,2011,629,778,-149
HKG,"Hong Kong, China",JPN,Japan,2012,884,521,363
HKG,"Hong Kong, China",JPN,Japan,2013,938,600,338
HKG,"Hong Kong, China",JPN,Japan,2014,1051,587,464
HKG,"Hong Kong, China",JPN,Japan,2015,1337,649,688
HKG,"Hong Kong, China",JPN,Japan,2016,1564,850,714
HKG,"Hong Kong, China",JPN,Japan,2017,2293,1079,1214
HKG,"Hong Kong, China",KOR,Korea,2008,361,277,84
HKG,"Hong Kong, China",KOR,Korea,2009,257,309,-52
HKG,"Hong Kong, China",KOR,Korea,2010,301,317,-16
HKG,"Hong Kong, China",KOR,Korea,2011,381,390,-9
HKG,"Hong Kong, China",KOR,Korea,2012,481,528,-47
HKG,"Hong Kong, China",KOR,Korea,2013,675,586,89
HKG,"Hong Kong, China",KOR,Korea,2014,872,709,163
HKG,"Hong Kong, China",KOR,Korea,2015,798,995,-197
HKG,"Hong Kong, China",KOR,Korea,2016,974,970,4
HKG,"Hong Kong, China",KOR,Korea,2017,860,997,-137
HKG,"Hong Kong, China",LUX,Luxembourg,2008,0,0,0
HKG,"Hong Kong, China",LUX,Luxembourg,2009,0,0,0
HKG,"Hong Kong, China",LUX,Luxembourg,2010,1,0,1
HKG,"Hong Kong, China",LUX,Luxembourg,2011,0,0,0
HKG,"Hong Kong, China",LUX,Luxembourg,2012,0,0,0
HKG,"Hong Kong, China",LUX,Luxembourg,2013,0,0,0
HKG,"Hong Kong, China",LUX,Luxembourg,2014,0,0,0
HKG,"Hong Kong, China",LUX,Luxembourg,2015,0,0,0
HKG,"Hong Kong, China",LUX,Luxembourg,2016,0,0,0
HKG,"Hong Kong, China",LUX,Luxembourg,2017,0,0,0
HKG,"Hong Kong, China",MEX,Mexico,2008,3,0,3
HKG,"Hong Kong, China",MEX,Mexico,2009,4,0,4
HKG,"Hong Kong, China",MEX,Mexico,2010,2,0,2
HKG,"Hong Kong, China",MEX,Mexico,2012,2,0,2
HKG,"Hong Kong, China",MEX,Mexico,2013,1,0,1
HKG,"Hong Kong, China",MEX,Mexico,2014,1,0,1
HKG,"Hong Kong, China",MEX,Mexico,2015,1,0,1
HKG,"Hong Kong, China",MEX,Mexico,2016,1,0,1
HKG,"Hong Kong, China",MEX,Mexico,2017,1,0,1
HKG,"Hong Kong, China",NZL,New Zealand,2008,371,105,266
HKG,"Hong Kong, China",NZL,New Zealand,2009,384,118,266
HKG,"Hong Kong, China",NZL,New Zealand,2010,443,168,275
HKG,"Hong Kong, China",NZL,New Zealand,2011,506,143,363
HKG,"Hong Kong, China",NZL,New Zealand,2012,560,165,395
HKG,"Hong Kong, China",NZL,New Zealand,2013,537,144,393
HKG,"Hong Kong, China",NZL,New Zealand,2014,580,134,446
HKG,"Hong Kong, China",NZL,New Zealand,2015,649,130,519
HKG,"Hong Kong, China",NZL,New Zealand,2016,744,157,587
HKG,"Hong Kong, China",NZL,New Zealand,2017,693,201,492
HKG,"Hong Kong, China",NOR,Norway,2008,0,0,0
HKG,"Hong Kong, China",NOR,Norway,2009,0,0,0
HKG,"Hong Kong, China",NOR,Norway,2010,0,0,0
HKG,"Hong Kong, China",NOR,Norway,2011,0,0,0
HKG,"Hong Kong, China",NOR,Norway,2012,0,0,0
HKG,"Hong Kong, China",NOR,Norway,2013,0,0,0
HKG,"Hong Kong, China",NOR,Norway,2014,0,0,0
HKG,"Hong Kong, China",NOR,Norway,2015,0,0,0
HKG,"Hong Kong, China",NOR,Norway,2016,0,0,0
HKG,"Hong Kong, China",NOR,Norway,2017,0,0,0
HKG,"Hong Kong, China",POL,Poland,2008,0,0,0
HKG,"Hong Kong, China",POL,Poland,2009,2,0,2
HKG,"Hong Kong, China",POL,Poland,2010,4,0,4
HKG,"Hong Kong, China",POL,Poland,2011,15,0,15
HKG,"Hong Kong, China",POL,Poland,2012,8,0,8
HKG,"Hong Kong, China",POL,Poland,2013,0,0,0
HKG,"Hong Kong, China",POL,Poland,2014,2,0,2
HKG,"Hong Kong, China",POL,Poland,2015,6,0,6
HKG,"Hong Kong, China",POL,Poland,2016,5,0,5
HKG,"Hong Kong, China",POL,Poland,2017,9,0,9
HKG,"Hong Kong, China",SWE,Sweden,2008,0,0,0
HKG,"Hong Kong, China",SWE,Sweden,2009,0,0,0
HKG,"Hong Kong, China",SWE,Sweden,2010,0,0,0
HKG,"Hong Kong, China",SWE,Sweden,2011,0,0,0
HKG,"Hong Kong, China",SWE,Sweden,2012,0,0,0
HKG,"Hong Kong, China",SWE,Sweden,2013,0,0,0
HKG,"Hong Kong, China",SWE,Sweden,2014,0,0,0
HKG,"Hong Kong, China",SWE,Sweden,2015,0,0,0
HKG,"Hong Kong, China",GBR,United Kingdom,2010,3000,0,3000
HKG,"Hong Kong, China",GBR,United Kingdom,2011,2000,1000,1000
HKG,"Hong Kong, China",GBR,United Kingdom,2013,3000,0,3000
HKG,"Hong Kong, China",GBR,United Kingdom,2016,5000,0,5000
HKG,"Hong Kong, China",GBR,United Kingdom,2017,8000,0,8000
HKG,"Hong Kong, China",USA,United States,2008,3373,0,3373
HKG,"Hong Kong, China",USA,United States,2009,2651,0,2651
HKG,"Hong Kong, China",USA,United States,2010,2432,0,2432
HKG,"Hong Kong, China",USA,United States,2011,2306,0,2306
HKG,"Hong Kong, China",USA,United States,2012,2104,0,2104
HKG,"Hong Kong, China",USA,United States,2013,2226,0,2226
HKG,"Hong Kong, China",USA,United States,2014,2278,0,2278
HKG,"Hong Kong, China",USA,United States,2015,2085,0,2085
HKG,"Hong Kong, China",USA,United States,2016,2510,0,2510
HKG,"Hong Kong, China",USA,United States,2017,2415,0,2415
HKG,"Hong Kong, China",CHL,Chile,2008,1,0,1
HKG,"Hong Kong, China",CHL,Chile,2009,0,0,0
HKG,"Hong Kong, China",CHL,Chile,2010,9,0,9
HKG,"Hong Kong, China",CHL,Chile,2011,16,0,16
HKG,"Hong Kong, China",CHL,Chile,2012,9,0,9
HKG,"Hong Kong, China",CHL,Chile,2013,14,0,14
HKG,"Hong Kong, China",CHL,Chile,2014,6,0,6
HKG,"Hong Kong, China",CHL,Chile,2015,2,0,2
HKG,"Hong Kong, China",CHL,Chile,2016,1,0,1
HKG,"Hong Kong, China",EST,Estonia,2017,0,0,0
HKG,"Hong Kong, China",SVN,Slovenia,2015,1,0,1
HKG,"Hong Kong, China",SVN,Slovenia,2017,2,0,2
HUN,Hungary,AUS,Australia,2008,221,62,159
HUN,Hungary,AUS,Australia,2009,249,42,207
HUN,Hungary,AUS,Australia,2010,287,41,246
HUN,Hungary,AUS,Australia,2011,256,44,212
HUN,Hungary,AUS,Australia,2012,336,58,278
HUN,Hungary,AUS,Australia,2013,373,43,330
HUN,Hungary,AUS,Australia,2014,352,73,279
HUN,Hungary,AUS,Australia,2015,362,51,311
HUN,Hungary,AUS,Australia,2016,292,51,241
HUN,Hungary,AUS,Australia,2017,302,56,246
HUN,Hungary,AUT,Austria,2008,5164,659,4505
HUN,Hungary,AUT,Austria,2009,5768,670,5098
HUN,Hungary,AUT,Austria,2010,6412,585,5827
HUN,Hungary,AUT,Austria,2011,9250,541,8709
HUN,Hungary,AUT,Austria,2012,13066,455,12611
HUN,Hungary,AUT,Austria,2013,14935,450,14485
HUN,Hungary,AUT,Austria,2014,14538,472,14066
HUN,Hungary,AUT,Austria,2015,14394,394,14000
HUN,Hungary,AUT,Austria,2016,13326,385,12941
HUN,Hungary,AUT,Austria,2017,13113,456,12657
HUN,Hungary,BEL,Belgium,2008,799,127,672
HUN,Hungary,BEL,Belgium,2009,850,124,726
HUN,Hungary,BEL,Belgium,2010,974,165,809
HUN,Hungary,BEL,Belgium,2011,1126,117,1009
HUN,Hungary,BEL,Belgium,2012,1199,132,1067
HUN,Hungary,BEL,Belgium,2013,1113,142,971
HUN,Hungary,BEL,Belgium,2014,838,147,691
HUN,Hungary,BEL,Belgium,2015,765,139,626
HUN,Hungary,BEL,Belgium,2016,608,193,415
HUN,Hungary,BEL,Belgium,2017,689,178,511
HUN,Hungary,CAN,Canada,2008,382,177,205
HUN,Hungary,CAN,Canada,2009,312,172,140
HUN,Hungary,CAN,Canada,2010,354,172,182
HUN,Hungary,CAN,Canada,2011,287,180,107
HUN,Hungary,CAN,Canada,2012,300,173,127
HUN,Hungary,CAN,Canada,2013,423,169,254
HUN,Hungary,CAN,Canada,2014,536,148,388
HUN,Hungary,CAN,Canada,2015,770,214,556
HUN,Hungary,CAN,Canada,2016,520,189,331
HUN,Hungary,CAN,Canada,2017,695,226,469
HUN,Hungary,CZE,Czech Republic,2008,68,54,14
HUN,Hungary,CZE,Czech Republic,2009,76,89,-13
HUN,Hungary,CZE,Czech Republic,2010,81,70,11
HUN,Hungary,CZE,Czech Republic,2011,88,56,32
HUN,Hungary,CZE,Czech Republic,2012,123,63,60
HUN,Hungary,CZE,Czech Republic,2013,374,64,310
HUN,Hungary,CZE,Czech Republic,2014,709,60,649
HUN,Hungary,CZE,Czech Republic,2015,776,65,711
HUN,Hungary,CZE,Czech Republic,2016,911,79,832
HUN,Hungary,CZE,Czech Republic,2017,1238,68,1170
HUN,Hungary,DNK,Denmark,2008,407,45,362
HUN,Hungary,DNK,Denmark,2009,419,50,369
HUN,Hungary,DNK,Denmark,2010,441,57,384
HUN,Hungary,DNK,Denmark,2011,449,36,413
HUN,Hungary,DNK,Denmark,2012,721,36,685
HUN,Hungary,DNK,Denmark,2013,770,39,731
HUN,Hungary,DNK,Denmark,2014,854,32,822
HUN,Hungary,DNK,Denmark,2015,771,33,738
HUN,Hungary,DNK,Denmark,2016,741,22,719
HUN,Hungary,DNK,Denmark,2017,748,41,707
HUN,Hungary,FIN,Finland,2008,325,73,252
HUN,Hungary,FIN,Finland,2009,182,56,126
HUN,Hungary,FIN,Finland,2010,171,63,108
HUN,Hungary,FIN,Finland,2011,277,56,221
HUN,Hungary,FIN,Finland,2012,251,62,189
HUN,Hungary,FIN,Finland,2013,247,65,182
HUN,Hungary,FIN,Finland,2014,184,65,119
HUN,Hungary,FIN,Finland,2015,196,97,99
HUN,Hungary,FIN,Finland,2016,151,74,77
HUN,Hungary,FIN,Finland,2017,130,80,50
HUN,Hungary,FRA,France,2008,0,376,-376
HUN,Hungary,FRA,France,2009,0,387,-387
HUN,Hungary,FRA,France,2010,0,344,-344
HUN,Hungary,FRA,France,2011,0,328,-328
HUN,Hungary,FRA,France,2012,0,315,-315
HUN,Hungary,FRA,France,2013,640,310,330
HUN,Hungary,FRA,France,2014,849,397,452
HUN,Hungary,FRA,France,2015,634,376,258
HUN,Hungary,FRA,France,2016,686,378,308
HUN,Hungary,FRA,France,2017,567,414,153
HUN,Hungary,DEU,Germany,2008,25151,3201,21950
HUN,Hungary,DEU,Germany,2009,25270,2694,22576
HUN,Hungary,DEU,Germany,2010,29286,2420,26866
HUN,Hungary,DEU,Germany,2011,41132,2428,38704
HUN,Hungary,DEU,Germany,2012,54491,2073,52418
HUN,Hungary,DEU,Germany,2013,59995,1991,58004
HUN,Hungary,DEU,Germany,2014,58779,1952,56827
HUN,Hungary,DEU,Germany,2015,58096,1968,56128
HUN,Hungary,DEU,Germany,2016,51592,2282,49310
HUN,Hungary,DEU,Germany,2017,48117,2503,45614
HUN,Hungary,HUN,Hungary,2008,0,0,0
HUN,Hungary,HUN,Hungary,2009,0,0,0
HUN,Hungary,HUN,Hungary,2010,0,0,0
HUN,Hungary,HUN,Hungary,2011,0,0,0
HUN,Hungary,HUN,Hungary,2012,0,0,0
HUN,Hungary,HUN,Hungary,2013,0,0,0
HUN,Hungary,HUN,Hungary,2014,0,0,0
HUN,Hungary,HUN,Hungary,2015,0,0,0
HUN,Hungary,HUN,Hungary,2016,0,0,0
HUN,Hungary,ISL,Iceland,2008,88,27,61
HUN,Hungary,ISL,Iceland,2009,24,9,15
HUN,Hungary,ISL,Iceland,2010,32,13,19
HUN,Hungary,ISL,Iceland,2011,30,22,8
HUN,Hungary,ISL,Iceland,2012,31,18,13
HUN,Hungary,ISL,Iceland,2013,43,15,28
HUN,Hungary,ISL,Iceland,2014,66,19,47
HUN,Hungary,ISL,Iceland,2015,79,17,62
HUN,Hungary,ISL,Iceland,2016,115,7,108
HUN,Hungary,ISL,Iceland,2017,174,14,160
HUN,Hungary,ITA,Italy,2008,1144,255,889
HUN,Hungary,ITA,Italy,2009,1054,267,787
HUN,Hungary,ITA,Italy,2010,921,253,668
HUN,Hungary,ITA,Italy,2011,871,318,553
HUN,Hungary,ITA,Italy,2012,853,352,501
HUN,Hungary,ITA,Italy,2013,710,387,323
HUN,Hungary,ITA,Italy,2014,656,514,142
HUN,Hungary,ITA,Italy,2015,668,576,92
HUN,Hungary,ITA,Italy,2016,619,601,18
HUN,Hungary,ITA,Italy,2017,601,598,3
HUN,Hungary,JPN,Japan,2008,360,522,-162
HUN,Hungary,JPN,Japan,2009,505,343,162
HUN,Hungary,JPN,Japan,2010,471,279,192
HUN,Hungary,JPN,Japan,2011,353,304,49
HUN,Hungary,JPN,Japan,2012,480,332,148
HUN,Hungary,JPN,Japan,2013,546,391,155
HUN,Hungary,JPN,Japan,2014,578,471,107
HUN,Hungary,JPN,Japan,2015,592,513,79
HUN,Hungary,JPN,Japan,2016,643,467,176
HUN,Hungary,JPN,Japan,2017,612,580,32
HUN,Hungary,KOR,Korea,2008,28,335,-307
HUN,Hungary,KOR,Korea,2009,26,282,-256
HUN,Hungary,KOR,Korea,2010,26,429,-403
HUN,Hungary,KOR,Korea,2011,35,382,-347
HUN,Hungary,KOR,Korea,2012,56,329,-273
HUN,Hungary,KOR,Korea,2013,58,340,-282
HUN,Hungary,KOR,Korea,2014,80,403,-323
HUN,Hungary,KOR,Korea,2015,63,339,-276
HUN,Hungary,KOR,Korea,2016,66,330,-264
HUN,Hungary,KOR,Korea,2017,66,580,-514
HUN,Hungary,LUX,Luxembourg,2008,126,5,121
HUN,Hungary,LUX,Luxembourg,2009,118,4,114
HUN,Hungary,LUX,Luxembourg,2010,138,1,137
HUN,Hungary,LUX,Luxembourg,2011,177,2,175
HUN,Hungary,LUX,Luxembourg,2012,155,8,147
HUN,Hungary,LUX,Luxembourg,2013,228,3,225
HUN,Hungary,LUX,Luxembourg,2014,226,2,224
HUN,Hungary,LUX,Luxembourg,2015,189,7,182
HUN,Hungary,LUX,Luxembourg,2016,193,10,183
HUN,Hungary,LUX,Luxembourg,2017,258,4,254
HUN,Hungary,MEX,Mexico,2008,28,104,-76
HUN,Hungary,MEX,Mexico,2009,40,100,-60
HUN,Hungary,MEX,Mexico,2010,53,118,-65
HUN,Hungary,MEX,Mexico,2011,24,128,-104
HUN,Hungary,MEX,Mexico,2012,19,143,-124
HUN,Hungary,MEX,Mexico,2013,89,92,-3
HUN,Hungary,MEX,Mexico,2014,62,110,-48
HUN,Hungary,MEX,Mexico,2015,35,163,-128
HUN,Hungary,MEX,Mexico,2016,28,147,-119
HUN,Hungary,MEX,Mexico,2017,25,150,-125
HUN,Hungary,NLD,Netherlands,2008,1721,320,1401
HUN,Hungary,NLD,Netherlands,2009,2190,382,1808
HUN,Hungary,NLD,Netherlands,2010,2400,328,2072
HUN,Hungary,NLD,Netherlands,2011,2590,320,2270
HUN,Hungary,NLD,Netherlands,2012,3084,313,2771
HUN,Hungary,NLD,Netherlands,2013,2913,316,2597
HUN,Hungary,NLD,Netherlands,2014,2906,361,2545
HUN,Hungary,NLD,Netherlands,2015,3040,363,2677
HUN,Hungary,NLD,Netherlands,2016,2932,328,2604
HUN,Hungary,NLD,Netherlands,2017,3226,445,2781
HUN,Hungary,NZL,New Zealand,2008,63,24,39
HUN,Hungary,NZL,New Zealand,2009,34,12,22
HUN,Hungary,NZL,New Zealand,2010,30,11,19
HUN,Hungary,NZL,New Zealand,2011,34,12,22
HUN,Hungary,NZL,New Zealand,2012,60,22,38
HUN,Hungary,NZL,New Zealand,2013,85,9,76
HUN,Hungary,NZL,New Zealand,2014,84,18,66
HUN,Hungary,NZL,New Zealand,2015,112,18,94
HUN,Hungary,NZL,New Zealand,2016,147,14,133
HUN,Hungary,NZL,New Zealand,2017,112,15,97
HUN,Hungary,NOR,Norway,2008,255,164,91
HUN,Hungary,NOR,Norway,2009,257,143,114
HUN,Hungary,NOR,Norway,2010,397,146,251
HUN,Hungary,NOR,Norway,2011,408,182,226
HUN,Hungary,NOR,Norway,2012,496,128,368
HUN,Hungary,NOR,Norway,2013,582,144,438
HUN,Hungary,NOR,Norway,2014,586,240,346
HUN,Hungary,NOR,Norway,2015,527,126,401
HUN,Hungary,NOR,Norway,2016,347,147,200
HUN,Hungary,NOR,Norway,2017,294,163,131
HUN,Hungary,POL,Poland,2008,108,177,-69
HUN,Hungary,POL,Poland,2009,99,218,-119
HUN,Hungary,POL,Poland,2010,111,192,-81
HUN,Hungary,POL,Poland,2011,121,193,-72
HUN,Hungary,POL,Poland,2012,171,215,-44
HUN,Hungary,POL,Poland,2013,411,231,180
HUN,Hungary,POL,Poland,2014,411,212,199
HUN,Hungary,POL,Poland,2015,194,246,-52
HUN,Hungary,POL,Poland,2016,214,232,-18
HUN,Hungary,POL,Poland,2017,238,267,-29
HUN,Hungary,SVK,Slovak Republic,2008,904,1286,-382
HUN,Hungary,SVK,Slovak Republic,2009,783,1169,-386
HUN,Hungary,SVK,Slovak Republic,2010,678,1195,-517
HUN,Hungary,SVK,Slovak Republic,2011,662,1129,-467
HUN,Hungary,SVK,Slovak Republic,2012,706,1013,-307
HUN,Hungary,SVK,Slovak Republic,2013,379,1092,-713
HUN,Hungary,SVK,Slovak Republic,2014,510,1239,-729
HUN,Hungary,SVK,Slovak Republic,2015,560,1275,-715
HUN,Hungary,SVK,Slovak Republic,2016,605,1338,-733
HUN,Hungary,SVK,Slovak Republic,2017,449,1508,-1059
HUN,Hungary,ESP,Spain,2008,1205,107,1098
HUN,Hungary,ESP,Spain,2009,888,141,747
HUN,Hungary,ESP,Spain,2010,855,191,664
HUN,Hungary,ESP,Spain,2011,997,161,836
HUN,Hungary,ESP,Spain,2012,997,214,783
HUN,Hungary,ESP,Spain,2013,938,257,681
HUN,Hungary,ESP,Spain,2014,916,277,639
HUN,Hungary,ESP,Spain,2015,959,322,637
HUN,Hungary,ESP,Spain,2016,1025,265,760
HUN,Hungary,ESP,Spain,2017,1225,278,947
HUN,Hungary,SWE,Sweden,2008,1018,178,840
HUN,Hungary,SWE,Sweden,2009,893,202,691
HUN,Hungary,SWE,Sweden,2010,770,143,627
HUN,Hungary,SWE,Sweden,2011,706,148,558
HUN,Hungary,SWE,Sweden,2012,857,125,732
HUN,Hungary,SWE,Sweden,2013,907,112,795
HUN,Hungary,SWE,Sweden,2014,939,112,827
HUN,Hungary,SWE,Sweden,2015,1013,127,886
HUN,Hungary,SWE,Sweden,2016,878,153,725
HUN,Hungary,SWE,Sweden,2017,828,173,655
HUN,Hungary,CHE,Switzerland,2008,1060,109,951
HUN,Hungary,CHE,Switzerland,2009,1104,125,979
HUN,Hungary,CHE,Switzerland,2010,1160,90,1070
HUN,Hungary,CHE,Switzerland,2011,2089,111,1978
HUN,Hungary,CHE,Switzerland,2012,2492,98,2394
HUN,Hungary,CHE,Switzerland,2013,2513,108,2405
HUN,Hungary,CHE,Switzerland,2014,4205,106,4099
HUN,Hungary,CHE,Switzerland,2015,3920,115,3805
HUN,Hungary,CHE,Switzerland,2016,3554,135,3419
HUN,Hungary,CHE,Switzerland,2017,3320,149,3171
HUN,Hungary,TUR,Turkey,2010,54,520,-466
HUN,Hungary,TUR,Turkey,2016,146,698,-552
HUN,Hungary,TUR,Turkey,2017,0,953,-953
HUN,Hungary,GBR,United Kingdom,2011,4000,395,3605
HUN,Hungary,GBR,United Kingdom,2012,5000,324,4676
HUN,Hungary,GBR,United Kingdom,2013,7000,378,6622
HUN,Hungary,GBR,United Kingdom,2014,8000,384,7616
HUN,Hungary,GBR,United Kingdom,2015,9000,414,8586
HUN,Hungary,GBR,United Kingdom,2016,3000,435,2565
HUN,Hungary,GBR,United Kingdom,2017,8000,509,7491
HUN,Hungary,USA,United States,2008,1127,1209,-82
HUN,Hungary,USA,United States,2009,1314,1271,43
HUN,Hungary,USA,United States,2010,1022,1125,-103
HUN,Hungary,USA,United States,2011,1044,998,46
HUN,Hungary,USA,United States,2012,1054,1045,9
HUN,Hungary,USA,United States,2013,1052,1039,13
HUN,Hungary,USA,United States,2014,996,1051,-55
HUN,Hungary,USA,United States,2015,1095,1188,-93
HUN,Hungary,USA,United States,2016,1048,1132,-84
HUN,Hungary,USA,United States,2017,972,1405,-433
HUN,Hungary,CHL,Chile,2008,4,6,-2
HUN,Hungary,CHL,Chile,2009,14,7,7
HUN,Hungary,CHL,Chile,2010,9,9,0
HUN,Hungary,CHL,Chile,2011,10,9,1
HUN,Hungary,CHL,Chile,2012,12,8,4
HUN,Hungary,CHL,Chile,2013,17,6,11
HUN,Hungary,CHL,Chile,2014,53,8,45
HUN,Hungary,CHL,Chile,2015,14,10,4
HUN,Hungary,CHL,Chile,2016,6,12,-6
HUN,Hungary,EST,Estonia,2008,14,13,1
HUN,Hungary,EST,Estonia,2009,21,16,5
HUN,Hungary,EST,Estonia,2010,7,10,-3
HUN,Hungary,EST,Estonia,2011,0,18,-18
HUN,Hungary,EST,Estonia,2012,1,15,-14
HUN,Hungary,EST,Estonia,2013,1,14,-13
HUN,Hungary,EST,Estonia,2014,3,22,-19
HUN,Hungary,EST,Estonia,2015,44,19,25
HUN,Hungary,EST,Estonia,2016,43,14,29
HUN,Hungary,EST,Estonia,2017,68,17,51
HUN,Hungary,ISR,Israel,2008,54,403,-349
HUN,Hungary,ISR,Israel,2009,90,289,-199
HUN,Hungary,ISR,Israel,2010,87,311,-224
HUN,Hungary,ISR,Israel,2011,128,255,-127
HUN,Hungary,ISR,Israel,2012,110,306,-196
HUN,Hungary,ISR,Israel,2013,148,270,-122
HUN,Hungary,ISR,Israel,2014,122,241,-119
HUN,Hungary,ISR,Israel,2015,81,234,-153
HUN,Hungary,ISR,Israel,2016,79,177,-98
HUN,Hungary,ISR,Israel,2017,52,255,-203
HUN,Hungary,SVN,Slovenia,2008,187,34,153
HUN,Hungary,SVN,Slovenia,2009,47,28,19
HUN,Hungary,SVN,Slovenia,2010,1,54,-53
HUN,Hungary,SVN,Slovenia,2011,201,46,155
HUN,Hungary,SVN,Slovenia,2012,222,50,172
HUN,Hungary,SVN,Slovenia,2013,300,29,271
HUN,Hungary,SVN,Slovenia,2014,285,35,250
HUN,Hungary,SVN,Slovenia,2015,333,34,299
HUN,Hungary,SVN,Slovenia,2016,339,53,286
HUN,Hungary,SVN,Slovenia,2017,367,53,314
ISL,Iceland,AUS,Australia,2008,9,5,4
ISL,Iceland,AUS,Australia,2009,17,10,7
ISL,Iceland,AUS,Australia,2010,10,7,3
ISL,Iceland,AUS,Australia,2011,7,19,-12
ISL,Iceland,AUS,Australia,2012,14,16,-2
ISL,Iceland,AUS,Australia,2013,15,14,1
ISL,Iceland,AUS,Australia,2014,9,15,-6
ISL,Iceland,AUS,Australia,2015,5,25,-20
ISL,Iceland,AUS,Australia,2016,11,17,-6
ISL,Iceland,AUS,Australia,2017,12,27,-15
ISL,Iceland,AUT,Austria,2008,24,39,-15
ISL,Iceland,AUT,Austria,2009,41,27,14
ISL,Iceland,AUT,Austria,2010,51,26,25
ISL,Iceland,AUT,Austria,2011,52,12,40
ISL,Iceland,AUT,Austria,2012,34,10,24
ISL,Iceland,AUT,Austria,2013,23,19,4
ISL,Iceland,AUT,Austria,2014,48,21,27
ISL,Iceland,AUT,Austria,2015,47,21,26
ISL,Iceland,AUT,Austria,2016,27,32,-5
ISL,Iceland,AUT,Austria,2017,35,31,4
ISL,Iceland,BEL,Belgium,2008,35,17,18
ISL,Iceland,BEL,Belgium,2009,44,13,31
ISL,Iceland,BEL,Belgium,2010,57,12,45
ISL,Iceland,BEL,Belgium,2012,31,6,25
ISL,Iceland,BEL,Belgium,2013,62,12,50
ISL,Iceland,BEL,Belgium,2014,25,26,-1
ISL,Iceland,BEL,Belgium,2015,24,19,5
ISL,Iceland,BEL,Belgium,2016,33,26,7
ISL,Iceland,BEL,Belgium,2017,48,30,18
ISL,Iceland,CAN,Canada,2008,13,70,-57
ISL,Iceland,CAN,Canada,2009,15,33,-18
ISL,Iceland,CAN,Canada,2010,30,42,-12
ISL,Iceland,CAN,Canada,2011,38,38,0
ISL,Iceland,CAN,Canada,2012,42,51,-9
ISL,Iceland,CAN,Canada,2013,72,56,16
ISL,Iceland,CAN,Canada,2014,38,55,-17
ISL,Iceland,CAN,Canada,2015,32,58,-26
ISL,Iceland,CAN,Canada,2016,15,76,-61
ISL,Iceland,CAN,Canada,2017,25,56,-31
ISL,Iceland,CZE,Czech Republic,2008,3,111,-108
ISL,Iceland,CZE,Czech Republic,2009,2,58,-56
ISL,Iceland,CZE,Czech Republic,2010,2,40,-38
ISL,Iceland,CZE,Czech Republic,2011,4,38,-34
ISL,Iceland,CZE,Czech Republic,2013,1,62,-61
ISL,Iceland,CZE,Czech Republic,2014,2,114,-112
ISL,Iceland,CZE,Czech Republic,2015,1,142,-141
ISL,Iceland,CZE,Czech Republic,2016,5,197,-192
ISL,Iceland,CZE,Czech Republic,2017,3,320,-317
ISL,Iceland,DNK,Denmark,2008,1109,177,932
ISL,Iceland,DNK,Denmark,2009,1003,88,915
ISL,Iceland,DNK,Denmark,2010,911,97,814
ISL,Iceland,DNK,Denmark,2011,621,121,500
ISL,Iceland,DNK,Denmark,2012,638,112,526
ISL,Iceland,DNK,Denmark,2013,561,147,414
ISL,Iceland,DNK,Denmark,2014,684,136,548
ISL,Iceland,DNK,Denmark,2015,816,159,657
ISL,Iceland,DNK,Denmark,2016,844,180,664
ISL,Iceland,DNK,Denmark,2017,733,181,552
ISL,Iceland,FIN,Finland,2008,20,36,-16
ISL,Iceland,FIN,Finland,2009,29,37,-8
ISL,Iceland,FIN,Finland,2010,15,31,-16
ISL,Iceland,FIN,Finland,2011,11,31,-20
ISL,Iceland,FIN,Finland,2012,10,23,-13
ISL,Iceland,FIN,Finland,2013,11,30,-19
ISL,Iceland,FIN,Finland,2014,18,40,-22
ISL,Iceland,FIN,Finland,2015,16,34,-18
ISL,Iceland,FIN,Finland,2016,21,48,-27
ISL,Iceland,FIN,Finland,2017,21,50,-29
ISL,Iceland,FRA,France,2008,0,102,-102
ISL,Iceland,FRA,France,2009,0,71,-71
ISL,Iceland,FRA,France,2010,0,105,-105
ISL,Iceland,FRA,France,2011,0,53,-53
ISL,Iceland,FRA,France,2012,0,47,-47
ISL,Iceland,FRA,France,2013,0,107,-107
ISL,Iceland,FRA,France,2014,0,132,-132
ISL,Iceland,FRA,France,2015,1,134,-133
ISL,Iceland,FRA,France,2016,0,151,-151
ISL,Iceland,FRA,France,2017,0,200,-200
ISL,Iceland,DEU,Germany,2008,229,320,-91
ISL,Iceland,DEU,Germany,2009,292,204,88
ISL,Iceland,DEU,Germany,2010,270,192,78
ISL,Iceland,DEU,Germany,2011,339,155,184
ISL,Iceland,DEU,Germany,2012,221,107,114
ISL,Iceland,DEU,Germany,2013,227,216,11
ISL,Iceland,DEU,Germany,2014,293,214,79
ISL,Iceland,DEU,Germany,2015,270,191,79
ISL,Iceland,DEU,Germany,2016,270,258,12
ISL,Iceland,DEU,Germany,2017,273,320,-47
ISL,Iceland,HUN,Hungary,2008,27,88,-61
ISL,Iceland,HUN,Hungary,2009,9,24,-15
ISL,Iceland,HUN,Hungary,2010,13,32,-19
ISL,Iceland,HUN,Hungary,2011,22,30,-8
ISL,Iceland,HUN,Hungary,2012,18,31,-13
ISL,Iceland,HUN,Hungary,2013,15,43,-28
ISL,Iceland,HUN,Hungary,2014,19,66,-47
ISL,Iceland,HUN,Hungary,2015,17,79,-62
ISL,Iceland,HUN,Hungary,2016,7,115,-108
ISL,Iceland,HUN,Hungary,2017,14,174,-160
ISL,Iceland,ISL,Iceland,2016,0,0,0
ISL,Iceland,ISL,Iceland,2017,0,0,0
ISL,Iceland,ITA,Italy,2008,45,53,-8
ISL,Iceland,ITA,Italy,2009,30,58,-28
ISL,Iceland,ITA,Italy,2010,28,63,-35
ISL,Iceland,ITA,Italy,2011,16,42,-26
ISL,Iceland,ITA,Italy,2012,11,46,-35
ISL,Iceland,ITA,Italy,2013,19,73,-54
ISL,Iceland,ITA,Italy,2015,12,90,-78
ISL,Iceland,ITA,Italy,2016,15,102,-87
ISL,Iceland,ITA,Italy,2017,9,158,-149
ISL,Iceland,JPN,Japan,2008,94,16,78
ISL,Iceland,JPN,Japan,2009,49,17,32
ISL,Iceland,JPN,Japan,2010,72,12,60
ISL,Iceland,JPN,Japan,2011,57,16,41
ISL,Iceland,JPN,Japan,2012,68,23,45
ISL,Iceland,JPN,Japan,2013,95,18,77
ISL,Iceland,JPN,Japan,2014,58,30,28
ISL,Iceland,JPN,Japan,2015,57,24,33
ISL,Iceland,JPN,Japan,2016,69,16,53
ISL,Iceland,JPN,Japan,2017,54,26,28
ISL,Iceland,KOR,Korea,2008,5,3,2
ISL,Iceland,KOR,Korea,2009,2,2,0
ISL,Iceland,KOR,Korea,2010,14,7,7
ISL,Iceland,KOR,Korea,2011,1,10,-9
ISL,Iceland,KOR,Korea,2012,7,1,6
ISL,Iceland,KOR,Korea,2013,8,7,1
ISL,Iceland,KOR,Korea,2014,4,6,-2
ISL,Iceland,KOR,Korea,2015,5,3,2
ISL,Iceland,KOR,Korea,2016,6,5,1
ISL,Iceland,KOR,Korea,2017,5,4,1
ISL,Iceland,LUX,Luxembourg,2008,27,1,26
ISL,Iceland,LUX,Luxembourg,2009,37,1,36
ISL,Iceland,LUX,Luxembourg,2010,49,1,48
ISL,Iceland,LUX,Luxembourg,2011,22,1,21
ISL,Iceland,LUX,Luxembourg,2012,31,0,31
ISL,Iceland,LUX,Luxembourg,2013,25,2,23
ISL,Iceland,LUX,Luxembourg,2014,14,0,14
ISL,Iceland,LUX,Luxembourg,2015,22,1,21
ISL,Iceland,LUX,Luxembourg,2016,29,1,28
ISL,Iceland,LUX,Luxembourg,2017,13,2,11
ISL,Iceland,MEX,Mexico,2008,1,13,-12
ISL,Iceland,MEX,Mexico,2009,2,13,-11
ISL,Iceland,MEX,Mexico,2010,2,7,-5
ISL,Iceland,MEX,Mexico,2012,0,11,-11
ISL,Iceland,MEX,Mexico,2013,3,8,-5
ISL,Iceland,MEX,Mexico,2014,2,13,-11
ISL,Iceland,MEX,Mexico,2015,4,19,-15
ISL,Iceland,MEX,Mexico,2016,1,30,-29
ISL,Iceland,MEX,Mexico,2017,1,16,-15
ISL,Iceland,NLD,Netherlands,2008,119,37,82
ISL,Iceland,NLD,Netherlands,2009,90,43,47
ISL,Iceland,NLD,Netherlands,2010,84,30,54
ISL,Iceland,NLD,Netherlands,2011,90,27,63
ISL,Iceland,NLD,Netherlands,2012,93,13,80
ISL,Iceland,NLD,Netherlands,2013,85,19,66
ISL,Iceland,NLD,Netherlands,2014,104,36,68
ISL,Iceland,NLD,Netherlands,2015,127,31,96
ISL,Iceland,NLD,Netherlands,2016,137,46,91
ISL,Iceland,NLD,Netherlands,2017,134,51,83
ISL,Iceland,NZL,New Zealand,2008,6,6,0
ISL,Iceland,NZL,New Zealand,2009,14,5,9
ISL,Iceland,NZL,New Zealand,2010,10,8,2
ISL,Iceland,NZL,New Zealand,2011,15,5,10
ISL,Iceland,NZL,New Zealand,2012,31,5,26
ISL,Iceland,NZL,New Zealand,2013,15,4,11
ISL,Iceland,NZL,New Zealand,2014,7,4,3
ISL,Iceland,NZL,New Zealand,2015,3,4,-1
ISL,Iceland,NZL,New Zealand,2016,1,10,-9
ISL,Iceland,NZL,New Zealand,2017,10,9,1
ISL,Iceland,NOR,Norway,2008,347,47,300
ISL,Iceland,NOR,Norway,2009,1584,24,1560
ISL,Iceland,NOR,Norway,2010,1678,37,1641
ISL,Iceland,NOR,Norway,2011,1726,40,1686
ISL,Iceland,NOR,Norway,2012,1450,34,1416
ISL,Iceland,NOR,Norway,2013,1104,55,1049
ISL,Iceland,NOR,Norway,2014,1135,37,1098
ISL,Iceland,NOR,Norway,2015,1002,34,968
ISL,Iceland,NOR,Norway,2016,582,57,525
ISL,Iceland,NOR,Norway,2017,359,59,300
ISL,Iceland,POL,Poland,2009,1,1237,-1236
ISL,Iceland,POL,Poland,2010,5,830,-825
ISL,Iceland,POL,Poland,2011,6,783,-777
ISL,Iceland,POL,Poland,2012,6,899,-893
ISL,Iceland,POL,Poland,2013,5,1329,-1324
ISL,Iceland,POL,Poland,2014,5,1410,-1405
ISL,Iceland,POL,Poland,2015,1,1624,-1623
ISL,Iceland,POL,Poland,2016,7,2873,-2866
ISL,Iceland,POL,Poland,2017,9,4549,-4540
ISL,Iceland,SVK,Slovak Republic,2008,2,181,-179
ISL,Iceland,SVK,Slovak Republic,2009,1,42,-41
ISL,Iceland,SVK,Slovak Republic,2010,1,28,-27
ISL,Iceland,SVK,Slovak Republic,2011,2,40,-38
ISL,Iceland,SVK,Slovak Republic,2012,4,44,-40
ISL,Iceland,SVK,Slovak Republic,2013,14,62,-48
ISL,Iceland,SVK,Slovak Republic,2014,17,84,-67
ISL,Iceland,SVK,Slovak Republic,2015,7,61,-54
ISL,Iceland,SVK,Slovak Republic,2016,5,156,-151
ISL,Iceland,SVK,Slovak Republic,2017,8,168,-160
ISL,Iceland,ESP,Spain,2008,135,53,82
ISL,Iceland,ESP,Spain,2009,76,61,15
ISL,Iceland,ESP,Spain,2010,99,84,15
ISL,Iceland,ESP,Spain,2011,138,59,79
ISL,Iceland,ESP,Spain,2012,107,64,43
ISL,Iceland,ESP,Spain,2013,109,152,-43
ISL,Iceland,ESP,Spain,2014,127,200,-73
ISL,Iceland,ESP,Spain,2015,179,178,1
ISL,Iceland,ESP,Spain,2016,174,213,-39
ISL,Iceland,ESP,Spain,2017,237,288,-51
ISL,Iceland,SWE,Sweden,2008,454,81,373
ISL,Iceland,SWE,Sweden,2009,671,65,606
ISL,Iceland,SWE,Sweden,2010,661,64,597
ISL,Iceland,SWE,Sweden,2011,732,83,649
ISL,Iceland,SWE,Sweden,2012,715,88,627
ISL,Iceland,SWE,Sweden,2013,541,79,462
ISL,Iceland,SWE,Sweden,2014,601,78,523
ISL,Iceland,SWE,Sweden,2015,796,75,721
ISL,Iceland,SWE,Sweden,2016,667,96,571
ISL,Iceland,SWE,Sweden,2017,654,104,550
ISL,Iceland,CHE,Switzerland,2008,26,28,-2
ISL,Iceland,CHE,Switzerland,2009,67,18,49
ISL,Iceland,CHE,Switzerland,2010,60,12,48
ISL,Iceland,CHE,Switzerland,2011,135,20,115
ISL,Iceland,CHE,Switzerland,2012,77,11,66
ISL,Iceland,CHE,Switzerland,2013,76,11,65
ISL,Iceland,CHE,Switzerland,2014,67,22,45
ISL,Iceland,CHE,Switzerland,2015,63,29,34
ISL,Iceland,CHE,Switzerland,2016,81,22,59
ISL,Iceland,CHE,Switzerland,2017,42,39,3
ISL,Iceland,TUR,Turkey,2010,3,7,-4
ISL,Iceland,USA,United States,2008,122,142,-20
ISL,Iceland,USA,United States,2009,131,131,0
ISL,Iceland,USA,United States,2010,105,130,-25
ISL,Iceland,USA,United States,2011,90,113,-23
ISL,Iceland,USA,United States,2012,103,191,-88
ISL,Iceland,USA,United States,2013,139,193,-54
ISL,Iceland,USA,United States,2014,86,169,-83
ISL,Iceland,USA,United States,2015,104,205,-101
ISL,Iceland,USA,United States,2016,97,262,-165
ISL,Iceland,USA,United States,2017,86,311,-225
ISL,Iceland,CHL,Chile,2008,2,2,0
ISL,Iceland,CHL,Chile,2009,5,2,3
ISL,Iceland,CHL,Chile,2010,3,4,-1
ISL,Iceland,CHL,Chile,2011,5,1,4
ISL,Iceland,CHL,Chile,2012,1,2,-1
ISL,Iceland,CHL,Chile,2013,1,0,1
ISL,Iceland,CHL,Chile,2014,1,4,-3
ISL,Iceland,CHL,Chile,2015,1,1,0
ISL,Iceland,CHL,Chile,2016,1,6,-5
ISL,Iceland,EST,Estonia,2008,0,30,-30
ISL,Iceland,EST,Estonia,2009,3,17,-14
ISL,Iceland,EST,Estonia,2010,0,29,-29
ISL,Iceland,EST,Estonia,2011,0,18,-18
ISL,Iceland,EST,Estonia,2012,1,7,-6
ISL,Iceland,EST,Estonia,2013,0,22,-22
ISL,Iceland,EST,Estonia,2014,0,11,-11
ISL,Iceland,EST,Estonia,2015,4,15,-11
ISL,Iceland,EST,Estonia,2016,1,21,-20
ISL,Iceland,EST,Estonia,2017,4,32,-28
ISL,Iceland,SVN,Slovenia,2008,1,16,-15
ISL,Iceland,SVN,Slovenia,2011,2,6,-4
ISL,Iceland,SVN,Slovenia,2012,1,1,0
ISL,Iceland,SVN,Slovenia,2013,2,7,-5
ISL,Iceland,SVN,Slovenia,2014,1,6,-5
ISL,Iceland,SVN,Slovenia,2016,2,15,-13
ISL,Iceland,SVN,Slovenia,2017,1,28,-27
IND,India,AUS,Australia,2008,22725,1495,21230
IND,India,AUS,Australia,2009,25280,1297,23983
IND,India,AUS,Australia,2010,23477,1514,21963
IND,India,AUS,Australia,2011,21855,1754,20101
IND,India,AUS,Australia,2012,27830,1678,26152
IND,India,AUS,Australia,2013,38123,1889,36234
IND,India,AUS,Australia,2014,39642,2051,37591
IND,India,AUS,Australia,2015,34710,2400,32310
IND,India,AUS,Australia,2016,38552,2400,36152
IND,India,AUS,Australia,2017,40019,0,40019
IND,India,AUT,Austria,2008,944,825,119
IND,India,AUT,Austria,2009,986,839,147
IND,India,AUT,Austria,2010,945,903,42
IND,India,AUT,Austria,2011,1043,737,306
IND,India,AUT,Austria,2012,1251,688,563
IND,India,AUT,Austria,2013,1194,724,470
IND,India,AUT,Austria,2014,1332,760,572
IND,India,AUT,Austria,2015,1411,764,647
IND,India,AUT,Austria,2016,1412,938,474
IND,India,AUT,Austria,2017,1471,976,495
IND,India,BEL,Belgium,2008,2058,1158,900
IND,India,BEL,Belgium,2009,1787,1293,494
IND,India,BEL,Belgium,2010,2286,1331,955
IND,India,BEL,Belgium,2011,2270,1441,829
IND,India,BEL,Belgium,2012,2305,1643,662
IND,India,BEL,Belgium,2013,2593,1710,883
IND,India,BEL,Belgium,2014,1949,1227,722
IND,India,BEL,Belgium,2015,2181,1248,933
IND,India,BEL,Belgium,2016,2391,1276,1115
IND,India,BEL,Belgium,2017,3066,1030,2036
IND,India,CAN,Canada,2008,28255,0,28255
IND,India,CAN,Canada,2009,29448,0,29448
IND,India,CAN,Canada,2010,34224,0,34224
IND,India,CAN,Canada,2011,27485,0,27485
IND,India,CAN,Canada,2012,30915,0,30915
IND,India,CAN,Canada,2013,33078,0,33078
IND,India,CAN,Canada,2014,38330,0,38330
IND,India,CAN,Canada,2015,39525,0,39525
IND,India,CAN,Canada,2016,39795,0,39795
IND,India,CAN,Canada,2017,51655,0,51655
IND,India,CZE,Czech Republic,2008,310,0,310
IND,India,CZE,Czech Republic,2009,295,0,295
IND,India,CZE,Czech Republic,2010,230,1,229
IND,India,CZE,Czech Republic,2011,208,2,206
IND,India,CZE,Czech Republic,2012,288,71,217
IND,India,CZE,Czech Republic,2013,313,212,101
IND,India,CZE,Czech Republic,2014,428,143,285
IND,India,CZE,Czech Republic,2015,550,241,309
IND,India,CZE,Czech Republic,2016,751,277,474
IND,India,CZE,Czech Republic,2017,1001,298,703
IND,India,DNK,Denmark,2008,1020,1008,12
IND,India,DNK,Denmark,2009,813,1029,-216
IND,India,DNK,Denmark,2010,913,990,-77
IND,India,DNK,Denmark,2011,1073,1221,-148
IND,India,DNK,Denmark,2012,905,1243,-338
IND,India,DNK,Denmark,2013,1128,1148,-20
IND,India,DNK,Denmark,2014,1371,1164,207
IND,India,DNK,Denmark,2015,1615,1056,559
IND,India,DNK,Denmark,2016,1897,1399,498
IND,India,DNK,Denmark,2017,1863,1788,75
IND,India,FIN,Finland,2008,623,269,354
IND,India,FIN,Finland,2009,612,200,412
IND,India,FIN,Finland,2010,486,166,320
IND,India,FIN,Finland,2011,573,239,334
IND,India,FIN,Finland,2012,572,296,276
IND,India,FIN,Finland,2013,676,297,379
IND,India,FIN,Finland,2014,826,398,428
IND,India,FIN,Finland,2015,821,495,326
IND,India,FIN,Finland,2016,676,514,162
IND,India,FIN,Finland,2017,730,349,381
IND,India,FRA,France,2008,1816,0,1816
IND,India,FRA,France,2009,1880,0,1880
IND,India,FRA,France,2010,1976,0,1976
IND,India,FRA,France,2011,2136,0,2136
IND,India,FRA,France,2012,2285,0,2285
IND,India,FRA,France,2013,2505,0,2505
IND,India,FRA,France,2014,2557,0,2557
IND,India,FRA,France,2015,2705,0,2705
IND,India,FRA,France,2016,2940,0,2940
IND,India,FRA,France,2017,3332,0,3332
IND,India,DEU,Germany,2008,11403,9532,1871
IND,India,DEU,Germany,2009,12009,10374,1635
IND,India,DEU,Germany,2010,13187,9981,3206
IND,India,DEU,Germany,2011,15352,9822,5530
IND,India,DEU,Germany,2012,18063,11108,6955
IND,India,DEU,Germany,2013,19455,12411,7044
IND,India,DEU,Germany,2014,22374,13134,9240
IND,India,DEU,Germany,2015,26113,15195,10918
IND,India,DEU,Germany,2016,27683,17186,10497
IND,India,DEU,Germany,2017,29535,15878,13657
IND,India,GRC,Greece,2008,647,0,647
IND,India,GRC,Greece,2009,739,0,739
IND,India,GRC,Greece,2010,588,0,588
IND,India,GRC,Greece,2011,763,0,763
IND,India,HUN,Hungary,2008,300,19,281
IND,India,HUN,Hungary,2009,218,57,161
IND,India,HUN,Hungary,2010,318,42,276
IND,India,HUN,Hungary,2011,356,45,311
IND,India,HUN,Hungary,2012,260,62,198
IND,India,HUN,Hungary,2013,211,88,123
IND,India,HUN,Hungary,2014,355,83,272
IND,India,HUN,Hungary,2015,512,131,381
IND,India,HUN,Hungary,2016,531,115,416
IND,India,HUN,Hungary,2017,795,0,795
IND,India,ISL,Iceland,2008,64,65,-1
IND,India,ISL,Iceland,2009,17,44,-27
IND,India,ISL,Iceland,2010,21,23,-2
IND,India,ISL,Iceland,2011,16,8,8
IND,India,ISL,Iceland,2012,19,4,15
IND,India,ISL,Iceland,2013,23,16,7
IND,India,ISL,Iceland,2014,20,13,7
IND,India,ISL,Iceland,2015,17,12,5
IND,India,ISL,Iceland,2016,26,15,11
IND,India,ISL,Iceland,2017,17,12,5
IND,India,ITA,Italy,2008,12469,403,12066
IND,India,ITA,Italy,2009,12769,476,12293
IND,India,ITA,Italy,2010,15246,1011,14235
IND,India,ITA,Italy,2011,13327,1058,12269
IND,India,ITA,Italy,2012,11158,1285,9873
IND,India,ITA,Italy,2013,10814,1485,9329
IND,India,ITA,Italy,2014,11052,1666,9386
IND,India,ITA,Italy,2015,11236,1491,9745
IND,India,ITA,Italy,2016,9980,0,9980
IND,India,ITA,Italy,2017,7723,1450,6273
IND,India,JPN,Japan,2008,5744,3470,2274
IND,India,JPN,Japan,2009,4559,3004,1555
IND,India,JPN,Japan,2010,4854,3329,1525
IND,India,JPN,Japan,2011,4673,3126,1547
IND,India,JPN,Japan,2012,5632,3379,2253
IND,India,JPN,Japan,2013,5605,3124,2481
IND,India,JPN,Japan,2014,6886,3111,3775
IND,India,JPN,Japan,2015,6850,3357,3493
IND,India,JPN,Japan,2016,7009,3228,3781
IND,India,JPN,Japan,2017,7920,3562,4358
IND,India,KOR,Korea,2008,2161,2706,-545
IND,India,KOR,Korea,2009,1788,2407,-619
IND,India,KOR,Korea,2010,2287,2169,118
IND,India,KOR,Korea,2011,2415,2530,-115
IND,India,KOR,Korea,2012,2582,2395,187
IND,India,KOR,Korea,2013,2858,2736,122
IND,India,KOR,Korea,2014,3445,2818,627
IND,India,KOR,Korea,2015,3060,3202,-142
IND,India,KOR,Korea,2016,3208,3168,40
IND,India,KOR,Korea,2017,3820,3396,424
IND,India,LUX,Luxembourg,2008,178,41,137
IND,India,LUX,Luxembourg,2009,97,39,58
IND,India,LUX,Luxembourg,2010,127,36,91
IND,India,LUX,Luxembourg,2011,156,32,124
IND,India,LUX,Luxembourg,2012,143,59,84
IND,India,LUX,Luxembourg,2013,145,95,50
IND,India,LUX,Luxembourg,2014,201,89,112
IND,India,LUX,Luxembourg,2015,337,99,238
IND,India,LUX,Luxembourg,2016,394,154,240
IND,India,LUX,Luxembourg,2017,620,159,461
IND,India,MEX,Mexico,2008,42,0,42
IND,India,MEX,Mexico,2009,64,0,64
IND,India,MEX,Mexico,2010,70,0,70
IND,India,MEX,Mexico,2011,64,0,64
IND,India,MEX,Mexico,2012,69,0,69
IND,India,MEX,Mexico,2013,200,0,200
IND,India,MEX,Mexico,2014,160,0,160
IND,India,MEX,Mexico,2015,171,0,171
IND,India,MEX,Mexico,2016,219,0,219
IND,India,MEX,Mexico,2017,251,0,251
IND,India,NLD,Netherlands,2008,3454,1768,1686
IND,India,NLD,Netherlands,2009,3069,2214,855
IND,India,NLD,Netherlands,2010,3172,2286,886
IND,India,NLD,Netherlands,2011,3783,2412,1371
IND,India,NLD,Netherlands,2012,3956,2820,1136
IND,India,NLD,Netherlands,2013,4480,2880,1600
IND,India,NLD,Netherlands,2014,5051,2932,2119
IND,India,NLD,Netherlands,2015,6137,3356,2781
IND,India,NLD,Netherlands,2016,7248,3656,3592
IND,India,NLD,Netherlands,2017,8629,3893,4736
IND,India,NZL,New Zealand,2008,6265,719,5546
IND,India,NZL,New Zealand,2009,7060,923,6137
IND,India,NZL,New Zealand,2010,7849,1145,6704
IND,India,NZL,New Zealand,2011,6640,1462,5178
IND,India,NZL,New Zealand,2012,6891,1412,5479
IND,India,NZL,New Zealand,2013,7143,1435,5708
IND,India,NZL,New Zealand,2014,12230,1240,10990
IND,India,NZL,New Zealand,2015,15477,1349,14128
IND,India,NZL,New Zealand,2016,11069,1596,9473
IND,India,NZL,New Zealand,2017,10067,2576,7491
IND,India,NOR,Norway,2008,1068,307,761
IND,India,NOR,Norway,2009,773,487,286
IND,India,NOR,Norway,2010,812,595,217
IND,India,NOR,Norway,2011,1167,568,599
IND,India,NOR,Norway,2012,1513,570,943
IND,India,NOR,Norway,2013,1500,719,781
IND,India,NOR,Norway,2014,1827,829,998
IND,India,NOR,Norway,2015,1656,1198,458
IND,India,NOR,Norway,2016,1366,1260,106
IND,India,NOR,Norway,2017,1607,889,718
IND,India,POL,Poland,2008,1031,0,1031
IND,India,POL,Poland,2009,1137,0,1137
IND,India,POL,Poland,2010,1201,0,1201
IND,India,POL,Poland,2011,1077,0,1077
IND,India,POL,Poland,2012,1151,0,1151
IND,India,POL,Poland,2013,1214,0,1214
IND,India,POL,Poland,2014,785,0,785
IND,India,POL,Poland,2015,1881,0,1881
IND,India,POL,Poland,2016,2813,0,2813
IND,India,POL,Poland,2017,4135,0,4135
IND,India,PRT,Portugal,2008,866,0,866
IND,India,PRT,Portugal,2009,976,0,976
IND,India,PRT,Portugal,2010,915,0,915
IND,India,PRT,Portugal,2011,1107,0,1107
IND,India,PRT,Portugal,2012,927,0,927
IND,India,PRT,Portugal,2013,970,0,970
IND,India,PRT,Portugal,2014,936,0,936
IND,India,PRT,Portugal,2015,1121,0,1121
IND,India,PRT,Portugal,2016,1024,0,1024
IND,India,PRT,Portugal,2017,1801,0,1801
IND,India,SVK,Slovak Republic,2008,4,34,-30
IND,India,SVK,Slovak Republic,2009,7,25,-18
IND,India,SVK,Slovak Republic,2010,8,30,-22
IND,India,SVK,Slovak Republic,2011,3,1,2
IND,India,SVK,Slovak Republic,2012,2,0,2
IND,India,SVK,Slovak Republic,2013,8,0,8
IND,India,SVK,Slovak Republic,2014,3,0,3
IND,India,SVK,Slovak Republic,2015,7,0,7
IND,India,SVK,Slovak Republic,2016,3,0,3
IND,India,SVK,Slovak Republic,2017,3,0,3
IND,India,ESP,Spain,2008,5024,1473,3551
IND,India,ESP,Spain,2009,4280,2378,1902
IND,India,ESP,Spain,2010,3382,3015,367
IND,India,ESP,Spain,2011,3649,3649,0
IND,India,ESP,Spain,2012,2932,3938,-1006
IND,India,ESP,Spain,2013,2827,4485,-1658
IND,India,ESP,Spain,2014,2893,2519,374
IND,India,ESP,Spain,2015,2990,2007,983
IND,India,ESP,Spain,2016,3792,2010,1782
IND,India,ESP,Spain,2017,4758,2117,2641
IND,India,SWE,Sweden,2008,1548,661,887
IND,India,SWE,Sweden,2009,1795,595,1200
IND,India,SWE,Sweden,2010,2150,673,1477
IND,India,SWE,Sweden,2011,1691,921,770
IND,India,SWE,Sweden,2012,2027,1228,799
IND,India,SWE,Sweden,2013,2376,1235,1141
IND,India,SWE,Sweden,2014,3004,1634,1370
IND,India,SWE,Sweden,2015,3522,2194,1328
IND,India,SWE,Sweden,2016,4161,1682,2479
IND,India,SWE,Sweden,2017,5673,1659,4014
IND,India,CHE,Switzerland,2010,2371,1575,796
IND,India,CHE,Switzerland,2011,2410,1478,932
IND,India,CHE,Switzerland,2012,2584,1628,956
IND,India,CHE,Switzerland,2013,2524,1821,703
IND,India,CHE,Switzerland,2014,2640,1705,935
IND,India,CHE,Switzerland,2015,2862,1761,1101
IND,India,CHE,Switzerland,2016,2912,2307,605
IND,India,CHE,Switzerland,2017,3073,2127,946
IND,India,TUR,Turkey,2010,81,0,81
IND,India,TUR,Turkey,2016,1769,418,1351
IND,India,TUR,Turkey,2017,2210,671,1539
IND,India,GBR,United Kingdom,2008,48000,15000,33000
IND,India,GBR,United Kingdom,2009,64000,15000,49000
IND,India,GBR,United Kingdom,2010,68000,14000,54000
IND,India,GBR,United Kingdom,2011,61000,22000,39000
IND,India,GBR,United Kingdom,2012,36000,17000,19000
IND,India,GBR,United Kingdom,2013,30000,14000,16000
IND,India,GBR,United Kingdom,2014,46000,13000,33000
IND,India,GBR,United Kingdom,2015,36000,13000,23000
IND,India,GBR,United Kingdom,2016,35000,11000,24000
IND,India,GBR,United Kingdom,2017,50000,8000,42000
IND,India,USA,United States,2008,63352,0,63352
IND,India,USA,United States,2009,57304,0,57304
IND,India,USA,United States,2010,69162,0,69162
IND,India,USA,United States,2011,69013,0,69013
IND,India,USA,United States,2012,66434,0,66434
IND,India,USA,United States,2013,68458,0,68458
IND,India,USA,United States,2014,77908,0,77908
IND,India,USA,United States,2015,64116,0,64116
IND,India,USA,United States,2016,64687,0,64687
IND,India,USA,United States,2017,60394,0,60394
IND,India,CHL,Chile,2008,161,0,161
IND,India,CHL,Chile,2009,117,0,117
IND,India,CHL,Chile,2010,142,0,142
IND,India,CHL,Chile,2011,142,0,142
IND,India,CHL,Chile,2012,175,0,175
IND,India,CHL,Chile,2013,122,0,122
IND,India,CHL,Chile,2014,135,0,135
IND,India,CHL,Chile,2015,213,0,213
IND,India,CHL,Chile,2016,239,0,239
IND,India,EST,Estonia,2008,16,0,16
IND,India,EST,Estonia,2009,14,0,14
IND,India,EST,Estonia,2010,11,0,11
IND,India,EST,Estonia,2011,20,0,20
IND,India,EST,Estonia,2012,28,0,28
IND,India,EST,Estonia,2013,47,0,47
IND,India,EST,Estonia,2014,25,0,25
IND,India,EST,Estonia,2015,80,0,80
IND,India,EST,Estonia,2016,106,0,106
IND,India,EST,Estonia,2017,132,0,132
IND,India,ISR,Israel,2008,61,0,61
IND,India,ISR,Israel,2009,30,0,30
IND,India,ISR,Israel,2010,44,0,44
IND,India,ISR,Israel,2011,35,0,35
IND,India,ISR,Israel,2012,27,0,27
IND,India,ISR,Israel,2013,44,0,44
IND,India,ISR,Israel,2014,32,0,32
IND,India,ISR,Israel,2015,47,0,47
IND,India,ISR,Israel,2016,55,0,55
IND,India,ISR,Israel,2017,56,0,56
IND,India,SVN,Slovenia,2008,42,0,42
IND,India,SVN,Slovenia,2009,22,0,22
IND,India,SVN,Slovenia,2010,33,0,33
IND,India,SVN,Slovenia,2011,35,2,33
IND,India,SVN,Slovenia,2012,35,1,34
IND,India,SVN,Slovenia,2013,23,1,22
IND,India,SVN,Slovenia,2014,30,0,30
IND,India,SVN,Slovenia,2015,35,3,32
IND,India,SVN,Slovenia,2016,87,2,85
IND,India,SVN,Slovenia,2017,82,9,73
IDN,Indonesia,AUS,Australia,2008,3162,179,2983
IDN,Indonesia,AUS,Australia,2009,2860,183,2677
IDN,Indonesia,AUS,Australia,2010,2408,219,2189
IDN,Indonesia,AUS,Australia,2011,2906,305,2601
IDN,Indonesia,AUS,Australia,2012,2510,296,2214
IDN,Indonesia,AUS,Australia,2013,2514,293,2221
IDN,Indonesia,AUS,Australia,2014,2366,326,2040
IDN,Indonesia,AUS,Australia,2015,2076,300,1776
IDN,Indonesia,AUS,Australia,2016,2092,300,1792
IDN,Indonesia,AUS,Australia,2017,1888,0,1888
IDN,Indonesia,AUT,Austria,2008,70,43,27
IDN,Indonesia,AUT,Austria,2009,126,68,58
IDN,Indonesia,AUT,Austria,2010,93,79,14
IDN,Indonesia,AUT,Austria,2011,113,63,50
IDN,Indonesia,AUT,Austria,2012,119,79,40
IDN,Indonesia,AUT,Austria,2013,104,91,13
IDN,Indonesia,AUT,Austria,2014,115,84,31
IDN,Indonesia,AUT,Austria,2015,158,67,91
IDN,Indonesia,AUT,Austria,2016,125,92,33
IDN,Indonesia,AUT,Austria,2017,121,78,43
IDN,Indonesia,BEL,Belgium,2008,187,0,187
IDN,Indonesia,BEL,Belgium,2009,156,0,156
IDN,Indonesia,BEL,Belgium,2010,158,105,53
IDN,Indonesia,BEL,Belgium,2011,172,111,61
IDN,Indonesia,BEL,Belgium,2012,193,124,69
IDN,Indonesia,BEL,Belgium,2013,169,121,48
IDN,Indonesia,BEL,Belgium,2014,128,96,32
IDN,Indonesia,BEL,Belgium,2015,164,91,73
IDN,Indonesia,BEL,Belgium,2016,186,49,137
IDN,Indonesia,BEL,Belgium,2017,195,58,137
IDN,Indonesia,CAN,Canada,2008,661,0,661
IDN,Indonesia,CAN,Canada,2009,504,0,504
IDN,Indonesia,CAN,Canada,2010,712,0,712
IDN,Indonesia,CAN,Canada,2011,390,0,390
IDN,Indonesia,CAN,Canada,2012,395,0,395
IDN,Indonesia,CAN,Canada,2013,386,0,386
IDN,Indonesia,CAN,Canada,2014,416,0,416
IDN,Indonesia,CAN,Canada,2015,377,0,377
IDN,Indonesia,CAN,Canada,2016,445,0,445
IDN,Indonesia,CAN,Canada,2017,500,0,500
IDN,Indonesia,CZE,Czech Republic,2008,126,2,124
IDN,Indonesia,CZE,Czech Republic,2009,26,0,26
IDN,Indonesia,CZE,Czech Republic,2010,35,0,35
IDN,Indonesia,CZE,Czech Republic,2011,23,0,23
IDN,Indonesia,CZE,Czech Republic,2012,17,7,10
IDN,Indonesia,CZE,Czech Republic,2013,31,31,0
IDN,Indonesia,CZE,Czech Republic,2014,35,20,15
IDN,Indonesia,CZE,Czech Republic,2015,26,16,10
IDN,Indonesia,CZE,Czech Republic,2016,54,24,30
IDN,Indonesia,CZE,Czech Republic,2017,35,21,14
IDN,Indonesia,DNK,Denmark,2008,52,39,13
IDN,Indonesia,DNK,Denmark,2009,54,49,5
IDN,Indonesia,DNK,Denmark,2010,51,44,7
IDN,Indonesia,DNK,Denmark,2011,52,56,-4
IDN,Indonesia,DNK,Denmark,2012,66,51,15
IDN,Indonesia,DNK,Denmark,2013,66,55,11
IDN,Indonesia,DNK,Denmark,2014,78,27,51
IDN,Indonesia,DNK,Denmark,2015,67,49,18
IDN,Indonesia,DNK,Denmark,2016,88,62,26
IDN,Indonesia,DNK,Denmark,2017,88,43,45
IDN,Indonesia,FIN,Finland,2008,17,5,12
IDN,Indonesia,FIN,Finland,2009,40,7,33
IDN,Indonesia,FIN,Finland,2010,28,5,23
IDN,Indonesia,FIN,Finland,2011,29,4,25
IDN,Indonesia,FIN,Finland,2012,41,11,30
IDN,Indonesia,FIN,Finland,2013,41,4,37
IDN,Indonesia,FIN,Finland,2014,59,7,52
IDN,Indonesia,FIN,Finland,2015,38,13,25
IDN,Indonesia,FIN,Finland,2016,66,10,56
IDN,Indonesia,FIN,Finland,2017,63,3,60
IDN,Indonesia,FRA,France,2008,159,0,159
IDN,Indonesia,FRA,France,2009,229,0,229
IDN,Indonesia,FRA,France,2010,241,0,241
IDN,Indonesia,FRA,France,2011,228,0,228
IDN,Indonesia,FRA,France,2012,229,0,229
IDN,Indonesia,FRA,France,2013,266,0,266
IDN,Indonesia,FRA,France,2014,272,0,272
IDN,Indonesia,FRA,France,2015,250,0,250
IDN,Indonesia,FRA,France,2016,248,0,248
IDN,Indonesia,FRA,France,2017,190,0,190
IDN,Indonesia,DEU,Germany,2008,1557,1440,117
IDN,Indonesia,DEU,Germany,2009,1776,1658,118
IDN,Indonesia,DEU,Germany,2010,1759,1552,207
IDN,Indonesia,DEU,Germany,2011,1951,1362,589
IDN,Indonesia,DEU,Germany,2012,2242,1254,988
IDN,Indonesia,DEU,Germany,2013,2765,1512,1253
IDN,Indonesia,DEU,Germany,2014,2520,1557,963
IDN,Indonesia,DEU,Germany,2015,2470,1633,837
IDN,Indonesia,DEU,Germany,2016,2701,1722,979
IDN,Indonesia,DEU,Germany,2017,2577,1532,1045
IDN,Indonesia,HUN,Hungary,2008,29,0,29
IDN,Indonesia,HUN,Hungary,2009,40,1,39
IDN,Indonesia,HUN,Hungary,2010,48,6,42
IDN,Indonesia,HUN,Hungary,2011,44,7,37
IDN,Indonesia,HUN,Hungary,2012,24,6,18
IDN,Indonesia,HUN,Hungary,2013,39,2,37
IDN,Indonesia,HUN,Hungary,2014,35,7,28
IDN,Indonesia,HUN,Hungary,2015,48,3,45
IDN,Indonesia,HUN,Hungary,2016,55,7,48
IDN,Indonesia,HUN,Hungary,2017,94,0,94
IDN,Indonesia,ISL,Iceland,2008,10,42,-32
IDN,Indonesia,ISL,Iceland,2009,2,2,0
IDN,Indonesia,ISL,Iceland,2010,6,5,1
IDN,Indonesia,ISL,Iceland,2011,13,5,8
IDN,Indonesia,ISL,Iceland,2012,6,4,2
IDN,Indonesia,ISL,Iceland,2013,5,0,5
IDN,Indonesia,ISL,Iceland,2014,10,5,5
IDN,Indonesia,ISL,Iceland,2015,7,2,5
IDN,Indonesia,ISL,Iceland,2016,10,9,1
IDN,Indonesia,ISL,Iceland,2017,12,8,4
IDN,Indonesia,ITA,Italy,2008,153,3,150
IDN,Indonesia,ITA,Italy,2009,251,4,247
IDN,Indonesia,ITA,Italy,2010,200,30,170
IDN,Indonesia,ITA,Italy,2011,218,26,192
IDN,Indonesia,ITA,Italy,2012,265,44,221
IDN,Indonesia,ITA,Italy,2013,230,22,208
IDN,Indonesia,ITA,Italy,2014,212,30,182
IDN,Indonesia,ITA,Italy,2015,218,37,181
IDN,Indonesia,ITA,Italy,2016,189,0,189
IDN,Indonesia,ITA,Italy,2017,168,43,125
IDN,Indonesia,JPN,Japan,2008,10069,7612,2457
IDN,Indonesia,JPN,Japan,2009,7481,8053,-572
IDN,Indonesia,JPN,Japan,2010,8297,8160,137
IDN,Indonesia,JPN,Japan,2011,8351,7789,562
IDN,Indonesia,JPN,Japan,2012,9282,7081,2201
IDN,Indonesia,JPN,Japan,2013,9628,7270,2358
IDN,Indonesia,JPN,Japan,2014,11757,7747,4010
IDN,Indonesia,JPN,Japan,2015,14295,8441,5854
IDN,Indonesia,JPN,Japan,2016,16846,10453,6393
IDN,Indonesia,JPN,Japan,2017,19632,12823,6809
IDN,Indonesia,KOR,Korea,2008,9654,5872,3782
IDN,Indonesia,KOR,Korea,2009,3344,5309,-1965
IDN,Indonesia,KOR,Korea,2010,5308,4232,1076
IDN,Indonesia,KOR,Korea,2011,8053,6158,1895
IDN,Indonesia,KOR,Korea,2012,8263,7894,369
IDN,Indonesia,KOR,Korea,2013,11760,7864,3896
IDN,Indonesia,KOR,Korea,2014,10506,5263,5243
IDN,Indonesia,KOR,Korea,2015,8538,7111,1427
IDN,Indonesia,KOR,Korea,2016,8956,9713,-757
IDN,Indonesia,KOR,Korea,2017,6887,9066,-2179
IDN,Indonesia,LUX,Luxembourg,2008,5,1,4
IDN,Indonesia,LUX,Luxembourg,2009,6,3,3
IDN,Indonesia,LUX,Luxembourg,2010,10,5,5
IDN,Indonesia,LUX,Luxembourg,2011,5,4,1
IDN,Indonesia,LUX,Luxembourg,2012,1,3,-2
IDN,Indonesia,LUX,Luxembourg,2013,5,1,4
IDN,Indonesia,LUX,Luxembourg,2014,13,2,11
IDN,Indonesia,LUX,Luxembourg,2015,4,1,3
IDN,Indonesia,LUX,Luxembourg,2016,10,2,8
IDN,Indonesia,LUX,Luxembourg,2017,8,2,6
IDN,Indonesia,MEX,Mexico,2008,6,0,6
IDN,Indonesia,MEX,Mexico,2009,5,0,5
IDN,Indonesia,MEX,Mexico,2010,6,0,6
IDN,Indonesia,MEX,Mexico,2011,10,0,10
IDN,Indonesia,MEX,Mexico,2012,6,0,6
IDN,Indonesia,MEX,Mexico,2013,48,0,48
IDN,Indonesia,MEX,Mexico,2014,19,0,19
IDN,Indonesia,MEX,Mexico,2015,12,0,12
IDN,Indonesia,MEX,Mexico,2016,6,0,6
IDN,Indonesia,MEX,Mexico,2017,13,0,13
IDN,Indonesia,NLD,Netherlands,2008,1248,887,361
IDN,Indonesia,NLD,Netherlands,2009,1110,954,156
IDN,Indonesia,NLD,Netherlands,2010,1227,910,317
IDN,Indonesia,NLD,Netherlands,2011,1310,907,403
IDN,Indonesia,NLD,Netherlands,2012,1168,941,227
IDN,Indonesia,NLD,Netherlands,2013,1328,1016,312
IDN,Indonesia,NLD,Netherlands,2014,1394,1003,391
IDN,Indonesia,NLD,Netherlands,2015,1481,1053,428
IDN,Indonesia,NLD,Netherlands,2016,1827,1170,657
IDN,Indonesia,NLD,Netherlands,2017,1611,1387,224
IDN,Indonesia,NZL,New Zealand,2008,306,160,146
IDN,Indonesia,NZL,New Zealand,2009,297,179,118
IDN,Indonesia,NZL,New Zealand,2010,292,187,105
IDN,Indonesia,NZL,New Zealand,2011,370,163,207
IDN,Indonesia,NZL,New Zealand,2012,380,157,223
IDN,Indonesia,NZL,New Zealand,2013,478,155,323
IDN,Indonesia,NZL,New Zealand,2014,491,166,325
IDN,Indonesia,NZL,New Zealand,2015,534,125,409
IDN,Indonesia,NZL,New Zealand,2016,621,166,455
IDN,Indonesia,NZL,New Zealand,2017,626,203,423
IDN,Indonesia,NOR,Norway,2008,151,50,101
IDN,Indonesia,NOR,Norway,2009,124,63,61
IDN,Indonesia,NOR,Norway,2010,122,57,65
IDN,Indonesia,NOR,Norway,2011,140,67,73
IDN,Indonesia,NOR,Norway,2012,152,82,70
IDN,Indonesia,NOR,Norway,2013,109,97,12
IDN,Indonesia,NOR,Norway,2014,106,91,15
IDN,Indonesia,NOR,Norway,2015,90,91,-1
IDN,Indonesia,NOR,Norway,2016,92,94,-2
IDN,Indonesia,NOR,Norway,2017,113,60,53
IDN,Indonesia,POL,Poland,2009,53,0,53
IDN,Indonesia,POL,Poland,2010,80,0,80
IDN,Indonesia,POL,Poland,2011,62,0,62
IDN,Indonesia,POL,Poland,2012,58,0,58
IDN,Indonesia,POL,Poland,2013,80,0,80
IDN,Indonesia,POL,Poland,2014,36,0,36
IDN,Indonesia,POL,Poland,2015,102,0,102
IDN,Indonesia,POL,Poland,2016,116,0,116
IDN,Indonesia,POL,Poland,2017,106,0,106
IDN,Indonesia,SVK,Slovak Republic,2008,1,16,-15
IDN,Indonesia,SVK,Slovak Republic,2009,23,4,19
IDN,Indonesia,SVK,Slovak Republic,2010,2,27,-25
IDN,Indonesia,SVK,Slovak Republic,2011,2,14,-12
IDN,Indonesia,SVK,Slovak Republic,2012,3,0,3
IDN,Indonesia,SVK,Slovak Republic,2013,1,0,1
IDN,Indonesia,SVK,Slovak Republic,2014,5,1,4
IDN,Indonesia,SVK,Slovak Republic,2015,2,0,2
IDN,Indonesia,SVK,Slovak Republic,2016,2,0,2
IDN,Indonesia,SVK,Slovak Republic,2017,2,0,2
IDN,Indonesia,ESP,Spain,2008,364,61,303
IDN,Indonesia,ESP,Spain,2009,173,112,61
IDN,Indonesia,ESP,Spain,2010,91,101,-10
IDN,Indonesia,ESP,Spain,2011,113,103,10
IDN,Indonesia,ESP,Spain,2012,120,93,27
IDN,Indonesia,ESP,Spain,2013,119,106,13
IDN,Indonesia,ESP,Spain,2014,148,52,96
IDN,Indonesia,ESP,Spain,2015,160,55,105
IDN,Indonesia,ESP,Spain,2016,218,64,154
IDN,Indonesia,ESP,Spain,2017,210,121,89
IDN,Indonesia,SWE,Sweden,2008,111,23,88
IDN,Indonesia,SWE,Sweden,2009,127,19,108
IDN,Indonesia,SWE,Sweden,2010,99,34,65
IDN,Indonesia,SWE,Sweden,2011,87,53,34
IDN,Indonesia,SWE,Sweden,2012,103,60,43
IDN,Indonesia,SWE,Sweden,2013,96,40,56
IDN,Indonesia,SWE,Sweden,2014,110,53,57
IDN,Indonesia,SWE,Sweden,2015,124,67,57
IDN,Indonesia,SWE,Sweden,2016,189,57,132
IDN,Indonesia,SWE,Sweden,2017,153,43,110
IDN,Indonesia,CHE,Switzerland,2010,195,163,32
IDN,Indonesia,CHE,Switzerland,2011,233,159,74
IDN,Indonesia,CHE,Switzerland,2012,226,136,90
IDN,Indonesia,CHE,Switzerland,2013,307,183,124
IDN,Indonesia,CHE,Switzerland,2014,221,197,24
IDN,Indonesia,CHE,Switzerland,2015,248,187,61
IDN,Indonesia,CHE,Switzerland,2016,266,191,75
IDN,Indonesia,CHE,Switzerland,2017,248,199,49
IDN,Indonesia,TUR,Turkey,2010,320,0,320
IDN,Indonesia,TUR,Turkey,2016,1161,602,559
IDN,Indonesia,TUR,Turkey,2017,1591,715,876
IDN,Indonesia,GBR,United Kingdom,2011,1000,0,1000
IDN,Indonesia,GBR,United Kingdom,2012,2000,0,2000
IDN,Indonesia,GBR,United Kingdom,2013,3000,0,3000
IDN,Indonesia,GBR,United Kingdom,2014,2000,0,2000
IDN,Indonesia,GBR,United Kingdom,2015,1000,1000,0
IDN,Indonesia,USA,United States,2008,3606,0,3606
IDN,Indonesia,USA,United States,2009,3679,0,3679
IDN,Indonesia,USA,United States,2010,3032,0,3032
IDN,Indonesia,USA,United States,2011,2856,0,2856
IDN,Indonesia,USA,United States,2012,2603,0,2603
IDN,Indonesia,USA,United States,2013,2731,0,2731
IDN,Indonesia,USA,United States,2014,2139,0,2139
IDN,Indonesia,USA,United States,2015,2084,0,2084
IDN,Indonesia,USA,United States,2016,2129,0,2129
IDN,Indonesia,USA,United States,2017,1914,0,1914
IDN,Indonesia,CHL,Chile,2008,9,0,9
IDN,Indonesia,CHL,Chile,2009,14,0,14
IDN,Indonesia,CHL,Chile,2010,83,0,83
IDN,Indonesia,CHL,Chile,2011,10,0,10
IDN,Indonesia,CHL,Chile,2012,12,0,12
IDN,Indonesia,CHL,Chile,2013,11,0,11
IDN,Indonesia,CHL,Chile,2014,27,0,27
IDN,Indonesia,CHL,Chile,2015,42,0,42
IDN,Indonesia,CHL,Chile,2016,25,0,25
IDN,Indonesia,EST,Estonia,2008,1,0,1
IDN,Indonesia,EST,Estonia,2009,0,0,0
IDN,Indonesia,EST,Estonia,2010,1,0,1
IDN,Indonesia,EST,Estonia,2011,2,0,2
IDN,Indonesia,EST,Estonia,2012,2,0,2
IDN,Indonesia,EST,Estonia,2013,1,0,1
IDN,Indonesia,EST,Estonia,2014,0,0,0
IDN,Indonesia,EST,Estonia,2015,6,0,6
IDN,Indonesia,EST,Estonia,2016,2,0,2
IDN,Indonesia,EST,Estonia,2017,13,0,13
IDN,Indonesia,SVN,Slovenia,2008,6,0,6
IDN,Indonesia,SVN,Slovenia,2009,1,0,1
IDN,Indonesia,SVN,Slovenia,2010,2,0,2
IDN,Indonesia,SVN,Slovenia,2011,9,0,9
IDN,Indonesia,SVN,Slovenia,2012,4,0,4
IDN,Indonesia,SVN,Slovenia,2013,3,0,3
IDN,Indonesia,SVN,Slovenia,2015,7,0,7
IDN,Indonesia,SVN,Slovenia,2016,1,0,1
IDN,Indonesia,SVN,Slovenia,2017,2,0,2
IRN,Iran,AUS,Australia,2008,1153,264,889
IRN,Iran,AUS,Australia,2009,2041,254,1787
IRN,Iran,AUS,Australia,2010,1832,248,1584
IRN,Iran,AUS,Australia,2011,2559,264,2295
IRN,Iran,AUS,Australia,2012,3024,277,2747
IRN,Iran,AUS,Australia,2013,3068,310,2758
IRN,Iran,AUS,Australia,2014,2693,397,2296
IRN,Iran,AUS,Australia,2015,3935,500,3435
IRN,Iran,AUS,Australia,2016,2785,500,2285
IRN,Iran,AUS,Australia,2017,2818,0,2818
IRN,Iran,AUT,Austria,2008,1701,1657,44
IRN,Iran,AUT,Austria,2009,1872,1649,223
IRN,Iran,AUT,Austria,2010,1627,1373,254
IRN,Iran,AUT,Austria,2011,1349,1108,241
IRN,Iran,AUT,Austria,2012,2409,1007,1402
IRN,Iran,AUT,Austria,2013,2595,1679,916
IRN,Iran,AUT,Austria,2014,2612,1982,630
IRN,Iran,AUT,Austria,2015,4673,1399,3274
IRN,Iran,AUT,Austria,2016,4678,2396,2282
IRN,Iran,AUT,Austria,2017,1806,1726,80
IRN,Iran,BEL,Belgium,2008,242,0,242
IRN,Iran,BEL,Belgium,2009,277,0,277
IRN,Iran,BEL,Belgium,2010,350,119,231
IRN,Iran,BEL,Belgium,2011,374,173,201
IRN,Iran,BEL,Belgium,2012,644,238,406
IRN,Iran,BEL,Belgium,2013,460,272,188
IRN,Iran,BEL,Belgium,2014,338,283,55
IRN,Iran,BEL,Belgium,2015,644,210,434
IRN,Iran,BEL,Belgium,2016,437,123,314
IRN,Iran,BEL,Belgium,2017,447,152,295
IRN,Iran,CAN,Canada,2008,6474,0,6474
IRN,Iran,CAN,Canada,2009,6580,0,6580
IRN,Iran,CAN,Canada,2010,7477,0,7477
IRN,Iran,CAN,Canada,2011,7479,0,7479
IRN,Iran,CAN,Canada,2012,7525,0,7525
IRN,Iran,CAN,Canada,2013,11288,0,11288
IRN,Iran,CAN,Canada,2014,16772,0,16772
IRN,Iran,CAN,Canada,2015,11668,0,11668
IRN,Iran,CAN,Canada,2016,6485,0,6485
IRN,Iran,CAN,Canada,2017,4735,0,4735
IRN,Iran,CZE,Czech Republic,2008,54,0,54
IRN,Iran,CZE,Czech Republic,2009,64,0,64
IRN,Iran,CZE,Czech Republic,2010,79,0,79
IRN,Iran,CZE,Czech Republic,2011,27,0,27
IRN,Iran,CZE,Czech Republic,2012,35,11,24
IRN,Iran,CZE,Czech Republic,2013,58,37,21
IRN,Iran,CZE,Czech Republic,2014,63,20,43
IRN,Iran,CZE,Czech Republic,2015,66,29,37
IRN,Iran,CZE,Czech Republic,2016,73,29,44
IRN,Iran,CZE,Czech Republic,2017,127,31,96
IRN,Iran,DNK,Denmark,2008,210,70,140
IRN,Iran,DNK,Denmark,2009,296,48,248
IRN,Iran,DNK,Denmark,2010,461,85,376
IRN,Iran,DNK,Denmark,2011,567,108,459
IRN,Iran,DNK,Denmark,2012,592,107,485
IRN,Iran,DNK,Denmark,2013,931,134,797
IRN,Iran,DNK,Denmark,2014,939,221,718
IRN,Iran,DNK,Denmark,2015,0,304,-304
IRN,Iran,DNK,Denmark,2016,819,404,415
IRN,Iran,DNK,Denmark,2017,1273,381,892
IRN,Iran,FIN,Finland,2008,231,35,196
IRN,Iran,FIN,Finland,2009,150,15,135
IRN,Iran,FIN,Finland,2010,209,4,205
IRN,Iran,FIN,Finland,2011,268,20,248
IRN,Iran,FIN,Finland,2012,333,35,298
IRN,Iran,FIN,Finland,2013,403,37,366
IRN,Iran,FIN,Finland,2014,414,41,373
IRN,Iran,FIN,Finland,2015,265,27,238
IRN,Iran,FIN,Finland,2016,440,46,394
IRN,Iran,FIN,Finland,2017,337,45,292
IRN,Iran,FRA,France,2008,405,0,405
IRN,Iran,FRA,France,2009,478,0,478
IRN,Iran,FRA,France,2010,599,0,599
IRN,Iran,FRA,France,2011,542,0,542
IRN,Iran,FRA,France,2012,567,0,567
IRN,Iran,FRA,France,2013,576,0,576
IRN,Iran,FRA,France,2014,495,0,495
IRN,Iran,FRA,France,2015,441,0,441
IRN,Iran,FRA,France,2016,566,0,566
IRN,Iran,FRA,France,2017,761,0,761
IRN,Iran,DEU,Germany,2008,3257,3189,68
IRN,Iran,DEU,Germany,2009,3951,3510,441
IRN,Iran,DEU,Germany,2010,5695,2861,2834
IRN,Iran,DEU,Germany,2011,7175,2370,4805
IRN,Iran,DEU,Germany,2012,8215,2579,5636
IRN,Iran,DEU,Germany,2013,8250,2759,5491
IRN,Iran,DEU,Germany,2014,7122,2628,4494
IRN,Iran,DEU,Germany,2015,17187,3115,14072
IRN,Iran,DEU,Germany,2016,23009,7269,15740
IRN,Iran,DEU,Germany,2017,13676,4857,8819
IRN,Iran,HUN,Hungary,2008,476,59,417
IRN,Iran,HUN,Hungary,2009,454,68,386
IRN,Iran,HUN,Hungary,2010,403,134,269
IRN,Iran,HUN,Hungary,2011,433,96,337
IRN,Iran,HUN,Hungary,2012,351,74,277
IRN,Iran,HUN,Hungary,2013,279,113,166
IRN,Iran,HUN,Hungary,2014,349,145,204
IRN,Iran,HUN,Hungary,2015,492,115,377
IRN,Iran,HUN,Hungary,2016,623,121,502
IRN,Iran,HUN,Hungary,2017,1009,0,1009
IRN,Iran,ISL,Iceland,2008,5,6,-1
IRN,Iran,ISL,Iceland,2009,3,6,-3
IRN,Iran,ISL,Iceland,2010,6,0,6
IRN,Iran,ISL,Iceland,2011,10,2,8
IRN,Iran,ISL,Iceland,2012,11,1,10
IRN,Iran,ISL,Iceland,2013,7,8,-1
IRN,Iran,ISL,Iceland,2014,10,7,3
IRN,Iran,ISL,Iceland,2015,16,7,9
IRN,Iran,ISL,Iceland,2016,33,7,26
IRN,Iran,ISL,Iceland,2017,10,4,6
IRN,Iran,ITA,Italy,2008,483,12,471
IRN,Iran,ITA,Italy,2009,611,14,597
IRN,Iran,ITA,Italy,2010,744,12,732
IRN,Iran,ITA,Italy,2011,940,31,909
IRN,Iran,ITA,Italy,2012,1378,40,1338
IRN,Iran,ITA,Italy,2013,1397,29,1368
IRN,Iran,ITA,Italy,2014,1205,58,1147
IRN,Iran,ITA,Italy,2015,1190,61,1129
IRN,Iran,ITA,Italy,2016,1045,0,1045
IRN,Iran,ITA,Italy,2017,1304,62,1242
IRN,Iran,JPN,Japan,2008,450,286,164
IRN,Iran,JPN,Japan,2009,450,293,157
IRN,Iran,JPN,Japan,2010,449,334,115
IRN,Iran,JPN,Japan,2011,360,241,119
IRN,Iran,JPN,Japan,2012,384,268,116
IRN,Iran,JPN,Japan,2013,273,199,74
IRN,Iran,JPN,Japan,2014,334,209,125
IRN,Iran,JPN,Japan,2015,448,298,150
IRN,Iran,JPN,Japan,2016,475,306,169
IRN,Iran,JPN,Japan,2017,439,303,136
IRN,Iran,KOR,Korea,2008,242,335,-93
IRN,Iran,KOR,Korea,2009,152,306,-154
IRN,Iran,KOR,Korea,2010,217,182,35
IRN,Iran,KOR,Korea,2011,229,192,37
IRN,Iran,KOR,Korea,2012,211,257,-46
IRN,Iran,KOR,Korea,2013,250,162,88
IRN,Iran,KOR,Korea,2014,243,179,64
IRN,Iran,KOR,Korea,2015,253,215,38
IRN,Iran,KOR,Korea,2016,293,206,87
IRN,Iran,KOR,Korea,2017,410,249,161
IRN,Iran,LUX,Luxembourg,2008,30,8,22
IRN,Iran,LUX,Luxembourg,2009,28,9,19
IRN,Iran,LUX,Luxembourg,2010,50,8,42
IRN,Iran,LUX,Luxembourg,2011,32,19,13
IRN,Iran,LUX,Luxembourg,2012,48,15,33
IRN,Iran,LUX,Luxembourg,2013,28,12,16
IRN,Iran,LUX,Luxembourg,2014,22,15,7
IRN,Iran,LUX,Luxembourg,2015,79,10,69
IRN,Iran,LUX,Luxembourg,2016,55,19,36
IRN,Iran,LUX,Luxembourg,2017,59,21,38
IRN,Iran,MEX,Mexico,2008,12,0,12
IRN,Iran,MEX,Mexico,2009,10,0,10
IRN,Iran,MEX,Mexico,2010,12,0,12
IRN,Iran,MEX,Mexico,2011,28,0,28
IRN,Iran,MEX,Mexico,2012,15,0,15
IRN,Iran,MEX,Mexico,2013,26,0,26
IRN,Iran,MEX,Mexico,2014,20,0,20
IRN,Iran,MEX,Mexico,2015,30,0,30
IRN,Iran,MEX,Mexico,2016,16,0,16
IRN,Iran,MEX,Mexico,2017,23,0,23
IRN,Iran,NLD,Netherlands,2008,584,159,425
IRN,Iran,NLD,Netherlands,2009,636,216,420
IRN,Iran,NLD,Netherlands,2010,689,312,377
IRN,Iran,NLD,Netherlands,2011,883,290,593
IRN,Iran,NLD,Netherlands,2012,624,237,387
IRN,Iran,NLD,Netherlands,2013,695,324,371
IRN,Iran,NLD,Netherlands,2014,853,260,593
IRN,Iran,NLD,Netherlands,2015,910,308,602
IRN,Iran,NLD,Netherlands,2016,1851,343,1508
IRN,Iran,NLD,Netherlands,2017,1481,417,1064
IRN,Iran,NZL,New Zealand,2008,116,15,101
IRN,Iran,NZL,New Zealand,2009,137,16,121
IRN,Iran,NZL,New Zealand,2010,179,18,161
IRN,Iran,NZL,New Zealand,2011,192,15,177
IRN,Iran,NZL,New Zealand,2012,238,43,195
IRN,Iran,NZL,New Zealand,2013,254,41,213
IRN,Iran,NZL,New Zealand,2014,355,37,318
IRN,Iran,NZL,New Zealand,2015,296,38,258
IRN,Iran,NZL,New Zealand,2016,305,30,275
IRN,Iran,NZL,New Zealand,2017,309,42,267
IRN,Iran,NOR,Norway,2008,422,88,334
IRN,Iran,NOR,Norway,2009,522,69,453
IRN,Iran,NOR,Norway,2010,548,96,452
IRN,Iran,NOR,Norway,2011,812,118,694
IRN,Iran,NOR,Norway,2012,755,127,628
IRN,Iran,NOR,Norway,2013,753,111,642
IRN,Iran,NOR,Norway,2014,441,155,286
IRN,Iran,NOR,Norway,2015,399,143,256
IRN,Iran,NOR,Norway,2016,722,124,598
IRN,Iran,NOR,Norway,2017,726,94,632
IRN,Iran,POL,Poland,2008,68,0,68
IRN,Iran,POL,Poland,2009,73,0,73
IRN,Iran,POL,Poland,2010,111,0,111
IRN,Iran,POL,Poland,2011,126,0,126
IRN,Iran,POL,Poland,2012,132,0,132
IRN,Iran,POL,Poland,2013,174,0,174
IRN,Iran,POL,Poland,2014,89,0,89
IRN,Iran,POL,Poland,2015,181,0,181
IRN,Iran,POL,Poland,2016,197,0,197
IRN,Iran,POL,Poland,2017,233,0,233
IRN,Iran,SVK,Slovak Republic,2008,2,5,-3
IRN,Iran,SVK,Slovak Republic,2009,3,4,-1
IRN,Iran,SVK,Slovak Republic,2010,7,15,-8
IRN,Iran,SVK,Slovak Republic,2011,1,10,-9
IRN,Iran,SVK,Slovak Republic,2012,4,0,4
IRN,Iran,SVK,Slovak Republic,2013,3,0,3
IRN,Iran,SVK,Slovak Republic,2014,3,0,3
IRN,Iran,SVK,Slovak Republic,2015,7,0,7
IRN,Iran,SVK,Slovak Republic,2016,4,0,4
IRN,Iran,SVK,Slovak Republic,2017,3,0,3
IRN,Iran,ESP,Spain,2008,280,159,121
IRN,Iran,ESP,Spain,2009,291,151,140
IRN,Iran,ESP,Spain,2010,363,178,185
IRN,Iran,ESP,Spain,2011,490,233,257
IRN,Iran,ESP,Spain,2012,616,199,417
IRN,Iran,ESP,Spain,2013,456,358,98
IRN,Iran,ESP,Spain,2014,485,282,203
IRN,Iran,ESP,Spain,2015,549,190,359
IRN,Iran,ESP,Spain,2016,737,250,487
IRN,Iran,ESP,Spain,2017,1478,352,1126
IRN,Iran,SWE,Sweden,2008,1766,287,1479
IRN,Iran,SWE,Sweden,2009,2416,131,2285
IRN,Iran,SWE,Sweden,2010,2820,256,2564
IRN,Iran,SWE,Sweden,2011,2168,375,1793
IRN,Iran,SWE,Sweden,2012,2111,515,1596
IRN,Iran,SWE,Sweden,2013,1988,447,1541
IRN,Iran,SWE,Sweden,2014,1744,657,1087
IRN,Iran,SWE,Sweden,2015,1334,827,507
IRN,Iran,SWE,Sweden,2016,1702,279,1423
IRN,Iran,SWE,Sweden,2017,2348,271,2077
IRN,Iran,CHE,Switzerland,2010,522,140,382
IRN,Iran,CHE,Switzerland,2011,524,161,363
IRN,Iran,CHE,Switzerland,2012,467,125,342
IRN,Iran,CHE,Switzerland,2013,437,157,280
IRN,Iran,CHE,Switzerland,2014,386,155,231
IRN,Iran,CHE,Switzerland,2015,440,164,276
IRN,Iran,CHE,Switzerland,2016,439,172,267
IRN,Iran,CHE,Switzerland,2017,485,178,307
IRN,Iran,TUR,Turkey,2010,1539,0,1539
IRN,Iran,TUR,Turkey,2016,15539,5695,9844
IRN,Iran,TUR,Turkey,2017,17794,5065,12729
IRN,Iran,GBR,United Kingdom,2009,4000,0,4000
IRN,Iran,GBR,United Kingdom,2011,2000,1000,1000
IRN,Iran,GBR,United Kingdom,2012,1000,0,1000
IRN,Iran,GBR,United Kingdom,2014,1000,0,1000
IRN,Iran,USA,United States,2008,13852,0,13852
IRN,Iran,USA,United States,2009,18553,0,18553
IRN,Iran,USA,United States,2010,14182,0,14182
IRN,Iran,USA,United States,2011,14822,0,14822
IRN,Iran,USA,United States,2012,12916,0,12916
IRN,Iran,USA,United States,2013,12863,0,12863
IRN,Iran,USA,United States,2014,11615,0,11615
IRN,Iran,USA,United States,2015,13114,0,13114
IRN,Iran,USA,United States,2016,13298,0,13298
IRN,Iran,USA,United States,2017,13791,0,13791
IRN,Iran,CHL,Chile,2008,6,0,6
IRN,Iran,CHL,Chile,2009,5,0,5
IRN,Iran,CHL,Chile,2010,2,0,2
IRN,Iran,CHL,Chile,2011,6,0,6
IRN,Iran,CHL,Chile,2012,7,0,7
IRN,Iran,CHL,Chile,2013,20,0,20
IRN,Iran,CHL,Chile,2014,21,0,21
IRN,Iran,CHL,Chile,2015,29,0,29
IRN,Iran,CHL,Chile,2016,20,0,20
IRN,Iran,EST,Estonia,2008,3,0,3
IRN,Iran,EST,Estonia,2009,2,0,2
IRN,Iran,EST,Estonia,2010,2,0,2
IRN,Iran,EST,Estonia,2011,5,0,5
IRN,Iran,EST,Estonia,2012,5,0,5
IRN,Iran,EST,Estonia,2013,10,0,10
IRN,Iran,EST,Estonia,2014,5,0,5
IRN,Iran,EST,Estonia,2015,22,0,22
IRN,Iran,EST,Estonia,2016,25,0,25
IRN,Iran,EST,Estonia,2017,33,0,33
IRN,Iran,ISR,Israel,2008,48,0,48
IRN,Iran,ISR,Israel,2009,45,0,45
IRN,Iran,ISR,Israel,2010,39,0,39
IRN,Iran,ISR,Israel,2011,46,0,46
IRN,Iran,ISR,Israel,2012,37,0,37
IRN,Iran,ISR,Israel,2013,82,0,82
IRN,Iran,ISR,Israel,2014,27,0,27
IRN,Iran,ISR,Israel,2015,35,0,35
IRN,Iran,ISR,Israel,2016,34,0,34
IRN,Iran,ISR,Israel,2017,18,0,18
IRN,Iran,SVN,Slovenia,2008,4,0,4
IRN,Iran,SVN,Slovenia,2009,5,0,5
IRN,Iran,SVN,Slovenia,2010,4,0,4
IRN,Iran,SVN,Slovenia,2011,13,0,13
IRN,Iran,SVN,Slovenia,2012,14,1,13
IRN,Iran,SVN,Slovenia,2013,5,0,5
IRN,Iran,SVN,Slovenia,2014,7,2,5
IRN,Iran,SVN,Slovenia,2015,22,3,19
IRN,Iran,SVN,Slovenia,2016,9,0,9
IRN,Iran,SVN,Slovenia,2017,29,0,29
IRQ,Iraq,AUS,Australia,2008,2566,259,2307
IRQ,Iraq,AUS,Australia,2009,4054,344,3710
IRQ,Iraq,AUS,Australia,2010,2456,373,2083
IRQ,Iraq,AUS,Australia,2011,2928,344,2584
IRQ,Iraq,AUS,Australia,2012,1963,419,1544
IRQ,Iraq,AUS,Australia,2013,3170,429,2741
IRQ,Iraq,AUS,Australia,2014,3973,316,3657
IRQ,Iraq,AUS,Australia,2015,3058,200,2858
IRQ,Iraq,AUS,Australia,2016,3037,300,2737
IRQ,Iraq,AUS,Australia,2017,9709,0,9709
IRQ,Iraq,AUT,Austria,2008,433,111,322
IRQ,Iraq,AUT,Austria,2009,384,109,275
IRQ,Iraq,AUT,Austria,2010,330,136,194
IRQ,Iraq,AUT,Austria,2011,399,129,270
IRQ,Iraq,AUT,Austria,2012,461,171,290
IRQ,Iraq,AUT,Austria,2013,425,148,277
IRQ,Iraq,AUT,Austria,2014,812,129,683
IRQ,Iraq,AUT,Austria,2015,10376,374,10002
IRQ,Iraq,AUT,Austria,2016,2653,1933,720
IRQ,Iraq,AUT,Austria,2017,839,1198,-359
IRQ,Iraq,BEL,Belgium,2008,242,0,242
IRQ,Iraq,BEL,Belgium,2009,359,0,359
IRQ,Iraq,BEL,Belgium,2010,363,48,315
IRQ,Iraq,BEL,Belgium,2011,587,0,587
IRQ,Iraq,BEL,Belgium,2012,1106,575,531
IRQ,Iraq,BEL,Belgium,2013,596,575,21
IRQ,Iraq,BEL,Belgium,2014,1067,332,735
IRQ,Iraq,BEL,Belgium,2015,8129,310,7819
IRQ,Iraq,BEL,Belgium,2016,1364,280,1084
IRQ,Iraq,BEL,Belgium,2017,1690,682,1008
IRQ,Iraq,CAN,Canada,2008,3543,0,3543
IRQ,Iraq,CAN,Canada,2009,5450,0,5450
IRQ,Iraq,CAN,Canada,2010,5941,0,5941
IRQ,Iraq,CAN,Canada,2011,6196,0,6196
IRQ,Iraq,CAN,Canada,2012,4036,0,4036
IRQ,Iraq,CAN,Canada,2013,4912,0,4912
IRQ,Iraq,CAN,Canada,2014,3894,0,3894
IRQ,Iraq,CAN,Canada,2015,3980,0,3980
IRQ,Iraq,CAN,Canada,2016,2410,0,2410
IRQ,Iraq,CAN,Canada,2017,4740,0,4740
IRQ,Iraq,CZE,Czech Republic,2008,79,2,77
IRQ,Iraq,CZE,Czech Republic,2009,27,0,27
IRQ,Iraq,CZE,Czech Republic,2010,33,1,32
IRQ,Iraq,CZE,Czech Republic,2011,18,1,17
IRQ,Iraq,CZE,Czech Republic,2012,33,12,21
IRQ,Iraq,CZE,Czech Republic,2013,28,29,-1
IRQ,Iraq,CZE,Czech Republic,2014,43,22,21
IRQ,Iraq,CZE,Czech Republic,2015,62,30,32
IRQ,Iraq,CZE,Czech Republic,2016,115,62,53
IRQ,Iraq,CZE,Czech Republic,2017,55,30,25
IRQ,Iraq,DNK,Denmark,2008,394,214,180
IRQ,Iraq,DNK,Denmark,2009,336,151,185
IRQ,Iraq,DNK,Denmark,2010,245,154,91
IRQ,Iraq,DNK,Denmark,2011,156,165,-9
IRQ,Iraq,DNK,Denmark,2012,124,122,2
IRQ,Iraq,DNK,Denmark,2013,147,121,26
IRQ,Iraq,DNK,Denmark,2014,182,64,118
IRQ,Iraq,DNK,Denmark,2015,129,54,75
IRQ,Iraq,DNK,Denmark,2016,222,82,140
IRQ,Iraq,DNK,Denmark,2017,268,67,201
IRQ,Iraq,FIN,Finland,2008,520,16,504
IRQ,Iraq,FIN,Finland,2009,907,33,874
IRQ,Iraq,FIN,Finland,2010,1057,28,1029
IRQ,Iraq,FIN,Finland,2011,719,17,702
IRQ,Iraq,FIN,Finland,2012,584,50,534
IRQ,Iraq,FIN,Finland,2013,910,30,880
IRQ,Iraq,FIN,Finland,2014,776,37,739
IRQ,Iraq,FIN,Finland,2015,754,31,723
IRQ,Iraq,FIN,Finland,2016,3235,58,3177
IRQ,Iraq,FIN,Finland,2017,2570,65,2505
IRQ,Iraq,FRA,France,2008,324,0,324
IRQ,Iraq,FRA,France,2009,619,0,619
IRQ,Iraq,FRA,France,2010,362,0,362
IRQ,Iraq,FRA,France,2011,303,0,303
IRQ,Iraq,FRA,France,2012,283,0,283
IRQ,Iraq,FRA,France,2013,245,0,245
IRQ,Iraq,FRA,France,2014,405,0,405
IRQ,Iraq,FRA,France,2015,1696,0,1696
IRQ,Iraq,FRA,France,2016,1342,0,1342
IRQ,Iraq,FRA,France,2017,1529,0,1529
IRQ,Iraq,DEU,Germany,2008,8923,3945,4978
IRQ,Iraq,DEU,Germany,2009,13062,3705,9357
IRQ,Iraq,DEU,Germany,2010,9496,3243,6253
IRQ,Iraq,DEU,Germany,2011,7453,2961,4492
IRQ,Iraq,DEU,Germany,2012,6654,3251,3403
IRQ,Iraq,DEU,Germany,2013,5218,3002,2216
IRQ,Iraq,DEU,Germany,2014,7140,2702,4438
IRQ,Iraq,DEU,Germany,2015,64825,5120,59705
IRQ,Iraq,DEU,Germany,2016,67978,20255,47723
IRQ,Iraq,DEU,Germany,2017,27574,11328,16246
IRQ,Iraq,HUN,Hungary,2008,8,1,7
IRQ,Iraq,HUN,Hungary,2009,17,0,17
IRQ,Iraq,HUN,Hungary,2010,17,2,15
IRQ,Iraq,HUN,Hungary,2011,20,7,13
IRQ,Iraq,HUN,Hungary,2012,24,3,21
IRQ,Iraq,HUN,Hungary,2013,18,3,15
IRQ,Iraq,HUN,Hungary,2014,84,3,81
IRQ,Iraq,HUN,Hungary,2015,185,7,178
IRQ,Iraq,HUN,Hungary,2016,163,10,153
IRQ,Iraq,HUN,Hungary,2017,299,0,299
IRQ,Iraq,ISL,Iceland,2008,3,0,3
IRQ,Iraq,ISL,Iceland,2009,1,3,-2
IRQ,Iraq,ISL,Iceland,2010,1,0,1
IRQ,Iraq,ISL,Iceland,2011,2,0,2
IRQ,Iraq,ISL,Iceland,2012,5,0,5
IRQ,Iraq,ISL,Iceland,2013,2,1,1
IRQ,Iraq,ISL,Iceland,2014,0,0,0
IRQ,Iraq,ISL,Iceland,2015,3,2,1
IRQ,Iraq,ISL,Iceland,2016,31,1,30
IRQ,Iraq,ISL,Iceland,2017,52,1,51
IRQ,Iraq,ITA,Italy,2008,389,6,383
IRQ,Iraq,ITA,Italy,2009,422,6,416
IRQ,Iraq,ITA,Italy,2010,414,26,388
IRQ,Iraq,ITA,Italy,2011,283,4,279
IRQ,Iraq,ITA,Italy,2012,297,20,277
IRQ,Iraq,ITA,Italy,2013,420,5,415
IRQ,Iraq,ITA,Italy,2014,397,22,375
IRQ,Iraq,ITA,Italy,2015,444,47,397
IRQ,Iraq,ITA,Italy,2016,768,0,768
IRQ,Iraq,ITA,Italy,2017,1265,44,1221
IRQ,Iraq,JPN,Japan,2008,437,433,4
IRQ,Iraq,JPN,Japan,2009,234,233,1
IRQ,Iraq,JPN,Japan,2010,349,335,14
IRQ,Iraq,JPN,Japan,2011,321,303,18
IRQ,Iraq,JPN,Japan,2012,369,365,4
IRQ,Iraq,JPN,Japan,2013,391,377,14
IRQ,Iraq,JPN,Japan,2014,174,152,22
IRQ,Iraq,JPN,Japan,2015,244,239,5
IRQ,Iraq,JPN,Japan,2016,229,207,22
IRQ,Iraq,JPN,Japan,2017,278,264,14
IRQ,Iraq,KOR,Korea,2008,95,86,9
IRQ,Iraq,KOR,Korea,2009,74,82,-8
IRQ,Iraq,KOR,Korea,2010,67,67,0
IRQ,Iraq,KOR,Korea,2011,68,70,-2
IRQ,Iraq,KOR,Korea,2012,65,83,-18
IRQ,Iraq,KOR,Korea,2013,92,78,14
IRQ,Iraq,KOR,Korea,2014,120,90,30
IRQ,Iraq,KOR,Korea,2015,124,112,12
IRQ,Iraq,KOR,Korea,2016,90,97,-7
IRQ,Iraq,KOR,Korea,2017,122,129,-7
IRQ,Iraq,LUX,Luxembourg,2008,26,4,22
IRQ,Iraq,LUX,Luxembourg,2009,43,7,36
IRQ,Iraq,LUX,Luxembourg,2010,93,5,88
IRQ,Iraq,LUX,Luxembourg,2011,35,21,14
IRQ,Iraq,LUX,Luxembourg,2012,26,9,17
IRQ,Iraq,LUX,Luxembourg,2013,36,15,21
IRQ,Iraq,LUX,Luxembourg,2014,14,4,10
IRQ,Iraq,LUX,Luxembourg,2015,508,5,503
IRQ,Iraq,LUX,Luxembourg,2016,149,87,62
IRQ,Iraq,LUX,Luxembourg,2017,95,32,63
IRQ,Iraq,MEX,Mexico,2008,3,0,3
IRQ,Iraq,MEX,Mexico,2009,2,0,2
IRQ,Iraq,MEX,Mexico,2010,3,0,3
IRQ,Iraq,MEX,Mexico,2011,6,0,6
IRQ,Iraq,MEX,Mexico,2012,2,0,2
IRQ,Iraq,MEX,Mexico,2013,7,0,7
IRQ,Iraq,MEX,Mexico,2014,1,0,1
IRQ,Iraq,MEX,Mexico,2015,1,0,1
IRQ,Iraq,MEX,Mexico,2016,10,0,10
IRQ,Iraq,MEX,Mexico,2017,6,0,6
IRQ,Iraq,NLD,Netherlands,2008,772,49,723
IRQ,Iraq,NLD,Netherlands,2009,977,101,876
IRQ,Iraq,NLD,Netherlands,2010,923,149,774
IRQ,Iraq,NLD,Netherlands,2011,702,230,472
IRQ,Iraq,NLD,Netherlands,2012,679,238,441
IRQ,Iraq,NLD,Netherlands,2013,829,131,698
IRQ,Iraq,NLD,Netherlands,2014,658,86,572
IRQ,Iraq,NLD,Netherlands,2015,598,78,520
IRQ,Iraq,NLD,Netherlands,2016,2287,89,2198
IRQ,Iraq,NLD,Netherlands,2017,1169,253,916
IRQ,Iraq,NZL,New Zealand,2008,301,3,298
IRQ,Iraq,NZL,New Zealand,2009,145,5,140
IRQ,Iraq,NZL,New Zealand,2010,69,12,57
IRQ,Iraq,NZL,New Zealand,2011,68,8,60
IRQ,Iraq,NZL,New Zealand,2012,267,3,264
IRQ,Iraq,NZL,New Zealand,2013,184,6,178
IRQ,Iraq,NZL,New Zealand,2014,110,7,103
IRQ,Iraq,NZL,New Zealand,2015,110,5,105
IRQ,Iraq,NZL,New Zealand,2016,129,1,128
IRQ,Iraq,NZL,New Zealand,2017,97,3,94
IRQ,Iraq,NOR,Norway,2008,1197,126,1071
IRQ,Iraq,NOR,Norway,2009,1191,208,983
IRQ,Iraq,NOR,Norway,2010,875,141,734
IRQ,Iraq,NOR,Norway,2011,638,175,463
IRQ,Iraq,NOR,Norway,2012,387,163,224
IRQ,Iraq,NOR,Norway,2013,279,170,109
IRQ,Iraq,NOR,Norway,2014,207,118,89
IRQ,Iraq,NOR,Norway,2015,246,95,151
IRQ,Iraq,NOR,Norway,2016,396,89,307
IRQ,Iraq,NOR,Norway,2017,741,67,674
IRQ,Iraq,POL,Poland,2008,147,0,147
IRQ,Iraq,POL,Poland,2009,159,0,159
IRQ,Iraq,POL,Poland,2010,182,0,182
IRQ,Iraq,POL,Poland,2011,218,0,218
IRQ,Iraq,POL,Poland,2012,207,0,207
IRQ,Iraq,POL,Poland,2013,212,0,212
IRQ,Iraq,POL,Poland,2014,139,0,139
IRQ,Iraq,POL,Poland,2015,487,0,487
IRQ,Iraq,POL,Poland,2016,471,0,471
IRQ,Iraq,POL,Poland,2017,732,0,732
IRQ,Iraq,SVK,Slovak Republic,2008,1,20,-19
IRQ,Iraq,SVK,Slovak Republic,2009,3,18,-15
IRQ,Iraq,SVK,Slovak Republic,2010,3,12,-9
IRQ,Iraq,SVK,Slovak Republic,2011,3,5,-2
IRQ,Iraq,SVK,Slovak Republic,2012,1,0,1
IRQ,Iraq,SVK,Slovak Republic,2013,2,0,2
IRQ,Iraq,SVK,Slovak Republic,2015,3,0,3
IRQ,Iraq,SVK,Slovak Republic,2016,150,35,115
IRQ,Iraq,ESP,Spain,2008,139,89,50
IRQ,Iraq,ESP,Spain,2009,72,89,-17
IRQ,Iraq,ESP,Spain,2010,71,80,-9
IRQ,Iraq,ESP,Spain,2011,90,73,17
IRQ,Iraq,ESP,Spain,2012,129,71,58
IRQ,Iraq,ESP,Spain,2013,135,67,68
IRQ,Iraq,ESP,Spain,2014,182,51,131
IRQ,Iraq,ESP,Spain,2015,240,71,169
IRQ,Iraq,ESP,Spain,2016,280,76,204
IRQ,Iraq,ESP,Spain,2017,338,120,218
IRQ,Iraq,SWE,Sweden,2008,12103,341,11762
IRQ,Iraq,SWE,Sweden,2009,8539,252,8287
IRQ,Iraq,SWE,Sweden,2010,4534,400,4134
IRQ,Iraq,SWE,Sweden,2011,4469,462,4007
IRQ,Iraq,SWE,Sweden,2012,3579,651,2928
IRQ,Iraq,SWE,Sweden,2013,2302,589,1713
IRQ,Iraq,SWE,Sweden,2014,2405,652,1753
IRQ,Iraq,SWE,Sweden,2015,2806,844,1962
IRQ,Iraq,SWE,Sweden,2016,3399,431,2968
IRQ,Iraq,SWE,Sweden,2017,6049,401,5648
IRQ,Iraq,CHE,Switzerland,2010,482,37,445
IRQ,Iraq,CHE,Switzerland,2011,372,68,304
IRQ,Iraq,CHE,Switzerland,2012,387,76,311
IRQ,Iraq,CHE,Switzerland,2013,470,83,387
IRQ,Iraq,CHE,Switzerland,2014,445,63,382
IRQ,Iraq,CHE,Switzerland,2015,341,53,288
IRQ,Iraq,CHE,Switzerland,2016,395,50,345
IRQ,Iraq,CHE,Switzerland,2017,530,42,488
IRQ,Iraq,TUR,Turkey,2010,1165,0,1165
IRQ,Iraq,TUR,Turkey,2016,70865,16094,54771
IRQ,Iraq,TUR,Turkey,2017,97054,28645,68409
IRQ,Iraq,GBR,United Kingdom,2011,2000,0,2000
IRQ,Iraq,GBR,United Kingdom,2012,3000,0,3000
IRQ,Iraq,GBR,United Kingdom,2013,3000,0,3000
IRQ,Iraq,GBR,United Kingdom,2014,1000,0,1000
IRQ,Iraq,GBR,United Kingdom,2015,1000,0,1000
IRQ,Iraq,USA,United States,2008,4795,0,4795
IRQ,Iraq,USA,United States,2009,12110,0,12110
IRQ,Iraq,USA,United States,2010,19855,0,19855
IRQ,Iraq,USA,United States,2011,21133,0,21133
IRQ,Iraq,USA,United States,2012,20369,0,20369
IRQ,Iraq,USA,United States,2013,9552,0,9552
IRQ,Iraq,USA,United States,2014,19153,0,19153
IRQ,Iraq,USA,United States,2015,21107,0,21107
IRQ,Iraq,USA,United States,2016,18904,0,18904
IRQ,Iraq,USA,United States,2017,14203,0,14203
IRQ,Iraq,CHL,Chile,2008,0,0,0
IRQ,Iraq,CHL,Chile,2009,0,0,0
IRQ,Iraq,CHL,Chile,2010,2,0,2
IRQ,Iraq,CHL,Chile,2011,2,0,2
IRQ,Iraq,CHL,Chile,2012,1,0,1
IRQ,Iraq,CHL,Chile,2013,2,0,2
IRQ,Iraq,CHL,Chile,2014,0,0,0
IRQ,Iraq,CHL,Chile,2015,3,0,3
IRQ,Iraq,CHL,Chile,2016,3,0,3
IRQ,Iraq,EST,Estonia,2008,1,0,1
IRQ,Iraq,EST,Estonia,2009,2,0,2
IRQ,Iraq,EST,Estonia,2010,0,0,0
IRQ,Iraq,EST,Estonia,2011,2,0,2
IRQ,Iraq,EST,Estonia,2012,0,0,0
IRQ,Iraq,EST,Estonia,2013,0,0,0
IRQ,Iraq,EST,Estonia,2014,0,0,0
IRQ,Iraq,EST,Estonia,2015,3,0,3
IRQ,Iraq,EST,Estonia,2016,29,0,29
IRQ,Iraq,EST,Estonia,2017,8,0,8
IRQ,Iraq,ISR,Israel,2008,4,0,4
IRQ,Iraq,ISR,Israel,2009,0,0,0
IRQ,Iraq,ISR,Israel,2010,5,0,5
IRQ,Iraq,ISR,Israel,2011,2,0,2
IRQ,Iraq,SVN,Slovenia,2008,1,0,1
IRQ,Iraq,SVN,Slovenia,2009,2,0,2
IRQ,Iraq,SVN,Slovenia,2010,1,0,1
IRQ,Iraq,SVN,Slovenia,2012,1,0,1
IRQ,Iraq,SVN,Slovenia,2013,6,0,6
IRQ,Iraq,SVN,Slovenia,2014,3,0,3
IRQ,Iraq,SVN,Slovenia,2015,2,0,2
IRQ,Iraq,SVN,Slovenia,2016,2,0,2
IRQ,Iraq,SVN,Slovenia,2017,9,0,9
IRL,Ireland,AUS,Australia,2008,2034,0,2034
IRL,Ireland,AUS,Australia,2009,2663,0,2663
IRL,Ireland,AUS,Australia,2010,3031,0,3031
IRL,Ireland,AUS,Australia,2011,3352,0,3352
IRL,Ireland,AUS,Australia,2012,5034,0,5034
IRL,Ireland,AUS,Australia,2013,5250,0,5250
IRL,Ireland,AUS,Australia,2014,6263,0,6263
IRL,Ireland,AUS,Australia,2015,6258,0,6258
IRL,Ireland,AUS,Australia,2016,4925,0,4925
IRL,Ireland,AUS,Australia,2017,3920,0,3920
IRL,Ireland,AUT,Austria,2008,134,0,134
IRL,Ireland,AUT,Austria,2009,127,0,127
IRL,Ireland,AUT,Austria,2010,173,0,173
IRL,Ireland,AUT,Austria,2011,222,0,222
IRL,Ireland,AUT,Austria,2012,176,0,176
IRL,Ireland,AUT,Austria,2013,223,0,223
IRL,Ireland,AUT,Austria,2014,278,0,278
IRL,Ireland,AUT,Austria,2015,252,0,252
IRL,Ireland,AUT,Austria,2016,279,0,279
IRL,Ireland,AUT,Austria,2017,282,0,282
IRL,Ireland,BEL,Belgium,2008,365,0,365
IRL,Ireland,BEL,Belgium,2009,369,0,369
IRL,Ireland,BEL,Belgium,2010,426,0,426
IRL,Ireland,BEL,Belgium,2011,437,0,437
IRL,Ireland,BEL,Belgium,2012,426,0,426
IRL,Ireland,BEL,Belgium,2013,411,0,411
IRL,Ireland,BEL,Belgium,2014,356,0,356
IRL,Ireland,BEL,Belgium,2015,379,0,379
IRL,Ireland,BEL,Belgium,2016,351,0,351
IRL,Ireland,BEL,Belgium,2017,346,0,346
IRL,Ireland,CAN,Canada,2008,412,0,412
IRL,Ireland,CAN,Canada,2009,395,0,395
IRL,Ireland,CAN,Canada,2010,548,0,548
IRL,Ireland,CAN,Canada,2011,524,0,524
IRL,Ireland,CAN,Canada,2012,725,0,725
IRL,Ireland,CAN,Canada,2013,1015,0,1015
IRL,Ireland,CAN,Canada,2014,1977,0,1977
IRL,Ireland,CAN,Canada,2015,2081,0,2081
IRL,Ireland,CAN,Canada,2016,2220,0,2220
IRL,Ireland,CAN,Canada,2017,1965,0,1965
IRL,Ireland,CZE,Czech Republic,2008,115,0,115
IRL,Ireland,CZE,Czech Republic,2009,49,0,49
IRL,Ireland,CZE,Czech Republic,2010,30,0,30
IRL,Ireland,CZE,Czech Republic,2011,25,0,25
IRL,Ireland,CZE,Czech Republic,2012,25,0,25
IRL,Ireland,CZE,Czech Republic,2013,45,0,45
IRL,Ireland,CZE,Czech Republic,2014,42,0,42
IRL,Ireland,CZE,Czech Republic,2015,30,0,30
IRL,Ireland,CZE,Czech Republic,2016,30,0,30
IRL,Ireland,CZE,Czech Republic,2017,51,0,51
IRL,Ireland,DNK,Denmark,2008,91,0,91
IRL,Ireland,DNK,Denmark,2009,89,0,89
IRL,Ireland,DNK,Denmark,2010,105,0,105
IRL,Ireland,DNK,Denmark,2011,122,0,122
IRL,Ireland,DNK,Denmark,2012,114,0,114
IRL,Ireland,DNK,Denmark,2013,141,0,141
IRL,Ireland,DNK,Denmark,2014,166,0,166
IRL,Ireland,DNK,Denmark,2015,223,0,223
IRL,Ireland,DNK,Denmark,2016,211,0,211
IRL,Ireland,DNK,Denmark,2017,331,0,331
IRL,Ireland,FIN,Finland,2008,56,0,56
IRL,Ireland,FIN,Finland,2009,38,0,38
IRL,Ireland,FIN,Finland,2010,31,0,31
IRL,Ireland,FIN,Finland,2011,49,0,49
IRL,Ireland,FIN,Finland,2012,45,0,45
IRL,Ireland,FIN,Finland,2013,46,0,46
IRL,Ireland,FIN,Finland,2014,41,0,41
IRL,Ireland,FIN,Finland,2015,60,0,60
IRL,Ireland,FIN,Finland,2016,45,0,45
IRL,Ireland,FIN,Finland,2017,44,0,44
IRL,Ireland,FRA,France,2008,0,0,0
IRL,Ireland,FRA,France,2009,0,0,0
IRL,Ireland,FRA,France,2010,0,0,0
IRL,Ireland,FRA,France,2011,0,0,0
IRL,Ireland,FRA,France,2012,0,0,0
IRL,Ireland,FRA,France,2013,708,0,708
IRL,Ireland,FRA,France,2014,866,0,866
IRL,Ireland,FRA,France,2015,805,0,805
IRL,Ireland,FRA,France,2016,962,0,962
IRL,Ireland,FRA,France,2017,723,0,723
IRL,Ireland,DEU,Germany,2008,1184,0,1184
IRL,Ireland,DEU,Germany,2009,1279,0,1279
IRL,Ireland,DEU,Germany,2010,1426,0,1426
IRL,Ireland,DEU,Germany,2011,1760,0,1760
IRL,Ireland,DEU,Germany,2012,1868,0,1868
IRL,Ireland,DEU,Germany,2013,1796,0,1796
IRL,Ireland,DEU,Germany,2014,2010,0,2010
IRL,Ireland,DEU,Germany,2015,1941,0,1941
IRL,Ireland,DEU,Germany,2016,2112,0,2112
IRL,Ireland,DEU,Germany,2017,2167,0,2167
IRL,Ireland,HUN,Hungary,2008,72,0,72
IRL,Ireland,HUN,Hungary,2009,77,0,77
IRL,Ireland,HUN,Hungary,2010,55,0,55
IRL,Ireland,HUN,Hungary,2011,59,0,59
IRL,Ireland,HUN,Hungary,2012,57,0,57
IRL,Ireland,HUN,Hungary,2013,71,0,71
IRL,Ireland,HUN,Hungary,2014,69,0,69
IRL,Ireland,HUN,Hungary,2015,78,0,78
IRL,Ireland,HUN,Hungary,2016,78,0,78
IRL,Ireland,HUN,Hungary,2017,91,0,91
IRL,Ireland,ISL,Iceland,2008,12,0,12
IRL,Ireland,ISL,Iceland,2009,15,0,15
IRL,Ireland,ISL,Iceland,2010,6,0,6
IRL,Ireland,ISL,Iceland,2011,8,0,8
IRL,Ireland,ISL,Iceland,2012,11,0,11
IRL,Ireland,ISL,Iceland,2013,11,0,11
IRL,Ireland,ISL,Iceland,2014,10,0,10
IRL,Ireland,ISL,Iceland,2015,18,0,18
IRL,Ireland,ISL,Iceland,2016,29,0,29
IRL,Ireland,ISL,Iceland,2017,23,0,23
IRL,Ireland,ITA,Italy,2008,286,0,286
IRL,Ireland,ITA,Italy,2009,227,0,227
IRL,Ireland,ITA,Italy,2010,194,0,194
IRL,Ireland,ITA,Italy,2011,211,0,211
IRL,Ireland,ITA,Italy,2012,177,0,177
IRL,Ireland,ITA,Italy,2013,148,0,148
IRL,Ireland,ITA,Italy,2014,143,0,143
IRL,Ireland,ITA,Italy,2015,117,0,117
IRL,Ireland,ITA,Italy,2016,186,0,186
IRL,Ireland,ITA,Italy,2017,182,0,182
IRL,Ireland,JPN,Japan,2008,354,0,354
IRL,Ireland,JPN,Japan,2009,368,0,368
IRL,Ireland,JPN,Japan,2010,345,0,345
IRL,Ireland,JPN,Japan,2011,341,0,341
IRL,Ireland,JPN,Japan,2012,374,0,374
IRL,Ireland,JPN,Japan,2013,445,0,445
IRL,Ireland,JPN,Japan,2014,351,0,351
IRL,Ireland,JPN,Japan,2015,413,0,413
IRL,Ireland,JPN,Japan,2016,383,0,383
IRL,Ireland,JPN,Japan,2017,437,0,437
IRL,Ireland,KOR,Korea,2008,218,0,218
IRL,Ireland,KOR,Korea,2009,317,0,317
IRL,Ireland,KOR,Korea,2010,373,0,373
IRL,Ireland,KOR,Korea,2011,402,0,402
IRL,Ireland,KOR,Korea,2012,336,0,336
IRL,Ireland,KOR,Korea,2013,277,0,277
IRL,Ireland,KOR,Korea,2014,199,0,199
IRL,Ireland,KOR,Korea,2015,204,0,204
IRL,Ireland,KOR,Korea,2016,176,0,176
IRL,Ireland,KOR,Korea,2017,161,0,161
IRL,Ireland,LUX,Luxembourg,2008,100,0,100
IRL,Ireland,LUX,Luxembourg,2009,84,0,84
IRL,Ireland,LUX,Luxembourg,2010,126,0,126
IRL,Ireland,LUX,Luxembourg,2011,164,0,164
IRL,Ireland,LUX,Luxembourg,2012,108,0,108
IRL,Ireland,LUX,Luxembourg,2013,95,0,95
IRL,Ireland,LUX,Luxembourg,2014,133,0,133
IRL,Ireland,LUX,Luxembourg,2015,160,0,160
IRL,Ireland,LUX,Luxembourg,2016,147,0,147
IRL,Ireland,LUX,Luxembourg,2017,186,0,186
IRL,Ireland,MEX,Mexico,2008,9,0,9
IRL,Ireland,MEX,Mexico,2009,15,0,15
IRL,Ireland,MEX,Mexico,2010,23,0,23
IRL,Ireland,MEX,Mexico,2011,28,0,28
IRL,Ireland,MEX,Mexico,2012,13,0,13
IRL,Ireland,MEX,Mexico,2013,50,0,50
IRL,Ireland,MEX,Mexico,2014,40,0,40
IRL,Ireland,MEX,Mexico,2015,17,0,17
IRL,Ireland,MEX,Mexico,2016,44,0,44
IRL,Ireland,MEX,Mexico,2017,22,0,22
IRL,Ireland,NLD,Netherlands,2008,477,0,477
IRL,Ireland,NLD,Netherlands,2009,636,0,636
IRL,Ireland,NLD,Netherlands,2010,684,0,684
IRL,Ireland,NLD,Netherlands,2011,779,0,779
IRL,Ireland,NLD,Netherlands,2012,647,0,647
IRL,Ireland,NLD,Netherlands,2013,719,0,719
IRL,Ireland,NLD,Netherlands,2014,849,0,849
IRL,Ireland,NLD,Netherlands,2015,880,0,880
IRL,Ireland,NLD,Netherlands,2016,1116,0,1116
IRL,Ireland,NLD,Netherlands,2017,1292,0,1292
IRL,Ireland,NZL,New Zealand,2008,1078,0,1078
IRL,Ireland,NZL,New Zealand,2009,1440,0,1440
IRL,Ireland,NZL,New Zealand,2010,1437,0,1437
IRL,Ireland,NZL,New Zealand,2011,2087,0,2087
IRL,Ireland,NZL,New Zealand,2012,1855,0,1855
IRL,Ireland,NZL,New Zealand,2013,2199,0,2199
IRL,Ireland,NZL,New Zealand,2014,1674,0,1674
IRL,Ireland,NZL,New Zealand,2015,1448,0,1448
IRL,Ireland,NZL,New Zealand,2016,1203,0,1203
IRL,Ireland,NZL,New Zealand,2017,1299,0,1299
IRL,Ireland,NOR,Norway,2008,88,0,88
IRL,Ireland,NOR,Norway,2009,108,0,108
IRL,Ireland,NOR,Norway,2010,145,0,145
IRL,Ireland,NOR,Norway,2011,152,0,152
IRL,Ireland,NOR,Norway,2012,156,0,156
IRL,Ireland,NOR,Norway,2013,120,0,120
IRL,Ireland,NOR,Norway,2014,98,0,98
IRL,Ireland,NOR,Norway,2015,121,0,121
IRL,Ireland,NOR,Norway,2016,73,0,73
IRL,Ireland,NOR,Norway,2017,74,0,74
IRL,Ireland,POL,Poland,2008,39,0,39
IRL,Ireland,POL,Poland,2009,87,0,87
IRL,Ireland,POL,Poland,2010,90,0,90
IRL,Ireland,POL,Poland,2011,97,0,97
IRL,Ireland,POL,Poland,2012,100,0,100
IRL,Ireland,POL,Poland,2013,81,0,81
IRL,Ireland,POL,Poland,2014,81,0,81
IRL,Ireland,POL,Poland,2015,104,0,104
IRL,Ireland,POL,Poland,2016,76,0,76
IRL,Ireland,POL,Poland,2017,96,0,96
IRL,Ireland,SVK,Slovak Republic,2008,19,0,19
IRL,Ireland,SVK,Slovak Republic,2009,26,0,26
IRL,Ireland,SVK,Slovak Republic,2010,23,0,23
IRL,Ireland,SVK,Slovak Republic,2011,25,0,25
IRL,Ireland,SVK,Slovak Republic,2012,10,0,10
IRL,Ireland,SVK,Slovak Republic,2013,10,0,10
IRL,Ireland,SVK,Slovak Republic,2014,7,0,7
IRL,Ireland,SVK,Slovak Republic,2015,18,0,18
IRL,Ireland,SVK,Slovak Republic,2016,10,0,10
IRL,Ireland,SVK,Slovak Republic,2017,14,0,14
IRL,Ireland,ESP,Spain,2008,1235,0,1235
IRL,Ireland,ESP,Spain,2009,1320,0,1320
IRL,Ireland,ESP,Spain,2010,1265,0,1265
IRL,Ireland,ESP,Spain,2011,1344,0,1344
IRL,Ireland,ESP,Spain,2012,1398,0,1398
IRL,Ireland,ESP,Spain,2013,1318,0,1318
IRL,Ireland,ESP,Spain,2014,1187,0,1187
IRL,Ireland,ESP,Spain,2015,1238,0,1238
IRL,Ireland,ESP,Spain,2016,1402,0,1402
IRL,Ireland,ESP,Spain,2017,1722,0,1722
IRL,Ireland,SWE,Sweden,2008,216,0,216
IRL,Ireland,SWE,Sweden,2009,244,0,244
IRL,Ireland,SWE,Sweden,2010,230,0,230
IRL,Ireland,SWE,Sweden,2011,210,0,210
IRL,Ireland,SWE,Sweden,2012,319,0,319
IRL,Ireland,SWE,Sweden,2013,253,0,253
IRL,Ireland,SWE,Sweden,2014,272,0,272
IRL,Ireland,SWE,Sweden,2015,253,0,253
IRL,Ireland,SWE,Sweden,2016,261,0,261
IRL,Ireland,SWE,Sweden,2017,266,0,266
IRL,Ireland,CHE,Switzerland,2008,451,0,451
IRL,Ireland,CHE,Switzerland,2009,431,0,431
IRL,Ireland,CHE,Switzerland,2010,521,0,521
IRL,Ireland,CHE,Switzerland,2011,565,0,565
IRL,Ireland,CHE,Switzerland,2012,475,0,475
IRL,Ireland,CHE,Switzerland,2013,519,0,519
IRL,Ireland,CHE,Switzerland,2014,544,0,544
IRL,Ireland,CHE,Switzerland,2015,480,0,480
IRL,Ireland,CHE,Switzerland,2016,447,0,447
IRL,Ireland,CHE,Switzerland,2017,435,0,435
IRL,Ireland,TUR,Turkey,2010,77,0,77
IRL,Ireland,GBR,United Kingdom,2009,11000,3900,7100
IRL,Ireland,GBR,United Kingdom,2010,14000,2500,11500
IRL,Ireland,GBR,United Kingdom,2011,10000,4100,5900
IRL,Ireland,GBR,United Kingdom,2012,4000,3900,100
IRL,Ireland,GBR,United Kingdom,2013,10000,4100,5900
IRL,Ireland,GBR,United Kingdom,2014,6000,4200,1800
IRL,Ireland,GBR,United Kingdom,2015,5000,5000,0
IRL,Ireland,GBR,United Kingdom,2016,11000,5900,5100
IRL,Ireland,GBR,United Kingdom,2017,10000,6100,3900
IRL,Ireland,USA,United States,2008,1465,0,1465
IRL,Ireland,USA,United States,2009,1637,0,1637
IRL,Ireland,USA,United States,2010,1507,0,1507
IRL,Ireland,USA,United States,2011,1371,0,1371
IRL,Ireland,USA,United States,2012,1514,0,1514
IRL,Ireland,USA,United States,2013,1626,0,1626
IRL,Ireland,USA,United States,2014,1605,0,1605
IRL,Ireland,USA,United States,2015,1607,0,1607
IRL,Ireland,USA,United States,2016,1759,0,1759
IRL,Ireland,USA,United States,2017,1485,0,1485
IRL,Ireland,CHL,Chile,2008,9,0,9
IRL,Ireland,CHL,Chile,2009,18,0,18
IRL,Ireland,CHL,Chile,2010,15,0,15
IRL,Ireland,CHL,Chile,2011,20,0,20
IRL,Ireland,CHL,Chile,2012,25,0,25
IRL,Ireland,CHL,Chile,2013,24,0,24
IRL,Ireland,CHL,Chile,2014,18,0,18
IRL,Ireland,CHL,Chile,2015,27,0,27
IRL,Ireland,CHL,Chile,2016,27,0,27
IRL,Ireland,EST,Estonia,2008,7,0,7
IRL,Ireland,EST,Estonia,2009,8,0,8
IRL,Ireland,EST,Estonia,2010,8,0,8
IRL,Ireland,EST,Estonia,2011,2,0,2
IRL,Ireland,EST,Estonia,2012,0,0,0
IRL,Ireland,EST,Estonia,2013,1,0,1
IRL,Ireland,EST,Estonia,2014,0,0,0
IRL,Ireland,EST,Estonia,2015,17,0,17
IRL,Ireland,EST,Estonia,2016,23,0,23
IRL,Ireland,EST,Estonia,2017,19,0,19
IRL,Ireland,SVN,Slovenia,2008,9,0,9
IRL,Ireland,SVN,Slovenia,2010,1,0,1
IRL,Ireland,SVN,Slovenia,2011,26,0,26
IRL,Ireland,SVN,Slovenia,2012,13,0,13
IRL,Ireland,SVN,Slovenia,2013,11,0,11
IRL,Ireland,SVN,Slovenia,2014,26,0,26
IRL,Ireland,SVN,Slovenia,2015,20,0,20
IRL,Ireland,SVN,Slovenia,2016,31,0,31
IRL,Ireland,SVN,Slovenia,2017,28,0,28
ISR,Israel,AUS,Australia,2008,502,109,393
ISR,Israel,AUS,Australia,2009,554,107,447
ISR,Israel,AUS,Australia,2010,526,133,393
ISR,Israel,AUS,Australia,2011,422,92,330
ISR,Israel,AUS,Australia,2012,352,96,256
ISR,Israel,AUS,Australia,2013,518,145,373
ISR,Israel,AUS,Australia,2014,420,124,296
ISR,Israel,AUS,Australia,2015,379,103,276
ISR,Israel,AUS,Australia,2016,365,108,257
ISR,Israel,AUS,Australia,2017,377,138,239
ISR,Israel,AUT,Austria,2008,182,17,165
ISR,Israel,AUT,Austria,2009,187,11,176
ISR,Israel,AUT,Austria,2010,195,18,177
ISR,Israel,AUT,Austria,2011,160,19,141
ISR,Israel,AUT,Austria,2012,182,18,164
ISR,Israel,AUT,Austria,2013,233,25,208
ISR,Israel,AUT,Austria,2014,222,17,205
ISR,Israel,AUT,Austria,2015,200,45,155
ISR,Israel,AUT,Austria,2016,200,46,154
ISR,Israel,AUT,Austria,2017,127,26,101
ISR,Israel,BEL,Belgium,2008,189,84,105
ISR,Israel,BEL,Belgium,2009,167,125,42
ISR,Israel,BEL,Belgium,2010,150,186,-36
ISR,Israel,BEL,Belgium,2011,160,175,-15
ISR,Israel,BEL,Belgium,2012,130,140,-10
ISR,Israel,BEL,Belgium,2013,124,222,-98
ISR,Israel,BEL,Belgium,2014,110,224,-114
ISR,Israel,BEL,Belgium,2015,110,242,-132
ISR,Israel,BEL,Belgium,2016,65,185,-120
ISR,Israel,BEL,Belgium,2017,98,117,-19
ISR,Israel,CAN,Canada,2008,2559,264,2295
ISR,Israel,CAN,Canada,2009,2316,283,2033
ISR,Israel,CAN,Canada,2010,2755,271,2484
ISR,Israel,CAN,Canada,2011,1967,212,1755
ISR,Israel,CAN,Canada,2012,2132,236,1896
ISR,Israel,CAN,Canada,2013,1945,228,1717
ISR,Israel,CAN,Canada,2014,1899,265,1634
ISR,Israel,CAN,Canada,2015,2132,338,1794
ISR,Israel,CAN,Canada,2016,2400,296,2104
ISR,Israel,CAN,Canada,2017,1865,280,1585
ISR,Israel,CZE,Czech Republic,2008,117,0,117
ISR,Israel,CZE,Czech Republic,2009,92,0,92
ISR,Israel,CZE,Czech Republic,2010,63,0,63
ISR,Israel,CZE,Czech Republic,2011,56,0,56
ISR,Israel,CZE,Czech Republic,2012,70,0,70
ISR,Israel,CZE,Czech Republic,2013,95,0,95
ISR,Israel,CZE,Czech Republic,2014,122,0,122
ISR,Israel,CZE,Czech Republic,2015,107,0,107
ISR,Israel,CZE,Czech Republic,2016,169,0,169
ISR,Israel,CZE,Czech Republic,2017,204,0,204
ISR,Israel,DNK,Denmark,2008,47,0,47
ISR,Israel,DNK,Denmark,2009,38,0,38
ISR,Israel,DNK,Denmark,2010,41,0,41
ISR,Israel,DNK,Denmark,2011,22,0,22
ISR,Israel,DNK,Denmark,2012,27,0,27
ISR,Israel,DNK,Denmark,2013,41,0,41
ISR,Israel,DNK,Denmark,2014,40,0,40
ISR,Israel,DNK,Denmark,2015,29,0,29
ISR,Israel,DNK,Denmark,2016,44,0,44
ISR,Israel,DNK,Denmark,2017,38,0,38
ISR,Israel,FIN,Finland,2008,40,0,40
ISR,Israel,FIN,Finland,2009,25,0,25
ISR,Israel,FIN,Finland,2010,29,0,29
ISR,Israel,FIN,Finland,2011,32,0,32
ISR,Israel,FIN,Finland,2012,24,0,24
ISR,Israel,FIN,Finland,2013,22,0,22
ISR,Israel,FIN,Finland,2014,21,0,21
ISR,Israel,FIN,Finland,2015,24,0,24
ISR,Israel,FIN,Finland,2016,34,0,34
ISR,Israel,FIN,Finland,2017,22,0,22
ISR,Israel,FRA,France,2008,151,1563,-1412
ISR,Israel,FRA,France,2009,170,1557,-1387
ISR,Israel,FRA,France,2010,147,1775,-1628
ISR,Israel,FRA,France,2011,140,1619,-1479
ISR,Israel,FRA,France,2012,155,1653,-1498
ISR,Israel,FRA,France,2013,145,2904,-2759
ISR,Israel,FRA,France,2014,153,6547,-6394
ISR,Israel,FRA,France,2015,141,6628,-6487
ISR,Israel,FRA,France,2016,156,4239,-4083
ISR,Israel,FRA,France,2017,144,3157,-3013
ISR,Israel,DEU,Germany,2008,1268,86,1182
ISR,Israel,DEU,Germany,2009,1491,96,1395
ISR,Israel,DEU,Germany,2010,1651,119,1532
ISR,Israel,DEU,Germany,2011,1615,97,1518
ISR,Israel,DEU,Germany,2012,1847,100,1747
ISR,Israel,DEU,Germany,2013,2002,79,1923
ISR,Israel,DEU,Germany,2014,2108,91,2017
ISR,Israel,DEU,Germany,2015,2251,114,2137
ISR,Israel,DEU,Germany,2016,2019,138,1881
ISR,Israel,DEU,Germany,2017,2083,155,1928
ISR,Israel,HUN,Hungary,2008,403,54,349
ISR,Israel,HUN,Hungary,2009,289,90,199
ISR,Israel,HUN,Hungary,2010,311,87,224
ISR,Israel,HUN,Hungary,2011,255,128,127
ISR,Israel,HUN,Hungary,2012,306,110,196
ISR,Israel,HUN,Hungary,2013,270,148,122
ISR,Israel,HUN,Hungary,2014,241,122,119
ISR,Israel,HUN,Hungary,2015,234,81,153
ISR,Israel,HUN,Hungary,2016,177,79,98
ISR,Israel,HUN,Hungary,2017,255,52,203
ISR,Israel,ISL,Iceland,2008,1,0,1
ISR,Israel,ISL,Iceland,2009,3,0,3
ISR,Israel,ISL,Iceland,2010,3,0,3
ISR,Israel,ISL,Iceland,2011,0,0,0
ISR,Israel,ISL,Iceland,2012,7,0,7
ISR,Israel,ISL,Iceland,2013,2,0,2
ISR,Israel,ISL,Iceland,2014,1,0,1
ISR,Israel,ISL,Iceland,2015,3,0,3
ISR,Israel,ISL,Iceland,2016,2,0,2
ISR,Israel,ISL,Iceland,2017,1,0,1
ISR,Israel,ITA,Italy,2008,181,52,129
ISR,Israel,ITA,Italy,2009,184,62,122
ISR,Israel,ITA,Italy,2010,211,97,114
ISR,Israel,ITA,Italy,2011,191,94,97
ISR,Israel,ITA,Italy,2012,206,137,69
ISR,Israel,ITA,Italy,2013,182,133,49
ISR,Israel,ITA,Italy,2014,172,323,-151
ISR,Israel,ITA,Italy,2015,168,353,-185
ISR,Israel,ITA,Italy,2016,141,184,-43
ISR,Israel,ITA,Italy,2017,174,115,59
ISR,Israel,JPN,Japan,2008,314,0,314
ISR,Israel,JPN,Japan,2009,181,0,181
ISR,Israel,JPN,Japan,2010,283,0,283
ISR,Israel,JPN,Japan,2011,121,0,121
ISR,Israel,JPN,Japan,2012,208,0,208
ISR,Israel,JPN,Japan,2013,138,0,138
ISR,Israel,JPN,Japan,2014,235,0,235
ISR,Israel,JPN,Japan,2015,192,0,192
ISR,Israel,JPN,Japan,2016,239,0,239
ISR,Israel,JPN,Japan,2017,209,0,209
ISR,Israel,KOR,Korea,2008,54,0,54
ISR,Israel,KOR,Korea,2009,51,0,51
ISR,Israel,KOR,Korea,2010,54,0,54
ISR,Israel,KOR,Korea,2011,61,0,61
ISR,Israel,KOR,Korea,2012,39,0,39
ISR,Israel,KOR,Korea,2013,48,0,48
ISR,Israel,KOR,Korea,2014,49,0,49
ISR,Israel,KOR,Korea,2015,60,0,60
ISR,Israel,KOR,Korea,2016,44,0,44
ISR,Israel,KOR,Korea,2017,39,0,39
ISR,Israel,LUX,Luxembourg,2008,18,0,18
ISR,Israel,LUX,Luxembourg,2009,14,0,14
ISR,Israel,LUX,Luxembourg,2010,17,0,17
ISR,Israel,LUX,Luxembourg,2011,11,0,11
ISR,Israel,LUX,Luxembourg,2012,22,0,22
ISR,Israel,LUX,Luxembourg,2013,33,0,33
ISR,Israel,LUX,Luxembourg,2014,16,0,16
ISR,Israel,LUX,Luxembourg,2015,11,0,11
ISR,Israel,LUX,Luxembourg,2016,20,0,20
ISR,Israel,LUX,Luxembourg,2017,17,0,17
ISR,Israel,MEX,Mexico,2008,56,83,-27
ISR,Israel,MEX,Mexico,2009,95,121,-26
ISR,Israel,MEX,Mexico,2010,92,137,-45
ISR,Israel,MEX,Mexico,2011,77,87,-10
ISR,Israel,MEX,Mexico,2012,58,61,-3
ISR,Israel,MEX,Mexico,2013,224,77,147
ISR,Israel,MEX,Mexico,2014,136,60,76
ISR,Israel,MEX,Mexico,2015,113,71,42
ISR,Israel,MEX,Mexico,2016,73,89,-16
ISR,Israel,MEX,Mexico,2017,68,76,-8
ISR,Israel,NLD,Netherlands,2008,264,30,234
ISR,Israel,NLD,Netherlands,2009,204,51,153
ISR,Israel,NLD,Netherlands,2010,172,36,136
ISR,Israel,NLD,Netherlands,2011,222,40,182
ISR,Israel,NLD,Netherlands,2012,235,36,199
ISR,Israel,NLD,Netherlands,2013,215,55,160
ISR,Israel,NLD,Netherlands,2014,266,49,217
ISR,Israel,NLD,Netherlands,2015,341,55,286
ISR,Israel,NLD,Netherlands,2016,260,72,188
ISR,Israel,NLD,Netherlands,2017,314,50,264
ISR,Israel,NZL,New Zealand,2008,69,0,69
ISR,Israel,NZL,New Zealand,2009,52,0,52
ISR,Israel,NZL,New Zealand,2010,53,0,53
ISR,Israel,NZL,New Zealand,2011,61,0,61
ISR,Israel,NZL,New Zealand,2012,56,0,56
ISR,Israel,NZL,New Zealand,2013,69,0,69
ISR,Israel,NZL,New Zealand,2014,95,0,95
ISR,Israel,NZL,New Zealand,2015,120,0,120
ISR,Israel,NZL,New Zealand,2016,116,0,116
ISR,Israel,NZL,New Zealand,2017,148,0,148
ISR,Israel,NOR,Norway,2008,30,0,30
ISR,Israel,NOR,Norway,2009,42,0,42
ISR,Israel,NOR,Norway,2010,21,0,21
ISR,Israel,NOR,Norway,2011,33,0,33
ISR,Israel,NOR,Norway,2012,36,0,36
ISR,Israel,NOR,Norway,2013,30,0,30
ISR,Israel,NOR,Norway,2014,23,0,23
ISR,Israel,NOR,Norway,2015,21,0,21
ISR,Israel,NOR,Norway,2016,20,0,20
ISR,Israel,NOR,Norway,2017,27,0,27
ISR,Israel,POL,Poland,2008,147,24,123
ISR,Israel,POL,Poland,2009,113,18,95
ISR,Israel,POL,Poland,2010,99,15,84
ISR,Israel,POL,Poland,2011,118,17,101
ISR,Israel,POL,Poland,2012,145,15,130
ISR,Israel,POL,Poland,2013,123,25,98
ISR,Israel,POL,Poland,2014,74,29,45
ISR,Israel,POL,Poland,2015,144,21,123
ISR,Israel,POL,Poland,2016,118,14,104
ISR,Israel,POL,Poland,2017,113,17,96
ISR,Israel,SVK,Slovak Republic,2008,2,0,2
ISR,Israel,SVK,Slovak Republic,2009,2,0,2
ISR,Israel,SVK,Slovak Republic,2010,4,0,4
ISR,Israel,SVK,Slovak Republic,2011,2,0,2
ISR,Israel,SVK,Slovak Republic,2012,1,0,1
ISR,Israel,SVK,Slovak Republic,2014,2,0,2
ISR,Israel,SVK,Slovak Republic,2015,4,0,4
ISR,Israel,SVK,Slovak Republic,2016,1,0,1
ISR,Israel,SVK,Slovak Republic,2017,3,0,3
ISR,Israel,ESP,Spain,2008,232,22,210
ISR,Israel,ESP,Spain,2009,259,29,230
ISR,Israel,ESP,Spain,2010,196,35,161
ISR,Israel,ESP,Spain,2011,279,53,226
ISR,Israel,ESP,Spain,2012,262,76,186
ISR,Israel,ESP,Spain,2013,241,70,171
ISR,Israel,ESP,Spain,2014,250,77,173
ISR,Israel,ESP,Spain,2015,261,87,174
ISR,Israel,ESP,Spain,2016,328,74,254
ISR,Israel,ESP,Spain,2017,432,90,342
ISR,Israel,SWE,Sweden,2008,87,7,80
ISR,Israel,SWE,Sweden,2009,77,24,53
ISR,Israel,SWE,Sweden,2010,48,28,20
ISR,Israel,SWE,Sweden,2011,49,22,27
ISR,Israel,SWE,Sweden,2012,73,15,58
ISR,Israel,SWE,Sweden,2013,65,29,36
ISR,Israel,SWE,Sweden,2014,81,13,68
ISR,Israel,SWE,Sweden,2015,73,33,40
ISR,Israel,SWE,Sweden,2016,48,25,23
ISR,Israel,SWE,Sweden,2017,51,28,23
ISR,Israel,CHE,Switzerland,2010,194,110,84
ISR,Israel,CHE,Switzerland,2011,211,59,152
ISR,Israel,CHE,Switzerland,2012,213,81,132
ISR,Israel,CHE,Switzerland,2013,206,75,131
ISR,Israel,CHE,Switzerland,2014,168,78,90
ISR,Israel,CHE,Switzerland,2015,181,75,106
ISR,Israel,CHE,Switzerland,2016,172,113,59
ISR,Israel,CHE,Switzerland,2017,216,84,132
ISR,Israel,TUR,Turkey,2010,18,131,-113
ISR,Israel,TUR,Turkey,2017,153,369,-216
ISR,Israel,GBR,United Kingdom,2012,1000,569,431
ISR,Israel,GBR,United Kingdom,2015,1000,623,377
ISR,Israel,USA,United States,2008,5851,2023,3828
ISR,Israel,USA,United States,2009,5612,2475,3137
ISR,Israel,USA,United States,2010,4515,2530,1985
ISR,Israel,USA,United States,2011,3826,2363,1463
ISR,Israel,USA,United States,2012,4153,2290,1863
ISR,Israel,USA,United States,2013,3996,2186,1810
ISR,Israel,USA,United States,2014,3805,2439,1366
ISR,Israel,USA,United States,2015,3965,2451,1514
ISR,Israel,USA,United States,2016,4142,2682,1460
ISR,Israel,USA,United States,2017,3802,2567,1235
ISR,Israel,CHL,Chile,2008,32,71,-39
ISR,Israel,CHL,Chile,2009,112,68,44
ISR,Israel,CHL,Chile,2010,22,46,-24
ISR,Israel,CHL,Chile,2011,26,40,-14
ISR,Israel,CHL,Chile,2012,39,42,-3
ISR,Israel,CHL,Chile,2013,18,52,-34
ISR,Israel,CHL,Chile,2014,65,43,22
ISR,Israel,CHL,Chile,2015,52,53,-1
ISR,Israel,CHL,Chile,2016,24,54,-30
ISR,Israel,EST,Estonia,2008,10,0,10
ISR,Israel,EST,Estonia,2009,12,0,12
ISR,Israel,EST,Estonia,2010,12,0,12
ISR,Israel,EST,Estonia,2011,22,0,22
ISR,Israel,EST,Estonia,2012,14,0,14
ISR,Israel,EST,Estonia,2013,13,0,13
ISR,Israel,EST,Estonia,2014,25,0,25
ISR,Israel,EST,Estonia,2015,21,0,21
ISR,Israel,EST,Estonia,2016,26,0,26
ISR,Israel,EST,Estonia,2017,19,0,19
ISR,Israel,SVN,Slovenia,2008,20,0,20
ISR,Israel,SVN,Slovenia,2009,10,0,10
ISR,Israel,SVN,Slovenia,2010,7,0,7
ISR,Israel,SVN,Slovenia,2011,7,0,7
ISR,Israel,SVN,Slovenia,2012,7,0,7
ISR,Israel,SVN,Slovenia,2013,5,0,5
ISR,Israel,SVN,Slovenia,2014,6,0,6
ISR,Israel,SVN,Slovenia,2015,16,0,16
ISR,Israel,SVN,Slovenia,2016,10,0,10
ISR,Israel,SVN,Slovenia,2017,13,0,13
ITA,Italy,AUS,Australia,2008,591,215,376
ITA,Italy,AUS,Australia,2009,707,248,459
ITA,Italy,AUS,Australia,2010,701,252,449
ITA,Italy,AUS,Australia,2011,788,226,562
ITA,Italy,AUS,Australia,2012,936,202,734
ITA,Italy,AUS,Australia,2013,1059,235,824
ITA,Italy,AUS,Australia,2014,1097,208,889
ITA,Italy,AUS,Australia,2015,1374,213,1161
ITA,Italy,AUS,Australia,2016,1639,185,1454
ITA,Italy,AUS,Australia,2017,1917,191,1726
ITA,Italy,AUT,Austria,2008,1842,457,1385
ITA,Italy,AUT,Austria,2009,1955,346,1609
ITA,Italy,AUT,Austria,2010,2167,343,1824
ITA,Italy,AUT,Austria,2011,2297,317,1980
ITA,Italy,AUT,Austria,2012,3095,331,2764
ITA,Italy,AUT,Austria,2013,3975,236,3739
ITA,Italy,AUT,Austria,2014,4101,209,3892
ITA,Italy,AUT,Austria,2015,4611,220,4391
ITA,Italy,AUT,Austria,2016,4249,245,4004
ITA,Italy,AUT,Austria,2017,4389,323,4066
ITA,Italy,BEL,Belgium,2008,3655,473,3182
ITA,Italy,BEL,Belgium,2009,3557,362,3195
ITA,Italy,BEL,Belgium,2010,4315,376,3939
ITA,Italy,BEL,Belgium,2011,4717,354,4363
ITA,Italy,BEL,Belgium,2012,5238,343,4895
ITA,Italy,BEL,Belgium,2013,5719,273,5446
ITA,Italy,BEL,Belgium,2014,5302,329,4973
ITA,Italy,BEL,Belgium,2015,5105,302,4803
ITA,Italy,BEL,Belgium,2016,4775,359,4416
ITA,Italy,BEL,Belgium,2017,4847,338,4509
ITA,Italy,CAN,Canada,2008,370,306,64
ITA,Italy,CAN,Canada,2009,429,275,154
ITA,Italy,CAN,Canada,2010,434,301,133
ITA,Italy,CAN,Canada,2011,374,285,89
ITA,Italy,CAN,Canada,2012,438,252,186
ITA,Italy,CAN,Canada,2013,545,209,336
ITA,Italy,CAN,Canada,2014,652,209,443
ITA,Italy,CAN,Canada,2015,832,204,628
ITA,Italy,CAN,Canada,2016,980,211,769
ITA,Italy,CAN,Canada,2017,1030,250,780
ITA,Italy,CZE,Czech Republic,2008,303,620,-317
ITA,Italy,CZE,Czech Republic,2009,230,555,-325
ITA,Italy,CZE,Czech Republic,2010,185,496,-311
ITA,Italy,CZE,Czech Republic,2011,163,428,-265
ITA,Italy,CZE,Czech Republic,2012,249,389,-140
ITA,Italy,CZE,Czech Republic,2013,338,257,81
ITA,Italy,CZE,Czech Republic,2014,357,253,104
ITA,Italy,CZE,Czech Republic,2015,378,211,167
ITA,Italy,CZE,Czech Republic,2016,425,212,213
ITA,Italy,CZE,Czech Republic,2017,411,195,216
ITA,Italy,DNK,Denmark,2008,538,198,340
ITA,Italy,DNK,Denmark,2009,556,159,397
ITA,Italy,DNK,Denmark,2010,669,143,526
ITA,Italy,DNK,Denmark,2011,706,150,556
ITA,Italy,DNK,Denmark,2012,899,153,746
ITA,Italy,DNK,Denmark,2013,1066,94,972
ITA,Italy,DNK,Denmark,2014,1390,105,1285
ITA,Italy,DNK,Denmark,2015,1483,108,1375
ITA,Italy,DNK,Denmark,2016,1487,91,1396
ITA,Italy,DNK,Denmark,2017,1463,110,1353
ITA,Italy,FIN,Finland,2008,199,198,1
ITA,Italy,FIN,Finland,2009,144,169,-25
ITA,Italy,FIN,Finland,2010,157,122,35
ITA,Italy,FIN,Finland,2011,161,117,44
ITA,Italy,FIN,Finland,2012,218,111,107
ITA,Italy,FIN,Finland,2013,199,104,95
ITA,Italy,FIN,Finland,2014,310,87,223
ITA,Italy,FIN,Finland,2015,308,101,207
ITA,Italy,FIN,Finland,2016,272,97,175
ITA,Italy,FIN,Finland,2017,266,97,169
ITA,Italy,FRA,France,2008,0,2497,-2497
ITA,Italy,FRA,France,2009,0,2345,-2345
ITA,Italy,FRA,France,2010,0,2012,-2012
ITA,Italy,FRA,France,2011,0,1892,-1892
ITA,Italy,FRA,France,2012,0,1896,-1896
ITA,Italy,FRA,France,2013,12171,1846,10325
ITA,Italy,FRA,France,2014,12689,1729,10960
ITA,Italy,FRA,France,2015,13247,1703,11544
ITA,Italy,FRA,France,2016,13883,1777,12106
ITA,Italy,FRA,France,2017,13578,1960,11618
ITA,Italy,DEU,Germany,2008,20087,3132,16955
ITA,Italy,DEU,Germany,2009,22235,2538,19697
ITA,Italy,DEU,Germany,2010,23894,2099,21795
ITA,Italy,DEU,Germany,2011,28070,2034,26036
ITA,Italy,DEU,Germany,2012,36896,1877,35019
ITA,Italy,DEU,Germany,2013,47485,1668,45817
ITA,Italy,DEU,Germany,2014,56700,1435,55265
ITA,Italy,DEU,Germany,2015,57191,1449,55742
ITA,Italy,DEU,Germany,2016,52564,1528,51036
ITA,Italy,DEU,Germany,2017,51471,1745,49726
ITA,Italy,HUN,Hungary,2008,255,1144,-889
ITA,Italy,HUN,Hungary,2009,267,1054,-787
ITA,Italy,HUN,Hungary,2010,253,921,-668
ITA,Italy,HUN,Hungary,2011,318,871,-553
ITA,Italy,HUN,Hungary,2012,352,853,-501
ITA,Italy,HUN,Hungary,2013,387,710,-323
ITA,Italy,HUN,Hungary,2014,514,656,-142
ITA,Italy,HUN,Hungary,2015,576,668,-92
ITA,Italy,HUN,Hungary,2016,601,619,-18
ITA,Italy,HUN,Hungary,2017,598,601,-3
ITA,Italy,ISL,Iceland,2008,53,45,8
ITA,Italy,ISL,Iceland,2009,58,30,28
ITA,Italy,ISL,Iceland,2010,63,28,35
ITA,Italy,ISL,Iceland,2011,42,16,26
ITA,Italy,ISL,Iceland,2012,46,11,35
ITA,Italy,ISL,Iceland,2013,73,19,54
ITA,Italy,ISL,Iceland,2014,76,0,76
ITA,Italy,ISL,Iceland,2015,90,12,78
ITA,Italy,ISL,Iceland,2016,102,15,87
ITA,Italy,ISL,Iceland,2017,158,9,149
ITA,Italy,JPN,Japan,2008,2336,590,1746
ITA,Italy,JPN,Japan,2009,2311,660,1651
ITA,Italy,JPN,Japan,2010,2106,617,1489
ITA,Italy,JPN,Japan,2011,1991,593,1398
ITA,Italy,JPN,Japan,2012,1803,574,1229
ITA,Italy,JPN,Japan,2013,2677,609,2068
ITA,Italy,JPN,Japan,2014,2430,531,1899
ITA,Italy,JPN,Japan,2015,2281,527,1754
ITA,Italy,JPN,Japan,2016,2829,492,2337
ITA,Italy,JPN,Japan,2017,2876,568,2308
ITA,Italy,KOR,Korea,2008,142,251,-109
ITA,Italy,KOR,Korea,2009,111,282,-171
ITA,Italy,KOR,Korea,2010,177,264,-87
ITA,Italy,KOR,Korea,2011,177,315,-138
ITA,Italy,KOR,Korea,2012,219,315,-96
ITA,Italy,KOR,Korea,2013,244,292,-48
ITA,Italy,KOR,Korea,2014,303,315,-12
ITA,Italy,KOR,Korea,2015,274,364,-90
ITA,Italy,KOR,Korea,2016,297,287,10
ITA,Italy,KOR,Korea,2017,354,342,12
ITA,Italy,LUX,Luxembourg,2008,813,27,786
ITA,Italy,LUX,Luxembourg,2009,659,18,641
ITA,Italy,LUX,Luxembourg,2010,751,18,733
ITA,Italy,LUX,Luxembourg,2011,958,16,942
ITA,Italy,LUX,Luxembourg,2012,1137,17,1120
ITA,Italy,LUX,Luxembourg,2013,1251,18,1233
ITA,Italy,LUX,Luxembourg,2014,1649,12,1637
ITA,Italy,LUX,Luxembourg,2015,1645,15,1630
ITA,Italy,LUX,Luxembourg,2016,1800,8,1792
ITA,Italy,LUX,Luxembourg,2017,1834,12,1822
ITA,Italy,MEX,Mexico,2008,323,423,-100
ITA,Italy,MEX,Mexico,2009,501,518,-17
ITA,Italy,MEX,Mexico,2010,550,602,-52
ITA,Italy,MEX,Mexico,2011,487,538,-51
ITA,Italy,MEX,Mexico,2012,437,462,-25
ITA,Italy,MEX,Mexico,2013,1529,441,1088
ITA,Italy,MEX,Mexico,2014,910,366,544
ITA,Italy,MEX,Mexico,2015,681,411,270
ITA,Italy,MEX,Mexico,2016,719,418,301
ITA,Italy,MEX,Mexico,2017,566,408,158
ITA,Italy,NLD,Netherlands,2008,2611,706,1905
ITA,Italy,NLD,Netherlands,2009,2575,530,2045
ITA,Italy,NLD,Netherlands,2010,2797,491,2306
ITA,Italy,NLD,Netherlands,2011,3075,437,2638
ITA,Italy,NLD,Netherlands,2012,3619,415,3204
ITA,Italy,NLD,Netherlands,2013,4235,441,3794
ITA,Italy,NLD,Netherlands,2014,5147,388,4759
ITA,Italy,NLD,Netherlands,2015,5713,455,5258
ITA,Italy,NLD,Netherlands,2016,6488,476,6012
ITA,Italy,NLD,Netherlands,2017,7583,492,7091
ITA,Italy,NZL,New Zealand,2008,199,47,152
ITA,Italy,NZL,New Zealand,2009,213,36,177
ITA,Italy,NZL,New Zealand,2010,243,54,189
ITA,Italy,NZL,New Zealand,2011,369,28,341
ITA,Italy,NZL,New Zealand,2012,463,41,422
ITA,Italy,NZL,New Zealand,2013,761,28,733
ITA,Italy,NZL,New Zealand,2014,949,26,923
ITA,Italy,NZL,New Zealand,2015,1121,27,1094
ITA,Italy,NZL,New Zealand,2016,1128,25,1103
ITA,Italy,NZL,New Zealand,2017,1319,39,1280
ITA,Italy,NOR,Norway,2008,372,111,261
ITA,Italy,NOR,Norway,2009,393,92,301
ITA,Italy,NOR,Norway,2010,494,90,404
ITA,Italy,NOR,Norway,2011,493,79,414
ITA,Italy,NOR,Norway,2012,597,108,489
ITA,Italy,NOR,Norway,2013,766,92,674
ITA,Italy,NOR,Norway,2014,794,65,729
ITA,Italy,NOR,Norway,2015,736,65,671
ITA,Italy,NOR,Norway,2016,656,75,581
ITA,Italy,NOR,Norway,2017,702,62,640
ITA,Italy,POL,Poland,2008,524,12314,-11790
ITA,Italy,POL,Poland,2009,626,9123,-8497
ITA,Italy,POL,Poland,2010,530,7174,-6644
ITA,Italy,POL,Poland,2011,637,5471,-4834
ITA,Italy,POL,Poland,2012,670,4618,-3948
ITA,Italy,POL,Poland,2013,851,3506,-2655
ITA,Italy,POL,Poland,2014,852,2953,-2101
ITA,Italy,POL,Poland,2015,1001,2657,-1656
ITA,Italy,POL,Poland,2016,1047,2424,-1377
ITA,Italy,POL,Poland,2017,1025,2065,-1040
ITA,Italy,PRT,Portugal,2008,990,503,487
ITA,Italy,PRT,Portugal,2009,1016,516,500
ITA,Italy,PRT,Portugal,2010,977,420,557
ITA,Italy,PRT,Portugal,2011,810,452,358
ITA,Italy,PRT,Portugal,2012,743,446,297
ITA,Italy,PRT,Portugal,2013,814,374,440
ITA,Italy,PRT,Portugal,2014,1071,376,695
ITA,Italy,PRT,Portugal,2015,1577,354,1223
ITA,Italy,PRT,Portugal,2016,3106,443,2663
ITA,Italy,PRT,Portugal,2017,5267,465,4802
ITA,Italy,SVK,Slovak Republic,2008,171,1274,-1103
ITA,Italy,SVK,Slovak Republic,2009,214,1074,-860
ITA,Italy,SVK,Slovak Republic,2010,206,895,-689
ITA,Italy,SVK,Slovak Republic,2011,175,730,-555
ITA,Italy,SVK,Slovak Republic,2012,164,645,-481
ITA,Italy,SVK,Slovak Republic,2013,150,539,-389
ITA,Italy,SVK,Slovak Republic,2014,107,478,-371
ITA,Italy,SVK,Slovak Republic,2015,211,471,-260
ITA,Italy,SVK,Slovak Republic,2016,200,421,-221
ITA,Italy,SVK,Slovak Republic,2017,218,374,-156
ITA,Italy,ESP,Spain,2008,15882,1512,14370
ITA,Italy,ESP,Spain,2009,11763,1386,10377
ITA,Italy,ESP,Spain,2010,11196,1514,9682
ITA,Italy,ESP,Spain,2011,11643,1666,9977
ITA,Italy,ESP,Spain,2012,12016,1956,10060
ITA,Italy,ESP,Spain,2013,12183,1836,10347
ITA,Italy,ESP,Spain,2014,14890,1830,13060
ITA,Italy,ESP,Spain,2015,18645,1906,16739
ITA,Italy,ESP,Spain,2016,21667,2075,19592
ITA,Italy,ESP,Spain,2017,28702,1972,26730
ITA,Italy,SWE,Sweden,2008,732,343,389
ITA,Italy,SWE,Sweden,2009,677,257,420
ITA,Italy,SWE,Sweden,2010,692,224,468
ITA,Italy,SWE,Sweden,2011,696,260,436
ITA,Italy,SWE,Sweden,2012,866,225,641
ITA,Italy,SWE,Sweden,2013,1016,187,829
ITA,Italy,SWE,Sweden,2014,1095,168,927
ITA,Italy,SWE,Sweden,2015,1209,163,1046
ITA,Italy,SWE,Sweden,2016,1307,162,1145
ITA,Italy,SWE,Sweden,2017,1309,193,1116
ITA,Italy,CHE,Switzerland,2008,9911,567,9344
ITA,Italy,CHE,Switzerland,2009,8511,487,8024
ITA,Italy,CHE,Switzerland,2010,10098,443,9655
ITA,Italy,CHE,Switzerland,2011,10777,375,10402
ITA,Italy,CHE,Switzerland,2012,13624,350,13274
ITA,Italy,CHE,Switzerland,2013,17475,393,17082
ITA,Italy,CHE,Switzerland,2014,17822,319,17503
ITA,Italy,CHE,Switzerland,2015,18241,283,17958
ITA,Italy,CHE,Switzerland,2016,18136,361,17775
ITA,Italy,CHE,Switzerland,2017,15484,436,15048
ITA,Italy,TUR,Turkey,2010,274,1483,-1209
ITA,Italy,TUR,Turkey,2016,693,840,-147
ITA,Italy,TUR,Turkey,2017,462,997,-535
ITA,Italy,GBR,United Kingdom,2008,14000,2244,11756
ITA,Italy,GBR,United Kingdom,2009,8000,1939,6061
ITA,Italy,GBR,United Kingdom,2010,9000,1568,7432
ITA,Italy,GBR,United Kingdom,2011,10000,1591,8409
ITA,Italy,GBR,United Kingdom,2012,10000,1548,8452
ITA,Italy,GBR,United Kingdom,2013,17000,1235,15765
ITA,Italy,GBR,United Kingdom,2014,17000,1328,15672
ITA,Italy,GBR,United Kingdom,2015,26000,1482,24518
ITA,Italy,GBR,United Kingdom,2016,26000,1712,24288
ITA,Italy,GBR,United Kingdom,2017,19000,1964,17036
ITA,Italy,USA,United States,2008,2514,1447,1067
ITA,Italy,USA,United States,2009,2892,1456,1436
ITA,Italy,USA,United States,2010,2579,1477,1102
ITA,Italy,USA,United States,2011,2443,1573,870
ITA,Italy,USA,United States,2012,2673,1620,1053
ITA,Italy,USA,United States,2013,2960,1546,1414
ITA,Italy,USA,United States,2014,3298,1391,1907
ITA,Italy,USA,United States,2015,3544,1395,2149
ITA,Italy,USA,United States,2016,4078,1365,2713
ITA,Italy,USA,United States,2017,3655,1583,2072
ITA,Italy,CHL,Chile,2008,170,339,-169
ITA,Italy,CHL,Chile,2009,223,266,-43
ITA,Italy,CHL,Chile,2010,446,332,114
ITA,Italy,CHL,Chile,2011,311,285,26
ITA,Italy,CHL,Chile,2012,307,247,60
ITA,Italy,CHL,Chile,2013,472,234,238
ITA,Italy,CHL,Chile,2014,429,196,233
ITA,Italy,CHL,Chile,2015,427,189,238
ITA,Italy,CHL,Chile,2016,416,162,254
ITA,Italy,EST,Estonia,2008,50,136,-86
ITA,Italy,EST,Estonia,2009,59,110,-51
ITA,Italy,EST,Estonia,2010,34,124,-90
ITA,Italy,EST,Estonia,2011,3,91,-88
ITA,Italy,EST,Estonia,2012,3,93,-90
ITA,Italy,EST,Estonia,2013,7,71,-64
ITA,Italy,EST,Estonia,2014,3,68,-65
ITA,Italy,EST,Estonia,2015,198,86,112
ITA,Italy,EST,Estonia,2016,242,70,172
ITA,Italy,EST,Estonia,2017,316,74,242
ITA,Italy,ISR,Israel,2008,52,181,-129
ITA,Italy,ISR,Israel,2009,62,184,-122
ITA,Italy,ISR,Israel,2010,97,211,-114
ITA,Italy,ISR,Israel,2011,94,191,-97
ITA,Italy,ISR,Israel,2012,137,206,-69
ITA,Italy,ISR,Israel,2013,133,182,-49
ITA,Italy,ISR,Israel,2014,323,172,151
ITA,Italy,ISR,Israel,2015,353,168,185
ITA,Italy,ISR,Israel,2016,184,141,43
ITA,Italy,ISR,Israel,2017,115,174,-59
ITA,Italy,SVN,Slovenia,2008,10,314,-304
ITA,Italy,SVN,Slovenia,2009,233,203,30
ITA,Italy,SVN,Slovenia,2010,3,191,-188
ITA,Italy,SVN,Slovenia,2011,356,192,164
ITA,Italy,SVN,Slovenia,2012,501,208,293
ITA,Italy,SVN,Slovenia,2013,566,122,444
ITA,Italy,SVN,Slovenia,2014,735,155,580
ITA,Italy,SVN,Slovenia,2015,828,167,661
ITA,Italy,SVN,Slovenia,2016,775,166,609
ITA,Italy,SVN,Slovenia,2017,786,183,603
JAM,Jamaica,AUS,Australia,2008,18,6,12
JAM,Jamaica,AUS,Australia,2009,22,7,15
JAM,Jamaica,AUS,Australia,2010,15,6,9
JAM,Jamaica,AUS,Australia,2011,6,7,-1
JAM,Jamaica,AUS,Australia,2012,13,8,5
JAM,Jamaica,AUS,Australia,2013,30,8,22
JAM,Jamaica,AUS,Australia,2014,43,6,37
JAM,Jamaica,AUS,Australia,2015,26,0,26
JAM,Jamaica,AUS,Australia,2016,27,0,27
JAM,Jamaica,AUS,Australia,2017,13,0,13
JAM,Jamaica,AUT,Austria,2008,11,6,5
JAM,Jamaica,AUT,Austria,2009,8,7,1
JAM,Jamaica,AUT,Austria,2010,14,6,8
JAM,Jamaica,AUT,Austria,2011,12,6,6
JAM,Jamaica,AUT,Austria,2012,6,7,-1
JAM,Jamaica,AUT,Austria,2013,13,3,10
JAM,Jamaica,AUT,Austria,2014,12,4,8
JAM,Jamaica,AUT,Austria,2015,9,7,2
JAM,Jamaica,AUT,Austria,2016,8,9,-1
JAM,Jamaica,AUT,Austria,2017,15,5,10
JAM,Jamaica,BEL,Belgium,2008,17,0,17
JAM,Jamaica,BEL,Belgium,2009,23,0,23
JAM,Jamaica,BEL,Belgium,2010,14,4,10
JAM,Jamaica,BEL,Belgium,2012,13,9,4
JAM,Jamaica,BEL,Belgium,2013,12,4,8
JAM,Jamaica,BEL,Belgium,2014,17,4,13
JAM,Jamaica,BEL,Belgium,2015,22,6,16
JAM,Jamaica,BEL,Belgium,2016,15,3,12
JAM,Jamaica,BEL,Belgium,2017,10,3,7
JAM,Jamaica,CAN,Canada,2008,2334,0,2334
JAM,Jamaica,CAN,Canada,2009,2456,0,2456
JAM,Jamaica,CAN,Canada,2010,2321,0,2321
JAM,Jamaica,CAN,Canada,2011,2059,0,2059
JAM,Jamaica,CAN,Canada,2012,2173,0,2173
JAM,Jamaica,CAN,Canada,2013,2480,0,2480
JAM,Jamaica,CAN,Canada,2014,3050,0,3050
JAM,Jamaica,CAN,Canada,2015,3426,0,3426
JAM,Jamaica,CAN,Canada,2016,3560,0,3560
JAM,Jamaica,CAN,Canada,2017,3830,0,3830
JAM,Jamaica,CZE,Czech Republic,2008,1,0,1
JAM,Jamaica,CZE,Czech Republic,2012,1,0,1
JAM,Jamaica,CZE,Czech Republic,2013,1,0,1
JAM,Jamaica,CZE,Czech Republic,2014,2,1,1
JAM,Jamaica,CZE,Czech Republic,2015,2,0,2
JAM,Jamaica,CZE,Czech Republic,2016,2,0,2
JAM,Jamaica,DNK,Denmark,2008,5,2,3
JAM,Jamaica,DNK,Denmark,2009,3,1,2
JAM,Jamaica,DNK,Denmark,2010,6,1,5
JAM,Jamaica,DNK,Denmark,2011,7,3,4
JAM,Jamaica,DNK,Denmark,2012,5,1,4
JAM,Jamaica,DNK,Denmark,2013,4,3,1
JAM,Jamaica,DNK,Denmark,2014,2,4,-2
JAM,Jamaica,DNK,Denmark,2015,4,2,2
JAM,Jamaica,DNK,Denmark,2016,6,2,4
JAM,Jamaica,DNK,Denmark,2017,2,5,-3
JAM,Jamaica,FIN,Finland,2008,3,1,2
JAM,Jamaica,FIN,Finland,2009,1,0,1
JAM,Jamaica,FIN,Finland,2010,3,0,3
JAM,Jamaica,FIN,Finland,2011,5,0,5
JAM,Jamaica,FIN,Finland,2012,6,0,6
JAM,Jamaica,FIN,Finland,2013,4,1,3
JAM,Jamaica,FIN,Finland,2014,5,1,4
JAM,Jamaica,FIN,Finland,2015,6,0,6
JAM,Jamaica,FIN,Finland,2016,1,4,-3
JAM,Jamaica,FIN,Finland,2017,4,0,4
JAM,Jamaica,FRA,France,2008,32,0,32
JAM,Jamaica,FRA,France,2009,31,0,31
JAM,Jamaica,FRA,France,2010,37,0,37
JAM,Jamaica,FRA,France,2011,51,0,51
JAM,Jamaica,FRA,France,2012,47,0,47
JAM,Jamaica,FRA,France,2013,29,0,29
JAM,Jamaica,FRA,France,2014,43,0,43
JAM,Jamaica,FRA,France,2015,68,0,68
JAM,Jamaica,FRA,France,2016,89,0,89
JAM,Jamaica,FRA,France,2017,77,0,77
JAM,Jamaica,DEU,Germany,2008,73,100,-27
JAM,Jamaica,DEU,Germany,2009,71,87,-16
JAM,Jamaica,DEU,Germany,2010,102,81,21
JAM,Jamaica,DEU,Germany,2011,93,64,29
JAM,Jamaica,DEU,Germany,2012,84,53,31
JAM,Jamaica,DEU,Germany,2013,84,72,12
JAM,Jamaica,DEU,Germany,2014,97,61,36
JAM,Jamaica,DEU,Germany,2015,108,62,46
JAM,Jamaica,DEU,Germany,2016,104,75,29
JAM,Jamaica,DEU,Germany,2017,188,75,113
JAM,Jamaica,HUN,Hungary,2008,2,0,2
JAM,Jamaica,HUN,Hungary,2009,2,1,1
JAM,Jamaica,HUN,Hungary,2010,2,1,1
JAM,Jamaica,HUN,Hungary,2011,4,0,4
JAM,Jamaica,HUN,Hungary,2012,1,0,1
JAM,Jamaica,HUN,Hungary,2013,4,0,4
JAM,Jamaica,HUN,Hungary,2014,3,1,2
JAM,Jamaica,HUN,Hungary,2015,0,0,0
JAM,Jamaica,HUN,Hungary,2016,2,0,2
JAM,Jamaica,HUN,Hungary,2017,2,0,2
JAM,Jamaica,ISL,Iceland,2008,1,1,0
JAM,Jamaica,ISL,Iceland,2009,1,1,0
JAM,Jamaica,ISL,Iceland,2010,1,1,0
JAM,Jamaica,ISL,Iceland,2011,1,0,1
JAM,Jamaica,ISL,Iceland,2012,1,0,1
JAM,Jamaica,ISL,Iceland,2013,0,0,0
JAM,Jamaica,ISL,Iceland,2014,2,2,0
JAM,Jamaica,ISL,Iceland,2015,2,1,1
JAM,Jamaica,ISL,Iceland,2016,1,2,-1
JAM,Jamaica,ISL,Iceland,2017,3,2,1
JAM,Jamaica,ITA,Italy,2008,13,3,10
JAM,Jamaica,ITA,Italy,2009,9,4,5
JAM,Jamaica,ITA,Italy,2010,18,5,13
JAM,Jamaica,ITA,Italy,2011,14,0,14
JAM,Jamaica,ITA,Italy,2012,11,1,10
JAM,Jamaica,ITA,Italy,2013,15,1,14
JAM,Jamaica,ITA,Italy,2014,10,2,8
JAM,Jamaica,ITA,Italy,2015,13,2,11
JAM,Jamaica,ITA,Italy,2016,13,0,13
JAM,Jamaica,ITA,Italy,2017,10,0,10
JAM,Jamaica,JPN,Japan,2008,208,165,43
JAM,Jamaica,JPN,Japan,2009,171,124,47
JAM,Jamaica,JPN,Japan,2010,145,125,20
JAM,Jamaica,JPN,Japan,2011,176,117,59
JAM,Jamaica,JPN,Japan,2012,160,118,42
JAM,Jamaica,JPN,Japan,2013,133,86,47
JAM,Jamaica,JPN,Japan,2014,135,76,59
JAM,Jamaica,JPN,Japan,2015,195,89,106
JAM,Jamaica,JPN,Japan,2016,224,110,114
JAM,Jamaica,JPN,Japan,2017,197,103,94
JAM,Jamaica,KOR,Korea,2008,12,3,9
JAM,Jamaica,KOR,Korea,2009,6,7,-1
JAM,Jamaica,KOR,Korea,2010,7,4,3
JAM,Jamaica,KOR,Korea,2011,6,8,-2
JAM,Jamaica,KOR,Korea,2012,8,6,2
JAM,Jamaica,KOR,Korea,2013,8,9,-1
JAM,Jamaica,KOR,Korea,2014,13,8,5
JAM,Jamaica,KOR,Korea,2015,13,14,-1
JAM,Jamaica,KOR,Korea,2016,13,10,3
JAM,Jamaica,KOR,Korea,2017,18,13,5
JAM,Jamaica,LUX,Luxembourg,2008,3,0,3
JAM,Jamaica,LUX,Luxembourg,2009,2,1,1
JAM,Jamaica,LUX,Luxembourg,2010,1,0,1
JAM,Jamaica,LUX,Luxembourg,2011,4,0,4
JAM,Jamaica,LUX,Luxembourg,2012,2,0,2
JAM,Jamaica,LUX,Luxembourg,2013,1,0,1
JAM,Jamaica,LUX,Luxembourg,2014,1,4,-3
JAM,Jamaica,LUX,Luxembourg,2015,2,0,2
JAM,Jamaica,LUX,Luxembourg,2016,0,0,0
JAM,Jamaica,LUX,Luxembourg,2017,1,1,0
JAM,Jamaica,MEX,Mexico,2008,8,0,8
JAM,Jamaica,MEX,Mexico,2009,14,0,14
JAM,Jamaica,MEX,Mexico,2010,4,0,4
JAM,Jamaica,MEX,Mexico,2011,5,0,5
JAM,Jamaica,MEX,Mexico,2012,2,0,2
JAM,Jamaica,MEX,Mexico,2013,12,0,12
JAM,Jamaica,MEX,Mexico,2014,8,0,8
JAM,Jamaica,MEX,Mexico,2015,7,0,7
JAM,Jamaica,MEX,Mexico,2016,10,0,10
JAM,Jamaica,MEX,Mexico,2017,12,0,12
JAM,Jamaica,NLD,Netherlands,2008,11,6,5
JAM,Jamaica,NLD,Netherlands,2009,26,11,15
JAM,Jamaica,NLD,Netherlands,2010,22,15,7
JAM,Jamaica,NLD,Netherlands,2011,27,2,25
JAM,Jamaica,NLD,Netherlands,2012,39,7,32
JAM,Jamaica,NLD,Netherlands,2013,27,5,22
JAM,Jamaica,NLD,Netherlands,2014,40,13,27
JAM,Jamaica,NLD,Netherlands,2015,74,12,62
JAM,Jamaica,NLD,Netherlands,2016,74,14,60
JAM,Jamaica,NLD,Netherlands,2017,34,12,22
JAM,Jamaica,NZL,New Zealand,2008,3,1,2
JAM,Jamaica,NZL,New Zealand,2009,4,1,3
JAM,Jamaica,NZL,New Zealand,2010,3,3,0
JAM,Jamaica,NZL,New Zealand,2011,12,1,11
JAM,Jamaica,NZL,New Zealand,2012,7,3,4
JAM,Jamaica,NZL,New Zealand,2013,19,1,18
JAM,Jamaica,NZL,New Zealand,2014,6,3,3
JAM,Jamaica,NZL,New Zealand,2015,19,3,16
JAM,Jamaica,NZL,New Zealand,2016,8,9,-1
JAM,Jamaica,NZL,New Zealand,2017,13,4,9
JAM,Jamaica,NOR,Norway,2008,6,3,3
JAM,Jamaica,NOR,Norway,2009,7,3,4
JAM,Jamaica,NOR,Norway,2010,9,1,8
JAM,Jamaica,NOR,Norway,2011,12,9,3
JAM,Jamaica,NOR,Norway,2012,7,5,2
JAM,Jamaica,NOR,Norway,2013,4,3,1
JAM,Jamaica,NOR,Norway,2014,1,6,-5
JAM,Jamaica,NOR,Norway,2015,11,3,8
JAM,Jamaica,NOR,Norway,2016,9,3,6
JAM,Jamaica,NOR,Norway,2017,8,2,6
JAM,Jamaica,POL,Poland,2009,5,0,5
JAM,Jamaica,POL,Poland,2010,7,0,7
JAM,Jamaica,POL,Poland,2011,10,0,10
JAM,Jamaica,POL,Poland,2012,11,0,11
JAM,Jamaica,POL,Poland,2013,9,0,9
JAM,Jamaica,POL,Poland,2014,6,0,6
JAM,Jamaica,POL,Poland,2015,8,0,8
JAM,Jamaica,POL,Poland,2016,5,0,5
JAM,Jamaica,POL,Poland,2017,7,0,7
JAM,Jamaica,SVK,Slovak Republic,2008,1,0,1
JAM,Jamaica,SVK,Slovak Republic,2009,4,0,4
JAM,Jamaica,SVK,Slovak Republic,2010,1,0,1
JAM,Jamaica,SVK,Slovak Republic,2011,1,0,1
JAM,Jamaica,SVK,Slovak Republic,2013,1,0,1
JAM,Jamaica,SVK,Slovak Republic,2014,1,0,1
JAM,Jamaica,ESP,Spain,2008,20,1,19
JAM,Jamaica,ESP,Spain,2009,18,2,16
JAM,Jamaica,ESP,Spain,2010,1,9,-8
JAM,Jamaica,ESP,Spain,2011,13,9,4
JAM,Jamaica,ESP,Spain,2012,16,4,12
JAM,Jamaica,ESP,Spain,2013,11,3,8
JAM,Jamaica,ESP,Spain,2014,6,3,3
JAM,Jamaica,ESP,Spain,2015,8,3,5
JAM,Jamaica,ESP,Spain,2016,14,3,11
JAM,Jamaica,ESP,Spain,2017,25,8,17
JAM,Jamaica,SWE,Sweden,2008,13,8,5
JAM,Jamaica,SWE,Sweden,2009,19,1,18
JAM,Jamaica,SWE,Sweden,2010,15,1,14
JAM,Jamaica,SWE,Sweden,2011,22,2,20
JAM,Jamaica,SWE,Sweden,2012,29,7,22
JAM,Jamaica,SWE,Sweden,2013,15,4,11
JAM,Jamaica,SWE,Sweden,2014,23,8,15
JAM,Jamaica,SWE,Sweden,2015,13,9,4
JAM,Jamaica,SWE,Sweden,2016,16,4,12
JAM,Jamaica,SWE,Sweden,2017,16,1,15
JAM,Jamaica,CHE,Switzerland,2010,35,12,23
JAM,Jamaica,CHE,Switzerland,2011,22,17,5
JAM,Jamaica,CHE,Switzerland,2012,31,9,22
JAM,Jamaica,CHE,Switzerland,2013,28,9,19
JAM,Jamaica,CHE,Switzerland,2014,16,8,8
JAM,Jamaica,CHE,Switzerland,2015,27,7,20
JAM,Jamaica,CHE,Switzerland,2016,22,12,10
JAM,Jamaica,CHE,Switzerland,2017,21,9,12
JAM,Jamaica,GBR,United Kingdom,2012,1000,0,1000
JAM,Jamaica,GBR,United Kingdom,2015,2000,0,2000
JAM,Jamaica,USA,United States,2008,18477,0,18477
JAM,Jamaica,USA,United States,2009,21783,0,21783
JAM,Jamaica,USA,United States,2010,19825,0,19825
JAM,Jamaica,USA,United States,2011,19662,0,19662
JAM,Jamaica,USA,United States,2012,20705,0,20705
JAM,Jamaica,USA,United States,2013,19400,0,19400
JAM,Jamaica,USA,United States,2014,19026,0,19026
JAM,Jamaica,USA,United States,2015,17642,0,17642
JAM,Jamaica,USA,United States,2016,23350,0,23350
JAM,Jamaica,USA,United States,2017,21905,0,21905
JAM,Jamaica,CHL,Chile,2008,4,0,4
JAM,Jamaica,CHL,Chile,2009,2,0,2
JAM,Jamaica,CHL,Chile,2010,1,0,1
JAM,Jamaica,CHL,Chile,2011,0,0,0
JAM,Jamaica,CHL,Chile,2012,0,0,0
JAM,Jamaica,CHL,Chile,2013,3,0,3
JAM,Jamaica,CHL,Chile,2014,5,0,5
JAM,Jamaica,CHL,Chile,2015,2,0,2
JAM,Jamaica,CHL,Chile,2016,4,0,4
JAM,Jamaica,EST,Estonia,2008,0,0,0
JAM,Jamaica,EST,Estonia,2009,0,0,0
JAM,Jamaica,EST,Estonia,2010,0,0,0
JAM,Jamaica,EST,Estonia,2011,0,0,0
JAM,Jamaica,EST,Estonia,2012,0,0,0
JAM,Jamaica,EST,Estonia,2013,0,0,0
JAM,Jamaica,EST,Estonia,2014,0,0,0
JAM,Jamaica,EST,Estonia,2015,1,0,1
JAM,Jamaica,EST,Estonia,2016,0,0,0
JAM,Jamaica,EST,Estonia,2017,1,0,1
JAM,Jamaica,SVN,Slovenia,2008,2,0,2
JAM,Jamaica,SVN,Slovenia,2009,1,0,1
JAM,Jamaica,SVN,Slovenia,2010,1,0,1
JAM,Jamaica,SVN,Slovenia,2011,2,0,2
JAM,Jamaica,SVN,Slovenia,2013,1,0,1
JAM,Jamaica,SVN,Slovenia,2015,1,0,1
JAM,Jamaica,SVN,Slovenia,2017,1,0,1
JPN,Japan,AUS,Australia,2008,1935,3526,-1591
JPN,Japan,AUS,Australia,2009,1954,3054,-1100
JPN,Japan,AUS,Australia,2010,1636,1123,513
JPN,Japan,AUS,Australia,2011,1470,2813,-1343
JPN,Japan,AUS,Australia,2012,1628,2937,-1309
JPN,Japan,AUS,Australia,2013,1776,2979,-1203
JPN,Japan,AUS,Australia,2014,1317,3324,-2007
JPN,Japan,AUS,Australia,2015,1118,3619,-2501
JPN,Japan,AUS,Australia,2016,1141,3775,-2634
JPN,Japan,AUS,Australia,2017,1176,4005,-2829
JPN,Japan,AUT,Austria,2008,357,1433,-1076
JPN,Japan,AUT,Austria,2009,333,1044,-711
JPN,Japan,AUT,Austria,2010,320,3087,-2767
JPN,Japan,AUT,Austria,2011,360,755,-395
JPN,Japan,AUT,Austria,2012,365,1175,-810
JPN,Japan,AUT,Austria,2013,371,881,-510
JPN,Japan,AUT,Austria,2014,398,759,-361
JPN,Japan,AUT,Austria,2015,436,884,-448
JPN,Japan,AUT,Austria,2016,447,1331,-884
JPN,Japan,AUT,Austria,2017,484,961,-477
JPN,Japan,BEL,Belgium,2008,1084,482,602
JPN,Japan,BEL,Belgium,2009,1063,383,680
JPN,Japan,BEL,Belgium,2010,914,444,470
JPN,Japan,BEL,Belgium,2011,1061,351,710
JPN,Japan,BEL,Belgium,2012,994,496,498
JPN,Japan,BEL,Belgium,2013,935,390,545
JPN,Japan,BEL,Belgium,2014,786,411,375
JPN,Japan,BEL,Belgium,2015,910,456,454
JPN,Japan,BEL,Belgium,2016,830,470,360
JPN,Japan,BEL,Belgium,2017,880,548,332
JPN,Japan,CAN,Canada,2008,1284,3631,-2347
JPN,Japan,CAN,Canada,2009,1193,2743,-1550
JPN,Japan,CAN,Canada,2010,1167,2696,-1529
JPN,Japan,CAN,Canada,2011,1265,2062,-797
JPN,Japan,CAN,Canada,2012,1210,2203,-993
JPN,Japan,CAN,Canada,2013,983,2157,-1174
JPN,Japan,CAN,Canada,2014,1127,2290,-1163
JPN,Japan,CAN,Canada,2015,995,2348,-1353
JPN,Japan,CAN,Canada,2016,1035,2724,-1689
JPN,Japan,CAN,Canada,2017,1080,2651,-1571
JPN,Japan,CZE,Czech Republic,2008,594,915,-321
JPN,Japan,CZE,Czech Republic,2009,372,720,-348
JPN,Japan,CZE,Czech Republic,2010,320,512,-192
JPN,Japan,CZE,Czech Republic,2011,230,618,-388
JPN,Japan,CZE,Czech Republic,2012,417,400,17
JPN,Japan,CZE,Czech Republic,2013,367,1062,-695
JPN,Japan,CZE,Czech Republic,2014,375,410,-35
JPN,Japan,CZE,Czech Republic,2015,320,867,-547
JPN,Japan,CZE,Czech Republic,2016,341,704,-363
JPN,Japan,CZE,Czech Republic,2017,428,695,-267
JPN,Japan,DNK,Denmark,2008,168,223,-55
JPN,Japan,DNK,Denmark,2009,154,353,-199
JPN,Japan,DNK,Denmark,2010,121,263,-142
JPN,Japan,DNK,Denmark,2011,161,247,-86
JPN,Japan,DNK,Denmark,2012,186,317,-131
JPN,Japan,DNK,Denmark,2013,184,323,-139
JPN,Japan,DNK,Denmark,2014,187,346,-159
JPN,Japan,DNK,Denmark,2015,220,446,-226
JPN,Japan,DNK,Denmark,2016,183,433,-250
JPN,Japan,DNK,Denmark,2017,207,582,-375
JPN,Japan,FIN,Finland,2008,152,407,-255
JPN,Japan,FIN,Finland,2009,140,413,-273
JPN,Japan,FIN,Finland,2010,94,529,-435
JPN,Japan,FIN,Finland,2011,115,443,-328
JPN,Japan,FIN,Finland,2012,110,427,-317
JPN,Japan,FIN,Finland,2013,116,506,-390
JPN,Japan,FIN,Finland,2014,108,492,-384
JPN,Japan,FIN,Finland,2015,90,715,-625
JPN,Japan,FIN,Finland,2016,132,703,-571
JPN,Japan,FIN,Finland,2017,158,802,-644
JPN,Japan,FRA,France,2008,1531,4537,-3006
JPN,Japan,FRA,France,2009,1604,3931,-2327
JPN,Japan,FRA,France,2010,1471,3984,-2513
JPN,Japan,FRA,France,2011,1598,2911,-1313
JPN,Japan,FRA,France,2012,1518,3955,-2437
JPN,Japan,FRA,France,2013,1552,4481,-2929
JPN,Japan,FRA,France,2014,1647,4532,-2885
JPN,Japan,FRA,France,2015,1588,4990,-3402
JPN,Japan,FRA,France,2016,1515,5556,-4041
JPN,Japan,FRA,France,2017,1566,5527,-3961
JPN,Japan,DEU,Germany,2008,5847,4847,1000
JPN,Japan,DEU,Germany,2009,5482,4499,983
JPN,Japan,DEU,Germany,2010,5567,4277,1290
JPN,Japan,DEU,Germany,2011,6827,3676,3151
JPN,Japan,DEU,Germany,2012,6629,4141,2488
JPN,Japan,DEU,Germany,2013,6755,4063,2692
JPN,Japan,DEU,Germany,2014,6747,4322,2425
JPN,Japan,DEU,Germany,2015,6886,4759,2127
JPN,Japan,DEU,Germany,2016,7002,5333,1669
JPN,Japan,DEU,Germany,2017,6942,5149,1793
JPN,Japan,HUN,Hungary,2008,522,360,162
JPN,Japan,HUN,Hungary,2009,343,505,-162
JPN,Japan,HUN,Hungary,2010,279,471,-192
JPN,Japan,HUN,Hungary,2011,304,353,-49
JPN,Japan,HUN,Hungary,2012,332,480,-148
JPN,Japan,HUN,Hungary,2013,391,546,-155
JPN,Japan,HUN,Hungary,2014,471,578,-107
JPN,Japan,HUN,Hungary,2015,513,592,-79
JPN,Japan,HUN,Hungary,2016,467,643,-176
JPN,Japan,HUN,Hungary,2017,580,612,-32
JPN,Japan,ISL,Iceland,2008,16,94,-78
JPN,Japan,ISL,Iceland,2009,17,49,-32
JPN,Japan,ISL,Iceland,2010,12,72,-60
JPN,Japan,ISL,Iceland,2011,16,57,-41
JPN,Japan,ISL,Iceland,2012,23,68,-45
JPN,Japan,ISL,Iceland,2013,18,95,-77
JPN,Japan,ISL,Iceland,2014,30,58,-28
JPN,Japan,ISL,Iceland,2015,24,57,-33
JPN,Japan,ISL,Iceland,2016,16,69,-53
JPN,Japan,ISL,Iceland,2017,26,54,-28
JPN,Japan,ITA,Italy,2008,590,2336,-1746
JPN,Japan,ITA,Italy,2009,660,2311,-1651
JPN,Japan,ITA,Italy,2010,617,2106,-1489
JPN,Japan,ITA,Italy,2011,593,1991,-1398
JPN,Japan,ITA,Italy,2012,574,1803,-1229
JPN,Japan,ITA,Italy,2013,609,2677,-2068
JPN,Japan,ITA,Italy,2014,531,2430,-1899
JPN,Japan,ITA,Italy,2015,527,2281,-1754
JPN,Japan,ITA,Italy,2016,492,2829,-2337
JPN,Japan,ITA,Italy,2017,568,2876,-2308
JPN,Japan,JPN,Japan,2008,0,0,0
JPN,Japan,JPN,Japan,2009,0,0,0
JPN,Japan,JPN,Japan,2010,0,0,0
JPN,Japan,JPN,Japan,2011,0,0,0
JPN,Japan,JPN,Japan,2012,0,0,0
JPN,Japan,JPN,Japan,2013,0,0,0
JPN,Japan,JPN,Japan,2014,0,0,0
JPN,Japan,JPN,Japan,2015,0,0,0
JPN,Japan,JPN,Japan,2016,0,0,0
JPN,Japan,JPN,Japan,2017,0,0,0
JPN,Japan,KOR,Korea,2008,4659,30043,-25384
JPN,Japan,KOR,Korea,2009,4371,26979,-22608
JPN,Japan,KOR,Korea,2010,4744,27868,-23124
JPN,Japan,KOR,Korea,2011,5549,23360,-17811
JPN,Japan,KOR,Korea,2012,5831,25748,-19917
JPN,Japan,KOR,Korea,2013,5891,24202,-18311
JPN,Japan,KOR,Korea,2014,4736,21116,-16380
JPN,Japan,KOR,Korea,2015,4589,22571,-17982
JPN,Japan,KOR,Korea,2016,4662,25639,-20977
JPN,Japan,KOR,Korea,2017,4469,28006,-23537
JPN,Japan,LUX,Luxembourg,2008,95,45,50
JPN,Japan,LUX,Luxembourg,2009,67,33,34
JPN,Japan,LUX,Luxembourg,2010,78,37,41
JPN,Japan,LUX,Luxembourg,2011,93,36,57
JPN,Japan,LUX,Luxembourg,2012,85,38,47
JPN,Japan,LUX,Luxembourg,2013,109,35,74
JPN,Japan,LUX,Luxembourg,2014,121,60,61
JPN,Japan,LUX,Luxembourg,2015,134,40,94
JPN,Japan,LUX,Luxembourg,2016,115,38,77
JPN,Japan,LUX,Luxembourg,2017,104,104,0
JPN,Japan,MEX,Mexico,2008,128,683,-555
JPN,Japan,MEX,Mexico,2009,132,500,-368
JPN,Japan,MEX,Mexico,2010,156,628,-472
JPN,Japan,MEX,Mexico,2011,145,607,-462
JPN,Japan,MEX,Mexico,2012,118,789,-671
JPN,Japan,MEX,Mexico,2013,637,767,-130
JPN,Japan,MEX,Mexico,2014,408,724,-316
JPN,Japan,MEX,Mexico,2015,349,823,-474
JPN,Japan,MEX,Mexico,2016,426,916,-490
JPN,Japan,MEX,Mexico,2017,609,1082,-473
JPN,Japan,NLD,Netherlands,2008,1207,1005,202
JPN,Japan,NLD,Netherlands,2009,1063,941,122
JPN,Japan,NLD,Netherlands,2010,1018,805,213
JPN,Japan,NLD,Netherlands,2011,1119,727,392
JPN,Japan,NLD,Netherlands,2012,1102,779,323
JPN,Japan,NLD,Netherlands,2013,1028,920,108
JPN,Japan,NLD,Netherlands,2014,1137,878,259
JPN,Japan,NLD,Netherlands,2015,1228,1094,134
JPN,Japan,NLD,Netherlands,2016,1522,1136,386
JPN,Japan,NLD,Netherlands,2017,1362,1216,146
JPN,Japan,NZL,New Zealand,2008,2188,882,1306
JPN,Japan,NZL,New Zealand,2009,1935,780,1155
JPN,Japan,NZL,New Zealand,2010,1853,739,1114
JPN,Japan,NZL,New Zealand,2011,1832,759,1073
JPN,Japan,NZL,New Zealand,2012,1773,682,1091
JPN,Japan,NZL,New Zealand,2013,1850,798,1052
JPN,Japan,NZL,New Zealand,2014,2014,722,1292
JPN,Japan,NZL,New Zealand,2015,2181,775,1406
JPN,Japan,NZL,New Zealand,2016,2370,855,1515
JPN,Japan,NZL,New Zealand,2017,2449,970,1479
JPN,Japan,NOR,Norway,2008,135,226,-91
JPN,Japan,NOR,Norway,2009,134,259,-125
JPN,Japan,NOR,Norway,2010,114,298,-184
JPN,Japan,NOR,Norway,2011,148,255,-107
JPN,Japan,NOR,Norway,2012,139,242,-103
JPN,Japan,NOR,Norway,2013,138,306,-168
JPN,Japan,NOR,Norway,2014,182,415,-233
JPN,Japan,NOR,Norway,2015,159,303,-144
JPN,Japan,NOR,Norway,2016,155,336,-181
JPN,Japan,NOR,Norway,2017,175,399,-224
JPN,Japan,POL,Poland,2008,782,1056,-274
JPN,Japan,POL,Poland,2009,669,753,-84
JPN,Japan,POL,Poland,2010,573,841,-268
JPN,Japan,POL,Poland,2011,503,698,-195
JPN,Japan,POL,Poland,2012,498,830,-332
JPN,Japan,POL,Poland,2013,549,731,-182
JPN,Japan,POL,Poland,2014,213,809,-596
JPN,Japan,POL,Poland,2015,506,1365,-859
JPN,Japan,POL,Poland,2016,456,1100,-644
JPN,Japan,POL,Poland,2017,392,1031,-639
JPN,Japan,SVK,Slovak Republic,2008,12,263,-251
JPN,Japan,SVK,Slovak Republic,2009,4,178,-174
JPN,Japan,SVK,Slovak Republic,2010,5,285,-280
JPN,Japan,SVK,Slovak Republic,2011,6,140,-134
JPN,Japan,SVK,Slovak Republic,2012,1,306,-305
JPN,Japan,SVK,Slovak Republic,2013,3,232,-229
JPN,Japan,SVK,Slovak Republic,2014,1,190,-189
JPN,Japan,SVK,Slovak Republic,2015,2,279,-277
JPN,Japan,SVK,Slovak Republic,2016,1,212,-211
JPN,Japan,SVK,Slovak Republic,2017,2,179,-177
JPN,Japan,ESP,Spain,2008,572,1139,-567
JPN,Japan,ESP,Spain,2009,562,1177,-615
JPN,Japan,ESP,Spain,2010,558,1007,-449
JPN,Japan,ESP,Spain,2011,737,1028,-291
JPN,Japan,ESP,Spain,2012,794,1248,-454
JPN,Japan,ESP,Spain,2013,717,1480,-763
JPN,Japan,ESP,Spain,2014,701,1506,-805
JPN,Japan,ESP,Spain,2015,710,1827,-1117
JPN,Japan,ESP,Spain,2016,679,1884,-1205
JPN,Japan,ESP,Spain,2017,766,1937,-1171
JPN,Japan,SWE,Sweden,2008,354,835,-481
JPN,Japan,SWE,Sweden,2009,312,829,-517
JPN,Japan,SWE,Sweden,2010,320,1026,-706
JPN,Japan,SWE,Sweden,2011,288,816,-528
JPN,Japan,SWE,Sweden,2012,325,982,-657
JPN,Japan,SWE,Sweden,2013,244,960,-716
JPN,Japan,SWE,Sweden,2014,258,1159,-901
JPN,Japan,SWE,Sweden,2015,222,1061,-839
JPN,Japan,SWE,Sweden,2016,287,982,-695
JPN,Japan,SWE,Sweden,2017,272,988,-716
JPN,Japan,CHE,Switzerland,2010,767,474,293
JPN,Japan,CHE,Switzerland,2011,826,384,442
JPN,Japan,CHE,Switzerland,2012,785,377,408
JPN,Japan,CHE,Switzerland,2013,794,511,283
JPN,Japan,CHE,Switzerland,2014,776,644,132
JPN,Japan,CHE,Switzerland,2015,798,485,313
JPN,Japan,CHE,Switzerland,2016,742,494,248
JPN,Japan,CHE,Switzerland,2017,710,571,139
JPN,Japan,TUR,Turkey,2010,172,855,-683
JPN,Japan,TUR,Turkey,2016,340,895,-555
JPN,Japan,TUR,Turkey,2017,344,955,-611
JPN,Japan,GBR,United Kingdom,2009,6000,5278,722
JPN,Japan,GBR,United Kingdom,2010,4000,5800,-1800
JPN,Japan,GBR,United Kingdom,2011,3000,5160,-2160
JPN,Japan,GBR,United Kingdom,2012,5000,5504,-504
JPN,Japan,GBR,United Kingdom,2013,5000,6138,-1138
JPN,Japan,GBR,United Kingdom,2014,4000,5875,-1875
JPN,Japan,GBR,United Kingdom,2015,7000,6673,327
JPN,Japan,GBR,United Kingdom,2016,5000,6582,-1582
JPN,Japan,USA,United States,2008,6821,24021,-17200
JPN,Japan,USA,United States,2009,7690,23549,-15859
JPN,Japan,USA,United States,2010,6264,22669,-16405
JPN,Japan,USA,United States,2011,6161,19303,-13142
JPN,Japan,USA,United States,2012,6061,20985,-14924
JPN,Japan,USA,United States,2013,5925,21058,-15133
JPN,Japan,USA,United States,2014,5545,22042,-16497
JPN,Japan,USA,United States,2015,5395,21523,-16128
JPN,Japan,USA,United States,2016,5207,22182,-16975
JPN,Japan,USA,United States,2017,4635,21994,-17359
JPN,Japan,CHL,Chile,2008,85,185,-100
JPN,Japan,CHL,Chile,2009,107,172,-65
JPN,Japan,CHL,Chile,2010,61,167,-106
JPN,Japan,CHL,Chile,2011,75,139,-64
JPN,Japan,CHL,Chile,2012,81,124,-43
JPN,Japan,CHL,Chile,2013,60,146,-86
JPN,Japan,CHL,Chile,2014,110,107,3
JPN,Japan,CHL,Chile,2015,98,148,-50
JPN,Japan,CHL,Chile,2016,93,136,-43
JPN,Japan,EST,Estonia,2008,5,71,-66
JPN,Japan,EST,Estonia,2009,12,106,-94
JPN,Japan,EST,Estonia,2010,4,62,-58
JPN,Japan,EST,Estonia,2011,10,71,-61
JPN,Japan,EST,Estonia,2012,8,86,-78
JPN,Japan,EST,Estonia,2013,10,80,-70
JPN,Japan,EST,Estonia,2014,4,87,-83
JPN,Japan,EST,Estonia,2015,21,505,-484
JPN,Japan,EST,Estonia,2016,27,371,-344
JPN,Japan,EST,Estonia,2017,38,98,-60
JPN,Japan,SVN,Slovenia,2008,32,106,-74
JPN,Japan,SVN,Slovenia,2009,25,28,-3
JPN,Japan,SVN,Slovenia,2010,29,56,-27
JPN,Japan,SVN,Slovenia,2011,58,41,17
JPN,Japan,SVN,Slovenia,2012,25,67,-42
JPN,Japan,SVN,Slovenia,2013,31,70,-39
JPN,Japan,SVN,Slovenia,2014,22,325,-303
JPN,Japan,SVN,Slovenia,2015,20,81,-61
JPN,Japan,SVN,Slovenia,2016,16,89,-73
JPN,Japan,SVN,Slovenia,2017,26,87,-61
JOR,Jordan,AUS,Australia,2008,257,81,176
JOR,Jordan,AUS,Australia,2009,328,85,243
JOR,Jordan,AUS,Australia,2010,297,99,198
JOR,Jordan,AUS,Australia,2011,262,67,195
JOR,Jordan,AUS,Australia,2012,337,92,245
JOR,Jordan,AUS,Australia,2013,376,109,267
JOR,Jordan,AUS,Australia,2014,424,123,301
JOR,Jordan,AUS,Australia,2015,412,100,312
JOR,Jordan,AUS,Australia,2016,436,100,336
JOR,Jordan,AUS,Australia,2017,536,0,536
JOR,Jordan,AUT,Austria,2008,49,38,11
JOR,Jordan,AUT,Austria,2009,36,32,4
JOR,Jordan,AUT,Austria,2010,31,38,-7
JOR,Jordan,AUT,Austria,2011,43,27,16
JOR,Jordan,AUT,Austria,2012,70,32,38
JOR,Jordan,AUT,Austria,2013,58,33,25
JOR,Jordan,AUT,Austria,2014,82,29,53
JOR,Jordan,AUT,Austria,2015,65,43,22
JOR,Jordan,AUT,Austria,2016,82,34,48
JOR,Jordan,AUT,Austria,2017,97,39,58
JOR,Jordan,BEL,Belgium,2008,56,0,56
JOR,Jordan,BEL,Belgium,2009,71,0,71
JOR,Jordan,BEL,Belgium,2010,68,29,39
JOR,Jordan,BEL,Belgium,2012,63,38,25
JOR,Jordan,BEL,Belgium,2013,81,41,40
JOR,Jordan,BEL,Belgium,2014,62,40,22
JOR,Jordan,BEL,Belgium,2015,60,29,31
JOR,Jordan,BEL,Belgium,2016,72,31,41
JOR,Jordan,BEL,Belgium,2017,62,14,48
JOR,Jordan,CAN,Canada,2008,1579,0,1579
JOR,Jordan,CAN,Canada,2009,1235,0,1235
JOR,Jordan,CAN,Canada,2010,1831,0,1831
JOR,Jordan,CAN,Canada,2011,1635,0,1635
JOR,Jordan,CAN,Canada,2012,1206,0,1206
JOR,Jordan,CAN,Canada,2013,1255,0,1255
JOR,Jordan,CAN,Canada,2014,1158,0,1158
JOR,Jordan,CAN,Canada,2015,1112,0,1112
JOR,Jordan,CAN,Canada,2016,915,0,915
JOR,Jordan,CAN,Canada,2017,785,0,785
JOR,Jordan,CZE,Czech Republic,2008,26,0,26
JOR,Jordan,CZE,Czech Republic,2009,9,0,9
JOR,Jordan,CZE,Czech Republic,2010,21,2,19
JOR,Jordan,CZE,Czech Republic,2011,17,1,16
JOR,Jordan,CZE,Czech Republic,2012,13,2,11
JOR,Jordan,CZE,Czech Republic,2013,8,10,-2
JOR,Jordan,CZE,Czech Republic,2014,18,5,13
JOR,Jordan,CZE,Czech Republic,2015,16,16,0
JOR,Jordan,CZE,Czech Republic,2016,18,14,4
JOR,Jordan,CZE,Czech Republic,2017,29,21,8
JOR,Jordan,DNK,Denmark,2008,15,9,6
JOR,Jordan,DNK,Denmark,2009,26,3,23
JOR,Jordan,DNK,Denmark,2010,26,8,18
JOR,Jordan,DNK,Denmark,2011,20,11,9
JOR,Jordan,DNK,Denmark,2012,16,10,6
JOR,Jordan,DNK,Denmark,2013,38,7,31
JOR,Jordan,DNK,Denmark,2014,39,7,32
JOR,Jordan,DNK,Denmark,2015,34,11,23
JOR,Jordan,DNK,Denmark,2016,38,18,20
JOR,Jordan,DNK,Denmark,2017,39,15,24
JOR,Jordan,FIN,Finland,2008,9,7,2
JOR,Jordan,FIN,Finland,2009,11,10,1
JOR,Jordan,FIN,Finland,2010,20,3,17
JOR,Jordan,FIN,Finland,2011,18,2,16
JOR,Jordan,FIN,Finland,2012,5,1,4
JOR,Jordan,FIN,Finland,2013,9,2,7
JOR,Jordan,FIN,Finland,2014,17,5,12
JOR,Jordan,FIN,Finland,2015,10,4,6
JOR,Jordan,FIN,Finland,2016,21,4,17
JOR,Jordan,FIN,Finland,2017,29,5,24
JOR,Jordan,FRA,France,2008,44,0,44
JOR,Jordan,FRA,France,2009,48,0,48
JOR,Jordan,FRA,France,2010,72,0,72
JOR,Jordan,FRA,France,2011,55,0,55
JOR,Jordan,FRA,France,2012,63,0,63
JOR,Jordan,FRA,France,2013,60,0,60
JOR,Jordan,FRA,France,2014,67,0,67
JOR,Jordan,FRA,France,2015,68,0,68
JOR,Jordan,FRA,France,2016,68,0,68
JOR,Jordan,FRA,France,2017,72,0,72
JOR,Jordan,DEU,Germany,2008,629,601,28
JOR,Jordan,DEU,Germany,2009,804,769,35
JOR,Jordan,DEU,Germany,2010,879,788,91
JOR,Jordan,DEU,Germany,2011,1062,694,368
JOR,Jordan,DEU,Germany,2012,1242,719,523
JOR,Jordan,DEU,Germany,2013,1367,853,514
JOR,Jordan,DEU,Germany,2014,1413,845,568
JOR,Jordan,DEU,Germany,2015,1574,844,730
JOR,Jordan,DEU,Germany,2016,1689,1046,643
JOR,Jordan,DEU,Germany,2017,1975,1052,923
JOR,Jordan,HUN,Hungary,2008,33,1,32
JOR,Jordan,HUN,Hungary,2009,27,5,22
JOR,Jordan,HUN,Hungary,2010,17,3,14
JOR,Jordan,HUN,Hungary,2011,18,4,14
JOR,Jordan,HUN,Hungary,2012,23,2,21
JOR,Jordan,HUN,Hungary,2013,47,6,41
JOR,Jordan,HUN,Hungary,2014,209,6,203
JOR,Jordan,HUN,Hungary,2015,81,76,5
JOR,Jordan,HUN,Hungary,2016,125,12,113
JOR,Jordan,HUN,Hungary,2017,213,0,213
JOR,Jordan,ISL,Iceland,2008,2,3,-1
JOR,Jordan,ISL,Iceland,2009,0,1,-1
JOR,Jordan,ISL,Iceland,2010,1,0,1
JOR,Jordan,ISL,Iceland,2011,1,0,1
JOR,Jordan,ISL,Iceland,2012,1,0,1
JOR,Jordan,ISL,Iceland,2013,2,1,1
JOR,Jordan,ISL,Iceland,2014,0,1,-1
JOR,Jordan,ISL,Iceland,2015,0,0,0
JOR,Jordan,ISL,Iceland,2016,2,2,0
JOR,Jordan,ISL,Iceland,2017,2,2,0
JOR,Jordan,ITA,Italy,2008,136,9,127
JOR,Jordan,ITA,Italy,2009,99,10,89
JOR,Jordan,ITA,Italy,2010,124,4,120
JOR,Jordan,ITA,Italy,2011,87,12,75
JOR,Jordan,ITA,Italy,2012,103,18,85
JOR,Jordan,ITA,Italy,2013,76,12,64
JOR,Jordan,ITA,Italy,2014,97,4,93
JOR,Jordan,ITA,Italy,2015,96,12,84
JOR,Jordan,ITA,Italy,2016,93,0,93
JOR,Jordan,ITA,Italy,2017,97,16,81
JOR,Jordan,JPN,Japan,2008,186,179,7
JOR,Jordan,JPN,Japan,2009,230,194,36
JOR,Jordan,JPN,Japan,2010,275,269,6
JOR,Jordan,JPN,Japan,2011,145,138,7
JOR,Jordan,JPN,Japan,2012,173,166,7
JOR,Jordan,JPN,Japan,2013,118,116,2
JOR,Jordan,JPN,Japan,2014,268,245,23
JOR,Jordan,JPN,Japan,2015,158,145,13
JOR,Jordan,JPN,Japan,2016,199,180,19
JOR,Jordan,JPN,Japan,2017,186,181,5
JOR,Jordan,KOR,Korea,2008,100,72,28
JOR,Jordan,KOR,Korea,2009,106,101,5
JOR,Jordan,KOR,Korea,2010,147,106,41
JOR,Jordan,KOR,Korea,2011,153,141,12
JOR,Jordan,KOR,Korea,2012,182,222,-40
JOR,Jordan,KOR,Korea,2013,95,135,-40
JOR,Jordan,KOR,Korea,2014,137,154,-17
JOR,Jordan,KOR,Korea,2015,91,132,-41
JOR,Jordan,KOR,Korea,2016,115,127,-12
JOR,Jordan,KOR,Korea,2017,86,110,-24
JOR,Jordan,LUX,Luxembourg,2008,1,0,1
JOR,Jordan,LUX,Luxembourg,2009,1,2,-1
JOR,Jordan,LUX,Luxembourg,2010,2,2,0
JOR,Jordan,LUX,Luxembourg,2011,0,0,0
JOR,Jordan,LUX,Luxembourg,2012,2,0,2
JOR,Jordan,LUX,Luxembourg,2013,0,1,-1
JOR,Jordan,LUX,Luxembourg,2014,2,0,2
JOR,Jordan,LUX,Luxembourg,2015,9,0,9
JOR,Jordan,LUX,Luxembourg,2016,5,0,5
JOR,Jordan,LUX,Luxembourg,2017,4,1,3
JOR,Jordan,MEX,Mexico,2008,8,0,8
JOR,Jordan,MEX,Mexico,2009,16,0,16
JOR,Jordan,MEX,Mexico,2010,6,0,6
JOR,Jordan,MEX,Mexico,2011,6,0,6
JOR,Jordan,MEX,Mexico,2012,8,0,8
JOR,Jordan,MEX,Mexico,2013,12,0,12
JOR,Jordan,MEX,Mexico,2014,9,0,9
JOR,Jordan,MEX,Mexico,2015,11,0,11
JOR,Jordan,MEX,Mexico,2016,10,0,10
JOR,Jordan,MEX,Mexico,2017,4,0,4
JOR,Jordan,NLD,Netherlands,2008,37,16,21
JOR,Jordan,NLD,Netherlands,2009,28,18,10
JOR,Jordan,NLD,Netherlands,2010,24,18,6
JOR,Jordan,NLD,Netherlands,2011,30,10,20
JOR,Jordan,NLD,Netherlands,2012,40,27,13
JOR,Jordan,NLD,Netherlands,2013,31,20,11
JOR,Jordan,NLD,Netherlands,2014,55,16,39
JOR,Jordan,NLD,Netherlands,2015,103,36,67
JOR,Jordan,NLD,Netherlands,2016,94,21,73
JOR,Jordan,NLD,Netherlands,2017,131,36,95
JOR,Jordan,NZL,New Zealand,2008,69,3,66
JOR,Jordan,NZL,New Zealand,2009,30,4,26
JOR,Jordan,NZL,New Zealand,2010,44,8,36
JOR,Jordan,NZL,New Zealand,2011,38,13,25
JOR,Jordan,NZL,New Zealand,2012,43,10,33
JOR,Jordan,NZL,New Zealand,2013,71,11,60
JOR,Jordan,NZL,New Zealand,2014,67,5,62
JOR,Jordan,NZL,New Zealand,2015,89,9,80
JOR,Jordan,NZL,New Zealand,2016,90,11,79
JOR,Jordan,NZL,New Zealand,2017,99,11,88
JOR,Jordan,NOR,Norway,2008,29,8,21
JOR,Jordan,NOR,Norway,2009,43,9,34
JOR,Jordan,NOR,Norway,2010,17,6,11
JOR,Jordan,NOR,Norway,2011,32,10,22
JOR,Jordan,NOR,Norway,2012,26,13,13
JOR,Jordan,NOR,Norway,2013,29,19,10
JOR,Jordan,NOR,Norway,2014,34,12,22
JOR,Jordan,NOR,Norway,2015,32,8,24
JOR,Jordan,NOR,Norway,2016,38,22,16
JOR,Jordan,NOR,Norway,2017,29,12,17
JOR,Jordan,POL,Poland,2008,41,0,41
JOR,Jordan,POL,Poland,2009,45,0,45
JOR,Jordan,POL,Poland,2010,42,0,42
JOR,Jordan,POL,Poland,2011,56,0,56
JOR,Jordan,POL,Poland,2012,41,0,41
JOR,Jordan,POL,Poland,2013,65,0,65
JOR,Jordan,POL,Poland,2014,37,0,37
JOR,Jordan,POL,Poland,2015,85,0,85
JOR,Jordan,POL,Poland,2016,103,0,103
JOR,Jordan,POL,Poland,2017,105,0,105
JOR,Jordan,SVK,Slovak Republic,2008,4,2,2
JOR,Jordan,SVK,Slovak Republic,2009,2,1,1
JOR,Jordan,SVK,Slovak Republic,2010,3,2,1
JOR,Jordan,SVK,Slovak Republic,2011,2,2,0
JOR,Jordan,SVK,Slovak Republic,2012,1,0,1
JOR,Jordan,SVK,Slovak Republic,2013,5,0,5
JOR,Jordan,SVK,Slovak Republic,2014,1,1,0
JOR,Jordan,SVK,Slovak Republic,2015,1,0,1
JOR,Jordan,SVK,Slovak Republic,2016,1,0,1
JOR,Jordan,ESP,Spain,2008,101,94,7
JOR,Jordan,ESP,Spain,2009,102,77,25
JOR,Jordan,ESP,Spain,2010,119,75,44
JOR,Jordan,ESP,Spain,2011,135,105,30
JOR,Jordan,ESP,Spain,2012,123,42,81
JOR,Jordan,ESP,Spain,2013,168,60,108
JOR,Jordan,ESP,Spain,2014,190,78,112
JOR,Jordan,ESP,Spain,2015,185,83,102
JOR,Jordan,ESP,Spain,2016,173,83,90
JOR,Jordan,ESP,Spain,2017,207,113,94
JOR,Jordan,SWE,Sweden,2008,253,28,225
JOR,Jordan,SWE,Sweden,2009,277,13,264
JOR,Jordan,SWE,Sweden,2010,249,22,227
JOR,Jordan,SWE,Sweden,2011,283,28,255
JOR,Jordan,SWE,Sweden,2012,291,46,245
JOR,Jordan,SWE,Sweden,2013,226,45,181
JOR,Jordan,SWE,Sweden,2014,328,64,264
JOR,Jordan,SWE,Sweden,2015,272,88,184
JOR,Jordan,SWE,Sweden,2016,289,51,238
JOR,Jordan,SWE,Sweden,2017,282,61,221
JOR,Jordan,CHE,Switzerland,2010,53,43,10
JOR,Jordan,CHE,Switzerland,2011,65,24,41
JOR,Jordan,CHE,Switzerland,2012,52,21,31
JOR,Jordan,CHE,Switzerland,2013,52,32,20
JOR,Jordan,CHE,Switzerland,2014,50,29,21
JOR,Jordan,CHE,Switzerland,2015,69,36,33
JOR,Jordan,CHE,Switzerland,2016,51,37,14
JOR,Jordan,CHE,Switzerland,2017,70,35,35
JOR,Jordan,TUR,Turkey,2010,113,0,113
JOR,Jordan,TUR,Turkey,2016,1744,425,1319
JOR,Jordan,TUR,Turkey,2017,2930,959,1971
JOR,Jordan,GBR,United Kingdom,2011,2000,0,2000
JOR,Jordan,GBR,United Kingdom,2014,1000,0,1000
JOR,Jordan,USA,United States,2008,3936,0,3936
JOR,Jordan,USA,United States,2009,4282,0,4282
JOR,Jordan,USA,United States,2010,3868,0,3868
JOR,Jordan,USA,United States,2011,3876,0,3876
JOR,Jordan,USA,United States,2012,4099,0,4099
JOR,Jordan,USA,United States,2013,4188,0,4188
JOR,Jordan,USA,United States,2014,5187,0,5187
JOR,Jordan,USA,United States,2015,4664,0,4664
JOR,Jordan,USA,United States,2016,5269,0,5269
JOR,Jordan,USA,United States,2017,5264,0,5264
JOR,Jordan,CHL,Chile,2008,1,0,1
JOR,Jordan,CHL,Chile,2009,6,0,6
JOR,Jordan,CHL,Chile,2010,10,0,10
JOR,Jordan,CHL,Chile,2011,3,0,3
JOR,Jordan,CHL,Chile,2012,15,0,15
JOR,Jordan,CHL,Chile,2013,7,0,7
JOR,Jordan,CHL,Chile,2014,7,0,7
JOR,Jordan,CHL,Chile,2015,14,0,14
JOR,Jordan,CHL,Chile,2016,11,0,11
JOR,Jordan,EST,Estonia,2008,0,0,0
JOR,Jordan,EST,Estonia,2009,1,0,1
JOR,Jordan,EST,Estonia,2010,0,0,0
JOR,Jordan,EST,Estonia,2011,1,0,1
JOR,Jordan,EST,Estonia,2012,3,0,3
JOR,Jordan,EST,Estonia,2013,1,0,1
JOR,Jordan,EST,Estonia,2014,1,0,1
JOR,Jordan,EST,Estonia,2015,4,0,4
JOR,Jordan,EST,Estonia,2016,5,0,5
JOR,Jordan,EST,Estonia,2017,9,0,9
JOR,Jordan,SVN,Slovenia,2008,3,0,3
JOR,Jordan,SVN,Slovenia,2010,1,0,1
JOR,Jordan,SVN,Slovenia,2011,1,0,1
JOR,Jordan,SVN,Slovenia,2012,2,1,1
JOR,Jordan,SVN,Slovenia,2013,3,0,3
JOR,Jordan,SVN,Slovenia,2014,1,1,0
JOR,Jordan,SVN,Slovenia,2016,5,0,5
JOR,Jordan,SVN,Slovenia,2017,6,0,6
KAZ,Kazakhstan,AUS,Australia,2008,62,8,54
KAZ,Kazakhstan,AUS,Australia,2009,102,13,89
KAZ,Kazakhstan,AUS,Australia,2010,49,9,40
KAZ,Kazakhstan,AUS,Australia,2011,61,7,54
KAZ,Kazakhstan,AUS,Australia,2012,77,11,66
KAZ,Kazakhstan,AUS,Australia,2013,110,12,98
KAZ,Kazakhstan,AUS,Australia,2014,70,15,55
KAZ,Kazakhstan,AUS,Australia,2015,113,0,113
KAZ,Kazakhstan,AUS,Australia,2016,101,0,101
KAZ,Kazakhstan,AUS,Australia,2017,84,0,84
KAZ,Kazakhstan,AUT,Austria,2008,51,30,21
KAZ,Kazakhstan,AUT,Austria,2009,100,32,68
KAZ,Kazakhstan,AUT,Austria,2010,112,64,48
KAZ,Kazakhstan,AUT,Austria,2011,137,57,80
KAZ,Kazakhstan,AUT,Austria,2012,202,82,120
KAZ,Kazakhstan,AUT,Austria,2013,286,96,190
KAZ,Kazakhstan,AUT,Austria,2014,298,139,159
KAZ,Kazakhstan,AUT,Austria,2015,324,151,173
KAZ,Kazakhstan,AUT,Austria,2016,261,161,100
KAZ,Kazakhstan,AUT,Austria,2017,276,203,73
KAZ,Kazakhstan,BEL,Belgium,2008,63,0,63
KAZ,Kazakhstan,BEL,Belgium,2009,67,0,67
KAZ,Kazakhstan,BEL,Belgium,2010,84,18,66
KAZ,Kazakhstan,BEL,Belgium,2012,242,148,94
KAZ,Kazakhstan,BEL,Belgium,2013,109,235,-126
KAZ,Kazakhstan,BEL,Belgium,2014,63,113,-50
KAZ,Kazakhstan,BEL,Belgium,2015,43,77,-34
KAZ,Kazakhstan,BEL,Belgium,2016,43,23,20
KAZ,Kazakhstan,BEL,Belgium,2017,72,21,51
KAZ,Kazakhstan,CAN,Canada,2008,394,0,394
KAZ,Kazakhstan,CAN,Canada,2009,431,0,431
KAZ,Kazakhstan,CAN,Canada,2010,377,0,377
KAZ,Kazakhstan,CAN,Canada,2011,381,0,381
KAZ,Kazakhstan,CAN,Canada,2012,462,0,462
KAZ,Kazakhstan,CAN,Canada,2013,347,0,347
KAZ,Kazakhstan,CAN,Canada,2014,293,0,293
KAZ,Kazakhstan,CAN,Canada,2015,327,0,327
KAZ,Kazakhstan,CAN,Canada,2016,400,0,400
KAZ,Kazakhstan,CAN,Canada,2017,335,0,335
KAZ,Kazakhstan,CZE,Czech Republic,2008,706,4,702
KAZ,Kazakhstan,CZE,Czech Republic,2009,780,3,777
KAZ,Kazakhstan,CZE,Czech Republic,2010,716,4,712
KAZ,Kazakhstan,CZE,Czech Republic,2011,516,2,514
KAZ,Kazakhstan,CZE,Czech Republic,2012,642,285,357
KAZ,Kazakhstan,CZE,Czech Republic,2013,618,633,-15
KAZ,Kazakhstan,CZE,Czech Republic,2014,1018,344,674
KAZ,Kazakhstan,CZE,Czech Republic,2015,689,399,290
KAZ,Kazakhstan,CZE,Czech Republic,2016,612,474,138
KAZ,Kazakhstan,CZE,Czech Republic,2017,623,437,186
KAZ,Kazakhstan,DNK,Denmark,2008,3,8,-5
KAZ,Kazakhstan,DNK,Denmark,2009,6,6,0
KAZ,Kazakhstan,DNK,Denmark,2010,16,4,12
KAZ,Kazakhstan,DNK,Denmark,2011,14,1,13
KAZ,Kazakhstan,DNK,Denmark,2012,25,6,19
KAZ,Kazakhstan,DNK,Denmark,2013,11,20,-9
KAZ,Kazakhstan,DNK,Denmark,2014,19,12,7
KAZ,Kazakhstan,DNK,Denmark,2015,16,8,8
KAZ,Kazakhstan,DNK,Denmark,2016,21,22,-1
KAZ,Kazakhstan,DNK,Denmark,2017,21,28,-7
KAZ,Kazakhstan,FIN,Finland,2008,34,2,32
KAZ,Kazakhstan,FIN,Finland,2009,15,4,11
KAZ,Kazakhstan,FIN,Finland,2010,10,2,8
KAZ,Kazakhstan,FIN,Finland,2011,22,1,21
KAZ,Kazakhstan,FIN,Finland,2012,22,4,18
KAZ,Kazakhstan,FIN,Finland,2013,26,7,19
KAZ,Kazakhstan,FIN,Finland,2014,33,3,30
KAZ,Kazakhstan,FIN,Finland,2015,37,2,35
KAZ,Kazakhstan,FIN,Finland,2016,36,5,31
KAZ,Kazakhstan,FIN,Finland,2017,24,7,17
KAZ,Kazakhstan,FRA,France,2008,111,0,111
KAZ,Kazakhstan,FRA,France,2009,86,0,86
KAZ,Kazakhstan,FRA,France,2010,116,0,116
KAZ,Kazakhstan,FRA,France,2011,100,0,100
KAZ,Kazakhstan,FRA,France,2012,140,0,140
KAZ,Kazakhstan,FRA,France,2013,165,0,165
KAZ,Kazakhstan,FRA,France,2014,177,0,177
KAZ,Kazakhstan,FRA,France,2015,151,0,151
KAZ,Kazakhstan,FRA,France,2016,159,0,159
KAZ,Kazakhstan,FRA,France,2017,157,0,157
KAZ,Kazakhstan,DEU,Germany,2008,1883,1525,358
KAZ,Kazakhstan,DEU,Germany,2009,1820,1306,514
KAZ,Kazakhstan,DEU,Germany,2010,1637,1200,437
KAZ,Kazakhstan,DEU,Germany,2011,1717,1085,632
KAZ,Kazakhstan,DEU,Germany,2012,1728,1043,685
KAZ,Kazakhstan,DEU,Germany,2013,2034,1133,901
KAZ,Kazakhstan,DEU,Germany,2014,2557,1204,1353
KAZ,Kazakhstan,DEU,Germany,2015,2126,1091,1035
KAZ,Kazakhstan,DEU,Germany,2016,2456,911,1545
KAZ,Kazakhstan,DEU,Germany,2017,2339,935,1404
KAZ,Kazakhstan,HUN,Hungary,2008,46,1,45
KAZ,Kazakhstan,HUN,Hungary,2009,49,6,43
KAZ,Kazakhstan,HUN,Hungary,2010,69,3,66
KAZ,Kazakhstan,HUN,Hungary,2011,54,14,40
KAZ,Kazakhstan,HUN,Hungary,2012,91,8,83
KAZ,Kazakhstan,HUN,Hungary,2013,121,5,116
KAZ,Kazakhstan,HUN,Hungary,2014,186,3,183
KAZ,Kazakhstan,HUN,Hungary,2015,141,32,109
KAZ,Kazakhstan,HUN,Hungary,2016,161,26,135
KAZ,Kazakhstan,HUN,Hungary,2017,224,0,224
KAZ,Kazakhstan,ISL,Iceland,2008,2,1,1
KAZ,Kazakhstan,ISL,Iceland,2009,1,1,0
KAZ,Kazakhstan,ISL,Iceland,2010,1,1,0
KAZ,Kazakhstan,ISL,Iceland,2011,0,0,0
KAZ,Kazakhstan,ISL,Iceland,2012,0,1,-1
KAZ,Kazakhstan,ISL,Iceland,2013,1,0,1
KAZ,Kazakhstan,ISL,Iceland,2014,0,0,0
KAZ,Kazakhstan,ISL,Iceland,2015,2,1,1
KAZ,Kazakhstan,ISL,Iceland,2016,5,0,5
KAZ,Kazakhstan,ISL,Iceland,2017,1,0,1
KAZ,Kazakhstan,ITA,Italy,2008,211,14,197
KAZ,Kazakhstan,ITA,Italy,2009,191,15,176
KAZ,Kazakhstan,ITA,Italy,2010,198,29,169
KAZ,Kazakhstan,ITA,Italy,2011,196,87,109
KAZ,Kazakhstan,ITA,Italy,2012,191,19,172
KAZ,Kazakhstan,ITA,Italy,2013,217,18,199
KAZ,Kazakhstan,ITA,Italy,2014,174,41,133
KAZ,Kazakhstan,ITA,Italy,2015,179,30,149
KAZ,Kazakhstan,ITA,Italy,2016,184,0,184
KAZ,Kazakhstan,ITA,Italy,2017,146,44,102
KAZ,Kazakhstan,JPN,Japan,2008,287,271,16
KAZ,Kazakhstan,JPN,Japan,2009,203,184,19
KAZ,Kazakhstan,JPN,Japan,2010,275,263,12
KAZ,Kazakhstan,JPN,Japan,2011,177,158,19
KAZ,Kazakhstan,JPN,Japan,2012,227,211,16
KAZ,Kazakhstan,JPN,Japan,2013,253,220,33
KAZ,Kazakhstan,JPN,Japan,2014,202,154,48
KAZ,Kazakhstan,JPN,Japan,2015,286,213,73
KAZ,Kazakhstan,JPN,Japan,2016,416,327,89
KAZ,Kazakhstan,JPN,Japan,2017,299,245,54
KAZ,Kazakhstan,KOR,Korea,2008,459,679,-220
KAZ,Kazakhstan,KOR,Korea,2009,489,750,-261
KAZ,Kazakhstan,KOR,Korea,2010,755,615,140
KAZ,Kazakhstan,KOR,Korea,2011,774,687,87
KAZ,Kazakhstan,KOR,Korea,2012,1098,750,348
KAZ,Kazakhstan,KOR,Korea,2013,1130,925,205
KAZ,Kazakhstan,KOR,Korea,2014,1431,968,463
KAZ,Kazakhstan,KOR,Korea,2015,3534,1239,2295
KAZ,Kazakhstan,KOR,Korea,2016,7711,2707,5004
KAZ,Kazakhstan,KOR,Korea,2017,13356,3886,9470
KAZ,Kazakhstan,LUX,Luxembourg,2008,4,3,1
KAZ,Kazakhstan,LUX,Luxembourg,2009,5,5,0
KAZ,Kazakhstan,LUX,Luxembourg,2010,6,0,6
KAZ,Kazakhstan,LUX,Luxembourg,2011,7,3,4
KAZ,Kazakhstan,LUX,Luxembourg,2012,1,2,-1
KAZ,Kazakhstan,LUX,Luxembourg,2013,16,5,11
KAZ,Kazakhstan,LUX,Luxembourg,2014,7,5,2
KAZ,Kazakhstan,LUX,Luxembourg,2015,4,7,-3
KAZ,Kazakhstan,LUX,Luxembourg,2016,13,5,8
KAZ,Kazakhstan,LUX,Luxembourg,2017,15,6,9
KAZ,Kazakhstan,MEX,Mexico,2010,2,0,2
KAZ,Kazakhstan,MEX,Mexico,2011,1,0,1
KAZ,Kazakhstan,MEX,Mexico,2012,3,0,3
KAZ,Kazakhstan,MEX,Mexico,2013,7,0,7
KAZ,Kazakhstan,MEX,Mexico,2014,3,0,3
KAZ,Kazakhstan,MEX,Mexico,2015,3,0,3
KAZ,Kazakhstan,MEX,Mexico,2016,1,0,1
KAZ,Kazakhstan,MEX,Mexico,2017,7,0,7
KAZ,Kazakhstan,NLD,Netherlands,2008,74,46,28
KAZ,Kazakhstan,NLD,Netherlands,2009,68,33,35
KAZ,Kazakhstan,NLD,Netherlands,2010,126,59,67
KAZ,Kazakhstan,NLD,Netherlands,2011,107,66,41
KAZ,Kazakhstan,NLD,Netherlands,2012,91,67,24
KAZ,Kazakhstan,NLD,Netherlands,2013,93,88,5
KAZ,Kazakhstan,NLD,Netherlands,2014,120,56,64
KAZ,Kazakhstan,NLD,Netherlands,2015,130,78,52
KAZ,Kazakhstan,NLD,Netherlands,2016,150,74,76
KAZ,Kazakhstan,NLD,Netherlands,2017,159,68,91
KAZ,Kazakhstan,NZL,New Zealand,2008,21,1,20
KAZ,Kazakhstan,NZL,New Zealand,2009,27,10,17
KAZ,Kazakhstan,NZL,New Zealand,2010,30,9,21
KAZ,Kazakhstan,NZL,New Zealand,2011,25,9,16
KAZ,Kazakhstan,NZL,New Zealand,2012,19,12,7
KAZ,Kazakhstan,NZL,New Zealand,2013,36,9,27
KAZ,Kazakhstan,NZL,New Zealand,2014,28,11,17
KAZ,Kazakhstan,NZL,New Zealand,2015,29,3,26
KAZ,Kazakhstan,NZL,New Zealand,2016,49,4,45
KAZ,Kazakhstan,NZL,New Zealand,2017,87,3,84
KAZ,Kazakhstan,NOR,Norway,2008,23,6,17
KAZ,Kazakhstan,NOR,Norway,2009,45,10,35
KAZ,Kazakhstan,NOR,Norway,2010,37,23,14
KAZ,Kazakhstan,NOR,Norway,2011,41,32,9
KAZ,Kazakhstan,NOR,Norway,2012,56,19,37
KAZ,Kazakhstan,NOR,Norway,2013,53,23,30
KAZ,Kazakhstan,NOR,Norway,2014,47,27,20
KAZ,Kazakhstan,NOR,Norway,2015,23,20,3
KAZ,Kazakhstan,NOR,Norway,2016,23,37,-14
KAZ,Kazakhstan,NOR,Norway,2017,28,20,8
KAZ,Kazakhstan,POL,Poland,2008,442,0,442
KAZ,Kazakhstan,POL,Poland,2009,447,0,447
KAZ,Kazakhstan,POL,Poland,2010,398,0,398
KAZ,Kazakhstan,POL,Poland,2011,348,0,348
KAZ,Kazakhstan,POL,Poland,2012,309,0,309
KAZ,Kazakhstan,POL,Poland,2013,349,0,349
KAZ,Kazakhstan,POL,Poland,2014,247,0,247
KAZ,Kazakhstan,POL,Poland,2015,455,0,455
KAZ,Kazakhstan,POL,Poland,2016,512,0,512
KAZ,Kazakhstan,POL,Poland,2017,462,0,462
KAZ,Kazakhstan,SVK,Slovak Republic,2008,1,6,-5
KAZ,Kazakhstan,SVK,Slovak Republic,2009,3,3,0
KAZ,Kazakhstan,SVK,Slovak Republic,2010,2,2,0
KAZ,Kazakhstan,SVK,Slovak Republic,2011,3,1,2
KAZ,Kazakhstan,SVK,Slovak Republic,2013,1,0,1
KAZ,Kazakhstan,SVK,Slovak Republic,2014,3,0,3
KAZ,Kazakhstan,SVK,Slovak Republic,2015,4,0,4
KAZ,Kazakhstan,SVK,Slovak Republic,2016,2,0,2
KAZ,Kazakhstan,SVK,Slovak Republic,2017,3,0,3
KAZ,Kazakhstan,ESP,Spain,2008,155,57,98
KAZ,Kazakhstan,ESP,Spain,2009,191,70,121
KAZ,Kazakhstan,ESP,Spain,2010,188,62,126
KAZ,Kazakhstan,ESP,Spain,2011,223,91,132
KAZ,Kazakhstan,ESP,Spain,2012,262,87,175
KAZ,Kazakhstan,ESP,Spain,2013,259,118,141
KAZ,Kazakhstan,ESP,Spain,2014,353,118,235
KAZ,Kazakhstan,ESP,Spain,2015,358,103,255
KAZ,Kazakhstan,ESP,Spain,2016,374,131,243
KAZ,Kazakhstan,ESP,Spain,2017,424,189,235
KAZ,Kazakhstan,SWE,Sweden,2008,48,5,43
KAZ,Kazakhstan,SWE,Sweden,2009,80,1,79
KAZ,Kazakhstan,SWE,Sweden,2010,128,10,118
KAZ,Kazakhstan,SWE,Sweden,2011,136,5,131
KAZ,Kazakhstan,SWE,Sweden,2012,149,15,134
KAZ,Kazakhstan,SWE,Sweden,2013,172,20,152
KAZ,Kazakhstan,SWE,Sweden,2014,128,20,108
KAZ,Kazakhstan,SWE,Sweden,2015,128,33,95
KAZ,Kazakhstan,SWE,Sweden,2016,157,30,127
KAZ,Kazakhstan,SWE,Sweden,2017,100,24,76
KAZ,Kazakhstan,CHE,Switzerland,2010,249,127,122
KAZ,Kazakhstan,CHE,Switzerland,2011,211,159,52
KAZ,Kazakhstan,CHE,Switzerland,2012,207,163,44
KAZ,Kazakhstan,CHE,Switzerland,2013,189,134,55
KAZ,Kazakhstan,CHE,Switzerland,2014,194,132,62
KAZ,Kazakhstan,CHE,Switzerland,2015,201,137,64
KAZ,Kazakhstan,CHE,Switzerland,2016,145,148,-3
KAZ,Kazakhstan,CHE,Switzerland,2017,149,116,33
KAZ,Kazakhstan,TUR,Turkey,2010,1365,0,1365
KAZ,Kazakhstan,TUR,Turkey,2016,3644,2296,1348
KAZ,Kazakhstan,TUR,Turkey,2017,4318,3604,714
KAZ,Kazakhstan,GBR,United Kingdom,2011,2000,0,2000
KAZ,Kazakhstan,GBR,United Kingdom,2013,1000,0,1000
KAZ,Kazakhstan,GBR,United Kingdom,2014,2000,1000,1000
KAZ,Kazakhstan,GBR,United Kingdom,2015,1000,0,1000
KAZ,Kazakhstan,USA,United States,2008,1630,0,1630
KAZ,Kazakhstan,USA,United States,2009,1562,0,1562
KAZ,Kazakhstan,USA,United States,2010,1282,0,1282
KAZ,Kazakhstan,USA,United States,2011,1235,0,1235
KAZ,Kazakhstan,USA,United States,2012,1202,0,1202
KAZ,Kazakhstan,USA,United States,2013,1241,0,1241
KAZ,Kazakhstan,USA,United States,2014,1221,0,1221
KAZ,Kazakhstan,USA,United States,2015,1201,0,1201
KAZ,Kazakhstan,USA,United States,2016,1310,0,1310
KAZ,Kazakhstan,USA,United States,2017,1377,0,1377
KAZ,Kazakhstan,CHL,Chile,2008,0,0,0
KAZ,Kazakhstan,CHL,Chile,2009,2,0,2
KAZ,Kazakhstan,CHL,Chile,2010,1,0,1
KAZ,Kazakhstan,CHL,Chile,2011,0,0,0
KAZ,Kazakhstan,CHL,Chile,2012,3,0,3
KAZ,Kazakhstan,CHL,Chile,2013,1,0,1
KAZ,Kazakhstan,CHL,Chile,2014,0,0,0
KAZ,Kazakhstan,CHL,Chile,2015,1,0,1
KAZ,Kazakhstan,CHL,Chile,2016,3,0,3
KAZ,Kazakhstan,EST,Estonia,2008,5,0,5
KAZ,Kazakhstan,EST,Estonia,2009,5,0,5
KAZ,Kazakhstan,EST,Estonia,2010,2,0,2
KAZ,Kazakhstan,EST,Estonia,2011,12,0,12
KAZ,Kazakhstan,EST,Estonia,2012,18,0,18
KAZ,Kazakhstan,EST,Estonia,2013,16,0,16
KAZ,Kazakhstan,EST,Estonia,2014,6,0,6
KAZ,Kazakhstan,EST,Estonia,2015,28,0,28
KAZ,Kazakhstan,EST,Estonia,2016,35,0,35
KAZ,Kazakhstan,EST,Estonia,2017,28,0,28
KAZ,Kazakhstan,SVN,Slovenia,2008,26,0,26
KAZ,Kazakhstan,SVN,Slovenia,2009,8,0,8
KAZ,Kazakhstan,SVN,Slovenia,2010,17,0,17
KAZ,Kazakhstan,SVN,Slovenia,2011,9,1,8
KAZ,Kazakhstan,SVN,Slovenia,2012,26,0,26
KAZ,Kazakhstan,SVN,Slovenia,2013,26,0,26
KAZ,Kazakhstan,SVN,Slovenia,2014,33,0,33
KAZ,Kazakhstan,SVN,Slovenia,2015,26,0,26
KAZ,Kazakhstan,SVN,Slovenia,2016,32,1,31
KAZ,Kazakhstan,SVN,Slovenia,2017,25,0,25
KEN,Kenya,AUS,Australia,2008,418,83,335
KEN,Kenya,AUS,Australia,2009,487,77,410
KEN,Kenya,AUS,Australia,2010,407,88,319
KEN,Kenya,AUS,Australia,2011,510,110,400
KEN,Kenya,AUS,Australia,2012,554,125,429
KEN,Kenya,AUS,Australia,2013,532,119,413
KEN,Kenya,AUS,Australia,2014,397,130,267
KEN,Kenya,AUS,Australia,2015,883,100,783
KEN,Kenya,AUS,Australia,2016,629,100,529
KEN,Kenya,AUS,Australia,2017,560,0,560
KEN,Kenya,AUT,Austria,2008,124,67,57
KEN,Kenya,AUT,Austria,2009,123,62,61
KEN,Kenya,AUT,Austria,2010,131,81,50
KEN,Kenya,AUT,Austria,2011,129,85,44
KEN,Kenya,AUT,Austria,2012,114,70,44
KEN,Kenya,AUT,Austria,2013,75,57,18
KEN,Kenya,AUT,Austria,2014,88,43,45
KEN,Kenya,AUT,Austria,2015,99,60,39
KEN,Kenya,AUT,Austria,2016,109,46,63
KEN,Kenya,AUT,Austria,2017,82,50,32
KEN,Kenya,BEL,Belgium,2008,76,0,76
KEN,Kenya,BEL,Belgium,2009,90,0,90
KEN,Kenya,BEL,Belgium,2010,100,40,60
KEN,Kenya,BEL,Belgium,2011,98,0,98
KEN,Kenya,BEL,Belgium,2012,101,80,21
KEN,Kenya,BEL,Belgium,2013,92,83,9
KEN,Kenya,BEL,Belgium,2014,100,79,21
KEN,Kenya,BEL,Belgium,2015,82,67,15
KEN,Kenya,BEL,Belgium,2016,111,36,75
KEN,Kenya,BEL,Belgium,2017,103,40,63
KEN,Kenya,CAN,Canada,2008,453,0,453
KEN,Kenya,CAN,Canada,2009,489,0,489
KEN,Kenya,CAN,Canada,2010,507,0,507
KEN,Kenya,CAN,Canada,2011,585,0,585
KEN,Kenya,CAN,Canada,2012,718,0,718
KEN,Kenya,CAN,Canada,2013,664,0,664
KEN,Kenya,CAN,Canada,2014,455,0,455
KEN,Kenya,CAN,Canada,2015,383,0,383
KEN,Kenya,CAN,Canada,2016,480,0,480
KEN,Kenya,CAN,Canada,2017,465,0,465
KEN,Kenya,CZE,Czech Republic,2008,5,0,5
KEN,Kenya,CZE,Czech Republic,2009,5,1,4
KEN,Kenya,CZE,Czech Republic,2010,6,0,6
KEN,Kenya,CZE,Czech Republic,2011,5,0,5
KEN,Kenya,CZE,Czech Republic,2012,8,3,5
KEN,Kenya,CZE,Czech Republic,2013,4,5,-1
KEN,Kenya,CZE,Czech Republic,2014,21,5,16
KEN,Kenya,CZE,Czech Republic,2015,13,9,4
KEN,Kenya,CZE,Czech Republic,2016,14,7,7
KEN,Kenya,CZE,Czech Republic,2017,17,0,17
KEN,Kenya,DNK,Denmark,2008,81,16,65
KEN,Kenya,DNK,Denmark,2009,64,18,46
KEN,Kenya,DNK,Denmark,2010,69,38,31
KEN,Kenya,DNK,Denmark,2011,72,20,52
KEN,Kenya,DNK,Denmark,2012,70,33,37
KEN,Kenya,DNK,Denmark,2013,101,38,63
KEN,Kenya,DNK,Denmark,2014,95,44,51
KEN,Kenya,DNK,Denmark,2015,73,57,16
KEN,Kenya,DNK,Denmark,2016,96,68,28
KEN,Kenya,DNK,Denmark,2017,85,43,42
KEN,Kenya,FIN,Finland,2008,112,10,102
KEN,Kenya,FIN,Finland,2009,75,12,63
KEN,Kenya,FIN,Finland,2010,60,6,54
KEN,Kenya,FIN,Finland,2011,70,5,65
KEN,Kenya,FIN,Finland,2012,93,14,79
KEN,Kenya,FIN,Finland,2013,131,15,116
KEN,Kenya,FIN,Finland,2014,91,9,82
KEN,Kenya,FIN,Finland,2015,97,8,89
KEN,Kenya,FIN,Finland,2016,79,14,65
KEN,Kenya,FIN,Finland,2017,60,13,47
KEN,Kenya,FRA,France,2008,80,0,80
KEN,Kenya,FRA,France,2009,69,0,69
KEN,Kenya,FRA,France,2010,68,0,68
KEN,Kenya,FRA,France,2011,63,0,63
KEN,Kenya,FRA,France,2012,87,0,87
KEN,Kenya,FRA,France,2013,71,0,71
KEN,Kenya,FRA,France,2014,94,0,94
KEN,Kenya,FRA,France,2015,91,0,91
KEN,Kenya,FRA,France,2016,83,0,83
KEN,Kenya,FRA,France,2017,69,0,69
KEN,Kenya,DEU,Germany,2008,1255,750,505
KEN,Kenya,DEU,Germany,2009,1462,787,675
KEN,Kenya,DEU,Germany,2010,1502,813,689
KEN,Kenya,DEU,Germany,2011,1030,685,345
KEN,Kenya,DEU,Germany,2012,1034,545,489
KEN,Kenya,DEU,Germany,2013,876,472,404
KEN,Kenya,DEU,Germany,2014,867,422,445
KEN,Kenya,DEU,Germany,2015,877,464,413
KEN,Kenya,DEU,Germany,2016,991,503,488
KEN,Kenya,DEU,Germany,2017,1092,436,656
KEN,Kenya,HUN,Hungary,2008,13,1,12
KEN,Kenya,HUN,Hungary,2009,24,0,24
KEN,Kenya,HUN,Hungary,2010,19,1,18
KEN,Kenya,HUN,Hungary,2011,15,7,8
KEN,Kenya,HUN,Hungary,2012,25,1,24
KEN,Kenya,HUN,Hungary,2013,18,5,13
KEN,Kenya,HUN,Hungary,2014,14,1,13
KEN,Kenya,HUN,Hungary,2015,20,4,16
KEN,Kenya,HUN,Hungary,2016,46,8,38
KEN,Kenya,HUN,Hungary,2017,60,0,60
KEN,Kenya,ISL,Iceland,2008,9,11,-2
KEN,Kenya,ISL,Iceland,2009,5,4,1
KEN,Kenya,ISL,Iceland,2010,17,11,6
KEN,Kenya,ISL,Iceland,2011,17,8,9
KEN,Kenya,ISL,Iceland,2012,23,3,20
KEN,Kenya,ISL,Iceland,2013,23,3,20
KEN,Kenya,ISL,Iceland,2014,25,43,-18
KEN,Kenya,ISL,Iceland,2015,19,15,4
KEN,Kenya,ISL,Iceland,2016,19,17,2
KEN,Kenya,ISL,Iceland,2017,15,18,-3
KEN,Kenya,ITA,Italy,2008,180,14,166
KEN,Kenya,ITA,Italy,2009,232,16,216
KEN,Kenya,ITA,Italy,2010,270,24,246
KEN,Kenya,ITA,Italy,2011,205,24,181
KEN,Kenya,ITA,Italy,2012,226,26,200
KEN,Kenya,ITA,Italy,2013,208,20,188
KEN,Kenya,ITA,Italy,2014,191,32,159
KEN,Kenya,ITA,Italy,2015,193,23,170
KEN,Kenya,ITA,Italy,2016,167,0,167
KEN,Kenya,ITA,Italy,2017,176,30,146
KEN,Kenya,JPN,Japan,2008,400,358,42
KEN,Kenya,JPN,Japan,2009,274,243,31
KEN,Kenya,JPN,Japan,2010,348,316,32
KEN,Kenya,JPN,Japan,2011,338,302,36
KEN,Kenya,JPN,Japan,2012,357,353,4
KEN,Kenya,JPN,Japan,2013,394,368,26
KEN,Kenya,JPN,Japan,2014,376,262,114
KEN,Kenya,JPN,Japan,2015,483,387,96
KEN,Kenya,JPN,Japan,2016,415,344,71
KEN,Kenya,JPN,Japan,2017,358,303,55
KEN,Kenya,KOR,Korea,2008,49,32,17
KEN,Kenya,KOR,Korea,2009,50,47,3
KEN,Kenya,KOR,Korea,2010,85,68,17
KEN,Kenya,KOR,Korea,2011,70,57,13
KEN,Kenya,KOR,Korea,2012,90,66,24
KEN,Kenya,KOR,Korea,2013,89,75,14
KEN,Kenya,KOR,Korea,2014,97,79,18
KEN,Kenya,KOR,Korea,2015,111,65,46
KEN,Kenya,KOR,Korea,2016,112,74,38
KEN,Kenya,KOR,Korea,2017,118,104,14
KEN,Kenya,LUX,Luxembourg,2008,0,2,-2
KEN,Kenya,LUX,Luxembourg,2009,6,0,6
KEN,Kenya,LUX,Luxembourg,2010,7,1,6
KEN,Kenya,LUX,Luxembourg,2011,1,2,-1
KEN,Kenya,LUX,Luxembourg,2012,4,2,2
KEN,Kenya,LUX,Luxembourg,2013,3,6,-3
KEN,Kenya,LUX,Luxembourg,2014,2,1,1
KEN,Kenya,LUX,Luxembourg,2015,6,2,4
KEN,Kenya,LUX,Luxembourg,2016,5,0,5
KEN,Kenya,LUX,Luxembourg,2017,15,3,12
KEN,Kenya,MEX,Mexico,2008,5,0,5
KEN,Kenya,MEX,Mexico,2009,9,0,9
KEN,Kenya,MEX,Mexico,2010,6,0,6
KEN,Kenya,MEX,Mexico,2011,5,0,5
KEN,Kenya,MEX,Mexico,2012,2,0,2
KEN,Kenya,MEX,Mexico,2013,41,0,41
KEN,Kenya,MEX,Mexico,2014,23,0,23
KEN,Kenya,MEX,Mexico,2015,18,0,18
KEN,Kenya,MEX,Mexico,2016,19,0,19
KEN,Kenya,MEX,Mexico,2017,13,0,13
KEN,Kenya,NLD,Netherlands,2008,188,102,86
KEN,Kenya,NLD,Netherlands,2009,194,70,124
KEN,Kenya,NLD,Netherlands,2010,180,124,56
KEN,Kenya,NLD,Netherlands,2011,200,124,76
KEN,Kenya,NLD,Netherlands,2012,150,108,42
KEN,Kenya,NLD,Netherlands,2013,167,138,29
KEN,Kenya,NLD,Netherlands,2014,153,92,61
KEN,Kenya,NLD,Netherlands,2015,165,107,58
KEN,Kenya,NLD,Netherlands,2016,188,118,70
KEN,Kenya,NLD,Netherlands,2017,190,114,76
KEN,Kenya,NZL,New Zealand,2008,49,10,39
KEN,Kenya,NZL,New Zealand,2009,58,20,38
KEN,Kenya,NZL,New Zealand,2010,34,6,28
KEN,Kenya,NZL,New Zealand,2011,29,15,14
KEN,Kenya,NZL,New Zealand,2012,46,20,26
KEN,Kenya,NZL,New Zealand,2013,28,22,6
KEN,Kenya,NZL,New Zealand,2014,35,9,26
KEN,Kenya,NZL,New Zealand,2015,60,8,52
KEN,Kenya,NZL,New Zealand,2016,61,10,51
KEN,Kenya,NZL,New Zealand,2017,65,14,51
KEN,Kenya,NOR,Norway,2008,114,26,88
KEN,Kenya,NOR,Norway,2009,92,28,64
KEN,Kenya,NOR,Norway,2010,93,40,53
KEN,Kenya,NOR,Norway,2011,95,47,48
KEN,Kenya,NOR,Norway,2012,92,52,40
KEN,Kenya,NOR,Norway,2013,102,37,65
KEN,Kenya,NOR,Norway,2014,123,42,81
KEN,Kenya,NOR,Norway,2015,121,39,82
KEN,Kenya,NOR,Norway,2016,101,45,56
KEN,Kenya,NOR,Norway,2017,84,31,53
KEN,Kenya,POL,Poland,2008,77,0,77
KEN,Kenya,POL,Poland,2009,74,0,74
KEN,Kenya,POL,Poland,2010,65,0,65
KEN,Kenya,POL,Poland,2011,68,0,68
KEN,Kenya,POL,Poland,2012,67,0,67
KEN,Kenya,POL,Poland,2013,94,0,94
KEN,Kenya,POL,Poland,2014,38,0,38
KEN,Kenya,POL,Poland,2015,57,0,57
KEN,Kenya,POL,Poland,2016,56,0,56
KEN,Kenya,POL,Poland,2017,46,0,46
KEN,Kenya,SVK,Slovak Republic,2008,1,3,-2
KEN,Kenya,SVK,Slovak Republic,2009,3,0,3
KEN,Kenya,SVK,Slovak Republic,2010,2,0,2
KEN,Kenya,SVK,Slovak Republic,2012,1,0,1
KEN,Kenya,SVK,Slovak Republic,2013,2,0,2
KEN,Kenya,SVK,Slovak Republic,2016,1,0,1
KEN,Kenya,ESP,Spain,2008,153,27,126
KEN,Kenya,ESP,Spain,2009,157,37,120
KEN,Kenya,ESP,Spain,2010,133,43,90
KEN,Kenya,ESP,Spain,2011,154,47,107
KEN,Kenya,ESP,Spain,2012,104,44,60
KEN,Kenya,ESP,Spain,2013,70,40,30
KEN,Kenya,ESP,Spain,2014,78,37,41
KEN,Kenya,ESP,Spain,2015,66,28,38
KEN,Kenya,ESP,Spain,2016,109,20,89
KEN,Kenya,ESP,Spain,2017,127,47,80
KEN,Kenya,SWE,Sweden,2008,137,11,126
KEN,Kenya,SWE,Sweden,2009,163,15,148
KEN,Kenya,SWE,Sweden,2010,161,24,137
KEN,Kenya,SWE,Sweden,2011,200,20,180
KEN,Kenya,SWE,Sweden,2012,197,35,162
KEN,Kenya,SWE,Sweden,2013,206,28,178
KEN,Kenya,SWE,Sweden,2014,235,26,209
KEN,Kenya,SWE,Sweden,2015,193,50,143
KEN,Kenya,SWE,Sweden,2016,175,21,154
KEN,Kenya,SWE,Sweden,2017,225,24,201
KEN,Kenya,CHE,Switzerland,2010,130,60,70
KEN,Kenya,CHE,Switzerland,2011,122,81,41
KEN,Kenya,CHE,Switzerland,2012,131,63,68
KEN,Kenya,CHE,Switzerland,2013,111,65,46
KEN,Kenya,CHE,Switzerland,2014,151,44,107
KEN,Kenya,CHE,Switzerland,2015,122,55,67
KEN,Kenya,CHE,Switzerland,2016,133,47,86
KEN,Kenya,CHE,Switzerland,2017,111,69,42
KEN,Kenya,TUR,Turkey,2010,26,0,26
KEN,Kenya,TUR,Turkey,2016,106,101,5
KEN,Kenya,TUR,Turkey,2017,0,0,0
KEN,Kenya,GBR,United Kingdom,2008,1000,0,1000
KEN,Kenya,GBR,United Kingdom,2011,1000,0,1000
KEN,Kenya,GBR,United Kingdom,2015,2000,0,2000
KEN,Kenya,USA,United States,2008,6998,0,6998
KEN,Kenya,USA,United States,2009,9880,0,9880
KEN,Kenya,USA,United States,2010,7421,0,7421
KEN,Kenya,USA,United States,2011,7762,0,7762
KEN,Kenya,USA,United States,2012,7043,0,7043
KEN,Kenya,USA,United States,2013,6123,0,6123
KEN,Kenya,USA,United States,2014,5884,0,5884
KEN,Kenya,USA,United States,2015,5602,0,5602
KEN,Kenya,USA,United States,2016,6274,0,6274
KEN,Kenya,USA,United States,2017,6957,0,6957
KEN,Kenya,CHL,Chile,2008,2,0,2
KEN,Kenya,CHL,Chile,2009,0,0,0
KEN,Kenya,CHL,Chile,2010,3,0,3
KEN,Kenya,CHL,Chile,2011,4,0,4
KEN,Kenya,CHL,Chile,2012,3,0,3
KEN,Kenya,CHL,Chile,2013,1,0,1
KEN,Kenya,CHL,Chile,2014,2,0,2
KEN,Kenya,CHL,Chile,2015,7,0,7
KEN,Kenya,CHL,Chile,2016,5,0,5
KEN,Kenya,EST,Estonia,2008,1,0,1
KEN,Kenya,EST,Estonia,2009,1,0,1
KEN,Kenya,EST,Estonia,2010,0,0,0
KEN,Kenya,EST,Estonia,2011,0,0,0
KEN,Kenya,EST,Estonia,2012,0,0,0
KEN,Kenya,EST,Estonia,2013,1,0,1
KEN,Kenya,EST,Estonia,2014,1,0,1
KEN,Kenya,EST,Estonia,2015,1,0,1
KEN,Kenya,EST,Estonia,2016,4,0,4
KEN,Kenya,EST,Estonia,2017,7,0,7
KEN,Kenya,SVN,Slovenia,2008,1,0,1
KEN,Kenya,SVN,Slovenia,2009,2,0,2
KEN,Kenya,SVN,Slovenia,2010,2,0,2
KEN,Kenya,SVN,Slovenia,2011,3,0,3
KEN,Kenya,SVN,Slovenia,2013,1,0,1
KEN,Kenya,SVN,Slovenia,2017,4,0,4
KIR,Kiribati,AUS,Australia,2008,7,0,7
KIR,Kiribati,AUS,Australia,2009,9,7,2
KIR,Kiribati,AUS,Australia,2010,21,0,21
KIR,Kiribati,AUS,Australia,2011,6,0,6
KIR,Kiribati,AUS,Australia,2012,3,0,3
KIR,Kiribati,AUS,Australia,2013,6,0,6
KIR,Kiribati,AUS,Australia,2014,6,0,6
KIR,Kiribati,AUS,Australia,2015,21,0,21
KIR,Kiribati,AUS,Australia,2016,34,0,34
KIR,Kiribati,AUS,Australia,2017,52,0,52
KIR,Kiribati,AUT,Austria,2008,0,0,0
KIR,Kiribati,AUT,Austria,2009,0,0,0
KIR,Kiribati,AUT,Austria,2010,0,0,0
KIR,Kiribati,AUT,Austria,2011,0,0,0
KIR,Kiribati,AUT,Austria,2012,0,0,0
KIR,Kiribati,AUT,Austria,2013,0,0,0
KIR,Kiribati,AUT,Austria,2014,0,0,0
KIR,Kiribati,AUT,Austria,2015,0,0,0
KIR,Kiribati,AUT,Austria,2016,0,0,0
KIR,Kiribati,AUT,Austria,2017,0,0,0
KIR,Kiribati,BEL,Belgium,2010,0,0,0
KIR,Kiribati,CAN,Canada,2008,1,0,1
KIR,Kiribati,CAN,Canada,2009,1,0,1
KIR,Kiribati,CAN,Canada,2010,0,0,0
KIR,Kiribati,CAN,Canada,2011,0,0,0
KIR,Kiribati,CAN,Canada,2012,2,0,2
KIR,Kiribati,CAN,Canada,2013,0,0,0
KIR,Kiribati,CAN,Canada,2014,0,0,0
KIR,Kiribati,CAN,Canada,2015,0,0,0
KIR,Kiribati,CAN,Canada,2016,0,0,0
KIR,Kiribati,CAN,Canada,2017,0,0,0
KIR,Kiribati,DNK,Denmark,2008,0,0,0
KIR,Kiribati,DNK,Denmark,2009,0,0,0
KIR,Kiribati,DNK,Denmark,2012,0,0,0
KIR,Kiribati,DNK,Denmark,2013,0,0,0
KIR,Kiribati,DNK,Denmark,2014,0,0,0
KIR,Kiribati,DNK,Denmark,2015,0,0,0
KIR,Kiribati,DNK,Denmark,2016,0,0,0
KIR,Kiribati,DNK,Denmark,2017,0,0,0
KIR,Kiribati,FIN,Finland,2008,0,0,0
KIR,Kiribati,FIN,Finland,2009,0,0,0
KIR,Kiribati,FIN,Finland,2010,0,0,0
KIR,Kiribati,FIN,Finland,2011,0,0,0
KIR,Kiribati,FIN,Finland,2012,0,0,0
KIR,Kiribati,FIN,Finland,2013,0,0,0
KIR,Kiribati,FIN,Finland,2014,0,0,0
KIR,Kiribati,FIN,Finland,2015,0,0,0
KIR,Kiribati,FIN,Finland,2016,0,0,0
KIR,Kiribati,FIN,Finland,2017,0,0,0
KIR,Kiribati,FRA,France,2008,2,0,2
KIR,Kiribati,FRA,France,2009,0,0,0
KIR,Kiribati,FRA,France,2010,0,0,0
KIR,Kiribati,FRA,France,2011,0,0,0
KIR,Kiribati,FRA,France,2012,0,0,0
KIR,Kiribati,FRA,France,2013,1,0,1
KIR,Kiribati,FRA,France,2014,1,0,1
KIR,Kiribati,FRA,France,2015,0,0,0
KIR,Kiribati,FRA,France,2016,0,0,0
KIR,Kiribati,FRA,France,2017,1,0,1
KIR,Kiribati,DEU,Germany,2008,326,0,326
KIR,Kiribati,DEU,Germany,2009,269,325,-56
KIR,Kiribati,DEU,Germany,2010,232,238,-6
KIR,Kiribati,DEU,Germany,2011,222,224,-2
KIR,Kiribati,DEU,Germany,2012,223,148,75
KIR,Kiribati,DEU,Germany,2013,173,167,6
KIR,Kiribati,DEU,Germany,2014,175,146,29
KIR,Kiribati,DEU,Germany,2015,146,131,15
KIR,Kiribati,DEU,Germany,2016,173,175,-2
KIR,Kiribati,DEU,Germany,2017,143,122,21
KIR,Kiribati,HUN,Hungary,2008,0,0,0
KIR,Kiribati,HUN,Hungary,2009,0,0,0
KIR,Kiribati,HUN,Hungary,2010,0,0,0
KIR,Kiribati,HUN,Hungary,2011,0,0,0
KIR,Kiribati,HUN,Hungary,2012,0,0,0
KIR,Kiribati,HUN,Hungary,2013,0,0,0
KIR,Kiribati,HUN,Hungary,2014,0,0,0
KIR,Kiribati,HUN,Hungary,2015,0,0,0
KIR,Kiribati,HUN,Hungary,2016,0,0,0
KIR,Kiribati,HUN,Hungary,2017,0,0,0
KIR,Kiribati,ISL,Iceland,2016,0,0,0
KIR,Kiribati,ISL,Iceland,2017,0,0,0
KIR,Kiribati,ITA,Italy,2008,0,0,0
KIR,Kiribati,ITA,Italy,2009,2,0,2
KIR,Kiribati,ITA,Italy,2010,0,0,0
KIR,Kiribati,ITA,Italy,2011,0,0,0
KIR,Kiribati,ITA,Italy,2012,1,0,1
KIR,Kiribati,ITA,Italy,2013,0,0,0
KIR,Kiribati,ITA,Italy,2014,1,0,1
KIR,Kiribati,ITA,Italy,2015,100,0,100
KIR,Kiribati,JPN,Japan,2008,23,28,-5
KIR,Kiribati,JPN,Japan,2009,32,32,0
KIR,Kiribati,JPN,Japan,2010,44,44,0
KIR,Kiribati,JPN,Japan,2011,38,37,1
KIR,Kiribati,JPN,Japan,2012,37,37,0
KIR,Kiribati,JPN,Japan,2013,36,37,-1
KIR,Kiribati,JPN,Japan,2014,46,46,0
KIR,Kiribati,JPN,Japan,2015,51,49,2
KIR,Kiribati,JPN,Japan,2016,37,28,9
KIR,Kiribati,JPN,Japan,2017,55,52,3
KIR,Kiribati,KOR,Korea,2008,2,1,1
KIR,Kiribati,KOR,Korea,2009,0,3,-3
KIR,Kiribati,KOR,Korea,2010,0,2,-2
KIR,Kiribati,KOR,Korea,2011,2,2,0
KIR,Kiribati,KOR,Korea,2012,3,3,0
KIR,Kiribati,KOR,Korea,2013,0,2,-2
KIR,Kiribati,KOR,Korea,2014,5,2,3
KIR,Kiribati,KOR,Korea,2015,1,2,-1
KIR,Kiribati,KOR,Korea,2016,2,0,2
KIR,Kiribati,KOR,Korea,2017,7,1,6
KIR,Kiribati,LUX,Luxembourg,2008,0,0,0
KIR,Kiribati,LUX,Luxembourg,2009,0,0,0
KIR,Kiribati,LUX,Luxembourg,2010,0,0,0
KIR,Kiribati,LUX,Luxembourg,2011,0,0,0
KIR,Kiribati,LUX,Luxembourg,2012,0,0,0
KIR,Kiribati,LUX,Luxembourg,2013,0,0,0
KIR,Kiribati,LUX,Luxembourg,2014,0,0,0
KIR,Kiribati,LUX,Luxembourg,2015,0,0,0
KIR,Kiribati,LUX,Luxembourg,2016,0,0,0
KIR,Kiribati,LUX,Luxembourg,2017,0,0,0
KIR,Kiribati,MEX,Mexico,2012,0,0,0
KIR,Kiribati,MEX,Mexico,2013,0,0,0
KIR,Kiribati,MEX,Mexico,2014,0,0,0
KIR,Kiribati,NLD,Netherlands,2013,1,1,0
KIR,Kiribati,NLD,Netherlands,2015,3,0,3
KIR,Kiribati,NLD,Netherlands,2016,0,3,-3
KIR,Kiribati,NZL,New Zealand,2008,51,26,25
KIR,Kiribati,NZL,New Zealand,2009,67,56,11
KIR,Kiribati,NZL,New Zealand,2010,31,43,-12
KIR,Kiribati,NZL,New Zealand,2011,66,32,34
KIR,Kiribati,NZL,New Zealand,2012,39,19,20
KIR,Kiribati,NZL,New Zealand,2013,72,13,59
KIR,Kiribati,NZL,New Zealand,2014,49,22,27
KIR,Kiribati,NZL,New Zealand,2015,93,28,65
KIR,Kiribati,NZL,New Zealand,2016,67,29,38
KIR,Kiribati,NZL,New Zealand,2017,98,38,60
KIR,Kiribati,NOR,Norway,2008,0,0,0
KIR,Kiribati,NOR,Norway,2009,0,0,0
KIR,Kiribati,NOR,Norway,2010,0,0,0
KIR,Kiribati,NOR,Norway,2011,0,0,0
KIR,Kiribati,NOR,Norway,2012,0,0,0
KIR,Kiribati,NOR,Norway,2013,0,0,0
KIR,Kiribati,NOR,Norway,2014,0,0,0
KIR,Kiribati,NOR,Norway,2015,0,0,0
KIR,Kiribati,NOR,Norway,2016,0,0,0
KIR,Kiribati,NOR,Norway,2017,0,0,0
KIR,Kiribati,POL,Poland,2009,0,0,0
KIR,Kiribati,POL,Poland,2010,0,0,0
KIR,Kiribati,POL,Poland,2011,1,0,1
KIR,Kiribati,POL,Poland,2012,0,0,0
KIR,Kiribati,POL,Poland,2013,1,0,1
KIR,Kiribati,POL,Poland,2014,0,0,0
KIR,Kiribati,POL,Poland,2015,0,0,0
KIR,Kiribati,POL,Poland,2016,0,0,0
KIR,Kiribati,POL,Poland,2017,0,0,0
KIR,Kiribati,SVK,Slovak Republic,2008,1,0,1
KIR,Kiribati,SVK,Slovak Republic,2010,1,0,1
KIR,Kiribati,ESP,Spain,2008,0,0,0
KIR,Kiribati,ESP,Spain,2009,0,0,0
KIR,Kiribati,ESP,Spain,2010,0,0,0
KIR,Kiribati,ESP,Spain,2011,0,0,0
KIR,Kiribati,ESP,Spain,2012,0,0,0
KIR,Kiribati,ESP,Spain,2013,1,0,1
KIR,Kiribati,ESP,Spain,2014,0,0,0
KIR,Kiribati,ESP,Spain,2015,1,1,0
KIR,Kiribati,ESP,Spain,2016,1,0,1
KIR,Kiribati,ESP,Spain,2017,1,0,1
KIR,Kiribati,SWE,Sweden,2008,0,1,-1
KIR,Kiribati,SWE,Sweden,2009,0,0,0
KIR,Kiribati,SWE,Sweden,2010,0,0,0
KIR,Kiribati,SWE,Sweden,2011,0,0,0
KIR,Kiribati,SWE,Sweden,2012,0,0,0
KIR,Kiribati,SWE,Sweden,2013,0,0,0
KIR,Kiribati,SWE,Sweden,2014,0,0,0
KIR,Kiribati,SWE,Sweden,2015,0,1,-1
KIR,Kiribati,SWE,Sweden,2016,1,0,1
KIR,Kiribati,SWE,Sweden,2017,0,0,0
KIR,Kiribati,CHE,Switzerland,2010,1,0,1
KIR,Kiribati,CHE,Switzerland,2011,0,0,0
KIR,Kiribati,CHE,Switzerland,2012,1,0,1
KIR,Kiribati,CHE,Switzerland,2013,0,0,0
KIR,Kiribati,CHE,Switzerland,2014,0,1,-1
KIR,Kiribati,CHE,Switzerland,2015,0,0,0
KIR,Kiribati,CHE,Switzerland,2016,0,0,0
KIR,Kiribati,CHE,Switzerland,2017,0,0,0
KIR,Kiribati,USA,United States,2008,4,0,4
KIR,Kiribati,USA,United States,2009,10,0,10
KIR,Kiribati,USA,United States,2010,6,0,6
KIR,Kiribati,USA,United States,2011,2,0,2
KIR,Kiribati,USA,United States,2012,6,0,6
KIR,Kiribati,USA,United States,2013,3,0,3
KIR,Kiribati,USA,United States,2014,6,0,6
KIR,Kiribati,USA,United States,2015,4,0,4
KIR,Kiribati,USA,United States,2016,9,0,9
KIR,Kiribati,USA,United States,2017,2,0,2
KIR,Kiribati,CHL,Chile,2008,0,0,0
KIR,Kiribati,CHL,Chile,2009,0,0,0
KIR,Kiribati,CHL,Chile,2010,0,0,0
KIR,Kiribati,CHL,Chile,2011,0,0,0
KIR,Kiribati,CHL,Chile,2012,0,0,0
KIR,Kiribati,CHL,Chile,2013,4,0,4
KIR,Kiribati,CHL,Chile,2014,0,0,0
KIR,Kiribati,CHL,Chile,2015,0,0,0
KIR,Kiribati,CHL,Chile,2016,0,0,0
KIR,Kiribati,EST,Estonia,2008,0,0,0
KIR,Kiribati,EST,Estonia,2009,0,0,0
KIR,Kiribati,EST,Estonia,2010,0,0,0
KIR,Kiribati,EST,Estonia,2011,0,0,0
KIR,Kiribati,EST,Estonia,2012,0,0,0
KIR,Kiribati,EST,Estonia,2013,0,0,0
KIR,Kiribati,EST,Estonia,2014,0,0,0
KIR,Kiribati,EST,Estonia,2015,0,0,0
KIR,Kiribati,EST,Estonia,2016,0,0,0
KIR,Kiribati,EST,Estonia,2017,0,0,0
KOR,Korea,AUS,Australia,2008,5036,1402,3634
KOR,Korea,AUS,Australia,2009,5156,1365,3791
KOR,Korea,AUS,Australia,2010,4307,1555,2752
KOR,Korea,AUS,Australia,2011,4299,1766,2533
KOR,Korea,AUS,Australia,2012,5042,1776,3266
KOR,Korea,AUS,Australia,2013,5432,1756,3676
KOR,Korea,AUS,Australia,2014,3763,1988,1775
KOR,Korea,AUS,Australia,2015,3551,1668,1883
KOR,Korea,AUS,Australia,2016,3310,1720,1590
KOR,Korea,AUS,Australia,2017,3204,1519,1685
KOR,Korea,AUT,Austria,2008,345,71,274
KOR,Korea,AUT,Austria,2009,372,79,293
KOR,Korea,AUT,Austria,2010,352,85,267
KOR,Korea,AUT,Austria,2011,362,93,269
KOR,Korea,AUT,Austria,2012,411,103,308
KOR,Korea,AUT,Austria,2013,425,122,303
KOR,Korea,AUT,Austria,2014,445,82,363
KOR,Korea,AUT,Austria,2015,399,110,289
KOR,Korea,AUT,Austria,2016,419,109,310
KOR,Korea,AUT,Austria,2017,477,91,386
KOR,Korea,BEL,Belgium,2008,203,67,136
KOR,Korea,BEL,Belgium,2009,191,64,127
KOR,Korea,BEL,Belgium,2010,205,103,102
KOR,Korea,BEL,Belgium,2011,252,68,184
KOR,Korea,BEL,Belgium,2012,248,80,168
KOR,Korea,BEL,Belgium,2013,229,91,138
KOR,Korea,BEL,Belgium,2014,201,85,116
KOR,Korea,BEL,Belgium,2015,216,121,95
KOR,Korea,BEL,Belgium,2016,238,128,110
KOR,Korea,BEL,Belgium,2017,275,133,142
KOR,Korea,CAN,Canada,2008,7291,6402,889
KOR,Korea,CAN,Canada,2009,5873,6490,-617
KOR,Korea,CAN,Canada,2010,5537,6505,-968
KOR,Korea,CAN,Canada,2011,4588,5956,-1368
KOR,Korea,CAN,Canada,2012,5315,6012,-697
KOR,Korea,CAN,Canada,2013,4509,5635,-1126
KOR,Korea,CAN,Canada,2014,4458,5454,-996
KOR,Korea,CAN,Canada,2015,4091,5270,-1179
KOR,Korea,CAN,Canada,2016,4010,5271,-1261
KOR,Korea,CAN,Canada,2017,3975,4588,-613
KOR,Korea,CZE,Czech Republic,2008,726,62,664
KOR,Korea,CZE,Czech Republic,2009,333,76,257
KOR,Korea,CZE,Czech Republic,2010,364,67,297
KOR,Korea,CZE,Czech Republic,2011,364,64,300
KOR,Korea,CZE,Czech Republic,2012,404,76,328
KOR,Korea,CZE,Czech Republic,2013,359,117,242
KOR,Korea,CZE,Czech Republic,2014,368,93,275
KOR,Korea,CZE,Czech Republic,2015,443,107,336
KOR,Korea,CZE,Czech Republic,2016,469,111,358
KOR,Korea,CZE,Czech Republic,2017,552,120,432
KOR,Korea,DNK,Denmark,2008,78,63,15
KOR,Korea,DNK,Denmark,2009,75,64,11
KOR,Korea,DNK,Denmark,2010,50,70,-20
KOR,Korea,DNK,Denmark,2011,84,98,-14
KOR,Korea,DNK,Denmark,2012,111,157,-46
KOR,Korea,DNK,Denmark,2013,98,165,-67
KOR,Korea,DNK,Denmark,2014,121,162,-41
KOR,Korea,DNK,Denmark,2015,0,169,-169
KOR,Korea,DNK,Denmark,2016,132,171,-39
KOR,Korea,DNK,Denmark,2017,167,185,-18
KOR,Korea,FIN,Finland,2008,55,88,-33
KOR,Korea,FIN,Finland,2009,58,89,-31
KOR,Korea,FIN,Finland,2010,55,149,-94
KOR,Korea,FIN,Finland,2011,95,152,-57
KOR,Korea,FIN,Finland,2012,65,158,-93
KOR,Korea,FIN,Finland,2013,64,171,-107
KOR,Korea,FIN,Finland,2014,68,181,-113
KOR,Korea,FIN,Finland,2015,69,180,-111
KOR,Korea,FIN,Finland,2016,105,205,-100
KOR,Korea,FIN,Finland,2017,100,169,-69
KOR,Korea,FRA,France,2008,526,1044,-518
KOR,Korea,FRA,France,2009,485,1009,-524
KOR,Korea,FRA,France,2010,493,1160,-667
KOR,Korea,FRA,France,2011,557,1295,-738
KOR,Korea,FRA,France,2012,541,1367,-826
KOR,Korea,FRA,France,2013,540,1735,-1195
KOR,Korea,FRA,France,2014,559,1940,-1381
KOR,Korea,FRA,France,2015,517,1821,-1304
KOR,Korea,FRA,France,2016,601,1957,-1356
KOR,Korea,FRA,France,2017,614,1971,-1357
KOR,Korea,DEU,Germany,2008,3915,963,2952
KOR,Korea,DEU,Germany,2009,3771,927,2844
KOR,Korea,DEU,Germany,2010,4096,1087,3009
KOR,Korea,DEU,Germany,2011,4775,1017,3758
KOR,Korea,DEU,Germany,2012,4927,1241,3686
KOR,Korea,DEU,Germany,2013,5524,1264,4260
KOR,Korea,DEU,Germany,2014,6261,1326,4935
KOR,Korea,DEU,Germany,2015,7229,1277,5952
KOR,Korea,DEU,Germany,2016,7682,1422,6260
KOR,Korea,DEU,Germany,2017,8154,1334,6820
KOR,Korea,HUN,Hungary,2008,335,28,307
KOR,Korea,HUN,Hungary,2009,282,26,256
KOR,Korea,HUN,Hungary,2010,429,26,403
KOR,Korea,HUN,Hungary,2011,382,35,347
KOR,Korea,HUN,Hungary,2012,329,56,273
KOR,Korea,HUN,Hungary,2013,340,58,282
KOR,Korea,HUN,Hungary,2014,403,80,323
KOR,Korea,HUN,Hungary,2015,339,63,276
KOR,Korea,HUN,Hungary,2016,330,66,264
KOR,Korea,HUN,Hungary,2017,580,66,514
KOR,Korea,ISL,Iceland,2008,3,5,-2
KOR,Korea,ISL,Iceland,2009,2,2,0
KOR,Korea,ISL,Iceland,2010,7,14,-7
KOR,Korea,ISL,Iceland,2011,10,1,9
KOR,Korea,ISL,Iceland,2012,1,7,-6
KOR,Korea,ISL,Iceland,2013,7,8,-1
KOR,Korea,ISL,Iceland,2014,6,4,2
KOR,Korea,ISL,Iceland,2015,3,5,-2
KOR,Korea,ISL,Iceland,2016,5,6,-1
KOR,Korea,ISL,Iceland,2017,4,5,-1
KOR,Korea,ITA,Italy,2008,251,142,109
KOR,Korea,ITA,Italy,2009,282,111,171
KOR,Korea,ITA,Italy,2010,264,177,87
KOR,Korea,ITA,Italy,2011,315,177,138
KOR,Korea,ITA,Italy,2012,315,219,96
KOR,Korea,ITA,Italy,2013,292,244,48
KOR,Korea,ITA,Italy,2014,315,303,12
KOR,Korea,ITA,Italy,2015,364,274,90
KOR,Korea,ITA,Italy,2016,287,297,-10
KOR,Korea,ITA,Italy,2017,342,354,-12
KOR,Korea,JPN,Japan,2008,30043,4659,25384
KOR,Korea,JPN,Japan,2009,26979,4371,22608
KOR,Korea,JPN,Japan,2010,27868,4744,23124
KOR,Korea,JPN,Japan,2011,23360,5549,17811
KOR,Korea,JPN,Japan,2012,25748,5831,19917
KOR,Korea,JPN,Japan,2013,24202,5891,18311
KOR,Korea,JPN,Japan,2014,21116,4736,16380
KOR,Korea,JPN,Japan,2015,22571,4589,17982
KOR,Korea,JPN,Japan,2016,25639,4662,20977
KOR,Korea,JPN,Japan,2017,28006,4469,23537
KOR,Korea,LUX,Luxembourg,2008,17,3,14
KOR,Korea,LUX,Luxembourg,2009,16,2,14
KOR,Korea,LUX,Luxembourg,2010,18,1,17
KOR,Korea,LUX,Luxembourg,2011,29,1,28
KOR,Korea,LUX,Luxembourg,2012,24,2,22
KOR,Korea,LUX,Luxembourg,2013,60,1,59
KOR,Korea,LUX,Luxembourg,2014,79,1,78
KOR,Korea,LUX,Luxembourg,2015,38,7,31
KOR,Korea,LUX,Luxembourg,2016,26,5,21
KOR,Korea,LUX,Luxembourg,2017,24,4,20
KOR,Korea,MEX,Mexico,2008,382,185,197
KOR,Korea,MEX,Mexico,2009,415,231,184
KOR,Korea,MEX,Mexico,2010,505,258,247
KOR,Korea,MEX,Mexico,2011,425,253,172
KOR,Korea,MEX,Mexico,2012,406,247,159
KOR,Korea,MEX,Mexico,2013,1329,249,1080
KOR,Korea,MEX,Mexico,2014,792,301,491
KOR,Korea,MEX,Mexico,2015,548,377,171
KOR,Korea,MEX,Mexico,2016,577,369,208
KOR,Korea,MEX,Mexico,2017,454,376,78
KOR,Korea,NLD,Netherlands,2008,535,160,375
KOR,Korea,NLD,Netherlands,2009,533,129,404
KOR,Korea,NLD,Netherlands,2010,665,146,519
KOR,Korea,NLD,Netherlands,2011,818,284,534
KOR,Korea,NLD,Netherlands,2012,743,254,489
KOR,Korea,NLD,Netherlands,2013,845,268,577
KOR,Korea,NLD,Netherlands,2014,968,327,641
KOR,Korea,NLD,Netherlands,2015,1110,371,739
KOR,Korea,NLD,Netherlands,2016,1344,411,933
KOR,Korea,NLD,Netherlands,2017,1539,403,1136
KOR,Korea,NZL,New Zealand,2008,1842,736,1106
KOR,Korea,NZL,New Zealand,2009,2053,745,1308
KOR,Korea,NZL,New Zealand,2010,1913,756,1157
KOR,Korea,NZL,New Zealand,2011,1725,898,827
KOR,Korea,NZL,New Zealand,2012,1565,827,738
KOR,Korea,NZL,New Zealand,2013,1758,761,997
KOR,Korea,NZL,New Zealand,2014,1689,777,912
KOR,Korea,NZL,New Zealand,2015,1867,630,1237
KOR,Korea,NZL,New Zealand,2016,2489,610,1879
KOR,Korea,NZL,New Zealand,2017,2889,620,2269
KOR,Korea,NOR,Norway,2008,141,157,-16
KOR,Korea,NOR,Norway,2009,140,161,-21
KOR,Korea,NOR,Norway,2010,135,120,15
KOR,Korea,NOR,Norway,2011,165,135,30
KOR,Korea,NOR,Norway,2012,158,168,-10
KOR,Korea,NOR,Norway,2013,155,269,-114
KOR,Korea,NOR,Norway,2014,141,323,-182
KOR,Korea,NOR,Norway,2015,119,259,-140
KOR,Korea,NOR,Norway,2016,109,242,-133
KOR,Korea,NOR,Norway,2017,112,173,-61
KOR,Korea,POL,Poland,2008,1078,131,947
KOR,Korea,POL,Poland,2009,1000,127,873
KOR,Korea,POL,Poland,2010,1070,142,928
KOR,Korea,POL,Poland,2011,984,154,830
KOR,Korea,POL,Poland,2012,990,143,847
KOR,Korea,POL,Poland,2013,1148,169,979
KOR,Korea,POL,Poland,2014,619,185,434
KOR,Korea,POL,Poland,2015,1039,175,864
KOR,Korea,POL,Poland,2016,838,170,668
KOR,Korea,POL,Poland,2017,662,146,516
KOR,Korea,SVK,Slovak Republic,2008,88,13,75
KOR,Korea,SVK,Slovak Republic,2009,43,25,18
KOR,Korea,SVK,Slovak Republic,2010,39,32,7
KOR,Korea,SVK,Slovak Republic,2011,34,23,11
KOR,Korea,SVK,Slovak Republic,2012,22,28,-6
KOR,Korea,SVK,Slovak Republic,2013,14,36,-22
KOR,Korea,SVK,Slovak Republic,2014,15,33,-18
KOR,Korea,SVK,Slovak Republic,2015,21,27,-6
KOR,Korea,SVK,Slovak Republic,2016,17,32,-15
KOR,Korea,SVK,Slovak Republic,2017,26,25,1
KOR,Korea,ESP,Spain,2008,359,149,210
KOR,Korea,ESP,Spain,2009,268,132,136
KOR,Korea,ESP,Spain,2010,356,182,174
KOR,Korea,ESP,Spain,2011,590,211,379
KOR,Korea,ESP,Spain,2012,687,290,397
KOR,Korea,ESP,Spain,2013,662,233,429
KOR,Korea,ESP,Spain,2014,610,255,355
KOR,Korea,ESP,Spain,2015,627,244,383
KOR,Korea,ESP,Spain,2016,612,294,318
KOR,Korea,ESP,Spain,2017,718,286,432
KOR,Korea,SWE,Sweden,2008,205,161,44
KOR,Korea,SWE,Sweden,2009,241,141,100
KOR,Korea,SWE,Sweden,2010,235,166,69
KOR,Korea,SWE,Sweden,2011,233,235,-2
KOR,Korea,SWE,Sweden,2012,186,233,-47
KOR,Korea,SWE,Sweden,2013,237,260,-23
KOR,Korea,SWE,Sweden,2014,215,284,-69
KOR,Korea,SWE,Sweden,2015,181,278,-97
KOR,Korea,SWE,Sweden,2016,291,282,9
KOR,Korea,SWE,Sweden,2017,288,281,7
KOR,Korea,CHE,Switzerland,2010,407,112,295
KOR,Korea,CHE,Switzerland,2011,438,96,342
KOR,Korea,CHE,Switzerland,2012,414,100,314
KOR,Korea,CHE,Switzerland,2013,445,97,348
KOR,Korea,CHE,Switzerland,2014,429,114,315
KOR,Korea,CHE,Switzerland,2015,522,104,418
KOR,Korea,CHE,Switzerland,2016,421,122,299
KOR,Korea,CHE,Switzerland,2017,430,120,310
KOR,Korea,TUR,Turkey,2010,260,407,-147
KOR,Korea,TUR,Turkey,2016,670,424,246
KOR,Korea,TUR,Turkey,2017,756,587,169
KOR,Korea,GBR,United Kingdom,2009,5000,1782,3218
KOR,Korea,GBR,United Kingdom,2010,4000,1727,2273
KOR,Korea,GBR,United Kingdom,2011,3000,2086,914
KOR,Korea,GBR,United Kingdom,2012,1000,1818,-818
KOR,Korea,GBR,United Kingdom,2013,3000,1877,1123
KOR,Korea,GBR,United Kingdom,2014,6000,1567,4433
KOR,Korea,GBR,United Kingdom,2015,2000,1305,695
KOR,Korea,USA,United States,2008,26666,23402,3264
KOR,Korea,USA,United States,2009,25859,27127,-1268
KOR,Korea,USA,United States,2010,22227,28328,-6101
KOR,Korea,USA,United States,2011,22824,28061,-5237
KOR,Korea,USA,United States,2012,20846,28866,-8020
KOR,Korea,USA,United States,2013,23166,26622,-3456
KOR,Korea,USA,United States,2014,20423,24500,-4077
KOR,Korea,USA,United States,2015,17138,22741,-5603
KOR,Korea,USA,United States,2016,21801,21771,30
KOR,Korea,USA,United States,2017,19194,19848,-654
KOR,Korea,CHL,Chile,2008,176,32,144
KOR,Korea,CHL,Chile,2009,202,46,156
KOR,Korea,CHL,Chile,2010,400,49,351
KOR,Korea,CHL,Chile,2011,332,45,287
KOR,Korea,CHL,Chile,2012,221,42,179
KOR,Korea,CHL,Chile,2013,153,39,114
KOR,Korea,CHL,Chile,2014,227,68,159
KOR,Korea,CHL,Chile,2015,382,53,329
KOR,Korea,CHL,Chile,2016,241,50,191
KOR,Korea,EST,Estonia,2008,0,5,-5
KOR,Korea,EST,Estonia,2009,4,0,4
KOR,Korea,EST,Estonia,2010,3,9,-6
KOR,Korea,EST,Estonia,2011,2,13,-11
KOR,Korea,EST,Estonia,2012,1,14,-13
KOR,Korea,EST,Estonia,2013,32,11,21
KOR,Korea,EST,Estonia,2014,3,10,-7
KOR,Korea,EST,Estonia,2015,16,10,6
KOR,Korea,EST,Estonia,2016,20,13,7
KOR,Korea,EST,Estonia,2017,26,13,13
KOR,Korea,SVN,Slovenia,2008,10,4,6
KOR,Korea,SVN,Slovenia,2009,14,11,3
KOR,Korea,SVN,Slovenia,2011,19,13,6
KOR,Korea,SVN,Slovenia,2012,15,12,3
KOR,Korea,SVN,Slovenia,2013,44,9,35
KOR,Korea,SVN,Slovenia,2014,14,20,-6
KOR,Korea,SVN,Slovenia,2015,4,16,-12
KOR,Korea,SVN,Slovenia,2016,13,18,-5
KOR,Korea,SVN,Slovenia,2017,16,21,-5
KWT,Kuwait,AUS,Australia,2008,8,77,-69
KWT,Kuwait,AUS,Australia,2009,7,63,-56
KWT,Kuwait,AUS,Australia,2010,9,62,-53
KWT,Kuwait,AUS,Australia,2011,8,53,-45
KWT,Kuwait,AUS,Australia,2012,13,61,-48
KWT,Kuwait,AUS,Australia,2013,6,70,-64
KWT,Kuwait,AUS,Australia,2014,11,61,-50
KWT,Kuwait,AUS,Australia,2015,9,100,-91
KWT,Kuwait,AUS,Australia,2016,12,100,-88
KWT,Kuwait,AUS,Australia,2017,9,0,9
KWT,Kuwait,AUT,Austria,2008,2,5,-3
KWT,Kuwait,AUT,Austria,2009,1,2,-1
KWT,Kuwait,AUT,Austria,2010,2,2,0
KWT,Kuwait,AUT,Austria,2011,4,0,4
KWT,Kuwait,AUT,Austria,2012,7,1,6
KWT,Kuwait,AUT,Austria,2013,12,5,7
KWT,Kuwait,AUT,Austria,2014,11,8,3
KWT,Kuwait,AUT,Austria,2015,24,7,17
KWT,Kuwait,AUT,Austria,2016,25,12,13
KWT,Kuwait,AUT,Austria,2017,7,7,0
KWT,Kuwait,BEL,Belgium,2008,7,0,7
KWT,Kuwait,BEL,Belgium,2009,0,0,0
KWT,Kuwait,BEL,Belgium,2010,3,6,-3
KWT,Kuwait,BEL,Belgium,2012,2,1,1
KWT,Kuwait,BEL,Belgium,2013,6,6,0
KWT,Kuwait,BEL,Belgium,2014,10,1,9
KWT,Kuwait,BEL,Belgium,2015,6,3,3
KWT,Kuwait,BEL,Belgium,2016,5,8,-3
KWT,Kuwait,BEL,Belgium,2017,7,5,2
KWT,Kuwait,CAN,Canada,2008,53,0,53
KWT,Kuwait,CAN,Canada,2009,68,0,68
KWT,Kuwait,CAN,Canada,2010,67,0,67
KWT,Kuwait,CAN,Canada,2011,58,0,58
KWT,Kuwait,CAN,Canada,2012,73,0,73
KWT,Kuwait,CAN,Canada,2013,48,0,48
KWT,Kuwait,CAN,Canada,2014,49,0,49
KWT,Kuwait,CAN,Canada,2015,20,0,20
KWT,Kuwait,CAN,Canada,2016,45,0,45
KWT,Kuwait,CAN,Canada,2017,25,0,25
KWT,Kuwait,CZE,Czech Republic,2008,19,0,19
KWT,Kuwait,CZE,Czech Republic,2009,7,0,7
KWT,Kuwait,CZE,Czech Republic,2012,1,2,-1
KWT,Kuwait,CZE,Czech Republic,2013,4,2,2
KWT,Kuwait,CZE,Czech Republic,2014,2,1,1
KWT,Kuwait,CZE,Czech Republic,2015,4,2,2
KWT,Kuwait,CZE,Czech Republic,2016,1,1,0
KWT,Kuwait,CZE,Czech Republic,2017,4,2,2
KWT,Kuwait,DNK,Denmark,2008,1,0,1
KWT,Kuwait,DNK,Denmark,2009,1,1,0
KWT,Kuwait,DNK,Denmark,2010,1,0,1
KWT,Kuwait,DNK,Denmark,2012,3,1,2
KWT,Kuwait,DNK,Denmark,2013,1,0,1
KWT,Kuwait,DNK,Denmark,2014,2,0,2
KWT,Kuwait,DNK,Denmark,2015,2,0,2
KWT,Kuwait,DNK,Denmark,2016,1,0,1
KWT,Kuwait,DNK,Denmark,2017,0,0,0
KWT,Kuwait,FIN,Finland,2008,0,0,0
KWT,Kuwait,FIN,Finland,2009,1,0,1
KWT,Kuwait,FIN,Finland,2010,0,0,0
KWT,Kuwait,FIN,Finland,2011,1,0,1
KWT,Kuwait,FIN,Finland,2012,0,0,0
KWT,Kuwait,FIN,Finland,2013,0,1,-1
KWT,Kuwait,FIN,Finland,2014,1,0,1
KWT,Kuwait,FIN,Finland,2015,0,0,0
KWT,Kuwait,FIN,Finland,2016,1,0,1
KWT,Kuwait,FIN,Finland,2017,0,0,0
KWT,Kuwait,FRA,France,2008,25,0,25
KWT,Kuwait,FRA,France,2009,10,0,10
KWT,Kuwait,FRA,France,2010,12,0,12
KWT,Kuwait,FRA,France,2011,11,0,11
KWT,Kuwait,FRA,France,2012,17,0,17
KWT,Kuwait,FRA,France,2013,16,0,16
KWT,Kuwait,FRA,France,2014,18,0,18
KWT,Kuwait,FRA,France,2015,20,0,20
KWT,Kuwait,FRA,France,2016,26,0,26
KWT,Kuwait,FRA,France,2017,37,0,37
KWT,Kuwait,DEU,Germany,2008,94,117,-23
KWT,Kuwait,DEU,Germany,2009,153,115,38
KWT,Kuwait,DEU,Germany,2010,174,164,10
KWT,Kuwait,DEU,Germany,2011,131,102,29
KWT,Kuwait,DEU,Germany,2012,217,154,63
KWT,Kuwait,DEU,Germany,2013,541,381,160
KWT,Kuwait,DEU,Germany,2014,1421,729,692
KWT,Kuwait,DEU,Germany,2015,2093,1338,755
KWT,Kuwait,DEU,Germany,2016,2840,2913,-73
KWT,Kuwait,DEU,Germany,2017,994,1173,-179
KWT,Kuwait,HUN,Hungary,2008,0,0,0
KWT,Kuwait,HUN,Hungary,2009,10,0,10
KWT,Kuwait,HUN,Hungary,2010,4,0,4
KWT,Kuwait,HUN,Hungary,2011,12,0,12
KWT,Kuwait,HUN,Hungary,2012,7,1,6
KWT,Kuwait,HUN,Hungary,2013,6,0,6
KWT,Kuwait,HUN,Hungary,2014,18,0,18
KWT,Kuwait,HUN,Hungary,2015,1,0,1
KWT,Kuwait,HUN,Hungary,2016,9,7,2
KWT,Kuwait,HUN,Hungary,2017,25,0,25
KWT,Kuwait,ISL,Iceland,2008,0,0,0
KWT,Kuwait,ISL,Iceland,2009,0,0,0
KWT,Kuwait,ISL,Iceland,2010,0,0,0
KWT,Kuwait,ISL,Iceland,2011,0,0,0
KWT,Kuwait,ISL,Iceland,2012,0,0,0
KWT,Kuwait,ISL,Iceland,2016,0,0,0
KWT,Kuwait,ISL,Iceland,2017,0,0,0
KWT,Kuwait,ITA,Italy,2008,14,0,14
KWT,Kuwait,ITA,Italy,2009,8,0,8
KWT,Kuwait,ITA,Italy,2010,1,1,0
KWT,Kuwait,ITA,Italy,2011,3,0,3
KWT,Kuwait,ITA,Italy,2012,3,0,3
KWT,Kuwait,ITA,Italy,2013,9,2,7
KWT,Kuwait,ITA,Italy,2014,10,1,9
KWT,Kuwait,ITA,Italy,2015,13,1,12
KWT,Kuwait,ITA,Italy,2016,14,0,14
KWT,Kuwait,ITA,Italy,2017,11,1,10
KWT,Kuwait,JPN,Japan,2008,133,124,9
KWT,Kuwait,JPN,Japan,2009,86,85,1
KWT,Kuwait,JPN,Japan,2010,92,86,6
KWT,Kuwait,JPN,Japan,2011,36,24,12
KWT,Kuwait,JPN,Japan,2012,190,197,-7
KWT,Kuwait,JPN,Japan,2013,87,76,11
KWT,Kuwait,JPN,Japan,2014,118,117,1
KWT,Kuwait,JPN,Japan,2015,66,71,-5
KWT,Kuwait,JPN,Japan,2016,111,107,4
KWT,Kuwait,JPN,Japan,2017,61,39,22
KWT,Kuwait,KOR,Korea,2008,10,2,8
KWT,Kuwait,KOR,Korea,2009,1,9,-8
KWT,Kuwait,KOR,Korea,2010,8,2,6
KWT,Kuwait,KOR,Korea,2011,5,22,-17
KWT,Kuwait,KOR,Korea,2012,8,15,-7
KWT,Kuwait,KOR,Korea,2013,8,4,4
KWT,Kuwait,KOR,Korea,2014,12,20,-8
KWT,Kuwait,KOR,Korea,2015,9,15,-6
KWT,Kuwait,KOR,Korea,2016,16,11,5
KWT,Kuwait,KOR,Korea,2017,13,40,-27
KWT,Kuwait,LUX,Luxembourg,2008,0,0,0
KWT,Kuwait,LUX,Luxembourg,2009,0,0,0
KWT,Kuwait,LUX,Luxembourg,2010,0,0,0
KWT,Kuwait,LUX,Luxembourg,2011,2,0,2
KWT,Kuwait,LUX,Luxembourg,2012,0,0,0
KWT,Kuwait,LUX,Luxembourg,2013,0,0,0
KWT,Kuwait,LUX,Luxembourg,2014,1,0,1
KWT,Kuwait,LUX,Luxembourg,2015,0,0,0
KWT,Kuwait,LUX,Luxembourg,2016,0,0,0
KWT,Kuwait,LUX,Luxembourg,2017,3,0,3
KWT,Kuwait,MEX,Mexico,2008,1,0,1
KWT,Kuwait,MEX,Mexico,2012,0,0,0
KWT,Kuwait,MEX,Mexico,2013,0,0,0
KWT,Kuwait,MEX,Mexico,2014,0,0,0
KWT,Kuwait,NLD,Netherlands,2008,0,2,-2
KWT,Kuwait,NLD,Netherlands,2009,5,2,3
KWT,Kuwait,NLD,Netherlands,2010,4,3,1
KWT,Kuwait,NLD,Netherlands,2011,13,5,8
KWT,Kuwait,NLD,Netherlands,2012,14,6,8
KWT,Kuwait,NLD,Netherlands,2013,40,9,31
KWT,Kuwait,NLD,Netherlands,2014,47,13,34
KWT,Kuwait,NLD,Netherlands,2015,22,31,-9
KWT,Kuwait,NLD,Netherlands,2016,10,30,-20
KWT,Kuwait,NLD,Netherlands,2017,23,16,7
KWT,Kuwait,NZL,New Zealand,2008,2,1,1
KWT,Kuwait,NZL,New Zealand,2009,3,1,2
KWT,Kuwait,NZL,New Zealand,2010,44,1,43
KWT,Kuwait,NZL,New Zealand,2011,80,1,79
KWT,Kuwait,NZL,New Zealand,2012,73,1,72
KWT,Kuwait,NZL,New Zealand,2013,30,11,19
KWT,Kuwait,NZL,New Zealand,2014,16,2,14
KWT,Kuwait,NZL,New Zealand,2015,31,5,26
KWT,Kuwait,NZL,New Zealand,2016,23,8,15
KWT,Kuwait,NZL,New Zealand,2017,8,13,-5
KWT,Kuwait,NOR,Norway,2008,9,0,9
KWT,Kuwait,NOR,Norway,2009,1,1,0
KWT,Kuwait,NOR,Norway,2010,2,0,2
KWT,Kuwait,NOR,Norway,2011,1,0,1
KWT,Kuwait,NOR,Norway,2012,2,0,2
KWT,Kuwait,NOR,Norway,2013,1,0,1
KWT,Kuwait,NOR,Norway,2014,3,0,3
KWT,Kuwait,NOR,Norway,2015,1,0,1
KWT,Kuwait,NOR,Norway,2016,1,0,1
KWT,Kuwait,NOR,Norway,2017,5,3,2
KWT,Kuwait,POL,Poland,2009,1,0,1
KWT,Kuwait,POL,Poland,2010,1,0,1
KWT,Kuwait,POL,Poland,2011,1,0,1
KWT,Kuwait,POL,Poland,2012,5,0,5
KWT,Kuwait,POL,Poland,2013,3,0,3
KWT,Kuwait,POL,Poland,2014,3,0,3
KWT,Kuwait,POL,Poland,2015,5,0,5
KWT,Kuwait,POL,Poland,2016,2,0,2
KWT,Kuwait,POL,Poland,2017,54,0,54
KWT,Kuwait,SVK,Slovak Republic,2008,8,2,6
KWT,Kuwait,SVK,Slovak Republic,2009,2,9,-7
KWT,Kuwait,SVK,Slovak Republic,2010,1,8,-7
KWT,Kuwait,SVK,Slovak Republic,2011,4,1,3
KWT,Kuwait,SVK,Slovak Republic,2012,1,1,0
KWT,Kuwait,SVK,Slovak Republic,2014,1,0,1
KWT,Kuwait,SVK,Slovak Republic,2015,1,0,1
KWT,Kuwait,SVK,Slovak Republic,2017,1,0,1
KWT,Kuwait,ESP,Spain,2008,8,4,4
KWT,Kuwait,ESP,Spain,2009,15,6,9
KWT,Kuwait,ESP,Spain,2010,13,5,8
KWT,Kuwait,ESP,Spain,2011,26,5,21
KWT,Kuwait,ESP,Spain,2012,27,3,24
KWT,Kuwait,ESP,Spain,2013,32,15,17
KWT,Kuwait,ESP,Spain,2014,58,16,42
KWT,Kuwait,ESP,Spain,2015,43,5,38
KWT,Kuwait,ESP,Spain,2016,40,17,23
KWT,Kuwait,ESP,Spain,2017,57,32,25
KWT,Kuwait,SWE,Sweden,2008,1,2,-1
KWT,Kuwait,SWE,Sweden,2009,2,1,1
KWT,Kuwait,SWE,Sweden,2010,0,1,-1
KWT,Kuwait,SWE,Sweden,2011,4,0,4
KWT,Kuwait,SWE,Sweden,2012,7,2,5
KWT,Kuwait,SWE,Sweden,2013,9,1,8
KWT,Kuwait,SWE,Sweden,2014,16,2,14
KWT,Kuwait,SWE,Sweden,2015,4,1,3
KWT,Kuwait,SWE,Sweden,2016,3,2,1
KWT,Kuwait,SWE,Sweden,2017,26,0,26
KWT,Kuwait,CHE,Switzerland,2010,8,12,-4
KWT,Kuwait,CHE,Switzerland,2011,9,8,1
KWT,Kuwait,CHE,Switzerland,2012,10,11,-1
KWT,Kuwait,CHE,Switzerland,2013,14,5,9
KWT,Kuwait,CHE,Switzerland,2014,14,12,2
KWT,Kuwait,CHE,Switzerland,2015,5,6,-1
KWT,Kuwait,CHE,Switzerland,2016,8,3,5
KWT,Kuwait,CHE,Switzerland,2017,5,14,-9
KWT,Kuwait,TUR,Turkey,2010,9,0,9
KWT,Kuwait,TUR,Turkey,2016,200,93,107
KWT,Kuwait,TUR,Turkey,2017,369,122,247
KWT,Kuwait,GBR,United Kingdom,2011,1000,0,1000
KWT,Kuwait,GBR,United Kingdom,2012,1000,0,1000
KWT,Kuwait,GBR,United Kingdom,2013,1000,0,1000
KWT,Kuwait,GBR,United Kingdom,2014,2000,0,2000
KWT,Kuwait,GBR,United Kingdom,2015,1000,0,1000
KWT,Kuwait,USA,United States,2008,1104,0,1104
KWT,Kuwait,USA,United States,2009,1124,0,1124
KWT,Kuwait,USA,United States,2010,1037,0,1037
KWT,Kuwait,USA,United States,2011,973,0,973
KWT,Kuwait,USA,United States,2012,1044,0,1044
KWT,Kuwait,USA,United States,2013,937,0,937
KWT,Kuwait,USA,United States,2014,1057,0,1057
KWT,Kuwait,USA,United States,2015,1055,0,1055
KWT,Kuwait,USA,United States,2016,1186,0,1186
KWT,Kuwait,USA,United States,2017,1177,0,1177
KWT,Kuwait,CHL,Chile,2008,0,0,0
KWT,Kuwait,CHL,Chile,2009,0,0,0
KWT,Kuwait,CHL,Chile,2010,0,0,0
KWT,Kuwait,CHL,Chile,2011,0,0,0
KWT,Kuwait,CHL,Chile,2012,0,0,0
KWT,Kuwait,CHL,Chile,2013,0,0,0
KWT,Kuwait,CHL,Chile,2014,0,0,0
KWT,Kuwait,CHL,Chile,2015,0,0,0
KWT,Kuwait,CHL,Chile,2016,0,0,0
KWT,Kuwait,EST,Estonia,2008,0,0,0
KWT,Kuwait,EST,Estonia,2009,0,0,0
KWT,Kuwait,EST,Estonia,2010,0,0,0
KWT,Kuwait,EST,Estonia,2011,0,0,0
KWT,Kuwait,EST,Estonia,2012,0,0,0
KWT,Kuwait,EST,Estonia,2013,1,0,1
KWT,Kuwait,EST,Estonia,2014,0,0,0
KWT,Kuwait,EST,Estonia,2015,0,0,0
KWT,Kuwait,EST,Estonia,2016,0,0,0
KWT,Kuwait,EST,Estonia,2017,0,0,0
KWT,Kuwait,SVN,Slovenia,2017,1,0,1
KGZ,Kyrgyzstan,AUS,Australia,2008,33,0,33
KGZ,Kyrgyzstan,AUS,Australia,2009,27,5,22
KGZ,Kyrgyzstan,AUS,Australia,2010,32,0,32
KGZ,Kyrgyzstan,AUS,Australia,2011,23,5,18
KGZ,Kyrgyzstan,AUS,Australia,2012,18,5,13
KGZ,Kyrgyzstan,AUS,Australia,2013,23,11,12
KGZ,Kyrgyzstan,AUS,Australia,2014,14,7,7
KGZ,Kyrgyzstan,AUS,Australia,2015,17,0,17
KGZ,Kyrgyzstan,AUS,Australia,2016,22,0,22
KGZ,Kyrgyzstan,AUS,Australia,2017,21,0,21
KGZ,Kyrgyzstan,AUT,Austria,2008,95,49,46
KGZ,Kyrgyzstan,AUT,Austria,2009,71,62,9
KGZ,Kyrgyzstan,AUT,Austria,2010,128,50,78
KGZ,Kyrgyzstan,AUT,Austria,2011,109,78,31
KGZ,Kyrgyzstan,AUT,Austria,2012,112,59,53
KGZ,Kyrgyzstan,AUT,Austria,2013,98,63,35
KGZ,Kyrgyzstan,AUT,Austria,2014,61,52,9
KGZ,Kyrgyzstan,AUT,Austria,2015,85,55,30
KGZ,Kyrgyzstan,AUT,Austria,2016,95,45,50
KGZ,Kyrgyzstan,AUT,Austria,2017,103,62,41
KGZ,Kyrgyzstan,BEL,Belgium,2008,37,0,37
KGZ,Kyrgyzstan,BEL,Belgium,2009,35,0,35
KGZ,Kyrgyzstan,BEL,Belgium,2010,35,8,27
KGZ,Kyrgyzstan,BEL,Belgium,2012,105,47,58
KGZ,Kyrgyzstan,BEL,Belgium,2013,45,97,-52
KGZ,Kyrgyzstan,BEL,Belgium,2014,33,74,-41
KGZ,Kyrgyzstan,BEL,Belgium,2015,29,53,-24
KGZ,Kyrgyzstan,BEL,Belgium,2016,27,22,5
KGZ,Kyrgyzstan,BEL,Belgium,2017,37,18,19
KGZ,Kyrgyzstan,CAN,Canada,2008,167,0,167
KGZ,Kyrgyzstan,CAN,Canada,2009,173,0,173
KGZ,Kyrgyzstan,CAN,Canada,2010,157,0,157
KGZ,Kyrgyzstan,CAN,Canada,2011,159,0,159
KGZ,Kyrgyzstan,CAN,Canada,2012,278,0,278
KGZ,Kyrgyzstan,CAN,Canada,2013,123,0,123
KGZ,Kyrgyzstan,CAN,Canada,2014,126,0,126
KGZ,Kyrgyzstan,CAN,Canada,2015,132,0,132
KGZ,Kyrgyzstan,CAN,Canada,2016,250,0,250
KGZ,Kyrgyzstan,CAN,Canada,2017,135,0,135
KGZ,Kyrgyzstan,CZE,Czech Republic,2008,81,1,80
KGZ,Kyrgyzstan,CZE,Czech Republic,2009,84,0,84
KGZ,Kyrgyzstan,CZE,Czech Republic,2010,64,1,63
KGZ,Kyrgyzstan,CZE,Czech Republic,2011,48,1,47
KGZ,Kyrgyzstan,CZE,Czech Republic,2012,68,35,33
KGZ,Kyrgyzstan,CZE,Czech Republic,2013,51,78,-27
KGZ,Kyrgyzstan,CZE,Czech Republic,2014,77,31,46
KGZ,Kyrgyzstan,CZE,Czech Republic,2015,44,48,-4
KGZ,Kyrgyzstan,CZE,Czech Republic,2016,70,22,48
KGZ,Kyrgyzstan,CZE,Czech Republic,2017,125,32,93
KGZ,Kyrgyzstan,DNK,Denmark,2008,5,1,4
KGZ,Kyrgyzstan,DNK,Denmark,2009,3,3,0
KGZ,Kyrgyzstan,DNK,Denmark,2010,4,1,3
KGZ,Kyrgyzstan,DNK,Denmark,2011,5,1,4
KGZ,Kyrgyzstan,DNK,Denmark,2012,6,3,3
KGZ,Kyrgyzstan,DNK,Denmark,2013,2,1,1
KGZ,Kyrgyzstan,DNK,Denmark,2014,4,1,3
KGZ,Kyrgyzstan,DNK,Denmark,2015,3,1,2
KGZ,Kyrgyzstan,DNK,Denmark,2016,9,5,4
KGZ,Kyrgyzstan,DNK,Denmark,2017,1,1,0
KGZ,Kyrgyzstan,FIN,Finland,2008,20,2,18
KGZ,Kyrgyzstan,FIN,Finland,2009,18,2,16
KGZ,Kyrgyzstan,FIN,Finland,2010,19,1,18
KGZ,Kyrgyzstan,FIN,Finland,2011,6,1,5
KGZ,Kyrgyzstan,FIN,Finland,2012,10,3,7
KGZ,Kyrgyzstan,FIN,Finland,2013,6,0,6
KGZ,Kyrgyzstan,FIN,Finland,2014,5,1,4
KGZ,Kyrgyzstan,FIN,Finland,2015,15,1,14
KGZ,Kyrgyzstan,FIN,Finland,2016,1,4,-3
KGZ,Kyrgyzstan,FIN,Finland,2017,24,1,23
KGZ,Kyrgyzstan,FRA,France,2008,58,0,58
KGZ,Kyrgyzstan,FRA,France,2009,53,0,53
KGZ,Kyrgyzstan,FRA,France,2010,47,0,47
KGZ,Kyrgyzstan,FRA,France,2011,49,0,49
KGZ,Kyrgyzstan,FRA,France,2012,57,0,57
KGZ,Kyrgyzstan,FRA,France,2013,78,0,78
KGZ,Kyrgyzstan,FRA,France,2014,70,0,70
KGZ,Kyrgyzstan,FRA,France,2015,57,0,57
KGZ,Kyrgyzstan,FRA,France,2016,63,0,63
KGZ,Kyrgyzstan,FRA,France,2017,63,0,63
KGZ,Kyrgyzstan,DEU,Germany,2008,708,673,35
KGZ,Kyrgyzstan,DEU,Germany,2009,599,591,8
KGZ,Kyrgyzstan,DEU,Germany,2010,620,399,221
KGZ,Kyrgyzstan,DEU,Germany,2011,707,391,316
KGZ,Kyrgyzstan,DEU,Germany,2012,613,465,148
KGZ,Kyrgyzstan,DEU,Germany,2013,622,200,422
KGZ,Kyrgyzstan,DEU,Germany,2014,618,422,196
KGZ,Kyrgyzstan,DEU,Germany,2015,660,453,207
KGZ,Kyrgyzstan,DEU,Germany,2016,639,437,202
KGZ,Kyrgyzstan,DEU,Germany,2017,839,442,397
KGZ,Kyrgyzstan,HUN,Hungary,2008,17,0,17
KGZ,Kyrgyzstan,HUN,Hungary,2009,10,0,10
KGZ,Kyrgyzstan,HUN,Hungary,2010,18,0,18
KGZ,Kyrgyzstan,HUN,Hungary,2011,23,0,23
KGZ,Kyrgyzstan,HUN,Hungary,2012,16,0,16
KGZ,Kyrgyzstan,HUN,Hungary,2013,7,0,7
KGZ,Kyrgyzstan,HUN,Hungary,2014,23,1,22
KGZ,Kyrgyzstan,HUN,Hungary,2015,26,1,25
KGZ,Kyrgyzstan,HUN,Hungary,2016,15,0,15
KGZ,Kyrgyzstan,HUN,Hungary,2017,47,0,47
KGZ,Kyrgyzstan,ISL,Iceland,2008,1,0,1
KGZ,Kyrgyzstan,ISL,Iceland,2009,0,0,0
KGZ,Kyrgyzstan,ISL,Iceland,2010,1,1,0
KGZ,Kyrgyzstan,ISL,Iceland,2011,0,1,-1
KGZ,Kyrgyzstan,ISL,Iceland,2012,0,0,0
KGZ,Kyrgyzstan,ISL,Iceland,2013,2,2,0
KGZ,Kyrgyzstan,ISL,Iceland,2014,0,0,0
KGZ,Kyrgyzstan,ISL,Iceland,2015,2,2,0
KGZ,Kyrgyzstan,ISL,Iceland,2016,1,1,0
KGZ,Kyrgyzstan,ISL,Iceland,2017,0,0,0
KGZ,Kyrgyzstan,ITA,Italy,2008,96,3,93
KGZ,Kyrgyzstan,ITA,Italy,2009,110,4,106
KGZ,Kyrgyzstan,ITA,Italy,2010,281,1,280
KGZ,Kyrgyzstan,ITA,Italy,2011,177,0,177
KGZ,Kyrgyzstan,ITA,Italy,2012,172,11,161
KGZ,Kyrgyzstan,ITA,Italy,2013,161,5,156
KGZ,Kyrgyzstan,ITA,Italy,2014,75,5,70
KGZ,Kyrgyzstan,ITA,Italy,2015,100,6,94
KGZ,Kyrgyzstan,ITA,Italy,2016,84,0,84
KGZ,Kyrgyzstan,ITA,Italy,2017,133,18,115
KGZ,Kyrgyzstan,JPN,Japan,2008,250,204,46
KGZ,Kyrgyzstan,JPN,Japan,2009,227,216,11
KGZ,Kyrgyzstan,JPN,Japan,2010,171,156,15
KGZ,Kyrgyzstan,JPN,Japan,2011,185,174,11
KGZ,Kyrgyzstan,JPN,Japan,2012,206,171,35
KGZ,Kyrgyzstan,JPN,Japan,2013,248,205,43
KGZ,Kyrgyzstan,JPN,Japan,2014,269,217,52
KGZ,Kyrgyzstan,JPN,Japan,2015,299,221,78
KGZ,Kyrgyzstan,JPN,Japan,2016,324,265,59
KGZ,Kyrgyzstan,JPN,Japan,2017,336,268,68
KGZ,Kyrgyzstan,KOR,Korea,2008,874,998,-124
KGZ,Kyrgyzstan,KOR,Korea,2009,585,714,-129
KGZ,Kyrgyzstan,KOR,Korea,2010,817,607,210
KGZ,Kyrgyzstan,KOR,Korea,2011,656,626,30
KGZ,Kyrgyzstan,KOR,Korea,2012,772,636,136
KGZ,Kyrgyzstan,KOR,Korea,2013,897,765,132
KGZ,Kyrgyzstan,KOR,Korea,2014,1003,787,216
KGZ,Kyrgyzstan,KOR,Korea,2015,1385,813,572
KGZ,Kyrgyzstan,KOR,Korea,2016,1759,1053,706
KGZ,Kyrgyzstan,KOR,Korea,2017,1688,1238,450
KGZ,Kyrgyzstan,LUX,Luxembourg,2008,0,0,0
KGZ,Kyrgyzstan,LUX,Luxembourg,2009,2,0,2
KGZ,Kyrgyzstan,LUX,Luxembourg,2010,1,0,1
KGZ,Kyrgyzstan,LUX,Luxembourg,2011,2,1,1
KGZ,Kyrgyzstan,LUX,Luxembourg,2012,1,1,0
KGZ,Kyrgyzstan,LUX,Luxembourg,2013,1,3,-2
KGZ,Kyrgyzstan,LUX,Luxembourg,2014,4,2,2
KGZ,Kyrgyzstan,LUX,Luxembourg,2015,2,3,-1
KGZ,Kyrgyzstan,LUX,Luxembourg,2016,4,2,2
KGZ,Kyrgyzstan,LUX,Luxembourg,2017,4,1,3
KGZ,Kyrgyzstan,MEX,Mexico,2008,2,0,2
KGZ,Kyrgyzstan,MEX,Mexico,2009,2,0,2
KGZ,Kyrgyzstan,MEX,Mexico,2010,2,0,2
KGZ,Kyrgyzstan,MEX,Mexico,2011,1,0,1
KGZ,Kyrgyzstan,MEX,Mexico,2012,0,0,0
KGZ,Kyrgyzstan,MEX,Mexico,2013,3,0,3
KGZ,Kyrgyzstan,MEX,Mexico,2014,2,0,2
KGZ,Kyrgyzstan,MEX,Mexico,2017,1,0,1
KGZ,Kyrgyzstan,NLD,Netherlands,2009,16,7,9
KGZ,Kyrgyzstan,NLD,Netherlands,2010,10,6,4
KGZ,Kyrgyzstan,NLD,Netherlands,2013,25,6,19
KGZ,Kyrgyzstan,NLD,Netherlands,2014,21,11,10
KGZ,Kyrgyzstan,NLD,Netherlands,2015,32,13,19
KGZ,Kyrgyzstan,NLD,Netherlands,2016,17,20,-3
KGZ,Kyrgyzstan,NLD,Netherlands,2017,24,12,12
KGZ,Kyrgyzstan,NZL,New Zealand,2008,4,0,4
KGZ,Kyrgyzstan,NZL,New Zealand,2009,1,1,0
KGZ,Kyrgyzstan,NZL,New Zealand,2010,2,0,2
KGZ,Kyrgyzstan,NZL,New Zealand,2011,7,0,7
KGZ,Kyrgyzstan,NZL,New Zealand,2012,2,1,1
KGZ,Kyrgyzstan,NZL,New Zealand,2013,8,1,7
KGZ,Kyrgyzstan,NZL,New Zealand,2014,4,0,4
KGZ,Kyrgyzstan,NZL,New Zealand,2015,2,4,-2
KGZ,Kyrgyzstan,NZL,New Zealand,2016,5,0,5
KGZ,Kyrgyzstan,NZL,New Zealand,2017,13,0,13
KGZ,Kyrgyzstan,NOR,Norway,2008,16,3,13
KGZ,Kyrgyzstan,NOR,Norway,2009,9,1,8
KGZ,Kyrgyzstan,NOR,Norway,2010,12,0,12
KGZ,Kyrgyzstan,NOR,Norway,2011,8,2,6
KGZ,Kyrgyzstan,NOR,Norway,2012,15,10,5
KGZ,Kyrgyzstan,NOR,Norway,2013,33,9,24
KGZ,Kyrgyzstan,NOR,Norway,2014,18,22,-4
KGZ,Kyrgyzstan,NOR,Norway,2015,19,4,15
KGZ,Kyrgyzstan,NOR,Norway,2016,18,7,11
KGZ,Kyrgyzstan,NOR,Norway,2017,13,4,9
KGZ,Kyrgyzstan,POL,Poland,2008,30,0,30
KGZ,Kyrgyzstan,POL,Poland,2009,37,0,37
KGZ,Kyrgyzstan,POL,Poland,2010,45,0,45
KGZ,Kyrgyzstan,POL,Poland,2011,42,0,42
KGZ,Kyrgyzstan,POL,Poland,2012,28,0,28
KGZ,Kyrgyzstan,POL,Poland,2013,34,0,34
KGZ,Kyrgyzstan,POL,Poland,2014,24,0,24
KGZ,Kyrgyzstan,POL,Poland,2015,69,0,69
KGZ,Kyrgyzstan,POL,Poland,2016,119,0,119
KGZ,Kyrgyzstan,POL,Poland,2017,168,0,168
KGZ,Kyrgyzstan,SVK,Slovak Republic,2008,15,5,10
KGZ,Kyrgyzstan,SVK,Slovak Republic,2009,13,5,8
KGZ,Kyrgyzstan,SVK,Slovak Republic,2010,7,0,7
KGZ,Kyrgyzstan,SVK,Slovak Republic,2011,2,1,1
KGZ,Kyrgyzstan,SVK,Slovak Republic,2016,2,0,2
KGZ,Kyrgyzstan,ESP,Spain,2008,38,12,26
KGZ,Kyrgyzstan,ESP,Spain,2009,38,12,26
KGZ,Kyrgyzstan,ESP,Spain,2010,40,18,22
KGZ,Kyrgyzstan,ESP,Spain,2011,24,15,9
KGZ,Kyrgyzstan,ESP,Spain,2012,23,6,17
KGZ,Kyrgyzstan,ESP,Spain,2013,33,12,21
KGZ,Kyrgyzstan,ESP,Spain,2014,41,1,40
KGZ,Kyrgyzstan,ESP,Spain,2015,32,15,17
KGZ,Kyrgyzstan,ESP,Spain,2016,35,9,26
KGZ,Kyrgyzstan,ESP,Spain,2017,51,34,17
KGZ,Kyrgyzstan,SWE,Sweden,2008,41,3,38
KGZ,Kyrgyzstan,SWE,Sweden,2009,47,2,45
KGZ,Kyrgyzstan,SWE,Sweden,2010,50,4,46
KGZ,Kyrgyzstan,SWE,Sweden,2011,97,11,86
KGZ,Kyrgyzstan,SWE,Sweden,2012,127,12,115
KGZ,Kyrgyzstan,SWE,Sweden,2013,129,9,120
KGZ,Kyrgyzstan,SWE,Sweden,2014,84,24,60
KGZ,Kyrgyzstan,SWE,Sweden,2015,75,24,51
KGZ,Kyrgyzstan,SWE,Sweden,2016,63,14,49
KGZ,Kyrgyzstan,SWE,Sweden,2017,86,7,79
KGZ,Kyrgyzstan,CHE,Switzerland,2010,18,13,5
KGZ,Kyrgyzstan,CHE,Switzerland,2011,28,8,20
KGZ,Kyrgyzstan,CHE,Switzerland,2012,13,11,2
KGZ,Kyrgyzstan,CHE,Switzerland,2013,20,7,13
KGZ,Kyrgyzstan,CHE,Switzerland,2014,34,7,27
KGZ,Kyrgyzstan,CHE,Switzerland,2015,29,11,18
KGZ,Kyrgyzstan,CHE,Switzerland,2016,22,11,11
KGZ,Kyrgyzstan,CHE,Switzerland,2017,24,12,12
KGZ,Kyrgyzstan,TUR,Turkey,2010,1046,0,1046
KGZ,Kyrgyzstan,TUR,Turkey,2016,6012,2745,3267
KGZ,Kyrgyzstan,TUR,Turkey,2017,8982,4596,4386
KGZ,Kyrgyzstan,USA,United States,2008,632,0,632
KGZ,Kyrgyzstan,USA,United States,2009,574,0,574
KGZ,Kyrgyzstan,USA,United States,2010,507,0,507
KGZ,Kyrgyzstan,USA,United States,2011,542,0,542
KGZ,Kyrgyzstan,USA,United States,2012,648,0,648
KGZ,Kyrgyzstan,USA,United States,2013,652,0,652
KGZ,Kyrgyzstan,USA,United States,2014,707,0,707
KGZ,Kyrgyzstan,USA,United States,2015,790,0,790
KGZ,Kyrgyzstan,USA,United States,2016,847,0,847
KGZ,Kyrgyzstan,USA,United States,2017,715,0,715
KGZ,Kyrgyzstan,CHL,Chile,2008,1,0,1
KGZ,Kyrgyzstan,CHL,Chile,2009,0,0,0
KGZ,Kyrgyzstan,CHL,Chile,2010,0,0,0
KGZ,Kyrgyzstan,CHL,Chile,2011,3,0,3
KGZ,Kyrgyzstan,CHL,Chile,2012,0,0,0
KGZ,Kyrgyzstan,CHL,Chile,2013,0,0,0
KGZ,Kyrgyzstan,CHL,Chile,2014,0,0,0
KGZ,Kyrgyzstan,CHL,Chile,2015,0,0,0
KGZ,Kyrgyzstan,CHL,Chile,2016,0,0,0
KGZ,Kyrgyzstan,EST,Estonia,2008,3,0,3
KGZ,Kyrgyzstan,EST,Estonia,2009,1,0,1
KGZ,Kyrgyzstan,EST,Estonia,2010,0,0,0
KGZ,Kyrgyzstan,EST,Estonia,2011,3,0,3
KGZ,Kyrgyzstan,EST,Estonia,2012,1,0,1
KGZ,Kyrgyzstan,EST,Estonia,2013,0,0,0
KGZ,Kyrgyzstan,EST,Estonia,2014,0,0,0
KGZ,Kyrgyzstan,EST,Estonia,2015,5,0,5
KGZ,Kyrgyzstan,EST,Estonia,2016,5,0,5
KGZ,Kyrgyzstan,EST,Estonia,2017,6,0,6
KGZ,Kyrgyzstan,SVN,Slovenia,2008,2,0,2
KGZ,Kyrgyzstan,SVN,Slovenia,2009,1,0,1
KGZ,Kyrgyzstan,SVN,Slovenia,2010,1,0,1
KGZ,Kyrgyzstan,SVN,Slovenia,2012,6,0,6
KGZ,Kyrgyzstan,SVN,Slovenia,2013,3,0,3
KGZ,Kyrgyzstan,SVN,Slovenia,2014,3,0,3
KGZ,Kyrgyzstan,SVN,Slovenia,2015,1,0,1
KGZ,Kyrgyzstan,SVN,Slovenia,2016,1,0,1
KGZ,Kyrgyzstan,SVN,Slovenia,2017,2,0,2
LAO,Laos,AUS,Australia,2008,91,49,42
LAO,Laos,AUS,Australia,2009,86,36,50
LAO,Laos,AUS,Australia,2010,69,43,26
LAO,Laos,AUS,Australia,2011,302,46,256
LAO,Laos,AUS,Australia,2012,142,39,103
LAO,Laos,AUS,Australia,2013,79,46,33
LAO,Laos,AUS,Australia,2014,88,34,54
LAO,Laos,AUS,Australia,2015,61,0,61
LAO,Laos,AUS,Australia,2016,85,0,85
LAO,Laos,AUS,Australia,2017,55,0,55
LAO,Laos,AUT,Austria,2008,2,1,1
LAO,Laos,AUT,Austria,2009,2,1,1
LAO,Laos,AUT,Austria,2010,6,3,3
LAO,Laos,AUT,Austria,2011,2,4,-2
LAO,Laos,AUT,Austria,2012,5,2,3
LAO,Laos,AUT,Austria,2013,3,4,-1
LAO,Laos,AUT,Austria,2014,3,0,3
LAO,Laos,AUT,Austria,2015,5,4,1
LAO,Laos,AUT,Austria,2016,4,2,2
LAO,Laos,AUT,Austria,2017,4,0,4
LAO,Laos,BEL,Belgium,2008,15,0,15
LAO,Laos,BEL,Belgium,2009,14,0,14
LAO,Laos,BEL,Belgium,2010,9,4,5
LAO,Laos,BEL,Belgium,2012,13,9,4
LAO,Laos,BEL,Belgium,2013,10,5,5
LAO,Laos,BEL,Belgium,2014,6,3,3
LAO,Laos,BEL,Belgium,2015,9,2,7
LAO,Laos,BEL,Belgium,2016,9,4,5
LAO,Laos,BEL,Belgium,2017,6,3,3
LAO,Laos,CAN,Canada,2008,32,0,32
LAO,Laos,CAN,Canada,2009,39,0,39
LAO,Laos,CAN,Canada,2010,54,0,54
LAO,Laos,CAN,Canada,2011,22,0,22
LAO,Laos,CAN,Canada,2012,25,0,25
LAO,Laos,CAN,Canada,2013,15,0,15
LAO,Laos,CAN,Canada,2014,28,0,28
LAO,Laos,CAN,Canada,2015,19,0,19
LAO,Laos,CAN,Canada,2016,20,0,20
LAO,Laos,CAN,Canada,2017,25,0,25
LAO,Laos,CZE,Czech Republic,2008,2,0,2
LAO,Laos,CZE,Czech Republic,2009,6,0,6
LAO,Laos,CZE,Czech Republic,2010,1,0,1
LAO,Laos,CZE,Czech Republic,2012,7,1,6
LAO,Laos,CZE,Czech Republic,2013,1,2,-1
LAO,Laos,DNK,Denmark,2008,2,0,2
LAO,Laos,DNK,Denmark,2009,2,7,-5
LAO,Laos,DNK,Denmark,2010,1,0,1
LAO,Laos,DNK,Denmark,2012,4,0,4
LAO,Laos,DNK,Denmark,2013,4,1,3
LAO,Laos,DNK,Denmark,2014,6,2,4
LAO,Laos,DNK,Denmark,2015,0,0,0
LAO,Laos,DNK,Denmark,2016,3,2,1
LAO,Laos,DNK,Denmark,2017,1,2,-1
LAO,Laos,FIN,Finland,2008,3,0,3
LAO,Laos,FIN,Finland,2009,4,0,4
LAO,Laos,FIN,Finland,2010,3,0,3
LAO,Laos,FIN,Finland,2011,5,0,5
LAO,Laos,FIN,Finland,2012,4,0,4
LAO,Laos,FIN,Finland,2013,6,0,6
LAO,Laos,FIN,Finland,2014,4,0,4
LAO,Laos,FIN,Finland,2015,2,0,2
LAO,Laos,FIN,Finland,2016,2,0,2
LAO,Laos,FIN,Finland,2017,5,0,5
LAO,Laos,FRA,France,2008,118,0,118
LAO,Laos,FRA,France,2009,115,0,115
LAO,Laos,FRA,France,2010,90,0,90
LAO,Laos,FRA,France,2011,107,0,107
LAO,Laos,FRA,France,2012,120,0,120
LAO,Laos,FRA,France,2013,139,0,139
LAO,Laos,FRA,France,2014,123,0,123
LAO,Laos,FRA,France,2015,105,0,105
LAO,Laos,FRA,France,2016,100,0,100
LAO,Laos,FRA,France,2017,106,0,106
LAO,Laos,DEU,Germany,2008,28,43,-15
LAO,Laos,DEU,Germany,2009,56,45,11
LAO,Laos,DEU,Germany,2010,51,52,-1
LAO,Laos,DEU,Germany,2011,62,27,35
LAO,Laos,DEU,Germany,2012,58,35,23
LAO,Laos,DEU,Germany,2013,41,53,-12
LAO,Laos,DEU,Germany,2014,42,21,21
LAO,Laos,DEU,Germany,2015,52,37,15
LAO,Laos,DEU,Germany,2016,43,23,20
LAO,Laos,DEU,Germany,2017,34,20,14
LAO,Laos,HUN,Hungary,2008,1,0,1
LAO,Laos,HUN,Hungary,2009,1,0,1
LAO,Laos,HUN,Hungary,2010,1,0,1
LAO,Laos,HUN,Hungary,2011,2,0,2
LAO,Laos,HUN,Hungary,2012,1,0,1
LAO,Laos,HUN,Hungary,2013,1,0,1
LAO,Laos,HUN,Hungary,2014,11,0,11
LAO,Laos,HUN,Hungary,2015,14,0,14
LAO,Laos,HUN,Hungary,2016,11,1,10
LAO,Laos,HUN,Hungary,2017,25,0,25
LAO,Laos,ISL,Iceland,2008,1,0,1
LAO,Laos,ISL,Iceland,2009,0,1,-1
LAO,Laos,ISL,Iceland,2010,0,0,0
LAO,Laos,ISL,Iceland,2011,0,0,0
LAO,Laos,ISL,Iceland,2012,0,0,0
LAO,Laos,ISL,Iceland,2014,1,0,1
LAO,Laos,ISL,Iceland,2016,0,0,0
LAO,Laos,ISL,Iceland,2017,0,0,0
LAO,Laos,ITA,Italy,2008,8,3,5
LAO,Laos,ITA,Italy,2009,5,4,1
LAO,Laos,ITA,Italy,2010,1,0,1
LAO,Laos,ITA,Italy,2011,3,1,2
LAO,Laos,ITA,Italy,2012,13,0,13
LAO,Laos,ITA,Italy,2013,6,1,5
LAO,Laos,ITA,Italy,2014,5,1,4
LAO,Laos,ITA,Italy,2015,4,1,3
LAO,Laos,ITA,Italy,2016,6,0,6
LAO,Laos,ITA,Italy,2017,1,0,1
LAO,Laos,JPN,Japan,2008,859,722,137
LAO,Laos,JPN,Japan,2009,858,747,111
LAO,Laos,JPN,Japan,2010,855,812,43
LAO,Laos,JPN,Japan,2011,764,744,20
LAO,Laos,JPN,Japan,2012,847,773,74
LAO,Laos,JPN,Japan,2013,895,791,104
LAO,Laos,JPN,Japan,2014,733,662,71
LAO,Laos,JPN,Japan,2015,1154,1068,86
LAO,Laos,JPN,Japan,2016,1203,1058,145
LAO,Laos,JPN,Japan,2017,1316,1182,134
LAO,Laos,KOR,Korea,2008,65,53,12
LAO,Laos,KOR,Korea,2009,65,39,26
LAO,Laos,KOR,Korea,2010,117,56,61
LAO,Laos,KOR,Korea,2011,242,98,144
LAO,Laos,KOR,Korea,2012,231,123,108
LAO,Laos,KOR,Korea,2013,271,141,130
LAO,Laos,KOR,Korea,2014,267,152,115
LAO,Laos,KOR,Korea,2015,225,200,25
LAO,Laos,KOR,Korea,2016,216,155,61
LAO,Laos,KOR,Korea,2017,252,201,51
LAO,Laos,LUX,Luxembourg,2008,1,0,1
LAO,Laos,LUX,Luxembourg,2009,2,0,2
LAO,Laos,LUX,Luxembourg,2010,0,0,0
LAO,Laos,LUX,Luxembourg,2011,0,0,0
LAO,Laos,LUX,Luxembourg,2012,2,2,0
LAO,Laos,LUX,Luxembourg,2013,5,1,4
LAO,Laos,LUX,Luxembourg,2014,4,5,-1
LAO,Laos,LUX,Luxembourg,2015,2,4,-2
LAO,Laos,LUX,Luxembourg,2016,0,1,-1
LAO,Laos,LUX,Luxembourg,2017,1,0,1
LAO,Laos,MEX,Mexico,2012,0,0,0
LAO,Laos,MEX,Mexico,2013,0,0,0
LAO,Laos,MEX,Mexico,2014,0,0,0
LAO,Laos,NLD,Netherlands,2008,7,2,5
LAO,Laos,NLD,Netherlands,2009,8,0,8
LAO,Laos,NLD,Netherlands,2010,7,4,3
LAO,Laos,NLD,Netherlands,2011,4,1,3
LAO,Laos,NLD,Netherlands,2012,7,1,6
LAO,Laos,NLD,Netherlands,2013,5,2,3
LAO,Laos,NLD,Netherlands,2014,4,2,2
LAO,Laos,NLD,Netherlands,2015,3,2,1
LAO,Laos,NLD,Netherlands,2016,6,1,5
LAO,Laos,NLD,Netherlands,2017,4,1,3
LAO,Laos,NZL,New Zealand,2008,33,3,30
LAO,Laos,NZL,New Zealand,2009,22,19,3
LAO,Laos,NZL,New Zealand,2010,21,24,-3
LAO,Laos,NZL,New Zealand,2011,19,9,10
LAO,Laos,NZL,New Zealand,2012,36,22,14
LAO,Laos,NZL,New Zealand,2013,52,12,40
LAO,Laos,NZL,New Zealand,2014,55,27,28
LAO,Laos,NZL,New Zealand,2015,62,19,43
LAO,Laos,NZL,New Zealand,2016,39,26,13
LAO,Laos,NZL,New Zealand,2017,70,21,49
LAO,Laos,NOR,Norway,2008,11,4,7
LAO,Laos,NOR,Norway,2009,8,5,3
LAO,Laos,NOR,Norway,2010,6,2,4
LAO,Laos,NOR,Norway,2011,9,5,4
LAO,Laos,NOR,Norway,2012,9,3,6
LAO,Laos,NOR,Norway,2013,2,2,0
LAO,Laos,NOR,Norway,2014,3,2,1
LAO,Laos,NOR,Norway,2015,3,3,0
LAO,Laos,NOR,Norway,2016,7,0,7
LAO,Laos,NOR,Norway,2017,8,1,7
LAO,Laos,POL,Poland,2009,3,0,3
LAO,Laos,POL,Poland,2010,4,0,4
LAO,Laos,POL,Poland,2011,1,0,1
LAO,Laos,POL,Poland,2012,3,0,3
LAO,Laos,POL,Poland,2013,1,0,1
LAO,Laos,POL,Poland,2014,1,0,1
LAO,Laos,POL,Poland,2015,3,0,3
LAO,Laos,POL,Poland,2016,1,0,1
LAO,Laos,POL,Poland,2017,1,0,1
LAO,Laos,SVK,Slovak Republic,2008,1,1,0
LAO,Laos,SVK,Slovak Republic,2009,6,0,6
LAO,Laos,SVK,Slovak Republic,2011,3,4,-1
LAO,Laos,SVK,Slovak Republic,2012,1,0,1
LAO,Laos,ESP,Spain,2008,5,0,5
LAO,Laos,ESP,Spain,2009,0,2,-2
LAO,Laos,ESP,Spain,2010,0,0,0
LAO,Laos,ESP,Spain,2011,3,1,2
LAO,Laos,ESP,Spain,2012,2,1,1
LAO,Laos,ESP,Spain,2013,1,0,1
LAO,Laos,ESP,Spain,2014,4,1,3
LAO,Laos,ESP,Spain,2015,5,0,5
LAO,Laos,ESP,Spain,2016,7,0,7
LAO,Laos,ESP,Spain,2017,2,0,2
LAO,Laos,SWE,Sweden,2008,18,6,12
LAO,Laos,SWE,Sweden,2009,9,2,7
LAO,Laos,SWE,Sweden,2010,17,2,15
LAO,Laos,SWE,Sweden,2011,14,2,12
LAO,Laos,SWE,Sweden,2012,12,5,7
LAO,Laos,SWE,Sweden,2013,10,3,7
LAO,Laos,SWE,Sweden,2014,8,3,5
LAO,Laos,SWE,Sweden,2015,9,15,-6
LAO,Laos,SWE,Sweden,2016,8,0,8
LAO,Laos,SWE,Sweden,2017,8,2,6
LAO,Laos,CHE,Switzerland,2010,15,2,13
LAO,Laos,CHE,Switzerland,2011,6,9,-3
LAO,Laos,CHE,Switzerland,2012,5,2,3
LAO,Laos,CHE,Switzerland,2013,12,5,7
LAO,Laos,CHE,Switzerland,2014,13,5,8
LAO,Laos,CHE,Switzerland,2015,8,4,4
LAO,Laos,CHE,Switzerland,2016,12,6,6
LAO,Laos,CHE,Switzerland,2017,26,7,19
LAO,Laos,USA,United States,2008,2198,0,2198
LAO,Laos,USA,United States,2009,1688,0,1688
LAO,Laos,USA,United States,2010,1200,0,1200
LAO,Laos,USA,United States,2011,956,0,956
LAO,Laos,USA,United States,2012,949,0,949
LAO,Laos,USA,United States,2013,923,0,923
LAO,Laos,USA,United States,2014,806,0,806
LAO,Laos,USA,United States,2015,917,0,917
LAO,Laos,USA,United States,2016,856,0,856
LAO,Laos,USA,United States,2017,685,0,685
LAO,Laos,CHL,Chile,2008,0,0,0
LAO,Laos,CHL,Chile,2009,0,0,0
LAO,Laos,CHL,Chile,2010,0,0,0
LAO,Laos,CHL,Chile,2011,0,0,0
LAO,Laos,CHL,Chile,2012,0,0,0
LAO,Laos,CHL,Chile,2013,1,0,1
LAO,Laos,CHL,Chile,2014,0,0,0
LAO,Laos,CHL,Chile,2015,0,0,0
LAO,Laos,CHL,Chile,2016,0,0,0
LAO,Laos,EST,Estonia,2008,1,0,1
LAO,Laos,EST,Estonia,2009,0,0,0
LAO,Laos,EST,Estonia,2010,0,0,0
LAO,Laos,EST,Estonia,2011,0,0,0
LAO,Laos,EST,Estonia,2012,0,0,0
LAO,Laos,EST,Estonia,2013,0,0,0
LAO,Laos,EST,Estonia,2014,0,0,0
LAO,Laos,EST,Estonia,2015,0,0,0
LAO,Laos,EST,Estonia,2016,0,0,0
LAO,Laos,EST,Estonia,2017,0,0,0
LAO,Laos,SVN,Slovenia,2009,1,0,1
LAO,Laos,SVN,Slovenia,2010,1,0,1
LAO,Laos,SVN,Slovenia,2017,1,0,1
LVA,Latvia,AUS,Australia,2008,47,1,46
LVA,Latvia,AUS,Australia,2009,48,4,44
LVA,Latvia,AUS,Australia,2010,74,4,70
LVA,Latvia,AUS,Australia,2011,44,0,44
LVA,Latvia,AUS,Australia,2012,70,0,70
LVA,Latvia,AUS,Australia,2013,47,0,47
LVA,Latvia,AUS,Australia,2014,48,2,46
LVA,Latvia,AUS,Australia,2015,38,2,36
LVA,Latvia,AUS,Australia,2016,54,0,54
LVA,Latvia,AUS,Australia,2017,34,4,30
LVA,Latvia,AUT,Austria,2008,110,17,93
LVA,Latvia,AUT,Austria,2009,181,16,165
LVA,Latvia,AUT,Austria,2010,195,15,180
LVA,Latvia,AUT,Austria,2011,303,0,303
LVA,Latvia,AUT,Austria,2012,360,0,360
LVA,Latvia,AUT,Austria,2013,286,0,286
LVA,Latvia,AUT,Austria,2014,274,7,267
LVA,Latvia,AUT,Austria,2015,296,7,289
LVA,Latvia,AUT,Austria,2016,187,0,187
LVA,Latvia,AUT,Austria,2017,268,9,259
LVA,Latvia,BEL,Belgium,2008,163,3,160
LVA,Latvia,BEL,Belgium,2009,253,11,242
LVA,Latvia,BEL,Belgium,2010,325,12,313
LVA,Latvia,BEL,Belgium,2011,439,0,439
LVA,Latvia,BEL,Belgium,2012,352,0,352
LVA,Latvia,BEL,Belgium,2013,274,0,274
LVA,Latvia,BEL,Belgium,2014,185,2,183
LVA,Latvia,BEL,Belgium,2015,155,2,153
LVA,Latvia,BEL,Belgium,2016,190,0,190
LVA,Latvia,BEL,Belgium,2017,240,9,231
LVA,Latvia,CAN,Canada,2008,67,9,58
LVA,Latvia,CAN,Canada,2009,85,7,78
LVA,Latvia,CAN,Canada,2010,70,8,62
LVA,Latvia,CAN,Canada,2011,103,0,103
LVA,Latvia,CAN,Canada,2012,199,0,199
LVA,Latvia,CAN,Canada,2013,215,0,215
LVA,Latvia,CAN,Canada,2014,163,6,157
LVA,Latvia,CAN,Canada,2015,130,6,124
LVA,Latvia,CAN,Canada,2016,135,0,135
LVA,Latvia,CAN,Canada,2017,105,18,87
LVA,Latvia,CZE,Czech Republic,2008,18,27,-9
LVA,Latvia,CZE,Czech Republic,2009,27,23,4
LVA,Latvia,CZE,Czech Republic,2010,47,9,38
LVA,Latvia,CZE,Czech Republic,2011,48,0,48
LVA,Latvia,CZE,Czech Republic,2012,45,0,45
LVA,Latvia,CZE,Czech Republic,2013,64,0,64
LVA,Latvia,CZE,Czech Republic,2014,58,3,55
LVA,Latvia,CZE,Czech Republic,2015,57,3,54
LVA,Latvia,CZE,Czech Republic,2016,37,0,37
LVA,Latvia,CZE,Czech Republic,2017,47,10,37
LVA,Latvia,DNK,Denmark,2008,442,19,423
LVA,Latvia,DNK,Denmark,2009,729,44,685
LVA,Latvia,DNK,Denmark,2010,860,20,840
LVA,Latvia,DNK,Denmark,2011,814,0,814
LVA,Latvia,DNK,Denmark,2012,676,0,676
LVA,Latvia,DNK,Denmark,2013,682,0,682
LVA,Latvia,DNK,Denmark,2014,588,13,575
LVA,Latvia,DNK,Denmark,2015,539,13,526
LVA,Latvia,DNK,Denmark,2016,503,0,503
LVA,Latvia,DNK,Denmark,2017,560,18,542
LVA,Latvia,FIN,Finland,2008,91,53,38
LVA,Latvia,FIN,Finland,2009,129,34,95
LVA,Latvia,FIN,Finland,2010,186,39,147
LVA,Latvia,FIN,Finland,2011,219,0,219
LVA,Latvia,FIN,Finland,2012,178,0,178
LVA,Latvia,FIN,Finland,2013,198,0,198
LVA,Latvia,FIN,Finland,2014,244,48,196
LVA,Latvia,FIN,Finland,2015,203,48,155
LVA,Latvia,FIN,Finland,2016,195,0,195
LVA,Latvia,FIN,Finland,2017,267,20,247
LVA,Latvia,FRA,France,2008,0,76,-76
LVA,Latvia,FRA,France,2009,0,51,-51
LVA,Latvia,FRA,France,2010,0,63,-63
LVA,Latvia,FRA,France,2011,0,0,0
LVA,Latvia,FRA,France,2012,0,0,0
LVA,Latvia,FRA,France,2013,337,0,337
LVA,Latvia,FRA,France,2014,262,18,244
LVA,Latvia,FRA,France,2015,70,18,52
LVA,Latvia,FRA,France,2016,190,0,190
LVA,Latvia,FRA,France,2017,106,36,70
LVA,Latvia,DEU,Germany,2008,2066,209,1857
LVA,Latvia,DEU,Germany,2009,4896,161,4735
LVA,Latvia,DEU,Germany,2010,7485,176,7309
LVA,Latvia,DEU,Germany,2011,10034,0,10034
LVA,Latvia,DEU,Germany,2012,9212,0,9212
LVA,Latvia,DEU,Germany,2013,8403,234,8169
LVA,Latvia,DEU,Germany,2014,7457,235,7222
LVA,Latvia,DEU,Germany,2015,6608,235,6373
LVA,Latvia,DEU,Germany,2016,6529,0,6529
LVA,Latvia,DEU,Germany,2017,7283,99,7184
LVA,Latvia,HUN,Hungary,2008,7,14,-7
LVA,Latvia,HUN,Hungary,2009,17,3,14
LVA,Latvia,HUN,Hungary,2010,12,2,10
LVA,Latvia,HUN,Hungary,2011,21,0,21
LVA,Latvia,HUN,Hungary,2012,23,0,23
LVA,Latvia,HUN,Hungary,2013,27,0,27
LVA,Latvia,HUN,Hungary,2014,15,3,12
LVA,Latvia,HUN,Hungary,2015,20,3,17
LVA,Latvia,HUN,Hungary,2016,13,0,13
LVA,Latvia,HUN,Hungary,2017,19,5,14
LVA,Latvia,ISL,Iceland,2008,254,8,246
LVA,Latvia,ISL,Iceland,2009,160,9,151
LVA,Latvia,ISL,Iceland,2010,106,6,100
LVA,Latvia,ISL,Iceland,2011,95,0,95
LVA,Latvia,ISL,Iceland,2012,59,0,59
LVA,Latvia,ISL,Iceland,2013,91,0,91
LVA,Latvia,ISL,Iceland,2014,102,1,101
LVA,Latvia,ISL,Iceland,2015,127,1,126
LVA,Latvia,ISL,Iceland,2016,155,0,155
LVA,Latvia,ISL,Iceland,2017,601,0,601
LVA,Latvia,ITA,Italy,2008,266,48,218
LVA,Latvia,ITA,Italy,2009,293,52,241
LVA,Latvia,ITA,Italy,2010,330,40,290
LVA,Latvia,ITA,Italy,2011,321,0,321
LVA,Latvia,ITA,Italy,2012,272,0,272
LVA,Latvia,ITA,Italy,2013,190,0,190
LVA,Latvia,ITA,Italy,2014,169,44,125
LVA,Latvia,ITA,Italy,2015,192,44,148
LVA,Latvia,ITA,Italy,2016,171,0,171
LVA,Latvia,ITA,Italy,2017,144,40,104
LVA,Latvia,JPN,Japan,2008,104,0,104
LVA,Latvia,JPN,Japan,2009,71,0,71
LVA,Latvia,JPN,Japan,2010,210,0,210
LVA,Latvia,JPN,Japan,2011,49,0,49
LVA,Latvia,JPN,Japan,2012,132,0,132
LVA,Latvia,JPN,Japan,2013,54,0,54
LVA,Latvia,JPN,Japan,2014,51,3,48
LVA,Latvia,JPN,Japan,2015,157,3,154
LVA,Latvia,JPN,Japan,2016,246,0,246
LVA,Latvia,JPN,Japan,2017,120,5,115
LVA,Latvia,KOR,Korea,2008,6,28,-22
LVA,Latvia,KOR,Korea,2009,15,10,5
LVA,Latvia,KOR,Korea,2010,15,10,5
LVA,Latvia,KOR,Korea,2011,10,0,10
LVA,Latvia,KOR,Korea,2012,16,0,16
LVA,Latvia,KOR,Korea,2013,10,0,10
LVA,Latvia,KOR,Korea,2014,16,12,4
LVA,Latvia,KOR,Korea,2015,37,12,25
LVA,Latvia,KOR,Korea,2016,25,0,25
LVA,Latvia,KOR,Korea,2017,17,6,11
LVA,Latvia,LUX,Luxembourg,2008,53,0,53
LVA,Latvia,LUX,Luxembourg,2009,50,2,48
LVA,Latvia,LUX,Luxembourg,2010,64,0,64
LVA,Latvia,LUX,Luxembourg,2011,85,0,85
LVA,Latvia,LUX,Luxembourg,2012,59,0,59
LVA,Latvia,LUX,Luxembourg,2013,72,0,72
LVA,Latvia,LUX,Luxembourg,2014,84,0,84
LVA,Latvia,LUX,Luxembourg,2015,68,0,68
LVA,Latvia,LUX,Luxembourg,2016,65,0,65
LVA,Latvia,LUX,Luxembourg,2017,60,1,59
LVA,Latvia,MEX,Mexico,2008,5,1,4
LVA,Latvia,MEX,Mexico,2009,11,8,3
LVA,Latvia,MEX,Mexico,2010,2,8,-6
LVA,Latvia,MEX,Mexico,2011,3,0,3
LVA,Latvia,MEX,Mexico,2012,3,0,3
LVA,Latvia,MEX,Mexico,2013,14,0,14
LVA,Latvia,MEX,Mexico,2014,6,2,4
LVA,Latvia,MEX,Mexico,2015,9,2,7
LVA,Latvia,MEX,Mexico,2016,13,0,13
LVA,Latvia,MEX,Mexico,2017,8,1,7
LVA,Latvia,NLD,Netherlands,2008,245,14,231
LVA,Latvia,NLD,Netherlands,2009,577,20,557
LVA,Latvia,NLD,Netherlands,2010,1016,13,1003
LVA,Latvia,NLD,Netherlands,2011,1059,0,1059
LVA,Latvia,NLD,Netherlands,2012,1181,0,1181
LVA,Latvia,NLD,Netherlands,2013,918,0,918
LVA,Latvia,NLD,Netherlands,2014,1074,19,1055
LVA,Latvia,NLD,Netherlands,2015,960,19,941
LVA,Latvia,NLD,Netherlands,2016,1009,0,1009
LVA,Latvia,NLD,Netherlands,2017,1189,10,1179
LVA,Latvia,NZL,New Zealand,2008,6,0,6
LVA,Latvia,NZL,New Zealand,2009,14,0,14
LVA,Latvia,NZL,New Zealand,2010,25,0,25
LVA,Latvia,NZL,New Zealand,2011,35,0,35
LVA,Latvia,NZL,New Zealand,2012,46,0,46
LVA,Latvia,NZL,New Zealand,2013,34,0,34
LVA,Latvia,NZL,New Zealand,2014,43,1,42
LVA,Latvia,NZL,New Zealand,2015,81,1,80
LVA,Latvia,NZL,New Zealand,2016,77,0,77
LVA,Latvia,NZL,New Zealand,2017,68,8,60
LVA,Latvia,NOR,Norway,2008,614,36,578
LVA,Latvia,NOR,Norway,2009,1129,38,1091
LVA,Latvia,NOR,Norway,2010,2292,34,2258
LVA,Latvia,NOR,Norway,2011,2116,0,2116
LVA,Latvia,NOR,Norway,2012,1655,0,1655
LVA,Latvia,NOR,Norway,2013,1349,0,1349
LVA,Latvia,NOR,Norway,2014,1123,37,1086
LVA,Latvia,NOR,Norway,2015,844,37,807
LVA,Latvia,NOR,Norway,2016,711,0,711
LVA,Latvia,NOR,Norway,2017,689,11,678
LVA,Latvia,POL,Poland,2008,55,85,-30
LVA,Latvia,POL,Poland,2009,68,70,-2
LVA,Latvia,POL,Poland,2010,73,43,30
LVA,Latvia,POL,Poland,2011,79,0,79
LVA,Latvia,POL,Poland,2012,83,0,83
LVA,Latvia,POL,Poland,2013,68,163,-95
LVA,Latvia,POL,Poland,2014,68,27,41
LVA,Latvia,POL,Poland,2015,71,27,44
LVA,Latvia,POL,Poland,2016,89,0,89
LVA,Latvia,POL,Poland,2017,112,61,51
LVA,Latvia,SVK,Slovak Republic,2008,10,0,10
LVA,Latvia,SVK,Slovak Republic,2009,11,0,11
LVA,Latvia,SVK,Slovak Republic,2010,31,0,31
LVA,Latvia,SVK,Slovak Republic,2011,15,0,15
LVA,Latvia,SVK,Slovak Republic,2012,16,0,16
LVA,Latvia,SVK,Slovak Republic,2013,9,0,9
LVA,Latvia,SVK,Slovak Republic,2014,7,5,2
LVA,Latvia,SVK,Slovak Republic,2015,17,5,12
LVA,Latvia,SVK,Slovak Republic,2016,19,0,19
LVA,Latvia,SVK,Slovak Republic,2017,9,7,2
LVA,Latvia,ESP,Spain,2008,354,49,305
LVA,Latvia,ESP,Spain,2009,623,36,587
LVA,Latvia,ESP,Spain,2010,493,41,452
LVA,Latvia,ESP,Spain,2011,556,0,556
LVA,Latvia,ESP,Spain,2012,524,0,524
LVA,Latvia,ESP,Spain,2013,454,0,454
LVA,Latvia,ESP,Spain,2014,383,19,364
LVA,Latvia,ESP,Spain,2015,399,19,380
LVA,Latvia,ESP,Spain,2016,410,0,410
LVA,Latvia,ESP,Spain,2017,570,41,529
LVA,Latvia,SWE,Sweden,2008,404,69,335
LVA,Latvia,SWE,Sweden,2009,928,89,839
LVA,Latvia,SWE,Sweden,2010,767,63,704
LVA,Latvia,SWE,Sweden,2011,795,0,795
LVA,Latvia,SWE,Sweden,2012,698,0,698
LVA,Latvia,SWE,Sweden,2013,599,0,599
LVA,Latvia,SWE,Sweden,2014,688,104,584
LVA,Latvia,SWE,Sweden,2015,735,104,631
LVA,Latvia,SWE,Sweden,2016,858,0,858
LVA,Latvia,SWE,Sweden,2017,776,41,735
LVA,Latvia,CHE,Switzerland,2008,174,6,168
LVA,Latvia,CHE,Switzerland,2009,217,7,210
LVA,Latvia,CHE,Switzerland,2010,224,6,218
LVA,Latvia,CHE,Switzerland,2011,322,0,322
LVA,Latvia,CHE,Switzerland,2012,319,0,319
LVA,Latvia,CHE,Switzerland,2013,266,0,266
LVA,Latvia,CHE,Switzerland,2014,301,3,298
LVA,Latvia,CHE,Switzerland,2015,267,3,264
LVA,Latvia,CHE,Switzerland,2016,289,0,289
LVA,Latvia,CHE,Switzerland,2017,277,6,271
LVA,Latvia,TUR,Turkey,2010,39,7,32
LVA,Latvia,GBR,United Kingdom,2010,8000,60,7940
LVA,Latvia,GBR,United Kingdom,2011,6000,0,6000
LVA,Latvia,GBR,United Kingdom,2012,4000,0,4000
LVA,Latvia,GBR,United Kingdom,2013,5000,0,5000
LVA,Latvia,GBR,United Kingdom,2014,6000,75,5925
LVA,Latvia,GBR,United Kingdom,2015,2000,75,1925
LVA,Latvia,USA,United States,2008,455,47,408
LVA,Latvia,USA,United States,2009,444,27,417
LVA,Latvia,USA,United States,2010,435,35,400
LVA,Latvia,USA,United States,2011,426,0,426
LVA,Latvia,USA,United States,2012,436,0,436
LVA,Latvia,USA,United States,2013,424,0,424
LVA,Latvia,USA,United States,2014,384,33,351
LVA,Latvia,USA,United States,2015,480,33,447
LVA,Latvia,USA,United States,2016,391,0,391
LVA,Latvia,USA,United States,2017,359,47,312
LVA,Latvia,CHL,Chile,2008,2,0,2
LVA,Latvia,CHL,Chile,2009,3,0,3
LVA,Latvia,CHL,Chile,2010,2,0,2
LVA,Latvia,CHL,Chile,2011,6,0,6
LVA,Latvia,CHL,Chile,2012,6,0,6
LVA,Latvia,CHL,Chile,2013,11,0,11
LVA,Latvia,CHL,Chile,2014,6,1,5
LVA,Latvia,CHL,Chile,2015,14,1,13
LVA,Latvia,CHL,Chile,2016,2,0,2
LVA,Latvia,EST,Estonia,2008,78,79,-1
LVA,Latvia,EST,Estonia,2009,101,71,30
LVA,Latvia,EST,Estonia,2010,54,48,6
LVA,Latvia,EST,Estonia,2011,14,0,14
LVA,Latvia,EST,Estonia,2012,13,0,13
LVA,Latvia,EST,Estonia,2013,33,0,33
LVA,Latvia,EST,Estonia,2014,52,31,21
LVA,Latvia,EST,Estonia,2015,326,31,295
LVA,Latvia,EST,Estonia,2016,429,0,429
LVA,Latvia,EST,Estonia,2017,863,38,825
LVA,Latvia,SVN,Slovenia,2008,10,0,10
LVA,Latvia,SVN,Slovenia,2009,19,0,19
LVA,Latvia,SVN,Slovenia,2011,21,0,21
LVA,Latvia,SVN,Slovenia,2012,26,0,26
LVA,Latvia,SVN,Slovenia,2013,32,0,32
LVA,Latvia,SVN,Slovenia,2014,25,0,25
LVA,Latvia,SVN,Slovenia,2015,35,0,35
LVA,Latvia,SVN,Slovenia,2016,25,0,25
LVA,Latvia,SVN,Slovenia,2017,19,6,13
LBN,Lebanon,AUS,Australia,2008,1607,636,971
LBN,Lebanon,AUS,Australia,2009,1407,794,613
LBN,Lebanon,AUS,Australia,2010,1157,736,421
LBN,Lebanon,AUS,Australia,2011,1042,688,354
LBN,Lebanon,AUS,Australia,2012,1451,522,929
LBN,Lebanon,AUS,Australia,2013,983,509,474
LBN,Lebanon,AUS,Australia,2014,1128,490,638
LBN,Lebanon,AUS,Australia,2015,1159,500,659
LBN,Lebanon,AUS,Australia,2016,983,500,483
LBN,Lebanon,AUS,Australia,2017,1169,0,1169
LBN,Lebanon,AUT,Austria,2008,85,54,31
LBN,Lebanon,AUT,Austria,2009,48,52,-4
LBN,Lebanon,AUT,Austria,2010,54,58,-4
LBN,Lebanon,AUT,Austria,2011,63,49,14
LBN,Lebanon,AUT,Austria,2012,61,41,20
LBN,Lebanon,AUT,Austria,2013,68,46,22
LBN,Lebanon,AUT,Austria,2014,87,32,55
LBN,Lebanon,AUT,Austria,2015,166,22,144
LBN,Lebanon,AUT,Austria,2016,137,92,45
LBN,Lebanon,AUT,Austria,2017,84,62,22
LBN,Lebanon,BEL,Belgium,2008,227,0,227
LBN,Lebanon,BEL,Belgium,2009,262,0,262
LBN,Lebanon,BEL,Belgium,2010,230,52,178
LBN,Lebanon,BEL,Belgium,2011,204,0,204
LBN,Lebanon,BEL,Belgium,2012,229,118,111
LBN,Lebanon,BEL,Belgium,2013,229,151,78
LBN,Lebanon,BEL,Belgium,2014,241,125,116
LBN,Lebanon,BEL,Belgium,2015,302,88,214
LBN,Lebanon,BEL,Belgium,2016,300,83,217
LBN,Lebanon,BEL,Belgium,2017,238,97,141
LBN,Lebanon,CAN,Canada,2008,3563,0,3563
LBN,Lebanon,CAN,Canada,2009,3078,0,3078
LBN,Lebanon,CAN,Canada,2010,3432,0,3432
LBN,Lebanon,CAN,Canada,2011,3070,0,3070
LBN,Lebanon,CAN,Canada,2012,1614,0,1614
LBN,Lebanon,CAN,Canada,2013,2175,0,2175
LBN,Lebanon,CAN,Canada,2014,2224,0,2224
LBN,Lebanon,CAN,Canada,2015,2135,0,2135
LBN,Lebanon,CAN,Canada,2016,1935,0,1935
LBN,Lebanon,CAN,Canada,2017,1365,0,1365
LBN,Lebanon,CZE,Czech Republic,2008,17,2,15
LBN,Lebanon,CZE,Czech Republic,2009,27,1,26
LBN,Lebanon,CZE,Czech Republic,2010,16,3,13
LBN,Lebanon,CZE,Czech Republic,2011,8,0,8
LBN,Lebanon,CZE,Czech Republic,2012,16,6,10
LBN,Lebanon,CZE,Czech Republic,2013,14,14,0
LBN,Lebanon,CZE,Czech Republic,2014,26,11,15
LBN,Lebanon,CZE,Czech Republic,2015,20,15,5
LBN,Lebanon,CZE,Czech Republic,2016,21,11,10
LBN,Lebanon,CZE,Czech Republic,2017,35,13,22
LBN,Lebanon,DNK,Denmark,2008,46,27,19
LBN,Lebanon,DNK,Denmark,2009,68,30,38
LBN,Lebanon,DNK,Denmark,2010,56,22,34
LBN,Lebanon,DNK,Denmark,2011,37,31,6
LBN,Lebanon,DNK,Denmark,2012,40,25,15
LBN,Lebanon,DNK,Denmark,2013,56,19,37
LBN,Lebanon,DNK,Denmark,2014,81,19,62
LBN,Lebanon,DNK,Denmark,2015,58,17,41
LBN,Lebanon,DNK,Denmark,2016,54,21,33
LBN,Lebanon,DNK,Denmark,2017,63,48,15
LBN,Lebanon,FIN,Finland,2008,23,3,20
LBN,Lebanon,FIN,Finland,2009,11,3,8
LBN,Lebanon,FIN,Finland,2010,7,2,5
LBN,Lebanon,FIN,Finland,2011,10,2,8
LBN,Lebanon,FIN,Finland,2012,16,1,15
LBN,Lebanon,FIN,Finland,2013,8,2,6
LBN,Lebanon,FIN,Finland,2014,12,3,9
LBN,Lebanon,FIN,Finland,2015,18,2,16
LBN,Lebanon,FIN,Finland,2016,21,3,18
LBN,Lebanon,FIN,Finland,2017,23,7,16
LBN,Lebanon,FRA,France,2008,1415,0,1415
LBN,Lebanon,FRA,France,2009,1093,0,1093
LBN,Lebanon,FRA,France,2010,962,0,962
LBN,Lebanon,FRA,France,2011,993,0,993
LBN,Lebanon,FRA,France,2012,1011,0,1011
LBN,Lebanon,FRA,France,2013,939,0,939
LBN,Lebanon,FRA,France,2014,1041,0,1041
LBN,Lebanon,FRA,France,2015,643,0,643
LBN,Lebanon,FRA,France,2016,651,0,651
LBN,Lebanon,FRA,France,2017,666,0,666
LBN,Lebanon,DEU,Germany,2008,2340,1846,494
LBN,Lebanon,DEU,Germany,2009,2310,2180,130
LBN,Lebanon,DEU,Germany,2010,2118,1855,263
LBN,Lebanon,DEU,Germany,2011,2139,1619,520
LBN,Lebanon,DEU,Germany,2012,2135,1441,694
LBN,Lebanon,DEU,Germany,2013,2114,1351,763
LBN,Lebanon,DEU,Germany,2014,2498,1088,1410
LBN,Lebanon,DEU,Germany,2015,5592,1188,4404
LBN,Lebanon,DEU,Germany,2016,4885,2834,2051
LBN,Lebanon,DEU,Germany,2017,2875,1930,945
LBN,Lebanon,HUN,Hungary,2008,16,2,14
LBN,Lebanon,HUN,Hungary,2009,15,1,14
LBN,Lebanon,HUN,Hungary,2010,17,3,14
LBN,Lebanon,HUN,Hungary,2011,12,2,10
LBN,Lebanon,HUN,Hungary,2012,13,2,11
LBN,Lebanon,HUN,Hungary,2013,24,2,22
LBN,Lebanon,HUN,Hungary,2014,29,4,25
LBN,Lebanon,HUN,Hungary,2015,37,5,32
LBN,Lebanon,HUN,Hungary,2016,39,3,36
LBN,Lebanon,HUN,Hungary,2017,48,0,48
LBN,Lebanon,ISL,Iceland,2008,4,3,1
LBN,Lebanon,ISL,Iceland,2009,2,2,0
LBN,Lebanon,ISL,Iceland,2010,0,1,-1
LBN,Lebanon,ISL,Iceland,2011,0,0,0
LBN,Lebanon,ISL,Iceland,2012,0,0,0
LBN,Lebanon,ISL,Iceland,2013,2,0,2
LBN,Lebanon,ISL,Iceland,2014,1,1,0
LBN,Lebanon,ISL,Iceland,2015,2,0,2
LBN,Lebanon,ISL,Iceland,2016,1,1,0
LBN,Lebanon,ISL,Iceland,2017,2,0,2
LBN,Lebanon,ITA,Italy,2008,404,17,387
LBN,Lebanon,ITA,Italy,2009,334,19,315
LBN,Lebanon,ITA,Italy,2010,314,40,274
LBN,Lebanon,ITA,Italy,2011,284,38,246
LBN,Lebanon,ITA,Italy,2012,286,27,259
LBN,Lebanon,ITA,Italy,2013,344,26,318
LBN,Lebanon,ITA,Italy,2014,296,34,262
LBN,Lebanon,ITA,Italy,2015,304,36,268
LBN,Lebanon,ITA,Italy,2016,316,0,316
LBN,Lebanon,ITA,Italy,2017,340,20,320
LBN,Lebanon,JPN,Japan,2008,35,29,6
LBN,Lebanon,JPN,Japan,2009,36,26,10
LBN,Lebanon,JPN,Japan,2010,53,48,5
LBN,Lebanon,JPN,Japan,2011,29,27,2
LBN,Lebanon,JPN,Japan,2012,44,34,10
LBN,Lebanon,JPN,Japan,2013,44,30,14
LBN,Lebanon,JPN,Japan,2014,29,18,11
LBN,Lebanon,JPN,Japan,2015,48,42,6
LBN,Lebanon,JPN,Japan,2016,62,45,17
LBN,Lebanon,JPN,Japan,2017,60,43,17
LBN,Lebanon,KOR,Korea,2008,7,5,2
LBN,Lebanon,KOR,Korea,2009,8,14,-6
LBN,Lebanon,KOR,Korea,2010,10,8,2
LBN,Lebanon,KOR,Korea,2011,12,15,-3
LBN,Lebanon,KOR,Korea,2012,7,9,-2
LBN,Lebanon,KOR,Korea,2013,12,7,5
LBN,Lebanon,KOR,Korea,2014,12,16,-4
LBN,Lebanon,KOR,Korea,2015,7,14,-7
LBN,Lebanon,KOR,Korea,2016,12,6,6
LBN,Lebanon,KOR,Korea,2017,7,10,-3
LBN,Lebanon,LUX,Luxembourg,2008,7,4,3
LBN,Lebanon,LUX,Luxembourg,2009,8,3,5
LBN,Lebanon,LUX,Luxembourg,2010,0,2,-2
LBN,Lebanon,LUX,Luxembourg,2011,9,0,9
LBN,Lebanon,LUX,Luxembourg,2012,9,3,6
LBN,Lebanon,LUX,Luxembourg,2013,15,4,11
LBN,Lebanon,LUX,Luxembourg,2014,10,6,4
LBN,Lebanon,LUX,Luxembourg,2015,16,4,12
LBN,Lebanon,LUX,Luxembourg,2016,11,12,-1
LBN,Lebanon,LUX,Luxembourg,2017,30,7,23
LBN,Lebanon,MEX,Mexico,2008,28,0,28
LBN,Lebanon,MEX,Mexico,2009,40,0,40
LBN,Lebanon,MEX,Mexico,2010,52,0,52
LBN,Lebanon,MEX,Mexico,2011,39,0,39
LBN,Lebanon,MEX,Mexico,2012,18,0,18
LBN,Lebanon,MEX,Mexico,2013,94,0,94
LBN,Lebanon,MEX,Mexico,2014,27,0,27
LBN,Lebanon,MEX,Mexico,2015,35,0,35
LBN,Lebanon,MEX,Mexico,2016,30,0,30
LBN,Lebanon,MEX,Mexico,2017,26,0,26
LBN,Lebanon,NLD,Netherlands,2008,57,29,28
LBN,Lebanon,NLD,Netherlands,2009,51,30,21
LBN,Lebanon,NLD,Netherlands,2010,49,20,29
LBN,Lebanon,NLD,Netherlands,2011,54,20,34
LBN,Lebanon,NLD,Netherlands,2012,45,23,22
LBN,Lebanon,NLD,Netherlands,2013,64,20,44
LBN,Lebanon,NLD,Netherlands,2014,61,44,17
LBN,Lebanon,NLD,Netherlands,2015,124,13,111
LBN,Lebanon,NLD,Netherlands,2016,161,44,117
LBN,Lebanon,NLD,Netherlands,2017,167,42,125
LBN,Lebanon,NZL,New Zealand,2008,9,1,8
LBN,Lebanon,NZL,New Zealand,2009,19,14,5
LBN,Lebanon,NZL,New Zealand,2010,6,1,5
LBN,Lebanon,NZL,New Zealand,2011,11,3,8
LBN,Lebanon,NZL,New Zealand,2012,13,2,11
LBN,Lebanon,NZL,New Zealand,2013,17,2,15
LBN,Lebanon,NZL,New Zealand,2014,16,2,14
LBN,Lebanon,NZL,New Zealand,2015,20,0,20
LBN,Lebanon,NZL,New Zealand,2016,24,3,21
LBN,Lebanon,NZL,New Zealand,2017,27,2,25
LBN,Lebanon,NOR,Norway,2008,34,13,21
LBN,Lebanon,NOR,Norway,2009,37,14,23
LBN,Lebanon,NOR,Norway,2010,31,13,18
LBN,Lebanon,NOR,Norway,2011,37,13,24
LBN,Lebanon,NOR,Norway,2012,21,13,8
LBN,Lebanon,NOR,Norway,2013,27,14,13
LBN,Lebanon,NOR,Norway,2014,37,4,33
LBN,Lebanon,NOR,Norway,2015,35,9,26
LBN,Lebanon,NOR,Norway,2016,52,7,45
LBN,Lebanon,NOR,Norway,2017,41,5,36
LBN,Lebanon,POL,Poland,2008,48,0,48
LBN,Lebanon,POL,Poland,2009,52,0,52
LBN,Lebanon,POL,Poland,2010,51,0,51
LBN,Lebanon,POL,Poland,2011,58,0,58
LBN,Lebanon,POL,Poland,2012,70,0,70
LBN,Lebanon,POL,Poland,2013,70,0,70
LBN,Lebanon,POL,Poland,2014,27,0,27
LBN,Lebanon,POL,Poland,2015,106,0,106
LBN,Lebanon,POL,Poland,2016,110,0,110
LBN,Lebanon,POL,Poland,2017,145,0,145
LBN,Lebanon,SVK,Slovak Republic,2008,4,3,1
LBN,Lebanon,SVK,Slovak Republic,2009,4,5,-1
LBN,Lebanon,SVK,Slovak Republic,2010,5,3,2
LBN,Lebanon,SVK,Slovak Republic,2011,5,1,4
LBN,Lebanon,SVK,Slovak Republic,2012,1,0,1
LBN,Lebanon,SVK,Slovak Republic,2013,6,0,6
LBN,Lebanon,SVK,Slovak Republic,2014,6,0,6
LBN,Lebanon,SVK,Slovak Republic,2015,8,0,8
LBN,Lebanon,SVK,Slovak Republic,2016,1,0,1
LBN,Lebanon,SVK,Slovak Republic,2017,3,0,3
LBN,Lebanon,ESP,Spain,2008,157,107,50
LBN,Lebanon,ESP,Spain,2009,118,120,-2
LBN,Lebanon,ESP,Spain,2010,99,110,-11
LBN,Lebanon,ESP,Spain,2011,169,78,91
LBN,Lebanon,ESP,Spain,2012,183,80,103
LBN,Lebanon,ESP,Spain,2013,265,126,139
LBN,Lebanon,ESP,Spain,2014,333,77,256
LBN,Lebanon,ESP,Spain,2015,288,81,207
LBN,Lebanon,ESP,Spain,2016,359,169,190
LBN,Lebanon,ESP,Spain,2017,386,230,156
LBN,Lebanon,SWE,Sweden,2008,387,61,326
LBN,Lebanon,SWE,Sweden,2009,411,44,367
LBN,Lebanon,SWE,Sweden,2010,421,52,369
LBN,Lebanon,SWE,Sweden,2011,348,101,247
LBN,Lebanon,SWE,Sweden,2012,380,79,301
LBN,Lebanon,SWE,Sweden,2013,423,60,363
LBN,Lebanon,SWE,Sweden,2014,422,89,333
LBN,Lebanon,SWE,Sweden,2015,434,96,338
LBN,Lebanon,SWE,Sweden,2016,409,62,347
LBN,Lebanon,SWE,Sweden,2017,401,66,335
LBN,Lebanon,CHE,Switzerland,2010,209,108,101
LBN,Lebanon,CHE,Switzerland,2011,193,102,91
LBN,Lebanon,CHE,Switzerland,2012,193,71,122
LBN,Lebanon,CHE,Switzerland,2013,232,94,138
LBN,Lebanon,CHE,Switzerland,2014,216,74,142
LBN,Lebanon,CHE,Switzerland,2015,236,97,139
LBN,Lebanon,CHE,Switzerland,2016,235,114,121
LBN,Lebanon,CHE,Switzerland,2017,237,93,144
LBN,Lebanon,TUR,Turkey,2010,28,0,28
LBN,Lebanon,TUR,Turkey,2016,596,181,415
LBN,Lebanon,TUR,Turkey,2017,778,291,487
LBN,Lebanon,GBR,United Kingdom,2014,1000,0,1000
LBN,Lebanon,USA,United States,2008,4254,0,4254
LBN,Lebanon,USA,United States,2009,3831,0,3831
LBN,Lebanon,USA,United States,2010,3487,0,3487
LBN,Lebanon,USA,United States,2011,3295,0,3295
LBN,Lebanon,USA,United States,2012,2879,0,2879
LBN,Lebanon,USA,United States,2013,2783,0,2783
LBN,Lebanon,USA,United States,2014,3245,0,3245
LBN,Lebanon,USA,United States,2015,2813,0,2813
LBN,Lebanon,USA,United States,2016,2971,0,2971
LBN,Lebanon,USA,United States,2017,2818,0,2818
LBN,Lebanon,CHL,Chile,2008,11,0,11
LBN,Lebanon,CHL,Chile,2009,13,0,13
LBN,Lebanon,CHL,Chile,2010,5,0,5
LBN,Lebanon,CHL,Chile,2011,10,0,10
LBN,Lebanon,CHL,Chile,2012,10,0,10
LBN,Lebanon,CHL,Chile,2013,14,0,14
LBN,Lebanon,CHL,Chile,2014,6,0,6
LBN,Lebanon,CHL,Chile,2015,7,0,7
LBN,Lebanon,CHL,Chile,2016,18,0,18
LBN,Lebanon,EST,Estonia,2008,0,0,0
LBN,Lebanon,EST,Estonia,2009,1,0,1
LBN,Lebanon,EST,Estonia,2010,1,0,1
LBN,Lebanon,EST,Estonia,2011,1,0,1
LBN,Lebanon,EST,Estonia,2012,0,0,0
LBN,Lebanon,EST,Estonia,2013,0,0,0
LBN,Lebanon,EST,Estonia,2014,2,0,2
LBN,Lebanon,EST,Estonia,2015,1,0,1
LBN,Lebanon,EST,Estonia,2016,1,0,1
LBN,Lebanon,EST,Estonia,2017,0,0,0
LBN,Lebanon,SVN,Slovenia,2008,1,0,1
LBN,Lebanon,SVN,Slovenia,2009,4,0,4
LBN,Lebanon,SVN,Slovenia,2011,3,0,3
LBN,Lebanon,SVN,Slovenia,2013,1,0,1
LBN,Lebanon,SVN,Slovenia,2014,1,0,1
LBN,Lebanon,SVN,Slovenia,2015,2,0,2
LBN,Lebanon,SVN,Slovenia,2016,3,0,3
LBN,Lebanon,SVN,Slovenia,2017,3,0,3
LSO,Lesotho,AUS,Australia,2008,2,0,2
LSO,Lesotho,AUS,Australia,2009,0,0,0
LSO,Lesotho,AUS,Australia,2010,6,0,6
LSO,Lesotho,AUS,Australia,2011,7,0,7
LSO,Lesotho,AUS,Australia,2012,0,0,0
LSO,Lesotho,AUS,Australia,2013,1,0,1
LSO,Lesotho,AUS,Australia,2014,0,0,0
LSO,Lesotho,AUS,Australia,2015,0,0,0
LSO,Lesotho,AUS,Australia,2016,0,0,0
LSO,Lesotho,AUS,Australia,2017,3,0,3
LSO,Lesotho,AUT,Austria,2008,0,0,0
LSO,Lesotho,AUT,Austria,2009,0,0,0
LSO,Lesotho,AUT,Austria,2010,0,1,-1
LSO,Lesotho,AUT,Austria,2011,0,0,0
LSO,Lesotho,AUT,Austria,2012,2,0,2
LSO,Lesotho,AUT,Austria,2013,3,2,1
LSO,Lesotho,AUT,Austria,2014,0,1,-1
LSO,Lesotho,AUT,Austria,2015,3,1,2
LSO,Lesotho,AUT,Austria,2016,2,3,-1
LSO,Lesotho,AUT,Austria,2017,2,1,1
LSO,Lesotho,BEL,Belgium,2008,3,0,3
LSO,Lesotho,BEL,Belgium,2009,5,0,5
LSO,Lesotho,BEL,Belgium,2010,0,0,0
LSO,Lesotho,BEL,Belgium,2013,4,2,2
LSO,Lesotho,BEL,Belgium,2014,2,1,1
LSO,Lesotho,BEL,Belgium,2017,2,0,2
LSO,Lesotho,CAN,Canada,2008,1,0,1
LSO,Lesotho,CAN,Canada,2009,8,0,8
LSO,Lesotho,CAN,Canada,2010,7,0,7
LSO,Lesotho,CAN,Canada,2011,1,0,1
LSO,Lesotho,CAN,Canada,2012,0,0,0
LSO,Lesotho,CAN,Canada,2013,6,0,6
LSO,Lesotho,CAN,Canada,2014,2,0,2
LSO,Lesotho,CAN,Canada,2015,0,0,0
LSO,Lesotho,CAN,Canada,2016,10,0,10
LSO,Lesotho,CAN,Canada,2017,0,0,0
LSO,Lesotho,DNK,Denmark,2008,1,0,1
LSO,Lesotho,DNK,Denmark,2009,0,1,-1
LSO,Lesotho,DNK,Denmark,2011,2,1,1
LSO,Lesotho,DNK,Denmark,2012,0,0,0
LSO,Lesotho,DNK,Denmark,2013,0,0,0
LSO,Lesotho,DNK,Denmark,2014,1,0,1
LSO,Lesotho,DNK,Denmark,2015,1,0,1
LSO,Lesotho,DNK,Denmark,2016,0,0,0
LSO,Lesotho,DNK,Denmark,2017,2,0,2
LSO,Lesotho,FIN,Finland,2008,0,0,0
LSO,Lesotho,FIN,Finland,2009,0,0,0
LSO,Lesotho,FIN,Finland,2010,0,0,0
LSO,Lesotho,FIN,Finland,2011,0,0,0
LSO,Lesotho,FIN,Finland,2012,0,0,0
LSO,Lesotho,FIN,Finland,2013,0,0,0
LSO,Lesotho,FIN,Finland,2014,0,0,0
LSO,Lesotho,FIN,Finland,2015,0,0,0
LSO,Lesotho,FIN,Finland,2016,0,0,0
LSO,Lesotho,FIN,Finland,2017,0,0,0
LSO,Lesotho,FRA,France,2008,0,0,0
LSO,Lesotho,FRA,France,2009,8,0,8
LSO,Lesotho,FRA,France,2010,6,0,6
LSO,Lesotho,FRA,France,2011,1,0,1
LSO,Lesotho,FRA,France,2012,0,0,0
LSO,Lesotho,FRA,France,2013,1,0,1
LSO,Lesotho,FRA,France,2014,0,0,0
LSO,Lesotho,FRA,France,2015,1,0,1
LSO,Lesotho,FRA,France,2016,1,0,1
LSO,Lesotho,FRA,France,2017,0,0,0
LSO,Lesotho,DEU,Germany,2008,12,14,-2
LSO,Lesotho,DEU,Germany,2009,11,19,-8
LSO,Lesotho,DEU,Germany,2010,7,9,-2
LSO,Lesotho,DEU,Germany,2011,12,6,6
LSO,Lesotho,DEU,Germany,2012,4,3,1
LSO,Lesotho,DEU,Germany,2013,9,11,-2
LSO,Lesotho,DEU,Germany,2014,5,2,3
LSO,Lesotho,DEU,Germany,2015,13,3,10
LSO,Lesotho,DEU,Germany,2016,1,6,-5
LSO,Lesotho,DEU,Germany,2017,12,5,7
LSO,Lesotho,HUN,Hungary,2008,0,0,0
LSO,Lesotho,HUN,Hungary,2009,0,0,0
LSO,Lesotho,HUN,Hungary,2010,1,0,1
LSO,Lesotho,HUN,Hungary,2011,1,0,1
LSO,Lesotho,HUN,Hungary,2012,1,0,1
LSO,Lesotho,HUN,Hungary,2013,0,0,0
LSO,Lesotho,HUN,Hungary,2014,0,0,0
LSO,Lesotho,HUN,Hungary,2015,1,0,1
LSO,Lesotho,HUN,Hungary,2016,1,0,1
LSO,Lesotho,HUN,Hungary,2017,0,0,0
LSO,Lesotho,ISL,Iceland,2008,0,0,0
LSO,Lesotho,ISL,Iceland,2009,0,0,0
LSO,Lesotho,ISL,Iceland,2010,0,0,0
LSO,Lesotho,ISL,Iceland,2011,0,0,0
LSO,Lesotho,ISL,Iceland,2012,0,0,0
LSO,Lesotho,ISL,Iceland,2013,0,0,0
LSO,Lesotho,ISL,Iceland,2014,0,0,0
LSO,Lesotho,ISL,Iceland,2015,0,0,0
LSO,Lesotho,ISL,Iceland,2016,2,2,0
LSO,Lesotho,ISL,Iceland,2017,2,2,0
LSO,Lesotho,ITA,Italy,2008,2,0,2
LSO,Lesotho,ITA,Italy,2009,3,0,3
LSO,Lesotho,ITA,Italy,2010,3,1,2
LSO,Lesotho,ITA,Italy,2011,0,1,-1
LSO,Lesotho,ITA,Italy,2012,0,0,0
LSO,Lesotho,ITA,Italy,2013,5,0,5
LSO,Lesotho,ITA,Italy,2014,0,0,0
LSO,Lesotho,ITA,Italy,2015,0,0,0
LSO,Lesotho,ITA,Italy,2016,0,0,0
LSO,Lesotho,ITA,Italy,2017,2,0,2
LSO,Lesotho,JPN,Japan,2008,23,21,2
LSO,Lesotho,JPN,Japan,2009,19,21,-2
LSO,Lesotho,JPN,Japan,2010,31,26,5
LSO,Lesotho,JPN,Japan,2011,17,17,0
LSO,Lesotho,JPN,Japan,2012,25,25,0
LSO,Lesotho,JPN,Japan,2013,27,27,0
LSO,Lesotho,JPN,Japan,2014,29,28,1
LSO,Lesotho,JPN,Japan,2015,27,29,-2
LSO,Lesotho,JPN,Japan,2016,39,27,12
LSO,Lesotho,JPN,Japan,2017,27,25,2
LSO,Lesotho,KOR,Korea,2008,1,0,1
LSO,Lesotho,KOR,Korea,2009,0,0,0
LSO,Lesotho,KOR,Korea,2010,2,1,1
LSO,Lesotho,KOR,Korea,2011,0,0,0
LSO,Lesotho,KOR,Korea,2012,0,1,-1
LSO,Lesotho,KOR,Korea,2013,5,1,4
LSO,Lesotho,KOR,Korea,2014,4,0,4
LSO,Lesotho,KOR,Korea,2015,2,4,-2
LSO,Lesotho,KOR,Korea,2016,1,1,0
LSO,Lesotho,KOR,Korea,2017,1,1,0
LSO,Lesotho,LUX,Luxembourg,2008,0,0,0
LSO,Lesotho,LUX,Luxembourg,2009,0,0,0
LSO,Lesotho,LUX,Luxembourg,2010,0,0,0
LSO,Lesotho,LUX,Luxembourg,2011,0,0,0
LSO,Lesotho,LUX,Luxembourg,2012,0,0,0
LSO,Lesotho,LUX,Luxembourg,2013,0,0,0
LSO,Lesotho,LUX,Luxembourg,2014,0,0,0
LSO,Lesotho,LUX,Luxembourg,2015,0,0,0
LSO,Lesotho,LUX,Luxembourg,2016,0,0,0
LSO,Lesotho,LUX,Luxembourg,2017,0,0,0
LSO,Lesotho,MEX,Mexico,2012,0,0,0
LSO,Lesotho,MEX,Mexico,2013,0,0,0
LSO,Lesotho,MEX,Mexico,2014,0,0,0
LSO,Lesotho,NLD,Netherlands,2008,6,1,5
LSO,Lesotho,NLD,Netherlands,2009,2,3,-1
LSO,Lesotho,NLD,Netherlands,2010,11,2,9
LSO,Lesotho,NLD,Netherlands,2011,7,1,6
LSO,Lesotho,NLD,Netherlands,2012,9,2,7
LSO,Lesotho,NLD,Netherlands,2013,6,4,2
LSO,Lesotho,NLD,Netherlands,2014,8,0,8
LSO,Lesotho,NLD,Netherlands,2015,6,0,6
LSO,Lesotho,NLD,Netherlands,2016,2,4,-2
LSO,Lesotho,NLD,Netherlands,2017,5,2,3
LSO,Lesotho,NZL,New Zealand,2012,3,0,3
LSO,Lesotho,NZL,New Zealand,2017,1,0,1
LSO,Lesotho,NOR,Norway,2008,0,0,0
LSO,Lesotho,NOR,Norway,2009,0,3,-3
LSO,Lesotho,NOR,Norway,2010,0,0,0
LSO,Lesotho,NOR,Norway,2011,1,1,0
LSO,Lesotho,NOR,Norway,2012,0,0,0
LSO,Lesotho,NOR,Norway,2013,1,1,0
LSO,Lesotho,NOR,Norway,2014,3,0,3
LSO,Lesotho,NOR,Norway,2015,2,3,-1
LSO,Lesotho,NOR,Norway,2016,1,3,-2
LSO,Lesotho,NOR,Norway,2017,0,0,0
LSO,Lesotho,POL,Poland,2009,0,0,0
LSO,Lesotho,POL,Poland,2010,1,0,1
LSO,Lesotho,POL,Poland,2011,0,0,0
LSO,Lesotho,POL,Poland,2012,0,0,0
LSO,Lesotho,POL,Poland,2013,0,0,0
LSO,Lesotho,POL,Poland,2014,0,0,0
LSO,Lesotho,POL,Poland,2015,0,0,0
LSO,Lesotho,POL,Poland,2016,0,0,0
LSO,Lesotho,POL,Poland,2017,1,0,1
LSO,Lesotho,SVK,Slovak Republic,2008,0,0,0
LSO,Lesotho,SVK,Slovak Republic,2010,1,0,1
LSO,Lesotho,SVK,Slovak Republic,2014,2,0,2
LSO,Lesotho,ESP,Spain,2008,1,0,1
LSO,Lesotho,ESP,Spain,2009,4,2,2
LSO,Lesotho,ESP,Spain,2010,2,1,1
LSO,Lesotho,ESP,Spain,2011,0,0,0
LSO,Lesotho,ESP,Spain,2012,0,0,0
LSO,Lesotho,ESP,Spain,2013,2,0,2
LSO,Lesotho,ESP,Spain,2014,1,1,0
LSO,Lesotho,ESP,Spain,2015,0,0,0
LSO,Lesotho,ESP,Spain,2016,2,0,2
LSO,Lesotho,ESP,Spain,2017,1,0,1
LSO,Lesotho,SWE,Sweden,2008,0,0,0
LSO,Lesotho,SWE,Sweden,2009,3,0,3
LSO,Lesotho,SWE,Sweden,2010,1,0,1
LSO,Lesotho,SWE,Sweden,2011,3,0,3
LSO,Lesotho,SWE,Sweden,2012,5,1,4
LSO,Lesotho,SWE,Sweden,2013,3,0,3
LSO,Lesotho,SWE,Sweden,2014,0,0,0
LSO,Lesotho,SWE,Sweden,2015,0,2,-2
LSO,Lesotho,SWE,Sweden,2016,1,0,1
LSO,Lesotho,SWE,Sweden,2017,1,0,1
LSO,Lesotho,CHE,Switzerland,2010,1,1,0
LSO,Lesotho,CHE,Switzerland,2011,5,2,3
LSO,Lesotho,CHE,Switzerland,2012,4,2,2
LSO,Lesotho,CHE,Switzerland,2013,1,0,1
LSO,Lesotho,CHE,Switzerland,2014,0,1,-1
LSO,Lesotho,CHE,Switzerland,2015,3,0,3
LSO,Lesotho,CHE,Switzerland,2016,0,2,-2
LSO,Lesotho,CHE,Switzerland,2017,0,0,0
LSO,Lesotho,TUR,Turkey,2010,1,0,1
LSO,Lesotho,USA,United States,2008,16,0,16
LSO,Lesotho,USA,United States,2009,14,0,14
LSO,Lesotho,USA,United States,2010,23,0,23
LSO,Lesotho,USA,United States,2011,25,0,25
LSO,Lesotho,USA,United States,2012,17,0,17
LSO,Lesotho,USA,United States,2013,20,0,20
LSO,Lesotho,USA,United States,2014,13,0,13
LSO,Lesotho,USA,United States,2015,23,0,23
LSO,Lesotho,USA,United States,2016,19,0,19
LSO,Lesotho,USA,United States,2017,24,0,24
LSO,Lesotho,CHL,Chile,2008,0,0,0
LSO,Lesotho,CHL,Chile,2009,0,0,0
LSO,Lesotho,CHL,Chile,2010,0,0,0
LSO,Lesotho,CHL,Chile,2011,0,0,0
LSO,Lesotho,CHL,Chile,2012,0,0,0
LSO,Lesotho,CHL,Chile,2013,0,0,0
LSO,Lesotho,CHL,Chile,2014,0,0,0
LSO,Lesotho,CHL,Chile,2015,0,0,0
LSO,Lesotho,CHL,Chile,2016,1,0,1
LSO,Lesotho,EST,Estonia,2008,0,0,0
LSO,Lesotho,EST,Estonia,2009,0,0,0
LSO,Lesotho,EST,Estonia,2010,0,0,0
LSO,Lesotho,EST,Estonia,2011,0,0,0
LSO,Lesotho,EST,Estonia,2012,0,0,0
LSO,Lesotho,EST,Estonia,2013,0,0,0
LSO,Lesotho,EST,Estonia,2014,0,0,0
LSO,Lesotho,EST,Estonia,2015,0,0,0
LSO,Lesotho,EST,Estonia,2016,0,0,0
LSO,Lesotho,EST,Estonia,2017,0,0,0
LBR,Liberia,AUS,Australia,2008,380,12,368
LBR,Liberia,AUS,Australia,2009,414,7,407
LBR,Liberia,AUS,Australia,2010,474,10,464
LBR,Liberia,AUS,Australia,2011,144,8,136
LBR,Liberia,AUS,Australia,2012,174,11,163
LBR,Liberia,AUS,Australia,2013,100,12,88
LBR,Liberia,AUS,Australia,2014,164,8,156
LBR,Liberia,AUS,Australia,2015,112,0,112
LBR,Liberia,AUS,Australia,2016,83,0,83
LBR,Liberia,AUS,Australia,2017,160,0,160
LBR,Liberia,AUT,Austria,2008,32,52,-20
LBR,Liberia,AUT,Austria,2009,34,55,-21
LBR,Liberia,AUT,Austria,2010,33,44,-11
LBR,Liberia,AUT,Austria,2011,38,30,8
LBR,Liberia,AUT,Austria,2012,29,23,6
LBR,Liberia,AUT,Austria,2013,32,27,5
LBR,Liberia,AUT,Austria,2014,36,25,11
LBR,Liberia,AUT,Austria,2015,28,15,13
LBR,Liberia,AUT,Austria,2016,26,20,6
LBR,Liberia,AUT,Austria,2017,13,30,-17
LBR,Liberia,BEL,Belgium,2008,23,0,23
LBR,Liberia,BEL,Belgium,2009,17,0,17
LBR,Liberia,BEL,Belgium,2010,14,4,10
LBR,Liberia,BEL,Belgium,2012,47,14,33
LBR,Liberia,BEL,Belgium,2013,35,44,-9
LBR,Liberia,BEL,Belgium,2014,30,19,11
LBR,Liberia,BEL,Belgium,2015,28,34,-6
LBR,Liberia,BEL,Belgium,2016,19,20,-1
LBR,Liberia,BEL,Belgium,2017,10,11,-1
LBR,Liberia,CAN,Canada,2008,74,0,74
LBR,Liberia,CAN,Canada,2009,94,0,94
LBR,Liberia,CAN,Canada,2010,162,0,162
LBR,Liberia,CAN,Canada,2011,106,0,106
LBR,Liberia,CAN,Canada,2012,58,0,58
LBR,Liberia,CAN,Canada,2013,39,0,39
LBR,Liberia,CAN,Canada,2014,60,0,60
LBR,Liberia,CAN,Canada,2015,155,0,155
LBR,Liberia,CAN,Canada,2016,155,0,155
LBR,Liberia,CAN,Canada,2017,55,0,55
LBR,Liberia,DNK,Denmark,2008,1,0,1
LBR,Liberia,DNK,Denmark,2009,13,3,10
LBR,Liberia,DNK,Denmark,2010,19,2,17
LBR,Liberia,DNK,Denmark,2011,4,3,1
LBR,Liberia,DNK,Denmark,2012,4,2,2
LBR,Liberia,DNK,Denmark,2013,5,1,4
LBR,Liberia,DNK,Denmark,2014,2,3,-1
LBR,Liberia,DNK,Denmark,2015,2,2,0
LBR,Liberia,DNK,Denmark,2016,3,2,1
LBR,Liberia,DNK,Denmark,2017,0,3,-3
LBR,Liberia,FIN,Finland,2008,11,1,10
LBR,Liberia,FIN,Finland,2009,4,0,4
LBR,Liberia,FIN,Finland,2010,0,0,0
LBR,Liberia,FIN,Finland,2011,1,0,1
LBR,Liberia,FIN,Finland,2012,2,1,1
LBR,Liberia,FIN,Finland,2013,1,0,1
LBR,Liberia,FIN,Finland,2014,4,0,4
LBR,Liberia,FIN,Finland,2015,1,0,1
LBR,Liberia,FIN,Finland,2016,3,0,3
LBR,Liberia,FIN,Finland,2017,1,0,1
LBR,Liberia,FRA,France,2008,29,0,29
LBR,Liberia,FRA,France,2009,28,0,28
LBR,Liberia,FRA,France,2010,23,0,23
LBR,Liberia,FRA,France,2011,24,0,24
LBR,Liberia,FRA,France,2012,24,0,24
LBR,Liberia,FRA,France,2013,14,0,14
LBR,Liberia,FRA,France,2014,12,0,12
LBR,Liberia,FRA,France,2015,16,0,16
LBR,Liberia,FRA,France,2016,20,0,20
LBR,Liberia,FRA,France,2017,21,0,21
LBR,Liberia,DEU,Germany,2008,109,188,-79
LBR,Liberia,DEU,Germany,2009,89,164,-75
LBR,Liberia,DEU,Germany,2010,77,104,-27
LBR,Liberia,DEU,Germany,2011,75,54,21
LBR,Liberia,DEU,Germany,2012,100,73,27
LBR,Liberia,DEU,Germany,2013,94,60,34
LBR,Liberia,DEU,Germany,2014,154,58,96
LBR,Liberia,DEU,Germany,2015,173,69,104
LBR,Liberia,DEU,Germany,2016,193,95,98
LBR,Liberia,DEU,Germany,2017,245,98,147
LBR,Liberia,HUN,Hungary,2008,4,1,3
LBR,Liberia,HUN,Hungary,2009,0,1,-1
LBR,Liberia,HUN,Hungary,2010,0,0,0
LBR,Liberia,HUN,Hungary,2011,9,0,9
LBR,Liberia,HUN,Hungary,2012,8,1,7
LBR,Liberia,HUN,Hungary,2013,5,0,5
LBR,Liberia,HUN,Hungary,2014,0,0,0
LBR,Liberia,HUN,Hungary,2015,0,0,0
LBR,Liberia,HUN,Hungary,2016,5,3,2
LBR,Liberia,HUN,Hungary,2017,3,0,3
LBR,Liberia,ISL,Iceland,2008,1,0,1
LBR,Liberia,ISL,Iceland,2009,0,1,-1
LBR,Liberia,ISL,Iceland,2010,1,0,1
LBR,Liberia,ISL,Iceland,2011,1,0,1
LBR,Liberia,ISL,Iceland,2012,1,0,1
LBR,Liberia,ISL,Iceland,2013,0,0,0
LBR,Liberia,ISL,Iceland,2014,0,2,-2
LBR,Liberia,ISL,Iceland,2015,0,0,0
LBR,Liberia,ISL,Iceland,2016,1,0,1
LBR,Liberia,ISL,Iceland,2017,2,0,2
LBR,Liberia,ITA,Italy,2008,283,9,274
LBR,Liberia,ITA,Italy,2009,196,10,186
LBR,Liberia,ITA,Italy,2010,170,4,166
LBR,Liberia,ITA,Italy,2011,122,2,120
LBR,Liberia,ITA,Italy,2012,120,14,106
LBR,Liberia,ITA,Italy,2013,91,2,89
LBR,Liberia,ITA,Italy,2014,63,5,58
LBR,Liberia,ITA,Italy,2015,47,6,41
LBR,Liberia,ITA,Italy,2016,115,0,115
LBR,Liberia,ITA,Italy,2017,241,2,239
LBR,Liberia,JPN,Japan,2008,37,38,-1
LBR,Liberia,JPN,Japan,2009,34,31,3
LBR,Liberia,JPN,Japan,2010,49,49,0
LBR,Liberia,JPN,Japan,2011,35,31,4
LBR,Liberia,JPN,Japan,2012,86,88,-2
LBR,Liberia,JPN,Japan,2013,66,60,6
LBR,Liberia,JPN,Japan,2014,21,22,-1
LBR,Liberia,JPN,Japan,2015,40,41,-1
LBR,Liberia,JPN,Japan,2016,62,58,4
LBR,Liberia,JPN,Japan,2017,77,73,4
LBR,Liberia,KOR,Korea,2008,17,19,-2
LBR,Liberia,KOR,Korea,2009,5,19,-14
LBR,Liberia,KOR,Korea,2010,22,22,0
LBR,Liberia,KOR,Korea,2011,43,20,23
LBR,Liberia,KOR,Korea,2012,29,24,5
LBR,Liberia,KOR,Korea,2013,40,21,19
LBR,Liberia,KOR,Korea,2014,61,16,45
LBR,Liberia,KOR,Korea,2015,110,29,81
LBR,Liberia,KOR,Korea,2016,136,60,76
LBR,Liberia,KOR,Korea,2017,165,68,97
LBR,Liberia,LUX,Luxembourg,2008,2,5,-3
LBR,Liberia,LUX,Luxembourg,2009,3,3,0
LBR,Liberia,LUX,Luxembourg,2010,3,1,2
LBR,Liberia,LUX,Luxembourg,2011,1,3,-2
LBR,Liberia,LUX,Luxembourg,2012,2,0,2
LBR,Liberia,LUX,Luxembourg,2013,2,1,1
LBR,Liberia,LUX,Luxembourg,2014,4,0,4
LBR,Liberia,LUX,Luxembourg,2015,0,2,-2
LBR,Liberia,LUX,Luxembourg,2016,1,0,1
LBR,Liberia,LUX,Luxembourg,2017,1,2,-1
LBR,Liberia,MEX,Mexico,2012,0,0,0
LBR,Liberia,MEX,Mexico,2013,0,0,0
LBR,Liberia,MEX,Mexico,2014,0,0,0
LBR,Liberia,MEX,Mexico,2015,1,0,1
LBR,Liberia,MEX,Mexico,2016,1,0,1
LBR,Liberia,NLD,Netherlands,2008,20,-2,22
LBR,Liberia,NLD,Netherlands,2009,29,15,14
LBR,Liberia,NLD,Netherlands,2010,22,14,8
LBR,Liberia,NLD,Netherlands,2011,9,7,2
LBR,Liberia,NLD,Netherlands,2012,10,12,-2
LBR,Liberia,NLD,Netherlands,2013,17,2,15
LBR,Liberia,NLD,Netherlands,2014,14,13,1
LBR,Liberia,NLD,Netherlands,2015,16,12,4
LBR,Liberia,NLD,Netherlands,2016,13,7,6
LBR,Liberia,NLD,Netherlands,2017,15,11,4
LBR,Liberia,NZL,New Zealand,2008,3,1,2
LBR,Liberia,NZL,New Zealand,2010,0,0,0
LBR,Liberia,NZL,New Zealand,2012,1,0,1
LBR,Liberia,NZL,New Zealand,2014,4,0,4
LBR,Liberia,NZL,New Zealand,2015,1,0,1
LBR,Liberia,NZL,New Zealand,2016,1,0,1
LBR,Liberia,NOR,Norway,2008,35,14,21
LBR,Liberia,NOR,Norway,2009,30,7,23
LBR,Liberia,NOR,Norway,2010,23,10,13
LBR,Liberia,NOR,Norway,2011,21,6,15
LBR,Liberia,NOR,Norway,2012,15,13,2
LBR,Liberia,NOR,Norway,2013,19,10,9
LBR,Liberia,NOR,Norway,2014,10,9,1
LBR,Liberia,NOR,Norway,2015,18,8,10
LBR,Liberia,NOR,Norway,2016,11,5,6
LBR,Liberia,NOR,Norway,2017,14,3,11
LBR,Liberia,POL,Poland,2009,1,0,1
LBR,Liberia,POL,Poland,2010,2,0,2
LBR,Liberia,POL,Poland,2011,2,0,2
LBR,Liberia,POL,Poland,2012,3,0,3
LBR,Liberia,POL,Poland,2013,2,0,2
LBR,Liberia,POL,Poland,2014,1,0,1
LBR,Liberia,POL,Poland,2015,2,0,2
LBR,Liberia,POL,Poland,2016,2,0,2
LBR,Liberia,POL,Poland,2017,1,0,1
LBR,Liberia,SVK,Slovak Republic,2008,1,0,1
LBR,Liberia,ESP,Spain,2008,32,40,-8
LBR,Liberia,ESP,Spain,2009,32,44,-12
LBR,Liberia,ESP,Spain,2010,25,36,-11
LBR,Liberia,ESP,Spain,2011,20,29,-9
LBR,Liberia,ESP,Spain,2012,28,23,5
LBR,Liberia,ESP,Spain,2013,23,19,4
LBR,Liberia,ESP,Spain,2014,13,13,0
LBR,Liberia,ESP,Spain,2015,16,16,0
LBR,Liberia,ESP,Spain,2016,22,7,15
LBR,Liberia,ESP,Spain,2017,12,14,-2
LBR,Liberia,SWE,Sweden,2008,29,3,26
LBR,Liberia,SWE,Sweden,2009,23,2,21
LBR,Liberia,SWE,Sweden,2010,41,2,39
LBR,Liberia,SWE,Sweden,2011,28,4,24
LBR,Liberia,SWE,Sweden,2012,29,2,27
LBR,Liberia,SWE,Sweden,2013,24,6,18
LBR,Liberia,SWE,Sweden,2014,19,6,13
LBR,Liberia,SWE,Sweden,2015,10,2,8
LBR,Liberia,SWE,Sweden,2016,17,3,14
LBR,Liberia,SWE,Sweden,2017,26,9,17
LBR,Liberia,CHE,Switzerland,2010,8,1,7
LBR,Liberia,CHE,Switzerland,2011,12,1,11
LBR,Liberia,CHE,Switzerland,2012,9,4,5
LBR,Liberia,CHE,Switzerland,2013,8,5,3
LBR,Liberia,CHE,Switzerland,2014,2,1,1
LBR,Liberia,CHE,Switzerland,2015,5,1,4
LBR,Liberia,CHE,Switzerland,2016,8,0,8
LBR,Liberia,CHE,Switzerland,2017,1,2,-1
LBR,Liberia,GBR,United Kingdom,2014,1000,0,1000
LBR,Liberia,USA,United States,2008,7193,0,7193
LBR,Liberia,USA,United States,2009,7641,0,7641
LBR,Liberia,USA,United States,2010,4837,0,4837
LBR,Liberia,USA,United States,2011,4151,0,4151
LBR,Liberia,USA,United States,2012,4109,0,4109
LBR,Liberia,USA,United States,2013,3334,0,3334
LBR,Liberia,USA,United States,2014,3874,0,3874
LBR,Liberia,USA,United States,2015,3795,0,3795
LBR,Liberia,USA,United States,2016,3619,0,3619
LBR,Liberia,USA,United States,2017,4155,0,4155
LBR,Liberia,CHL,Chile,2008,0,0,0
LBR,Liberia,CHL,Chile,2009,0,0,0
LBR,Liberia,CHL,Chile,2010,0,0,0
LBR,Liberia,CHL,Chile,2011,0,0,0
LBR,Liberia,CHL,Chile,2012,0,0,0
LBR,Liberia,CHL,Chile,2013,1,0,1
LBR,Liberia,CHL,Chile,2014,0,0,0
LBR,Liberia,CHL,Chile,2015,0,0,0
LBR,Liberia,CHL,Chile,2016,0,0,0
LBR,Liberia,EST,Estonia,2008,0,0,0
LBR,Liberia,EST,Estonia,2009,0,0,0
LBR,Liberia,EST,Estonia,2010,0,0,0
LBR,Liberia,EST,Estonia,2011,0,0,0
LBR,Liberia,EST,Estonia,2012,0,0,0
LBR,Liberia,EST,Estonia,2013,0,0,0
LBR,Liberia,EST,Estonia,2014,0,0,0
LBR,Liberia,EST,Estonia,2015,0,0,0
LBR,Liberia,EST,Estonia,2016,1,0,1
LBR,Liberia,EST,Estonia,2017,0,0,0
LBR,Liberia,SVN,Slovenia,2009,2,0,2
LBR,Liberia,SVN,Slovenia,2015,1,0,1
LBY,Libya,AUS,Australia,2008,7,12,-5
LBY,Libya,AUS,Australia,2009,13,9,4
LBY,Libya,AUS,Australia,2010,6,6,0
LBY,Libya,AUS,Australia,2011,8,18,-10
LBY,Libya,AUS,Australia,2012,23,10,13
LBY,Libya,AUS,Australia,2013,16,18,-2
LBY,Libya,AUS,Australia,2014,26,13,13
LBY,Libya,AUS,Australia,2015,17,0,17
LBY,Libya,AUS,Australia,2016,31,0,31
LBY,Libya,AUS,Australia,2017,34,0,34
LBY,Libya,AUT,Austria,2008,30,70,-40
LBY,Libya,AUT,Austria,2009,68,33,35
LBY,Libya,AUT,Austria,2010,65,58,7
LBY,Libya,AUT,Austria,2011,78,55,23
LBY,Libya,AUT,Austria,2012,65,43,22
LBY,Libya,AUT,Austria,2013,117,60,57
LBY,Libya,AUT,Austria,2014,356,147,209
LBY,Libya,AUT,Austria,2015,188,175,13
LBY,Libya,AUT,Austria,2016,176,139,37
LBY,Libya,AUT,Austria,2017,151,150,1
LBY,Libya,BEL,Belgium,2008,31,0,31
LBY,Libya,BEL,Belgium,2009,20,0,20
LBY,Libya,BEL,Belgium,2010,17,27,-10
LBY,Libya,BEL,Belgium,2012,17,20,-3
LBY,Libya,BEL,Belgium,2013,22,32,-10
LBY,Libya,BEL,Belgium,2014,49,21,28
LBY,Libya,BEL,Belgium,2015,76,13,63
LBY,Libya,BEL,Belgium,2016,49,8,41
LBY,Libya,BEL,Belgium,2017,52,8,44
LBY,Libya,CAN,Canada,2008,306,0,306
LBY,Libya,CAN,Canada,2009,282,0,282
LBY,Libya,CAN,Canada,2010,384,0,384
LBY,Libya,CAN,Canada,2011,352,0,352
LBY,Libya,CAN,Canada,2012,299,0,299
LBY,Libya,CAN,Canada,2013,255,0,255
LBY,Libya,CAN,Canada,2014,298,0,298
LBY,Libya,CAN,Canada,2015,244,0,244
LBY,Libya,CAN,Canada,2016,300,0,300
LBY,Libya,CAN,Canada,2017,500,0,500
LBY,Libya,CZE,Czech Republic,2008,60,0,60
LBY,Libya,CZE,Czech Republic,2009,66,0,66
LBY,Libya,CZE,Czech Republic,2010,64,0,64
LBY,Libya,CZE,Czech Republic,2011,14,0,14
LBY,Libya,CZE,Czech Republic,2012,22,9,13
LBY,Libya,CZE,Czech Republic,2013,29,24,5
LBY,Libya,CZE,Czech Republic,2014,28,13,15
LBY,Libya,CZE,Czech Republic,2015,16,7,9
LBY,Libya,CZE,Czech Republic,2016,17,13,4
LBY,Libya,CZE,Czech Republic,2017,9,12,-3
LBY,Libya,DNK,Denmark,2008,3,5,-2
LBY,Libya,DNK,Denmark,2009,5,7,-2
LBY,Libya,DNK,Denmark,2010,3,0,3
LBY,Libya,DNK,Denmark,2011,13,3,10
LBY,Libya,DNK,Denmark,2012,14,1,13
LBY,Libya,DNK,Denmark,2013,3,3,0
LBY,Libya,DNK,Denmark,2014,3,1,2
LBY,Libya,DNK,Denmark,2015,0,0,0
LBY,Libya,DNK,Denmark,2016,3,2,1
LBY,Libya,DNK,Denmark,2017,3,5,-2
LBY,Libya,FIN,Finland,2008,5,10,-5
LBY,Libya,FIN,Finland,2009,7,6,1
LBY,Libya,FIN,Finland,2010,6,4,2
LBY,Libya,FIN,Finland,2011,3,0,3
LBY,Libya,FIN,Finland,2012,6,1,5
LBY,Libya,FIN,Finland,2013,6,3,3
LBY,Libya,FIN,Finland,2014,17,2,15
LBY,Libya,FIN,Finland,2015,19,1,18
LBY,Libya,FIN,Finland,2016,20,5,15
LBY,Libya,FIN,Finland,2017,1,4,-3
LBY,Libya,FRA,France,2008,72,0,72
LBY,Libya,FRA,France,2009,93,0,93
LBY,Libya,FRA,France,2010,107,0,107
LBY,Libya,FRA,France,2011,63,0,63
LBY,Libya,FRA,France,2012,202,0,202
LBY,Libya,FRA,France,2013,311,0,311
LBY,Libya,FRA,France,2014,186,0,186
LBY,Libya,FRA,France,2015,136,0,136
LBY,Libya,FRA,France,2016,153,0,153
LBY,Libya,FRA,France,2017,179,0,179
LBY,Libya,DEU,Germany,2008,691,616,75
LBY,Libya,DEU,Germany,2009,674,683,-9
LBY,Libya,DEU,Germany,2010,902,635,267
LBY,Libya,DEU,Germany,2011,948,633,315
LBY,Libya,DEU,Germany,2012,1920,910,1010
LBY,Libya,DEU,Germany,2013,4432,1755,2677
LBY,Libya,DEU,Germany,2014,4256,2257,1999
LBY,Libya,DEU,Germany,2015,2621,1965,656
LBY,Libya,DEU,Germany,2016,2316,1577,739
LBY,Libya,DEU,Germany,2017,2366,1708,658
LBY,Libya,HUN,Hungary,2008,25,4,21
LBY,Libya,HUN,Hungary,2009,26,1,25
LBY,Libya,HUN,Hungary,2010,23,5,18
LBY,Libya,HUN,Hungary,2011,28,8,20
LBY,Libya,HUN,Hungary,2012,47,0,47
LBY,Libya,HUN,Hungary,2013,120,8,112
LBY,Libya,HUN,Hungary,2014,74,11,63
LBY,Libya,HUN,Hungary,2015,57,13,44
LBY,Libya,HUN,Hungary,2016,58,26,32
LBY,Libya,HUN,Hungary,2017,70,0,70
LBY,Libya,ISL,Iceland,2008,0,0,0
LBY,Libya,ISL,Iceland,2009,1,0,1
LBY,Libya,ISL,Iceland,2010,0,0,0
LBY,Libya,ISL,Iceland,2011,0,0,0
LBY,Libya,ISL,Iceland,2012,0,0,0
LBY,Libya,ISL,Iceland,2013,1,0,1
LBY,Libya,ISL,Iceland,2014,0,0,0
LBY,Libya,ISL,Iceland,2015,1,0,1
LBY,Libya,ISL,Iceland,2016,2,0,2
LBY,Libya,ISL,Iceland,2017,0,1,-1
LBY,Libya,ITA,Italy,2008,75,2,73
LBY,Libya,ITA,Italy,2009,66,2,64
LBY,Libya,ITA,Italy,2010,108,4,104
LBY,Libya,ITA,Italy,2011,258,9,249
LBY,Libya,ITA,Italy,2012,283,20,263
LBY,Libya,ITA,Italy,2013,326,12,314
LBY,Libya,ITA,Italy,2014,292,12,280
LBY,Libya,ITA,Italy,2015,296,24,272
LBY,Libya,ITA,Italy,2016,304,0,304
LBY,Libya,ITA,Italy,2017,402,15,387
LBY,Libya,JPN,Japan,2008,43,37,6
LBY,Libya,JPN,Japan,2009,20,31,-11
LBY,Libya,JPN,Japan,2010,46,13,33
LBY,Libya,JPN,Japan,2011,42,12,30
LBY,Libya,JPN,Japan,2012,57,60,-3
LBY,Libya,JPN,Japan,2013,115,80,35
LBY,Libya,JPN,Japan,2014,42,31,11
LBY,Libya,JPN,Japan,2015,5,5,0
LBY,Libya,JPN,Japan,2016,5,8,-3
LBY,Libya,JPN,Japan,2017,18,10,8
LBY,Libya,KOR,Korea,2008,38,24,14
LBY,Libya,KOR,Korea,2009,62,60,2
LBY,Libya,KOR,Korea,2010,66,77,-11
LBY,Libya,KOR,Korea,2011,52,63,-11
LBY,Libya,KOR,Korea,2012,179,106,73
LBY,Libya,KOR,Korea,2013,193,158,35
LBY,Libya,KOR,Korea,2014,169,187,-18
LBY,Libya,KOR,Korea,2015,123,196,-73
LBY,Libya,KOR,Korea,2016,89,137,-48
LBY,Libya,KOR,Korea,2017,93,112,-19
LBY,Libya,LUX,Luxembourg,2008,0,0,0
LBY,Libya,LUX,Luxembourg,2009,0,0,0
LBY,Libya,LUX,Luxembourg,2010,14,0,14
LBY,Libya,LUX,Luxembourg,2011,1,0,1
LBY,Libya,LUX,Luxembourg,2012,9,0,9
LBY,Libya,LUX,Luxembourg,2013,14,3,11
LBY,Libya,LUX,Luxembourg,2014,7,9,-2
LBY,Libya,LUX,Luxembourg,2015,4,6,-2
LBY,Libya,LUX,Luxembourg,2016,4,3,1
LBY,Libya,LUX,Luxembourg,2017,12,6,6
LBY,Libya,MEX,Mexico,2009,1,0,1
LBY,Libya,MEX,Mexico,2010,1,0,1
LBY,Libya,MEX,Mexico,2011,1,0,1
LBY,Libya,MEX,Mexico,2012,0,0,0
LBY,Libya,MEX,Mexico,2013,3,0,3
LBY,Libya,MEX,Mexico,2014,2,0,2
LBY,Libya,MEX,Mexico,2015,1,0,1
LBY,Libya,MEX,Mexico,2016,1,0,1
LBY,Libya,NLD,Netherlands,2008,16,42,-26
LBY,Libya,NLD,Netherlands,2009,24,11,13
LBY,Libya,NLD,Netherlands,2010,17,16,1
LBY,Libya,NLD,Netherlands,2011,32,22,10
LBY,Libya,NLD,Netherlands,2012,20,23,-3
LBY,Libya,NLD,Netherlands,2013,26,21,5
LBY,Libya,NLD,Netherlands,2014,53,22,31
LBY,Libya,NLD,Netherlands,2015,57,6,51
LBY,Libya,NLD,Netherlands,2016,48,32,16
LBY,Libya,NLD,Netherlands,2017,48,15,33
LBY,Libya,NZL,New Zealand,2008,0,0,0
LBY,Libya,NZL,New Zealand,2010,4,0,4
LBY,Libya,NZL,New Zealand,2011,3,1,2
LBY,Libya,NZL,New Zealand,2012,3,2,1
LBY,Libya,NZL,New Zealand,2013,12,0,12
LBY,Libya,NZL,New Zealand,2014,11,7,4
LBY,Libya,NZL,New Zealand,2015,2,6,-4
LBY,Libya,NZL,New Zealand,2016,9,0,9
LBY,Libya,NZL,New Zealand,2017,4,0,4
LBY,Libya,NOR,Norway,2008,20,0,20
LBY,Libya,NOR,Norway,2009,8,4,4
LBY,Libya,NOR,Norway,2010,14,9,5
LBY,Libya,NOR,Norway,2011,34,6,28
LBY,Libya,NOR,Norway,2012,23,28,-5
LBY,Libya,NOR,Norway,2013,16,10,6
LBY,Libya,NOR,Norway,2014,8,7,1
LBY,Libya,NOR,Norway,2015,31,5,26
LBY,Libya,NOR,Norway,2016,23,12,11
LBY,Libya,NOR,Norway,2017,25,6,19
LBY,Libya,POL,Poland,2008,57,0,57
LBY,Libya,POL,Poland,2009,63,0,63
LBY,Libya,POL,Poland,2010,56,0,56
LBY,Libya,POL,Poland,2011,55,0,55
LBY,Libya,POL,Poland,2012,52,0,52
LBY,Libya,POL,Poland,2013,71,0,71
LBY,Libya,POL,Poland,2014,95,0,95
LBY,Libya,POL,Poland,2015,271,0,271
LBY,Libya,POL,Poland,2016,222,0,222
LBY,Libya,POL,Poland,2017,168,0,168
LBY,Libya,SVK,Slovak Republic,2008,47,12,35
LBY,Libya,SVK,Slovak Republic,2009,99,21,78
LBY,Libya,SVK,Slovak Republic,2010,103,8,95
LBY,Libya,SVK,Slovak Republic,2011,2,4,-2
LBY,Libya,SVK,Slovak Republic,2013,2,0,2
LBY,Libya,SVK,Slovak Republic,2014,2,0,2
LBY,Libya,SVK,Slovak Republic,2015,5,0,5
LBY,Libya,SVK,Slovak Republic,2016,1,0,1
LBY,Libya,SVK,Slovak Republic,2017,17,0,17
LBY,Libya,ESP,Spain,2008,33,42,-9
LBY,Libya,ESP,Spain,2009,44,37,7
LBY,Libya,ESP,Spain,2010,60,31,29
LBY,Libya,ESP,Spain,2011,115,54,61
LBY,Libya,ESP,Spain,2012,79,34,45
LBY,Libya,ESP,Spain,2013,152,47,105
LBY,Libya,ESP,Spain,2014,286,39,247
LBY,Libya,ESP,Spain,2015,367,69,298
LBY,Libya,ESP,Spain,2016,207,102,105
LBY,Libya,ESP,Spain,2017,244,159,85
LBY,Libya,SWE,Sweden,2008,117,13,104
LBY,Libya,SWE,Sweden,2009,145,11,134
LBY,Libya,SWE,Sweden,2010,126,6,120
LBY,Libya,SWE,Sweden,2011,215,28,187
LBY,Libya,SWE,Sweden,2012,124,61,63
LBY,Libya,SWE,Sweden,2013,91,36,55
LBY,Libya,SWE,Sweden,2014,88,50,38
LBY,Libya,SWE,Sweden,2015,107,52,55
LBY,Libya,SWE,Sweden,2016,143,23,120
LBY,Libya,SWE,Sweden,2017,71,9,62
LBY,Libya,CHE,Switzerland,2010,16,28,-12
LBY,Libya,CHE,Switzerland,2011,25,13,12
LBY,Libya,CHE,Switzerland,2012,30,49,-19
LBY,Libya,CHE,Switzerland,2013,27,27,0
LBY,Libya,CHE,Switzerland,2014,36,19,17
LBY,Libya,CHE,Switzerland,2015,49,11,38
LBY,Libya,CHE,Switzerland,2016,29,11,18
LBY,Libya,CHE,Switzerland,2017,39,11,28
LBY,Libya,TUR,Turkey,2010,34,0,34
LBY,Libya,TUR,Turkey,2016,4344,5197,-853
LBY,Libya,TUR,Turkey,2017,6029,3032,2997
LBY,Libya,GBR,United Kingdom,2012,3000,0,3000
LBY,Libya,GBR,United Kingdom,2013,6000,0,6000
LBY,Libya,GBR,United Kingdom,2014,2000,0,2000
LBY,Libya,USA,United States,2008,285,0,285
LBY,Libya,USA,United States,2009,296,0,296
LBY,Libya,USA,United States,2010,355,0,355
LBY,Libya,USA,United States,2011,357,0,357
LBY,Libya,USA,United States,2012,315,0,315
LBY,Libya,USA,United States,2013,376,0,376
LBY,Libya,USA,United States,2014,524,0,524
LBY,Libya,USA,United States,2015,734,0,734
LBY,Libya,USA,United States,2016,642,0,642
LBY,Libya,USA,United States,2017,780,0,780
LBY,Libya,CHL,Chile,2008,0,0,0
LBY,Libya,CHL,Chile,2009,0,0,0
LBY,Libya,CHL,Chile,2010,1,0,1
LBY,Libya,CHL,Chile,2011,0,0,0
LBY,Libya,CHL,Chile,2012,0,0,0
LBY,Libya,CHL,Chile,2013,1,0,1
LBY,Libya,CHL,Chile,2014,0,0,0
LBY,Libya,CHL,Chile,2015,1,0,1
LBY,Libya,CHL,Chile,2016,1,0,1
LBY,Libya,EST,Estonia,2008,0,0,0
LBY,Libya,EST,Estonia,2009,0,0,0
LBY,Libya,EST,Estonia,2010,0,0,0
LBY,Libya,EST,Estonia,2011,0,0,0
LBY,Libya,EST,Estonia,2012,0,0,0
LBY,Libya,EST,Estonia,2013,0,0,0
LBY,Libya,EST,Estonia,2014,0,0,0
LBY,Libya,EST,Estonia,2015,0,0,0
LBY,Libya,EST,Estonia,2016,0,0,0
LBY,Libya,EST,Estonia,2017,0,0,0
LBY,Libya,SVN,Slovenia,2008,1,0,1
LBY,Libya,SVN,Slovenia,2009,1,0,1
LBY,Libya,SVN,Slovenia,2011,28,0,28
LBY,Libya,SVN,Slovenia,2013,2,0,2
LBY,Libya,SVN,Slovenia,2014,12,0,12
LBY,Libya,SVN,Slovenia,2015,6,0,6
LBY,Libya,SVN,Slovenia,2016,15,0,15
LBY,Libya,SVN,Slovenia,2017,7,1,6
LIE,Liechtenstein,AUS,Australia,2008,1,0,1
LIE,Liechtenstein,AUS,Australia,2009,2,0,2
LIE,Liechtenstein,AUS,Australia,2010,0,0,0
LIE,Liechtenstein,AUS,Australia,2011,0,0,0
LIE,Liechtenstein,AUS,Australia,2012,2,0,2
LIE,Liechtenstein,AUS,Australia,2013,1,0,1
LIE,Liechtenstein,AUS,Australia,2014,0,0,0
LIE,Liechtenstein,AUS,Australia,2015,0,0,0
LIE,Liechtenstein,AUS,Australia,2016,0,0,0
LIE,Liechtenstein,AUS,Australia,2017,0,0,0
LIE,Liechtenstein,AUT,Austria,2008,24,15,9
LIE,Liechtenstein,AUT,Austria,2009,29,15,14
LIE,Liechtenstein,AUT,Austria,2010,22,10,12
LIE,Liechtenstein,AUT,Austria,2011,12,14,-2
LIE,Liechtenstein,AUT,Austria,2012,19,17,2
LIE,Liechtenstein,AUT,Austria,2013,24,29,-5
LIE,Liechtenstein,AUT,Austria,2014,26,12,14
LIE,Liechtenstein,AUT,Austria,2015,36,19,17
LIE,Liechtenstein,AUT,Austria,2016,32,11,21
LIE,Liechtenstein,AUT,Austria,2017,28,18,10
LIE,Liechtenstein,BEL,Belgium,2008,1,0,1
LIE,Liechtenstein,BEL,Belgium,2009,5,0,5
LIE,Liechtenstein,BEL,Belgium,2010,1,1,0
LIE,Liechtenstein,BEL,Belgium,2012,3,6,-3
LIE,Liechtenstein,BEL,Belgium,2014,1,3,-2
LIE,Liechtenstein,BEL,Belgium,2015,1,2,-1
LIE,Liechtenstein,BEL,Belgium,2016,2,0,2
LIE,Liechtenstein,BEL,Belgium,2017,3,0,3
LIE,Liechtenstein,CAN,Canada,2008,1,0,1
LIE,Liechtenstein,CAN,Canada,2009,1,0,1
LIE,Liechtenstein,CAN,Canada,2010,0,0,0
LIE,Liechtenstein,CAN,Canada,2011,2,0,2
LIE,Liechtenstein,CAN,Canada,2012,1,0,1
LIE,Liechtenstein,CAN,Canada,2013,0,0,0
LIE,Liechtenstein,CAN,Canada,2014,0,0,0
LIE,Liechtenstein,CAN,Canada,2015,0,0,0
LIE,Liechtenstein,CAN,Canada,2016,0,0,0
LIE,Liechtenstein,CAN,Canada,2017,0,0,0
LIE,Liechtenstein,CZE,Czech Republic,2010,4,0,4
LIE,Liechtenstein,DNK,Denmark,2008,0,3,-3
LIE,Liechtenstein,DNK,Denmark,2009,0,1,-1
LIE,Liechtenstein,DNK,Denmark,2010,1,7,-6
LIE,Liechtenstein,DNK,Denmark,2012,1,0,1
LIE,Liechtenstein,DNK,Denmark,2013,0,2,-2
LIE,Liechtenstein,DNK,Denmark,2014,2,1,1
LIE,Liechtenstein,DNK,Denmark,2015,2,3,-1
LIE,Liechtenstein,DNK,Denmark,2016,1,0,1
LIE,Liechtenstein,DNK,Denmark,2017,3,1,2
LIE,Liechtenstein,FIN,Finland,2008,0,0,0
LIE,Liechtenstein,FIN,Finland,2009,0,0,0
LIE,Liechtenstein,FIN,Finland,2010,0,0,0
LIE,Liechtenstein,FIN,Finland,2011,0,0,0
LIE,Liechtenstein,FIN,Finland,2012,1,0,1
LIE,Liechtenstein,FIN,Finland,2013,0,0,0
LIE,Liechtenstein,FIN,Finland,2014,1,1,0
LIE,Liechtenstein,FIN,Finland,2015,0,0,0
LIE,Liechtenstein,FIN,Finland,2016,0,0,0
LIE,Liechtenstein,FIN,Finland,2017,0,0,0
LIE,Liechtenstein,FRA,France,2008,0,0,0
LIE,Liechtenstein,FRA,France,2009,0,0,0
LIE,Liechtenstein,FRA,France,2010,0,0,0
LIE,Liechtenstein,FRA,France,2011,0,0,0
LIE,Liechtenstein,FRA,France,2012,0,0,0
LIE,Liechtenstein,FRA,France,2013,0,0,0
LIE,Liechtenstein,FRA,France,2014,0,0,0
LIE,Liechtenstein,FRA,France,2015,0,0,0
LIE,Liechtenstein,FRA,France,2016,0,0,0
LIE,Liechtenstein,FRA,France,2017,0,0,0
LIE,Liechtenstein,DEU,Germany,2008,22,22,0
LIE,Liechtenstein,DEU,Germany,2009,23,29,-6
LIE,Liechtenstein,DEU,Germany,2010,38,17,21
LIE,Liechtenstein,DEU,Germany,2011,30,16,14
LIE,Liechtenstein,DEU,Germany,2012,33,22,11
LIE,Liechtenstein,DEU,Germany,2013,38,20,18
LIE,Liechtenstein,DEU,Germany,2014,32,24,8
LIE,Liechtenstein,DEU,Germany,2015,40,35,5
LIE,Liechtenstein,DEU,Germany,2016,24,20,4
LIE,Liechtenstein,DEU,Germany,2017,38,28,10
LIE,Liechtenstein,HUN,Hungary,2008,0,0,0
LIE,Liechtenstein,HUN,Hungary,2009,0,0,0
LIE,Liechtenstein,HUN,Hungary,2010,0,0,0
LIE,Liechtenstein,HUN,Hungary,2011,0,0,0
LIE,Liechtenstein,HUN,Hungary,2012,1,0,1
LIE,Liechtenstein,HUN,Hungary,2013,2,0,2
LIE,Liechtenstein,HUN,Hungary,2014,0,0,0
LIE,Liechtenstein,HUN,Hungary,2015,3,0,3
LIE,Liechtenstein,HUN,Hungary,2016,0,0,0
LIE,Liechtenstein,HUN,Hungary,2017,0,0,0
LIE,Liechtenstein,ISL,Iceland,2008,0,0,0
LIE,Liechtenstein,ISL,Iceland,2009,0,0,0
LIE,Liechtenstein,ISL,Iceland,2010,0,0,0
LIE,Liechtenstein,ISL,Iceland,2011,0,0,0
LIE,Liechtenstein,ISL,Iceland,2012,0,0,0
LIE,Liechtenstein,ISL,Iceland,2013,1,0,1
LIE,Liechtenstein,ISL,Iceland,2014,1,0,1
LIE,Liechtenstein,ISL,Iceland,2015,0,0,0
LIE,Liechtenstein,ISL,Iceland,2016,0,1,-1
LIE,Liechtenstein,ISL,Iceland,2017,0,0,0
LIE,Liechtenstein,ITA,Italy,2008,14,0,14
LIE,Liechtenstein,ITA,Italy,2009,7,0,7
LIE,Liechtenstein,ITA,Italy,2010,7,2,5
LIE,Liechtenstein,ITA,Italy,2011,1,1,0
LIE,Liechtenstein,ITA,Italy,2012,6,0,6
LIE,Liechtenstein,ITA,Italy,2013,2,0,2
LIE,Liechtenstein,ITA,Italy,2015,247,0,247
LIE,Liechtenstein,ITA,Italy,2016,8,0,8
LIE,Liechtenstein,ITA,Italy,2017,4,10,-6
LIE,Liechtenstein,JPN,Japan,2008,3,1,2
LIE,Liechtenstein,JPN,Japan,2009,0,4,-4
LIE,Liechtenstein,JPN,Japan,2010,1,1,0
LIE,Liechtenstein,JPN,Japan,2011,3,4,-1
LIE,Liechtenstein,JPN,Japan,2012,7,5,2
LIE,Liechtenstein,JPN,Japan,2013,3,2,1
LIE,Liechtenstein,JPN,Japan,2014,3,5,-2
LIE,Liechtenstein,JPN,Japan,2015,5,3,2
LIE,Liechtenstein,JPN,Japan,2016,3,3,0
LIE,Liechtenstein,JPN,Japan,2017,3,4,-1
LIE,Liechtenstein,KOR,Korea,2008,0,1,-1
LIE,Liechtenstein,KOR,Korea,2009,0,0,0
LIE,Liechtenstein,KOR,Korea,2010,0,1,-1
LIE,Liechtenstein,KOR,Korea,2011,0,1,-1
LIE,Liechtenstein,KOR,Korea,2012,0,0,0
LIE,Liechtenstein,KOR,Korea,2013,0,0,0
LIE,Liechtenstein,KOR,Korea,2014,0,0,0
LIE,Liechtenstein,KOR,Korea,2015,2,1,1
LIE,Liechtenstein,KOR,Korea,2016,0,0,0
LIE,Liechtenstein,KOR,Korea,2017,1,2,-1
LIE,Liechtenstein,LUX,Luxembourg,2008,1,0,1
LIE,Liechtenstein,LUX,Luxembourg,2009,0,0,0
LIE,Liechtenstein,LUX,Luxembourg,2010,0,0,0
LIE,Liechtenstein,LUX,Luxembourg,2011,1,0,1
LIE,Liechtenstein,LUX,Luxembourg,2012,1,1,0
LIE,Liechtenstein,LUX,Luxembourg,2013,0,0,0
LIE,Liechtenstein,LUX,Luxembourg,2014,0,1,-1
LIE,Liechtenstein,LUX,Luxembourg,2015,0,0,0
LIE,Liechtenstein,LUX,Luxembourg,2016,1,0,1
LIE,Liechtenstein,LUX,Luxembourg,2017,0,0,0
LIE,Liechtenstein,MEX,Mexico,2011,1,0,1
LIE,Liechtenstein,MEX,Mexico,2012,1,0,1
LIE,Liechtenstein,MEX,Mexico,2013,1,0,1
LIE,Liechtenstein,MEX,Mexico,2014,1,0,1
LIE,Liechtenstein,MEX,Mexico,2015,1,0,1
LIE,Liechtenstein,MEX,Mexico,2016,1,0,1
LIE,Liechtenstein,MEX,Mexico,2017,1,0,1
LIE,Liechtenstein,NLD,Netherlands,2008,2,0,2
LIE,Liechtenstein,NLD,Netherlands,2009,5,2,3
LIE,Liechtenstein,NLD,Netherlands,2010,2,2,0
LIE,Liechtenstein,NLD,Netherlands,2011,2,3,-1
LIE,Liechtenstein,NLD,Netherlands,2012,1,5,-4
LIE,Liechtenstein,NLD,Netherlands,2013,1,0,1
LIE,Liechtenstein,NLD,Netherlands,2014,2,2,0
LIE,Liechtenstein,NLD,Netherlands,2015,3,4,-1
LIE,Liechtenstein,NLD,Netherlands,2016,6,2,4
LIE,Liechtenstein,NLD,Netherlands,2017,3,3,0
LIE,Liechtenstein,NZL,New Zealand,2008,0,0,0
LIE,Liechtenstein,NZL,New Zealand,2009,1,0,1
LIE,Liechtenstein,NZL,New Zealand,2010,1,0,1
LIE,Liechtenstein,NZL,New Zealand,2012,0,0,0
LIE,Liechtenstein,NZL,New Zealand,2016,1,0,1
LIE,Liechtenstein,NOR,Norway,2008,0,3,-3
LIE,Liechtenstein,NOR,Norway,2009,1,0,1
LIE,Liechtenstein,NOR,Norway,2010,2,1,1
LIE,Liechtenstein,NOR,Norway,2011,0,1,-1
LIE,Liechtenstein,NOR,Norway,2012,0,1,-1
LIE,Liechtenstein,NOR,Norway,2013,0,1,-1
LIE,Liechtenstein,NOR,Norway,2014,0,0,0
LIE,Liechtenstein,NOR,Norway,2015,0,0,0
LIE,Liechtenstein,NOR,Norway,2016,1,0,1
LIE,Liechtenstein,NOR,Norway,2017,0,0,0
LIE,Liechtenstein,POL,Poland,2009,0,0,0
LIE,Liechtenstein,POL,Poland,2010,0,0,0
LIE,Liechtenstein,POL,Poland,2011,0,0,0
LIE,Liechtenstein,POL,Poland,2012,0,0,0
LIE,Liechtenstein,POL,Poland,2013,0,0,0
LIE,Liechtenstein,POL,Poland,2014,0,0,0
LIE,Liechtenstein,POL,Poland,2015,1,0,1
LIE,Liechtenstein,POL,Poland,2016,1,0,1
LIE,Liechtenstein,POL,Poland,2017,0,0,0
LIE,Liechtenstein,SVK,Slovak Republic,2008,0,0,0
LIE,Liechtenstein,SVK,Slovak Republic,2010,1,0,1
LIE,Liechtenstein,ESP,Spain,2008,7,3,4
LIE,Liechtenstein,ESP,Spain,2009,0,1,-1
LIE,Liechtenstein,ESP,Spain,2010,6,9,-3
LIE,Liechtenstein,ESP,Spain,2011,0,8,-8
LIE,Liechtenstein,ESP,Spain,2012,6,0,6
LIE,Liechtenstein,ESP,Spain,2013,2,0,2
LIE,Liechtenstein,ESP,Spain,2014,7,3,4
LIE,Liechtenstein,ESP,Spain,2015,4,2,2
LIE,Liechtenstein,ESP,Spain,2016,3,1,2
LIE,Liechtenstein,ESP,Spain,2017,7,1,6
LIE,Liechtenstein,SWE,Sweden,2008,1,0,1
LIE,Liechtenstein,SWE,Sweden,2009,2,0,2
LIE,Liechtenstein,SWE,Sweden,2010,2,1,1
LIE,Liechtenstein,SWE,Sweden,2011,3,0,3
LIE,Liechtenstein,SWE,Sweden,2012,0,1,-1
LIE,Liechtenstein,SWE,Sweden,2013,2,0,2
LIE,Liechtenstein,SWE,Sweden,2014,2,1,1
LIE,Liechtenstein,SWE,Sweden,2015,0,4,-4
LIE,Liechtenstein,SWE,Sweden,2016,1,1,0
LIE,Liechtenstein,SWE,Sweden,2017,1,1,0
LIE,Liechtenstein,CHE,Switzerland,2008,118,76,42
LIE,Liechtenstein,CHE,Switzerland,2009,116,88,28
LIE,Liechtenstein,CHE,Switzerland,2010,118,83,35
LIE,Liechtenstein,CHE,Switzerland,2011,100,79,21
LIE,Liechtenstein,CHE,Switzerland,2012,107,61,46
LIE,Liechtenstein,CHE,Switzerland,2013,138,71,67
LIE,Liechtenstein,CHE,Switzerland,2014,103,70,33
LIE,Liechtenstein,CHE,Switzerland,2015,110,66,44
LIE,Liechtenstein,CHE,Switzerland,2016,108,69,39
LIE,Liechtenstein,CHE,Switzerland,2017,82,73,9
LIE,Liechtenstein,USA,United States,2010,3,0,3
LIE,Liechtenstein,USA,United States,2011,3,0,3
LIE,Liechtenstein,CHL,Chile,2008,1,0,1
LIE,Liechtenstein,CHL,Chile,2009,0,0,0
LIE,Liechtenstein,CHL,Chile,2010,0,0,0
LIE,Liechtenstein,CHL,Chile,2011,0,0,0
LIE,Liechtenstein,CHL,Chile,2012,0,0,0
LIE,Liechtenstein,CHL,Chile,2013,0,0,0
LIE,Liechtenstein,CHL,Chile,2014,0,0,0
LIE,Liechtenstein,CHL,Chile,2015,0,0,0
LIE,Liechtenstein,CHL,Chile,2016,0,0,0
LIE,Liechtenstein,EST,Estonia,2008,0,0,0
LIE,Liechtenstein,EST,Estonia,2009,0,0,0
LIE,Liechtenstein,EST,Estonia,2010,0,0,0
LIE,Liechtenstein,EST,Estonia,2011,0,0,0
LIE,Liechtenstein,EST,Estonia,2012,0,0,0
LIE,Liechtenstein,EST,Estonia,2013,0,0,0
LIE,Liechtenstein,EST,Estonia,2014,0,0,0
LIE,Liechtenstein,EST,Estonia,2015,0,0,0
LIE,Liechtenstein,EST,Estonia,2016,0,0,0
LIE,Liechtenstein,EST,Estonia,2017,0,0,0
LIE,Liechtenstein,SVN,Slovenia,2008,3,0,3
LIE,Liechtenstein,SVN,Slovenia,2009,1,0,1
LIE,Liechtenstein,SVN,Slovenia,2014,3,0,3
LTU,Lithuania,AUS,Australia,2008,35,16,19
LTU,Lithuania,AUS,Australia,2009,36,15,21
LTU,Lithuania,AUS,Australia,2010,59,5,54
LTU,Lithuania,AUS,Australia,2011,42,6,36
LTU,Lithuania,AUS,Australia,2012,79,10,69
LTU,Lithuania,AUS,Australia,2013,67,9,58
LTU,Lithuania,AUS,Australia,2014,65,9,56
LTU,Lithuania,AUS,Australia,2015,75,0,75
LTU,Lithuania,AUS,Australia,2016,71,0,71
LTU,Lithuania,AUS,Australia,2017,79,0,79
LTU,Lithuania,AUT,Austria,2008,188,145,43
LTU,Lithuania,AUT,Austria,2009,224,146,78
LTU,Lithuania,AUT,Austria,2010,276,159,117
LTU,Lithuania,AUT,Austria,2011,313,189,124
LTU,Lithuania,AUT,Austria,2012,292,178,114
LTU,Lithuania,AUT,Austria,2013,260,175,85
LTU,Lithuania,AUT,Austria,2014,252,186,66
LTU,Lithuania,AUT,Austria,2015,258,173,85
LTU,Lithuania,AUT,Austria,2016,247,176,71
LTU,Lithuania,AUT,Austria,2017,281,185,96
LTU,Lithuania,BEL,Belgium,2008,326,140,186
LTU,Lithuania,BEL,Belgium,2009,312,169,143
LTU,Lithuania,BEL,Belgium,2010,416,208,208
LTU,Lithuania,BEL,Belgium,2011,408,197,211
LTU,Lithuania,BEL,Belgium,2012,443,215,228
LTU,Lithuania,BEL,Belgium,2013,362,258,104
LTU,Lithuania,BEL,Belgium,2014,252,228,24
LTU,Lithuania,BEL,Belgium,2015,249,183,66
LTU,Lithuania,BEL,Belgium,2016,230,114,116
LTU,Lithuania,BEL,Belgium,2017,333,97,236
LTU,Lithuania,CAN,Canada,2008,109,0,109
LTU,Lithuania,CAN,Canada,2009,63,0,63
LTU,Lithuania,CAN,Canada,2010,57,0,57
LTU,Lithuania,CAN,Canada,2011,52,0,52
LTU,Lithuania,CAN,Canada,2012,77,0,77
LTU,Lithuania,CAN,Canada,2013,145,0,145
LTU,Lithuania,CAN,Canada,2014,154,0,154
LTU,Lithuania,CAN,Canada,2015,133,0,133
LTU,Lithuania,CAN,Canada,2016,190,0,190
LTU,Lithuania,CAN,Canada,2017,140,0,140
LTU,Lithuania,CZE,Czech Republic,2008,50,6,44
LTU,Lithuania,CZE,Czech Republic,2009,50,16,34
LTU,Lithuania,CZE,Czech Republic,2010,38,30,8
LTU,Lithuania,CZE,Czech Republic,2011,30,6,24
LTU,Lithuania,CZE,Czech Republic,2012,56,3,53
LTU,Lithuania,CZE,Czech Republic,2013,48,8,40
LTU,Lithuania,CZE,Czech Republic,2014,47,6,41
LTU,Lithuania,CZE,Czech Republic,2015,36,14,22
LTU,Lithuania,CZE,Czech Republic,2016,39,8,31
LTU,Lithuania,CZE,Czech Republic,2017,49,16,33
LTU,Lithuania,DNK,Denmark,2008,1086,602,484
LTU,Lithuania,DNK,Denmark,2009,1265,559,706
LTU,Lithuania,DNK,Denmark,2010,1486,615,871
LTU,Lithuania,DNK,Denmark,2011,1576,741,835
LTU,Lithuania,DNK,Denmark,2012,1509,965,544
LTU,Lithuania,DNK,Denmark,2013,1448,936,512
LTU,Lithuania,DNK,Denmark,2014,1471,1070,401
LTU,Lithuania,DNK,Denmark,2015,1505,979,526
LTU,Lithuania,DNK,Denmark,2016,1692,1357,335
LTU,Lithuania,DNK,Denmark,2017,1917,1375,542
LTU,Lithuania,FIN,Finland,2008,94,18,76
LTU,Lithuania,FIN,Finland,2009,66,32,34
LTU,Lithuania,FIN,Finland,2010,143,16,127
LTU,Lithuania,FIN,Finland,2011,121,14,107
LTU,Lithuania,FIN,Finland,2012,175,42,133
LTU,Lithuania,FIN,Finland,2013,164,27,137
LTU,Lithuania,FIN,Finland,2014,154,42,112
LTU,Lithuania,FIN,Finland,2015,160,35,125
LTU,Lithuania,FIN,Finland,2016,131,38,93
LTU,Lithuania,FIN,Finland,2017,180,62,118
LTU,Lithuania,FRA,France,2008,0,0,0
LTU,Lithuania,FRA,France,2009,0,0,0
LTU,Lithuania,FRA,France,2010,0,0,0
LTU,Lithuania,FRA,France,2011,0,0,0
LTU,Lithuania,FRA,France,2012,0,0,0
LTU,Lithuania,FRA,France,2013,263,0,263
LTU,Lithuania,FRA,France,2014,305,0,305
LTU,Lithuania,FRA,France,2015,214,0,214
LTU,Lithuania,FRA,France,2016,210,0,210
LTU,Lithuania,FRA,France,2017,229,0,229
LTU,Lithuania,DEU,Germany,2008,3453,3152,301
LTU,Lithuania,DEU,Germany,2009,4647,3282,1365
LTU,Lithuania,DEU,Germany,2010,6134,3797,2337
LTU,Lithuania,DEU,Germany,2011,10075,4862,5213
LTU,Lithuania,DEU,Germany,2012,10226,5340,4886
LTU,Lithuania,DEU,Germany,2013,9271,5988,3283
LTU,Lithuania,DEU,Germany,2014,8584,6311,2273
LTU,Lithuania,DEU,Germany,2015,9798,5822,3976
LTU,Lithuania,DEU,Germany,2016,9595,6778,2817
LTU,Lithuania,DEU,Germany,2017,10209,6090,4119
LTU,Lithuania,HUN,Hungary,2008,15,6,9
LTU,Lithuania,HUN,Hungary,2009,15,4,11
LTU,Lithuania,HUN,Hungary,2010,27,3,24
LTU,Lithuania,HUN,Hungary,2011,25,0,25
LTU,Lithuania,HUN,Hungary,2012,24,1,23
LTU,Lithuania,HUN,Hungary,2013,33,10,23
LTU,Lithuania,HUN,Hungary,2014,34,7,27
LTU,Lithuania,HUN,Hungary,2015,29,11,18
LTU,Lithuania,HUN,Hungary,2016,42,18,24
LTU,Lithuania,HUN,Hungary,2017,33,0,33
LTU,Lithuania,ISL,Iceland,2008,427,222,205
LTU,Lithuania,ISL,Iceland,2009,236,387,-151
LTU,Lithuania,ISL,Iceland,2010,252,197,55
LTU,Lithuania,ISL,Iceland,2011,173,205,-32
LTU,Lithuania,ISL,Iceland,2012,143,180,-37
LTU,Lithuania,ISL,Iceland,2013,166,120,46
LTU,Lithuania,ISL,Iceland,2014,177,149,28
LTU,Lithuania,ISL,Iceland,2015,273,142,131
LTU,Lithuania,ISL,Iceland,2016,674,197,477
LTU,Lithuania,ISL,Iceland,2017,1295,248,1047
LTU,Lithuania,ITA,Italy,2008,720,35,685
LTU,Lithuania,ITA,Italy,2009,611,42,569
LTU,Lithuania,ITA,Italy,2010,529,47,482
LTU,Lithuania,ITA,Italy,2011,492,44,448
LTU,Lithuania,ITA,Italy,2012,438,63,375
LTU,Lithuania,ITA,Italy,2013,368,67,301
LTU,Lithuania,ITA,Italy,2014,284,72,212
LTU,Lithuania,ITA,Italy,2015,247,84,163
LTU,Lithuania,ITA,Italy,2016,247,0,247
LTU,Lithuania,ITA,Italy,2017,281,58,223
LTU,Lithuania,JPN,Japan,2008,74,71,3
LTU,Lithuania,JPN,Japan,2009,160,144,16
LTU,Lithuania,JPN,Japan,2010,177,177,0
LTU,Lithuania,JPN,Japan,2011,95,92,3
LTU,Lithuania,JPN,Japan,2012,146,126,20
LTU,Lithuania,JPN,Japan,2013,110,100,10
LTU,Lithuania,JPN,Japan,2014,138,117,21
LTU,Lithuania,JPN,Japan,2015,457,141,316
LTU,Lithuania,JPN,Japan,2016,243,154,89
LTU,Lithuania,JPN,Japan,2017,183,193,-10
LTU,Lithuania,KOR,Korea,2008,14,15,-1
LTU,Lithuania,KOR,Korea,2009,25,26,-1
LTU,Lithuania,KOR,Korea,2010,57,42,15
LTU,Lithuania,KOR,Korea,2011,37,44,-7
LTU,Lithuania,KOR,Korea,2012,52,54,-2
LTU,Lithuania,KOR,Korea,2013,57,59,-2
LTU,Lithuania,KOR,Korea,2014,53,46,7
LTU,Lithuania,KOR,Korea,2015,50,57,-7
LTU,Lithuania,KOR,Korea,2016,54,52,2
LTU,Lithuania,KOR,Korea,2017,43,57,-14
LTU,Lithuania,LUX,Luxembourg,2008,89,29,60
LTU,Lithuania,LUX,Luxembourg,2009,66,16,50
LTU,Lithuania,LUX,Luxembourg,2010,61,21,40
LTU,Lithuania,LUX,Luxembourg,2011,81,23,58
LTU,Lithuania,LUX,Luxembourg,2012,61,36,25
LTU,Lithuania,LUX,Luxembourg,2013,69,41,28
LTU,Lithuania,LUX,Luxembourg,2014,98,35,63
LTU,Lithuania,LUX,Luxembourg,2015,139,26,113
LTU,Lithuania,LUX,Luxembourg,2016,109,96,13
LTU,Lithuania,LUX,Luxembourg,2017,83,47,36
LTU,Lithuania,MEX,Mexico,2008,1,0,1
LTU,Lithuania,MEX,Mexico,2009,2,0,2
LTU,Lithuania,MEX,Mexico,2010,7,0,7
LTU,Lithuania,MEX,Mexico,2011,10,0,10
LTU,Lithuania,MEX,Mexico,2012,4,0,4
LTU,Lithuania,MEX,Mexico,2013,22,0,22
LTU,Lithuania,MEX,Mexico,2014,9,0,9
LTU,Lithuania,MEX,Mexico,2015,12,0,12
LTU,Lithuania,MEX,Mexico,2016,10,0,10
LTU,Lithuania,MEX,Mexico,2017,10,0,10
LTU,Lithuania,NLD,Netherlands,2008,491,193,298
LTU,Lithuania,NLD,Netherlands,2009,640,263,377
LTU,Lithuania,NLD,Netherlands,2010,1087,334,753
LTU,Lithuania,NLD,Netherlands,2011,1316,491,825
LTU,Lithuania,NLD,Netherlands,2012,1196,718,478
LTU,Lithuania,NLD,Netherlands,2013,1254,907,347
LTU,Lithuania,NLD,Netherlands,2014,1109,844,265
LTU,Lithuania,NLD,Netherlands,2015,1124,754,370
LTU,Lithuania,NLD,Netherlands,2016,1225,754,471
LTU,Lithuania,NLD,Netherlands,2017,1568,780,788
LTU,Lithuania,NZL,New Zealand,2008,10,5,5
LTU,Lithuania,NZL,New Zealand,2009,10,3,7
LTU,Lithuania,NZL,New Zealand,2010,10,5,5
LTU,Lithuania,NZL,New Zealand,2011,10,3,7
LTU,Lithuania,NZL,New Zealand,2012,16,2,14
LTU,Lithuania,NZL,New Zealand,2013,19,8,11
LTU,Lithuania,NZL,New Zealand,2014,17,4,13
LTU,Lithuania,NZL,New Zealand,2015,17,3,14
LTU,Lithuania,NZL,New Zealand,2016,10,5,5
LTU,Lithuania,NZL,New Zealand,2017,93,7,86
LTU,Lithuania,NOR,Norway,2008,2851,465,2386
LTU,Lithuania,NOR,Norway,2009,3196,567,2629
LTU,Lithuania,NOR,Norway,2010,6552,785,5767
LTU,Lithuania,NOR,Norway,2011,7743,468,7275
LTU,Lithuania,NOR,Norway,2012,6600,563,6037
LTU,Lithuania,NOR,Norway,2013,5573,1172,4401
LTU,Lithuania,NOR,Norway,2014,4444,1413,3031
LTU,Lithuania,NOR,Norway,2015,3309,1897,1412
LTU,Lithuania,NOR,Norway,2016,2522,2445,77
LTU,Lithuania,NOR,Norway,2017,2742,2197,545
LTU,Lithuania,POL,Poland,2008,162,0,162
LTU,Lithuania,POL,Poland,2009,191,0,191
LTU,Lithuania,POL,Poland,2010,212,0,212
LTU,Lithuania,POL,Poland,2011,188,0,188
LTU,Lithuania,POL,Poland,2012,213,0,213
LTU,Lithuania,POL,Poland,2013,243,0,243
LTU,Lithuania,POL,Poland,2014,242,0,242
LTU,Lithuania,POL,Poland,2015,249,0,249
LTU,Lithuania,POL,Poland,2016,259,0,259
LTU,Lithuania,POL,Poland,2017,248,0,248
LTU,Lithuania,SVK,Slovak Republic,2008,13,7,6
LTU,Lithuania,SVK,Slovak Republic,2009,17,1,16
LTU,Lithuania,SVK,Slovak Republic,2010,11,2,9
LTU,Lithuania,SVK,Slovak Republic,2011,19,3,16
LTU,Lithuania,SVK,Slovak Republic,2012,11,0,11
LTU,Lithuania,SVK,Slovak Republic,2013,9,3,6
LTU,Lithuania,SVK,Slovak Republic,2014,10,0,10
LTU,Lithuania,SVK,Slovak Republic,2015,19,0,19
LTU,Lithuania,SVK,Slovak Republic,2016,11,1,10
LTU,Lithuania,SVK,Slovak Republic,2017,15,0,15
LTU,Lithuania,ESP,Spain,2008,1111,1356,-245
LTU,Lithuania,ESP,Spain,2009,1156,1702,-546
LTU,Lithuania,ESP,Spain,2010,1307,1536,-229
LTU,Lithuania,ESP,Spain,2011,1085,1269,-184
LTU,Lithuania,ESP,Spain,2012,864,1394,-530
LTU,Lithuania,ESP,Spain,2013,793,1554,-761
LTU,Lithuania,ESP,Spain,2014,724,1602,-878
LTU,Lithuania,ESP,Spain,2015,828,1313,-485
LTU,Lithuania,ESP,Spain,2016,1024,1071,-47
LTU,Lithuania,ESP,Spain,2017,1327,1434,-107
LTU,Lithuania,SWE,Sweden,2008,915,160,755
LTU,Lithuania,SWE,Sweden,2009,1214,123,1091
LTU,Lithuania,SWE,Sweden,2010,1370,182,1188
LTU,Lithuania,SWE,Sweden,2011,1349,226,1123
LTU,Lithuania,SWE,Sweden,2012,1356,371,985
LTU,Lithuania,SWE,Sweden,2013,1155,339,816
LTU,Lithuania,SWE,Sweden,2014,1251,351,900
LTU,Lithuania,SWE,Sweden,2015,1243,381,862
LTU,Lithuania,SWE,Sweden,2016,1390,393,997
LTU,Lithuania,SWE,Sweden,2017,1700,337,1363
LTU,Lithuania,CHE,Switzerland,2008,137,41,96
LTU,Lithuania,CHE,Switzerland,2009,152,44,108
LTU,Lithuania,CHE,Switzerland,2010,188,65,123
LTU,Lithuania,CHE,Switzerland,2011,296,79,217
LTU,Lithuania,CHE,Switzerland,2012,258,81,177
LTU,Lithuania,CHE,Switzerland,2013,236,104,132
LTU,Lithuania,CHE,Switzerland,2014,335,96,239
LTU,Lithuania,CHE,Switzerland,2015,309,107,202
LTU,Lithuania,CHE,Switzerland,2016,352,117,235
LTU,Lithuania,CHE,Switzerland,2017,363,119,244
LTU,Lithuania,TUR,Turkey,2010,52,0,52
LTU,Lithuania,TUR,Turkey,2016,127,156,-29
LTU,Lithuania,TUR,Turkey,2017,126,105,21
LTU,Lithuania,GBR,United Kingdom,2010,13000,0,13000
LTU,Lithuania,GBR,United Kingdom,2011,17000,3000,14000
LTU,Lithuania,GBR,United Kingdom,2012,9000,2000,7000
LTU,Lithuania,GBR,United Kingdom,2013,11000,3000,8000
LTU,Lithuania,GBR,United Kingdom,2014,14000,2000,12000
LTU,Lithuania,GBR,United Kingdom,2015,7000,1000,6000
LTU,Lithuania,GBR,United Kingdom,2016,7000,7000,0
LTU,Lithuania,GBR,United Kingdom,2017,8000,0,8000
LTU,Lithuania,USA,United States,2008,967,0,967
LTU,Lithuania,USA,United States,2009,1069,0,1069
LTU,Lithuania,USA,United States,2010,985,0,985
LTU,Lithuania,USA,United States,2011,936,0,936
LTU,Lithuania,USA,United States,2012,924,0,924
LTU,Lithuania,USA,United States,2013,854,0,854
LTU,Lithuania,USA,United States,2014,747,0,747
LTU,Lithuania,USA,United States,2015,750,0,750
LTU,Lithuania,USA,United States,2016,735,0,735
LTU,Lithuania,USA,United States,2017,645,0,645
LTU,Lithuania,CHL,Chile,2008,4,0,4
LTU,Lithuania,CHL,Chile,2009,25,0,25
LTU,Lithuania,CHL,Chile,2010,3,0,3
LTU,Lithuania,CHL,Chile,2011,15,0,15
LTU,Lithuania,CHL,Chile,2012,8,0,8
LTU,Lithuania,CHL,Chile,2013,8,0,8
LTU,Lithuania,CHL,Chile,2014,5,0,5
LTU,Lithuania,CHL,Chile,2015,6,0,6
LTU,Lithuania,CHL,Chile,2016,2,0,2
LTU,Lithuania,EST,Estonia,2008,70,0,70
LTU,Lithuania,EST,Estonia,2009,53,0,53
LTU,Lithuania,EST,Estonia,2010,17,0,17
LTU,Lithuania,EST,Estonia,2011,0,0,0
LTU,Lithuania,EST,Estonia,2012,3,0,3
LTU,Lithuania,EST,Estonia,2013,8,0,8
LTU,Lithuania,EST,Estonia,2014,17,0,17
LTU,Lithuania,EST,Estonia,2015,129,0,129
LTU,Lithuania,EST,Estonia,2016,165,0,165
LTU,Lithuania,EST,Estonia,2017,183,0,183
LTU,Lithuania,SVN,Slovenia,2008,1,0,1
LTU,Lithuania,SVN,Slovenia,2009,45,0,45
LTU,Lithuania,SVN,Slovenia,2011,52,2,50
LTU,Lithuania,SVN,Slovenia,2012,65,1,64
LTU,Lithuania,SVN,Slovenia,2013,66,0,66
LTU,Lithuania,SVN,Slovenia,2014,55,0,55
LTU,Lithuania,SVN,Slovenia,2015,54,0,54
LTU,Lithuania,SVN,Slovenia,2016,57,0,57
LTU,Lithuania,SVN,Slovenia,2017,46,0,46
LUX,Luxembourg,AUS,Australia,2008,6,21,-15
LUX,Luxembourg,AUS,Australia,2009,0,32,-32
LUX,Luxembourg,AUS,Australia,2010,6,5,1
LUX,Luxembourg,AUS,Australia,2011,2,17,-15
LUX,Luxembourg,AUS,Australia,2012,2,13,-11
LUX,Luxembourg,AUS,Australia,2013,8,23,-15
LUX,Luxembourg,AUS,Australia,2014,0,28,-28
LUX,Luxembourg,AUS,Australia,2015,6,24,-18
LUX,Luxembourg,AUS,Australia,2017,3,29,-26
LUX,Luxembourg,AUT,Austria,2008,73,58,15
LUX,Luxembourg,AUT,Austria,2009,67,72,-5
LUX,Luxembourg,AUT,Austria,2010,80,62,18
LUX,Luxembourg,AUT,Austria,2011,68,64,4
LUX,Luxembourg,AUT,Austria,2012,96,65,31
LUX,Luxembourg,AUT,Austria,2013,120,60,60
LUX,Luxembourg,AUT,Austria,2014,127,104,23
LUX,Luxembourg,AUT,Austria,2015,146,70,76
LUX,Luxembourg,AUT,Austria,2016,156,73,83
LUX,Luxembourg,AUT,Austria,2017,142,71,71
LUX,Luxembourg,BEL,Belgium,2008,319,1002,-683
LUX,Luxembourg,BEL,Belgium,2009,242,1020,-778
LUX,Luxembourg,BEL,Belgium,2010,253,1171,-918
LUX,Luxembourg,BEL,Belgium,2011,243,1159,-916
LUX,Luxembourg,BEL,Belgium,2012,250,1304,-1054
LUX,Luxembourg,BEL,Belgium,2013,252,1470,-1218
LUX,Luxembourg,BEL,Belgium,2014,240,1592,-1352
LUX,Luxembourg,BEL,Belgium,2015,219,1502,-1283
LUX,Luxembourg,BEL,Belgium,2016,229,1320,-1091
LUX,Luxembourg,BEL,Belgium,2017,228,1356,-1128
LUX,Luxembourg,CAN,Canada,2008,3,83,-80
LUX,Luxembourg,CAN,Canada,2009,5,42,-37
LUX,Luxembourg,CAN,Canada,2010,8,43,-35
LUX,Luxembourg,CAN,Canada,2011,11,61,-50
LUX,Luxembourg,CAN,Canada,2012,6,58,-52
LUX,Luxembourg,CAN,Canada,2013,7,92,-85
LUX,Luxembourg,CAN,Canada,2014,8,73,-65
LUX,Luxembourg,CAN,Canada,2015,8,83,-75
LUX,Luxembourg,CAN,Canada,2016,5,63,-58
LUX,Luxembourg,CAN,Canada,2017,5,83,-78
LUX,Luxembourg,CZE,Czech Republic,2008,4,111,-107
LUX,Luxembourg,CZE,Czech Republic,2010,1,88,-87
LUX,Luxembourg,CZE,Czech Republic,2011,1,109,-108
LUX,Luxembourg,CZE,Czech Republic,2012,2,81,-79
LUX,Luxembourg,CZE,Czech Republic,2013,2,63,-61
LUX,Luxembourg,CZE,Czech Republic,2014,1,87,-86
LUX,Luxembourg,CZE,Czech Republic,2015,2,100,-98
LUX,Luxembourg,CZE,Czech Republic,2016,2,80,-78
LUX,Luxembourg,CZE,Czech Republic,2017,1,94,-93
LUX,Luxembourg,DNK,Denmark,2008,4,130,-126
LUX,Luxembourg,DNK,Denmark,2009,6,124,-118
LUX,Luxembourg,DNK,Denmark,2010,7,98,-91
LUX,Luxembourg,DNK,Denmark,2011,1,104,-103
LUX,Luxembourg,DNK,Denmark,2012,4,122,-118
LUX,Luxembourg,DNK,Denmark,2013,5,140,-135
LUX,Luxembourg,DNK,Denmark,2014,10,97,-87
LUX,Luxembourg,DNK,Denmark,2015,9,92,-83
LUX,Luxembourg,DNK,Denmark,2016,13,93,-80
LUX,Luxembourg,DNK,Denmark,2017,15,104,-89
LUX,Luxembourg,FIN,Finland,2008,1,86,-85
LUX,Luxembourg,FIN,Finland,2009,0,61,-61
LUX,Luxembourg,FIN,Finland,2010,1,82,-81
LUX,Luxembourg,FIN,Finland,2011,2,126,-124
LUX,Luxembourg,FIN,Finland,2012,1,61,-60
LUX,Luxembourg,FIN,Finland,2013,0,75,-75
LUX,Luxembourg,FIN,Finland,2014,0,99,-99
LUX,Luxembourg,FIN,Finland,2015,2,118,-116
LUX,Luxembourg,FIN,Finland,2016,2,111,-109
LUX,Luxembourg,FIN,Finland,2017,0,94,-94
LUX,Luxembourg,FRA,France,2008,0,3201,-3201
LUX,Luxembourg,FRA,France,2009,0,2730,-2730
LUX,Luxembourg,FRA,France,2010,0,2909,-2909
LUX,Luxembourg,FRA,France,2011,0,3227,-3227
LUX,Luxembourg,FRA,France,2012,0,3523,-3523
LUX,Luxembourg,FRA,France,2013,554,3501,-2947
LUX,Luxembourg,FRA,France,2014,663,3897,-3234
LUX,Luxembourg,FRA,France,2015,916,4119,-3203
LUX,Luxembourg,FRA,France,2016,1195,3962,-2767
LUX,Luxembourg,FRA,France,2017,387,4183,-3796
LUX,Luxembourg,DEU,Germany,2008,2231,1130,1101
LUX,Luxembourg,DEU,Germany,2009,1985,1008,977
LUX,Luxembourg,DEU,Germany,2010,1903,1008,895
LUX,Luxembourg,DEU,Germany,2011,1963,1110,853
LUX,Luxembourg,DEU,Germany,2012,2003,1006,997
LUX,Luxembourg,DEU,Germany,2013,2253,1037,1216
LUX,Luxembourg,DEU,Germany,2014,2390,1023,1367
LUX,Luxembourg,DEU,Germany,2015,2680,1020,1660
LUX,Luxembourg,DEU,Germany,2016,2799,945,1854
LUX,Luxembourg,DEU,Germany,2017,2574,1026,1548
LUX,Luxembourg,HUN,Hungary,2008,5,126,-121
LUX,Luxembourg,HUN,Hungary,2009,4,118,-114
LUX,Luxembourg,HUN,Hungary,2010,1,138,-137
LUX,Luxembourg,HUN,Hungary,2011,2,177,-175
LUX,Luxembourg,HUN,Hungary,2012,8,155,-147
LUX,Luxembourg,HUN,Hungary,2013,3,228,-225
LUX,Luxembourg,HUN,Hungary,2014,2,226,-224
LUX,Luxembourg,HUN,Hungary,2015,7,189,-182
LUX,Luxembourg,HUN,Hungary,2016,10,193,-183
LUX,Luxembourg,HUN,Hungary,2017,4,258,-254
LUX,Luxembourg,ISL,Iceland,2008,1,27,-26
LUX,Luxembourg,ISL,Iceland,2009,1,37,-36
LUX,Luxembourg,ISL,Iceland,2010,1,49,-48
LUX,Luxembourg,ISL,Iceland,2011,1,22,-21
LUX,Luxembourg,ISL,Iceland,2012,0,31,-31
LUX,Luxembourg,ISL,Iceland,2013,2,25,-23
LUX,Luxembourg,ISL,Iceland,2014,0,14,-14
LUX,Luxembourg,ISL,Iceland,2015,1,22,-21
LUX,Luxembourg,ISL,Iceland,2016,1,29,-28
LUX,Luxembourg,ISL,Iceland,2017,2,13,-11
LUX,Luxembourg,ITA,Italy,2008,27,813,-786
LUX,Luxembourg,ITA,Italy,2009,18,659,-641
LUX,Luxembourg,ITA,Italy,2010,18,751,-733
LUX,Luxembourg,ITA,Italy,2011,16,958,-942
LUX,Luxembourg,ITA,Italy,2012,17,1137,-1120
LUX,Luxembourg,ITA,Italy,2013,18,1251,-1233
LUX,Luxembourg,ITA,Italy,2014,12,1649,-1637
LUX,Luxembourg,ITA,Italy,2015,15,1645,-1630
LUX,Luxembourg,ITA,Italy,2016,8,1800,-1792
LUX,Luxembourg,ITA,Italy,2017,12,1834,-1822
LUX,Luxembourg,JPN,Japan,2008,45,95,-50
LUX,Luxembourg,JPN,Japan,2009,33,67,-34
LUX,Luxembourg,JPN,Japan,2010,37,78,-41
LUX,Luxembourg,JPN,Japan,2011,36,93,-57
LUX,Luxembourg,JPN,Japan,2012,38,85,-47
LUX,Luxembourg,JPN,Japan,2013,35,109,-74
LUX,Luxembourg,JPN,Japan,2014,60,121,-61
LUX,Luxembourg,JPN,Japan,2015,40,134,-94
LUX,Luxembourg,JPN,Japan,2016,38,115,-77
LUX,Luxembourg,JPN,Japan,2017,104,104,0
LUX,Luxembourg,KOR,Korea,2008,3,17,-14
LUX,Luxembourg,KOR,Korea,2009,2,16,-14
LUX,Luxembourg,KOR,Korea,2010,1,18,-17
LUX,Luxembourg,KOR,Korea,2011,1,29,-28
LUX,Luxembourg,KOR,Korea,2012,2,24,-22
LUX,Luxembourg,KOR,Korea,2013,1,60,-59
LUX,Luxembourg,KOR,Korea,2014,1,79,-78
LUX,Luxembourg,KOR,Korea,2015,7,38,-31
LUX,Luxembourg,KOR,Korea,2016,5,26,-21
LUX,Luxembourg,KOR,Korea,2017,4,24,-20
LUX,Luxembourg,LUX,Luxembourg,2014,0,0,0
LUX,Luxembourg,LUX,Luxembourg,2017,0,0,0
LUX,Luxembourg,MEX,Mexico,2012,2,19,-17
LUX,Luxembourg,MEX,Mexico,2013,3,25,-22
LUX,Luxembourg,MEX,Mexico,2014,0,24,-24
LUX,Luxembourg,MEX,Mexico,2015,1,42,-41
LUX,Luxembourg,NLD,Netherlands,2008,44,291,-247
LUX,Luxembourg,NLD,Netherlands,2009,31,204,-173
LUX,Luxembourg,NLD,Netherlands,2010,43,207,-164
LUX,Luxembourg,NLD,Netherlands,2011,55,229,-174
LUX,Luxembourg,NLD,Netherlands,2012,56,213,-157
LUX,Luxembourg,NLD,Netherlands,2013,61,252,-191
LUX,Luxembourg,NLD,Netherlands,2014,87,262,-175
LUX,Luxembourg,NLD,Netherlands,2015,117,232,-115
LUX,Luxembourg,NLD,Netherlands,2016,164,235,-71
LUX,Luxembourg,NLD,Netherlands,2017,228,286,-58
LUX,Luxembourg,NZL,New Zealand,2008,2,8,-6
LUX,Luxembourg,NZL,New Zealand,2009,0,8,-8
LUX,Luxembourg,NZL,New Zealand,2010,4,24,-20
LUX,Luxembourg,NZL,New Zealand,2011,2,2,0
LUX,Luxembourg,NZL,New Zealand,2012,2,1,1
LUX,Luxembourg,NZL,New Zealand,2013,2,7,-5
LUX,Luxembourg,NZL,New Zealand,2015,3,11,-8
LUX,Luxembourg,NZL,New Zealand,2016,2,5,-3
LUX,Luxembourg,NZL,New Zealand,2017,11,12,-1
LUX,Luxembourg,NOR,Norway,2008,4,28,-24
LUX,Luxembourg,NOR,Norway,2009,6,10,-4
LUX,Luxembourg,NOR,Norway,2010,5,31,-26
LUX,Luxembourg,NOR,Norway,2011,6,27,-21
LUX,Luxembourg,NOR,Norway,2012,2,32,-30
LUX,Luxembourg,NOR,Norway,2013,4,21,-17
LUX,Luxembourg,NOR,Norway,2014,1,27,-26
LUX,Luxembourg,NOR,Norway,2015,4,25,-21
LUX,Luxembourg,NOR,Norway,2016,7,15,-8
LUX,Luxembourg,NOR,Norway,2017,4,20,-16
LUX,Luxembourg,POL,Poland,2008,4,489,-485
LUX,Luxembourg,POL,Poland,2009,3,365,-362
LUX,Luxembourg,POL,Poland,2010,0,361,-361
LUX,Luxembourg,POL,Poland,2011,4,417,-413
LUX,Luxembourg,POL,Poland,2012,1,400,-399
LUX,Luxembourg,POL,Poland,2013,4,362,-358
LUX,Luxembourg,POL,Poland,2014,6,504,-498
LUX,Luxembourg,POL,Poland,2015,9,514,-505
LUX,Luxembourg,POL,Poland,2016,22,427,-405
LUX,Luxembourg,POL,Poland,2017,3,443,-440
LUX,Luxembourg,SVK,Slovak Republic,2008,2,82,-80
LUX,Luxembourg,SVK,Slovak Republic,2009,3,64,-61
LUX,Luxembourg,SVK,Slovak Republic,2010,1,79,-78
LUX,Luxembourg,SVK,Slovak Republic,2011,1,62,-61
LUX,Luxembourg,SVK,Slovak Republic,2017,4,69,-65
LUX,Luxembourg,ESP,Spain,2008,52,248,-196
LUX,Luxembourg,ESP,Spain,2009,44,236,-192
LUX,Luxembourg,ESP,Spain,2010,48,308,-260
LUX,Luxembourg,ESP,Spain,2011,41,455,-414
LUX,Luxembourg,ESP,Spain,2012,49,494,-445
LUX,Luxembourg,ESP,Spain,2013,43,563,-520
LUX,Luxembourg,ESP,Spain,2014,48,579,-531
LUX,Luxembourg,ESP,Spain,2015,52,689,-637
LUX,Luxembourg,ESP,Spain,2016,57,771,-714
LUX,Luxembourg,ESP,Spain,2017,72,795,-723
LUX,Luxembourg,SWE,Sweden,2008,6,186,-180
LUX,Luxembourg,SWE,Sweden,2009,9,111,-102
LUX,Luxembourg,SWE,Sweden,2010,4,131,-127
LUX,Luxembourg,SWE,Sweden,2011,10,97,-87
LUX,Luxembourg,SWE,Sweden,2012,9,126,-117
LUX,Luxembourg,SWE,Sweden,2013,5,139,-134
LUX,Luxembourg,SWE,Sweden,2014,4,164,-160
LUX,Luxembourg,SWE,Sweden,2015,3,150,-147
LUX,Luxembourg,SWE,Sweden,2016,6,123,-117
LUX,Luxembourg,SWE,Sweden,2017,5,94,-89
LUX,Luxembourg,CHE,Switzerland,2008,186,48,138
LUX,Luxembourg,CHE,Switzerland,2009,147,41,106
LUX,Luxembourg,CHE,Switzerland,2010,209,40,169
LUX,Luxembourg,CHE,Switzerland,2011,188,68,120
LUX,Luxembourg,CHE,Switzerland,2012,169,47,122
LUX,Luxembourg,CHE,Switzerland,2013,182,58,124
LUX,Luxembourg,CHE,Switzerland,2014,170,53,117
LUX,Luxembourg,CHE,Switzerland,2015,179,47,132
LUX,Luxembourg,CHE,Switzerland,2016,177,46,131
LUX,Luxembourg,CHE,Switzerland,2017,150,65,85
LUX,Luxembourg,TUR,Turkey,2010,1,71,-70
LUX,Luxembourg,GBR,United Kingdom,2013,1000,467,533
LUX,Luxembourg,GBR,United Kingdom,2014,1000,502,498
LUX,Luxembourg,USA,United States,2008,28,332,-304
LUX,Luxembourg,USA,United States,2009,30,274,-244
LUX,Luxembourg,USA,United States,2010,22,335,-313
LUX,Luxembourg,USA,United States,2011,24,337,-313
LUX,Luxembourg,USA,United States,2012,19,431,-412
LUX,Luxembourg,USA,United States,2013,40,488,-448
LUX,Luxembourg,USA,United States,2014,26,682,-656
LUX,Luxembourg,USA,United States,2015,27,549,-522
LUX,Luxembourg,USA,United States,2016,34,407,-373
LUX,Luxembourg,USA,United States,2017,33,505,-472
LUX,Luxembourg,CHL,Chile,2008,1,4,-3
LUX,Luxembourg,CHL,Chile,2009,1,1,0
LUX,Luxembourg,CHL,Chile,2010,0,12,-12
LUX,Luxembourg,CHL,Chile,2011,0,3,-3
LUX,Luxembourg,CHL,Chile,2012,0,4,-4
LUX,Luxembourg,CHL,Chile,2013,0,6,-6
LUX,Luxembourg,CHL,Chile,2014,2,7,-5
LUX,Luxembourg,CHL,Chile,2015,3,10,-7
LUX,Luxembourg,CHL,Chile,2016,0,11,-11
LUX,Luxembourg,EST,Estonia,2008,0,71,-71
LUX,Luxembourg,EST,Estonia,2009,1,34,-33
LUX,Luxembourg,EST,Estonia,2010,0,60,-60
LUX,Luxembourg,EST,Estonia,2011,0,55,-55
LUX,Luxembourg,EST,Estonia,2012,0,59,-59
LUX,Luxembourg,EST,Estonia,2013,0,53,-53
LUX,Luxembourg,EST,Estonia,2014,0,45,-45
LUX,Luxembourg,EST,Estonia,2015,1,43,-42
LUX,Luxembourg,EST,Estonia,2016,0,41,-41
LUX,Luxembourg,EST,Estonia,2017,1,52,-51
LUX,Luxembourg,SVN,Slovenia,2008,4,49,-45
LUX,Luxembourg,SVN,Slovenia,2009,1,52,-51
LUX,Luxembourg,SVN,Slovenia,2014,1,63,-62
LUX,Luxembourg,SVN,Slovenia,2015,2,60,-58
LUX,Luxembourg,SVN,Slovenia,2017,3,59,-56
MAC,Macau,AUS,Australia,2008,41,21,20
MAC,Macau,AUS,Australia,2009,46,14,32
MAC,Macau,AUS,Australia,2010,23,23,0
MAC,Macau,AUS,Australia,2011,25,21,4
MAC,Macau,AUS,Australia,2012,21,27,-6
MAC,Macau,AUS,Australia,2013,44,27,17
MAC,Macau,AUS,Australia,2014,63,18,45
MAC,Macau,AUS,Australia,2015,58,0,58
MAC,Macau,AUS,Australia,2016,69,0,69
MAC,Macau,AUS,Australia,2017,61,0,61
MAC,Macau,AUT,Austria,2014,0,0,0
MAC,Macau,AUT,Austria,2015,0,0,0
MAC,Macau,AUT,Austria,2016,0,0,0
MAC,Macau,AUT,Austria,2017,0,0,0
MAC,Macau,BEL,Belgium,2010,0,0,0
MAC,Macau,CAN,Canada,2008,12,0,12
MAC,Macau,CAN,Canada,2009,21,0,21
MAC,Macau,CAN,Canada,2010,21,0,21
MAC,Macau,CAN,Canada,2011,13,0,13
MAC,Macau,CAN,Canada,2012,33,0,33
MAC,Macau,CAN,Canada,2013,29,0,29
MAC,Macau,CAN,Canada,2014,37,0,37
MAC,Macau,CAN,Canada,2015,21,0,21
MAC,Macau,CAN,Canada,2016,25,0,25
MAC,Macau,CAN,Canada,2017,30,0,30
MAC,Macau,DNK,Denmark,2015,0,0,0
MAC,Macau,DNK,Denmark,2016,0,0,0
MAC,Macau,FIN,Finland,2008,0,0,0
MAC,Macau,FIN,Finland,2009,0,0,0
MAC,Macau,FIN,Finland,2010,0,0,0
MAC,Macau,FIN,Finland,2011,0,0,0
MAC,Macau,FIN,Finland,2012,0,0,0
MAC,Macau,FIN,Finland,2013,0,0,0
MAC,Macau,FIN,Finland,2014,0,0,0
MAC,Macau,FIN,Finland,2015,0,0,0
MAC,Macau,FIN,Finland,2016,0,0,0
MAC,Macau,FIN,Finland,2017,0,0,0
MAC,Macau,FRA,France,2008,0,0,0
MAC,Macau,FRA,France,2009,0,0,0
MAC,Macau,FRA,France,2010,0,0,0
MAC,Macau,FRA,France,2011,0,0,0
MAC,Macau,FRA,France,2012,0,0,0
MAC,Macau,FRA,France,2013,0,0,0
MAC,Macau,FRA,France,2014,0,0,0
MAC,Macau,FRA,France,2015,0,0,0
MAC,Macau,FRA,France,2016,0,0,0
MAC,Macau,FRA,France,2017,0,0,0
MAC,Macau,HUN,Hungary,2008,0,0,0
MAC,Macau,HUN,Hungary,2009,0,0,0
MAC,Macau,HUN,Hungary,2010,0,0,0
MAC,Macau,HUN,Hungary,2011,0,0,0
MAC,Macau,HUN,Hungary,2012,0,0,0
MAC,Macau,HUN,Hungary,2013,0,0,0
MAC,Macau,HUN,Hungary,2014,0,0,0
MAC,Macau,HUN,Hungary,2015,0,0,0
MAC,Macau,HUN,Hungary,2016,0,0,0
MAC,Macau,HUN,Hungary,2017,0,0,0
MAC,Macau,ISL,Iceland,2016,0,0,0
MAC,Macau,ISL,Iceland,2017,0,0,0
MAC,Macau,JPN,Japan,2008,0,0,0
MAC,Macau,JPN,Japan,2009,0,0,0
MAC,Macau,JPN,Japan,2010,0,0,0
MAC,Macau,JPN,Japan,2011,0,0,0
MAC,Macau,JPN,Japan,2012,0,0,0
MAC,Macau,JPN,Japan,2013,0,0,0
MAC,Macau,JPN,Japan,2014,0,0,0
MAC,Macau,JPN,Japan,2015,0,0,0
MAC,Macau,JPN,Japan,2016,0,0,0
MAC,Macau,JPN,Japan,2017,0,0,0
MAC,Macau,KOR,Korea,2008,12,12,0
MAC,Macau,KOR,Korea,2009,9,8,1
MAC,Macau,KOR,Korea,2010,8,4,4
MAC,Macau,KOR,Korea,2011,13,14,-1
MAC,Macau,KOR,Korea,2012,17,13,4
MAC,Macau,KOR,Korea,2013,26,19,7
MAC,Macau,KOR,Korea,2014,38,28,10
MAC,Macau,KOR,Korea,2015,32,49,-17
MAC,Macau,KOR,Korea,2016,40,46,-6
MAC,Macau,KOR,Korea,2017,49,50,-1
MAC,Macau,LUX,Luxembourg,2008,0,0,0
MAC,Macau,LUX,Luxembourg,2009,0,0,0
MAC,Macau,LUX,Luxembourg,2010,0,0,0
MAC,Macau,LUX,Luxembourg,2011,0,0,0
MAC,Macau,LUX,Luxembourg,2012,0,0,0
MAC,Macau,LUX,Luxembourg,2013,0,0,0
MAC,Macau,LUX,Luxembourg,2014,0,0,0
MAC,Macau,LUX,Luxembourg,2015,0,0,0
MAC,Macau,LUX,Luxembourg,2016,0,0,0
MAC,Macau,LUX,Luxembourg,2017,0,0,0
MAC,Macau,MEX,Mexico,2008,2,0,2
MAC,Macau,MEX,Mexico,2009,3,0,3
MAC,Macau,MEX,Mexico,2012,0,0,0
MAC,Macau,MEX,Mexico,2013,0,0,0
MAC,Macau,MEX,Mexico,2014,0,0,0
MAC,Macau,NZL,New Zealand,2008,6,1,5
MAC,Macau,NZL,New Zealand,2009,7,1,6
MAC,Macau,NZL,New Zealand,2010,11,0,11
MAC,Macau,NZL,New Zealand,2011,14,1,13
MAC,Macau,NZL,New Zealand,2012,18,2,16
MAC,Macau,NZL,New Zealand,2013,13,0,13
MAC,Macau,NZL,New Zealand,2014,21,1,20
MAC,Macau,NZL,New Zealand,2015,21,4,17
MAC,Macau,NZL,New Zealand,2016,42,3,39
MAC,Macau,NZL,New Zealand,2017,21,10,11
MAC,Macau,NOR,Norway,2008,0,0,0
MAC,Macau,NOR,Norway,2009,0,0,0
MAC,Macau,NOR,Norway,2010,0,23,-23
MAC,Macau,NOR,Norway,2011,0,0,0
MAC,Macau,NOR,Norway,2012,0,0,0
MAC,Macau,NOR,Norway,2013,0,0,0
MAC,Macau,NOR,Norway,2014,0,0,0
MAC,Macau,NOR,Norway,2015,0,0,0
MAC,Macau,NOR,Norway,2016,0,0,0
MAC,Macau,NOR,Norway,2017,0,0,0
MAC,Macau,POL,Poland,2009,0,0,0
MAC,Macau,POL,Poland,2010,0,0,0
MAC,Macau,POL,Poland,2011,0,0,0
MAC,Macau,POL,Poland,2012,0,0,0
MAC,Macau,POL,Poland,2013,0,0,0
MAC,Macau,POL,Poland,2014,0,0,0
MAC,Macau,POL,Poland,2015,0,0,0
MAC,Macau,POL,Poland,2016,1,0,1
MAC,Macau,POL,Poland,2017,2,0,2
MAC,Macau,SWE,Sweden,2010,0,0,0
MAC,Macau,SWE,Sweden,2011,0,0,0
MAC,Macau,SWE,Sweden,2012,0,0,0
MAC,Macau,SWE,Sweden,2013,0,0,0
MAC,Macau,SWE,Sweden,2014,0,0,0
MAC,Macau,SWE,Sweden,2015,0,0,0
MAC,Macau,CHE,Switzerland,2014,9,11,-2
MAC,Macau,CHE,Switzerland,2015,0,0,0
MAC,Macau,CHE,Switzerland,2017,0,0,0
MAC,Macau,USA,United States,2008,205,0,205
MAC,Macau,USA,United States,2009,158,0,158
MAC,Macau,USA,United States,2010,143,0,143
MAC,Macau,USA,United States,2011,130,0,130
MAC,Macau,USA,United States,2012,120,0,120
MAC,Macau,USA,United States,2013,106,0,106
MAC,Macau,USA,United States,2014,105,0,105
MAC,Macau,USA,United States,2015,99,0,99
MAC,Macau,USA,United States,2016,109,0,109
MAC,Macau,USA,United States,2017,109,0,109
MAC,Macau,CHL,Chile,2008,0,0,0
MAC,Macau,CHL,Chile,2009,0,0,0
MAC,Macau,CHL,Chile,2010,0,0,0
MAC,Macau,CHL,Chile,2011,0,0,0
MAC,Macau,CHL,Chile,2012,0,0,0
MAC,Macau,CHL,Chile,2013,0,0,0
MAC,Macau,CHL,Chile,2014,1,0,1
MAC,Macau,CHL,Chile,2015,0,0,0
MAC,Macau,CHL,Chile,2016,3,0,3
MAC,Macau,EST,Estonia,2017,0,0,0
MKD,North Macedonia,AUS,Australia,2008,394,285,109
MKD,North Macedonia,AUS,Australia,2009,360,247,113
MKD,North Macedonia,AUS,Australia,2010,313,206,107
MKD,North Macedonia,AUS,Australia,2011,269,253,16
MKD,North Macedonia,AUS,Australia,2012,213,236,-23
MKD,North Macedonia,AUS,Australia,2013,298,312,-14
MKD,North Macedonia,AUS,Australia,2014,298,292,6
MKD,North Macedonia,AUS,Australia,2015,221,300,-79
MKD,North Macedonia,AUS,Australia,2016,266,200,66
MKD,North Macedonia,AUS,Australia,2017,269,0,269
MKD,North Macedonia,AUT,Austria,2008,1035,530,505
MKD,North Macedonia,AUT,Austria,2009,925,632,293
MKD,North Macedonia,AUT,Austria,2010,1432,918,514
MKD,North Macedonia,AUT,Austria,2011,1131,900,231
MKD,North Macedonia,AUT,Austria,2012,1300,811,489
MKD,North Macedonia,AUT,Austria,2013,1457,765,692
MKD,North Macedonia,AUT,Austria,2014,1459,746,713
MKD,North Macedonia,AUT,Austria,2015,1658,829,829
MKD,North Macedonia,AUT,Austria,2016,1509,819,690
MKD,North Macedonia,AUT,Austria,2017,1551,805,746
MKD,North Macedonia,BEL,Belgium,2008,305,0,305
MKD,North Macedonia,BEL,Belgium,2009,364,0,364
MKD,North Macedonia,BEL,Belgium,2010,551,72,479
MKD,North Macedonia,BEL,Belgium,2011,416,0,416
MKD,North Macedonia,BEL,Belgium,2012,733,707,26
MKD,North Macedonia,BEL,Belgium,2013,411,679,-268
MKD,North Macedonia,BEL,Belgium,2014,407,632,-225
MKD,North Macedonia,BEL,Belgium,2015,398,469,-71
MKD,North Macedonia,BEL,Belgium,2016,319,175,144
MKD,North Macedonia,BEL,Belgium,2017,384,160,224
MKD,North Macedonia,CAN,Canada,2008,191,0,191
MKD,North Macedonia,CAN,Canada,2009,198,0,198
MKD,North Macedonia,CAN,Canada,2010,188,0,188
MKD,North Macedonia,CAN,Canada,2011,130,0,130
MKD,North Macedonia,CAN,Canada,2012,126,0,126
MKD,North Macedonia,CAN,Canada,2013,112,0,112
MKD,North Macedonia,CAN,Canada,2014,117,0,117
MKD,North Macedonia,CAN,Canada,2015,221,0,221
MKD,North Macedonia,CAN,Canada,2016,135,0,135
MKD,North Macedonia,CAN,Canada,2017,90,0,90
MKD,North Macedonia,CZE,Czech Republic,2008,579,2,577
MKD,North Macedonia,CZE,Czech Republic,2009,247,2,245
MKD,North Macedonia,CZE,Czech Republic,2010,124,3,121
MKD,North Macedonia,CZE,Czech Republic,2011,74,0,74
MKD,North Macedonia,CZE,Czech Republic,2012,126,70,56
MKD,North Macedonia,CZE,Czech Republic,2013,78,113,-35
MKD,North Macedonia,CZE,Czech Republic,2014,153,66,87
MKD,North Macedonia,CZE,Czech Republic,2015,124,69,55
MKD,North Macedonia,CZE,Czech Republic,2016,162,72,90
MKD,North Macedonia,CZE,Czech Republic,2017,212,118,94
MKD,North Macedonia,DNK,Denmark,2008,70,11,59
MKD,North Macedonia,DNK,Denmark,2009,81,15,66
MKD,North Macedonia,DNK,Denmark,2010,70,17,53
MKD,North Macedonia,DNK,Denmark,2011,66,15,51
MKD,North Macedonia,DNK,Denmark,2012,54,10,44
MKD,North Macedonia,DNK,Denmark,2013,100,24,76
MKD,North Macedonia,DNK,Denmark,2014,85,15,70
MKD,North Macedonia,DNK,Denmark,2015,0,12,-12
MKD,North Macedonia,DNK,Denmark,2016,115,11,104
MKD,North Macedonia,DNK,Denmark,2017,130,29,101
MKD,North Macedonia,FIN,Finland,2008,37,0,37
MKD,North Macedonia,FIN,Finland,2009,20,2,18
MKD,North Macedonia,FIN,Finland,2010,14,0,14
MKD,North Macedonia,FIN,Finland,2011,21,3,18
MKD,North Macedonia,FIN,Finland,2012,15,2,13
MKD,North Macedonia,FIN,Finland,2013,33,3,30
MKD,North Macedonia,FIN,Finland,2014,19,2,17
MKD,North Macedonia,FIN,Finland,2015,14,4,10
MKD,North Macedonia,FIN,Finland,2016,20,3,17
MKD,North Macedonia,FIN,Finland,2017,17,0,17
MKD,North Macedonia,FRA,France,2008,172,0,172
MKD,North Macedonia,FRA,France,2009,186,0,186
MKD,North Macedonia,FRA,France,2010,158,0,158
MKD,North Macedonia,FRA,France,2011,158,0,158
MKD,North Macedonia,FRA,France,2012,193,0,193
MKD,North Macedonia,FRA,France,2013,212,0,212
MKD,North Macedonia,FRA,France,2014,213,0,213
MKD,North Macedonia,FRA,France,2015,200,0,200
MKD,North Macedonia,FRA,France,2016,211,0,211
MKD,North Macedonia,FRA,France,2017,260,0,260
MKD,North Macedonia,DEU,Germany,2008,2308,2225,83
MKD,North Macedonia,DEU,Germany,2009,2399,2063,336
MKD,North Macedonia,DEU,Germany,2010,7585,3900,3685
MKD,North Macedonia,DEU,Germany,2011,5679,5184,495
MKD,North Macedonia,DEU,Germany,2012,11331,5980,5351
MKD,North Macedonia,DEU,Germany,2013,14387,8656,5731
MKD,North Macedonia,DEU,Germany,2014,15634,9521,6113
MKD,North Macedonia,DEU,Germany,2015,24776,12344,12432
MKD,North Macedonia,DEU,Germany,2016,14342,17468,-3126
MKD,North Macedonia,DEU,Germany,2017,18235,12222,6013
MKD,North Macedonia,HUN,Hungary,2008,47,1,46
MKD,North Macedonia,HUN,Hungary,2009,37,3,34
MKD,North Macedonia,HUN,Hungary,2010,49,9,40
MKD,North Macedonia,HUN,Hungary,2011,32,9,23
MKD,North Macedonia,HUN,Hungary,2012,39,5,34
MKD,North Macedonia,HUN,Hungary,2013,50,8,42
MKD,North Macedonia,HUN,Hungary,2014,68,5,63
MKD,North Macedonia,HUN,Hungary,2015,111,15,96
MKD,North Macedonia,HUN,Hungary,2016,93,22,71
MKD,North Macedonia,HUN,Hungary,2017,132,0,132
MKD,North Macedonia,ISL,Iceland,2008,8,2,6
MKD,North Macedonia,ISL,Iceland,2009,5,5,0
MKD,North Macedonia,ISL,Iceland,2010,1,2,-1
MKD,North Macedonia,ISL,Iceland,2011,0,1,-1
MKD,North Macedonia,ISL,Iceland,2012,3,0,3
MKD,North Macedonia,ISL,Iceland,2013,9,1,8
MKD,North Macedonia,ISL,Iceland,2014,6,5,1
MKD,North Macedonia,ISL,Iceland,2015,4,0,4
MKD,North Macedonia,ISL,Iceland,2016,7,2,5
MKD,North Macedonia,ISL,Iceland,2017,6,0,6
MKD,North Macedonia,ITA,Italy,2017,1835,541,1294
MKD,North Macedonia,JPN,Japan,2008,59,55,4
MKD,North Macedonia,JPN,Japan,2009,43,40,3
MKD,North Macedonia,JPN,Japan,2010,40,37,3
MKD,North Macedonia,JPN,Japan,2011,68,67,1
MKD,North Macedonia,JPN,Japan,2012,48,47,1
MKD,North Macedonia,JPN,Japan,2013,86,82,4
MKD,North Macedonia,JPN,Japan,2014,28,31,-3
MKD,North Macedonia,JPN,Japan,2015,40,41,-1
MKD,North Macedonia,JPN,Japan,2016,31,22,9
MKD,North Macedonia,JPN,Japan,2017,23,22,1
MKD,North Macedonia,KOR,Korea,2008,0,0,0
MKD,North Macedonia,KOR,Korea,2009,5,4,1
MKD,North Macedonia,KOR,Korea,2010,6,8,-2
MKD,North Macedonia,KOR,Korea,2011,5,6,-1
MKD,North Macedonia,KOR,Korea,2012,8,5,3
MKD,North Macedonia,KOR,Korea,2013,2,5,-3
MKD,North Macedonia,KOR,Korea,2014,6,3,3
MKD,North Macedonia,KOR,Korea,2015,5,5,0
MKD,North Macedonia,KOR,Korea,2016,7,10,-3
MKD,North Macedonia,KOR,Korea,2017,7,6,1
MKD,North Macedonia,LUX,Luxembourg,2008,26,19,7
MKD,North Macedonia,LUX,Luxembourg,2009,15,4,11
MKD,North Macedonia,LUX,Luxembourg,2010,25,0,25
MKD,North Macedonia,LUX,Luxembourg,2011,356,7,349
MKD,North Macedonia,LUX,Luxembourg,2012,82,228,-146
MKD,North Macedonia,LUX,Luxembourg,2013,42,52,-10
MKD,North Macedonia,LUX,Luxembourg,2014,42,37,5
MKD,North Macedonia,LUX,Luxembourg,2015,44,52,-8
MKD,North Macedonia,LUX,Luxembourg,2016,69,20,49
MKD,North Macedonia,LUX,Luxembourg,2017,39,34,5
MKD,North Macedonia,MEX,Mexico,2008,1,0,1
MKD,North Macedonia,MEX,Mexico,2009,2,0,2
MKD,North Macedonia,MEX,Mexico,2010,2,0,2
MKD,North Macedonia,MEX,Mexico,2012,2,0,2
MKD,North Macedonia,MEX,Mexico,2013,7,0,7
MKD,North Macedonia,MEX,Mexico,2014,3,0,3
MKD,North Macedonia,MEX,Mexico,2015,3,0,3
MKD,North Macedonia,MEX,Mexico,2016,5,0,5
MKD,North Macedonia,MEX,Mexico,2017,1,0,1
MKD,North Macedonia,NLD,Netherlands,2009,115,54,61
MKD,North Macedonia,NLD,Netherlands,2010,86,63,23
MKD,North Macedonia,NLD,Netherlands,2011,128,38,90
MKD,North Macedonia,NLD,Netherlands,2012,112,71,41
MKD,North Macedonia,NLD,Netherlands,2013,122,66,56
MKD,North Macedonia,NLD,Netherlands,2014,147,71,76
MKD,North Macedonia,NLD,Netherlands,2015,146,63,83
MKD,North Macedonia,NLD,Netherlands,2016,182,39,143
MKD,North Macedonia,NLD,Netherlands,2017,167,71,96
MKD,North Macedonia,NZL,New Zealand,2008,27,3,24
MKD,North Macedonia,NZL,New Zealand,2009,17,6,11
MKD,North Macedonia,NZL,New Zealand,2010,6,6,0
MKD,North Macedonia,NZL,New Zealand,2011,8,4,4
MKD,North Macedonia,NZL,New Zealand,2012,23,7,16
MKD,North Macedonia,NZL,New Zealand,2013,18,7,11
MKD,North Macedonia,NZL,New Zealand,2014,17,0,17
MKD,North Macedonia,NZL,New Zealand,2015,12,1,11
MKD,North Macedonia,NZL,New Zealand,2016,20,2,18
MKD,North Macedonia,NZL,New Zealand,2017,33,4,29
MKD,North Macedonia,NOR,Norway,2008,67,10,57
MKD,North Macedonia,NOR,Norway,2009,62,17,45
MKD,North Macedonia,NOR,Norway,2010,72,6,66
MKD,North Macedonia,NOR,Norway,2011,82,27,55
MKD,North Macedonia,NOR,Norway,2012,76,24,52
MKD,North Macedonia,NOR,Norway,2013,75,22,53
MKD,North Macedonia,NOR,Norway,2014,61,18,43
MKD,North Macedonia,NOR,Norway,2015,95,19,76
MKD,North Macedonia,NOR,Norway,2016,108,24,84
MKD,North Macedonia,NOR,Norway,2017,88,19,69
MKD,North Macedonia,POL,Poland,2008,58,0,58
MKD,North Macedonia,POL,Poland,2009,41,0,41
MKD,North Macedonia,POL,Poland,2010,41,0,41
MKD,North Macedonia,POL,Poland,2011,33,0,33
MKD,North Macedonia,POL,Poland,2012,40,0,40
MKD,North Macedonia,POL,Poland,2013,40,0,40
MKD,North Macedonia,POL,Poland,2014,22,0,22
MKD,North Macedonia,POL,Poland,2015,0,0,0
MKD,North Macedonia,POL,Poland,2016,0,0,0
MKD,North Macedonia,POL,Poland,2017,0,0,0
MKD,North Macedonia,SVK,Slovak Republic,2008,20,15,5
MKD,North Macedonia,SVK,Slovak Republic,2009,16,23,-7
MKD,North Macedonia,SVK,Slovak Republic,2010,14,20,-6
MKD,North Macedonia,SVK,Slovak Republic,2011,14,11,3
MKD,North Macedonia,SVK,Slovak Republic,2012,10,0,10
MKD,North Macedonia,SVK,Slovak Republic,2013,16,1,15
MKD,North Macedonia,SVK,Slovak Republic,2014,18,1,17
MKD,North Macedonia,SVK,Slovak Republic,2015,18,0,18
MKD,North Macedonia,SVK,Slovak Republic,2016,9,0,9
MKD,North Macedonia,SVK,Slovak Republic,2017,17,0,17
MKD,North Macedonia,ESP,Spain,2008,0,0,0
MKD,North Macedonia,ESP,Spain,2009,0,0,0
MKD,North Macedonia,ESP,Spain,2010,0,0,0
MKD,North Macedonia,ESP,Spain,2011,0,0,0
MKD,North Macedonia,ESP,Spain,2012,0,0,0
MKD,North Macedonia,ESP,Spain,2013,0,0,0
MKD,North Macedonia,ESP,Spain,2014,0,0,0
MKD,North Macedonia,ESP,Spain,2015,0,0,0
MKD,North Macedonia,ESP,Spain,2016,0,0,0
MKD,North Macedonia,SWE,Sweden,2008,304,29,275
MKD,North Macedonia,SWE,Sweden,2009,255,30,225
MKD,North Macedonia,SWE,Sweden,2010,252,21,231
MKD,North Macedonia,SWE,Sweden,2011,305,49,256
MKD,North Macedonia,SWE,Sweden,2012,346,53,293
MKD,North Macedonia,SWE,Sweden,2013,267,44,223
MKD,North Macedonia,SWE,Sweden,2014,310,54,256
MKD,North Macedonia,SWE,Sweden,2015,348,56,292
MKD,North Macedonia,SWE,Sweden,2016,428,39,389
MKD,North Macedonia,SWE,Sweden,2017,511,29,482
MKD,North Macedonia,CHE,Switzerland,2010,1158,312,846
MKD,North Macedonia,CHE,Switzerland,2011,1243,321,922
MKD,North Macedonia,CHE,Switzerland,2012,1328,302,1026
MKD,North Macedonia,CHE,Switzerland,2013,1385,311,1074
MKD,North Macedonia,CHE,Switzerland,2014,1392,266,1126
MKD,North Macedonia,CHE,Switzerland,2015,1536,226,1310
MKD,North Macedonia,CHE,Switzerland,2016,1735,221,1514
MKD,North Macedonia,CHE,Switzerland,2017,1797,240,1557
MKD,North Macedonia,TUR,Turkey,2010,153,0,153
MKD,North Macedonia,USA,United States,2008,1107,0,1107
MKD,North Macedonia,USA,United States,2009,1128,0,1128
MKD,North Macedonia,USA,United States,2010,963,0,963
MKD,North Macedonia,USA,United States,2011,1078,0,1078
MKD,North Macedonia,USA,United States,2012,906,0,906
MKD,North Macedonia,USA,United States,2013,895,0,895
MKD,North Macedonia,USA,United States,2014,960,0,960
MKD,North Macedonia,USA,United States,2015,1060,0,1060
MKD,North Macedonia,USA,United States,2016,1262,0,1262
MKD,North Macedonia,USA,United States,2017,1027,0,1027
MKD,North Macedonia,CHL,Chile,2008,3,0,3
MKD,North Macedonia,CHL,Chile,2009,0,0,0
MKD,North Macedonia,CHL,Chile,2010,2,0,2
MKD,North Macedonia,CHL,Chile,2011,2,0,2
MKD,North Macedonia,CHL,Chile,2012,2,0,2
MKD,North Macedonia,CHL,Chile,2013,0,0,0
MKD,North Macedonia,CHL,Chile,2014,0,0,0
MKD,North Macedonia,CHL,Chile,2015,2,0,2
MKD,North Macedonia,CHL,Chile,2016,1,0,1
MKD,North Macedonia,EST,Estonia,2008,0,0,0
MKD,North Macedonia,EST,Estonia,2009,0,0,0
MKD,North Macedonia,EST,Estonia,2010,1,0,1
MKD,North Macedonia,EST,Estonia,2011,1,0,1
MKD,North Macedonia,EST,Estonia,2012,0,0,0
MKD,North Macedonia,EST,Estonia,2013,1,0,1
MKD,North Macedonia,EST,Estonia,2014,1,0,1
MKD,North Macedonia,EST,Estonia,2015,1,0,1
MKD,North Macedonia,EST,Estonia,2016,4,0,4
MKD,North Macedonia,EST,Estonia,2017,6,0,6
MKD,North Macedonia,SVN,Slovenia,2008,4952,806,4146
MKD,North Macedonia,SVN,Slovenia,2009,2165,1720,445
MKD,North Macedonia,SVN,Slovenia,2010,1038,1359,-321
MKD,North Macedonia,SVN,Slovenia,2011,1220,152,1068
MKD,North Macedonia,SVN,Slovenia,2012,770,77,693
MKD,North Macedonia,SVN,Slovenia,2013,585,49,536
MKD,North Macedonia,SVN,Slovenia,2014,577,75,502
MKD,North Macedonia,SVN,Slovenia,2015,1000,106,894
MKD,North Macedonia,SVN,Slovenia,2016,870,128,742
MKD,North Macedonia,SVN,Slovenia,2017,1689,135,1554
MDG,Madagascar,AUS,Australia,2008,3,0,3
MDG,Madagascar,AUS,Australia,2009,0,0,0
MDG,Madagascar,AUS,Australia,2010,1,0,1
MDG,Madagascar,AUS,Australia,2011,7,0,7
MDG,Madagascar,AUS,Australia,2012,2,0,2
MDG,Madagascar,AUS,Australia,2013,1,0,1
MDG,Madagascar,AUS,Australia,2014,0,0,0
MDG,Madagascar,AUS,Australia,2015,0,0,0
MDG,Madagascar,AUS,Australia,2016,10,0,10
MDG,Madagascar,AUS,Australia,2017,3,0,3
MDG,Madagascar,AUT,Austria,2008,12,4,8
MDG,Madagascar,AUT,Austria,2009,10,8,2
MDG,Madagascar,AUT,Austria,2010,14,6,8
MDG,Madagascar,AUT,Austria,2011,20,13,7
MDG,Madagascar,AUT,Austria,2012,15,13,2
MDG,Madagascar,AUT,Austria,2013,18,9,9
MDG,Madagascar,AUT,Austria,2014,22,11,11
MDG,Madagascar,AUT,Austria,2015,13,12,1
MDG,Madagascar,AUT,Austria,2016,15,10,5
MDG,Madagascar,AUT,Austria,2017,13,12,1
MDG,Madagascar,BEL,Belgium,2008,112,0,112
MDG,Madagascar,BEL,Belgium,2009,100,0,100
MDG,Madagascar,BEL,Belgium,2010,107,26,81
MDG,Madagascar,BEL,Belgium,2011,94,0,94
MDG,Madagascar,BEL,Belgium,2012,97,40,57
MDG,Madagascar,BEL,Belgium,2013,81,41,40
MDG,Madagascar,BEL,Belgium,2014,78,39,39
MDG,Madagascar,BEL,Belgium,2015,87,29,58
MDG,Madagascar,BEL,Belgium,2016,96,15,81
MDG,Madagascar,BEL,Belgium,2017,98,25,73
MDG,Madagascar,CAN,Canada,2008,118,0,118
MDG,Madagascar,CAN,Canada,2009,169,0,169
MDG,Madagascar,CAN,Canada,2010,178,0,178
MDG,Madagascar,CAN,Canada,2011,148,0,148
MDG,Madagascar,CAN,Canada,2012,165,0,165
MDG,Madagascar,CAN,Canada,2013,229,0,229
MDG,Madagascar,CAN,Canada,2014,112,0,112
MDG,Madagascar,CAN,Canada,2015,115,0,115
MDG,Madagascar,CAN,Canada,2016,140,0,140
MDG,Madagascar,CAN,Canada,2017,120,0,120
MDG,Madagascar,CZE,Czech Republic,2008,4,0,4
MDG,Madagascar,CZE,Czech Republic,2009,3,0,3
MDG,Madagascar,CZE,Czech Republic,2010,1,0,1
MDG,Madagascar,CZE,Czech Republic,2014,2,2,0
MDG,Madagascar,DNK,Denmark,2008,4,1,3
MDG,Madagascar,DNK,Denmark,2009,3,0,3
MDG,Madagascar,DNK,Denmark,2010,1,1,0
MDG,Madagascar,DNK,Denmark,2012,1,0,1
MDG,Madagascar,DNK,Denmark,2013,0,3,-3
MDG,Madagascar,DNK,Denmark,2014,1,2,-1
MDG,Madagascar,DNK,Denmark,2015,0,0,0
MDG,Madagascar,DNK,Denmark,2016,4,3,1
MDG,Madagascar,DNK,Denmark,2017,2,2,0
MDG,Madagascar,FIN,Finland,2008,0,0,0
MDG,Madagascar,FIN,Finland,2009,3,0,3
MDG,Madagascar,FIN,Finland,2010,2,0,2
MDG,Madagascar,FIN,Finland,2011,3,0,3
MDG,Madagascar,FIN,Finland,2012,0,1,-1
MDG,Madagascar,FIN,Finland,2013,2,2,0
MDG,Madagascar,FIN,Finland,2014,1,0,1
MDG,Madagascar,FIN,Finland,2015,1,2,-1
MDG,Madagascar,FIN,Finland,2016,5,0,5
MDG,Madagascar,FIN,Finland,2017,3,0,3
MDG,Madagascar,FRA,France,2008,2096,0,2096
MDG,Madagascar,FRA,France,2009,2221,0,2221
MDG,Madagascar,FRA,France,2010,2322,0,2322
MDG,Madagascar,FRA,France,2011,2083,0,2083
MDG,Madagascar,FRA,France,2012,2123,0,2123
MDG,Madagascar,FRA,France,2013,2180,0,2180
MDG,Madagascar,FRA,France,2014,2416,0,2416
MDG,Madagascar,FRA,France,2015,1929,0,1929
MDG,Madagascar,FRA,France,2016,1889,0,1889
MDG,Madagascar,FRA,France,2017,1898,0,1898
MDG,Madagascar,DEU,Germany,2008,133,96,37
MDG,Madagascar,DEU,Germany,2009,133,96,37
MDG,Madagascar,DEU,Germany,2010,124,99,25
MDG,Madagascar,DEU,Germany,2011,190,76,114
MDG,Madagascar,DEU,Germany,2012,211,92,119
MDG,Madagascar,DEU,Germany,2013,208,94,114
MDG,Madagascar,DEU,Germany,2014,250,92,158
MDG,Madagascar,DEU,Germany,2015,371,116,255
MDG,Madagascar,DEU,Germany,2016,482,125,357
MDG,Madagascar,DEU,Germany,2017,583,143,440
MDG,Madagascar,HUN,Hungary,2008,3,0,3
MDG,Madagascar,HUN,Hungary,2009,1,0,1
MDG,Madagascar,HUN,Hungary,2010,0,0,0
MDG,Madagascar,HUN,Hungary,2011,4,0,4
MDG,Madagascar,HUN,Hungary,2012,1,0,1
MDG,Madagascar,HUN,Hungary,2013,0,0,0
MDG,Madagascar,HUN,Hungary,2014,2,0,2
MDG,Madagascar,HUN,Hungary,2015,2,0,2
MDG,Madagascar,HUN,Hungary,2016,3,0,3
MDG,Madagascar,HUN,Hungary,2017,1,0,1
MDG,Madagascar,ISL,Iceland,2008,0,0,0
MDG,Madagascar,ISL,Iceland,2009,1,0,1
MDG,Madagascar,ISL,Iceland,2010,0,1,-1
MDG,Madagascar,ISL,Iceland,2011,0,0,0
MDG,Madagascar,ISL,Iceland,2012,0,0,0
MDG,Madagascar,ISL,Iceland,2013,0,0,0
MDG,Madagascar,ISL,Iceland,2014,0,0,0
MDG,Madagascar,ISL,Iceland,2015,0,0,0
MDG,Madagascar,ISL,Iceland,2016,0,0,0
MDG,Madagascar,ISL,Iceland,2017,0,0,0
MDG,Madagascar,ITA,Italy,2008,105,22,83
MDG,Madagascar,ITA,Italy,2009,142,19,123
MDG,Madagascar,ITA,Italy,2010,167,17,150
MDG,Madagascar,ITA,Italy,2011,126,10,116
MDG,Madagascar,ITA,Italy,2012,117,10,107
MDG,Madagascar,ITA,Italy,2013,114,10,104
MDG,Madagascar,ITA,Italy,2014,99,9,90
MDG,Madagascar,ITA,Italy,2015,129,13,116
MDG,Madagascar,ITA,Italy,2016,107,0,107
MDG,Madagascar,ITA,Italy,2017,110,24,86
MDG,Madagascar,JPN,Japan,2008,166,146,20
MDG,Madagascar,JPN,Japan,2009,69,61,8
MDG,Madagascar,JPN,Japan,2010,31,26,5
MDG,Madagascar,JPN,Japan,2011,20,20,0
MDG,Madagascar,JPN,Japan,2012,37,17,20
MDG,Madagascar,JPN,Japan,2013,39,35,4
MDG,Madagascar,JPN,Japan,2014,36,29,7
MDG,Madagascar,JPN,Japan,2015,49,45,4
MDG,Madagascar,JPN,Japan,2016,89,71,18
MDG,Madagascar,JPN,Japan,2017,147,124,23
MDG,Madagascar,KOR,Korea,2008,0,1,-1
MDG,Madagascar,KOR,Korea,2009,1,1,0
MDG,Madagascar,KOR,Korea,2010,3,0,3
MDG,Madagascar,KOR,Korea,2011,6,1,5
MDG,Madagascar,KOR,Korea,2012,3,5,-2
MDG,Madagascar,KOR,Korea,2013,6,4,2
MDG,Madagascar,KOR,Korea,2014,12,7,5
MDG,Madagascar,KOR,Korea,2015,10,5,5
MDG,Madagascar,KOR,Korea,2016,15,9,6
MDG,Madagascar,KOR,Korea,2017,8,9,-1
MDG,Madagascar,LUX,Luxembourg,2008,7,2,5
MDG,Madagascar,LUX,Luxembourg,2009,7,0,7
MDG,Madagascar,LUX,Luxembourg,2010,6,1,5
MDG,Madagascar,LUX,Luxembourg,2011,2,1,1
MDG,Madagascar,LUX,Luxembourg,2012,2,2,0
MDG,Madagascar,LUX,Luxembourg,2013,3,1,2
MDG,Madagascar,LUX,Luxembourg,2014,11,3,8
MDG,Madagascar,LUX,Luxembourg,2015,8,3,5
MDG,Madagascar,LUX,Luxembourg,2016,7,1,6
MDG,Madagascar,LUX,Luxembourg,2017,9,1,8
MDG,Madagascar,MEX,Mexico,2008,1,0,1
MDG,Madagascar,MEX,Mexico,2012,0,0,0
MDG,Madagascar,MEX,Mexico,2013,1,0,1
MDG,Madagascar,MEX,Mexico,2014,0,0,0
MDG,Madagascar,NLD,Netherlands,2008,1,2,-1
MDG,Madagascar,NLD,Netherlands,2009,1,0,1
MDG,Madagascar,NLD,Netherlands,2010,3,0,3
MDG,Madagascar,NLD,Netherlands,2011,9,3,6
MDG,Madagascar,NLD,Netherlands,2012,5,6,-1
MDG,Madagascar,NLD,Netherlands,2013,10,5,5
MDG,Madagascar,NLD,Netherlands,2014,12,3,9
MDG,Madagascar,NLD,Netherlands,2015,8,6,2
MDG,Madagascar,NLD,Netherlands,2016,12,4,8
MDG,Madagascar,NLD,Netherlands,2017,12,4,8
MDG,Madagascar,NZL,New Zealand,2010,1,0,1
MDG,Madagascar,NZL,New Zealand,2012,2,0,2
MDG,Madagascar,NZL,New Zealand,2013,1,0,1
MDG,Madagascar,NZL,New Zealand,2015,1,1,0
MDG,Madagascar,NZL,New Zealand,2017,2,0,2
MDG,Madagascar,NOR,Norway,2008,12,12,0
MDG,Madagascar,NOR,Norway,2009,18,11,7
MDG,Madagascar,NOR,Norway,2010,21,0,21
MDG,Madagascar,NOR,Norway,2011,10,17,-7
MDG,Madagascar,NOR,Norway,2012,22,13,9
MDG,Madagascar,NOR,Norway,2013,18,12,6
MDG,Madagascar,NOR,Norway,2014,15,13,2
MDG,Madagascar,NOR,Norway,2015,10,10,0
MDG,Madagascar,NOR,Norway,2016,19,12,7
MDG,Madagascar,NOR,Norway,2017,13,13,0
MDG,Madagascar,POL,Poland,2009,9,0,9
MDG,Madagascar,POL,Poland,2010,2,0,2
MDG,Madagascar,POL,Poland,2011,5,0,5
MDG,Madagascar,POL,Poland,2012,7,0,7
MDG,Madagascar,POL,Poland,2013,6,0,6
MDG,Madagascar,POL,Poland,2014,2,0,2
MDG,Madagascar,POL,Poland,2015,4,0,4
MDG,Madagascar,POL,Poland,2016,4,0,4
MDG,Madagascar,POL,Poland,2017,8,0,8
MDG,Madagascar,SVK,Slovak Republic,2008,0,0,0
MDG,Madagascar,SVK,Slovak Republic,2011,1,0,1
MDG,Madagascar,SVK,Slovak Republic,2013,3,0,3
MDG,Madagascar,ESP,Spain,2008,18,8,10
MDG,Madagascar,ESP,Spain,2009,17,7,10
MDG,Madagascar,ESP,Spain,2010,14,7,7
MDG,Madagascar,ESP,Spain,2011,23,5,18
MDG,Madagascar,ESP,Spain,2012,29,2,27
MDG,Madagascar,ESP,Spain,2013,26,3,23
MDG,Madagascar,ESP,Spain,2014,25,4,21
MDG,Madagascar,ESP,Spain,2015,21,8,13
MDG,Madagascar,ESP,Spain,2016,37,3,34
MDG,Madagascar,ESP,Spain,2017,30,9,21
MDG,Madagascar,SWE,Sweden,2008,1,0,1
MDG,Madagascar,SWE,Sweden,2009,2,0,2
MDG,Madagascar,SWE,Sweden,2010,3,0,3
MDG,Madagascar,SWE,Sweden,2011,0,1,-1
MDG,Madagascar,SWE,Sweden,2012,4,0,4
MDG,Madagascar,SWE,Sweden,2013,4,1,3
MDG,Madagascar,SWE,Sweden,2014,2,0,2
MDG,Madagascar,SWE,Sweden,2015,3,0,3
MDG,Madagascar,SWE,Sweden,2016,5,0,5
MDG,Madagascar,SWE,Sweden,2017,0,5,-5
MDG,Madagascar,CHE,Switzerland,2010,69,23,46
MDG,Madagascar,CHE,Switzerland,2011,83,38,45
MDG,Madagascar,CHE,Switzerland,2012,64,30,34
MDG,Madagascar,CHE,Switzerland,2013,72,21,51
MDG,Madagascar,CHE,Switzerland,2014,56,30,26
MDG,Madagascar,CHE,Switzerland,2015,60,18,42
MDG,Madagascar,CHE,Switzerland,2016,59,19,40
MDG,Madagascar,CHE,Switzerland,2017,52,22,30
MDG,Madagascar,TUR,Turkey,2010,9,0,9
MDG,Madagascar,USA,United States,2008,77,0,77
MDG,Madagascar,USA,United States,2009,71,0,71
MDG,Madagascar,USA,United States,2010,80,0,80
MDG,Madagascar,USA,United States,2011,83,0,83
MDG,Madagascar,USA,United States,2012,79,0,79
MDG,Madagascar,USA,United States,2013,95,0,95
MDG,Madagascar,USA,United States,2014,86,0,86
MDG,Madagascar,USA,United States,2015,72,0,72
MDG,Madagascar,USA,United States,2016,88,0,88
MDG,Madagascar,USA,United States,2017,60,0,60
MDG,Madagascar,CHL,Chile,2008,0,0,0
MDG,Madagascar,CHL,Chile,2009,0,0,0
MDG,Madagascar,CHL,Chile,2010,0,0,0
MDG,Madagascar,CHL,Chile,2011,2,0,2
MDG,Madagascar,CHL,Chile,2012,0,0,0
MDG,Madagascar,CHL,Chile,2013,1,0,1
MDG,Madagascar,CHL,Chile,2014,1,0,1
MDG,Madagascar,CHL,Chile,2015,0,0,0
MDG,Madagascar,CHL,Chile,2016,0,0,0
MDG,Madagascar,EST,Estonia,2008,0,0,0
MDG,Madagascar,EST,Estonia,2009,0,0,0
MDG,Madagascar,EST,Estonia,2010,0,0,0
MDG,Madagascar,EST,Estonia,2011,0,0,0
MDG,Madagascar,EST,Estonia,2012,0,0,0
MDG,Madagascar,EST,Estonia,2013,0,0,0
MDG,Madagascar,EST,Estonia,2014,0,0,0
MDG,Madagascar,EST,Estonia,2015,0,0,0
MDG,Madagascar,EST,Estonia,2016,0,0,0
MDG,Madagascar,EST,Estonia,2017,0,0,0
MDG,Madagascar,SVN,Slovenia,2009,1,0,1
MDG,Madagascar,SVN,Slovenia,2010,1,0,1
MDG,Madagascar,SVN,Slovenia,2011,1,0,1
MDG,Madagascar,SVN,Slovenia,2015,4,0,4
MDG,Madagascar,SVN,Slovenia,2017,1,0,1
MWI,Malawi,AUS,Australia,2008,9,8,1
MWI,Malawi,AUS,Australia,2009,23,0,23
MWI,Malawi,AUS,Australia,2010,19,6,13
MWI,Malawi,AUS,Australia,2011,24,6,18
MWI,Malawi,AUS,Australia,2012,25,7,18
MWI,Malawi,AUS,Australia,2013,22,11,11
MWI,Malawi,AUS,Australia,2014,29,5,24
MWI,Malawi,AUS,Australia,2015,19,0,19
MWI,Malawi,AUS,Australia,2016,13,0,13
MWI,Malawi,AUS,Australia,2017,12,0,12
MWI,Malawi,AUT,Austria,2008,2,1,1
MWI,Malawi,AUT,Austria,2009,4,2,2
MWI,Malawi,AUT,Austria,2010,2,3,-1
MWI,Malawi,AUT,Austria,2011,4,2,2
MWI,Malawi,AUT,Austria,2012,7,1,6
MWI,Malawi,AUT,Austria,2013,6,3,3
MWI,Malawi,AUT,Austria,2014,9,3,6
MWI,Malawi,AUT,Austria,2015,8,8,0
MWI,Malawi,AUT,Austria,2016,5,4,1
MWI,Malawi,AUT,Austria,2017,6,5,1
MWI,Malawi,BEL,Belgium,2008,8,0,8
MWI,Malawi,BEL,Belgium,2009,6,0,6
MWI,Malawi,BEL,Belgium,2010,4,8,-4
MWI,Malawi,BEL,Belgium,2012,12,5,7
MWI,Malawi,BEL,Belgium,2013,13,1,12
MWI,Malawi,BEL,Belgium,2014,3,3,0
MWI,Malawi,BEL,Belgium,2015,4,14,-10
MWI,Malawi,BEL,Belgium,2016,6,1,5
MWI,Malawi,BEL,Belgium,2017,7,2,5
MWI,Malawi,CAN,Canada,2008,5,0,5
MWI,Malawi,CAN,Canada,2009,10,0,10
MWI,Malawi,CAN,Canada,2010,28,0,28
MWI,Malawi,CAN,Canada,2011,16,0,16
MWI,Malawi,CAN,Canada,2012,9,0,9
MWI,Malawi,CAN,Canada,2013,10,0,10
MWI,Malawi,CAN,Canada,2014,20,0,20
MWI,Malawi,CAN,Canada,2015,23,0,23
MWI,Malawi,CAN,Canada,2016,20,0,20
MWI,Malawi,CAN,Canada,2017,20,0,20
MWI,Malawi,CZE,Czech Republic,2012,1,0,1
MWI,Malawi,CZE,Czech Republic,2013,1,0,1
MWI,Malawi,CZE,Czech Republic,2015,3,0,3
MWI,Malawi,CZE,Czech Republic,2016,1,0,1
MWI,Malawi,DNK,Denmark,2008,4,4,0
MWI,Malawi,DNK,Denmark,2009,5,2,3
MWI,Malawi,DNK,Denmark,2010,3,0,3
MWI,Malawi,DNK,Denmark,2011,2,2,0
MWI,Malawi,DNK,Denmark,2012,2,2,0
MWI,Malawi,DNK,Denmark,2013,1,0,1
MWI,Malawi,DNK,Denmark,2014,2,0,2
MWI,Malawi,DNK,Denmark,2015,0,1,-1
MWI,Malawi,DNK,Denmark,2016,2,2,0
MWI,Malawi,DNK,Denmark,2017,1,1,0
MWI,Malawi,FIN,Finland,2008,1,0,1
MWI,Malawi,FIN,Finland,2009,1,0,1
MWI,Malawi,FIN,Finland,2010,0,1,-1
MWI,Malawi,FIN,Finland,2011,4,0,4
MWI,Malawi,FIN,Finland,2012,5,0,5
MWI,Malawi,FIN,Finland,2013,3,0,3
MWI,Malawi,FIN,Finland,2014,0,0,0
MWI,Malawi,FIN,Finland,2015,1,0,1
MWI,Malawi,FIN,Finland,2016,0,0,0
MWI,Malawi,FIN,Finland,2017,1,0,1
MWI,Malawi,FRA,France,2008,2,0,2
MWI,Malawi,FRA,France,2009,2,0,2
MWI,Malawi,FRA,France,2010,2,0,2
MWI,Malawi,FRA,France,2011,1,0,1
MWI,Malawi,FRA,France,2012,0,0,0
MWI,Malawi,FRA,France,2013,5,0,5
MWI,Malawi,FRA,France,2014,4,0,4
MWI,Malawi,FRA,France,2015,2,0,2
MWI,Malawi,FRA,France,2016,3,0,3
MWI,Malawi,FRA,France,2017,2,0,2
MWI,Malawi,DEU,Germany,2008,34,28,6
MWI,Malawi,DEU,Germany,2009,36,36,0
MWI,Malawi,DEU,Germany,2010,39,34,5
MWI,Malawi,DEU,Germany,2011,34,34,0
MWI,Malawi,DEU,Germany,2012,32,29,3
MWI,Malawi,DEU,Germany,2013,31,29,2
MWI,Malawi,DEU,Germany,2014,33,31,2
MWI,Malawi,DEU,Germany,2015,43,28,15
MWI,Malawi,DEU,Germany,2016,23,9,14
MWI,Malawi,DEU,Germany,2017,38,21,17
MWI,Malawi,HUN,Hungary,2008,1,0,1
MWI,Malawi,HUN,Hungary,2009,3,0,3
MWI,Malawi,HUN,Hungary,2010,1,0,1
MWI,Malawi,HUN,Hungary,2011,0,0,0
MWI,Malawi,HUN,Hungary,2012,0,0,0
MWI,Malawi,HUN,Hungary,2013,1,0,1
MWI,Malawi,HUN,Hungary,2014,0,0,0
MWI,Malawi,HUN,Hungary,2015,0,0,0
MWI,Malawi,HUN,Hungary,2016,2,1,1
MWI,Malawi,HUN,Hungary,2017,1,0,1
MWI,Malawi,ISL,Iceland,2008,0,0,0
MWI,Malawi,ISL,Iceland,2009,0,0,0
MWI,Malawi,ISL,Iceland,2010,0,0,0
MWI,Malawi,ISL,Iceland,2011,0,0,0
MWI,Malawi,ISL,Iceland,2012,1,0,1
MWI,Malawi,ISL,Iceland,2013,4,3,1
MWI,Malawi,ISL,Iceland,2014,8,8,0
MWI,Malawi,ISL,Iceland,2015,7,7,0
MWI,Malawi,ISL,Iceland,2016,4,5,-1
MWI,Malawi,ISL,Iceland,2017,4,5,-1
MWI,Malawi,ITA,Italy,2008,4,1,3
MWI,Malawi,ITA,Italy,2009,6,1,5
MWI,Malawi,ITA,Italy,2010,3,0,3
MWI,Malawi,ITA,Italy,2011,10,1,9
MWI,Malawi,ITA,Italy,2012,2,1,1
MWI,Malawi,ITA,Italy,2013,3,0,3
MWI,Malawi,ITA,Italy,2014,2,0,2
MWI,Malawi,ITA,Italy,2015,5,2,3
MWI,Malawi,ITA,Italy,2016,9,0,9
MWI,Malawi,ITA,Italy,2017,7,1,6
MWI,Malawi,JPN,Japan,2008,151,146,5
MWI,Malawi,JPN,Japan,2009,135,125,10
MWI,Malawi,JPN,Japan,2010,155,14,141
MWI,Malawi,JPN,Japan,2011,164,154,10
MWI,Malawi,JPN,Japan,2012,200,203,-3
MWI,Malawi,JPN,Japan,2013,215,207,8
MWI,Malawi,JPN,Japan,2014,137,127,10
MWI,Malawi,JPN,Japan,2015,205,196,9
MWI,Malawi,JPN,Japan,2016,198,160,38
MWI,Malawi,JPN,Japan,2017,161,149,12
MWI,Malawi,KOR,Korea,2008,0,1,-1
MWI,Malawi,KOR,Korea,2009,3,3,0
MWI,Malawi,KOR,Korea,2010,3,2,1
MWI,Malawi,KOR,Korea,2011,7,5,2
MWI,Malawi,KOR,Korea,2012,15,10,5
MWI,Malawi,KOR,Korea,2013,13,6,7
MWI,Malawi,KOR,Korea,2014,6,11,-5
MWI,Malawi,KOR,Korea,2015,14,8,6
MWI,Malawi,KOR,Korea,2016,10,7,3
MWI,Malawi,KOR,Korea,2017,17,26,-9
MWI,Malawi,LUX,Luxembourg,2008,0,0,0
MWI,Malawi,LUX,Luxembourg,2009,0,0,0
MWI,Malawi,LUX,Luxembourg,2010,1,0,1
MWI,Malawi,LUX,Luxembourg,2011,2,0,2
MWI,Malawi,LUX,Luxembourg,2012,0,1,-1
MWI,Malawi,LUX,Luxembourg,2013,0,0,0
MWI,Malawi,LUX,Luxembourg,2014,0,0,0
MWI,Malawi,LUX,Luxembourg,2015,0,0,0
MWI,Malawi,LUX,Luxembourg,2016,1,0,1
MWI,Malawi,LUX,Luxembourg,2017,0,0,0
MWI,Malawi,MEX,Mexico,2012,0,0,0
MWI,Malawi,MEX,Mexico,2013,0,0,0
MWI,Malawi,MEX,Mexico,2014,0,0,0
MWI,Malawi,NLD,Netherlands,2008,14,12,2
MWI,Malawi,NLD,Netherlands,2009,14,4,10
MWI,Malawi,NLD,Netherlands,2010,15,20,-5
MWI,Malawi,NLD,Netherlands,2011,11,9,2
MWI,Malawi,NLD,Netherlands,2012,13,10,3
MWI,Malawi,NLD,Netherlands,2013,11,10,1
MWI,Malawi,NLD,Netherlands,2014,9,8,1
MWI,Malawi,NLD,Netherlands,2015,16,16,0
MWI,Malawi,NLD,Netherlands,2016,14,4,10
MWI,Malawi,NLD,Netherlands,2017,22,12,10
MWI,Malawi,NZL,New Zealand,2008,12,5,7
MWI,Malawi,NZL,New Zealand,2009,9,1,8
MWI,Malawi,NZL,New Zealand,2010,2,2,0
MWI,Malawi,NZL,New Zealand,2011,2,6,-4
MWI,Malawi,NZL,New Zealand,2012,10,5,5
MWI,Malawi,NZL,New Zealand,2013,4,1,3
MWI,Malawi,NZL,New Zealand,2014,5,0,5
MWI,Malawi,NZL,New Zealand,2015,6,5,1
MWI,Malawi,NZL,New Zealand,2016,6,1,5
MWI,Malawi,NZL,New Zealand,2017,3,1,2
MWI,Malawi,NOR,Norway,2008,20,26,-6
MWI,Malawi,NOR,Norway,2009,21,19,2
MWI,Malawi,NOR,Norway,2010,15,18,-3
MWI,Malawi,NOR,Norway,2011,23,18,5
MWI,Malawi,NOR,Norway,2012,15,16,-1
MWI,Malawi,NOR,Norway,2013,25,14,11
MWI,Malawi,NOR,Norway,2014,27,22,5
MWI,Malawi,NOR,Norway,2015,20,25,-5
MWI,Malawi,NOR,Norway,2016,12,15,-3
MWI,Malawi,NOR,Norway,2017,9,11,-2
MWI,Malawi,POL,Poland,2009,1,0,1
MWI,Malawi,POL,Poland,2010,0,0,0
MWI,Malawi,POL,Poland,2011,4,0,4
MWI,Malawi,POL,Poland,2012,4,0,4
MWI,Malawi,POL,Poland,2013,4,0,4
MWI,Malawi,POL,Poland,2014,0,0,0
MWI,Malawi,POL,Poland,2015,1,0,1
MWI,Malawi,POL,Poland,2016,1,0,1
MWI,Malawi,POL,Poland,2017,2,0,2
MWI,Malawi,SVK,Slovak Republic,2008,1,0,1
MWI,Malawi,SVK,Slovak Republic,2009,2,0,2
MWI,Malawi,SVK,Slovak Republic,2010,1,0,1
MWI,Malawi,ESP,Spain,2008,4,1,3
MWI,Malawi,ESP,Spain,2009,2,2,0
MWI,Malawi,ESP,Spain,2010,3,0,3
MWI,Malawi,ESP,Spain,2011,15,1,14
MWI,Malawi,ESP,Spain,2012,12,0,12
MWI,Malawi,ESP,Spain,2013,7,7,0
MWI,Malawi,ESP,Spain,2014,5,3,2
MWI,Malawi,ESP,Spain,2015,5,0,5
MWI,Malawi,ESP,Spain,2016,4,2,2
MWI,Malawi,ESP,Spain,2017,7,4,3
MWI,Malawi,SWE,Sweden,2008,5,2,3
MWI,Malawi,SWE,Sweden,2009,3,1,2
MWI,Malawi,SWE,Sweden,2010,1,0,1
MWI,Malawi,SWE,Sweden,2011,2,6,-4
MWI,Malawi,SWE,Sweden,2012,8,2,6
MWI,Malawi,SWE,Sweden,2013,1,2,-1
MWI,Malawi,SWE,Sweden,2014,3,1,2
MWI,Malawi,SWE,Sweden,2015,1,3,-2
MWI,Malawi,SWE,Sweden,2016,8,8,0
MWI,Malawi,SWE,Sweden,2017,6,1,5
MWI,Malawi,CHE,Switzerland,2010,7,2,5
MWI,Malawi,CHE,Switzerland,2011,4,5,-1
MWI,Malawi,CHE,Switzerland,2012,4,3,1
MWI,Malawi,CHE,Switzerland,2013,4,1,3
MWI,Malawi,CHE,Switzerland,2014,1,3,-2
MWI,Malawi,CHE,Switzerland,2015,5,2,3
MWI,Malawi,CHE,Switzerland,2016,10,2,8
MWI,Malawi,CHE,Switzerland,2017,9,2,7
MWI,Malawi,TUR,Turkey,2010,8,0,8
MWI,Malawi,USA,United States,2008,133,0,133
MWI,Malawi,USA,United States,2009,164,0,164
MWI,Malawi,USA,United States,2010,164,0,164
MWI,Malawi,USA,United States,2011,123,0,123
MWI,Malawi,USA,United States,2012,192,0,192
MWI,Malawi,USA,United States,2013,159,0,159
MWI,Malawi,USA,United States,2014,172,0,172
MWI,Malawi,USA,United States,2015,160,0,160
MWI,Malawi,USA,United States,2016,205,0,205
MWI,Malawi,USA,United States,2017,228,0,228
MWI,Malawi,CHL,Chile,2008,0,0,0
MWI,Malawi,CHL,Chile,2009,0,0,0
MWI,Malawi,CHL,Chile,2010,0,0,0
MWI,Malawi,CHL,Chile,2011,0,0,0
MWI,Malawi,CHL,Chile,2012,0,0,0
MWI,Malawi,CHL,Chile,2013,0,0,0
MWI,Malawi,CHL,Chile,2014,0,0,0
MWI,Malawi,CHL,Chile,2015,0,0,0
MWI,Malawi,CHL,Chile,2016,0,0,0
MWI,Malawi,EST,Estonia,2008,0,0,0
MWI,Malawi,EST,Estonia,2009,0,0,0
MWI,Malawi,EST,Estonia,2010,0,0,0
MWI,Malawi,EST,Estonia,2011,0,0,0
MWI,Malawi,EST,Estonia,2012,0,0,0
MWI,Malawi,EST,Estonia,2013,0,0,0
MWI,Malawi,EST,Estonia,2014,0,0,0
MWI,Malawi,EST,Estonia,2015,0,0,0
MWI,Malawi,EST,Estonia,2016,0,0,0
MWI,Malawi,EST,Estonia,2017,0,0,0
MWI,Malawi,SVN,Slovenia,2017,1,0,1
MYS,Malaysia,AUS,Australia,2008,5117,603,4514
MYS,Malaysia,AUS,Australia,2009,5382,507,4875
MYS,Malaysia,AUS,Australia,2010,4920,511,4409
MYS,Malaysia,AUS,Australia,2011,4946,611,4335
MYS,Malaysia,AUS,Australia,2012,5374,536,4838
MYS,Malaysia,AUS,Australia,2013,5615,570,5045
MYS,Malaysia,AUS,Australia,2014,4465,620,3845
MYS,Malaysia,AUS,Australia,2015,4041,600,3441
MYS,Malaysia,AUS,Australia,2016,4128,600,3528
MYS,Malaysia,AUS,Australia,2017,4238,0,4238
MYS,Malaysia,AUT,Austria,2008,22,40,-18
MYS,Malaysia,AUT,Austria,2009,20,34,-14
MYS,Malaysia,AUT,Austria,2010,34,12,22
MYS,Malaysia,AUT,Austria,2011,56,40,16
MYS,Malaysia,AUT,Austria,2012,48,28,20
MYS,Malaysia,AUT,Austria,2013,43,43,0
MYS,Malaysia,AUT,Austria,2014,45,28,17
MYS,Malaysia,AUT,Austria,2015,40,35,5
MYS,Malaysia,AUT,Austria,2016,60,40,20
MYS,Malaysia,AUT,Austria,2017,56,44,12
MYS,Malaysia,BEL,Belgium,2008,67,0,67
MYS,Malaysia,BEL,Belgium,2009,54,0,54
MYS,Malaysia,BEL,Belgium,2010,72,28,44
MYS,Malaysia,BEL,Belgium,2012,69,55,14
MYS,Malaysia,BEL,Belgium,2013,66,62,4
MYS,Malaysia,BEL,Belgium,2014,39,30,9
MYS,Malaysia,BEL,Belgium,2015,41,45,-4
MYS,Malaysia,BEL,Belgium,2016,56,27,29
MYS,Malaysia,BEL,Belgium,2017,63,24,39
MYS,Malaysia,CAN,Canada,2008,658,0,658
MYS,Malaysia,CAN,Canada,2009,640,0,640
MYS,Malaysia,CAN,Canada,2010,799,0,799
MYS,Malaysia,CAN,Canada,2011,409,0,409
MYS,Malaysia,CAN,Canada,2012,356,0,356
MYS,Malaysia,CAN,Canada,2013,204,0,204
MYS,Malaysia,CAN,Canada,2014,336,0,336
MYS,Malaysia,CAN,Canada,2015,332,0,332
MYS,Malaysia,CAN,Canada,2016,365,0,365
MYS,Malaysia,CAN,Canada,2017,360,0,360
MYS,Malaysia,CZE,Czech Republic,2008,116,0,116
MYS,Malaysia,CZE,Czech Republic,2009,95,0,95
MYS,Malaysia,CZE,Czech Republic,2010,82,0,82
MYS,Malaysia,CZE,Czech Republic,2011,70,0,70
MYS,Malaysia,CZE,Czech Republic,2012,98,68,30
MYS,Malaysia,CZE,Czech Republic,2013,32,92,-60
MYS,Malaysia,CZE,Czech Republic,2014,60,91,-31
MYS,Malaysia,CZE,Czech Republic,2015,43,78,-35
MYS,Malaysia,CZE,Czech Republic,2016,55,91,-36
MYS,Malaysia,CZE,Czech Republic,2017,58,100,-42
MYS,Malaysia,DNK,Denmark,2008,56,18,38
MYS,Malaysia,DNK,Denmark,2009,52,30,22
MYS,Malaysia,DNK,Denmark,2010,32,31,1
MYS,Malaysia,DNK,Denmark,2011,54,51,3
MYS,Malaysia,DNK,Denmark,2012,60,43,17
MYS,Malaysia,DNK,Denmark,2013,65,63,2
MYS,Malaysia,DNK,Denmark,2014,42,60,-18
MYS,Malaysia,DNK,Denmark,2015,46,48,-2
MYS,Malaysia,DNK,Denmark,2016,60,63,-3
MYS,Malaysia,DNK,Denmark,2017,40,54,-14
MYS,Malaysia,FIN,Finland,2008,29,5,24
MYS,Malaysia,FIN,Finland,2009,30,13,17
MYS,Malaysia,FIN,Finland,2010,19,7,12
MYS,Malaysia,FIN,Finland,2011,19,6,13
MYS,Malaysia,FIN,Finland,2012,25,9,16
MYS,Malaysia,FIN,Finland,2013,21,19,2
MYS,Malaysia,FIN,Finland,2014,28,11,17
MYS,Malaysia,FIN,Finland,2015,18,10,8
MYS,Malaysia,FIN,Finland,2016,26,18,8
MYS,Malaysia,FIN,Finland,2017,34,3,31
MYS,Malaysia,FRA,France,2008,100,0,100
MYS,Malaysia,FRA,France,2009,103,0,103
MYS,Malaysia,FRA,France,2010,116,0,116
MYS,Malaysia,FRA,France,2011,129,0,129
MYS,Malaysia,FRA,France,2012,191,0,191
MYS,Malaysia,FRA,France,2013,111,0,111
MYS,Malaysia,FRA,France,2014,148,0,148
MYS,Malaysia,FRA,France,2015,113,0,113
MYS,Malaysia,FRA,France,2016,115,0,115
MYS,Malaysia,FRA,France,2017,108,0,108
MYS,Malaysia,DEU,Germany,2008,827,674,153
MYS,Malaysia,DEU,Germany,2009,696,654,42
MYS,Malaysia,DEU,Germany,2010,618,742,-124
MYS,Malaysia,DEU,Germany,2011,701,643,58
MYS,Malaysia,DEU,Germany,2012,652,525,127
MYS,Malaysia,DEU,Germany,2013,716,564,152
MYS,Malaysia,DEU,Germany,2014,794,608,186
MYS,Malaysia,DEU,Germany,2015,793,656,137
MYS,Malaysia,DEU,Germany,2016,902,527,375
MYS,Malaysia,DEU,Germany,2017,901,548,353
MYS,Malaysia,HUN,Hungary,2008,32,2,30
MYS,Malaysia,HUN,Hungary,2009,16,3,13
MYS,Malaysia,HUN,Hungary,2010,36,3,33
MYS,Malaysia,HUN,Hungary,2011,34,2,32
MYS,Malaysia,HUN,Hungary,2012,10,5,5
MYS,Malaysia,HUN,Hungary,2013,11,6,5
MYS,Malaysia,HUN,Hungary,2014,24,6,18
MYS,Malaysia,HUN,Hungary,2015,19,4,15
MYS,Malaysia,HUN,Hungary,2016,28,3,25
MYS,Malaysia,HUN,Hungary,2017,41,0,41
MYS,Malaysia,ISL,Iceland,2008,2,1,1
MYS,Malaysia,ISL,Iceland,2009,2,3,-1
MYS,Malaysia,ISL,Iceland,2010,4,1,3
MYS,Malaysia,ISL,Iceland,2011,0,1,-1
MYS,Malaysia,ISL,Iceland,2012,3,0,3
MYS,Malaysia,ISL,Iceland,2013,0,3,-3
MYS,Malaysia,ISL,Iceland,2014,2,0,2
MYS,Malaysia,ISL,Iceland,2015,0,0,0
MYS,Malaysia,ISL,Iceland,2016,1,0,1
MYS,Malaysia,ISL,Iceland,2017,4,0,4
MYS,Malaysia,ITA,Italy,2008,37,12,25
MYS,Malaysia,ITA,Italy,2009,30,14,16
MYS,Malaysia,ITA,Italy,2010,37,17,20
MYS,Malaysia,ITA,Italy,2011,31,4,27
MYS,Malaysia,ITA,Italy,2012,66,13,53
MYS,Malaysia,ITA,Italy,2013,72,8,64
MYS,Malaysia,ITA,Italy,2014,40,14,26
MYS,Malaysia,ITA,Italy,2015,78,8,70
MYS,Malaysia,ITA,Italy,2016,79,0,79
MYS,Malaysia,ITA,Italy,2017,124,20,104
MYS,Malaysia,JPN,Japan,2008,2640,1967,673
MYS,Malaysia,JPN,Japan,2009,2320,1921,399
MYS,Malaysia,JPN,Japan,2010,2318,1874,444
MYS,Malaysia,JPN,Japan,2011,2170,1900,270
MYS,Malaysia,JPN,Japan,2012,2504,2256,248
MYS,Malaysia,JPN,Japan,2013,2126,1670,456
MYS,Malaysia,JPN,Japan,2014,2164,1690,474
MYS,Malaysia,JPN,Japan,2015,2284,1702,582
MYS,Malaysia,JPN,Japan,2016,2476,2004,472
MYS,Malaysia,JPN,Japan,2017,2689,2015,674
MYS,Malaysia,KOR,Korea,2008,436,349,87
MYS,Malaysia,KOR,Korea,2009,432,365,67
MYS,Malaysia,KOR,Korea,2010,581,437,144
MYS,Malaysia,KOR,Korea,2011,594,690,-96
MYS,Malaysia,KOR,Korea,2012,715,959,-244
MYS,Malaysia,KOR,Korea,2013,963,710,253
MYS,Malaysia,KOR,Korea,2014,1184,948,236
MYS,Malaysia,KOR,Korea,2015,1285,1197,88
MYS,Malaysia,KOR,Korea,2016,1521,1344,177
MYS,Malaysia,KOR,Korea,2017,3798,2027,1771
MYS,Malaysia,LUX,Luxembourg,2008,8,0,8
MYS,Malaysia,LUX,Luxembourg,2009,2,2,0
MYS,Malaysia,LUX,Luxembourg,2010,1,1,0
MYS,Malaysia,LUX,Luxembourg,2011,7,0,7
MYS,Malaysia,LUX,Luxembourg,2012,4,2,2
MYS,Malaysia,LUX,Luxembourg,2013,7,4,3
MYS,Malaysia,LUX,Luxembourg,2014,7,5,2
MYS,Malaysia,LUX,Luxembourg,2015,3,1,2
MYS,Malaysia,LUX,Luxembourg,2016,13,5,8
MYS,Malaysia,LUX,Luxembourg,2017,20,2,18
MYS,Malaysia,MEX,Mexico,2008,4,0,4
MYS,Malaysia,MEX,Mexico,2009,4,0,4
MYS,Malaysia,MEX,Mexico,2010,12,0,12
MYS,Malaysia,MEX,Mexico,2011,6,0,6
MYS,Malaysia,MEX,Mexico,2012,0,0,0
MYS,Malaysia,MEX,Mexico,2013,15,0,15
MYS,Malaysia,MEX,Mexico,2014,5,0,5
MYS,Malaysia,MEX,Mexico,2015,3,0,3
MYS,Malaysia,MEX,Mexico,2016,3,0,3
MYS,Malaysia,MEX,Mexico,2017,6,0,6
MYS,Malaysia,NLD,Netherlands,2008,235,186,49
MYS,Malaysia,NLD,Netherlands,2009,216,169,47
MYS,Malaysia,NLD,Netherlands,2010,255,307,-52
MYS,Malaysia,NLD,Netherlands,2011,198,204,-6
MYS,Malaysia,NLD,Netherlands,2012,249,182,67
MYS,Malaysia,NLD,Netherlands,2013,233,190,43
MYS,Malaysia,NLD,Netherlands,2014,237,214,23
MYS,Malaysia,NLD,Netherlands,2015,250,192,58
MYS,Malaysia,NLD,Netherlands,2016,230,182,48
MYS,Malaysia,NLD,Netherlands,2017,228,188,40
MYS,Malaysia,NZL,New Zealand,2008,1346,704,642
MYS,Malaysia,NZL,New Zealand,2009,1238,755,483
MYS,Malaysia,NZL,New Zealand,2010,1282,907,375
MYS,Malaysia,NZL,New Zealand,2011,1336,913,423
MYS,Malaysia,NZL,New Zealand,2012,1098,750,348
MYS,Malaysia,NZL,New Zealand,2013,913,557,356
MYS,Malaysia,NZL,New Zealand,2014,949,476,473
MYS,Malaysia,NZL,New Zealand,2015,1085,446,639
MYS,Malaysia,NZL,New Zealand,2016,1241,325,916
MYS,Malaysia,NZL,New Zealand,2017,1304,448,856
MYS,Malaysia,NOR,Norway,2008,64,9,55
MYS,Malaysia,NOR,Norway,2009,80,33,47
MYS,Malaysia,NOR,Norway,2010,53,39,14
MYS,Malaysia,NOR,Norway,2011,107,63,44
MYS,Malaysia,NOR,Norway,2012,105,65,40
MYS,Malaysia,NOR,Norway,2013,84,49,35
MYS,Malaysia,NOR,Norway,2014,70,62,8
MYS,Malaysia,NOR,Norway,2015,66,50,16
MYS,Malaysia,NOR,Norway,2016,61,60,1
MYS,Malaysia,NOR,Norway,2017,43,29,14
MYS,Malaysia,POL,Poland,2008,48,0,48
MYS,Malaysia,POL,Poland,2009,90,0,90
MYS,Malaysia,POL,Poland,2010,116,0,116
MYS,Malaysia,POL,Poland,2011,154,0,154
MYS,Malaysia,POL,Poland,2012,157,0,157
MYS,Malaysia,POL,Poland,2013,199,0,199
MYS,Malaysia,POL,Poland,2014,156,0,156
MYS,Malaysia,POL,Poland,2015,143,0,143
MYS,Malaysia,POL,Poland,2016,39,0,39
MYS,Malaysia,POL,Poland,2017,93,0,93
MYS,Malaysia,SVK,Slovak Republic,2008,1,2,-1
MYS,Malaysia,SVK,Slovak Republic,2009,1,5,-4
MYS,Malaysia,SVK,Slovak Republic,2010,1,38,-37
MYS,Malaysia,SVK,Slovak Republic,2011,1,4,-3
MYS,Malaysia,SVK,Slovak Republic,2012,2,0,2
MYS,Malaysia,SVK,Slovak Republic,2015,1,0,1
MYS,Malaysia,ESP,Spain,2008,52,28,24
MYS,Malaysia,ESP,Spain,2009,49,33,16
MYS,Malaysia,ESP,Spain,2010,34,29,5
MYS,Malaysia,ESP,Spain,2011,80,30,50
MYS,Malaysia,ESP,Spain,2012,60,40,20
MYS,Malaysia,ESP,Spain,2013,49,36,13
MYS,Malaysia,ESP,Spain,2014,66,21,45
MYS,Malaysia,ESP,Spain,2015,49,15,34
MYS,Malaysia,ESP,Spain,2016,66,42,24
MYS,Malaysia,ESP,Spain,2017,81,77,4
MYS,Malaysia,SWE,Sweden,2008,78,31,47
MYS,Malaysia,SWE,Sweden,2009,67,25,42
MYS,Malaysia,SWE,Sweden,2010,46,46,0
MYS,Malaysia,SWE,Sweden,2011,60,36,24
MYS,Malaysia,SWE,Sweden,2012,56,34,22
MYS,Malaysia,SWE,Sweden,2013,68,36,32
MYS,Malaysia,SWE,Sweden,2014,69,30,39
MYS,Malaysia,SWE,Sweden,2015,51,71,-20
MYS,Malaysia,SWE,Sweden,2016,60,40,20
MYS,Malaysia,SWE,Sweden,2017,61,33,28
MYS,Malaysia,CHE,Switzerland,2010,259,199,60
MYS,Malaysia,CHE,Switzerland,2011,251,219,32
MYS,Malaysia,CHE,Switzerland,2012,261,204,57
MYS,Malaysia,CHE,Switzerland,2013,189,201,-12
MYS,Malaysia,CHE,Switzerland,2014,212,169,43
MYS,Malaysia,CHE,Switzerland,2015,185,171,14
MYS,Malaysia,CHE,Switzerland,2016,206,113,93
MYS,Malaysia,CHE,Switzerland,2017,202,176,26
MYS,Malaysia,TUR,Turkey,2010,7,0,7
MYS,Malaysia,TUR,Turkey,2016,139,146,-7
MYS,Malaysia,TUR,Turkey,2017,279,109,170
MYS,Malaysia,GBR,United Kingdom,2008,11000,2000,9000
MYS,Malaysia,GBR,United Kingdom,2009,7000,3000,4000
MYS,Malaysia,GBR,United Kingdom,2010,9000,2000,7000
MYS,Malaysia,GBR,United Kingdom,2011,4000,4000,0
MYS,Malaysia,GBR,United Kingdom,2012,6000,4000,2000
MYS,Malaysia,GBR,United Kingdom,2013,9000,4000,5000
MYS,Malaysia,GBR,United Kingdom,2014,6000,2000,4000
MYS,Malaysia,GBR,United Kingdom,2015,8000,4000,4000
MYS,Malaysia,USA,United States,2008,1945,0,1945
MYS,Malaysia,USA,United States,2009,2014,0,2014
MYS,Malaysia,USA,United States,2010,1714,0,1714
MYS,Malaysia,USA,United States,2011,2273,0,2273
MYS,Malaysia,USA,United States,2012,2605,0,2605
MYS,Malaysia,USA,United States,2013,2477,0,2477
MYS,Malaysia,USA,United States,2014,2622,0,2622
MYS,Malaysia,USA,United States,2015,2749,0,2749
MYS,Malaysia,USA,United States,2016,3382,0,3382
MYS,Malaysia,USA,United States,2017,4109,0,4109
MYS,Malaysia,CHL,Chile,2008,5,0,5
MYS,Malaysia,CHL,Chile,2009,5,0,5
MYS,Malaysia,CHL,Chile,2010,3,0,3
MYS,Malaysia,CHL,Chile,2011,4,0,4
MYS,Malaysia,CHL,Chile,2012,4,0,4
MYS,Malaysia,CHL,Chile,2013,6,0,6
MYS,Malaysia,CHL,Chile,2014,10,0,10
MYS,Malaysia,CHL,Chile,2015,12,0,12
MYS,Malaysia,CHL,Chile,2016,4,0,4
MYS,Malaysia,EST,Estonia,2008,3,0,3
MYS,Malaysia,EST,Estonia,2009,0,0,0
MYS,Malaysia,EST,Estonia,2010,0,0,0
MYS,Malaysia,EST,Estonia,2011,0,0,0
MYS,Malaysia,EST,Estonia,2012,1,0,1
MYS,Malaysia,EST,Estonia,2013,5,0,5
MYS,Malaysia,EST,Estonia,2014,0,0,0
MYS,Malaysia,EST,Estonia,2015,3,0,3
MYS,Malaysia,EST,Estonia,2016,2,0,2
MYS,Malaysia,EST,Estonia,2017,4,0,4
MYS,Malaysia,SVN,Slovenia,2009,3,0,3
MYS,Malaysia,SVN,Slovenia,2010,7,0,7
MYS,Malaysia,SVN,Slovenia,2011,3,0,3
MYS,Malaysia,SVN,Slovenia,2012,2,0,2
MYS,Malaysia,SVN,Slovenia,2013,3,0,3
MYS,Malaysia,SVN,Slovenia,2014,1,0,1
MYS,Malaysia,SVN,Slovenia,2015,2,0,2
MYS,Malaysia,SVN,Slovenia,2016,1,0,1
MYS,Malaysia,SVN,Slovenia,2017,3,0,3
MDV,Maldives,AUS,Australia,2008,35,7,28
MDV,Maldives,AUS,Australia,2009,26,0,26
MDV,Maldives,AUS,Australia,2010,43,6,37
MDV,Maldives,AUS,Australia,2011,17,7,10
MDV,Maldives,AUS,Australia,2012,24,0,24
MDV,Maldives,AUS,Australia,2013,44,0,44
MDV,Maldives,AUS,Australia,2014,32,5,27
MDV,Maldives,AUS,Australia,2015,38,0,38
MDV,Maldives,AUS,Australia,2016,38,0,38
MDV,Maldives,AUS,Australia,2017,35,0,35
MDV,Maldives,AUT,Austria,2008,1,1,0
MDV,Maldives,AUT,Austria,2009,0,1,-1
MDV,Maldives,AUT,Austria,2010,0,0,0
MDV,Maldives,AUT,Austria,2011,1,0,1
MDV,Maldives,AUT,Austria,2012,0,0,0
MDV,Maldives,AUT,Austria,2013,2,0,2
MDV,Maldives,AUT,Austria,2014,1,0,1
MDV,Maldives,AUT,Austria,2015,2,2,0
MDV,Maldives,AUT,Austria,2016,1,1,0
MDV,Maldives,AUT,Austria,2017,2,1,1
MDV,Maldives,BEL,Belgium,2008,1,0,1
MDV,Maldives,BEL,Belgium,2009,0,0,0
MDV,Maldives,BEL,Belgium,2010,0,0,0
MDV,Maldives,BEL,Belgium,2016,1,0,1
MDV,Maldives,BEL,Belgium,2017,2,0,2
MDV,Maldives,CAN,Canada,2008,1,0,1
MDV,Maldives,CAN,Canada,2009,7,0,7
MDV,Maldives,CAN,Canada,2010,4,0,4
MDV,Maldives,CAN,Canada,2011,3,0,3
MDV,Maldives,CAN,Canada,2012,1,0,1
MDV,Maldives,CAN,Canada,2013,1,0,1
MDV,Maldives,CAN,Canada,2014,0,0,0
MDV,Maldives,CAN,Canada,2015,0,0,0
MDV,Maldives,CAN,Canada,2016,0,0,0
MDV,Maldives,CAN,Canada,2017,0,0,0
MDV,Maldives,DNK,Denmark,2008,0,0,0
MDV,Maldives,DNK,Denmark,2009,1,0,1
MDV,Maldives,DNK,Denmark,2010,1,1,0
MDV,Maldives,DNK,Denmark,2012,0,1,-1
MDV,Maldives,DNK,Denmark,2013,3,1,2
MDV,Maldives,DNK,Denmark,2014,0,0,0
MDV,Maldives,DNK,Denmark,2015,1,1,0
MDV,Maldives,DNK,Denmark,2016,3,1,2
MDV,Maldives,DNK,Denmark,2017,1,0,1
MDV,Maldives,FIN,Finland,2008,0,0,0
MDV,Maldives,FIN,Finland,2009,0,0,0
MDV,Maldives,FIN,Finland,2010,0,1,-1
MDV,Maldives,FIN,Finland,2011,0,0,0
MDV,Maldives,FIN,Finland,2012,0,0,0
MDV,Maldives,FIN,Finland,2013,1,0,1
MDV,Maldives,FIN,Finland,2014,0,0,0
MDV,Maldives,FIN,Finland,2015,1,0,1
MDV,Maldives,FIN,Finland,2016,0,1,-1
MDV,Maldives,FIN,Finland,2017,0,0,0
MDV,Maldives,FRA,France,2008,0,0,0
MDV,Maldives,FRA,France,2009,1,0,1
MDV,Maldives,FRA,France,2010,2,0,2
MDV,Maldives,FRA,France,2011,2,0,2
MDV,Maldives,FRA,France,2012,2,0,2
MDV,Maldives,FRA,France,2013,0,0,0
MDV,Maldives,FRA,France,2014,2,0,2
MDV,Maldives,FRA,France,2015,1,0,1
MDV,Maldives,FRA,France,2016,2,0,2
MDV,Maldives,FRA,France,2017,2,0,2
MDV,Maldives,DEU,Germany,2008,6,6,0
MDV,Maldives,DEU,Germany,2009,5,6,-1
MDV,Maldives,DEU,Germany,2010,14,4,10
MDV,Maldives,DEU,Germany,2011,2,4,-2
MDV,Maldives,DEU,Germany,2012,3,2,1
MDV,Maldives,DEU,Germany,2013,11,4,7
MDV,Maldives,DEU,Germany,2014,11,2,9
MDV,Maldives,DEU,Germany,2015,13,4,9
MDV,Maldives,DEU,Germany,2016,14,6,8
MDV,Maldives,DEU,Germany,2017,7,6,1
MDV,Maldives,HUN,Hungary,2008,1,0,1
MDV,Maldives,HUN,Hungary,2009,0,0,0
MDV,Maldives,HUN,Hungary,2010,1,0,1
MDV,Maldives,HUN,Hungary,2011,0,0,0
MDV,Maldives,HUN,Hungary,2012,0,0,0
MDV,Maldives,HUN,Hungary,2013,0,0,0
MDV,Maldives,HUN,Hungary,2014,0,0,0
MDV,Maldives,HUN,Hungary,2015,0,0,0
MDV,Maldives,HUN,Hungary,2016,1,0,1
MDV,Maldives,HUN,Hungary,2017,0,0,0
MDV,Maldives,ISL,Iceland,2016,0,0,0
MDV,Maldives,ISL,Iceland,2017,0,0,0
MDV,Maldives,ITA,Italy,2008,2,0,2
MDV,Maldives,ITA,Italy,2009,4,0,4
MDV,Maldives,ITA,Italy,2010,2,0,2
MDV,Maldives,ITA,Italy,2011,3,0,3
MDV,Maldives,ITA,Italy,2012,3,0,3
MDV,Maldives,ITA,Italy,2013,0,0,0
MDV,Maldives,ITA,Italy,2015,2,1,1
MDV,Maldives,ITA,Italy,2016,3,0,3
MDV,Maldives,ITA,Italy,2017,3,0,3
MDV,Maldives,JPN,Japan,2008,53,46,7
MDV,Maldives,JPN,Japan,2009,80,73,7
MDV,Maldives,JPN,Japan,2010,60,58,2
MDV,Maldives,JPN,Japan,2011,68,65,3
MDV,Maldives,JPN,Japan,2012,77,76,1
MDV,Maldives,JPN,Japan,2013,76,63,13
MDV,Maldives,JPN,Japan,2014,89,92,-3
MDV,Maldives,JPN,Japan,2015,97,85,12
MDV,Maldives,JPN,Japan,2016,85,81,4
MDV,Maldives,JPN,Japan,2017,85,81,4
MDV,Maldives,KOR,Korea,2008,0,2,-2
MDV,Maldives,KOR,Korea,2009,1,0,1
MDV,Maldives,KOR,Korea,2010,1,2,-1
MDV,Maldives,KOR,Korea,2011,2,2,0
MDV,Maldives,KOR,Korea,2012,2,1,1
MDV,Maldives,KOR,Korea,2013,3,1,2
MDV,Maldives,KOR,Korea,2014,2,3,-1
MDV,Maldives,KOR,Korea,2015,3,2,1
MDV,Maldives,KOR,Korea,2016,2,4,-2
MDV,Maldives,KOR,Korea,2017,5,5,0
MDV,Maldives,LUX,Luxembourg,2008,0,0,0
MDV,Maldives,LUX,Luxembourg,2009,0,0,0
MDV,Maldives,LUX,Luxembourg,2010,0,0,0
MDV,Maldives,LUX,Luxembourg,2011,0,0,0
MDV,Maldives,LUX,Luxembourg,2012,0,0,0
MDV,Maldives,LUX,Luxembourg,2013,0,0,0
MDV,Maldives,LUX,Luxembourg,2014,0,0,0
MDV,Maldives,LUX,Luxembourg,2015,0,0,0
MDV,Maldives,LUX,Luxembourg,2016,0,0,0
MDV,Maldives,LUX,Luxembourg,2017,0,0,0
MDV,Maldives,MEX,Mexico,2012,0,0,0
MDV,Maldives,MEX,Mexico,2013,0,0,0
MDV,Maldives,MEX,Mexico,2014,0,0,0
MDV,Maldives,NLD,Netherlands,2008,2,0,2
MDV,Maldives,NLD,Netherlands,2013,1,0,1
MDV,Maldives,NLD,Netherlands,2014,2,1,1
MDV,Maldives,NLD,Netherlands,2015,2,1,1
MDV,Maldives,NLD,Netherlands,2016,7,0,7
MDV,Maldives,NLD,Netherlands,2017,3,2,1
MDV,Maldives,NZL,New Zealand,2008,20,13,7
MDV,Maldives,NZL,New Zealand,2009,27,27,0
MDV,Maldives,NZL,New Zealand,2010,39,8,31
MDV,Maldives,NZL,New Zealand,2011,13,19,-6
MDV,Maldives,NZL,New Zealand,2012,16,15,1
MDV,Maldives,NZL,New Zealand,2013,15,21,-6
MDV,Maldives,NZL,New Zealand,2014,18,4,14
MDV,Maldives,NZL,New Zealand,2015,11,7,4
MDV,Maldives,NZL,New Zealand,2016,13,8,5
MDV,Maldives,NZL,New Zealand,2017,15,5,10
MDV,Maldives,NOR,Norway,2008,0,3,-3
MDV,Maldives,NOR,Norway,2009,1,1,0
MDV,Maldives,NOR,Norway,2010,3,1,2
MDV,Maldives,NOR,Norway,2011,2,0,2
MDV,Maldives,NOR,Norway,2012,3,1,2
MDV,Maldives,NOR,Norway,2013,1,2,-1
MDV,Maldives,NOR,Norway,2014,0,4,-4
MDV,Maldives,NOR,Norway,2015,3,1,2
MDV,Maldives,NOR,Norway,2016,0,2,-2
MDV,Maldives,NOR,Norway,2017,1,1,0
MDV,Maldives,POL,Poland,2009,0,0,0
MDV,Maldives,POL,Poland,2010,0,0,0
MDV,Maldives,POL,Poland,2011,0,0,0
MDV,Maldives,POL,Poland,2012,0,0,0
MDV,Maldives,POL,Poland,2013,0,0,0
MDV,Maldives,POL,Poland,2014,0,0,0
MDV,Maldives,POL,Poland,2015,0,0,0
MDV,Maldives,POL,Poland,2016,0,0,0
MDV,Maldives,POL,Poland,2017,0,0,0
MDV,Maldives,SVK,Slovak Republic,2008,0,0,0
MDV,Maldives,SVK,Slovak Republic,2013,1,0,1
MDV,Maldives,ESP,Spain,2008,0,0,0
MDV,Maldives,ESP,Spain,2009,1,1,0
MDV,Maldives,ESP,Spain,2010,1,1,0
MDV,Maldives,ESP,Spain,2011,1,0,1
MDV,Maldives,ESP,Spain,2012,1,0,1
MDV,Maldives,ESP,Spain,2013,4,0,4
MDV,Maldives,ESP,Spain,2014,3,0,3
MDV,Maldives,ESP,Spain,2015,3,0,3
MDV,Maldives,ESP,Spain,2016,3,0,3
MDV,Maldives,ESP,Spain,2017,3,2,1
MDV,Maldives,SWE,Sweden,2008,1,0,1
MDV,Maldives,SWE,Sweden,2009,0,0,0
MDV,Maldives,SWE,Sweden,2010,1,0,1
MDV,Maldives,SWE,Sweden,2011,0,0,0
MDV,Maldives,SWE,Sweden,2012,3,2,1
MDV,Maldives,SWE,Sweden,2013,3,0,3
MDV,Maldives,SWE,Sweden,2014,2,0,2
MDV,Maldives,SWE,Sweden,2015,4,2,2
MDV,Maldives,SWE,Sweden,2016,2,0,2
MDV,Maldives,SWE,Sweden,2017,1,2,-1
MDV,Maldives,CHE,Switzerland,2010,2,2,0
MDV,Maldives,CHE,Switzerland,2011,1,2,-1
MDV,Maldives,CHE,Switzerland,2012,10,2,8
MDV,Maldives,CHE,Switzerland,2013,3,3,0
MDV,Maldives,CHE,Switzerland,2014,5,4,1
MDV,Maldives,CHE,Switzerland,2015,4,2,2
MDV,Maldives,CHE,Switzerland,2016,3,4,-1
MDV,Maldives,CHE,Switzerland,2017,7,1,6
MDV,Maldives,USA,United States,2008,2,0,2
MDV,Maldives,USA,United States,2009,6,0,6
MDV,Maldives,USA,United States,2010,5,0,5
MDV,Maldives,USA,United States,2011,3,0,3
MDV,Maldives,USA,United States,2012,3,0,3
MDV,Maldives,USA,United States,2013,5,0,5
MDV,Maldives,USA,United States,2014,13,0,13
MDV,Maldives,USA,United States,2015,8,0,8
MDV,Maldives,USA,United States,2016,11,0,11
MDV,Maldives,USA,United States,2017,5,0,5
MDV,Maldives,CHL,Chile,2008,0,0,0
MDV,Maldives,CHL,Chile,2009,0,0,0
MDV,Maldives,CHL,Chile,2010,0,0,0
MDV,Maldives,CHL,Chile,2011,0,0,0
MDV,Maldives,CHL,Chile,2012,0,0,0
MDV,Maldives,CHL,Chile,2013,0,0,0
MDV,Maldives,CHL,Chile,2014,0,0,0
MDV,Maldives,CHL,Chile,2015,0,0,0
MDV,Maldives,CHL,Chile,2016,0,0,0
MDV,Maldives,EST,Estonia,2008,1,0,1
MDV,Maldives,EST,Estonia,2009,0,0,0
MDV,Maldives,EST,Estonia,2010,0,0,0
MDV,Maldives,EST,Estonia,2011,0,0,0
MDV,Maldives,EST,Estonia,2012,0,0,0
MDV,Maldives,EST,Estonia,2013,0,0,0
MDV,Maldives,EST,Estonia,2014,0,0,0
MDV,Maldives,EST,Estonia,2015,0,0,0
MDV,Maldives,EST,Estonia,2016,0,0,0
MDV,Maldives,EST,Estonia,2017,0,0,0
MDV,Maldives,SVN,Slovenia,2016,1,0,1
MDV,Maldives,SVN,Slovenia,2017,7,0,7
MLI,Mali,AUS,Australia,2008,2,0,2
MLI,Mali,AUS,Australia,2009,0,0,0
MLI,Mali,AUS,Australia,2010,3,0,3
MLI,Mali,AUS,Australia,2011,2,0,2
MLI,Mali,AUS,Australia,2012,4,0,4
MLI,Mali,AUS,Australia,2013,9,0,9
MLI,Mali,AUS,Australia,2014,6,0,6
MLI,Mali,AUS,Australia,2015,0,0,0
MLI,Mali,AUS,Australia,2016,0,0,0
MLI,Mali,AUS,Australia,2017,5,0,5
MLI,Mali,AUT,Austria,2008,11,12,-1
MLI,Mali,AUT,Austria,2009,17,13,4
MLI,Mali,AUT,Austria,2010,23,15,8
MLI,Mali,AUT,Austria,2011,27,18,9
MLI,Mali,AUT,Austria,2012,29,24,5
MLI,Mali,AUT,Austria,2013,26,14,12
MLI,Mali,AUT,Austria,2014,20,18,2
MLI,Mali,AUT,Austria,2015,27,25,2
MLI,Mali,AUT,Austria,2016,36,26,10
MLI,Mali,AUT,Austria,2017,15,18,-3
MLI,Mali,BEL,Belgium,2008,70,0,70
MLI,Mali,BEL,Belgium,2009,81,0,81
MLI,Mali,BEL,Belgium,2010,53,30,23
MLI,Mali,BEL,Belgium,2012,182,46,136
MLI,Mali,BEL,Belgium,2013,183,86,97
MLI,Mali,BEL,Belgium,2014,78,82,-4
MLI,Mali,BEL,Belgium,2015,68,64,4
MLI,Mali,BEL,Belgium,2016,65,38,27
MLI,Mali,BEL,Belgium,2017,63,18,45
MLI,Mali,CAN,Canada,2008,154,0,154
MLI,Mali,CAN,Canada,2009,164,0,164
MLI,Mali,CAN,Canada,2010,170,0,170
MLI,Mali,CAN,Canada,2011,155,0,155
MLI,Mali,CAN,Canada,2012,191,0,191
MLI,Mali,CAN,Canada,2013,190,0,190
MLI,Mali,CAN,Canada,2014,195,0,195
MLI,Mali,CAN,Canada,2015,190,0,190
MLI,Mali,CAN,Canada,2016,205,0,205
MLI,Mali,CAN,Canada,2017,180,0,180
MLI,Mali,CZE,Czech Republic,2008,4,0,4
MLI,Mali,CZE,Czech Republic,2009,1,0,1
MLI,Mali,CZE,Czech Republic,2011,2,0,2
MLI,Mali,CZE,Czech Republic,2012,1,1,0
MLI,Mali,CZE,Czech Republic,2014,1,0,1
MLI,Mali,CZE,Czech Republic,2015,2,0,2
MLI,Mali,CZE,Czech Republic,2016,18,0,18
MLI,Mali,CZE,Czech Republic,2017,2,0,2
MLI,Mali,DNK,Denmark,2008,1,1,0
MLI,Mali,DNK,Denmark,2009,0,0,0
MLI,Mali,DNK,Denmark,2010,3,2,1
MLI,Mali,DNK,Denmark,2012,1,2,-1
MLI,Mali,DNK,Denmark,2013,0,0,0
MLI,Mali,DNK,Denmark,2014,0,0,0
MLI,Mali,DNK,Denmark,2015,0,0,0
MLI,Mali,DNK,Denmark,2016,0,0,0
MLI,Mali,DNK,Denmark,2017,0,0,0
MLI,Mali,FIN,Finland,2008,0,0,0
MLI,Mali,FIN,Finland,2009,0,0,0
MLI,Mali,FIN,Finland,2010,1,0,1
MLI,Mali,FIN,Finland,2011,1,0,1
MLI,Mali,FIN,Finland,2012,2,0,2
MLI,Mali,FIN,Finland,2013,1,0,1
MLI,Mali,FIN,Finland,2014,9,0,9
MLI,Mali,FIN,Finland,2015,9,0,9
MLI,Mali,FIN,Finland,2016,2,0,2
MLI,Mali,FIN,Finland,2017,3,0,3
MLI,Mali,FRA,France,2008,4721,0,4721
MLI,Mali,FRA,France,2009,5684,0,5684
MLI,Mali,FRA,France,2010,4925,0,4925
MLI,Mali,FRA,France,2011,4635,0,4635
MLI,Mali,FRA,France,2012,3550,0,3550
MLI,Mali,FRA,France,2013,3891,0,3891
MLI,Mali,FRA,France,2014,4080,0,4080
MLI,Mali,FRA,France,2015,3539,0,3539
MLI,Mali,FRA,France,2016,3803,0,3803
MLI,Mali,FRA,France,2017,3688,0,3688
MLI,Mali,DEU,Germany,2008,57,86,-29
MLI,Mali,DEU,Germany,2009,77,68,9
MLI,Mali,DEU,Germany,2010,118,73,45
MLI,Mali,DEU,Germany,2011,100,77,23
MLI,Mali,DEU,Germany,2012,301,69,232
MLI,Mali,DEU,Germany,2013,774,173,601
MLI,Mali,DEU,Germany,2014,739,357,382
MLI,Mali,DEU,Germany,2015,1411,414,997
MLI,Mali,DEU,Germany,2016,1414,810,604
MLI,Mali,DEU,Germany,2017,632,1073,-441
MLI,Mali,HUN,Hungary,2008,0,0,0
MLI,Mali,HUN,Hungary,2009,1,0,1
MLI,Mali,HUN,Hungary,2010,1,1,0
MLI,Mali,HUN,Hungary,2011,0,0,0
MLI,Mali,HUN,Hungary,2012,4,0,4
MLI,Mali,HUN,Hungary,2013,2,0,2
MLI,Mali,HUN,Hungary,2014,1,0,1
MLI,Mali,HUN,Hungary,2015,3,0,3
MLI,Mali,HUN,Hungary,2016,3,0,3
MLI,Mali,HUN,Hungary,2017,2,0,2
MLI,Mali,ISL,Iceland,2008,1,0,1
MLI,Mali,ISL,Iceland,2009,0,0,0
MLI,Mali,ISL,Iceland,2010,0,0,0
MLI,Mali,ISL,Iceland,2011,0,0,0
MLI,Mali,ISL,Iceland,2012,0,0,0
MLI,Mali,ISL,Iceland,2013,0,0,0
MLI,Mali,ISL,Iceland,2014,0,0,0
MLI,Mali,ISL,Iceland,2015,2,0,2
MLI,Mali,ISL,Iceland,2016,0,0,0
MLI,Mali,ISL,Iceland,2017,1,0,1
MLI,Mali,ITA,Italy,2008,137,11,126
MLI,Mali,ITA,Italy,2009,140,12,128
MLI,Mali,ITA,Italy,2010,193,1,192
MLI,Mali,ITA,Italy,2011,216,10,206
MLI,Mali,ITA,Italy,2012,1472,9,1463
MLI,Mali,ITA,Italy,2013,1308,23,1285
MLI,Mali,ITA,Italy,2014,2035,28,2007
MLI,Mali,ITA,Italy,2015,4772,51,4721
MLI,Mali,ITA,Italy,2016,5211,0,5211
MLI,Mali,ITA,Italy,2017,6810,82,6728
MLI,Mali,JPN,Japan,2008,67,63,4
MLI,Mali,JPN,Japan,2009,43,39,4
MLI,Mali,JPN,Japan,2010,42,39,3
MLI,Mali,JPN,Japan,2011,43,39,4
MLI,Mali,JPN,Japan,2012,35,29,6
MLI,Mali,JPN,Japan,2013,64,51,13
MLI,Mali,JPN,Japan,2014,49,46,3
MLI,Mali,JPN,Japan,2015,55,39,16
MLI,Mali,JPN,Japan,2016,58,39,19
MLI,Mali,JPN,Japan,2017,68,47,21
MLI,Mali,KOR,Korea,2008,0,0,0
MLI,Mali,KOR,Korea,2009,2,5,-3
MLI,Mali,KOR,Korea,2010,3,0,3
MLI,Mali,KOR,Korea,2011,6,5,1
MLI,Mali,KOR,Korea,2012,7,10,-3
MLI,Mali,KOR,Korea,2013,5,0,5
MLI,Mali,KOR,Korea,2014,7,3,4
MLI,Mali,KOR,Korea,2015,5,6,-1
MLI,Mali,KOR,Korea,2016,88,5,83
MLI,Mali,KOR,Korea,2017,73,15,58
MLI,Mali,LUX,Luxembourg,2008,2,1,1
MLI,Mali,LUX,Luxembourg,2009,1,1,0
MLI,Mali,LUX,Luxembourg,2010,3,0,3
MLI,Mali,LUX,Luxembourg,2011,1,0,1
MLI,Mali,LUX,Luxembourg,2012,1,1,0
MLI,Mali,LUX,Luxembourg,2013,7,1,6
MLI,Mali,LUX,Luxembourg,2014,2,1,1
MLI,Mali,LUX,Luxembourg,2015,12,2,10
MLI,Mali,LUX,Luxembourg,2016,7,3,4
MLI,Mali,LUX,Luxembourg,2017,2,4,-2
MLI,Mali,MEX,Mexico,2009,1,0,1
MLI,Mali,MEX,Mexico,2010,1,0,1
MLI,Mali,MEX,Mexico,2011,1,0,1
MLI,Mali,MEX,Mexico,2012,0,0,0
MLI,Mali,MEX,Mexico,2013,2,0,2
MLI,Mali,MEX,Mexico,2014,4,0,4
MLI,Mali,MEX,Mexico,2015,1,0,1
MLI,Mali,MEX,Mexico,2017,4,0,4
MLI,Mali,NLD,Netherlands,2008,5,2,3
MLI,Mali,NLD,Netherlands,2009,10,1,9
MLI,Mali,NLD,Netherlands,2010,1,11,-10
MLI,Mali,NLD,Netherlands,2011,3,5,-2
MLI,Mali,NLD,Netherlands,2012,6,0,6
MLI,Mali,NLD,Netherlands,2013,8,3,5
MLI,Mali,NLD,Netherlands,2014,5,2,3
MLI,Mali,NLD,Netherlands,2015,12,1,11
MLI,Mali,NLD,Netherlands,2016,3,4,-1
MLI,Mali,NLD,Netherlands,2017,10,6,4
MLI,Mali,NZL,New Zealand,2008,0,0,0
MLI,Mali,NZL,New Zealand,2016,1,0,1
MLI,Mali,NOR,Norway,2008,3,4,-1
MLI,Mali,NOR,Norway,2009,2,4,-2
MLI,Mali,NOR,Norway,2010,2,0,2
MLI,Mali,NOR,Norway,2011,1,2,-1
MLI,Mali,NOR,Norway,2012,4,0,4
MLI,Mali,NOR,Norway,2013,4,0,4
MLI,Mali,NOR,Norway,2014,3,0,3
MLI,Mali,NOR,Norway,2015,7,3,4
MLI,Mali,NOR,Norway,2016,0,0,0
MLI,Mali,NOR,Norway,2017,1,2,-1
MLI,Mali,POL,Poland,2009,13,0,13
MLI,Mali,POL,Poland,2010,4,0,4
MLI,Mali,POL,Poland,2011,18,0,18
MLI,Mali,POL,Poland,2012,6,0,6
MLI,Mali,POL,Poland,2013,8,0,8
MLI,Mali,POL,Poland,2014,7,0,7
MLI,Mali,POL,Poland,2015,6,0,6
MLI,Mali,POL,Poland,2016,5,0,5
MLI,Mali,POL,Poland,2017,2,0,2
MLI,Mali,SVK,Slovak Republic,2008,1,0,1
MLI,Mali,ESP,Spain,2008,3504,1446,2058
MLI,Mali,ESP,Spain,2009,2099,1833,266
MLI,Mali,ESP,Spain,2010,1312,2277,-965
MLI,Mali,ESP,Spain,2011,1087,2993,-1906
MLI,Mali,ESP,Spain,2012,1072,2827,-1755
MLI,Mali,ESP,Spain,2013,1162,3021,-1859
MLI,Mali,ESP,Spain,2014,1245,1725,-480
MLI,Mali,ESP,Spain,2015,1150,1273,-123
MLI,Mali,ESP,Spain,2016,1166,1220,-54
MLI,Mali,ESP,Spain,2017,1115,1375,-260
MLI,Mali,SWE,Sweden,2008,15,0,15
MLI,Mali,SWE,Sweden,2009,13,1,12
MLI,Mali,SWE,Sweden,2010,5,1,4
MLI,Mali,SWE,Sweden,2011,4,2,2
MLI,Mali,SWE,Sweden,2012,10,1,9
MLI,Mali,SWE,Sweden,2013,15,3,12
MLI,Mali,SWE,Sweden,2014,12,2,10
MLI,Mali,SWE,Sweden,2015,8,2,6
MLI,Mali,SWE,Sweden,2016,6,2,4
MLI,Mali,SWE,Sweden,2017,9,0,9
MLI,Mali,CHE,Switzerland,2010,19,2,17
MLI,Mali,CHE,Switzerland,2011,24,7,17
MLI,Mali,CHE,Switzerland,2012,13,4,9
MLI,Mali,CHE,Switzerland,2013,21,0,21
MLI,Mali,CHE,Switzerland,2014,20,7,13
MLI,Mali,CHE,Switzerland,2015,22,7,15
MLI,Mali,CHE,Switzerland,2016,22,3,19
MLI,Mali,CHE,Switzerland,2017,15,9,6
MLI,Mali,TUR,Turkey,2010,15,0,15
MLI,Mali,TUR,Turkey,2016,140,103,37
MLI,Mali,TUR,Turkey,2017,0,0,0
MLI,Mali,USA,United States,2008,523,0,523
MLI,Mali,USA,United States,2009,576,0,576
MLI,Mali,USA,United States,2010,528,0,528
MLI,Mali,USA,United States,2011,629,0,629
MLI,Mali,USA,United States,2012,734,0,734
MLI,Mali,USA,United States,2013,667,0,667
MLI,Mali,USA,United States,2014,604,0,604
MLI,Mali,USA,United States,2015,587,0,587
MLI,Mali,USA,United States,2016,598,0,598
MLI,Mali,USA,United States,2017,544,0,544
MLI,Mali,CHL,Chile,2008,0,0,0
MLI,Mali,CHL,Chile,2009,0,0,0
MLI,Mali,CHL,Chile,2010,0,0,0
MLI,Mali,CHL,Chile,2011,1,0,1
MLI,Mali,CHL,Chile,2012,0,0,0
MLI,Mali,CHL,Chile,2013,0,0,0
MLI,Mali,CHL,Chile,2014,6,0,6
MLI,Mali,CHL,Chile,2015,1,0,1
MLI,Mali,CHL,Chile,2016,0,0,0
MLI,Mali,EST,Estonia,2008,0,0,0
MLI,Mali,EST,Estonia,2009,0,0,0
MLI,Mali,EST,Estonia,2010,0,0,0
MLI,Mali,EST,Estonia,2011,0,0,0
MLI,Mali,EST,Estonia,2012,0,0,0
MLI,Mali,EST,Estonia,2013,0,0,0
MLI,Mali,EST,Estonia,2014,0,0,0
MLI,Mali,EST,Estonia,2015,0,0,0
MLI,Mali,EST,Estonia,2016,0,0,0
MLI,Mali,EST,Estonia,2017,1,0,1
MLI,Mali,SVN,Slovenia,2013,1,0,1
MLI,Mali,SVN,Slovenia,2017,1,0,1
MLT,Malta,AUS,Australia,2008,116,74,42
MLT,Malta,AUS,Australia,2009,75,105,-30
MLT,Malta,AUS,Australia,2010,50,95,-45
MLT,Malta,AUS,Australia,2011,57,85,-28
MLT,Malta,AUS,Australia,2012,57,61,-4
MLT,Malta,AUS,Australia,2013,60,103,-43
MLT,Malta,AUS,Australia,2014,34,91,-57
MLT,Malta,AUS,Australia,2015,47,100,-53
MLT,Malta,AUS,Australia,2016,42,100,-58
MLT,Malta,AUS,Australia,2017,25,0,25
MLT,Malta,AUT,Austria,2008,15,6,9
MLT,Malta,AUT,Austria,2009,12,11,1
MLT,Malta,AUT,Austria,2010,7,4,3
MLT,Malta,AUT,Austria,2011,12,6,6
MLT,Malta,AUT,Austria,2012,11,9,2
MLT,Malta,AUT,Austria,2013,4,9,-5
MLT,Malta,AUT,Austria,2014,11,9,2
MLT,Malta,AUT,Austria,2015,7,6,1
MLT,Malta,AUT,Austria,2016,10,8,2
MLT,Malta,AUT,Austria,2017,20,7,13
MLT,Malta,BEL,Belgium,2008,87,0,87
MLT,Malta,BEL,Belgium,2009,54,0,54
MLT,Malta,BEL,Belgium,2010,74,26,48
MLT,Malta,BEL,Belgium,2012,50,45,5
MLT,Malta,BEL,Belgium,2013,51,48,3
MLT,Malta,BEL,Belgium,2014,35,24,11
MLT,Malta,BEL,Belgium,2015,32,34,-2
MLT,Malta,BEL,Belgium,2016,34,29,5
MLT,Malta,BEL,Belgium,2017,58,20,38
MLT,Malta,CAN,Canada,2008,21,0,21
MLT,Malta,CAN,Canada,2009,18,0,18
MLT,Malta,CAN,Canada,2010,17,0,17
MLT,Malta,CAN,Canada,2011,8,0,8
MLT,Malta,CAN,Canada,2012,9,0,9
MLT,Malta,CAN,Canada,2013,4,0,4
MLT,Malta,CAN,Canada,2014,9,0,9
MLT,Malta,CAN,Canada,2015,10,0,10
MLT,Malta,CAN,Canada,2016,5,0,5
MLT,Malta,CAN,Canada,2017,10,0,10
MLT,Malta,CZE,Czech Republic,2009,3,1,2
MLT,Malta,CZE,Czech Republic,2012,1,0,1
MLT,Malta,CZE,Czech Republic,2013,5,1,4
MLT,Malta,CZE,Czech Republic,2014,2,0,2
MLT,Malta,CZE,Czech Republic,2015,3,0,3
MLT,Malta,CZE,Czech Republic,2016,1,0,1
MLT,Malta,CZE,Czech Republic,2017,3,0,3
MLT,Malta,DNK,Denmark,2008,8,3,5
MLT,Malta,DNK,Denmark,2009,9,6,3
MLT,Malta,DNK,Denmark,2010,7,10,-3
MLT,Malta,DNK,Denmark,2011,5,9,-4
MLT,Malta,DNK,Denmark,2012,6,6,0
MLT,Malta,DNK,Denmark,2013,9,8,1
MLT,Malta,DNK,Denmark,2014,11,8,3
MLT,Malta,DNK,Denmark,2015,8,9,-1
MLT,Malta,DNK,Denmark,2016,10,12,-2
MLT,Malta,DNK,Denmark,2017,13,7,6
MLT,Malta,FIN,Finland,2008,5,0,5
MLT,Malta,FIN,Finland,2009,0,2,-2
MLT,Malta,FIN,Finland,2010,0,1,-1
MLT,Malta,FIN,Finland,2011,1,0,1
MLT,Malta,FIN,Finland,2012,3,1,2
MLT,Malta,FIN,Finland,2013,1,1,0
MLT,Malta,FIN,Finland,2014,6,0,6
MLT,Malta,FIN,Finland,2015,2,2,0
MLT,Malta,FIN,Finland,2016,0,0,0
MLT,Malta,FIN,Finland,2017,2,1,1
MLT,Malta,FRA,France,2008,0,0,0
MLT,Malta,FRA,France,2009,0,0,0
MLT,Malta,FRA,France,2010,0,0,0
MLT,Malta,FRA,France,2011,0,0,0
MLT,Malta,FRA,France,2012,0,0,0
MLT,Malta,FRA,France,2013,18,0,18
MLT,Malta,FRA,France,2014,10,0,10
MLT,Malta,FRA,France,2015,0,0,0
MLT,Malta,FRA,France,2016,39,0,39
MLT,Malta,FRA,France,2017,6,0,6
MLT,Malta,DEU,Germany,2008,66,57,9
MLT,Malta,DEU,Germany,2009,68,55,13
MLT,Malta,DEU,Germany,2010,51,48,3
MLT,Malta,DEU,Germany,2011,103,57,46
MLT,Malta,DEU,Germany,2012,94,66,28
MLT,Malta,DEU,Germany,2013,102,72,30
MLT,Malta,DEU,Germany,2014,92,69,23
MLT,Malta,DEU,Germany,2015,95,75,20
MLT,Malta,DEU,Germany,2016,90,79,11
MLT,Malta,DEU,Germany,2017,105,66,39
MLT,Malta,HUN,Hungary,2008,5,0,5
MLT,Malta,HUN,Hungary,2009,6,1,5
MLT,Malta,HUN,Hungary,2010,6,0,6
MLT,Malta,HUN,Hungary,2011,10,0,10
MLT,Malta,HUN,Hungary,2012,7,0,7
MLT,Malta,HUN,Hungary,2013,7,0,7
MLT,Malta,HUN,Hungary,2014,16,2,14
MLT,Malta,HUN,Hungary,2015,8,6,2
MLT,Malta,HUN,Hungary,2016,7,7,0
MLT,Malta,HUN,Hungary,2017,14,0,14
MLT,Malta,ISL,Iceland,2008,0,0,0
MLT,Malta,ISL,Iceland,2009,0,2,-2
MLT,Malta,ISL,Iceland,2010,1,0,1
MLT,Malta,ISL,Iceland,2011,0,1,-1
MLT,Malta,ISL,Iceland,2012,1,1,0
MLT,Malta,ISL,Iceland,2013,1,0,1
MLT,Malta,ISL,Iceland,2014,8,0,8
MLT,Malta,ISL,Iceland,2015,2,7,-5
MLT,Malta,ISL,Iceland,2016,0,1,-1
MLT,Malta,ISL,Iceland,2017,2,1,1
MLT,Malta,ITA,Italy,2008,77,9,68
MLT,Malta,ITA,Italy,2009,55,12,43
MLT,Malta,ITA,Italy,2010,62,10,52
MLT,Malta,ITA,Italy,2011,61,11,50
MLT,Malta,ITA,Italy,2012,31,8,23
MLT,Malta,ITA,Italy,2013,35,18,17
MLT,Malta,ITA,Italy,2014,42,16,26
MLT,Malta,ITA,Italy,2015,35,27,8
MLT,Malta,ITA,Italy,2016,37,0,37
MLT,Malta,ITA,Italy,2017,39,15,24
MLT,Malta,JPN,Japan,2008,6,5,1
MLT,Malta,JPN,Japan,2009,11,9,2
MLT,Malta,JPN,Japan,2010,6,5,1
MLT,Malta,JPN,Japan,2011,3,6,-3
MLT,Malta,JPN,Japan,2012,4,2,2
MLT,Malta,JPN,Japan,2013,3,4,-1
MLT,Malta,JPN,Japan,2014,9,4,5
MLT,Malta,JPN,Japan,2015,3,4,-1
MLT,Malta,JPN,Japan,2016,6,4,2
MLT,Malta,JPN,Japan,2017,4,3,1
MLT,Malta,KOR,Korea,2008,0,1,-1
MLT,Malta,KOR,Korea,2009,0,0,0
MLT,Malta,KOR,Korea,2010,1,0,1
MLT,Malta,KOR,Korea,2011,1,4,-3
MLT,Malta,KOR,Korea,2012,6,3,3
MLT,Malta,KOR,Korea,2013,1,0,1
MLT,Malta,KOR,Korea,2014,0,0,0
MLT,Malta,KOR,Korea,2015,1,1,0
MLT,Malta,KOR,Korea,2016,1,0,1
MLT,Malta,KOR,Korea,2017,2,5,-3
MLT,Malta,LUX,Luxembourg,2008,30,26,4
MLT,Malta,LUX,Luxembourg,2009,32,26,6
MLT,Malta,LUX,Luxembourg,2010,34,14,20
MLT,Malta,LUX,Luxembourg,2011,21,15,6
MLT,Malta,LUX,Luxembourg,2012,18,12,6
MLT,Malta,LUX,Luxembourg,2013,23,42,-19
MLT,Malta,LUX,Luxembourg,2014,26,17,9
MLT,Malta,LUX,Luxembourg,2015,24,14,10
MLT,Malta,LUX,Luxembourg,2016,24,15,9
MLT,Malta,LUX,Luxembourg,2017,17,15,2
MLT,Malta,MEX,Mexico,2011,3,0,3
MLT,Malta,MEX,Mexico,2012,1,0,1
MLT,Malta,MEX,Mexico,2013,0,0,0
MLT,Malta,MEX,Mexico,2014,3,0,3
MLT,Malta,MEX,Mexico,2015,2,0,2
MLT,Malta,NLD,Netherlands,2008,33,11,22
MLT,Malta,NLD,Netherlands,2009,28,25,3
MLT,Malta,NLD,Netherlands,2010,41,21,20
MLT,Malta,NLD,Netherlands,2011,40,33,7
MLT,Malta,NLD,Netherlands,2012,36,31,5
MLT,Malta,NLD,Netherlands,2013,44,29,15
MLT,Malta,NLD,Netherlands,2014,37,36,1
MLT,Malta,NLD,Netherlands,2015,46,38,8
MLT,Malta,NLD,Netherlands,2016,67,39,28
MLT,Malta,NLD,Netherlands,2017,73,35,38
MLT,Malta,NZL,New Zealand,2009,5,2,3
MLT,Malta,NZL,New Zealand,2010,9,2,7
MLT,Malta,NZL,New Zealand,2011,1,0,1
MLT,Malta,NZL,New Zealand,2012,3,1,2
MLT,Malta,NZL,New Zealand,2013,5,3,2
MLT,Malta,NZL,New Zealand,2014,3,2,1
MLT,Malta,NZL,New Zealand,2015,4,2,2
MLT,Malta,NZL,New Zealand,2016,9,0,9
MLT,Malta,NZL,New Zealand,2017,8,5,3
MLT,Malta,NOR,Norway,2008,4,0,4
MLT,Malta,NOR,Norway,2009,2,2,0
MLT,Malta,NOR,Norway,2010,10,2,8
MLT,Malta,NOR,Norway,2011,4,2,2
MLT,Malta,NOR,Norway,2012,4,3,1
MLT,Malta,NOR,Norway,2013,10,2,8
MLT,Malta,NOR,Norway,2014,8,2,6
MLT,Malta,NOR,Norway,2015,7,5,2
MLT,Malta,NOR,Norway,2016,3,1,2
MLT,Malta,NOR,Norway,2017,3,5,-2
MLT,Malta,POL,Poland,2008,3,0,3
MLT,Malta,POL,Poland,2009,3,0,3
MLT,Malta,POL,Poland,2010,0,0,0
MLT,Malta,POL,Poland,2011,5,0,5
MLT,Malta,POL,Poland,2012,2,0,2
MLT,Malta,POL,Poland,2013,5,0,5
MLT,Malta,POL,Poland,2014,5,0,5
MLT,Malta,POL,Poland,2015,2,0,2
MLT,Malta,POL,Poland,2016,8,0,8
MLT,Malta,POL,Poland,2017,5,0,5
MLT,Malta,SVK,Slovak Republic,2008,2,0,2
MLT,Malta,SVK,Slovak Republic,2009,1,0,1
MLT,Malta,SVK,Slovak Republic,2010,4,1,3
MLT,Malta,SVK,Slovak Republic,2011,1,0,1
MLT,Malta,SVK,Slovak Republic,2012,1,0,1
MLT,Malta,SVK,Slovak Republic,2013,1,0,1
MLT,Malta,SVK,Slovak Republic,2014,4,0,4
MLT,Malta,SVK,Slovak Republic,2015,2,0,2
MLT,Malta,SVK,Slovak Republic,2016,2,0,2
MLT,Malta,SVK,Slovak Republic,2017,1,0,1
MLT,Malta,ESP,Spain,2008,34,4,30
MLT,Malta,ESP,Spain,2009,27,18,9
MLT,Malta,ESP,Spain,2010,28,26,2
MLT,Malta,ESP,Spain,2011,46,9,37
MLT,Malta,ESP,Spain,2012,27,6,21
MLT,Malta,ESP,Spain,2013,15,11,4
MLT,Malta,ESP,Spain,2014,26,9,17
MLT,Malta,ESP,Spain,2015,19,7,12
MLT,Malta,ESP,Spain,2016,28,5,23
MLT,Malta,ESP,Spain,2017,49,25,24
MLT,Malta,SWE,Sweden,2008,11,2,9
MLT,Malta,SWE,Sweden,2009,19,3,16
MLT,Malta,SWE,Sweden,2010,13,8,5
MLT,Malta,SWE,Sweden,2011,19,11,8
MLT,Malta,SWE,Sweden,2012,14,5,9
MLT,Malta,SWE,Sweden,2013,12,6,6
MLT,Malta,SWE,Sweden,2014,13,7,6
MLT,Malta,SWE,Sweden,2015,17,3,14
MLT,Malta,SWE,Sweden,2016,19,9,10
MLT,Malta,SWE,Sweden,2017,11,3,8
MLT,Malta,CHE,Switzerland,2008,29,10,19
MLT,Malta,CHE,Switzerland,2009,26,14,12
MLT,Malta,CHE,Switzerland,2010,29,13,16
MLT,Malta,CHE,Switzerland,2011,21,16,5
MLT,Malta,CHE,Switzerland,2012,26,14,12
MLT,Malta,CHE,Switzerland,2013,24,16,8
MLT,Malta,CHE,Switzerland,2014,12,14,-2
MLT,Malta,CHE,Switzerland,2015,17,8,9
MLT,Malta,CHE,Switzerland,2016,32,12,20
MLT,Malta,CHE,Switzerland,2017,50,16,34
MLT,Malta,GBR,United Kingdom,2014,2000,0,2000
MLT,Malta,USA,United States,2008,66,0,66
MLT,Malta,USA,United States,2009,58,0,58
MLT,Malta,USA,United States,2010,74,0,74
MLT,Malta,USA,United States,2011,51,0,51
MLT,Malta,USA,United States,2012,62,0,62
MLT,Malta,USA,United States,2013,43,0,43
MLT,Malta,USA,United States,2014,39,0,39
MLT,Malta,USA,United States,2015,58,0,58
MLT,Malta,USA,United States,2016,65,0,65
MLT,Malta,USA,United States,2017,75,0,75
MLT,Malta,CHL,Chile,2008,0,0,0
MLT,Malta,CHL,Chile,2009,0,0,0
MLT,Malta,CHL,Chile,2010,0,0,0
MLT,Malta,CHL,Chile,2011,0,0,0
MLT,Malta,CHL,Chile,2012,2,0,2
MLT,Malta,CHL,Chile,2013,1,0,1
MLT,Malta,CHL,Chile,2014,0,0,0
MLT,Malta,CHL,Chile,2015,0,0,0
MLT,Malta,CHL,Chile,2016,1,0,1
MLT,Malta,EST,Estonia,2008,0,0,0
MLT,Malta,EST,Estonia,2009,0,0,0
MLT,Malta,EST,Estonia,2010,0,0,0
MLT,Malta,EST,Estonia,2011,0,0,0
MLT,Malta,EST,Estonia,2012,0,0,0
MLT,Malta,EST,Estonia,2013,0,0,0
MLT,Malta,EST,Estonia,2014,0,0,0
MLT,Malta,EST,Estonia,2015,1,0,1
MLT,Malta,EST,Estonia,2016,1,0,1
MLT,Malta,EST,Estonia,2017,4,0,4
MLT,Malta,SVN,Slovenia,2008,1,0,1
MLT,Malta,SVN,Slovenia,2009,1,0,1
MLT,Malta,SVN,Slovenia,2011,2,0,2
MLT,Malta,SVN,Slovenia,2012,3,0,3
MLT,Malta,SVN,Slovenia,2014,2,0,2
MLT,Malta,SVN,Slovenia,2015,1,0,1
MLT,Malta,SVN,Slovenia,2016,1,0,1
MLT,Malta,SVN,Slovenia,2017,1,0,1
MHL,Marshall Islands,AUS,Australia,2008,0,0,0
MHL,Marshall Islands,AUS,Australia,2009,0,0,0
MHL,Marshall Islands,AUS,Australia,2010,0,0,0
MHL,Marshall Islands,AUS,Australia,2011,1,0,1
MHL,Marshall Islands,AUS,Australia,2012,0,0,0
MHL,Marshall Islands,AUS,Australia,2013,0,0,0
MHL,Marshall Islands,AUS,Australia,2014,0,0,0
MHL,Marshall Islands,AUS,Australia,2015,0,0,0
MHL,Marshall Islands,AUS,Australia,2017,0,0,0
MHL,Marshall Islands,AUT,Austria,2008,0,0,0
MHL,Marshall Islands,AUT,Austria,2009,0,1,-1
MHL,Marshall Islands,AUT,Austria,2010,0,0,0
MHL,Marshall Islands,AUT,Austria,2011,0,0,0
MHL,Marshall Islands,AUT,Austria,2012,0,0,0
MHL,Marshall Islands,AUT,Austria,2013,0,0,0
MHL,Marshall Islands,AUT,Austria,2014,0,0,0
MHL,Marshall Islands,AUT,Austria,2015,0,0,0
MHL,Marshall Islands,AUT,Austria,2016,0,0,0
MHL,Marshall Islands,AUT,Austria,2017,0,0,0
MHL,Marshall Islands,BEL,Belgium,2010,0,0,0
MHL,Marshall Islands,CAN,Canada,2008,0,0,0
MHL,Marshall Islands,CAN,Canada,2009,0,0,0
MHL,Marshall Islands,CAN,Canada,2010,0,0,0
MHL,Marshall Islands,CAN,Canada,2011,0,0,0
MHL,Marshall Islands,CAN,Canada,2012,0,0,0
MHL,Marshall Islands,CAN,Canada,2013,0,0,0
MHL,Marshall Islands,CAN,Canada,2014,0,0,0
MHL,Marshall Islands,CAN,Canada,2015,0,0,0
MHL,Marshall Islands,CAN,Canada,2016,0,0,0
MHL,Marshall Islands,CAN,Canada,2017,0,0,0
MHL,Marshall Islands,DNK,Denmark,2013,0,0,0
MHL,Marshall Islands,DNK,Denmark,2014,0,0,0
MHL,Marshall Islands,DNK,Denmark,2015,0,0,0
MHL,Marshall Islands,DNK,Denmark,2016,0,0,0
MHL,Marshall Islands,DNK,Denmark,2017,0,0,0
MHL,Marshall Islands,FIN,Finland,2008,0,0,0
MHL,Marshall Islands,FIN,Finland,2009,0,0,0
MHL,Marshall Islands,FIN,Finland,2010,0,0,0
MHL,Marshall Islands,FIN,Finland,2011,0,0,0
MHL,Marshall Islands,FIN,Finland,2012,0,0,0
MHL,Marshall Islands,FIN,Finland,2013,0,0,0
MHL,Marshall Islands,FIN,Finland,2014,0,0,0
MHL,Marshall Islands,FIN,Finland,2015,0,0,0
MHL,Marshall Islands,FIN,Finland,2016,0,0,0
MHL,Marshall Islands,FIN,Finland,2017,0,0,0
MHL,Marshall Islands,FRA,France,2008,0,0,0
MHL,Marshall Islands,FRA,France,2009,0,0,0
MHL,Marshall Islands,FRA,France,2010,0,0,0
MHL,Marshall Islands,FRA,France,2011,1,0,1
MHL,Marshall Islands,FRA,France,2012,0,0,0
MHL,Marshall Islands,FRA,France,2013,0,0,0
MHL,Marshall Islands,FRA,France,2014,0,0,0
MHL,Marshall Islands,FRA,France,2015,2,0,2
MHL,Marshall Islands,FRA,France,2016,0,0,0
MHL,Marshall Islands,FRA,France,2017,5,0,5
MHL,Marshall Islands,DEU,Germany,2008,0,0,0
MHL,Marshall Islands,DEU,Germany,2009,0,1,-1
MHL,Marshall Islands,DEU,Germany,2010,0,1,-1
MHL,Marshall Islands,DEU,Germany,2011,0,0,0
MHL,Marshall Islands,DEU,Germany,2012,1,0,1
MHL,Marshall Islands,DEU,Germany,2013,0,0,0
MHL,Marshall Islands,DEU,Germany,2014,1,0,1
MHL,Marshall Islands,DEU,Germany,2015,0,0,0
MHL,Marshall Islands,DEU,Germany,2016,2,1,1
MHL,Marshall Islands,DEU,Germany,2017,0,0,0
MHL,Marshall Islands,HUN,Hungary,2008,0,0,0
MHL,Marshall Islands,HUN,Hungary,2009,0,0,0
MHL,Marshall Islands,HUN,Hungary,2010,0,0,0
MHL,Marshall Islands,HUN,Hungary,2011,0,0,0
MHL,Marshall Islands,HUN,Hungary,2012,0,0,0
MHL,Marshall Islands,HUN,Hungary,2013,0,0,0
MHL,Marshall Islands,HUN,Hungary,2014,0,0,0
MHL,Marshall Islands,HUN,Hungary,2015,0,0,0
MHL,Marshall Islands,HUN,Hungary,2016,0,0,0
MHL,Marshall Islands,HUN,Hungary,2017,0,0,0
MHL,Marshall Islands,ISL,Iceland,2016,0,0,0
MHL,Marshall Islands,ISL,Iceland,2017,0,0,0
MHL,Marshall Islands,ITA,Italy,2008,3,0,3
MHL,Marshall Islands,ITA,Italy,2009,3,0,3
MHL,Marshall Islands,ITA,Italy,2010,0,0,0
MHL,Marshall Islands,ITA,Italy,2011,1,0,1
MHL,Marshall Islands,ITA,Italy,2012,1,0,1
MHL,Marshall Islands,ITA,Italy,2013,1,0,1
MHL,Marshall Islands,ITA,Italy,2014,1,2,-1
MHL,Marshall Islands,ITA,Italy,2015,0,0,0
MHL,Marshall Islands,ITA,Italy,2016,0,0,0
MHL,Marshall Islands,ITA,Italy,2017,0,0,0
MHL,Marshall Islands,JPN,Japan,2008,34,31,3
MHL,Marshall Islands,JPN,Japan,2009,29,30,-1
MHL,Marshall Islands,JPN,Japan,2010,37,4,33
MHL,Marshall Islands,JPN,Japan,2011,22,21,1
MHL,Marshall Islands,JPN,Japan,2012,56,50,6
MHL,Marshall Islands,JPN,Japan,2013,54,55,-1
MHL,Marshall Islands,JPN,Japan,2014,57,59,-2
MHL,Marshall Islands,JPN,Japan,2015,80,79,1
MHL,Marshall Islands,JPN,Japan,2016,61,57,4
MHL,Marshall Islands,JPN,Japan,2017,56,49,7
MHL,Marshall Islands,KOR,Korea,2008,0,0,0
MHL,Marshall Islands,KOR,Korea,2009,1,1,0
MHL,Marshall Islands,KOR,Korea,2010,0,1,-1
MHL,Marshall Islands,KOR,Korea,2011,4,1,3
MHL,Marshall Islands,KOR,Korea,2012,11,2,9
MHL,Marshall Islands,KOR,Korea,2013,2,3,-1
MHL,Marshall Islands,KOR,Korea,2014,0,4,-4
MHL,Marshall Islands,KOR,Korea,2015,1,3,-2
MHL,Marshall Islands,KOR,Korea,2016,2,1,1
MHL,Marshall Islands,KOR,Korea,2017,1,1,0
MHL,Marshall Islands,LUX,Luxembourg,2008,0,0,0
MHL,Marshall Islands,LUX,Luxembourg,2009,0,0,0
MHL,Marshall Islands,LUX,Luxembourg,2010,0,0,0
MHL,Marshall Islands,LUX,Luxembourg,2011,0,0,0
MHL,Marshall Islands,LUX,Luxembourg,2012,0,0,0
MHL,Marshall Islands,LUX,Luxembourg,2013,0,0,0
MHL,Marshall Islands,LUX,Luxembourg,2014,0,0,0
MHL,Marshall Islands,LUX,Luxembourg,2015,0,0,0
MHL,Marshall Islands,LUX,Luxembourg,2016,0,0,0
MHL,Marshall Islands,LUX,Luxembourg,2017,0,0,0
MHL,Marshall Islands,MEX,Mexico,2012,0,0,0
MHL,Marshall Islands,MEX,Mexico,2013,0,0,0
MHL,Marshall Islands,MEX,Mexico,2014,0,0,0
MHL,Marshall Islands,NZL,New Zealand,2008,3,0,3
MHL,Marshall Islands,NZL,New Zealand,2009,0,2,-2
MHL,Marshall Islands,NZL,New Zealand,2010,1,0,1
MHL,Marshall Islands,NZL,New Zealand,2011,1,2,-1
MHL,Marshall Islands,NZL,New Zealand,2012,3,1,2
MHL,Marshall Islands,NZL,New Zealand,2015,2,0,2
MHL,Marshall Islands,NZL,New Zealand,2016,2,2,0
MHL,Marshall Islands,NZL,New Zealand,2017,1,3,-2
MHL,Marshall Islands,NOR,Norway,2008,0,0,0
MHL,Marshall Islands,NOR,Norway,2009,0,0,0
MHL,Marshall Islands,NOR,Norway,2010,0,0,0
MHL,Marshall Islands,NOR,Norway,2011,1,0,1
MHL,Marshall Islands,NOR,Norway,2012,0,0,0
MHL,Marshall Islands,NOR,Norway,2013,0,0,0
MHL,Marshall Islands,NOR,Norway,2014,0,0,0
MHL,Marshall Islands,NOR,Norway,2015,0,0,0
MHL,Marshall Islands,NOR,Norway,2016,1,0,1
MHL,Marshall Islands,NOR,Norway,2017,0,0,0
MHL,Marshall Islands,POL,Poland,2009,0,0,0
MHL,Marshall Islands,POL,Poland,2010,0,0,0
MHL,Marshall Islands,POL,Poland,2011,0,0,0
MHL,Marshall Islands,POL,Poland,2012,0,0,0
MHL,Marshall Islands,POL,Poland,2013,0,0,0
MHL,Marshall Islands,POL,Poland,2014,0,0,0
MHL,Marshall Islands,POL,Poland,2015,0,0,0
MHL,Marshall Islands,POL,Poland,2016,0,0,0
MHL,Marshall Islands,POL,Poland,2017,0,0,0
MHL,Marshall Islands,SVK,Slovak Republic,2008,1,0,1
MHL,Marshall Islands,ESP,Spain,2008,0,0,0
MHL,Marshall Islands,ESP,Spain,2009,0,0,0
MHL,Marshall Islands,ESP,Spain,2010,0,1,-1
MHL,Marshall Islands,ESP,Spain,2011,0,0,0
MHL,Marshall Islands,ESP,Spain,2012,0,0,0
MHL,Marshall Islands,ESP,Spain,2013,1,0,1
MHL,Marshall Islands,ESP,Spain,2014,0,0,0
MHL,Marshall Islands,ESP,Spain,2015,0,0,0
MHL,Marshall Islands,ESP,Spain,2016,0,0,0
MHL,Marshall Islands,SWE,Sweden,2008,0,0,0
MHL,Marshall Islands,SWE,Sweden,2009,0,0,0
MHL,Marshall Islands,SWE,Sweden,2010,0,0,0
MHL,Marshall Islands,SWE,Sweden,2011,0,0,0
MHL,Marshall Islands,SWE,Sweden,2012,0,0,0
MHL,Marshall Islands,SWE,Sweden,2013,0,0,0
MHL,Marshall Islands,SWE,Sweden,2014,0,0,0
MHL,Marshall Islands,SWE,Sweden,2015,0,0,0
MHL,Marshall Islands,CHE,Switzerland,2010,0,0,0
MHL,Marshall Islands,CHE,Switzerland,2011,0,0,0
MHL,Marshall Islands,CHE,Switzerland,2012,0,0,0
MHL,Marshall Islands,CHE,Switzerland,2013,0,0,0
MHL,Marshall Islands,USA,United States,2008,39,0,39
MHL,Marshall Islands,USA,United States,2009,48,0,48
MHL,Marshall Islands,USA,United States,2010,37,0,37
MHL,Marshall Islands,USA,United States,2011,38,0,38
MHL,Marshall Islands,USA,United States,2012,50,0,50
MHL,Marshall Islands,USA,United States,2013,46,0,46
MHL,Marshall Islands,USA,United States,2014,56,0,56
MHL,Marshall Islands,USA,United States,2015,32,0,32
MHL,Marshall Islands,USA,United States,2016,32,0,32
MHL,Marshall Islands,USA,United States,2017,23,0,23
MHL,Marshall Islands,CHL,Chile,2008,0,0,0
MHL,Marshall Islands,CHL,Chile,2009,0,0,0
MHL,Marshall Islands,CHL,Chile,2010,0,0,0
MHL,Marshall Islands,CHL,Chile,2011,0,0,0
MHL,Marshall Islands,CHL,Chile,2012,0,0,0
MHL,Marshall Islands,CHL,Chile,2013,0,0,0
MHL,Marshall Islands,CHL,Chile,2014,0,0,0
MHL,Marshall Islands,CHL,Chile,2015,0,0,0
MHL,Marshall Islands,CHL,Chile,2016,0,0,0
MHL,Marshall Islands,EST,Estonia,2008,0,0,0
MHL,Marshall Islands,EST,Estonia,2009,0,0,0
MHL,Marshall Islands,EST,Estonia,2010,0,0,0
MHL,Marshall Islands,EST,Estonia,2011,0,0,0
MHL,Marshall Islands,EST,Estonia,2012,0,0,0
MHL,Marshall Islands,EST,Estonia,2013,0,0,0
MHL,Marshall Islands,EST,Estonia,2014,0,0,0
MHL,Marshall Islands,EST,Estonia,2015,0,0,0
MHL,Marshall Islands,EST,Estonia,2016,0,0,0
MHL,Marshall Islands,EST,Estonia,2017,0,0,0
MRT,Mauritania,AUS,Australia,2008,89,0,89
MRT,Mauritania,AUS,Australia,2009,1,0,1
MRT,Mauritania,AUS,Australia,2010,1,0,1
MRT,Mauritania,AUS,Australia,2011,0,0,0
MRT,Mauritania,AUS,Australia,2012,1,0,1
MRT,Mauritania,AUS,Australia,2013,0,0,0
MRT,Mauritania,AUS,Australia,2014,0,0,0
MRT,Mauritania,AUS,Australia,2015,0,0,0
MRT,Mauritania,AUS,Australia,2016,0,0,0
MRT,Mauritania,AUS,Australia,2017,3,0,3
MRT,Mauritania,AUT,Austria,2008,3,8,-5
MRT,Mauritania,AUT,Austria,2009,7,2,5
MRT,Mauritania,AUT,Austria,2010,7,7,0
MRT,Mauritania,AUT,Austria,2011,5,7,-2
MRT,Mauritania,AUT,Austria,2012,8,4,4
MRT,Mauritania,AUT,Austria,2013,6,4,2
MRT,Mauritania,AUT,Austria,2014,4,5,-1
MRT,Mauritania,AUT,Austria,2015,6,5,1
MRT,Mauritania,AUT,Austria,2016,5,4,1
MRT,Mauritania,AUT,Austria,2017,9,5,4
MRT,Mauritania,BEL,Belgium,2008,33,0,33
MRT,Mauritania,BEL,Belgium,2009,36,0,36
MRT,Mauritania,BEL,Belgium,2010,38,7,31
MRT,Mauritania,BEL,Belgium,2012,197,51,146
MRT,Mauritania,BEL,Belgium,2013,166,118,48
MRT,Mauritania,BEL,Belgium,2014,109,139,-30
MRT,Mauritania,BEL,Belgium,2015,145,107,38
MRT,Mauritania,BEL,Belgium,2016,92,52,40
MRT,Mauritania,BEL,Belgium,2017,111,27,84
MRT,Mauritania,CAN,Canada,2008,112,0,112
MRT,Mauritania,CAN,Canada,2009,83,0,83
MRT,Mauritania,CAN,Canada,2010,74,0,74
MRT,Mauritania,CAN,Canada,2011,54,0,54
MRT,Mauritania,CAN,Canada,2012,77,0,77
MRT,Mauritania,CAN,Canada,2013,57,0,57
MRT,Mauritania,CAN,Canada,2014,84,0,84
MRT,Mauritania,CAN,Canada,2015,104,0,104
MRT,Mauritania,CAN,Canada,2016,55,0,55
MRT,Mauritania,CAN,Canada,2017,70,0,70
MRT,Mauritania,CZE,Czech Republic,2010,1,0,1
MRT,Mauritania,DNK,Denmark,2008,0,1,-1
MRT,Mauritania,DNK,Denmark,2009,0,0,0
MRT,Mauritania,DNK,Denmark,2012,0,0,0
MRT,Mauritania,DNK,Denmark,2013,1,0,1
MRT,Mauritania,DNK,Denmark,2014,2,0,2
MRT,Mauritania,DNK,Denmark,2015,0,0,0
MRT,Mauritania,DNK,Denmark,2016,0,0,0
MRT,Mauritania,DNK,Denmark,2017,0,0,0
MRT,Mauritania,FIN,Finland,2008,1,0,1
MRT,Mauritania,FIN,Finland,2009,0,0,0
MRT,Mauritania,FIN,Finland,2010,0,0,0
MRT,Mauritania,FIN,Finland,2011,12,0,12
MRT,Mauritania,FIN,Finland,2012,1,0,1
MRT,Mauritania,FIN,Finland,2013,0,0,0
MRT,Mauritania,FIN,Finland,2014,6,0,6
MRT,Mauritania,FIN,Finland,2015,2,0,2
MRT,Mauritania,FIN,Finland,2016,1,0,1
MRT,Mauritania,FIN,Finland,2017,1,0,1
MRT,Mauritania,FRA,France,2008,886,0,886
MRT,Mauritania,FRA,France,2009,1000,0,1000
MRT,Mauritania,FRA,France,2010,954,0,954
MRT,Mauritania,FRA,France,2011,963,0,963
MRT,Mauritania,FRA,France,2012,932,0,932
MRT,Mauritania,FRA,France,2013,870,0,870
MRT,Mauritania,FRA,France,2014,767,0,767
MRT,Mauritania,FRA,France,2015,599,0,599
MRT,Mauritania,FRA,France,2016,679,0,679
MRT,Mauritania,FRA,France,2017,694,0,694
MRT,Mauritania,DEU,Germany,2008,61,79,-18
MRT,Mauritania,DEU,Germany,2009,76,99,-23
MRT,Mauritania,DEU,Germany,2010,82,70,12
MRT,Mauritania,DEU,Germany,2011,58,59,-1
MRT,Mauritania,DEU,Germany,2012,82,54,28
MRT,Mauritania,DEU,Germany,2013,184,54,130
MRT,Mauritania,DEU,Germany,2014,158,93,65
MRT,Mauritania,DEU,Germany,2015,246,111,135
MRT,Mauritania,DEU,Germany,2016,215,159,56
MRT,Mauritania,DEU,Germany,2017,127,130,-3
MRT,Mauritania,HUN,Hungary,2008,2,0,2
MRT,Mauritania,HUN,Hungary,2009,0,0,0
MRT,Mauritania,HUN,Hungary,2010,0,0,0
MRT,Mauritania,HUN,Hungary,2011,0,0,0
MRT,Mauritania,HUN,Hungary,2012,1,0,1
MRT,Mauritania,HUN,Hungary,2013,0,0,0
MRT,Mauritania,HUN,Hungary,2014,2,0,2
MRT,Mauritania,HUN,Hungary,2015,1,0,1
MRT,Mauritania,HUN,Hungary,2016,0,0,0
MRT,Mauritania,HUN,Hungary,2017,0,0,0
MRT,Mauritania,ISL,Iceland,2008,0,0,0
MRT,Mauritania,ISL,Iceland,2009,0,0,0
MRT,Mauritania,ISL,Iceland,2010,0,0,0
MRT,Mauritania,ISL,Iceland,2011,0,0,0
MRT,Mauritania,ISL,Iceland,2012,0,0,0
MRT,Mauritania,ISL,Iceland,2013,0,0,0
MRT,Mauritania,ISL,Iceland,2014,0,0,0
MRT,Mauritania,ISL,Iceland,2015,1,0,1
MRT,Mauritania,ISL,Iceland,2016,0,0,0
MRT,Mauritania,ISL,Iceland,2017,0,0,0
MRT,Mauritania,ITA,Italy,2008,52,3,49
MRT,Mauritania,ITA,Italy,2009,58,3,55
MRT,Mauritania,ITA,Italy,2010,103,2,101
MRT,Mauritania,ITA,Italy,2011,56,1,55
MRT,Mauritania,ITA,Italy,2012,90,2,88
MRT,Mauritania,ITA,Italy,2013,96,3,93
MRT,Mauritania,ITA,Italy,2014,57,8,49
MRT,Mauritania,ITA,Italy,2015,76,3,73
MRT,Mauritania,ITA,Italy,2016,75,0,75
MRT,Mauritania,ITA,Italy,2017,73,3,70
MRT,Mauritania,JPN,Japan,2008,43,45,-2
MRT,Mauritania,JPN,Japan,2009,12,11,1
MRT,Mauritania,JPN,Japan,2010,19,18,1
MRT,Mauritania,JPN,Japan,2011,30,23,7
MRT,Mauritania,JPN,Japan,2012,28,27,1
MRT,Mauritania,JPN,Japan,2013,34,32,2
MRT,Mauritania,JPN,Japan,2014,23,24,-1
MRT,Mauritania,JPN,Japan,2015,27,22,5
MRT,Mauritania,JPN,Japan,2016,37,28,9
MRT,Mauritania,JPN,Japan,2017,30,26,4
MRT,Mauritania,KOR,Korea,2008,2,0,2
MRT,Mauritania,KOR,Korea,2009,1,0,1
MRT,Mauritania,KOR,Korea,2010,1,0,1
MRT,Mauritania,KOR,Korea,2011,2,1,1
MRT,Mauritania,KOR,Korea,2012,6,9,-3
MRT,Mauritania,KOR,Korea,2013,3,1,2
MRT,Mauritania,KOR,Korea,2014,6,3,3
MRT,Mauritania,KOR,Korea,2015,2,2,0
MRT,Mauritania,KOR,Korea,2016,4,2,2
MRT,Mauritania,KOR,Korea,2017,4,3,1
MRT,Mauritania,LUX,Luxembourg,2008,0,0,0
MRT,Mauritania,LUX,Luxembourg,2009,2,0,2
MRT,Mauritania,LUX,Luxembourg,2010,2,0,2
MRT,Mauritania,LUX,Luxembourg,2011,0,3,-3
MRT,Mauritania,LUX,Luxembourg,2012,0,0,0
MRT,Mauritania,LUX,Luxembourg,2013,4,0,4
MRT,Mauritania,LUX,Luxembourg,2014,0,1,-1
MRT,Mauritania,LUX,Luxembourg,2015,0,2,-2
MRT,Mauritania,LUX,Luxembourg,2016,1,1,0
MRT,Mauritania,LUX,Luxembourg,2017,1,1,0
MRT,Mauritania,MEX,Mexico,2012,0,0,0
MRT,Mauritania,MEX,Mexico,2013,0,0,0
MRT,Mauritania,MEX,Mexico,2014,0,0,0
MRT,Mauritania,MEX,Mexico,2017,1,0,1
MRT,Mauritania,NLD,Netherlands,2008,2,0,2
MRT,Mauritania,NLD,Netherlands,2010,2,2,0
MRT,Mauritania,NLD,Netherlands,2011,2,-1,3
MRT,Mauritania,NLD,Netherlands,2012,1,0,1
MRT,Mauritania,NLD,Netherlands,2013,3,3,0
MRT,Mauritania,NLD,Netherlands,2014,5,0,5
MRT,Mauritania,NLD,Netherlands,2015,5,3,2
MRT,Mauritania,NLD,Netherlands,2016,4,2,2
MRT,Mauritania,NLD,Netherlands,2017,2,0,2
MRT,Mauritania,NZL,New Zealand,2015,1,0,1
MRT,Mauritania,NOR,Norway,2008,3,0,3
MRT,Mauritania,NOR,Norway,2009,4,3,1
MRT,Mauritania,NOR,Norway,2010,2,0,2
MRT,Mauritania,NOR,Norway,2011,3,4,-1
MRT,Mauritania,NOR,Norway,2012,2,0,2
MRT,Mauritania,NOR,Norway,2013,7,2,5
MRT,Mauritania,NOR,Norway,2014,2,2,0
MRT,Mauritania,NOR,Norway,2015,2,3,-1
MRT,Mauritania,NOR,Norway,2016,8,0,8
MRT,Mauritania,NOR,Norway,2017,8,0,8
MRT,Mauritania,POL,Poland,2009,4,0,4
MRT,Mauritania,POL,Poland,2010,2,0,2
MRT,Mauritania,POL,Poland,2011,3,0,3
MRT,Mauritania,POL,Poland,2012,3,0,3
MRT,Mauritania,POL,Poland,2013,1,0,1
MRT,Mauritania,POL,Poland,2014,0,0,0
MRT,Mauritania,POL,Poland,2015,2,0,2
MRT,Mauritania,POL,Poland,2016,0,0,0
MRT,Mauritania,POL,Poland,2017,0,0,0
MRT,Mauritania,SVK,Slovak Republic,2008,0,0,0
MRT,Mauritania,ESP,Spain,2008,1612,593,1019
MRT,Mauritania,ESP,Spain,2009,869,952,-83
MRT,Mauritania,ESP,Spain,2010,672,1116,-444
MRT,Mauritania,ESP,Spain,2011,622,1306,-684
MRT,Mauritania,ESP,Spain,2012,489,1350,-861
MRT,Mauritania,ESP,Spain,2013,489,1116,-627
MRT,Mauritania,ESP,Spain,2014,549,725,-176
MRT,Mauritania,ESP,Spain,2015,690,724,-34
MRT,Mauritania,ESP,Spain,2016,720,480,240
MRT,Mauritania,ESP,Spain,2017,455,773,-318
MRT,Mauritania,SWE,Sweden,2008,0,0,0
MRT,Mauritania,SWE,Sweden,2009,4,0,4
MRT,Mauritania,SWE,Sweden,2010,3,0,3
MRT,Mauritania,SWE,Sweden,2011,6,0,6
MRT,Mauritania,SWE,Sweden,2012,3,0,3
MRT,Mauritania,SWE,Sweden,2013,9,1,8
MRT,Mauritania,SWE,Sweden,2014,3,0,3
MRT,Mauritania,SWE,Sweden,2015,5,1,4
MRT,Mauritania,SWE,Sweden,2016,0,0,0
MRT,Mauritania,SWE,Sweden,2017,1,0,1
MRT,Mauritania,CHE,Switzerland,2010,1,3,-2
MRT,Mauritania,CHE,Switzerland,2011,4,5,-1
MRT,Mauritania,CHE,Switzerland,2012,5,0,5
MRT,Mauritania,CHE,Switzerland,2013,5,1,4
MRT,Mauritania,CHE,Switzerland,2014,6,1,5
MRT,Mauritania,CHE,Switzerland,2015,4,4,0
MRT,Mauritania,CHE,Switzerland,2016,5,0,5
MRT,Mauritania,CHE,Switzerland,2017,11,0,11
MRT,Mauritania,TUR,Turkey,2010,6,0,6
MRT,Mauritania,USA,United States,2008,844,0,844
MRT,Mauritania,USA,United States,2009,597,0,597
MRT,Mauritania,USA,United States,2010,495,0,495
MRT,Mauritania,USA,United States,2011,393,0,393
MRT,Mauritania,USA,United States,2012,410,0,410
MRT,Mauritania,USA,United States,2013,354,0,354
MRT,Mauritania,USA,United States,2014,320,0,320
MRT,Mauritania,USA,United States,2015,298,0,298
MRT,Mauritania,USA,United States,2016,317,0,317
MRT,Mauritania,USA,United States,2017,287,0,287
MRT,Mauritania,CHL,Chile,2008,0,0,0
MRT,Mauritania,CHL,Chile,2009,0,0,0
MRT,Mauritania,CHL,Chile,2010,0,0,0
MRT,Mauritania,CHL,Chile,2011,0,0,0
MRT,Mauritania,CHL,Chile,2012,0,0,0
MRT,Mauritania,CHL,Chile,2013,0,0,0
MRT,Mauritania,CHL,Chile,2014,0,0,0
MRT,Mauritania,CHL,Chile,2015,1,0,1
MRT,Mauritania,CHL,Chile,2016,0,0,0
MRT,Mauritania,EST,Estonia,2008,0,0,0
MRT,Mauritania,EST,Estonia,2009,0,0,0
MRT,Mauritania,EST,Estonia,2010,0,0,0
MRT,Mauritania,EST,Estonia,2011,0,0,0
MRT,Mauritania,EST,Estonia,2012,0,0,0
MRT,Mauritania,EST,Estonia,2013,0,0,0
MRT,Mauritania,EST,Estonia,2014,0,0,0
MRT,Mauritania,EST,Estonia,2015,0,0,0
MRT,Mauritania,EST,Estonia,2016,0,0,0
MRT,Mauritania,EST,Estonia,2017,0,0,0
MUS,Mauritius,AUS,Australia,2008,680,70,610
MUS,Mauritius,AUS,Australia,2009,778,82,696
MUS,Mauritius,AUS,Australia,2010,568,75,493
MUS,Mauritius,AUS,Australia,2011,774,95,679
MUS,Mauritius,AUS,Australia,2012,886,73,813
MUS,Mauritius,AUS,Australia,2013,1133,78,1055
MUS,Mauritius,AUS,Australia,2014,967,101,866
MUS,Mauritius,AUS,Australia,2015,756,100,656
MUS,Mauritius,AUS,Australia,2016,611,100,511
MUS,Mauritius,AUS,Australia,2017,495,0,495
MUS,Mauritius,AUT,Austria,2008,13,3,10
MUS,Mauritius,AUT,Austria,2009,8,6,2
MUS,Mauritius,AUT,Austria,2010,2,9,-7
MUS,Mauritius,AUT,Austria,2011,9,6,3
MUS,Mauritius,AUT,Austria,2012,7,6,1
MUS,Mauritius,AUT,Austria,2013,8,3,5
MUS,Mauritius,AUT,Austria,2014,8,5,3
MUS,Mauritius,AUT,Austria,2015,3,3,0
MUS,Mauritius,AUT,Austria,2016,8,2,6
MUS,Mauritius,AUT,Austria,2017,5,5,0
MUS,Mauritius,BEL,Belgium,2008,78,0,78
MUS,Mauritius,BEL,Belgium,2009,99,0,99
MUS,Mauritius,BEL,Belgium,2010,107,29,78
MUS,Mauritius,BEL,Belgium,2011,106,0,106
MUS,Mauritius,BEL,Belgium,2012,104,29,75
MUS,Mauritius,BEL,Belgium,2013,112,36,76
MUS,Mauritius,BEL,Belgium,2014,77,33,44
MUS,Mauritius,BEL,Belgium,2015,68,26,42
MUS,Mauritius,BEL,Belgium,2016,74,37,37
MUS,Mauritius,BEL,Belgium,2017,34,24,10
MUS,Mauritius,CAN,Canada,2008,714,0,714
MUS,Mauritius,CAN,Canada,2009,872,0,872
MUS,Mauritius,CAN,Canada,2010,1455,0,1455
MUS,Mauritius,CAN,Canada,2011,1146,0,1146
MUS,Mauritius,CAN,Canada,2012,798,0,798
MUS,Mauritius,CAN,Canada,2013,1203,0,1203
MUS,Mauritius,CAN,Canada,2014,419,0,419
MUS,Mauritius,CAN,Canada,2015,718,0,718
MUS,Mauritius,CAN,Canada,2016,550,0,550
MUS,Mauritius,CAN,Canada,2017,725,0,725
MUS,Mauritius,CZE,Czech Republic,2008,1,0,1
MUS,Mauritius,CZE,Czech Republic,2009,5,0,5
MUS,Mauritius,CZE,Czech Republic,2010,1,0,1
MUS,Mauritius,CZE,Czech Republic,2011,3,0,3
MUS,Mauritius,CZE,Czech Republic,2012,1,3,-2
MUS,Mauritius,CZE,Czech Republic,2013,1,1,0
MUS,Mauritius,CZE,Czech Republic,2014,7,2,5
MUS,Mauritius,CZE,Czech Republic,2015,1,4,-3
MUS,Mauritius,CZE,Czech Republic,2016,9,0,9
MUS,Mauritius,CZE,Czech Republic,2017,10,0,10
MUS,Mauritius,DNK,Denmark,2008,9,0,9
MUS,Mauritius,DNK,Denmark,2009,4,0,4
MUS,Mauritius,DNK,Denmark,2010,3,2,1
MUS,Mauritius,DNK,Denmark,2011,3,1,2
MUS,Mauritius,DNK,Denmark,2012,2,4,-2
MUS,Mauritius,DNK,Denmark,2013,7,1,6
MUS,Mauritius,DNK,Denmark,2014,6,2,4
MUS,Mauritius,DNK,Denmark,2015,4,2,2
MUS,Mauritius,DNK,Denmark,2016,8,7,1
MUS,Mauritius,DNK,Denmark,2017,5,3,2
MUS,Mauritius,FIN,Finland,2008,0,0,0
MUS,Mauritius,FIN,Finland,2009,0,0,0
MUS,Mauritius,FIN,Finland,2010,3,0,3
MUS,Mauritius,FIN,Finland,2011,0,0,0
MUS,Mauritius,FIN,Finland,2012,3,0,3
MUS,Mauritius,FIN,Finland,2013,2,0,2
MUS,Mauritius,FIN,Finland,2014,4,0,4
MUS,Mauritius,FIN,Finland,2015,2,0,2
MUS,Mauritius,FIN,Finland,2016,2,1,1
MUS,Mauritius,FIN,Finland,2017,0,0,0
MUS,Mauritius,FRA,France,2008,776,0,776
MUS,Mauritius,FRA,France,2009,797,0,797
MUS,Mauritius,FRA,France,2010,807,0,807
MUS,Mauritius,FRA,France,2011,931,0,931
MUS,Mauritius,FRA,France,2012,858,0,858
MUS,Mauritius,FRA,France,2013,842,0,842
MUS,Mauritius,FRA,France,2014,969,0,969
MUS,Mauritius,FRA,France,2015,857,0,857
MUS,Mauritius,FRA,France,2016,930,0,930
MUS,Mauritius,FRA,France,2017,884,0,884
MUS,Mauritius,DEU,Germany,2008,49,50,-1
MUS,Mauritius,DEU,Germany,2009,55,55,0
MUS,Mauritius,DEU,Germany,2010,70,53,17
MUS,Mauritius,DEU,Germany,2011,79,41,38
MUS,Mauritius,DEU,Germany,2012,109,55,54
MUS,Mauritius,DEU,Germany,2013,86,44,42
MUS,Mauritius,DEU,Germany,2014,110,52,58
MUS,Mauritius,DEU,Germany,2015,132,55,77
MUS,Mauritius,DEU,Germany,2016,138,64,74
MUS,Mauritius,DEU,Germany,2017,176,56,120
MUS,Mauritius,HUN,Hungary,2008,8,0,8
MUS,Mauritius,HUN,Hungary,2009,5,0,5
MUS,Mauritius,HUN,Hungary,2010,11,0,11
MUS,Mauritius,HUN,Hungary,2011,11,0,11
MUS,Mauritius,HUN,Hungary,2012,16,1,15
MUS,Mauritius,HUN,Hungary,2013,13,2,11
MUS,Mauritius,HUN,Hungary,2014,6,6,0
MUS,Mauritius,HUN,Hungary,2015,12,2,10
MUS,Mauritius,HUN,Hungary,2016,3,2,1
MUS,Mauritius,HUN,Hungary,2017,13,0,13
MUS,Mauritius,ISL,Iceland,2008,0,2,-2
MUS,Mauritius,ISL,Iceland,2009,1,0,1
MUS,Mauritius,ISL,Iceland,2010,0,1,-1
MUS,Mauritius,ISL,Iceland,2011,0,0,0
MUS,Mauritius,ISL,Iceland,2012,0,0,0
MUS,Mauritius,ISL,Iceland,2013,0,0,0
MUS,Mauritius,ISL,Iceland,2014,0,0,0
MUS,Mauritius,ISL,Iceland,2015,0,0,0
MUS,Mauritius,ISL,Iceland,2016,1,0,1
MUS,Mauritius,ISL,Iceland,2017,1,0,1
MUS,Mauritius,ITA,Italy,2008,162,11,151
MUS,Mauritius,ITA,Italy,2009,239,12,227
MUS,Mauritius,ITA,Italy,2010,397,13,384
MUS,Mauritius,ITA,Italy,2011,329,19,310
MUS,Mauritius,ITA,Italy,2012,290,21,269
MUS,Mauritius,ITA,Italy,2013,319,40,279
MUS,Mauritius,ITA,Italy,2014,227,33,194
MUS,Mauritius,ITA,Italy,2015,134,26,108
MUS,Mauritius,ITA,Italy,2016,110,0,110
MUS,Mauritius,ITA,Italy,2017,134,27,107
MUS,Mauritius,JPN,Japan,2008,26,25,1
MUS,Mauritius,JPN,Japan,2009,16,24,-8
MUS,Mauritius,JPN,Japan,2010,27,20,7
MUS,Mauritius,JPN,Japan,2011,25,24,1
MUS,Mauritius,JPN,Japan,2012,49,36,13
MUS,Mauritius,JPN,Japan,2013,52,56,-4
MUS,Mauritius,JPN,Japan,2014,32,23,9
MUS,Mauritius,JPN,Japan,2015,31,28,3
MUS,Mauritius,JPN,Japan,2016,23,20,3
MUS,Mauritius,JPN,Japan,2017,33,23,10
MUS,Mauritius,KOR,Korea,2008,2,2,0
MUS,Mauritius,KOR,Korea,2009,2,3,-1
MUS,Mauritius,KOR,Korea,2010,2,1,1
MUS,Mauritius,KOR,Korea,2011,2,1,1
MUS,Mauritius,KOR,Korea,2012,7,2,5
MUS,Mauritius,KOR,Korea,2013,3,1,2
MUS,Mauritius,KOR,Korea,2014,7,4,3
MUS,Mauritius,KOR,Korea,2015,1,2,-1
MUS,Mauritius,KOR,Korea,2016,10,4,6
MUS,Mauritius,KOR,Korea,2017,6,10,-4
MUS,Mauritius,LUX,Luxembourg,2008,33,3,30
MUS,Mauritius,LUX,Luxembourg,2009,14,13,1
MUS,Mauritius,LUX,Luxembourg,2010,13,4,9
MUS,Mauritius,LUX,Luxembourg,2011,11,3,8
MUS,Mauritius,LUX,Luxembourg,2012,8,3,5
MUS,Mauritius,LUX,Luxembourg,2013,11,1,10
MUS,Mauritius,LUX,Luxembourg,2014,17,9,8
MUS,Mauritius,LUX,Luxembourg,2015,26,5,21
MUS,Mauritius,LUX,Luxembourg,2016,54,2,52
MUS,Mauritius,LUX,Luxembourg,2017,41,11,30
MUS,Mauritius,MEX,Mexico,2010,1,0,1
MUS,Mauritius,MEX,Mexico,2012,0,0,0
MUS,Mauritius,MEX,Mexico,2013,0,0,0
MUS,Mauritius,MEX,Mexico,2014,0,0,0
MUS,Mauritius,MEX,Mexico,2017,3,0,3
MUS,Mauritius,NLD,Netherlands,2008,16,6,10
MUS,Mauritius,NLD,Netherlands,2009,13,9,4
MUS,Mauritius,NLD,Netherlands,2010,10,9,1
MUS,Mauritius,NLD,Netherlands,2011,6,4,2
MUS,Mauritius,NLD,Netherlands,2012,12,10,2
MUS,Mauritius,NLD,Netherlands,2013,11,8,3
MUS,Mauritius,NLD,Netherlands,2014,15,7,8
MUS,Mauritius,NLD,Netherlands,2015,16,11,5
MUS,Mauritius,NLD,Netherlands,2016,13,8,5
MUS,Mauritius,NLD,Netherlands,2017,21,9,12
MUS,Mauritius,NZL,New Zealand,2008,34,5,29
MUS,Mauritius,NZL,New Zealand,2009,46,3,43
MUS,Mauritius,NZL,New Zealand,2010,13,7,6
MUS,Mauritius,NZL,New Zealand,2011,22,14,8
MUS,Mauritius,NZL,New Zealand,2012,16,3,13
MUS,Mauritius,NZL,New Zealand,2013,17,8,9
MUS,Mauritius,NZL,New Zealand,2014,24,2,22
MUS,Mauritius,NZL,New Zealand,2015,26,9,17
MUS,Mauritius,NZL,New Zealand,2016,51,1,50
MUS,Mauritius,NZL,New Zealand,2017,51,7,44
MUS,Mauritius,NOR,Norway,2008,5,3,2
MUS,Mauritius,NOR,Norway,2009,8,0,8
MUS,Mauritius,NOR,Norway,2010,4,0,4
MUS,Mauritius,NOR,Norway,2011,6,0,6
MUS,Mauritius,NOR,Norway,2012,5,0,5
MUS,Mauritius,NOR,Norway,2013,4,0,4
MUS,Mauritius,NOR,Norway,2014,5,2,3
MUS,Mauritius,NOR,Norway,2015,4,3,1
MUS,Mauritius,NOR,Norway,2016,0,4,-4
MUS,Mauritius,NOR,Norway,2017,0,5,-5
MUS,Mauritius,POL,Poland,2009,8,0,8
MUS,Mauritius,POL,Poland,2010,7,0,7
MUS,Mauritius,POL,Poland,2011,18,0,18
MUS,Mauritius,POL,Poland,2012,17,0,17
MUS,Mauritius,POL,Poland,2013,14,0,14
MUS,Mauritius,POL,Poland,2014,9,0,9
MUS,Mauritius,POL,Poland,2015,20,0,20
MUS,Mauritius,POL,Poland,2016,17,0,17
MUS,Mauritius,POL,Poland,2017,10,0,10
MUS,Mauritius,SVK,Slovak Republic,2008,0,0,0
MUS,Mauritius,SVK,Slovak Republic,2009,1,0,1
MUS,Mauritius,SVK,Slovak Republic,2010,2,0,2
MUS,Mauritius,SVK,Slovak Republic,2011,1,1,0
MUS,Mauritius,SVK,Slovak Republic,2015,1,0,1
MUS,Mauritius,ESP,Spain,2008,11,2,9
MUS,Mauritius,ESP,Spain,2009,17,0,17
MUS,Mauritius,ESP,Spain,2010,9,9,0
MUS,Mauritius,ESP,Spain,2011,12,3,9
MUS,Mauritius,ESP,Spain,2012,16,6,10
MUS,Mauritius,ESP,Spain,2013,15,5,10
MUS,Mauritius,ESP,Spain,2014,13,2,11
MUS,Mauritius,ESP,Spain,2015,17,1,16
MUS,Mauritius,ESP,Spain,2016,24,2,22
MUS,Mauritius,ESP,Spain,2017,19,9,10
MUS,Mauritius,SWE,Sweden,2008,10,2,8
MUS,Mauritius,SWE,Sweden,2009,8,6,2
MUS,Mauritius,SWE,Sweden,2010,8,0,8
MUS,Mauritius,SWE,Sweden,2011,7,5,2
MUS,Mauritius,SWE,Sweden,2012,12,1,11
MUS,Mauritius,SWE,Sweden,2013,4,7,-3
MUS,Mauritius,SWE,Sweden,2014,4,1,3
MUS,Mauritius,SWE,Sweden,2015,4,3,1
MUS,Mauritius,SWE,Sweden,2016,8,1,7
MUS,Mauritius,SWE,Sweden,2017,9,1,8
MUS,Mauritius,CHE,Switzerland,2010,73,35,38
MUS,Mauritius,CHE,Switzerland,2011,85,28,57
MUS,Mauritius,CHE,Switzerland,2012,84,25,59
MUS,Mauritius,CHE,Switzerland,2013,77,36,41
MUS,Mauritius,CHE,Switzerland,2014,71,31,40
MUS,Mauritius,CHE,Switzerland,2015,73,24,49
MUS,Mauritius,CHE,Switzerland,2016,58,44,14
MUS,Mauritius,CHE,Switzerland,2017,73,34,39
MUS,Mauritius,TUR,Turkey,2010,2,0,2
MUS,Mauritius,GBR,United Kingdom,2011,2000,1000,1000
MUS,Mauritius,GBR,United Kingdom,2012,1000,1000,0
MUS,Mauritius,GBR,United Kingdom,2015,1000,1000,0
MUS,Mauritius,USA,United States,2008,83,0,83
MUS,Mauritius,USA,United States,2009,110,0,110
MUS,Mauritius,USA,United States,2010,84,0,84
MUS,Mauritius,USA,United States,2011,101,0,101
MUS,Mauritius,USA,United States,2012,77,0,77
MUS,Mauritius,USA,United States,2013,83,0,83
MUS,Mauritius,USA,United States,2014,81,0,81
MUS,Mauritius,USA,United States,2015,96,0,96
MUS,Mauritius,USA,United States,2016,110,0,110
MUS,Mauritius,USA,United States,2017,96,0,96
MUS,Mauritius,CHL,Chile,2008,0,0,0
MUS,Mauritius,CHL,Chile,2009,2,0,2
MUS,Mauritius,CHL,Chile,2010,0,0,0
MUS,Mauritius,CHL,Chile,2011,1,0,1
MUS,Mauritius,CHL,Chile,2012,1,0,1
MUS,Mauritius,CHL,Chile,2013,0,0,0
MUS,Mauritius,CHL,Chile,2014,0,0,0
MUS,Mauritius,CHL,Chile,2015,1,0,1
MUS,Mauritius,CHL,Chile,2016,0,0,0
MUS,Mauritius,EST,Estonia,2008,0,0,0
MUS,Mauritius,EST,Estonia,2009,0,0,0
MUS,Mauritius,EST,Estonia,2010,0,0,0
MUS,Mauritius,EST,Estonia,2011,0,0,0
MUS,Mauritius,EST,Estonia,2012,0,0,0
MUS,Mauritius,EST,Estonia,2013,0,0,0
MUS,Mauritius,EST,Estonia,2014,1,0,1
MUS,Mauritius,EST,Estonia,2015,0,0,0
MUS,Mauritius,EST,Estonia,2016,0,0,0
MUS,Mauritius,EST,Estonia,2017,7,0,7
MUS,Mauritius,SVN,Slovenia,2009,1,0,1
MUS,Mauritius,SVN,Slovenia,2010,1,0,1
MUS,Mauritius,SVN,Slovenia,2011,1,0,1
MUS,Mauritius,SVN,Slovenia,2013,1,0,1
MUS,Mauritius,SVN,Slovenia,2016,1,0,1
MEX,Mexico,AUS,Australia,2008,282,23,259
MEX,Mexico,AUS,Australia,2009,288,35,253
MEX,Mexico,AUS,Australia,2010,278,28,250
MEX,Mexico,AUS,Australia,2011,248,33,215
MEX,Mexico,AUS,Australia,2012,336,29,307
MEX,Mexico,AUS,Australia,2013,290,86,204
MEX,Mexico,AUS,Australia,2014,268,66,202
MEX,Mexico,AUS,Australia,2015,274,56,218
MEX,Mexico,AUS,Australia,2016,280,79,201
MEX,Mexico,AUS,Australia,2017,271,61,210
MEX,Mexico,AUT,Austria,2008,184,31,153
MEX,Mexico,AUT,Austria,2009,220,42,178
MEX,Mexico,AUT,Austria,2010,193,26,167
MEX,Mexico,AUT,Austria,2011,253,24,229
MEX,Mexico,AUT,Austria,2012,237,25,212
MEX,Mexico,AUT,Austria,2013,237,116,121
MEX,Mexico,AUT,Austria,2014,238,61,177
MEX,Mexico,AUT,Austria,2015,301,37,264
MEX,Mexico,AUT,Austria,2016,326,41,285
MEX,Mexico,AUT,Austria,2017,336,32,304
MEX,Mexico,BEL,Belgium,2008,247,39,208
MEX,Mexico,BEL,Belgium,2009,258,48,210
MEX,Mexico,BEL,Belgium,2010,261,85,176
MEX,Mexico,BEL,Belgium,2011,312,60,252
MEX,Mexico,BEL,Belgium,2012,321,55,266
MEX,Mexico,BEL,Belgium,2013,298,167,131
MEX,Mexico,BEL,Belgium,2014,223,115,108
MEX,Mexico,BEL,Belgium,2015,224,83,141
MEX,Mexico,BEL,Belgium,2016,315,83,232
MEX,Mexico,BEL,Belgium,2017,369,60,309
MEX,Mexico,CAN,Canada,2008,2853,397,2456
MEX,Mexico,CAN,Canada,2009,3092,586,2506
MEX,Mexico,CAN,Canada,2010,3861,748,3113
MEX,Mexico,CAN,Canada,2011,3947,849,3098
MEX,Mexico,CAN,Canada,2012,4227,830,3397
MEX,Mexico,CAN,Canada,2013,3995,3465,530
MEX,Mexico,CAN,Canada,2014,4477,1964,2513
MEX,Mexico,CAN,Canada,2015,3231,1785,1446
MEX,Mexico,CAN,Canada,2016,3400,1676,1724
MEX,Mexico,CAN,Canada,2017,3135,1296,1839
MEX,Mexico,CZE,Czech Republic,2008,102,33,69
MEX,Mexico,CZE,Czech Republic,2009,117,44,73
MEX,Mexico,CZE,Czech Republic,2010,88,38,50
MEX,Mexico,CZE,Czech Republic,2011,80,18,62
MEX,Mexico,CZE,Czech Republic,2012,67,27,40
MEX,Mexico,CZE,Czech Republic,2013,64,94,-30
MEX,Mexico,CZE,Czech Republic,2014,99,49,50
MEX,Mexico,CZE,Czech Republic,2015,123,34,89
MEX,Mexico,CZE,Czech Republic,2016,103,36,67
MEX,Mexico,CZE,Czech Republic,2017,138,24,114
MEX,Mexico,DNK,Denmark,2008,88,18,70
MEX,Mexico,DNK,Denmark,2009,94,36,58
MEX,Mexico,DNK,Denmark,2010,97,19,78
MEX,Mexico,DNK,Denmark,2011,98,14,84
MEX,Mexico,DNK,Denmark,2012,106,15,91
MEX,Mexico,DNK,Denmark,2013,128,53,75
MEX,Mexico,DNK,Denmark,2014,127,42,85
MEX,Mexico,DNK,Denmark,2015,99,19,80
MEX,Mexico,DNK,Denmark,2016,143,33,110
MEX,Mexico,DNK,Denmark,2017,152,23,129
MEX,Mexico,FIN,Finland,2008,53,9,44
MEX,Mexico,FIN,Finland,2009,58,18,40
MEX,Mexico,FIN,Finland,2010,53,12,41
MEX,Mexico,FIN,Finland,2011,78,23,55
MEX,Mexico,FIN,Finland,2012,69,11,58
MEX,Mexico,FIN,Finland,2013,62,37,25
MEX,Mexico,FIN,Finland,2014,65,24,41
MEX,Mexico,FIN,Finland,2015,75,25,50
MEX,Mexico,FIN,Finland,2016,75,18,57
MEX,Mexico,FIN,Finland,2017,80,15,65
MEX,Mexico,FRA,France,2008,618,357,261
MEX,Mexico,FRA,France,2009,733,512,221
MEX,Mexico,FRA,France,2010,787,565,222
MEX,Mexico,FRA,France,2011,763,466,297
MEX,Mexico,FRA,France,2012,714,379,335
MEX,Mexico,FRA,France,2013,724,1432,-708
MEX,Mexico,FRA,France,2014,767,1025,-258
MEX,Mexico,FRA,France,2015,842,721,121
MEX,Mexico,FRA,France,2016,882,673,209
MEX,Mexico,FRA,France,2017,820,620,200
MEX,Mexico,DEU,Germany,2008,2899,311,2588
MEX,Mexico,DEU,Germany,2009,2777,323,2454
MEX,Mexico,DEU,Germany,2010,3008,338,2670
MEX,Mexico,DEU,Germany,2011,3495,268,3227
MEX,Mexico,DEU,Germany,2012,3485,261,3224
MEX,Mexico,DEU,Germany,2013,3619,1102,2517
MEX,Mexico,DEU,Germany,2014,4763,625,4138
MEX,Mexico,DEU,Germany,2015,4592,481,4111
MEX,Mexico,DEU,Germany,2016,4500,554,3946
MEX,Mexico,DEU,Germany,2017,4888,400,4488
MEX,Mexico,HUN,Hungary,2008,104,28,76
MEX,Mexico,HUN,Hungary,2009,100,40,60
MEX,Mexico,HUN,Hungary,2010,118,53,65
MEX,Mexico,HUN,Hungary,2011,128,24,104
MEX,Mexico,HUN,Hungary,2012,143,19,124
MEX,Mexico,HUN,Hungary,2013,92,89,3
MEX,Mexico,HUN,Hungary,2014,110,62,48
MEX,Mexico,HUN,Hungary,2015,163,35,128
MEX,Mexico,HUN,Hungary,2016,147,28,119
MEX,Mexico,HUN,Hungary,2017,150,25,125
MEX,Mexico,ISL,Iceland,2008,13,1,12
MEX,Mexico,ISL,Iceland,2009,13,2,11
MEX,Mexico,ISL,Iceland,2010,7,2,5
MEX,Mexico,ISL,Iceland,2011,12,0,12
MEX,Mexico,ISL,Iceland,2012,11,0,11
MEX,Mexico,ISL,Iceland,2013,8,3,5
MEX,Mexico,ISL,Iceland,2014,13,2,11
MEX,Mexico,ISL,Iceland,2015,19,4,15
MEX,Mexico,ISL,Iceland,2016,30,1,29
MEX,Mexico,ISL,Iceland,2017,16,1,15
MEX,Mexico,ITA,Italy,2008,423,323,100
MEX,Mexico,ITA,Italy,2009,518,501,17
MEX,Mexico,ITA,Italy,2010,602,550,52
MEX,Mexico,ITA,Italy,2011,538,487,51
MEX,Mexico,ITA,Italy,2012,462,437,25
MEX,Mexico,ITA,Italy,2013,441,1529,-1088
MEX,Mexico,ITA,Italy,2014,366,910,-544
MEX,Mexico,ITA,Italy,2015,411,681,-270
MEX,Mexico,ITA,Italy,2016,418,719,-301
MEX,Mexico,ITA,Italy,2017,408,566,-158
MEX,Mexico,JPN,Japan,2008,683,128,555
MEX,Mexico,JPN,Japan,2009,500,132,368
MEX,Mexico,JPN,Japan,2010,628,156,472
MEX,Mexico,JPN,Japan,2011,607,145,462
MEX,Mexico,JPN,Japan,2012,789,118,671
MEX,Mexico,JPN,Japan,2013,767,637,130
MEX,Mexico,JPN,Japan,2014,724,408,316
MEX,Mexico,JPN,Japan,2015,823,349,474
MEX,Mexico,JPN,Japan,2016,916,426,490
MEX,Mexico,JPN,Japan,2017,1082,609,473
MEX,Mexico,KOR,Korea,2008,185,382,-197
MEX,Mexico,KOR,Korea,2009,231,415,-184
MEX,Mexico,KOR,Korea,2010,258,505,-247
MEX,Mexico,KOR,Korea,2011,253,425,-172
MEX,Mexico,KOR,Korea,2012,247,406,-159
MEX,Mexico,KOR,Korea,2013,249,1329,-1080
MEX,Mexico,KOR,Korea,2014,301,792,-491
MEX,Mexico,KOR,Korea,2015,377,548,-171
MEX,Mexico,KOR,Korea,2016,369,577,-208
MEX,Mexico,KOR,Korea,2017,376,454,-78
MEX,Mexico,LUX,Luxembourg,2008,28,0,28
MEX,Mexico,LUX,Luxembourg,2009,31,0,31
MEX,Mexico,LUX,Luxembourg,2010,19,0,19
MEX,Mexico,LUX,Luxembourg,2011,22,0,22
MEX,Mexico,LUX,Luxembourg,2012,19,2,17
MEX,Mexico,LUX,Luxembourg,2013,25,3,22
MEX,Mexico,LUX,Luxembourg,2014,24,0,24
MEX,Mexico,LUX,Luxembourg,2015,42,1,41
MEX,Mexico,LUX,Luxembourg,2016,41,0,41
MEX,Mexico,LUX,Luxembourg,2017,37,0,37
MEX,Mexico,MEX,Mexico,2012,0,0,0
MEX,Mexico,MEX,Mexico,2013,0,0,0
MEX,Mexico,MEX,Mexico,2014,0,0,0
MEX,Mexico,NLD,Netherlands,2008,408,76,332
MEX,Mexico,NLD,Netherlands,2009,391,103,288
MEX,Mexico,NLD,Netherlands,2010,429,95,334
MEX,Mexico,NLD,Netherlands,2011,441,108,333
MEX,Mexico,NLD,Netherlands,2012,471,85,386
MEX,Mexico,NLD,Netherlands,2013,510,301,209
MEX,Mexico,NLD,Netherlands,2014,524,149,375
MEX,Mexico,NLD,Netherlands,2015,638,98,540
MEX,Mexico,NLD,Netherlands,2016,668,120,548
MEX,Mexico,NLD,Netherlands,2017,762,81,681
MEX,Mexico,NZL,New Zealand,2008,72,4,68
MEX,Mexico,NZL,New Zealand,2009,96,7,89
MEX,Mexico,NZL,New Zealand,2010,125,8,117
MEX,Mexico,NZL,New Zealand,2011,147,9,138
MEX,Mexico,NZL,New Zealand,2012,189,1,188
MEX,Mexico,NZL,New Zealand,2013,190,25,165
MEX,Mexico,NZL,New Zealand,2014,210,19,191
MEX,Mexico,NZL,New Zealand,2015,198,24,174
MEX,Mexico,NZL,New Zealand,2016,194,16,178
MEX,Mexico,NZL,New Zealand,2017,167,13,154
MEX,Mexico,NOR,Norway,2008,95,15,80
MEX,Mexico,NOR,Norway,2009,109,15,94
MEX,Mexico,NOR,Norway,2010,100,7,93
MEX,Mexico,NOR,Norway,2011,120,17,103
MEX,Mexico,NOR,Norway,2012,131,10,121
MEX,Mexico,NOR,Norway,2013,134,33,101
MEX,Mexico,NOR,Norway,2014,110,27,83
MEX,Mexico,NOR,Norway,2015,96,23,73
MEX,Mexico,NOR,Norway,2016,104,19,85
MEX,Mexico,NOR,Norway,2017,109,10,99
MEX,Mexico,POL,Poland,2008,120,34,86
MEX,Mexico,POL,Poland,2009,156,40,116
MEX,Mexico,POL,Poland,2010,163,44,119
MEX,Mexico,POL,Poland,2011,168,49,119
MEX,Mexico,POL,Poland,2012,165,40,125
MEX,Mexico,POL,Poland,2013,171,128,43
MEX,Mexico,POL,Poland,2014,97,95,2
MEX,Mexico,POL,Poland,2015,190,66,124
MEX,Mexico,POL,Poland,2016,168,60,108
MEX,Mexico,POL,Poland,2017,177,54,123
MEX,Mexico,SVK,Slovak Republic,2008,3,4,-1
MEX,Mexico,SVK,Slovak Republic,2009,2,9,-7
MEX,Mexico,SVK,Slovak Republic,2010,3,17,-14
MEX,Mexico,SVK,Slovak Republic,2011,4,14,-10
MEX,Mexico,SVK,Slovak Republic,2012,2,9,-7
MEX,Mexico,SVK,Slovak Republic,2013,3,36,-33
MEX,Mexico,SVK,Slovak Republic,2014,3,30,-27
MEX,Mexico,SVK,Slovak Republic,2015,12,21,-9
MEX,Mexico,SVK,Slovak Republic,2016,3,19,-16
MEX,Mexico,SVK,Slovak Republic,2017,3,11,-8
MEX,Mexico,ESP,Spain,2008,4832,566,4266
MEX,Mexico,ESP,Spain,2009,3815,865,2950
MEX,Mexico,ESP,Spain,2010,3921,969,2952
MEX,Mexico,ESP,Spain,2011,4591,841,3750
MEX,Mexico,ESP,Spain,2012,4294,980,3314
MEX,Mexico,ESP,Spain,2013,3332,2607,725
MEX,Mexico,ESP,Spain,2014,3555,1767,1788
MEX,Mexico,ESP,Spain,2015,3914,1596,2318
MEX,Mexico,ESP,Spain,2016,3849,1706,2143
MEX,Mexico,ESP,Spain,2017,5077,1489,3588
MEX,Mexico,SWE,Sweden,2008,208,18,190
MEX,Mexico,SWE,Sweden,2009,186,30,156
MEX,Mexico,SWE,Sweden,2010,146,41,105
MEX,Mexico,SWE,Sweden,2011,157,28,129
MEX,Mexico,SWE,Sweden,2012,163,23,140
MEX,Mexico,SWE,Sweden,2013,137,92,45
MEX,Mexico,SWE,Sweden,2014,181,48,133
MEX,Mexico,SWE,Sweden,2015,145,55,90
MEX,Mexico,SWE,Sweden,2016,163,41,122
MEX,Mexico,SWE,Sweden,2017,241,19,222
MEX,Mexico,CHE,Switzerland,2010,629,105,524
MEX,Mexico,CHE,Switzerland,2011,599,67,532
MEX,Mexico,CHE,Switzerland,2012,556,55,501
MEX,Mexico,CHE,Switzerland,2013,510,256,254
MEX,Mexico,CHE,Switzerland,2014,494,126,368
MEX,Mexico,CHE,Switzerland,2015,494,108,386
MEX,Mexico,CHE,Switzerland,2016,499,95,404
MEX,Mexico,CHE,Switzerland,2017,533,86,447
MEX,Mexico,TUR,Turkey,2010,21,34,-13
MEX,Mexico,TUR,Turkey,2016,106,51,55
MEX,Mexico,TUR,Turkey,2017,101,25,76
MEX,Mexico,GBR,United Kingdom,2012,1000,200,800
MEX,Mexico,GBR,United Kingdom,2013,1000,748,252
MEX,Mexico,GBR,United Kingdom,2014,2000,454,1546
MEX,Mexico,GBR,United Kingdom,2015,4000,331,3669
MEX,Mexico,USA,United States,2008,189989,2155,187834
MEX,Mexico,USA,United States,2009,164920,2882,162038
MEX,Mexico,USA,United States,2010,139120,4026,135094
MEX,Mexico,USA,United States,2011,143446,4261,139185
MEX,Mexico,USA,United States,2012,146406,3952,142454
MEX,Mexico,USA,United States,2013,135028,14420,120608
MEX,Mexico,USA,United States,2014,134052,9373,124679
MEX,Mexico,USA,United States,2015,158619,7096,151523
MEX,Mexico,USA,United States,2016,174534,6754,167780
MEX,Mexico,USA,United States,2017,170581,5374,165207
MEX,Mexico,CHL,Chile,2008,513,251,262
MEX,Mexico,CHL,Chile,2009,481,393,88
MEX,Mexico,CHL,Chile,2010,507,426,81
MEX,Mexico,CHL,Chile,2011,611,318,293
MEX,Mexico,CHL,Chile,2012,796,256,540
MEX,Mexico,CHL,Chile,2013,704,921,-217
MEX,Mexico,CHL,Chile,2014,720,601,119
MEX,Mexico,CHL,Chile,2015,750,432,318
MEX,Mexico,CHL,Chile,2016,753,396,357
MEX,Mexico,EST,Estonia,2008,1,3,-2
MEX,Mexico,EST,Estonia,2009,6,4,2
MEX,Mexico,EST,Estonia,2010,2,1,1
MEX,Mexico,EST,Estonia,2011,3,1,2
MEX,Mexico,EST,Estonia,2012,8,3,5
MEX,Mexico,EST,Estonia,2013,10,9,1
MEX,Mexico,EST,Estonia,2014,10,8,2
MEX,Mexico,EST,Estonia,2015,13,1,12
MEX,Mexico,EST,Estonia,2016,26,6,20
MEX,Mexico,EST,Estonia,2017,22,2,20
MEX,Mexico,ISR,Israel,2008,83,56,27
MEX,Mexico,ISR,Israel,2009,121,95,26
MEX,Mexico,ISR,Israel,2010,137,92,45
MEX,Mexico,ISR,Israel,2011,87,77,10
MEX,Mexico,ISR,Israel,2012,61,58,3
MEX,Mexico,ISR,Israel,2013,77,224,-147
MEX,Mexico,ISR,Israel,2014,60,136,-76
MEX,Mexico,ISR,Israel,2015,71,113,-42
MEX,Mexico,ISR,Israel,2016,89,73,16
MEX,Mexico,ISR,Israel,2017,76,68,8
MEX,Mexico,SVN,Slovenia,2008,9,11,-2
MEX,Mexico,SVN,Slovenia,2009,9,15,-6
MEX,Mexico,SVN,Slovenia,2010,7,10,-3
MEX,Mexico,SVN,Slovenia,2011,9,8,1
MEX,Mexico,SVN,Slovenia,2012,1,4,-3
MEX,Mexico,SVN,Slovenia,2013,5,22,-17
MEX,Mexico,SVN,Slovenia,2014,25,10,15
MEX,Mexico,SVN,Slovenia,2015,13,9,4
MEX,Mexico,SVN,Slovenia,2016,8,6,2
MEX,Mexico,SVN,Slovenia,2017,14,9,5
FSM,Micronesia,AUS,Australia,2008,2,0,2
FSM,Micronesia,AUS,Australia,2009,0,0,0
FSM,Micronesia,AUS,Australia,2010,1,0,1
FSM,Micronesia,AUS,Australia,2011,0,0,0
FSM,Micronesia,AUS,Australia,2012,0,0,0
FSM,Micronesia,AUS,Australia,2013,0,0,0
FSM,Micronesia,AUS,Australia,2014,0,0,0
FSM,Micronesia,AUS,Australia,2015,0,0,0
FSM,Micronesia,AUS,Australia,2016,0,0,0
FSM,Micronesia,AUS,Australia,2017,3,0,3
FSM,Micronesia,AUT,Austria,2008,0,0,0
FSM,Micronesia,AUT,Austria,2009,0,0,0
FSM,Micronesia,AUT,Austria,2010,0,0,0
FSM,Micronesia,AUT,Austria,2011,0,0,0
FSM,Micronesia,AUT,Austria,2012,0,0,0
FSM,Micronesia,AUT,Austria,2013,0,0,0
FSM,Micronesia,AUT,Austria,2014,0,0,0
FSM,Micronesia,AUT,Austria,2015,0,0,0
FSM,Micronesia,AUT,Austria,2016,0,0,0
FSM,Micronesia,AUT,Austria,2017,0,0,0
FSM,Micronesia,BEL,Belgium,2010,0,0,0
FSM,Micronesia,BEL,Belgium,2017,3,0,3
FSM,Micronesia,CAN,Canada,2008,0,0,0
FSM,Micronesia,CAN,Canada,2009,0,0,0
FSM,Micronesia,CAN,Canada,2010,0,0,0
FSM,Micronesia,CAN,Canada,2011,0,0,0
FSM,Micronesia,CAN,Canada,2012,0,0,0
FSM,Micronesia,CAN,Canada,2013,1,0,1
FSM,Micronesia,CAN,Canada,2014,0,0,0
FSM,Micronesia,CAN,Canada,2015,0,0,0
FSM,Micronesia,CAN,Canada,2016,0,0,0
FSM,Micronesia,CAN,Canada,2017,0,0,0
FSM,Micronesia,DNK,Denmark,2015,0,0,0
FSM,Micronesia,DNK,Denmark,2016,0,0,0
FSM,Micronesia,DNK,Denmark,2017,0,0,0
FSM,Micronesia,FIN,Finland,2008,0,0,0
FSM,Micronesia,FIN,Finland,2009,0,0,0
FSM,Micronesia,FIN,Finland,2010,0,0,0
FSM,Micronesia,FIN,Finland,2011,0,0,0
FSM,Micronesia,FIN,Finland,2012,0,0,0
FSM,Micronesia,FIN,Finland,2013,0,0,0
FSM,Micronesia,FIN,Finland,2014,0,0,0
FSM,Micronesia,FIN,Finland,2015,0,0,0
FSM,Micronesia,FIN,Finland,2016,0,0,0
FSM,Micronesia,FIN,Finland,2017,0,0,0
FSM,Micronesia,FRA,France,2008,0,0,0
FSM,Micronesia,FRA,France,2009,0,0,0
FSM,Micronesia,FRA,France,2010,0,0,0
FSM,Micronesia,FRA,France,2011,0,0,0
FSM,Micronesia,FRA,France,2012,0,0,0
FSM,Micronesia,FRA,France,2013,0,0,0
FSM,Micronesia,FRA,France,2014,0,0,0
FSM,Micronesia,FRA,France,2015,0,0,0
FSM,Micronesia,FRA,France,2016,0,0,0
FSM,Micronesia,FRA,France,2017,0,0,0
FSM,Micronesia,DEU,Germany,2008,0,0,0
FSM,Micronesia,DEU,Germany,2009,0,0,0
FSM,Micronesia,DEU,Germany,2010,0,0,0
FSM,Micronesia,DEU,Germany,2011,1,0,1
FSM,Micronesia,DEU,Germany,2012,1,1,0
FSM,Micronesia,DEU,Germany,2013,1,0,1
FSM,Micronesia,DEU,Germany,2014,3,0,3
FSM,Micronesia,DEU,Germany,2015,1,0,1
FSM,Micronesia,DEU,Germany,2016,0,0,0
FSM,Micronesia,DEU,Germany,2017,1,0,1
FSM,Micronesia,HUN,Hungary,2008,0,0,0
FSM,Micronesia,HUN,Hungary,2009,0,0,0
FSM,Micronesia,HUN,Hungary,2010,0,0,0
FSM,Micronesia,HUN,Hungary,2011,0,0,0
FSM,Micronesia,HUN,Hungary,2012,0,0,0
FSM,Micronesia,HUN,Hungary,2013,0,0,0
FSM,Micronesia,HUN,Hungary,2014,0,0,0
FSM,Micronesia,HUN,Hungary,2015,0,0,0
FSM,Micronesia,HUN,Hungary,2016,0,0,0
FSM,Micronesia,HUN,Hungary,2017,0,0,0
FSM,Micronesia,ISL,Iceland,2016,0,0,0
FSM,Micronesia,ISL,Iceland,2017,0,0,0
FSM,Micronesia,ITA,Italy,2008,6,0,6
FSM,Micronesia,ITA,Italy,2009,7,0,7
FSM,Micronesia,ITA,Italy,2010,3,0,3
FSM,Micronesia,ITA,Italy,2011,2,0,2
FSM,Micronesia,JPN,Japan,2008,59,55,4
FSM,Micronesia,JPN,Japan,2009,69,63,6
FSM,Micronesia,JPN,Japan,2010,58,5,53
FSM,Micronesia,JPN,Japan,2011,31,32,-1
FSM,Micronesia,JPN,Japan,2012,69,58,11
FSM,Micronesia,JPN,Japan,2013,73,63,10
FSM,Micronesia,JPN,Japan,2014,74,67,7
FSM,Micronesia,JPN,Japan,2015,86,80,6
FSM,Micronesia,JPN,Japan,2016,80,77,3
FSM,Micronesia,JPN,Japan,2017,92,75,17
FSM,Micronesia,KOR,Korea,2008,3,1,2
FSM,Micronesia,KOR,Korea,2009,3,5,-2
FSM,Micronesia,KOR,Korea,2010,3,1,2
FSM,Micronesia,KOR,Korea,2011,3,1,2
FSM,Micronesia,KOR,Korea,2012,1,3,-2
FSM,Micronesia,KOR,Korea,2013,4,1,3
FSM,Micronesia,KOR,Korea,2014,2,4,-2
FSM,Micronesia,KOR,Korea,2015,4,1,3
FSM,Micronesia,KOR,Korea,2016,2,3,-1
FSM,Micronesia,KOR,Korea,2017,3,0,3
FSM,Micronesia,LUX,Luxembourg,2008,0,0,0
FSM,Micronesia,LUX,Luxembourg,2009,0,0,0
FSM,Micronesia,LUX,Luxembourg,2010,0,0,0
FSM,Micronesia,LUX,Luxembourg,2011,0,0,0
FSM,Micronesia,LUX,Luxembourg,2012,0,0,0
FSM,Micronesia,LUX,Luxembourg,2013,0,0,0
FSM,Micronesia,LUX,Luxembourg,2014,0,0,0
FSM,Micronesia,LUX,Luxembourg,2015,0,0,0
FSM,Micronesia,LUX,Luxembourg,2016,0,0,0
FSM,Micronesia,LUX,Luxembourg,2017,0,0,0
FSM,Micronesia,MEX,Mexico,2010,1,0,1
FSM,Micronesia,MEX,Mexico,2012,0,0,0
FSM,Micronesia,MEX,Mexico,2013,0,0,0
FSM,Micronesia,MEX,Mexico,2014,0,0,0
FSM,Micronesia,NZL,New Zealand,2008,2,0,2
FSM,Micronesia,NZL,New Zealand,2009,1,0,1
FSM,Micronesia,NZL,New Zealand,2010,1,0,1
FSM,Micronesia,NZL,New Zealand,2013,1,1,0
FSM,Micronesia,NZL,New Zealand,2015,1,1,0
FSM,Micronesia,NZL,New Zealand,2016,1,0,1
FSM,Micronesia,NZL,New Zealand,2017,1,0,1
FSM,Micronesia,NOR,Norway,2008,0,0,0
FSM,Micronesia,NOR,Norway,2009,0,0,0
FSM,Micronesia,NOR,Norway,2010,0,0,0
FSM,Micronesia,NOR,Norway,2011,0,0,0
FSM,Micronesia,NOR,Norway,2012,0,0,0
FSM,Micronesia,NOR,Norway,2013,0,0,0
FSM,Micronesia,NOR,Norway,2014,0,0,0
FSM,Micronesia,NOR,Norway,2015,0,0,0
FSM,Micronesia,NOR,Norway,2016,0,0,0
FSM,Micronesia,NOR,Norway,2017,0,0,0
FSM,Micronesia,POL,Poland,2009,0,0,0
FSM,Micronesia,POL,Poland,2010,0,0,0
FSM,Micronesia,POL,Poland,2011,0,0,0
FSM,Micronesia,POL,Poland,2012,0,0,0
FSM,Micronesia,POL,Poland,2013,0,0,0
FSM,Micronesia,POL,Poland,2014,0,0,0
FSM,Micronesia,POL,Poland,2015,0,0,0
FSM,Micronesia,POL,Poland,2016,0,0,0
FSM,Micronesia,POL,Poland,2017,0,0,0
FSM,Micronesia,SVK,Slovak Republic,2008,0,0,0
FSM,Micronesia,ESP,Spain,2008,2,1,1
FSM,Micronesia,ESP,Spain,2009,5,1,4
FSM,Micronesia,ESP,Spain,2010,3,2,1
FSM,Micronesia,ESP,Spain,2011,4,1,3
FSM,Micronesia,ESP,Spain,2012,7,0,7
FSM,Micronesia,ESP,Spain,2013,0,1,-1
FSM,Micronesia,ESP,Spain,2014,8,1,7
FSM,Micronesia,ESP,Spain,2015,1,0,1
FSM,Micronesia,ESP,Spain,2016,2,0,2
FSM,Micronesia,ESP,Spain,2017,2,0,2
FSM,Micronesia,SWE,Sweden,2008,0,0,0
FSM,Micronesia,SWE,Sweden,2009,0,0,0
FSM,Micronesia,SWE,Sweden,2010,0,0,0
FSM,Micronesia,SWE,Sweden,2011,0,0,0
FSM,Micronesia,SWE,Sweden,2012,0,0,0
FSM,Micronesia,SWE,Sweden,2013,0,0,0
FSM,Micronesia,SWE,Sweden,2014,0,0,0
FSM,Micronesia,SWE,Sweden,2015,0,0,0
FSM,Micronesia,SWE,Sweden,2016,0,0,0
FSM,Micronesia,SWE,Sweden,2017,0,0,0
FSM,Micronesia,CHE,Switzerland,2010,0,0,0
FSM,Micronesia,CHE,Switzerland,2011,0,0,0
FSM,Micronesia,CHE,Switzerland,2012,0,0,0
FSM,Micronesia,CHE,Switzerland,2013,0,0,0
FSM,Micronesia,USA,United States,2008,13,0,13
FSM,Micronesia,USA,United States,2009,16,0,16
FSM,Micronesia,USA,United States,2010,10,0,10
FSM,Micronesia,USA,United States,2011,9,0,9
FSM,Micronesia,USA,United States,2012,13,0,13
FSM,Micronesia,USA,United States,2013,4,0,4
FSM,Micronesia,USA,United States,2014,5,0,5
FSM,Micronesia,USA,United States,2015,6,0,6
FSM,Micronesia,USA,United States,2016,11,0,11
FSM,Micronesia,USA,United States,2017,6,0,6
FSM,Micronesia,CHL,Chile,2008,0,0,0
FSM,Micronesia,CHL,Chile,2009,0,0,0
FSM,Micronesia,CHL,Chile,2010,0,0,0
FSM,Micronesia,CHL,Chile,2011,0,0,0
FSM,Micronesia,CHL,Chile,2012,0,0,0
FSM,Micronesia,CHL,Chile,2013,0,0,0
FSM,Micronesia,CHL,Chile,2014,0,0,0
FSM,Micronesia,CHL,Chile,2015,0,0,0
FSM,Micronesia,CHL,Chile,2016,0,0,0
FSM,Micronesia,EST,Estonia,2008,0,0,0
FSM,Micronesia,EST,Estonia,2009,0,0,0
FSM,Micronesia,EST,Estonia,2010,0,0,0
FSM,Micronesia,EST,Estonia,2011,0,0,0
FSM,Micronesia,EST,Estonia,2012,0,0,0
FSM,Micronesia,EST,Estonia,2013,0,0,0
FSM,Micronesia,EST,Estonia,2014,0,0,0
FSM,Micronesia,EST,Estonia,2015,0,0,0
FSM,Micronesia,EST,Estonia,2016,0,0,0
FSM,Micronesia,EST,Estonia,2017,0,0,0
MDA,Moldova,AUS,Australia,2008,44,0,44
MDA,Moldova,AUS,Australia,2009,24,0,24
MDA,Moldova,AUS,Australia,2010,28,5,23
MDA,Moldova,AUS,Australia,2011,39,6,33
MDA,Moldova,AUS,Australia,2012,45,0,45
MDA,Moldova,AUS,Australia,2013,28,8,20
MDA,Moldova,AUS,Australia,2014,23,12,11
MDA,Moldova,AUS,Australia,2015,30,0,30
MDA,Moldova,AUS,Australia,2016,30,0,30
MDA,Moldova,AUS,Australia,2017,27,0,27
MDA,Moldova,AUT,Austria,2008,235,189,46
MDA,Moldova,AUT,Austria,2009,234,255,-21
MDA,Moldova,AUT,Austria,2010,153,222,-69
MDA,Moldova,AUT,Austria,2011,128,135,-7
MDA,Moldova,AUT,Austria,2012,149,81,68
MDA,Moldova,AUT,Austria,2013,148,110,38
MDA,Moldova,AUT,Austria,2014,177,73,104
MDA,Moldova,AUT,Austria,2015,187,97,90
MDA,Moldova,AUT,Austria,2016,192,100,92
MDA,Moldova,AUT,Austria,2017,178,108,70
MDA,Moldova,BEL,Belgium,2008,144,0,144
MDA,Moldova,BEL,Belgium,2009,156,0,156
MDA,Moldova,BEL,Belgium,2010,257,44,213
MDA,Moldova,BEL,Belgium,2011,201,0,201
MDA,Moldova,BEL,Belgium,2012,208,65,143
MDA,Moldova,BEL,Belgium,2013,149,72,77
MDA,Moldova,BEL,Belgium,2014,140,42,98
MDA,Moldova,BEL,Belgium,2015,148,36,112
MDA,Moldova,BEL,Belgium,2016,143,24,119
MDA,Moldova,BEL,Belgium,2017,245,21,224
MDA,Moldova,CAN,Canada,2008,1127,0,1127
MDA,Moldova,CAN,Canada,2009,1535,0,1535
MDA,Moldova,CAN,Canada,2010,1988,0,1988
MDA,Moldova,CAN,Canada,2011,1367,0,1367
MDA,Moldova,CAN,Canada,2012,1416,0,1416
MDA,Moldova,CAN,Canada,2013,1232,0,1232
MDA,Moldova,CAN,Canada,2014,941,0,941
MDA,Moldova,CAN,Canada,2015,929,0,929
MDA,Moldova,CAN,Canada,2016,1090,0,1090
MDA,Moldova,CAN,Canada,2017,685,0,685
MDA,Moldova,CZE,Czech Republic,2008,3319,6,3313
MDA,Moldova,CZE,Czech Republic,2009,1338,0,1338
MDA,Moldova,CZE,Czech Republic,2010,354,1,353
MDA,Moldova,CZE,Czech Republic,2011,161,9,152
MDA,Moldova,CZE,Czech Republic,2012,388,792,-404
MDA,Moldova,CZE,Czech Republic,2013,205,707,-502
MDA,Moldova,CZE,Czech Republic,2014,327,434,-107
MDA,Moldova,CZE,Czech Republic,2015,267,273,-6
MDA,Moldova,CZE,Czech Republic,2016,412,138,274
MDA,Moldova,CZE,Czech Republic,2017,500,209,291
MDA,Moldova,DNK,Denmark,2008,55,15,40
MDA,Moldova,DNK,Denmark,2009,40,33,7
MDA,Moldova,DNK,Denmark,2010,29,26,3
MDA,Moldova,DNK,Denmark,2011,50,28,22
MDA,Moldova,DNK,Denmark,2012,38,15,23
MDA,Moldova,DNK,Denmark,2013,21,20,1
MDA,Moldova,DNK,Denmark,2014,23,21,2
MDA,Moldova,DNK,Denmark,2015,0,11,-11
MDA,Moldova,DNK,Denmark,2016,26,13,13
MDA,Moldova,DNK,Denmark,2017,45,18,27
MDA,Moldova,FIN,Finland,2008,18,0,18
MDA,Moldova,FIN,Finland,2009,10,2,8
MDA,Moldova,FIN,Finland,2010,12,1,11
MDA,Moldova,FIN,Finland,2011,9,1,8
MDA,Moldova,FIN,Finland,2012,11,2,9
MDA,Moldova,FIN,Finland,2013,13,1,12
MDA,Moldova,FIN,Finland,2014,18,2,16
MDA,Moldova,FIN,Finland,2015,13,4,9
MDA,Moldova,FIN,Finland,2016,14,1,13
MDA,Moldova,FIN,Finland,2017,34,5,29
MDA,Moldova,FRA,France,2008,447,0,447
MDA,Moldova,FRA,France,2009,468,0,468
MDA,Moldova,FRA,France,2010,407,0,407
MDA,Moldova,FRA,France,2011,340,0,340
MDA,Moldova,FRA,France,2012,350,0,350
MDA,Moldova,FRA,France,2013,419,0,419
MDA,Moldova,FRA,France,2014,342,0,342
MDA,Moldova,FRA,France,2015,291,0,291
MDA,Moldova,FRA,France,2016,316,0,316
MDA,Moldova,FRA,France,2017,259,0,259
MDA,Moldova,DEU,Germany,2008,699,521,178
MDA,Moldova,DEU,Germany,2009,749,549,200
MDA,Moldova,DEU,Germany,2010,776,538,238
MDA,Moldova,DEU,Germany,2011,895,519,376
MDA,Moldova,DEU,Germany,2012,897,494,403
MDA,Moldova,DEU,Germany,2013,1039,586,453
MDA,Moldova,DEU,Germany,2014,1799,703,1096
MDA,Moldova,DEU,Germany,2015,3477,1121,2356
MDA,Moldova,DEU,Germany,2016,5869,3235,2634
MDA,Moldova,DEU,Germany,2017,4543,3326,1217
MDA,Moldova,HUN,Hungary,2008,140,5,135
MDA,Moldova,HUN,Hungary,2009,59,17,42
MDA,Moldova,HUN,Hungary,2010,54,8,46
MDA,Moldova,HUN,Hungary,2011,34,4,30
MDA,Moldova,HUN,Hungary,2012,64,6,58
MDA,Moldova,HUN,Hungary,2013,36,16,20
MDA,Moldova,HUN,Hungary,2014,44,13,31
MDA,Moldova,HUN,Hungary,2015,36,5,31
MDA,Moldova,HUN,Hungary,2016,30,5,25
MDA,Moldova,HUN,Hungary,2017,152,0,152
MDA,Moldova,ISL,Iceland,2008,1,3,-2
MDA,Moldova,ISL,Iceland,2009,0,1,-1
MDA,Moldova,ISL,Iceland,2010,1,0,1
MDA,Moldova,ISL,Iceland,2011,1,1,0
MDA,Moldova,ISL,Iceland,2012,0,0,0
MDA,Moldova,ISL,Iceland,2013,1,1,0
MDA,Moldova,ISL,Iceland,2014,2,0,2
MDA,Moldova,ISL,Iceland,2015,1,1,0
MDA,Moldova,ISL,Iceland,2016,1,0,1
MDA,Moldova,ISL,Iceland,2017,6,0,6
MDA,Moldova,ITA,Italy,2008,22007,388,21619
MDA,Moldova,ITA,Italy,2009,16812,463,16349
MDA,Moldova,ITA,Italy,2010,26591,822,25769
MDA,Moldova,ITA,Italy,2011,14956,806,14150
MDA,Moldova,ITA,Italy,2012,8813,1090,7723
MDA,Moldova,ITA,Italy,2013,8064,1585,6479
MDA,Moldova,ITA,Italy,2014,3759,1477,2282
MDA,Moldova,ITA,Italy,2015,2893,1237,1656
MDA,Moldova,ITA,Italy,2016,2339,0,2339
MDA,Moldova,ITA,Italy,2017,2138,723,1415
MDA,Moldova,JPN,Japan,2008,72,78,-6
MDA,Moldova,JPN,Japan,2009,67,58,9
MDA,Moldova,JPN,Japan,2010,58,6,52
MDA,Moldova,JPN,Japan,2011,62,59,3
MDA,Moldova,JPN,Japan,2012,57,56,1
MDA,Moldova,JPN,Japan,2013,52,51,1
MDA,Moldova,JPN,Japan,2014,34,31,3
MDA,Moldova,JPN,Japan,2015,47,40,7
MDA,Moldova,JPN,Japan,2016,68,65,3
MDA,Moldova,JPN,Japan,2017,40,29,11
MDA,Moldova,KOR,Korea,2008,20,45,-25
MDA,Moldova,KOR,Korea,2009,25,36,-11
MDA,Moldova,KOR,Korea,2010,39,48,-9
MDA,Moldova,KOR,Korea,2011,24,33,-9
MDA,Moldova,KOR,Korea,2012,38,24,14
MDA,Moldova,KOR,Korea,2013,23,27,-4
MDA,Moldova,KOR,Korea,2014,48,24,24
MDA,Moldova,KOR,Korea,2015,25,45,-20
MDA,Moldova,KOR,Korea,2016,37,39,-2
MDA,Moldova,KOR,Korea,2017,29,34,-5
MDA,Moldova,LUX,Luxembourg,2008,8,4,4
MDA,Moldova,LUX,Luxembourg,2009,9,4,5
MDA,Moldova,LUX,Luxembourg,2010,9,4,5
MDA,Moldova,LUX,Luxembourg,2011,6,0,6
MDA,Moldova,LUX,Luxembourg,2012,10,3,7
MDA,Moldova,LUX,Luxembourg,2013,8,2,6
MDA,Moldova,LUX,Luxembourg,2014,11,1,10
MDA,Moldova,LUX,Luxembourg,2015,7,5,2
MDA,Moldova,LUX,Luxembourg,2016,9,3,6
MDA,Moldova,LUX,Luxembourg,2017,19,0,19
MDA,Moldova,MEX,Mexico,2009,1,0,1
MDA,Moldova,MEX,Mexico,2011,2,0,2
MDA,Moldova,MEX,Mexico,2012,2,0,2
MDA,Moldova,MEX,Mexico,2013,6,0,6
MDA,Moldova,MEX,Mexico,2014,9,0,9
MDA,Moldova,MEX,Mexico,2015,6,0,6
MDA,Moldova,MEX,Mexico,2016,10,0,10
MDA,Moldova,MEX,Mexico,2017,7,0,7
MDA,Moldova,NLD,Netherlands,2008,90,33,57
MDA,Moldova,NLD,Netherlands,2009,66,40,26
MDA,Moldova,NLD,Netherlands,2010,66,43,23
MDA,Moldova,NLD,Netherlands,2011,79,46,33
MDA,Moldova,NLD,Netherlands,2012,75,52,23
MDA,Moldova,NLD,Netherlands,2013,67,47,20
MDA,Moldova,NLD,Netherlands,2014,67,38,29
MDA,Moldova,NLD,Netherlands,2015,50,37,13
MDA,Moldova,NLD,Netherlands,2016,71,35,36
MDA,Moldova,NLD,Netherlands,2017,91,33,58
MDA,Moldova,NZL,New Zealand,2008,2,0,2
MDA,Moldova,NZL,New Zealand,2009,4,1,3
MDA,Moldova,NZL,New Zealand,2010,4,0,4
MDA,Moldova,NZL,New Zealand,2011,1,0,1
MDA,Moldova,NZL,New Zealand,2012,5,1,4
MDA,Moldova,NZL,New Zealand,2013,5,0,5
MDA,Moldova,NZL,New Zealand,2014,24,1,23
MDA,Moldova,NZL,New Zealand,2015,2,2,0
MDA,Moldova,NZL,New Zealand,2016,3,1,2
MDA,Moldova,NZL,New Zealand,2017,9,0,9
MDA,Moldova,NOR,Norway,2008,32,10,22
MDA,Moldova,NOR,Norway,2009,39,9,30
MDA,Moldova,NOR,Norway,2010,35,13,22
MDA,Moldova,NOR,Norway,2011,41,12,29
MDA,Moldova,NOR,Norway,2012,42,9,33
MDA,Moldova,NOR,Norway,2013,32,11,21
MDA,Moldova,NOR,Norway,2014,25,7,18
MDA,Moldova,NOR,Norway,2015,33,12,21
MDA,Moldova,NOR,Norway,2016,16,14,2
MDA,Moldova,NOR,Norway,2017,18,3,15
MDA,Moldova,POL,Poland,2008,547,0,547
MDA,Moldova,POL,Poland,2009,468,0,468
MDA,Moldova,POL,Poland,2010,353,0,353
MDA,Moldova,POL,Poland,2011,353,0,353
MDA,Moldova,POL,Poland,2012,404,0,404
MDA,Moldova,POL,Poland,2013,358,0,358
MDA,Moldova,POL,Poland,2014,297,0,297
MDA,Moldova,POL,Poland,2015,510,0,510
MDA,Moldova,POL,Poland,2016,706,0,706
MDA,Moldova,POL,Poland,2017,919,0,919
MDA,Moldova,PRT,Portugal,2008,2438,0,2438
MDA,Moldova,PRT,Portugal,2009,1533,0,1533
MDA,Moldova,PRT,Portugal,2010,1152,0,1152
MDA,Moldova,PRT,Portugal,2011,863,0,863
MDA,Moldova,PRT,Portugal,2012,473,0,473
MDA,Moldova,PRT,Portugal,2013,299,0,299
MDA,Moldova,PRT,Portugal,2014,251,0,251
MDA,Moldova,PRT,Portugal,2015,235,0,235
MDA,Moldova,PRT,Portugal,2016,249,0,249
MDA,Moldova,PRT,Portugal,2017,256,0,256
MDA,Moldova,SVK,Slovak Republic,2008,1,15,-14
MDA,Moldova,SVK,Slovak Republic,2009,1,13,-12
MDA,Moldova,SVK,Slovak Republic,2010,3,13,-10
MDA,Moldova,SVK,Slovak Republic,2011,1,4,-3
MDA,Moldova,SVK,Slovak Republic,2012,1,1,0
MDA,Moldova,SVK,Slovak Republic,2013,4,0,4
MDA,Moldova,SVK,Slovak Republic,2014,1,0,1
MDA,Moldova,SVK,Slovak Republic,2015,1,0,1
MDA,Moldova,ESP,Spain,2008,2299,874,1425
MDA,Moldova,ESP,Spain,2009,1282,1111,171
MDA,Moldova,ESP,Spain,2010,879,992,-113
MDA,Moldova,ESP,Spain,2011,802,983,-181
MDA,Moldova,ESP,Spain,2012,574,906,-332
MDA,Moldova,ESP,Spain,2013,486,986,-500
MDA,Moldova,ESP,Spain,2014,698,506,192
MDA,Moldova,ESP,Spain,2015,888,365,523
MDA,Moldova,ESP,Spain,2016,933,447,486
MDA,Moldova,ESP,Spain,2017,1027,546,481
MDA,Moldova,SWE,Sweden,2008,40,10,30
MDA,Moldova,SWE,Sweden,2009,54,2,52
MDA,Moldova,SWE,Sweden,2010,39,12,27
MDA,Moldova,SWE,Sweden,2011,25,18,7
MDA,Moldova,SWE,Sweden,2012,54,4,50
MDA,Moldova,SWE,Sweden,2013,45,1,44
MDA,Moldova,SWE,Sweden,2014,31,7,24
MDA,Moldova,SWE,Sweden,2015,58,25,33
MDA,Moldova,SWE,Sweden,2016,43,9,34
MDA,Moldova,SWE,Sweden,2017,32,5,27
MDA,Moldova,CHE,Switzerland,2010,113,49,64
MDA,Moldova,CHE,Switzerland,2011,84,34,50
MDA,Moldova,CHE,Switzerland,2012,66,31,35
MDA,Moldova,CHE,Switzerland,2013,80,18,62
MDA,Moldova,CHE,Switzerland,2014,58,23,35
MDA,Moldova,CHE,Switzerland,2015,56,24,32
MDA,Moldova,CHE,Switzerland,2016,64,21,43
MDA,Moldova,CHE,Switzerland,2017,49,16,33
MDA,Moldova,TUR,Turkey,2010,575,0,575
MDA,Moldova,TUR,Turkey,2016,2388,1406,982
MDA,Moldova,TUR,Turkey,2017,2517,1496,1021
MDA,Moldova,GBR,United Kingdom,2014,1000,0,1000
MDA,Moldova,USA,United States,2008,1692,0,1692
MDA,Moldova,USA,United States,2009,2295,0,2295
MDA,Moldova,USA,United States,2010,1981,0,1981
MDA,Moldova,USA,United States,2011,2258,0,2258
MDA,Moldova,USA,United States,2012,2021,0,2021
MDA,Moldova,USA,United States,2013,2485,0,2485
MDA,Moldova,USA,United States,2014,2341,0,2341
MDA,Moldova,USA,United States,2015,2496,0,2496
MDA,Moldova,USA,United States,2016,2929,0,2929
MDA,Moldova,USA,United States,2017,2480,0,2480
MDA,Moldova,CHL,Chile,2008,1,0,1
MDA,Moldova,CHL,Chile,2009,1,0,1
MDA,Moldova,CHL,Chile,2010,3,0,3
MDA,Moldova,CHL,Chile,2011,5,0,5
MDA,Moldova,CHL,Chile,2012,5,0,5
MDA,Moldova,CHL,Chile,2013,3,0,3
MDA,Moldova,CHL,Chile,2014,1,0,1
MDA,Moldova,CHL,Chile,2015,4,0,4
MDA,Moldova,CHL,Chile,2016,2,0,2
MDA,Moldova,EST,Estonia,2008,14,0,14
MDA,Moldova,EST,Estonia,2009,12,0,12
MDA,Moldova,EST,Estonia,2010,4,0,4
MDA,Moldova,EST,Estonia,2011,13,0,13
MDA,Moldova,EST,Estonia,2012,8,0,8
MDA,Moldova,EST,Estonia,2013,10,0,10
MDA,Moldova,EST,Estonia,2014,3,0,3
MDA,Moldova,EST,Estonia,2015,9,0,9
MDA,Moldova,EST,Estonia,2016,17,0,17
MDA,Moldova,EST,Estonia,2017,19,0,19
MDA,Moldova,SVN,Slovenia,2008,136,0,136
MDA,Moldova,SVN,Slovenia,2009,102,0,102
MDA,Moldova,SVN,Slovenia,2010,68,0,68
MDA,Moldova,SVN,Slovenia,2011,59,10,49
MDA,Moldova,SVN,Slovenia,2012,34,8,26
MDA,Moldova,SVN,Slovenia,2013,24,6,18
MDA,Moldova,SVN,Slovenia,2014,14,1,13
MDA,Moldova,SVN,Slovenia,2015,18,5,13
MDA,Moldova,SVN,Slovenia,2016,16,5,11
MDA,Moldova,SVN,Slovenia,2017,35,6,29
MCO,Monaco,AUS,Australia,2008,1,0,1
MCO,Monaco,AUS,Australia,2009,0,0,0
MCO,Monaco,AUS,Australia,2010,0,0,0
MCO,Monaco,AUS,Australia,2011,0,0,0
MCO,Monaco,AUS,Australia,2012,0,0,0
MCO,Monaco,AUS,Australia,2013,0,0,0
MCO,Monaco,AUS,Australia,2014,0,0,0
MCO,Monaco,AUS,Australia,2015,0,0,0
MCO,Monaco,AUS,Australia,2017,0,0,0
MCO,Monaco,AUT,Austria,2008,4,0,4
MCO,Monaco,AUT,Austria,2009,5,3,2
MCO,Monaco,AUT,Austria,2010,0,0,0
MCO,Monaco,AUT,Austria,2011,1,0,1
MCO,Monaco,AUT,Austria,2012,0,0,0
MCO,Monaco,AUT,Austria,2013,1,0,1
MCO,Monaco,AUT,Austria,2014,0,0,0
MCO,Monaco,AUT,Austria,2015,0,0,0
MCO,Monaco,AUT,Austria,2016,0,0,0
MCO,Monaco,AUT,Austria,2017,0,0,0
MCO,Monaco,BEL,Belgium,2008,0,0,0
MCO,Monaco,BEL,Belgium,2009,1,0,1
MCO,Monaco,BEL,Belgium,2010,0,1,-1
MCO,Monaco,BEL,Belgium,2013,1,1,0
MCO,Monaco,BEL,Belgium,2014,1,2,-1
MCO,Monaco,BEL,Belgium,2016,1,0,1
MCO,Monaco,BEL,Belgium,2017,2,0,2
MCO,Monaco,CAN,Canada,2008,0,0,0
MCO,Monaco,CAN,Canada,2009,0,0,0
MCO,Monaco,CAN,Canada,2010,4,0,4
MCO,Monaco,CAN,Canada,2011,1,0,1
MCO,Monaco,CAN,Canada,2012,3,0,3
MCO,Monaco,CAN,Canada,2013,1,0,1
MCO,Monaco,CAN,Canada,2014,0,0,0
MCO,Monaco,CAN,Canada,2015,0,0,0
MCO,Monaco,CAN,Canada,2016,0,0,0
MCO,Monaco,CAN,Canada,2017,0,0,0
MCO,Monaco,DNK,Denmark,2013,0,0,0
MCO,Monaco,DNK,Denmark,2014,0,0,0
MCO,Monaco,DNK,Denmark,2015,0,0,0
MCO,Monaco,DNK,Denmark,2016,0,0,0
MCO,Monaco,DNK,Denmark,2017,0,0,0
MCO,Monaco,FIN,Finland,2008,0,0,0
MCO,Monaco,FIN,Finland,2009,0,0,0
MCO,Monaco,FIN,Finland,2010,0,0,0
MCO,Monaco,FIN,Finland,2011,0,0,0
MCO,Monaco,FIN,Finland,2012,0,0,0
MCO,Monaco,FIN,Finland,2013,0,0,0
MCO,Monaco,FIN,Finland,2014,0,0,0
MCO,Monaco,FIN,Finland,2015,0,0,0
MCO,Monaco,FIN,Finland,2016,0,0,0
MCO,Monaco,FIN,Finland,2017,0,0,0
MCO,Monaco,FRA,France,2008,0,0,0
MCO,Monaco,FRA,France,2009,1,0,1
MCO,Monaco,FRA,France,2010,0,0,0
MCO,Monaco,FRA,France,2011,0,0,0
MCO,Monaco,FRA,France,2012,0,0,0
MCO,Monaco,FRA,France,2013,0,0,0
MCO,Monaco,FRA,France,2014,0,0,0
MCO,Monaco,FRA,France,2015,0,0,0
MCO,Monaco,FRA,France,2016,0,0,0
MCO,Monaco,FRA,France,2017,0,0,0
MCO,Monaco,DEU,Germany,2008,8,2,6
MCO,Monaco,DEU,Germany,2009,1,10,-9
MCO,Monaco,DEU,Germany,2010,4,0,4
MCO,Monaco,DEU,Germany,2011,3,2,1
MCO,Monaco,DEU,Germany,2012,3,1,2
MCO,Monaco,DEU,Germany,2013,1,1,0
MCO,Monaco,DEU,Germany,2014,6,2,4
MCO,Monaco,DEU,Germany,2015,6,1,5
MCO,Monaco,DEU,Germany,2016,0,1,-1
MCO,Monaco,DEU,Germany,2017,3,0,3
MCO,Monaco,HUN,Hungary,2008,0,0,0
MCO,Monaco,HUN,Hungary,2009,0,0,0
MCO,Monaco,HUN,Hungary,2010,0,0,0
MCO,Monaco,HUN,Hungary,2011,0,0,0
MCO,Monaco,HUN,Hungary,2012,0,0,0
MCO,Monaco,HUN,Hungary,2013,0,0,0
MCO,Monaco,HUN,Hungary,2014,0,0,0
MCO,Monaco,HUN,Hungary,2015,0,0,0
MCO,Monaco,HUN,Hungary,2016,0,0,0
MCO,Monaco,HUN,Hungary,2017,0,0,0
MCO,Monaco,ISL,Iceland,2008,0,0,0
MCO,Monaco,ISL,Iceland,2009,0,0,0
MCO,Monaco,ISL,Iceland,2010,0,0,0
MCO,Monaco,ISL,Iceland,2011,0,0,0
MCO,Monaco,ISL,Iceland,2012,0,0,0
MCO,Monaco,ISL,Iceland,2014,1,0,1
MCO,Monaco,ISL,Iceland,2016,0,0,0
MCO,Monaco,ISL,Iceland,2017,0,0,0
MCO,Monaco,ITA,Italy,2008,8,1,7
MCO,Monaco,ITA,Italy,2009,9,1,8
MCO,Monaco,ITA,Italy,2010,8,1,7
MCO,Monaco,ITA,Italy,2011,4,0,4
MCO,Monaco,ITA,Italy,2012,1,1,0
MCO,Monaco,ITA,Italy,2013,7,6,1
MCO,Monaco,ITA,Italy,2014,2,0,2
MCO,Monaco,ITA,Italy,2015,2,1,1
MCO,Monaco,ITA,Italy,2016,1,0,1
MCO,Monaco,ITA,Italy,2017,8,0,8
MCO,Monaco,JPN,Japan,2008,6,6,0
MCO,Monaco,JPN,Japan,2009,4,4,0
MCO,Monaco,JPN,Japan,2010,0,0,0
MCO,Monaco,JPN,Japan,2011,4,3,1
MCO,Monaco,JPN,Japan,2012,4,3,1
MCO,Monaco,JPN,Japan,2013,0,0,0
MCO,Monaco,JPN,Japan,2014,0,0,0
MCO,Monaco,JPN,Japan,2015,1,1,0
MCO,Monaco,JPN,Japan,2016,8,8,0
MCO,Monaco,JPN,Japan,2017,2,3,-1
MCO,Monaco,KOR,Korea,2008,0,1,-1
MCO,Monaco,KOR,Korea,2009,0,0,0
MCO,Monaco,KOR,Korea,2010,0,0,0
MCO,Monaco,KOR,Korea,2011,0,0,0
MCO,Monaco,KOR,Korea,2012,2,1,1
MCO,Monaco,KOR,Korea,2013,0,0,0
MCO,Monaco,KOR,Korea,2014,0,0,0
MCO,Monaco,KOR,Korea,2015,1,1,0
MCO,Monaco,KOR,Korea,2016,0,0,0
MCO,Monaco,KOR,Korea,2017,0,0,0
MCO,Monaco,LUX,Luxembourg,2008,0,0,0
MCO,Monaco,LUX,Luxembourg,2009,1,0,1
MCO,Monaco,LUX,Luxembourg,2010,0,1,-1
MCO,Monaco,LUX,Luxembourg,2011,0,0,0
MCO,Monaco,LUX,Luxembourg,2012,0,0,0
MCO,Monaco,LUX,Luxembourg,2013,1,0,1
MCO,Monaco,LUX,Luxembourg,2014,0,0,0
MCO,Monaco,LUX,Luxembourg,2015,0,0,0
MCO,Monaco,LUX,Luxembourg,2016,0,0,0
MCO,Monaco,LUX,Luxembourg,2017,0,0,0
MCO,Monaco,MEX,Mexico,2012,0,0,0
MCO,Monaco,MEX,Mexico,2013,0,0,0
MCO,Monaco,MEX,Mexico,2014,0,0,0
MCO,Monaco,NLD,Netherlands,2010,1,0,1
MCO,Monaco,NLD,Netherlands,2011,3,1,2
MCO,Monaco,NLD,Netherlands,2013,0,1,-1
MCO,Monaco,NLD,Netherlands,2014,1,0,1
MCO,Monaco,NLD,Netherlands,2017,0,2,-2
MCO,Monaco,NZL,New Zealand,2013,1,0,1
MCO,Monaco,NZL,New Zealand,2015,1,0,1
MCO,Monaco,NZL,New Zealand,2017,2,0,2
MCO,Monaco,NOR,Norway,2008,3,0,3
MCO,Monaco,NOR,Norway,2009,1,1,0
MCO,Monaco,NOR,Norway,2010,0,0,0
MCO,Monaco,NOR,Norway,2011,2,0,2
MCO,Monaco,NOR,Norway,2012,0,0,0
MCO,Monaco,NOR,Norway,2013,1,0,1
MCO,Monaco,NOR,Norway,2014,0,0,0
MCO,Monaco,NOR,Norway,2015,0,0,0
MCO,Monaco,NOR,Norway,2016,0,0,0
MCO,Monaco,NOR,Norway,2017,0,0,0
MCO,Monaco,POL,Poland,2009,0,0,0
MCO,Monaco,POL,Poland,2010,0,0,0
MCO,Monaco,POL,Poland,2011,0,0,0
MCO,Monaco,POL,Poland,2012,0,0,0
MCO,Monaco,POL,Poland,2013,0,0,0
MCO,Monaco,POL,Poland,2014,0,0,0
MCO,Monaco,POL,Poland,2015,0,0,0
MCO,Monaco,POL,Poland,2016,0,0,0
MCO,Monaco,POL,Poland,2017,0,0,0
MCO,Monaco,SVK,Slovak Republic,2008,0,0,0
MCO,Monaco,SVK,Slovak Republic,2011,1,0,1
MCO,Monaco,ESP,Spain,2008,0,0,0
MCO,Monaco,ESP,Spain,2009,2,0,2
MCO,Monaco,ESP,Spain,2010,2,0,2
MCO,Monaco,ESP,Spain,2011,3,0,3
MCO,Monaco,ESP,Spain,2012,1,0,1
MCO,Monaco,ESP,Spain,2013,0,1,-1
MCO,Monaco,ESP,Spain,2014,2,0,2
MCO,Monaco,ESP,Spain,2015,2,0,2
MCO,Monaco,ESP,Spain,2016,0,0,0
MCO,Monaco,SWE,Sweden,2008,0,0,0
MCO,Monaco,SWE,Sweden,2009,0,0,0
MCO,Monaco,SWE,Sweden,2010,1,0,1
MCO,Monaco,SWE,Sweden,2011,1,0,1
MCO,Monaco,SWE,Sweden,2012,0,0,0
MCO,Monaco,SWE,Sweden,2013,1,0,1
MCO,Monaco,SWE,Sweden,2014,0,0,0
MCO,Monaco,SWE,Sweden,2015,1,0,1
MCO,Monaco,SWE,Sweden,2016,0,0,0
MCO,Monaco,SWE,Sweden,2017,0,0,0
MCO,Monaco,CHE,Switzerland,2010,1,3,-2
MCO,Monaco,CHE,Switzerland,2011,12,2,10
MCO,Monaco,CHE,Switzerland,2012,4,2,2
MCO,Monaco,CHE,Switzerland,2013,3,0,3
MCO,Monaco,CHE,Switzerland,2014,1,2,-1
MCO,Monaco,CHE,Switzerland,2015,3,4,-1
MCO,Monaco,CHE,Switzerland,2016,2,4,-2
MCO,Monaco,CHE,Switzerland,2017,2,1,1
MCO,Monaco,USA,United States,2008,7,0,7
MCO,Monaco,USA,United States,2009,4,0,4
MCO,Monaco,USA,United States,2010,12,0,12
MCO,Monaco,USA,United States,2011,6,0,6
MCO,Monaco,USA,United States,2012,5,0,5
MCO,Monaco,USA,United States,2013,8,0,8
MCO,Monaco,USA,United States,2014,8,0,8
MCO,Monaco,USA,United States,2015,10,0,10
MCO,Monaco,USA,United States,2016,11,0,11
MCO,Monaco,USA,United States,2017,14,0,14
MCO,Monaco,CHL,Chile,2008,0,0,0
MCO,Monaco,CHL,Chile,2009,0,0,0
MCO,Monaco,CHL,Chile,2010,0,0,0
MCO,Monaco,CHL,Chile,2011,0,0,0
MCO,Monaco,CHL,Chile,2012,0,0,0
MCO,Monaco,CHL,Chile,2013,0,0,0
MCO,Monaco,CHL,Chile,2014,0,0,0
MCO,Monaco,CHL,Chile,2015,0,0,0
MCO,Monaco,CHL,Chile,2016,0,0,0
MCO,Monaco,EST,Estonia,2008,0,0,0
MCO,Monaco,EST,Estonia,2009,0,0,0
MCO,Monaco,EST,Estonia,2010,0,0,0
MCO,Monaco,EST,Estonia,2011,0,0,0
MCO,Monaco,EST,Estonia,2012,0,0,0
MCO,Monaco,EST,Estonia,2013,0,0,0
MCO,Monaco,EST,Estonia,2014,0,0,0
MCO,Monaco,EST,Estonia,2015,0,0,0
MCO,Monaco,EST,Estonia,2016,0,0,0
MCO,Monaco,EST,Estonia,2017,0,0,0
MNG,Mongolia,AUS,Australia,2008,38,0,38
MNG,Mongolia,AUS,Australia,2009,55,0,55
MNG,Mongolia,AUS,Australia,2010,45,0,45
MNG,Mongolia,AUS,Australia,2011,39,0,39
MNG,Mongolia,AUS,Australia,2012,58,0,58
MNG,Mongolia,AUS,Australia,2013,44,5,39
MNG,Mongolia,AUS,Australia,2014,47,6,41
MNG,Mongolia,AUS,Australia,2015,18,0,18
MNG,Mongolia,AUS,Australia,2016,44,0,44
MNG,Mongolia,AUS,Australia,2017,42,0,42
MNG,Mongolia,AUT,Austria,2008,281,203,78
MNG,Mongolia,AUT,Austria,2009,361,230,131
MNG,Mongolia,AUT,Austria,2010,226,336,-110
MNG,Mongolia,AUT,Austria,2011,317,286,31
MNG,Mongolia,AUT,Austria,2012,343,213,130
MNG,Mongolia,AUT,Austria,2013,309,201,108
MNG,Mongolia,AUT,Austria,2014,330,160,170
MNG,Mongolia,AUT,Austria,2015,436,184,252
MNG,Mongolia,AUT,Austria,2016,256,195,61
MNG,Mongolia,AUT,Austria,2017,193,192,1
MNG,Mongolia,BEL,Belgium,2008,36,0,36
MNG,Mongolia,BEL,Belgium,2009,45,0,45
MNG,Mongolia,BEL,Belgium,2010,65,2,63
MNG,Mongolia,BEL,Belgium,2012,92,44,48
MNG,Mongolia,BEL,Belgium,2013,52,83,-31
MNG,Mongolia,BEL,Belgium,2014,42,106,-64
MNG,Mongolia,BEL,Belgium,2015,62,58,4
MNG,Mongolia,BEL,Belgium,2016,30,29,1
MNG,Mongolia,BEL,Belgium,2017,34,22,12
MNG,Mongolia,CAN,Canada,2008,59,0,59
MNG,Mongolia,CAN,Canada,2009,118,0,118
MNG,Mongolia,CAN,Canada,2010,169,0,169
MNG,Mongolia,CAN,Canada,2011,103,0,103
MNG,Mongolia,CAN,Canada,2012,68,0,68
MNG,Mongolia,CAN,Canada,2013,99,0,99
MNG,Mongolia,CAN,Canada,2014,93,0,93
MNG,Mongolia,CAN,Canada,2015,45,0,45
MNG,Mongolia,CAN,Canada,2016,95,0,95
MNG,Mongolia,CAN,Canada,2017,85,0,85
MNG,Mongolia,CZE,Czech Republic,2008,3500,3,3497
MNG,Mongolia,CZE,Czech Republic,2009,513,2,511
MNG,Mongolia,CZE,Czech Republic,2010,327,0,327
MNG,Mongolia,CZE,Czech Republic,2011,159,9,150
MNG,Mongolia,CZE,Czech Republic,2012,345,169,176
MNG,Mongolia,CZE,Czech Republic,2013,148,269,-121
MNG,Mongolia,CZE,Czech Republic,2014,227,137,90
MNG,Mongolia,CZE,Czech Republic,2015,558,135,423
MNG,Mongolia,CZE,Czech Republic,2016,709,187,522
MNG,Mongolia,CZE,Czech Republic,2017,1165,210,955
MNG,Mongolia,DNK,Denmark,2008,13,14,-1
MNG,Mongolia,DNK,Denmark,2009,13,8,5
MNG,Mongolia,DNK,Denmark,2010,5,6,-1
MNG,Mongolia,DNK,Denmark,2011,7,12,-5
MNG,Mongolia,DNK,Denmark,2012,8,4,4
MNG,Mongolia,DNK,Denmark,2013,8,3,5
MNG,Mongolia,DNK,Denmark,2014,2,7,-5
MNG,Mongolia,DNK,Denmark,2015,5,8,-3
MNG,Mongolia,DNK,Denmark,2016,1,5,-4
MNG,Mongolia,DNK,Denmark,2017,4,3,1
MNG,Mongolia,FIN,Finland,2008,3,0,3
MNG,Mongolia,FIN,Finland,2009,1,0,1
MNG,Mongolia,FIN,Finland,2010,4,0,4
MNG,Mongolia,FIN,Finland,2011,4,0,4
MNG,Mongolia,FIN,Finland,2012,2,5,-3
MNG,Mongolia,FIN,Finland,2013,1,0,1
MNG,Mongolia,FIN,Finland,2014,5,0,5
MNG,Mongolia,FIN,Finland,2015,0,1,-1
MNG,Mongolia,FIN,Finland,2016,4,0,4
MNG,Mongolia,FIN,Finland,2017,3,0,3
MNG,Mongolia,FRA,France,2008,96,0,96
MNG,Mongolia,FRA,France,2009,101,0,101
MNG,Mongolia,FRA,France,2010,108,0,108
MNG,Mongolia,FRA,France,2011,105,0,105
MNG,Mongolia,FRA,France,2012,148,0,148
MNG,Mongolia,FRA,France,2013,159,0,159
MNG,Mongolia,FRA,France,2014,181,0,181
MNG,Mongolia,FRA,France,2015,224,0,224
MNG,Mongolia,FRA,France,2016,217,0,217
MNG,Mongolia,FRA,France,2017,252,0,252
MNG,Mongolia,DEU,Germany,2008,399,692,-293
MNG,Mongolia,DEU,Germany,2009,393,821,-428
MNG,Mongolia,DEU,Germany,2010,492,644,-152
MNG,Mongolia,DEU,Germany,2011,531,431,100
MNG,Mongolia,DEU,Germany,2012,485,441,44
MNG,Mongolia,DEU,Germany,2013,598,425,173
MNG,Mongolia,DEU,Germany,2014,952,544,408
MNG,Mongolia,DEU,Germany,2015,1298,642,656
MNG,Mongolia,DEU,Germany,2016,779,811,-32
MNG,Mongolia,DEU,Germany,2017,818,603,215
MNG,Mongolia,HUN,Hungary,2008,270,50,220
MNG,Mongolia,HUN,Hungary,2009,118,40,78
MNG,Mongolia,HUN,Hungary,2010,96,95,1
MNG,Mongolia,HUN,Hungary,2011,84,33,51
MNG,Mongolia,HUN,Hungary,2012,72,84,-12
MNG,Mongolia,HUN,Hungary,2013,65,66,-1
MNG,Mongolia,HUN,Hungary,2014,63,38,25
MNG,Mongolia,HUN,Hungary,2015,98,24,74
MNG,Mongolia,HUN,Hungary,2016,169,37,132
MNG,Mongolia,HUN,Hungary,2017,271,32,239
MNG,Mongolia,ISL,Iceland,2008,6,5,1
MNG,Mongolia,ISL,Iceland,2009,3,6,-3
MNG,Mongolia,ISL,Iceland,2010,4,6,-2
MNG,Mongolia,ISL,Iceland,2011,3,2,1
MNG,Mongolia,ISL,Iceland,2012,4,2,2
MNG,Mongolia,ISL,Iceland,2013,1,7,-6
MNG,Mongolia,ISL,Iceland,2014,2,3,-1
MNG,Mongolia,ISL,Iceland,2015,3,4,-1
MNG,Mongolia,ISL,Iceland,2016,3,4,-1
MNG,Mongolia,ISL,Iceland,2017,3,3,0
MNG,Mongolia,ITA,Italy,2008,28,0,28
MNG,Mongolia,ITA,Italy,2009,15,0,15
MNG,Mongolia,ITA,Italy,2010,29,1,28
MNG,Mongolia,ITA,Italy,2011,31,0,31
MNG,Mongolia,ITA,Italy,2012,17,1,16
MNG,Mongolia,ITA,Italy,2013,21,5,16
MNG,Mongolia,ITA,Italy,2014,8,4,4
MNG,Mongolia,ITA,Italy,2015,15,1,14
MNG,Mongolia,ITA,Italy,2016,14,0,14
MNG,Mongolia,ITA,Italy,2017,14,4,10
MNG,Mongolia,JPN,Japan,2008,1326,752,574
MNG,Mongolia,JPN,Japan,2009,1163,861,302
MNG,Mongolia,JPN,Japan,2010,1182,929,253
MNG,Mongolia,JPN,Japan,2011,1278,1071,207
MNG,Mongolia,JPN,Japan,2012,1514,991,523
MNG,Mongolia,JPN,Japan,2013,1546,900,646
MNG,Mongolia,JPN,Japan,2014,1966,1096,870
MNG,Mongolia,JPN,Japan,2015,2336,1264,1072
MNG,Mongolia,JPN,Japan,2016,2507,1211,1296
MNG,Mongolia,JPN,Japan,2017,3187,1484,1703
MNG,Mongolia,KOR,Korea,2008,8065,8517,-452
MNG,Mongolia,KOR,Korea,2009,5276,7845,-2569
MNG,Mongolia,KOR,Korea,2010,5430,6733,-1303
MNG,Mongolia,KOR,Korea,2011,4268,7212,-2944
MNG,Mongolia,KOR,Korea,2012,5676,8931,-3255
MNG,Mongolia,KOR,Korea,2013,4331,7090,-2759
MNG,Mongolia,KOR,Korea,2014,3966,5297,-1331
MNG,Mongolia,KOR,Korea,2015,8286,4582,3704
MNG,Mongolia,KOR,Korea,2016,8155,5324,2831
MNG,Mongolia,KOR,Korea,2017,11781,6088,5693
MNG,Mongolia,LUX,Luxembourg,2008,3,1,2
MNG,Mongolia,LUX,Luxembourg,2009,3,2,1
MNG,Mongolia,LUX,Luxembourg,2010,5,0,5
MNG,Mongolia,LUX,Luxembourg,2011,3,1,2
MNG,Mongolia,LUX,Luxembourg,2012,3,3,0
MNG,Mongolia,LUX,Luxembourg,2013,4,0,4
MNG,Mongolia,LUX,Luxembourg,2014,8,3,5
MNG,Mongolia,LUX,Luxembourg,2015,8,3,5
MNG,Mongolia,LUX,Luxembourg,2016,10,1,9
MNG,Mongolia,LUX,Luxembourg,2017,5,5,0
MNG,Mongolia,MEX,Mexico,2009,4,0,4
MNG,Mongolia,MEX,Mexico,2011,1,0,1
MNG,Mongolia,MEX,Mexico,2012,0,0,0
MNG,Mongolia,MEX,Mexico,2013,4,0,4
MNG,Mongolia,MEX,Mexico,2014,2,0,2
MNG,Mongolia,MEX,Mexico,2015,1,0,1
MNG,Mongolia,MEX,Mexico,2016,3,0,3
MNG,Mongolia,MEX,Mexico,2017,1,0,1
MNG,Mongolia,NLD,Netherlands,2008,35,14,21
MNG,Mongolia,NLD,Netherlands,2009,32,21,11
MNG,Mongolia,NLD,Netherlands,2010,26,11,15
MNG,Mongolia,NLD,Netherlands,2011,25,26,-1
MNG,Mongolia,NLD,Netherlands,2012,28,17,11
MNG,Mongolia,NLD,Netherlands,2013,16,14,2
MNG,Mongolia,NLD,Netherlands,2014,28,21,7
MNG,Mongolia,NLD,Netherlands,2015,55,12,43
MNG,Mongolia,NLD,Netherlands,2016,57,20,37
MNG,Mongolia,NLD,Netherlands,2017,40,29,11
MNG,Mongolia,NZL,New Zealand,2008,14,3,11
MNG,Mongolia,NZL,New Zealand,2009,14,13,1
MNG,Mongolia,NZL,New Zealand,2010,11,4,7
MNG,Mongolia,NZL,New Zealand,2011,7,15,-8
MNG,Mongolia,NZL,New Zealand,2012,10,4,6
MNG,Mongolia,NZL,New Zealand,2013,10,9,1
MNG,Mongolia,NZL,New Zealand,2014,9,10,-1
MNG,Mongolia,NZL,New Zealand,2015,11,12,-1
MNG,Mongolia,NZL,New Zealand,2016,12,13,-1
MNG,Mongolia,NZL,New Zealand,2017,18,3,15
MNG,Mongolia,NOR,Norway,2008,10,3,7
MNG,Mongolia,NOR,Norway,2009,14,7,7
MNG,Mongolia,NOR,Norway,2010,7,4,3
MNG,Mongolia,NOR,Norway,2011,12,4,8
MNG,Mongolia,NOR,Norway,2012,12,4,8
MNG,Mongolia,NOR,Norway,2013,16,6,10
MNG,Mongolia,NOR,Norway,2014,11,4,7
MNG,Mongolia,NOR,Norway,2015,11,9,2
MNG,Mongolia,NOR,Norway,2016,12,5,7
MNG,Mongolia,NOR,Norway,2017,14,11,3
MNG,Mongolia,POL,Poland,2008,401,0,401
MNG,Mongolia,POL,Poland,2009,418,0,418
MNG,Mongolia,POL,Poland,2010,355,0,355
MNG,Mongolia,POL,Poland,2011,308,0,308
MNG,Mongolia,POL,Poland,2012,292,0,292
MNG,Mongolia,POL,Poland,2013,270,0,270
MNG,Mongolia,POL,Poland,2014,148,0,148
MNG,Mongolia,POL,Poland,2015,233,0,233
MNG,Mongolia,POL,Poland,2016,181,0,181
MNG,Mongolia,POL,Poland,2017,120,0,120
MNG,Mongolia,SVK,Slovak Republic,2008,10,3,7
MNG,Mongolia,SVK,Slovak Republic,2009,13,3,10
MNG,Mongolia,SVK,Slovak Republic,2010,1,5,-4
MNG,Mongolia,SVK,Slovak Republic,2011,1,3,-2
MNG,Mongolia,SVK,Slovak Republic,2012,4,0,4
MNG,Mongolia,SVK,Slovak Republic,2016,1,0,1
MNG,Mongolia,SVK,Slovak Republic,2017,1,0,1
MNG,Mongolia,ESP,Spain,2008,72,15,57
MNG,Mongolia,ESP,Spain,2009,111,26,85
MNG,Mongolia,ESP,Spain,2010,111,43,68
MNG,Mongolia,ESP,Spain,2011,101,57,44
MNG,Mongolia,ESP,Spain,2012,54,65,-11
MNG,Mongolia,ESP,Spain,2013,56,102,-46
MNG,Mongolia,ESP,Spain,2014,65,46,19
MNG,Mongolia,ESP,Spain,2015,81,46,35
MNG,Mongolia,ESP,Spain,2016,82,44,38
MNG,Mongolia,ESP,Spain,2017,97,48,49
MNG,Mongolia,SWE,Sweden,2008,95,6,89
MNG,Mongolia,SWE,Sweden,2009,153,9,144
MNG,Mongolia,SWE,Sweden,2010,351,4,347
MNG,Mongolia,SWE,Sweden,2011,562,9,553
MNG,Mongolia,SWE,Sweden,2012,481,18,463
MNG,Mongolia,SWE,Sweden,2013,357,36,321
MNG,Mongolia,SWE,Sweden,2014,383,82,301
MNG,Mongolia,SWE,Sweden,2015,342,68,274
MNG,Mongolia,SWE,Sweden,2016,320,36,284
MNG,Mongolia,SWE,Sweden,2017,564,20,544
MNG,Mongolia,CHE,Switzerland,2010,86,18,68
MNG,Mongolia,CHE,Switzerland,2011,54,19,35
MNG,Mongolia,CHE,Switzerland,2012,73,17,56
MNG,Mongolia,CHE,Switzerland,2013,73,36,37
MNG,Mongolia,CHE,Switzerland,2014,81,34,47
MNG,Mongolia,CHE,Switzerland,2015,74,21,53
MNG,Mongolia,CHE,Switzerland,2016,76,21,55
MNG,Mongolia,CHE,Switzerland,2017,130,23,107
MNG,Mongolia,TUR,Turkey,2010,171,0,171
MNG,Mongolia,TUR,Turkey,2016,358,275,83
MNG,Mongolia,TUR,Turkey,2017,546,346,200
MNG,Mongolia,USA,United States,2008,659,0,659
MNG,Mongolia,USA,United States,2009,831,0,831
MNG,Mongolia,USA,United States,2010,594,0,594
MNG,Mongolia,USA,United States,2011,774,0,774
MNG,Mongolia,USA,United States,2012,691,0,691
MNG,Mongolia,USA,United States,2013,729,0,729
MNG,Mongolia,USA,United States,2014,651,0,651
MNG,Mongolia,USA,United States,2015,644,0,644
MNG,Mongolia,USA,United States,2016,750,0,750
MNG,Mongolia,USA,United States,2017,661,0,661
MNG,Mongolia,CHL,Chile,2008,0,0,0
MNG,Mongolia,CHL,Chile,2009,0,0,0
MNG,Mongolia,CHL,Chile,2010,0,0,0
MNG,Mongolia,CHL,Chile,2011,0,0,0
MNG,Mongolia,CHL,Chile,2012,0,0,0
MNG,Mongolia,CHL,Chile,2013,0,0,0
MNG,Mongolia,CHL,Chile,2014,0,0,0
MNG,Mongolia,CHL,Chile,2015,0,0,0
MNG,Mongolia,CHL,Chile,2016,1,0,1
MNG,Mongolia,EST,Estonia,2008,0,0,0
MNG,Mongolia,EST,Estonia,2009,0,0,0
MNG,Mongolia,EST,Estonia,2010,0,0,0
MNG,Mongolia,EST,Estonia,2011,0,0,0
MNG,Mongolia,EST,Estonia,2012,0,0,0
MNG,Mongolia,EST,Estonia,2013,0,0,0
MNG,Mongolia,EST,Estonia,2014,1,0,1
MNG,Mongolia,EST,Estonia,2015,1,0,1
MNG,Mongolia,EST,Estonia,2016,0,0,0
MNG,Mongolia,EST,Estonia,2017,0,0,0
MNE,Montenegro,AUS,Australia,2008,10,10,0
MNE,Montenegro,AUS,Australia,2009,8,11,-3
MNE,Montenegro,AUS,Australia,2010,7,13,-6
MNE,Montenegro,AUS,Australia,2011,11,6,5
MNE,Montenegro,AUS,Australia,2012,14,8,6
MNE,Montenegro,AUS,Australia,2013,11,0,11
MNE,Montenegro,AUS,Australia,2014,18,6,12
MNE,Montenegro,AUS,Australia,2015,17,0,17
MNE,Montenegro,AUS,Australia,2016,13,0,13
MNE,Montenegro,AUS,Australia,2017,8,0,8
MNE,Montenegro,AUT,Austria,2008,63,37,26
MNE,Montenegro,AUT,Austria,2009,54,57,-3
MNE,Montenegro,AUT,Austria,2010,76,64,12
MNE,Montenegro,AUT,Austria,2011,94,59,35
MNE,Montenegro,AUT,Austria,2012,118,80,38
MNE,Montenegro,AUT,Austria,2013,144,64,80
MNE,Montenegro,AUT,Austria,2014,155,63,92
MNE,Montenegro,AUT,Austria,2015,158,82,76
MNE,Montenegro,AUT,Austria,2016,148,106,42
MNE,Montenegro,AUT,Austria,2017,130,97,33
MNE,Montenegro,BEL,Belgium,2008,17,0,17
MNE,Montenegro,BEL,Belgium,2009,17,0,17
MNE,Montenegro,BEL,Belgium,2010,50,7,43
MNE,Montenegro,BEL,Belgium,2012,126,67,59
MNE,Montenegro,BEL,Belgium,2013,18,50,-32
MNE,Montenegro,BEL,Belgium,2014,40,33,7
MNE,Montenegro,BEL,Belgium,2015,34,25,9
MNE,Montenegro,BEL,Belgium,2016,36,15,21
MNE,Montenegro,BEL,Belgium,2017,35,5,30
MNE,Montenegro,CAN,Canada,2008,15,0,15
MNE,Montenegro,CAN,Canada,2009,8,0,8
MNE,Montenegro,CAN,Canada,2010,13,0,13
MNE,Montenegro,CAN,Canada,2011,18,0,18
MNE,Montenegro,CAN,Canada,2012,24,0,24
MNE,Montenegro,CAN,Canada,2013,9,0,9
MNE,Montenegro,CAN,Canada,2014,7,0,7
MNE,Montenegro,CAN,Canada,2015,23,0,23
MNE,Montenegro,CAN,Canada,2016,25,0,25
MNE,Montenegro,CAN,Canada,2017,10,0,10
MNE,Montenegro,CZE,Czech Republic,2008,7,0,7
MNE,Montenegro,CZE,Czech Republic,2009,10,0,10
MNE,Montenegro,CZE,Czech Republic,2010,7,0,7
MNE,Montenegro,CZE,Czech Republic,2011,4,1,3
MNE,Montenegro,CZE,Czech Republic,2012,8,3,5
MNE,Montenegro,CZE,Czech Republic,2013,11,7,4
MNE,Montenegro,CZE,Czech Republic,2014,12,11,1
MNE,Montenegro,CZE,Czech Republic,2015,17,7,10
MNE,Montenegro,CZE,Czech Republic,2016,19,7,12
MNE,Montenegro,CZE,Czech Republic,2017,14,11,3
MNE,Montenegro,DNK,Denmark,2008,10,1,9
MNE,Montenegro,DNK,Denmark,2009,15,2,13
MNE,Montenegro,DNK,Denmark,2010,13,1,12
MNE,Montenegro,DNK,Denmark,2011,4,2,2
MNE,Montenegro,DNK,Denmark,2012,13,2,11
MNE,Montenegro,DNK,Denmark,2013,6,6,0
MNE,Montenegro,DNK,Denmark,2014,15,0,15
MNE,Montenegro,DNK,Denmark,2015,13,6,7
MNE,Montenegro,DNK,Denmark,2016,12,3,9
MNE,Montenegro,DNK,Denmark,2017,15,7,8
MNE,Montenegro,FIN,Finland,2008,5,0,5
MNE,Montenegro,FIN,Finland,2009,2,0,2
MNE,Montenegro,FIN,Finland,2010,1,0,1
MNE,Montenegro,FIN,Finland,2011,0,0,0
MNE,Montenegro,FIN,Finland,2012,2,0,2
MNE,Montenegro,FIN,Finland,2013,0,0,0
MNE,Montenegro,FIN,Finland,2014,0,0,0
MNE,Montenegro,FIN,Finland,2015,2,0,2
MNE,Montenegro,FIN,Finland,2016,14,0,14
MNE,Montenegro,FIN,Finland,2017,2,0,2
MNE,Montenegro,FRA,France,2008,26,0,26
MNE,Montenegro,FRA,France,2009,29,0,29
MNE,Montenegro,FRA,France,2010,36,0,36
MNE,Montenegro,FRA,France,2011,42,0,42
MNE,Montenegro,FRA,France,2012,70,0,70
MNE,Montenegro,FRA,France,2013,114,0,114
MNE,Montenegro,FRA,France,2014,119,0,119
MNE,Montenegro,FRA,France,2015,106,0,106
MNE,Montenegro,FRA,France,2016,120,0,120
MNE,Montenegro,FRA,France,2017,123,0,123
MNE,Montenegro,DEU,Germany,2008,370,217,153
MNE,Montenegro,DEU,Germany,2009,422,276,146
MNE,Montenegro,DEU,Germany,2010,640,441,199
MNE,Montenegro,DEU,Germany,2011,655,417,238
MNE,Montenegro,DEU,Germany,2012,988,564,424
MNE,Montenegro,DEU,Germany,2013,999,692,307
MNE,Montenegro,DEU,Germany,2014,2367,799,1568
MNE,Montenegro,DEU,Germany,2015,5194,1921,3273
MNE,Montenegro,DEU,Germany,2016,1990,4005,-2015
MNE,Montenegro,DEU,Germany,2017,2230,1825,405
MNE,Montenegro,HUN,Hungary,2008,8,1,7
MNE,Montenegro,HUN,Hungary,2009,14,1,13
MNE,Montenegro,HUN,Hungary,2010,12,5,7
MNE,Montenegro,HUN,Hungary,2011,24,4,20
MNE,Montenegro,HUN,Hungary,2012,19,12,7
MNE,Montenegro,HUN,Hungary,2013,34,7,27
MNE,Montenegro,HUN,Hungary,2014,25,3,22
MNE,Montenegro,HUN,Hungary,2015,49,8,41
MNE,Montenegro,HUN,Hungary,2016,26,7,19
MNE,Montenegro,HUN,Hungary,2017,45,0,45
MNE,Montenegro,ISL,Iceland,2008,0,0,0
MNE,Montenegro,ISL,Iceland,2009,0,0,0
MNE,Montenegro,ISL,Iceland,2010,0,0,0
MNE,Montenegro,ISL,Iceland,2011,1,0,1
MNE,Montenegro,ISL,Iceland,2012,0,0,0
MNE,Montenegro,ISL,Iceland,2013,0,1,-1
MNE,Montenegro,ISL,Iceland,2014,2,0,2
MNE,Montenegro,ISL,Iceland,2015,4,2,2
MNE,Montenegro,ISL,Iceland,2016,0,2,-2
MNE,Montenegro,ISL,Iceland,2017,4,2,2
MNE,Montenegro,ITA,Italy,2008,56,9,47
MNE,Montenegro,ITA,Italy,2009,44,12,32
MNE,Montenegro,ITA,Italy,2010,65,1,64
MNE,Montenegro,ITA,Italy,2011,87,8,79
MNE,Montenegro,ITA,Italy,2012,60,10,50
MNE,Montenegro,ITA,Italy,2013,84,18,66
MNE,Montenegro,ITA,Italy,2014,98,59,39
MNE,Montenegro,ITA,Italy,2015,95,24,71
MNE,Montenegro,ITA,Italy,2016,70,0,70
MNE,Montenegro,ITA,Italy,2017,74,14,60
MNE,Montenegro,JPN,Japan,2008,4,1,3
MNE,Montenegro,JPN,Japan,2009,9,7,2
MNE,Montenegro,JPN,Japan,2010,21,20,1
MNE,Montenegro,JPN,Japan,2011,5,3,2
MNE,Montenegro,JPN,Japan,2012,17,17,0
MNE,Montenegro,JPN,Japan,2013,19,16,3
MNE,Montenegro,JPN,Japan,2014,19,22,-3
MNE,Montenegro,JPN,Japan,2015,22,20,2
MNE,Montenegro,JPN,Japan,2016,19,20,-1
MNE,Montenegro,JPN,Japan,2017,10,8,2
MNE,Montenegro,KOR,Korea,2008,0,0,0
MNE,Montenegro,KOR,Korea,2009,2,0,2
MNE,Montenegro,KOR,Korea,2010,2,0,2
MNE,Montenegro,KOR,Korea,2011,4,5,-1
MNE,Montenegro,KOR,Korea,2012,3,0,3
MNE,Montenegro,KOR,Korea,2013,1,6,-5
MNE,Montenegro,KOR,Korea,2014,4,3,1
MNE,Montenegro,KOR,Korea,2015,3,2,1
MNE,Montenegro,KOR,Korea,2016,4,2,2
MNE,Montenegro,KOR,Korea,2017,5,4,1
MNE,Montenegro,LUX,Luxembourg,2008,40,9,31
MNE,Montenegro,LUX,Luxembourg,2009,55,12,43
MNE,Montenegro,LUX,Luxembourg,2010,57,14,43
MNE,Montenegro,LUX,Luxembourg,2011,152,19,133
MNE,Montenegro,LUX,Luxembourg,2012,257,62,195
MNE,Montenegro,LUX,Luxembourg,2013,182,91,91
MNE,Montenegro,LUX,Luxembourg,2014,208,100,108
MNE,Montenegro,LUX,Luxembourg,2015,156,155,1
MNE,Montenegro,LUX,Luxembourg,2016,165,48,117
MNE,Montenegro,LUX,Luxembourg,2017,120,39,81
MNE,Montenegro,MEX,Mexico,2010,2,0,2
MNE,Montenegro,MEX,Mexico,2012,0,0,0
MNE,Montenegro,MEX,Mexico,2013,1,0,1
MNE,Montenegro,MEX,Mexico,2014,1,0,1
MNE,Montenegro,MEX,Mexico,2015,2,0,2
MNE,Montenegro,MEX,Mexico,2017,2,0,2
MNE,Montenegro,NLD,Netherlands,2008,0,1,-1
MNE,Montenegro,NLD,Netherlands,2010,24,11,13
MNE,Montenegro,NLD,Netherlands,2011,19,10,9
MNE,Montenegro,NLD,Netherlands,2012,29,10,19
MNE,Montenegro,NLD,Netherlands,2013,28,18,10
MNE,Montenegro,NLD,Netherlands,2014,23,11,12
MNE,Montenegro,NLD,Netherlands,2015,21,11,10
MNE,Montenegro,NLD,Netherlands,2016,24,8,16
MNE,Montenegro,NLD,Netherlands,2017,21,10,11
MNE,Montenegro,NZL,New Zealand,2010,1,0,1
MNE,Montenegro,NZL,New Zealand,2011,1,0,1
MNE,Montenegro,NZL,New Zealand,2012,0,0,0
MNE,Montenegro,NZL,New Zealand,2015,1,0,1
MNE,Montenegro,NZL,New Zealand,2016,1,0,1
MNE,Montenegro,NOR,Norway,2008,15,0,15
MNE,Montenegro,NOR,Norway,2009,18,27,-9
MNE,Montenegro,NOR,Norway,2010,16,1,15
MNE,Montenegro,NOR,Norway,2011,25,2,23
MNE,Montenegro,NOR,Norway,2012,21,4,17
MNE,Montenegro,NOR,Norway,2013,22,5,17
MNE,Montenegro,NOR,Norway,2014,30,10,20
MNE,Montenegro,NOR,Norway,2015,23,5,18
MNE,Montenegro,NOR,Norway,2016,26,9,17
MNE,Montenegro,NOR,Norway,2017,20,8,12
MNE,Montenegro,POL,Poland,2009,23,0,23
MNE,Montenegro,POL,Poland,2010,18,0,18
MNE,Montenegro,POL,Poland,2011,12,0,12
MNE,Montenegro,POL,Poland,2012,19,0,19
MNE,Montenegro,POL,Poland,2013,20,0,20
MNE,Montenegro,POL,Poland,2014,7,0,7
MNE,Montenegro,POL,Poland,2015,39,0,39
MNE,Montenegro,POL,Poland,2016,27,0,27
MNE,Montenegro,POL,Poland,2017,28,0,28
MNE,Montenegro,SVK,Slovak Republic,2008,4,1,3
MNE,Montenegro,SVK,Slovak Republic,2009,2,1,1
MNE,Montenegro,SVK,Slovak Republic,2010,1,2,-1
MNE,Montenegro,SVK,Slovak Republic,2011,1,1,0
MNE,Montenegro,SVK,Slovak Republic,2015,1,0,1
MNE,Montenegro,ESP,Spain,2008,28,2,26
MNE,Montenegro,ESP,Spain,2009,15,9,6
MNE,Montenegro,ESP,Spain,2010,29,21,8
MNE,Montenegro,ESP,Spain,2011,29,42,-13
MNE,Montenegro,ESP,Spain,2012,25,12,13
MNE,Montenegro,ESP,Spain,2013,26,15,11
MNE,Montenegro,ESP,Spain,2014,26,10,16
MNE,Montenegro,ESP,Spain,2015,31,13,18
MNE,Montenegro,ESP,Spain,2016,40,16,24
MNE,Montenegro,ESP,Spain,2017,36,16,20
MNE,Montenegro,SWE,Sweden,2008,86,7,79
MNE,Montenegro,SWE,Sweden,2009,81,8,73
MNE,Montenegro,SWE,Sweden,2010,82,2,80
MNE,Montenegro,SWE,Sweden,2011,105,6,99
MNE,Montenegro,SWE,Sweden,2012,121,3,118
MNE,Montenegro,SWE,Sweden,2013,89,4,85
MNE,Montenegro,SWE,Sweden,2014,83,3,80
MNE,Montenegro,SWE,Sweden,2015,87,10,77
MNE,Montenegro,SWE,Sweden,2016,90,11,79
MNE,Montenegro,SWE,Sweden,2017,112,11,101
MNE,Montenegro,CHE,Switzerland,2010,51,17,34
MNE,Montenegro,CHE,Switzerland,2011,67,20,47
MNE,Montenegro,CHE,Switzerland,2012,74,23,51
MNE,Montenegro,CHE,Switzerland,2013,78,21,57
MNE,Montenegro,CHE,Switzerland,2014,62,22,40
MNE,Montenegro,CHE,Switzerland,2015,65,26,39
MNE,Montenegro,CHE,Switzerland,2016,69,17,52
MNE,Montenegro,CHE,Switzerland,2017,55,20,35
MNE,Montenegro,USA,United States,2010,120,0,120
MNE,Montenegro,USA,United States,2011,204,0,204
MNE,Montenegro,USA,United States,2012,265,0,265
MNE,Montenegro,USA,United States,2013,265,0,265
MNE,Montenegro,USA,United States,2014,289,0,289
MNE,Montenegro,USA,United States,2015,251,0,251
MNE,Montenegro,USA,United States,2016,387,0,387
MNE,Montenegro,USA,United States,2017,323,0,323
MNE,Montenegro,CHL,Chile,2008,0,0,0
MNE,Montenegro,CHL,Chile,2009,0,0,0
MNE,Montenegro,CHL,Chile,2010,0,0,0
MNE,Montenegro,CHL,Chile,2011,0,0,0
MNE,Montenegro,CHL,Chile,2012,0,0,0
MNE,Montenegro,CHL,Chile,2013,0,0,0
MNE,Montenegro,CHL,Chile,2014,0,0,0
MNE,Montenegro,CHL,Chile,2015,0,0,0
MNE,Montenegro,CHL,Chile,2016,0,0,0
MNE,Montenegro,EST,Estonia,2008,0,0,0
MNE,Montenegro,EST,Estonia,2009,0,0,0
MNE,Montenegro,EST,Estonia,2010,0,0,0
MNE,Montenegro,EST,Estonia,2011,0,0,0
MNE,Montenegro,EST,Estonia,2012,0,0,0
MNE,Montenegro,EST,Estonia,2013,0,0,0
MNE,Montenegro,EST,Estonia,2014,0,0,0
MNE,Montenegro,EST,Estonia,2015,1,0,1
MNE,Montenegro,EST,Estonia,2016,3,0,3
MNE,Montenegro,EST,Estonia,2017,0,0,0
MNE,Montenegro,SVN,Slovenia,2008,147,22,125
MNE,Montenegro,SVN,Slovenia,2009,125,61,64
MNE,Montenegro,SVN,Slovenia,2010,57,57,0
MNE,Montenegro,SVN,Slovenia,2011,119,7,112
MNE,Montenegro,SVN,Slovenia,2012,86,4,82
MNE,Montenegro,SVN,Slovenia,2013,66,2,64
MNE,Montenegro,SVN,Slovenia,2014,51,1,50
MNE,Montenegro,SVN,Slovenia,2015,125,11,114
MNE,Montenegro,SVN,Slovenia,2016,105,10,95
MNE,Montenegro,SVN,Slovenia,2017,142,10,132
MAR,Morocco,AUS,Australia,2008,60,23,37
MAR,Morocco,AUS,Australia,2009,47,24,23
MAR,Morocco,AUS,Australia,2010,40,11,29
MAR,Morocco,AUS,Australia,2011,67,24,43
MAR,Morocco,AUS,Australia,2012,56,23,33
MAR,Morocco,AUS,Australia,2013,83,27,56
MAR,Morocco,AUS,Australia,2014,75,29,46
MAR,Morocco,AUS,Australia,2015,79,0,79
MAR,Morocco,AUS,Australia,2016,73,0,73
MAR,Morocco,AUS,Australia,2017,80,0,80
MAR,Morocco,AUT,Austria,2008,178,111,67
MAR,Morocco,AUT,Austria,2009,184,136,48
MAR,Morocco,AUT,Austria,2010,167,145,22
MAR,Morocco,AUT,Austria,2011,194,122,72
MAR,Morocco,AUT,Austria,2012,194,122,72
MAR,Morocco,AUT,Austria,2013,250,130,120
MAR,Morocco,AUT,Austria,2014,249,182,67
MAR,Morocco,AUT,Austria,2015,388,208,180
MAR,Morocco,AUT,Austria,2016,507,383,124
MAR,Morocco,AUT,Austria,2017,330,354,-24
MAR,Morocco,BEL,Belgium,2008,8221,845,7376
MAR,Morocco,BEL,Belgium,2009,9093,793,8300
MAR,Morocco,BEL,Belgium,2010,9754,726,9028
MAR,Morocco,BEL,Belgium,2011,8491,1014,7477
MAR,Morocco,BEL,Belgium,2012,5852,1514,4338
MAR,Morocco,BEL,Belgium,2013,4687,1848,2839
MAR,Morocco,BEL,Belgium,2014,4709,1626,3083
MAR,Morocco,BEL,Belgium,2015,4816,1502,3314
MAR,Morocco,BEL,Belgium,2016,4411,1126,3285
MAR,Morocco,BEL,Belgium,2017,4491,1002,3489
MAR,Morocco,CAN,Canada,2008,4225,0,4225
MAR,Morocco,CAN,Canada,2009,5532,0,5532
MAR,Morocco,CAN,Canada,2010,6242,0,6242
MAR,Morocco,CAN,Canada,2011,4390,0,4390
MAR,Morocco,CAN,Canada,2012,3855,0,3855
MAR,Morocco,CAN,Canada,2013,3276,0,3276
MAR,Morocco,CAN,Canada,2014,2491,0,2491
MAR,Morocco,CAN,Canada,2015,2736,0,2736
MAR,Morocco,CAN,Canada,2016,2115,0,2115
MAR,Morocco,CAN,Canada,2017,2270,0,2270
MAR,Morocco,CZE,Czech Republic,2008,21,0,21
MAR,Morocco,CZE,Czech Republic,2009,25,0,25
MAR,Morocco,CZE,Czech Republic,2010,14,2,12
MAR,Morocco,CZE,Czech Republic,2011,9,0,9
MAR,Morocco,CZE,Czech Republic,2012,15,2,13
MAR,Morocco,CZE,Czech Republic,2013,20,8,12
MAR,Morocco,CZE,Czech Republic,2014,25,11,14
MAR,Morocco,CZE,Czech Republic,2015,27,7,20
MAR,Morocco,CZE,Czech Republic,2016,28,12,16
MAR,Morocco,CZE,Czech Republic,2017,47,17,30
MAR,Morocco,DNK,Denmark,2008,92,35,57
MAR,Morocco,DNK,Denmark,2009,104,17,87
MAR,Morocco,DNK,Denmark,2010,93,23,70
MAR,Morocco,DNK,Denmark,2011,84,24,60
MAR,Morocco,DNK,Denmark,2012,57,41,16
MAR,Morocco,DNK,Denmark,2013,103,22,81
MAR,Morocco,DNK,Denmark,2014,114,29,85
MAR,Morocco,DNK,Denmark,2015,96,20,76
MAR,Morocco,DNK,Denmark,2016,97,25,72
MAR,Morocco,DNK,Denmark,2017,108,39,69
MAR,Morocco,FIN,Finland,2008,92,11,81
MAR,Morocco,FIN,Finland,2009,101,13,88
MAR,Morocco,FIN,Finland,2010,63,6,57
MAR,Morocco,FIN,Finland,2011,87,5,82
MAR,Morocco,FIN,Finland,2012,81,4,77
MAR,Morocco,FIN,Finland,2013,112,9,103
MAR,Morocco,FIN,Finland,2014,119,12,107
MAR,Morocco,FIN,Finland,2015,113,16,97
MAR,Morocco,FIN,Finland,2016,147,8,139
MAR,Morocco,FIN,Finland,2017,108,14,94
MAR,Morocco,FRA,France,2008,24866,0,24866
MAR,Morocco,FRA,France,2009,21520,0,21520
MAR,Morocco,FRA,France,2010,20110,0,20110
MAR,Morocco,FRA,France,2011,18765,0,18765
MAR,Morocco,FRA,France,2012,19790,0,19790
MAR,Morocco,FRA,France,2013,20049,0,20049
MAR,Morocco,FRA,France,2014,21104,0,21104
MAR,Morocco,FRA,France,2015,18423,0,18423
MAR,Morocco,FRA,France,2016,18811,0,18811
MAR,Morocco,FRA,France,2017,18792,0,18792
MAR,Morocco,DEU,Germany,2008,3374,2765,609
MAR,Morocco,DEU,Germany,2009,3925,2652,1273
MAR,Morocco,DEU,Germany,2010,3762,2426,1336
MAR,Morocco,DEU,Germany,2011,4370,2275,2095
MAR,Morocco,DEU,Germany,2012,5024,2373,2651
MAR,Morocco,DEU,Germany,2013,6666,2993,3673
MAR,Morocco,DEU,Germany,2014,7836,3406,4430
MAR,Morocco,DEU,Germany,2015,11636,4330,7306
MAR,Morocco,DEU,Germany,2016,10594,8542,2052
MAR,Morocco,DEU,Germany,2017,8436,5960,2476
MAR,Morocco,HUN,Hungary,2008,22,1,21
MAR,Morocco,HUN,Hungary,2009,33,0,33
MAR,Morocco,HUN,Hungary,2010,14,6,8
MAR,Morocco,HUN,Hungary,2011,26,12,14
MAR,Morocco,HUN,Hungary,2012,17,3,14
MAR,Morocco,HUN,Hungary,2013,14,4,10
MAR,Morocco,HUN,Hungary,2014,21,0,21
MAR,Morocco,HUN,Hungary,2015,44,3,41
MAR,Morocco,HUN,Hungary,2016,74,3,71
MAR,Morocco,HUN,Hungary,2017,105,0,105
MAR,Morocco,ISL,Iceland,2008,15,14,1
MAR,Morocco,ISL,Iceland,2009,7,5,2
MAR,Morocco,ISL,Iceland,2010,5,5,0
MAR,Morocco,ISL,Iceland,2011,9,6,3
MAR,Morocco,ISL,Iceland,2012,7,2,5
MAR,Morocco,ISL,Iceland,2013,10,2,8
MAR,Morocco,ISL,Iceland,2014,6,4,2
MAR,Morocco,ISL,Iceland,2015,8,2,6
MAR,Morocco,ISL,Iceland,2016,17,2,15
MAR,Morocco,ISL,Iceland,2017,17,2,15
MAR,Morocco,ITA,Italy,2008,37275,1046,36229
MAR,Morocco,ITA,Italy,2009,33128,1178,31950
MAR,Morocco,ITA,Italy,2010,29960,2179,27781
MAR,Morocco,ITA,Italy,2011,23885,1761,22124
MAR,Morocco,ITA,Italy,2012,19590,1960,17630
MAR,Morocco,ITA,Italy,2013,19568,2418,17150
MAR,Morocco,ITA,Italy,2014,17637,2726,14911
MAR,Morocco,ITA,Italy,2015,15009,2536,12473
MAR,Morocco,ITA,Italy,2016,14651,0,14651
MAR,Morocco,ITA,Italy,2017,15690,2232,13458
MAR,Morocco,JPN,Japan,2008,163,128,35
MAR,Morocco,JPN,Japan,2009,142,127,15
MAR,Morocco,JPN,Japan,2010,164,14,150
MAR,Morocco,JPN,Japan,2011,121,101,20
MAR,Morocco,JPN,Japan,2012,182,148,34
MAR,Morocco,JPN,Japan,2013,156,130,26
MAR,Morocco,JPN,Japan,2014,247,218,29
MAR,Morocco,JPN,Japan,2015,211,159,52
MAR,Morocco,JPN,Japan,2016,233,142,91
MAR,Morocco,JPN,Japan,2017,256,193,63
MAR,Morocco,KOR,Korea,2008,74,44,30
MAR,Morocco,KOR,Korea,2009,80,67,13
MAR,Morocco,KOR,Korea,2010,65,69,-4
MAR,Morocco,KOR,Korea,2011,89,59,30
MAR,Morocco,KOR,Korea,2012,90,90,0
MAR,Morocco,KOR,Korea,2013,139,83,56
MAR,Morocco,KOR,Korea,2014,186,112,74
MAR,Morocco,KOR,Korea,2015,206,129,77
MAR,Morocco,KOR,Korea,2016,285,184,101
MAR,Morocco,KOR,Korea,2017,379,197,182
MAR,Morocco,LUX,Luxembourg,2008,78,15,63
MAR,Morocco,LUX,Luxembourg,2009,56,20,36
MAR,Morocco,LUX,Luxembourg,2010,80,14,66
MAR,Morocco,LUX,Luxembourg,2011,56,15,41
MAR,Morocco,LUX,Luxembourg,2012,78,22,56
MAR,Morocco,LUX,Luxembourg,2013,82,27,55
MAR,Morocco,LUX,Luxembourg,2014,97,27,70
MAR,Morocco,LUX,Luxembourg,2015,123,30,93
MAR,Morocco,LUX,Luxembourg,2016,149,30,119
MAR,Morocco,LUX,Luxembourg,2017,204,35,169
MAR,Morocco,MEX,Mexico,2008,14,0,14
MAR,Morocco,MEX,Mexico,2009,27,0,27
MAR,Morocco,MEX,Mexico,2010,19,0,19
MAR,Morocco,MEX,Mexico,2011,26,0,26
MAR,Morocco,MEX,Mexico,2012,15,0,15
MAR,Morocco,MEX,Mexico,2013,35,0,35
MAR,Morocco,MEX,Mexico,2014,33,0,33
MAR,Morocco,MEX,Mexico,2015,32,0,32
MAR,Morocco,MEX,Mexico,2016,34,0,34
MAR,Morocco,MEX,Mexico,2017,29,0,29
MAR,Morocco,NLD,Netherlands,2008,1465,861,604
MAR,Morocco,NLD,Netherlands,2009,1680,629,1051
MAR,Morocco,NLD,Netherlands,2010,1632,608,1024
MAR,Morocco,NLD,Netherlands,2011,1841,501,1340
MAR,Morocco,NLD,Netherlands,2012,1432,730,702
MAR,Morocco,NLD,Netherlands,2013,1469,503,966
MAR,Morocco,NLD,Netherlands,2014,1405,482,923
MAR,Morocco,NLD,Netherlands,2015,1080,350,730
MAR,Morocco,NLD,Netherlands,2016,1337,271,1066
MAR,Morocco,NLD,Netherlands,2017,1470,346,1124
MAR,Morocco,NZL,New Zealand,2008,9,2,7
MAR,Morocco,NZL,New Zealand,2009,3,1,2
MAR,Morocco,NZL,New Zealand,2010,4,1,3
MAR,Morocco,NZL,New Zealand,2011,10,0,10
MAR,Morocco,NZL,New Zealand,2012,7,1,6
MAR,Morocco,NZL,New Zealand,2013,7,0,7
MAR,Morocco,NZL,New Zealand,2014,6,1,5
MAR,Morocco,NZL,New Zealand,2015,11,3,8
MAR,Morocco,NZL,New Zealand,2016,5,3,2
MAR,Morocco,NZL,New Zealand,2017,10,3,7
MAR,Morocco,NOR,Norway,2008,122,19,103
MAR,Morocco,NOR,Norway,2009,114,0,114
MAR,Morocco,NOR,Norway,2010,123,25,98
MAR,Morocco,NOR,Norway,2011,123,34,89
MAR,Morocco,NOR,Norway,2012,121,39,82
MAR,Morocco,NOR,Norway,2013,139,30,109
MAR,Morocco,NOR,Norway,2014,123,26,97
MAR,Morocco,NOR,Norway,2015,123,29,94
MAR,Morocco,NOR,Norway,2016,148,26,122
MAR,Morocco,NOR,Norway,2017,142,17,125
MAR,Morocco,POL,Poland,2008,144,0,144
MAR,Morocco,POL,Poland,2009,181,0,181
MAR,Morocco,POL,Poland,2010,156,0,156
MAR,Morocco,POL,Poland,2011,175,0,175
MAR,Morocco,POL,Poland,2012,217,0,217
MAR,Morocco,POL,Poland,2013,168,0,168
MAR,Morocco,POL,Poland,2014,107,0,107
MAR,Morocco,POL,Poland,2015,227,0,227
MAR,Morocco,POL,Poland,2016,213,0,213
MAR,Morocco,POL,Poland,2017,237,0,237
MAR,Morocco,PRT,Portugal,2008,190,0,190
MAR,Morocco,PRT,Portugal,2009,109,0,109
MAR,Morocco,PRT,Portugal,2010,259,0,259
MAR,Morocco,PRT,Portugal,2011,242,0,242
MAR,Morocco,PRT,Portugal,2012,173,0,173
MAR,Morocco,PRT,Portugal,2013,166,0,166
MAR,Morocco,PRT,Portugal,2014,127,0,127
MAR,Morocco,PRT,Portugal,2015,136,0,136
MAR,Morocco,PRT,Portugal,2016,92,0,92
MAR,Morocco,PRT,Portugal,2017,143,0,143
MAR,Morocco,SVK,Slovak Republic,2008,1,4,-3
MAR,Morocco,SVK,Slovak Republic,2009,2,8,-6
MAR,Morocco,SVK,Slovak Republic,2010,2,0,2
MAR,Morocco,SVK,Slovak Republic,2011,3,2,1
MAR,Morocco,SVK,Slovak Republic,2012,2,1,1
MAR,Morocco,SVK,Slovak Republic,2013,2,0,2
MAR,Morocco,SVK,Slovak Republic,2014,1,0,1
MAR,Morocco,SVK,Slovak Republic,2015,2,0,2
MAR,Morocco,SVK,Slovak Republic,2016,3,0,3
MAR,Morocco,ESP,Spain,2008,71761,26709,45052
MAR,Morocco,ESP,Spain,2009,43178,33374,9804
MAR,Morocco,ESP,Spain,2010,30169,37662,-7493
MAR,Morocco,ESP,Spain,2011,27978,42231,-14253
MAR,Morocco,ESP,Spain,2012,22444,44423,-21979
MAR,Morocco,ESP,Spain,2013,20516,47463,-26947
MAR,Morocco,ESP,Spain,2014,19994,30545,-10551
MAR,Morocco,ESP,Spain,2015,23831,23537,294
MAR,Morocco,ESP,Spain,2016,29712,23364,6348
MAR,Morocco,ESP,Spain,2017,39847,22498,17349
MAR,Morocco,SWE,Sweden,2008,459,34,425
MAR,Morocco,SWE,Sweden,2009,400,32,368
MAR,Morocco,SWE,Sweden,2010,421,49,372
MAR,Morocco,SWE,Sweden,2011,416,31,385
MAR,Morocco,SWE,Sweden,2012,475,52,423
MAR,Morocco,SWE,Sweden,2013,521,60,461
MAR,Morocco,SWE,Sweden,2014,541,59,482
MAR,Morocco,SWE,Sweden,2015,529,83,446
MAR,Morocco,SWE,Sweden,2016,520,57,463
MAR,Morocco,SWE,Sweden,2017,600,49,551
MAR,Morocco,CHE,Switzerland,2010,730,183,547
MAR,Morocco,CHE,Switzerland,2011,619,227,392
MAR,Morocco,CHE,Switzerland,2012,505,181,324
MAR,Morocco,CHE,Switzerland,2013,542,186,356
MAR,Morocco,CHE,Switzerland,2014,492,174,318
MAR,Morocco,CHE,Switzerland,2015,51,175,-124
MAR,Morocco,CHE,Switzerland,2016,486,189,297
MAR,Morocco,CHE,Switzerland,2017,534,150,384
MAR,Morocco,TUR,Turkey,2010,128,0,128
MAR,Morocco,TUR,Turkey,2016,1763,643,1120
MAR,Morocco,TUR,Turkey,2017,2556,903,1653
MAR,Morocco,GBR,United Kingdom,2013,1000,1000,0
MAR,Morocco,GBR,United Kingdom,2014,1000,0,1000
MAR,Morocco,USA,United States,2008,4425,0,4425
MAR,Morocco,USA,United States,2009,5447,0,5447
MAR,Morocco,USA,United States,2010,5013,0,5013
MAR,Morocco,USA,United States,2011,4399,0,4399
MAR,Morocco,USA,United States,2012,3656,0,3656
MAR,Morocco,USA,United States,2013,3336,0,3336
MAR,Morocco,USA,United States,2014,3605,0,3605
MAR,Morocco,USA,United States,2015,3710,0,3710
MAR,Morocco,USA,United States,2016,4586,0,4586
MAR,Morocco,USA,United States,2017,4229,0,4229
MAR,Morocco,CHL,Chile,2008,7,0,7
MAR,Morocco,CHL,Chile,2009,7,0,7
MAR,Morocco,CHL,Chile,2010,6,0,6
MAR,Morocco,CHL,Chile,2011,13,0,13
MAR,Morocco,CHL,Chile,2012,8,0,8
MAR,Morocco,CHL,Chile,2013,9,0,9
MAR,Morocco,CHL,Chile,2014,5,0,5
MAR,Morocco,CHL,Chile,2015,8,0,8
MAR,Morocco,CHL,Chile,2016,9,0,9
MAR,Morocco,EST,Estonia,2008,1,0,1
MAR,Morocco,EST,Estonia,2009,0,0,0
MAR,Morocco,EST,Estonia,2010,1,0,1
MAR,Morocco,EST,Estonia,2011,2,0,2
MAR,Morocco,EST,Estonia,2012,1,0,1
MAR,Morocco,EST,Estonia,2013,4,0,4
MAR,Morocco,EST,Estonia,2014,0,0,0
MAR,Morocco,EST,Estonia,2015,4,0,4
MAR,Morocco,EST,Estonia,2016,5,0,5
MAR,Morocco,EST,Estonia,2017,3,0,3
MAR,Morocco,ISR,Israel,2008,42,0,42
MAR,Morocco,ISR,Israel,2009,25,0,25
MAR,Morocco,ISR,Israel,2010,35,0,35
MAR,Morocco,ISR,Israel,2011,40,0,40
MAR,Morocco,ISR,Israel,2012,45,0,45
MAR,Morocco,ISR,Israel,2013,37,0,37
MAR,Morocco,ISR,Israel,2014,48,0,48
MAR,Morocco,ISR,Israel,2015,95,0,95
MAR,Morocco,ISR,Israel,2016,66,0,66
MAR,Morocco,ISR,Israel,2017,57,0,57
MAR,Morocco,SVN,Slovenia,2008,3,0,3
MAR,Morocco,SVN,Slovenia,2009,1,0,1
MAR,Morocco,SVN,Slovenia,2010,4,0,4
MAR,Morocco,SVN,Slovenia,2011,3,0,3
MAR,Morocco,SVN,Slovenia,2012,1,1,0
MAR,Morocco,SVN,Slovenia,2013,3,0,3
MAR,Morocco,SVN,Slovenia,2014,1,0,1
MAR,Morocco,SVN,Slovenia,2015,3,0,3
MAR,Morocco,SVN,Slovenia,2016,8,0,8
MAR,Morocco,SVN,Slovenia,2017,9,2,7
MOZ,Mozambique,AUS,Australia,2008,9,9,0
MOZ,Mozambique,AUS,Australia,2009,12,5,7
MOZ,Mozambique,AUS,Australia,2010,21,9,12
MOZ,Mozambique,AUS,Australia,2011,10,5,5
MOZ,Mozambique,AUS,Australia,2012,14,8,6
MOZ,Mozambique,AUS,Australia,2013,11,5,6
MOZ,Mozambique,AUS,Australia,2014,21,7,14
MOZ,Mozambique,AUS,Australia,2015,0,0,0
MOZ,Mozambique,AUS,Australia,2016,7,0,7
MOZ,Mozambique,AUS,Australia,2017,11,0,11
MOZ,Mozambique,AUT,Austria,2008,8,2,6
MOZ,Mozambique,AUT,Austria,2009,1,2,-1
MOZ,Mozambique,AUT,Austria,2010,4,3,1
MOZ,Mozambique,AUT,Austria,2011,1,3,-2
MOZ,Mozambique,AUT,Austria,2012,3,2,1
MOZ,Mozambique,AUT,Austria,2013,3,1,2
MOZ,Mozambique,AUT,Austria,2014,6,1,5
MOZ,Mozambique,AUT,Austria,2015,3,0,3
MOZ,Mozambique,AUT,Austria,2016,2,4,-2
MOZ,Mozambique,AUT,Austria,2017,5,2,3
MOZ,Mozambique,BEL,Belgium,2008,4,0,4
MOZ,Mozambique,BEL,Belgium,2009,9,0,9
MOZ,Mozambique,BEL,Belgium,2010,13,2,11
MOZ,Mozambique,BEL,Belgium,2012,8,7,1
MOZ,Mozambique,BEL,Belgium,2013,10,5,5
MOZ,Mozambique,BEL,Belgium,2014,4,4,0
MOZ,Mozambique,BEL,Belgium,2015,3,4,-1
MOZ,Mozambique,BEL,Belgium,2016,6,6,0
MOZ,Mozambique,BEL,Belgium,2017,7,4,3
MOZ,Mozambique,CAN,Canada,2008,5,0,5
MOZ,Mozambique,CAN,Canada,2009,12,0,12
MOZ,Mozambique,CAN,Canada,2010,7,0,7
MOZ,Mozambique,CAN,Canada,2011,3,0,3
MOZ,Mozambique,CAN,Canada,2012,4,0,4
MOZ,Mozambique,CAN,Canada,2013,12,0,12
MOZ,Mozambique,CAN,Canada,2014,3,0,3
MOZ,Mozambique,CAN,Canada,2015,8,0,8
MOZ,Mozambique,CAN,Canada,2016,0,0,0
MOZ,Mozambique,CAN,Canada,2017,5,0,5
MOZ,Mozambique,CZE,Czech Republic,2014,1,0,1
MOZ,Mozambique,DNK,Denmark,2008,9,9,0
MOZ,Mozambique,DNK,Denmark,2009,11,8,3
MOZ,Mozambique,DNK,Denmark,2010,6,3,3
MOZ,Mozambique,DNK,Denmark,2011,1,7,-6
MOZ,Mozambique,DNK,Denmark,2012,8,1,7
MOZ,Mozambique,DNK,Denmark,2013,12,2,10
MOZ,Mozambique,DNK,Denmark,2014,5,4,1
MOZ,Mozambique,DNK,Denmark,2015,7,2,5
MOZ,Mozambique,DNK,Denmark,2016,7,0,7
MOZ,Mozambique,DNK,Denmark,2017,4,3,1
MOZ,Mozambique,FIN,Finland,2008,3,0,3
MOZ,Mozambique,FIN,Finland,2009,3,0,3
MOZ,Mozambique,FIN,Finland,2010,4,1,3
MOZ,Mozambique,FIN,Finland,2011,1,0,1
MOZ,Mozambique,FIN,Finland,2012,1,1,0
MOZ,Mozambique,FIN,Finland,2013,3,0,3
MOZ,Mozambique,FIN,Finland,2014,2,0,2
MOZ,Mozambique,FIN,Finland,2015,2,0,2
MOZ,Mozambique,FIN,Finland,2016,0,0,0
MOZ,Mozambique,FIN,Finland,2017,4,0,4
MOZ,Mozambique,FRA,France,2008,5,0,5
MOZ,Mozambique,FRA,France,2009,9,0,9
MOZ,Mozambique,FRA,France,2010,11,0,11
MOZ,Mozambique,FRA,France,2011,8,0,8
MOZ,Mozambique,FRA,France,2012,7,0,7
MOZ,Mozambique,FRA,France,2013,10,0,10
MOZ,Mozambique,FRA,France,2014,11,0,11
MOZ,Mozambique,FRA,France,2015,9,0,9
MOZ,Mozambique,FRA,France,2016,11,0,11
MOZ,Mozambique,FRA,France,2017,12,0,12
MOZ,Mozambique,DEU,Germany,2008,106,141,-35
MOZ,Mozambique,DEU,Germany,2009,98,177,-79
MOZ,Mozambique,DEU,Germany,2010,81,81,0
MOZ,Mozambique,DEU,Germany,2011,87,48,39
MOZ,Mozambique,DEU,Germany,2012,68,37,31
MOZ,Mozambique,DEU,Germany,2013,59,40,19
MOZ,Mozambique,DEU,Germany,2014,73,47,26
MOZ,Mozambique,DEU,Germany,2015,78,41,37
MOZ,Mozambique,DEU,Germany,2016,85,36,49
MOZ,Mozambique,DEU,Germany,2017,100,45,55
MOZ,Mozambique,HUN,Hungary,2008,1,0,1
MOZ,Mozambique,HUN,Hungary,2009,0,0,0
MOZ,Mozambique,HUN,Hungary,2010,0,0,0
MOZ,Mozambique,HUN,Hungary,2011,0,0,0
MOZ,Mozambique,HUN,Hungary,2012,1,0,1
MOZ,Mozambique,HUN,Hungary,2013,1,0,1
MOZ,Mozambique,HUN,Hungary,2014,0,0,0
MOZ,Mozambique,HUN,Hungary,2015,0,0,0
MOZ,Mozambique,HUN,Hungary,2016,2,0,2
MOZ,Mozambique,HUN,Hungary,2017,4,0,4
MOZ,Mozambique,ISL,Iceland,2008,2,1,1
MOZ,Mozambique,ISL,Iceland,2009,1,2,-1
MOZ,Mozambique,ISL,Iceland,2010,2,1,1
MOZ,Mozambique,ISL,Iceland,2011,2,0,2
MOZ,Mozambique,ISL,Iceland,2012,5,1,4
MOZ,Mozambique,ISL,Iceland,2013,6,4,2
MOZ,Mozambique,ISL,Iceland,2014,5,6,-1
MOZ,Mozambique,ISL,Iceland,2015,3,4,-1
MOZ,Mozambique,ISL,Iceland,2016,4,3,1
MOZ,Mozambique,ISL,Iceland,2017,1,1,0
MOZ,Mozambique,ITA,Italy,2008,27,0,27
MOZ,Mozambique,ITA,Italy,2009,37,0,37
MOZ,Mozambique,ITA,Italy,2010,32,2,30
MOZ,Mozambique,ITA,Italy,2011,29,0,29
MOZ,Mozambique,ITA,Italy,2012,30,3,27
MOZ,Mozambique,ITA,Italy,2013,28,3,25
MOZ,Mozambique,ITA,Italy,2014,26,4,22
MOZ,Mozambique,ITA,Italy,2015,36,8,28
MOZ,Mozambique,ITA,Italy,2016,22,0,22
MOZ,Mozambique,ITA,Italy,2017,41,6,35
MOZ,Mozambique,JPN,Japan,2008,103,111,-8
MOZ,Mozambique,JPN,Japan,2009,20,18,2
MOZ,Mozambique,JPN,Japan,2010,53,48,5
MOZ,Mozambique,JPN,Japan,2011,76,70,6
MOZ,Mozambique,JPN,Japan,2012,145,148,-3
MOZ,Mozambique,JPN,Japan,2013,309,305,4
MOZ,Mozambique,JPN,Japan,2014,238,211,27
MOZ,Mozambique,JPN,Japan,2015,248,206,42
MOZ,Mozambique,JPN,Japan,2016,197,170,27
MOZ,Mozambique,JPN,Japan,2017,318,302,16
MOZ,Mozambique,KOR,Korea,2008,19,11,8
MOZ,Mozambique,KOR,Korea,2009,8,15,-7
MOZ,Mozambique,KOR,Korea,2010,5,3,2
MOZ,Mozambique,KOR,Korea,2011,6,3,3
MOZ,Mozambique,KOR,Korea,2012,8,8,0
MOZ,Mozambique,KOR,Korea,2013,4,3,1
MOZ,Mozambique,KOR,Korea,2014,13,13,0
MOZ,Mozambique,KOR,Korea,2015,28,28,0
MOZ,Mozambique,KOR,Korea,2016,9,7,2
MOZ,Mozambique,KOR,Korea,2017,23,7,16
MOZ,Mozambique,LUX,Luxembourg,2008,1,0,1
MOZ,Mozambique,LUX,Luxembourg,2009,0,0,0
MOZ,Mozambique,LUX,Luxembourg,2010,2,0,2
MOZ,Mozambique,LUX,Luxembourg,2011,1,0,1
MOZ,Mozambique,LUX,Luxembourg,2012,0,0,0
MOZ,Mozambique,LUX,Luxembourg,2013,0,0,0
MOZ,Mozambique,LUX,Luxembourg,2014,0,0,0
MOZ,Mozambique,LUX,Luxembourg,2015,1,0,1
MOZ,Mozambique,LUX,Luxembourg,2016,0,0,0
MOZ,Mozambique,LUX,Luxembourg,2017,2,0,2
MOZ,Mozambique,MEX,Mexico,2010,1,0,1
MOZ,Mozambique,MEX,Mexico,2012,1,0,1
MOZ,Mozambique,MEX,Mexico,2013,2,0,2
MOZ,Mozambique,MEX,Mexico,2014,1,0,1
MOZ,Mozambique,MEX,Mexico,2016,1,0,1
MOZ,Mozambique,MEX,Mexico,2017,1,0,1
MOZ,Mozambique,NLD,Netherlands,2008,18,3,15
MOZ,Mozambique,NLD,Netherlands,2009,11,6,5
MOZ,Mozambique,NLD,Netherlands,2010,12,24,-12
MOZ,Mozambique,NLD,Netherlands,2011,19,6,13
MOZ,Mozambique,NLD,Netherlands,2012,16,12,4
MOZ,Mozambique,NLD,Netherlands,2013,16,24,-8
MOZ,Mozambique,NLD,Netherlands,2014,12,12,0
MOZ,Mozambique,NLD,Netherlands,2015,15,12,3
MOZ,Mozambique,NLD,Netherlands,2016,4,14,-10
MOZ,Mozambique,NLD,Netherlands,2017,17,6,11
MOZ,Mozambique,NZL,New Zealand,2008,1,0,1
MOZ,Mozambique,NZL,New Zealand,2009,1,1,0
MOZ,Mozambique,NZL,New Zealand,2010,1,1,0
MOZ,Mozambique,NZL,New Zealand,2011,0,1,-1
MOZ,Mozambique,NZL,New Zealand,2012,0,1,-1
MOZ,Mozambique,NZL,New Zealand,2014,2,1,1
MOZ,Mozambique,NZL,New Zealand,2015,2,0,2
MOZ,Mozambique,NZL,New Zealand,2016,3,0,3
MOZ,Mozambique,NZL,New Zealand,2017,1,0,1
MOZ,Mozambique,NOR,Norway,2008,15,7,8
MOZ,Mozambique,NOR,Norway,2009,10,8,2
MOZ,Mozambique,NOR,Norway,2010,9,14,-5
MOZ,Mozambique,NOR,Norway,2011,10,4,6
MOZ,Mozambique,NOR,Norway,2012,14,8,6
MOZ,Mozambique,NOR,Norway,2013,11,9,2
MOZ,Mozambique,NOR,Norway,2014,10,9,1
MOZ,Mozambique,NOR,Norway,2015,3,10,-7
MOZ,Mozambique,NOR,Norway,2016,3,1,2
MOZ,Mozambique,NOR,Norway,2017,2,1,1
MOZ,Mozambique,POL,Poland,2009,0,0,0
MOZ,Mozambique,POL,Poland,2010,0,0,0
MOZ,Mozambique,POL,Poland,2011,0,0,0
MOZ,Mozambique,POL,Poland,2012,0,0,0
MOZ,Mozambique,POL,Poland,2013,0,0,0
MOZ,Mozambique,POL,Poland,2014,0,0,0
MOZ,Mozambique,POL,Poland,2015,0,0,0
MOZ,Mozambique,POL,Poland,2016,2,0,2
MOZ,Mozambique,POL,Poland,2017,6,0,6
MOZ,Mozambique,PRT,Portugal,2008,314,0,314
MOZ,Mozambique,PRT,Portugal,2009,321,0,321
MOZ,Mozambique,PRT,Portugal,2010,299,0,299
MOZ,Mozambique,PRT,Portugal,2011,299,0,299
MOZ,Mozambique,PRT,Portugal,2012,256,0,256
MOZ,Mozambique,PRT,Portugal,2013,223,0,223
MOZ,Mozambique,PRT,Portugal,2014,255,0,255
MOZ,Mozambique,PRT,Portugal,2015,318,0,318
MOZ,Mozambique,PRT,Portugal,2016,342,0,342
MOZ,Mozambique,PRT,Portugal,2017,329,0,329
MOZ,Mozambique,SVK,Slovak Republic,2008,0,0,0
MOZ,Mozambique,ESP,Spain,2008,43,30,13
MOZ,Mozambique,ESP,Spain,2009,33,35,-2
MOZ,Mozambique,ESP,Spain,2010,53,31,22
MOZ,Mozambique,ESP,Spain,2011,29,46,-17
MOZ,Mozambique,ESP,Spain,2012,28,15,13
MOZ,Mozambique,ESP,Spain,2013,37,18,19
MOZ,Mozambique,ESP,Spain,2014,34,9,25
MOZ,Mozambique,ESP,Spain,2015,51,9,42
MOZ,Mozambique,ESP,Spain,2016,49,18,31
MOZ,Mozambique,ESP,Spain,2017,47,34,13
MOZ,Mozambique,SWE,Sweden,2008,17,2,15
MOZ,Mozambique,SWE,Sweden,2009,10,2,8
MOZ,Mozambique,SWE,Sweden,2010,15,3,12
MOZ,Mozambique,SWE,Sweden,2011,9,10,-1
MOZ,Mozambique,SWE,Sweden,2012,9,7,2
MOZ,Mozambique,SWE,Sweden,2013,7,7,0
MOZ,Mozambique,SWE,Sweden,2014,5,7,-2
MOZ,Mozambique,SWE,Sweden,2015,14,4,10
MOZ,Mozambique,SWE,Sweden,2016,4,9,-5
MOZ,Mozambique,SWE,Sweden,2017,9,7,2
MOZ,Mozambique,CHE,Switzerland,2010,7,2,5
MOZ,Mozambique,CHE,Switzerland,2011,7,3,4
MOZ,Mozambique,CHE,Switzerland,2012,15,2,13
MOZ,Mozambique,CHE,Switzerland,2013,7,1,6
MOZ,Mozambique,CHE,Switzerland,2014,8,1,7
MOZ,Mozambique,CHE,Switzerland,2015,13,5,8
MOZ,Mozambique,CHE,Switzerland,2016,3,4,-1
MOZ,Mozambique,CHE,Switzerland,2017,5,5,0
MOZ,Mozambique,TUR,Turkey,2010,6,0,6
MOZ,Mozambique,USA,United States,2008,69,0,69
MOZ,Mozambique,USA,United States,2009,66,0,66
MOZ,Mozambique,USA,United States,2010,53,0,53
MOZ,Mozambique,USA,United States,2011,60,0,60
MOZ,Mozambique,USA,United States,2012,94,0,94
MOZ,Mozambique,USA,United States,2013,73,0,73
MOZ,Mozambique,USA,United States,2014,71,0,71
MOZ,Mozambique,USA,United States,2015,107,0,107
MOZ,Mozambique,USA,United States,2016,101,0,101
MOZ,Mozambique,USA,United States,2017,96,0,96
MOZ,Mozambique,CHL,Chile,2008,0,0,0
MOZ,Mozambique,CHL,Chile,2009,0,0,0
MOZ,Mozambique,CHL,Chile,2010,0,0,0
MOZ,Mozambique,CHL,Chile,2011,1,0,1
MOZ,Mozambique,CHL,Chile,2012,0,0,0
MOZ,Mozambique,CHL,Chile,2013,2,0,2
MOZ,Mozambique,CHL,Chile,2014,1,0,1
MOZ,Mozambique,CHL,Chile,2015,7,0,7
MOZ,Mozambique,CHL,Chile,2016,5,0,5
MOZ,Mozambique,EST,Estonia,2008,0,0,0
MOZ,Mozambique,EST,Estonia,2009,0,0,0
MOZ,Mozambique,EST,Estonia,2010,0,0,0
MOZ,Mozambique,EST,Estonia,2011,0,0,0
MOZ,Mozambique,EST,Estonia,2012,0,0,0
MOZ,Mozambique,EST,Estonia,2013,0,0,0
MOZ,Mozambique,EST,Estonia,2014,0,0,0
MOZ,Mozambique,EST,Estonia,2015,0,0,0
MOZ,Mozambique,EST,Estonia,2016,0,0,0
MOZ,Mozambique,EST,Estonia,2017,0,0,0
MOZ,Mozambique,SVN,Slovenia,2008,3,0,3
MOZ,Mozambique,SVN,Slovenia,2012,1,0,1
MOZ,Mozambique,SVN,Slovenia,2013,1,0,1
MOZ,Mozambique,SVN,Slovenia,2015,1,0,1
MMR,Myanmar,AUS,Australia,2008,2646,37,2609
MMR,Myanmar,AUS,Australia,2009,3068,44,3024
MMR,Myanmar,AUS,Australia,2010,2576,49,2527
MMR,Myanmar,AUS,Australia,2011,1649,64,1585
MMR,Myanmar,AUS,Australia,2012,2521,74,2447
MMR,Myanmar,AUS,Australia,2013,2341,76,2265
MMR,Myanmar,AUS,Australia,2014,2380,100,2280
MMR,Myanmar,AUS,Australia,2015,2481,100,2381
MMR,Myanmar,AUS,Australia,2016,2288,100,2188
MMR,Myanmar,AUS,Australia,2017,2175,0,2175
MMR,Myanmar,AUT,Austria,2008,12,3,9
MMR,Myanmar,AUT,Austria,2009,4,5,-1
MMR,Myanmar,AUT,Austria,2010,6,0,6
MMR,Myanmar,AUT,Austria,2011,7,3,4
MMR,Myanmar,AUT,Austria,2012,12,6,6
MMR,Myanmar,AUT,Austria,2013,23,3,20
MMR,Myanmar,AUT,Austria,2014,7,8,-1
MMR,Myanmar,AUT,Austria,2015,21,6,15
MMR,Myanmar,AUT,Austria,2016,12,4,8
MMR,Myanmar,AUT,Austria,2017,17,7,10
MMR,Myanmar,BEL,Belgium,2008,6,0,6
MMR,Myanmar,BEL,Belgium,2009,8,0,8
MMR,Myanmar,BEL,Belgium,2010,5,2,3
MMR,Myanmar,BEL,Belgium,2012,27,9,18
MMR,Myanmar,BEL,Belgium,2013,33,7,26
MMR,Myanmar,BEL,Belgium,2014,10,16,-6
MMR,Myanmar,BEL,Belgium,2015,17,26,-9
MMR,Myanmar,BEL,Belgium,2016,9,15,-6
MMR,Myanmar,BEL,Belgium,2017,12,10,2
MMR,Myanmar,CAN,Canada,2008,975,0,975
MMR,Myanmar,CAN,Canada,2009,1152,0,1152
MMR,Myanmar,CAN,Canada,2010,556,0,556
MMR,Myanmar,CAN,Canada,2011,365,0,365
MMR,Myanmar,CAN,Canada,2012,193,0,193
MMR,Myanmar,CAN,Canada,2013,262,0,262
MMR,Myanmar,CAN,Canada,2014,440,0,440
MMR,Myanmar,CAN,Canada,2015,439,0,439
MMR,Myanmar,CAN,Canada,2016,425,0,425
MMR,Myanmar,CAN,Canada,2017,175,0,175
MMR,Myanmar,CZE,Czech Republic,2008,28,0,28
MMR,Myanmar,CZE,Czech Republic,2009,22,0,22
MMR,Myanmar,CZE,Czech Republic,2010,47,0,47
MMR,Myanmar,CZE,Czech Republic,2011,22,0,22
MMR,Myanmar,CZE,Czech Republic,2012,3,1,2
MMR,Myanmar,CZE,Czech Republic,2013,29,5,24
MMR,Myanmar,CZE,Czech Republic,2014,5,2,3
MMR,Myanmar,CZE,Czech Republic,2015,5,2,3
MMR,Myanmar,CZE,Czech Republic,2016,7,4,3
MMR,Myanmar,CZE,Czech Republic,2017,9,1,8
MMR,Myanmar,DNK,Denmark,2008,169,0,169
MMR,Myanmar,DNK,Denmark,2009,75,4,71
MMR,Myanmar,DNK,Denmark,2010,227,4,223
MMR,Myanmar,DNK,Denmark,2011,193,9,184
MMR,Myanmar,DNK,Denmark,2012,109,5,104
MMR,Myanmar,DNK,Denmark,2013,55,8,47
MMR,Myanmar,DNK,Denmark,2014,18,9,9
MMR,Myanmar,DNK,Denmark,2015,14,17,-3
MMR,Myanmar,DNK,Denmark,2016,19,13,6
MMR,Myanmar,DNK,Denmark,2017,20,24,-4
MMR,Myanmar,FIN,Finland,2008,271,2,269
MMR,Myanmar,FIN,Finland,2009,218,4,214
MMR,Myanmar,FIN,Finland,2010,126,0,126
MMR,Myanmar,FIN,Finland,2011,154,1,153
MMR,Myanmar,FIN,Finland,2012,110,1,109
MMR,Myanmar,FIN,Finland,2013,114,0,114
MMR,Myanmar,FIN,Finland,2014,9,0,9
MMR,Myanmar,FIN,Finland,2015,17,1,16
MMR,Myanmar,FIN,Finland,2016,12,2,10
MMR,Myanmar,FIN,Finland,2017,9,0,9
MMR,Myanmar,FRA,France,2008,27,0,27
MMR,Myanmar,FRA,France,2009,44,0,44
MMR,Myanmar,FRA,France,2010,41,0,41
MMR,Myanmar,FRA,France,2011,24,0,24
MMR,Myanmar,FRA,France,2012,33,0,33
MMR,Myanmar,FRA,France,2013,65,0,65
MMR,Myanmar,FRA,France,2014,87,0,87
MMR,Myanmar,FRA,France,2015,53,0,53
MMR,Myanmar,FRA,France,2016,46,0,46
MMR,Myanmar,FRA,France,2017,45,0,45
MMR,Myanmar,DEU,Germany,2008,434,310,124
MMR,Myanmar,DEU,Germany,2009,491,388,103
MMR,Myanmar,DEU,Germany,2010,446,427,19
MMR,Myanmar,DEU,Germany,2011,452,254,198
MMR,Myanmar,DEU,Germany,2012,411,528,-117
MMR,Myanmar,DEU,Germany,2013,353,295,58
MMR,Myanmar,DEU,Germany,2014,296,128,168
MMR,Myanmar,DEU,Germany,2015,392,380,12
MMR,Myanmar,DEU,Germany,2016,294,292,2
MMR,Myanmar,DEU,Germany,2017,335,228,107
MMR,Myanmar,HUN,Hungary,2008,0,1,-1
MMR,Myanmar,HUN,Hungary,2009,1,0,1
MMR,Myanmar,HUN,Hungary,2010,2,0,2
MMR,Myanmar,HUN,Hungary,2011,1,0,1
MMR,Myanmar,HUN,Hungary,2012,1,0,1
MMR,Myanmar,HUN,Hungary,2013,0,0,0
MMR,Myanmar,HUN,Hungary,2014,3,0,3
MMR,Myanmar,HUN,Hungary,2015,3,0,3
MMR,Myanmar,HUN,Hungary,2016,2,0,2
MMR,Myanmar,HUN,Hungary,2017,12,0,12
MMR,Myanmar,ISL,Iceland,2008,0,1,-1
MMR,Myanmar,ISL,Iceland,2009,0,0,0
MMR,Myanmar,ISL,Iceland,2010,0,0,0
MMR,Myanmar,ISL,Iceland,2011,0,0,0
MMR,Myanmar,ISL,Iceland,2012,0,0,0
MMR,Myanmar,ISL,Iceland,2013,0,0,0
MMR,Myanmar,ISL,Iceland,2014,0,0,0
MMR,Myanmar,ISL,Iceland,2015,0,0,0
MMR,Myanmar,ISL,Iceland,2016,1,0,1
MMR,Myanmar,ISL,Iceland,2017,2,0,2
MMR,Myanmar,ITA,Italy,2008,18,0,18
MMR,Myanmar,ITA,Italy,2009,38,0,38
MMR,Myanmar,ITA,Italy,2010,34,0,34
MMR,Myanmar,ITA,Italy,2011,27,9,18
MMR,Myanmar,ITA,Italy,2012,22,3,19
MMR,Myanmar,ITA,Italy,2013,71,1,70
MMR,Myanmar,ITA,Italy,2014,43,4,39
MMR,Myanmar,ITA,Italy,2015,44,1,43
MMR,Myanmar,ITA,Italy,2016,39,0,39
MMR,Myanmar,ITA,Italy,2017,31,7,24
MMR,Myanmar,JPN,Japan,2008,1415,749,666
MMR,Myanmar,JPN,Japan,2009,1424,798,626
MMR,Myanmar,JPN,Japan,2010,1139,761,378
MMR,Myanmar,JPN,Japan,2011,1097,807,290
MMR,Myanmar,JPN,Japan,2012,1532,1149,383
MMR,Myanmar,JPN,Japan,2013,2053,1440,613
MMR,Myanmar,JPN,Japan,2014,3301,1518,1783
MMR,Myanmar,JPN,Japan,2015,5218,1630,3588
MMR,Myanmar,JPN,Japan,2016,6135,1811,4324
MMR,Myanmar,JPN,Japan,2017,7608,2514,5094
MMR,Myanmar,KOR,Korea,2008,517,883,-366
MMR,Myanmar,KOR,Korea,2009,1743,972,771
MMR,Myanmar,KOR,Korea,2010,618,716,-98
MMR,Myanmar,KOR,Korea,2011,2571,813,1758
MMR,Myanmar,KOR,Korea,2012,4148,1479,2669
MMR,Myanmar,KOR,Korea,2013,4560,1187,3373
MMR,Myanmar,KOR,Korea,2014,5106,1994,3112
MMR,Myanmar,KOR,Korea,2015,5208,1864,3344
MMR,Myanmar,KOR,Korea,2016,6671,3373,3298
MMR,Myanmar,KOR,Korea,2017,6307,3931,2376
MMR,Myanmar,LUX,Luxembourg,2008,0,0,0
MMR,Myanmar,LUX,Luxembourg,2009,0,0,0
MMR,Myanmar,LUX,Luxembourg,2010,0,0,0
MMR,Myanmar,LUX,Luxembourg,2011,0,0,0
MMR,Myanmar,LUX,Luxembourg,2012,0,0,0
MMR,Myanmar,LUX,Luxembourg,2013,0,0,0
MMR,Myanmar,LUX,Luxembourg,2014,1,0,1
MMR,Myanmar,LUX,Luxembourg,2015,0,0,0
MMR,Myanmar,LUX,Luxembourg,2016,1,0,1
MMR,Myanmar,LUX,Luxembourg,2017,5,1,4
MMR,Myanmar,MEX,Mexico,2011,4,0,4
MMR,Myanmar,MEX,Mexico,2012,0,0,0
MMR,Myanmar,MEX,Mexico,2013,0,0,0
MMR,Myanmar,MEX,Mexico,2014,0,0,0
MMR,Myanmar,MEX,Mexico,2015,1,0,1
MMR,Myanmar,NLD,Netherlands,2008,13,6,7
MMR,Myanmar,NLD,Netherlands,2009,26,3,23
MMR,Myanmar,NLD,Netherlands,2010,86,7,79
MMR,Myanmar,NLD,Netherlands,2011,57,7,50
MMR,Myanmar,NLD,Netherlands,2012,29,9,20
MMR,Myanmar,NLD,Netherlands,2013,51,7,44
MMR,Myanmar,NLD,Netherlands,2014,55,14,41
MMR,Myanmar,NLD,Netherlands,2015,51,14,37
MMR,Myanmar,NLD,Netherlands,2016,45,13,32
MMR,Myanmar,NLD,Netherlands,2017,69,12,57
MMR,Myanmar,NZL,New Zealand,2008,146,1,145
MMR,Myanmar,NZL,New Zealand,2009,210,2,208
MMR,Myanmar,NZL,New Zealand,2010,222,6,216
MMR,Myanmar,NZL,New Zealand,2011,248,5,243
MMR,Myanmar,NZL,New Zealand,2012,331,5,326
MMR,Myanmar,NZL,New Zealand,2013,277,2,275
MMR,Myanmar,NZL,New Zealand,2014,215,8,207
MMR,Myanmar,NZL,New Zealand,2015,272,13,259
MMR,Myanmar,NZL,New Zealand,2016,228,17,211
MMR,Myanmar,NZL,New Zealand,2017,212,12,200
MMR,Myanmar,NOR,Norway,2008,405,0,405
MMR,Myanmar,NOR,Norway,2009,364,9,355
MMR,Myanmar,NOR,Norway,2010,279,10,269
MMR,Myanmar,NOR,Norway,2011,151,29,122
MMR,Myanmar,NOR,Norway,2012,340,22,318
MMR,Myanmar,NOR,Norway,2013,67,18,49
MMR,Myanmar,NOR,Norway,2014,40,17,23
MMR,Myanmar,NOR,Norway,2015,34,34,0
MMR,Myanmar,NOR,Norway,2016,68,15,53
MMR,Myanmar,NOR,Norway,2017,40,10,30
MMR,Myanmar,POL,Poland,2009,3,0,3
MMR,Myanmar,POL,Poland,2010,8,0,8
MMR,Myanmar,POL,Poland,2011,9,0,9
MMR,Myanmar,POL,Poland,2012,11,0,11
MMR,Myanmar,POL,Poland,2013,10,0,10
MMR,Myanmar,POL,Poland,2014,7,0,7
MMR,Myanmar,POL,Poland,2015,3,0,3
MMR,Myanmar,POL,Poland,2016,6,0,6
MMR,Myanmar,POL,Poland,2017,5,0,5
MMR,Myanmar,SVK,Slovak Republic,2008,0,0,0
MMR,Myanmar,ESP,Spain,2008,5,0,5
MMR,Myanmar,ESP,Spain,2009,2,2,0
MMR,Myanmar,ESP,Spain,2010,6,1,5
MMR,Myanmar,ESP,Spain,2011,6,4,2
MMR,Myanmar,ESP,Spain,2012,10,1,9
MMR,Myanmar,ESP,Spain,2013,5,0,5
MMR,Myanmar,ESP,Spain,2014,8,1,7
MMR,Myanmar,ESP,Spain,2015,7,2,5
MMR,Myanmar,ESP,Spain,2016,6,1,5
MMR,Myanmar,ESP,Spain,2017,9,4,5
MMR,Myanmar,SWE,Sweden,2008,249,5,244
MMR,Myanmar,SWE,Sweden,2009,196,2,194
MMR,Myanmar,SWE,Sweden,2010,91,4,87
MMR,Myanmar,SWE,Sweden,2011,41,2,39
MMR,Myanmar,SWE,Sweden,2012,54,5,49
MMR,Myanmar,SWE,Sweden,2013,23,7,16
MMR,Myanmar,SWE,Sweden,2014,17,6,11
MMR,Myanmar,SWE,Sweden,2015,12,6,6
MMR,Myanmar,SWE,Sweden,2016,18,6,12
MMR,Myanmar,SWE,Sweden,2017,22,7,15
MMR,Myanmar,CHE,Switzerland,2010,11,8,3
MMR,Myanmar,CHE,Switzerland,2011,19,6,13
MMR,Myanmar,CHE,Switzerland,2012,16,4,12
MMR,Myanmar,CHE,Switzerland,2013,17,5,12
MMR,Myanmar,CHE,Switzerland,2014,28,10,18
MMR,Myanmar,CHE,Switzerland,2015,31,13,18
MMR,Myanmar,CHE,Switzerland,2016,49,25,24
MMR,Myanmar,CHE,Switzerland,2017,68,29,39
MMR,Myanmar,TUR,Turkey,2010,10,0,10
MMR,Myanmar,USA,United States,2008,3403,0,3403
MMR,Myanmar,USA,United States,2009,13621,0,13621
MMR,Myanmar,USA,United States,2010,12925,0,12925
MMR,Myanmar,USA,United States,2011,16518,0,16518
MMR,Myanmar,USA,United States,2012,17383,0,17383
MMR,Myanmar,USA,United States,2013,12565,0,12565
MMR,Myanmar,USA,United States,2014,11144,0,11144
MMR,Myanmar,USA,United States,2015,12808,0,12808
MMR,Myanmar,USA,United States,2016,13065,0,13065
MMR,Myanmar,USA,United States,2017,12897,0,12897
MMR,Myanmar,CHL,Chile,2008,1,0,1
MMR,Myanmar,CHL,Chile,2009,0,0,0
MMR,Myanmar,CHL,Chile,2010,0,0,0
MMR,Myanmar,CHL,Chile,2011,0,0,0
MMR,Myanmar,CHL,Chile,2012,0,0,0
MMR,Myanmar,CHL,Chile,2013,0,0,0
MMR,Myanmar,CHL,Chile,2014,0,0,0
MMR,Myanmar,CHL,Chile,2015,1,0,1
MMR,Myanmar,CHL,Chile,2016,0,0,0
MMR,Myanmar,EST,Estonia,2008,0,0,0
MMR,Myanmar,EST,Estonia,2009,0,0,0
MMR,Myanmar,EST,Estonia,2010,0,0,0
MMR,Myanmar,EST,Estonia,2011,0,0,0
MMR,Myanmar,EST,Estonia,2012,0,0,0
MMR,Myanmar,EST,Estonia,2013,1,0,1
MMR,Myanmar,EST,Estonia,2014,0,0,0
MMR,Myanmar,EST,Estonia,2015,0,0,0
MMR,Myanmar,EST,Estonia,2016,0,0,0
MMR,Myanmar,EST,Estonia,2017,0,0,0
MMR,Myanmar,SVN,Slovenia,2016,1,0,1
NAM,Namibia,AUS,Australia,2008,21,5,16
NAM,Namibia,AUS,Australia,2009,18,7,11
NAM,Namibia,AUS,Australia,2010,42,8,34
NAM,Namibia,AUS,Australia,2011,27,0,27
NAM,Namibia,AUS,Australia,2012,22,6,16
NAM,Namibia,AUS,Australia,2013,18,7,11
NAM,Namibia,AUS,Australia,2014,20,8,12
NAM,Namibia,AUS,Australia,2015,11,0,11
NAM,Namibia,AUS,Australia,2016,10,0,10
NAM,Namibia,AUS,Australia,2017,18,0,18
NAM,Namibia,AUT,Austria,2008,6,5,1
NAM,Namibia,AUT,Austria,2009,4,1,3
NAM,Namibia,AUT,Austria,2010,9,6,3
NAM,Namibia,AUT,Austria,2011,11,4,7
NAM,Namibia,AUT,Austria,2012,13,5,8
NAM,Namibia,AUT,Austria,2013,6,8,-2
NAM,Namibia,AUT,Austria,2014,11,4,7
NAM,Namibia,AUT,Austria,2015,7,9,-2
NAM,Namibia,AUT,Austria,2016,6,4,2
NAM,Namibia,AUT,Austria,2017,4,4,0
NAM,Namibia,BEL,Belgium,2008,4,0,4
NAM,Namibia,BEL,Belgium,2009,4,0,4
NAM,Namibia,BEL,Belgium,2010,3,1,2
NAM,Namibia,BEL,Belgium,2012,5,3,2
NAM,Namibia,BEL,Belgium,2013,1,2,-1
NAM,Namibia,BEL,Belgium,2014,6,1,5
NAM,Namibia,BEL,Belgium,2015,2,2,0
NAM,Namibia,BEL,Belgium,2016,6,1,5
NAM,Namibia,BEL,Belgium,2017,3,1,2
NAM,Namibia,CAN,Canada,2008,26,0,26
NAM,Namibia,CAN,Canada,2009,14,0,14
NAM,Namibia,CAN,Canada,2010,16,0,16
NAM,Namibia,CAN,Canada,2011,22,0,22
NAM,Namibia,CAN,Canada,2012,24,0,24
NAM,Namibia,CAN,Canada,2013,83,0,83
NAM,Namibia,CAN,Canada,2014,120,0,120
NAM,Namibia,CAN,Canada,2015,102,0,102
NAM,Namibia,CAN,Canada,2016,70,0,70
NAM,Namibia,CAN,Canada,2017,120,0,120
NAM,Namibia,CZE,Czech Republic,2008,2,0,2
NAM,Namibia,CZE,Czech Republic,2009,2,0,2
NAM,Namibia,CZE,Czech Republic,2010,3,0,3
NAM,Namibia,CZE,Czech Republic,2011,2,0,2
NAM,Namibia,CZE,Czech Republic,2012,2,3,-1
NAM,Namibia,CZE,Czech Republic,2013,1,0,1
NAM,Namibia,CZE,Czech Republic,2014,1,2,-1
NAM,Namibia,CZE,Czech Republic,2015,2,3,-1
NAM,Namibia,CZE,Czech Republic,2016,5,5,0
NAM,Namibia,CZE,Czech Republic,2017,4,2,2
NAM,Namibia,DNK,Denmark,2008,0,1,-1
NAM,Namibia,DNK,Denmark,2009,0,2,-2
NAM,Namibia,DNK,Denmark,2010,2,1,1
NAM,Namibia,DNK,Denmark,2011,3,0,3
NAM,Namibia,DNK,Denmark,2012,2,1,1
NAM,Namibia,DNK,Denmark,2013,4,1,3
NAM,Namibia,DNK,Denmark,2014,4,1,3
NAM,Namibia,DNK,Denmark,2015,2,1,1
NAM,Namibia,DNK,Denmark,2016,2,1,1
NAM,Namibia,DNK,Denmark,2017,2,3,-1
NAM,Namibia,FIN,Finland,2008,1,2,-1
NAM,Namibia,FIN,Finland,2009,7,0,7
NAM,Namibia,FIN,Finland,2010,2,0,2
NAM,Namibia,FIN,Finland,2011,2,0,2
NAM,Namibia,FIN,Finland,2012,3,0,3
NAM,Namibia,FIN,Finland,2013,9,0,9
NAM,Namibia,FIN,Finland,2014,6,2,4
NAM,Namibia,FIN,Finland,2015,3,0,3
NAM,Namibia,FIN,Finland,2016,4,3,1
NAM,Namibia,FIN,Finland,2017,53,0,53
NAM,Namibia,FRA,France,2008,3,0,3
NAM,Namibia,FRA,France,2009,1,0,1
NAM,Namibia,FRA,France,2010,5,0,5
NAM,Namibia,FRA,France,2011,5,0,5
NAM,Namibia,FRA,France,2012,2,0,2
NAM,Namibia,FRA,France,2013,4,0,4
NAM,Namibia,FRA,France,2014,0,0,0
NAM,Namibia,FRA,France,2015,1,0,1
NAM,Namibia,FRA,France,2016,6,0,6
NAM,Namibia,FRA,France,2017,4,0,4
NAM,Namibia,DEU,Germany,2008,90,60,30
NAM,Namibia,DEU,Germany,2009,99,71,28
NAM,Namibia,DEU,Germany,2010,124,104,20
NAM,Namibia,DEU,Germany,2011,120,52,68
NAM,Namibia,DEU,Germany,2012,115,81,34
NAM,Namibia,DEU,Germany,2013,107,83,24
NAM,Namibia,DEU,Germany,2014,91,77,14
NAM,Namibia,DEU,Germany,2015,116,63,53
NAM,Namibia,DEU,Germany,2016,109,64,45
NAM,Namibia,DEU,Germany,2017,88,64,24
NAM,Namibia,HUN,Hungary,2008,0,0,0
NAM,Namibia,HUN,Hungary,2009,0,0,0
NAM,Namibia,HUN,Hungary,2010,3,0,3
NAM,Namibia,HUN,Hungary,2011,0,0,0
NAM,Namibia,HUN,Hungary,2012,2,0,2
NAM,Namibia,HUN,Hungary,2013,0,0,0
NAM,Namibia,HUN,Hungary,2014,8,1,7
NAM,Namibia,HUN,Hungary,2015,7,1,6
NAM,Namibia,HUN,Hungary,2016,4,0,4
NAM,Namibia,HUN,Hungary,2017,5,0,5
NAM,Namibia,ISL,Iceland,2008,6,0,6
NAM,Namibia,ISL,Iceland,2009,1,3,-2
NAM,Namibia,ISL,Iceland,2010,2,2,0
NAM,Namibia,ISL,Iceland,2011,0,1,-1
NAM,Namibia,ISL,Iceland,2012,4,0,4
NAM,Namibia,ISL,Iceland,2013,3,2,1
NAM,Namibia,ISL,Iceland,2014,1,4,-3
NAM,Namibia,ISL,Iceland,2015,4,1,3
NAM,Namibia,ISL,Iceland,2016,5,2,3
NAM,Namibia,ISL,Iceland,2017,2,4,-2
NAM,Namibia,ITA,Italy,2008,6,0,6
NAM,Namibia,ITA,Italy,2009,3,0,3
NAM,Namibia,ITA,Italy,2010,2,0,2
NAM,Namibia,ITA,Italy,2011,7,0,7
NAM,Namibia,ITA,Italy,2012,2,1,1
NAM,Namibia,ITA,Italy,2013,4,1,3
NAM,Namibia,ITA,Italy,2014,1,3,-2
NAM,Namibia,ITA,Italy,2015,1,0,1
NAM,Namibia,ITA,Italy,2016,2,0,2
NAM,Namibia,ITA,Italy,2017,1,0,1
NAM,Namibia,JPN,Japan,2008,53,46,7
NAM,Namibia,JPN,Japan,2009,34,41,-7
NAM,Namibia,JPN,Japan,2010,54,46,8
NAM,Namibia,JPN,Japan,2011,51,51,0
NAM,Namibia,JPN,Japan,2012,80,78,2
NAM,Namibia,JPN,Japan,2013,138,137,1
NAM,Namibia,JPN,Japan,2014,65,58,7
NAM,Namibia,JPN,Japan,2015,64,56,8
NAM,Namibia,JPN,Japan,2016,67,64,3
NAM,Namibia,JPN,Japan,2017,23,28,-5
NAM,Namibia,KOR,Korea,2008,0,0,0
NAM,Namibia,KOR,Korea,2009,0,0,0
NAM,Namibia,KOR,Korea,2010,1,1,0
NAM,Namibia,KOR,Korea,2011,0,0,0
NAM,Namibia,KOR,Korea,2012,0,3,-3
NAM,Namibia,KOR,Korea,2013,0,0,0
NAM,Namibia,KOR,Korea,2014,0,0,0
NAM,Namibia,KOR,Korea,2015,1,1,0
NAM,Namibia,KOR,Korea,2016,2,2,0
NAM,Namibia,KOR,Korea,2017,1,1,0
NAM,Namibia,LUX,Luxembourg,2008,1,1,0
NAM,Namibia,LUX,Luxembourg,2009,0,0,0
NAM,Namibia,LUX,Luxembourg,2010,1,0,1
NAM,Namibia,LUX,Luxembourg,2011,0,0,0
NAM,Namibia,LUX,Luxembourg,2012,0,0,0
NAM,Namibia,LUX,Luxembourg,2013,1,0,1
NAM,Namibia,LUX,Luxembourg,2014,0,0,0
NAM,Namibia,LUX,Luxembourg,2015,3,1,2
NAM,Namibia,LUX,Luxembourg,2016,0,0,0
NAM,Namibia,LUX,Luxembourg,2017,2,2,0
NAM,Namibia,MEX,Mexico,2010,1,0,1
NAM,Namibia,MEX,Mexico,2012,0,0,0
NAM,Namibia,MEX,Mexico,2013,0,0,0
NAM,Namibia,MEX,Mexico,2014,0,0,0
NAM,Namibia,NLD,Netherlands,2008,23,8,15
NAM,Namibia,NLD,Netherlands,2009,17,25,-8
NAM,Namibia,NLD,Netherlands,2010,13,16,-3
NAM,Namibia,NLD,Netherlands,2011,17,10,7
NAM,Namibia,NLD,Netherlands,2012,20,13,7
NAM,Namibia,NLD,Netherlands,2013,21,20,1
NAM,Namibia,NLD,Netherlands,2014,14,12,2
NAM,Namibia,NLD,Netherlands,2015,16,24,-8
NAM,Namibia,NLD,Netherlands,2016,14,7,7
NAM,Namibia,NLD,Netherlands,2017,34,6,28
NAM,Namibia,NZL,New Zealand,2008,4,2,2
NAM,Namibia,NZL,New Zealand,2009,3,0,3
NAM,Namibia,NZL,New Zealand,2010,5,3,2
NAM,Namibia,NZL,New Zealand,2011,6,3,3
NAM,Namibia,NZL,New Zealand,2012,11,4,7
NAM,Namibia,NZL,New Zealand,2013,1,0,1
NAM,Namibia,NZL,New Zealand,2014,3,1,2
NAM,Namibia,NZL,New Zealand,2016,6,4,2
NAM,Namibia,NZL,New Zealand,2017,23,4,19
NAM,Namibia,NOR,Norway,2008,4,4,0
NAM,Namibia,NOR,Norway,2009,5,3,2
NAM,Namibia,NOR,Norway,2010,7,4,3
NAM,Namibia,NOR,Norway,2011,13,14,-1
NAM,Namibia,NOR,Norway,2012,10,7,3
NAM,Namibia,NOR,Norway,2013,4,4,0
NAM,Namibia,NOR,Norway,2014,7,8,-1
NAM,Namibia,NOR,Norway,2015,3,4,-1
NAM,Namibia,NOR,Norway,2016,5,6,-1
NAM,Namibia,NOR,Norway,2017,6,3,3
NAM,Namibia,POL,Poland,2009,0,0,0
NAM,Namibia,POL,Poland,2010,3,0,3
NAM,Namibia,POL,Poland,2011,1,0,1
NAM,Namibia,POL,Poland,2012,2,0,2
NAM,Namibia,POL,Poland,2013,1,0,1
NAM,Namibia,POL,Poland,2014,0,0,0
NAM,Namibia,POL,Poland,2015,3,0,3
NAM,Namibia,POL,Poland,2016,6,0,6
NAM,Namibia,POL,Poland,2017,7,0,7
NAM,Namibia,SVK,Slovak Republic,2008,1,2,-1
NAM,Namibia,SVK,Slovak Republic,2009,3,0,3
NAM,Namibia,SVK,Slovak Republic,2011,1,0,1
NAM,Namibia,ESP,Spain,2008,7,2,5
NAM,Namibia,ESP,Spain,2009,5,1,4
NAM,Namibia,ESP,Spain,2010,3,3,0
NAM,Namibia,ESP,Spain,2011,10,2,8
NAM,Namibia,ESP,Spain,2012,9,1,8
NAM,Namibia,ESP,Spain,2013,10,4,6
NAM,Namibia,ESP,Spain,2014,6,2,4
NAM,Namibia,ESP,Spain,2015,6,0,6
NAM,Namibia,ESP,Spain,2016,11,1,10
NAM,Namibia,ESP,Spain,2017,19,4,15
NAM,Namibia,SWE,Sweden,2008,1,3,-2
NAM,Namibia,SWE,Sweden,2009,18,2,16
NAM,Namibia,SWE,Sweden,2010,9,2,7
NAM,Namibia,SWE,Sweden,2011,23,4,19
NAM,Namibia,SWE,Sweden,2012,12,1,11
NAM,Namibia,SWE,Sweden,2013,18,2,16
NAM,Namibia,SWE,Sweden,2014,2,2,0
NAM,Namibia,SWE,Sweden,2015,6,2,4
NAM,Namibia,SWE,Sweden,2016,10,1,9
NAM,Namibia,SWE,Sweden,2017,13,5,8
NAM,Namibia,CHE,Switzerland,2010,4,4,0
NAM,Namibia,CHE,Switzerland,2011,2,0,2
NAM,Namibia,CHE,Switzerland,2012,6,6,0
NAM,Namibia,CHE,Switzerland,2013,6,3,3
NAM,Namibia,CHE,Switzerland,2014,5,2,3
NAM,Namibia,CHE,Switzerland,2015,7,6,1
NAM,Namibia,CHE,Switzerland,2016,5,0,5
NAM,Namibia,CHE,Switzerland,2017,6,1,5
NAM,Namibia,TUR,Turkey,2010,1,0,1
NAM,Namibia,USA,United States,2008,46,0,46
NAM,Namibia,USA,United States,2009,53,0,53
NAM,Namibia,USA,United States,2010,60,0,60
NAM,Namibia,USA,United States,2011,43,0,43
NAM,Namibia,USA,United States,2012,59,0,59
NAM,Namibia,USA,United States,2013,57,0,57
NAM,Namibia,USA,United States,2014,44,0,44
NAM,Namibia,USA,United States,2015,86,0,86
NAM,Namibia,USA,United States,2016,87,0,87
NAM,Namibia,USA,United States,2017,130,0,130
NAM,Namibia,CHL,Chile,2008,0,0,0
NAM,Namibia,CHL,Chile,2009,0,0,0
NAM,Namibia,CHL,Chile,2010,0,0,0
NAM,Namibia,CHL,Chile,2011,1,0,1
NAM,Namibia,CHL,Chile,2012,0,0,0
NAM,Namibia,CHL,Chile,2013,0,0,0
NAM,Namibia,CHL,Chile,2014,0,0,0
NAM,Namibia,CHL,Chile,2015,4,0,4
NAM,Namibia,CHL,Chile,2016,0,0,0
NAM,Namibia,EST,Estonia,2008,0,0,0
NAM,Namibia,EST,Estonia,2009,0,0,0
NAM,Namibia,EST,Estonia,2010,0,0,0
NAM,Namibia,EST,Estonia,2011,0,0,0
NAM,Namibia,EST,Estonia,2012,0,0,0
NAM,Namibia,EST,Estonia,2013,0,0,0
NAM,Namibia,EST,Estonia,2014,1,0,1
NAM,Namibia,EST,Estonia,2015,3,0,3
NAM,Namibia,EST,Estonia,2016,1,0,1
NAM,Namibia,EST,Estonia,2017,2,0,2
NAM,Namibia,SVN,Slovenia,2015,1,0,1
NRU,Nauru,AUS,Australia,2008,13,6,7
NRU,Nauru,AUS,Australia,2009,11,0,11
NRU,Nauru,AUS,Australia,2010,10,8,2
NRU,Nauru,AUS,Australia,2011,2,0,2
NRU,Nauru,AUS,Australia,2012,19,8,11
NRU,Nauru,AUS,Australia,2013,11,0,11
NRU,Nauru,AUS,Australia,2014,0,8,-8
NRU,Nauru,AUS,Australia,2015,8,0,8
NRU,Nauru,AUS,Australia,2016,8,0,8
NRU,Nauru,AUS,Australia,2017,7,0,7
NRU,Nauru,AUT,Austria,2008,0,0,0
NRU,Nauru,AUT,Austria,2009,0,0,0
NRU,Nauru,AUT,Austria,2010,0,0,0
NRU,Nauru,AUT,Austria,2011,0,0,0
NRU,Nauru,AUT,Austria,2012,0,0,0
NRU,Nauru,AUT,Austria,2013,0,0,0
NRU,Nauru,AUT,Austria,2014,0,0,0
NRU,Nauru,AUT,Austria,2015,0,0,0
NRU,Nauru,AUT,Austria,2016,0,0,0
NRU,Nauru,AUT,Austria,2017,1,0,1
NRU,Nauru,BEL,Belgium,2010,0,0,0
NRU,Nauru,CAN,Canada,2008,0,0,0
NRU,Nauru,CAN,Canada,2009,1,0,1
NRU,Nauru,CAN,Canada,2010,0,0,0
NRU,Nauru,CAN,Canada,2011,0,0,0
NRU,Nauru,CAN,Canada,2012,0,0,0
NRU,Nauru,CAN,Canada,2013,1,0,1
NRU,Nauru,CAN,Canada,2014,1,0,1
NRU,Nauru,CAN,Canada,2015,0,0,0
NRU,Nauru,CAN,Canada,2016,0,0,0
NRU,Nauru,CAN,Canada,2017,0,0,0
NRU,Nauru,DNK,Denmark,2013,0,0,0
NRU,Nauru,DNK,Denmark,2014,0,0,0
NRU,Nauru,DNK,Denmark,2015,0,0,0
NRU,Nauru,DNK,Denmark,2016,0,1,-1
NRU,Nauru,DNK,Denmark,2017,0,1,-1
NRU,Nauru,FIN,Finland,2008,0,0,0
NRU,Nauru,FIN,Finland,2009,0,0,0
NRU,Nauru,FIN,Finland,2010,0,0,0
NRU,Nauru,FIN,Finland,2011,0,0,0
NRU,Nauru,FIN,Finland,2012,0,0,0
NRU,Nauru,FIN,Finland,2013,0,0,0
NRU,Nauru,FIN,Finland,2014,0,0,0
NRU,Nauru,FIN,Finland,2015,0,0,0
NRU,Nauru,FIN,Finland,2016,0,0,0
NRU,Nauru,FIN,Finland,2017,0,0,0
NRU,Nauru,FRA,France,2008,0,0,0
NRU,Nauru,FRA,France,2009,0,0,0
NRU,Nauru,FRA,France,2010,0,0,0
NRU,Nauru,FRA,France,2011,1,0,1
NRU,Nauru,FRA,France,2012,0,0,0
NRU,Nauru,FRA,France,2013,0,0,0
NRU,Nauru,FRA,France,2014,0,0,0
NRU,Nauru,FRA,France,2015,0,0,0
NRU,Nauru,FRA,France,2016,0,0,0
NRU,Nauru,FRA,France,2017,0,0,0
NRU,Nauru,DEU,Germany,2008,0,0,0
NRU,Nauru,DEU,Germany,2009,0,0,0
NRU,Nauru,DEU,Germany,2010,0,0,0
NRU,Nauru,DEU,Germany,2011,0,0,0
NRU,Nauru,DEU,Germany,2012,1,0,1
NRU,Nauru,DEU,Germany,2013,0,0,0
NRU,Nauru,DEU,Germany,2014,0,0,0
NRU,Nauru,DEU,Germany,2015,2,0,2
NRU,Nauru,DEU,Germany,2016,0,0,0
NRU,Nauru,DEU,Germany,2017,0,0,0
NRU,Nauru,HUN,Hungary,2008,0,0,0
NRU,Nauru,HUN,Hungary,2009,0,0,0
NRU,Nauru,HUN,Hungary,2010,0,0,0
NRU,Nauru,HUN,Hungary,2011,0,0,0
NRU,Nauru,HUN,Hungary,2012,0,0,0
NRU,Nauru,HUN,Hungary,2013,0,0,0
NRU,Nauru,HUN,Hungary,2014,0,0,0
NRU,Nauru,HUN,Hungary,2015,0,0,0
NRU,Nauru,HUN,Hungary,2016,0,0,0
NRU,Nauru,HUN,Hungary,2017,0,0,0
NRU,Nauru,ISL,Iceland,2008,0,1,-1
NRU,Nauru,ISL,Iceland,2009,0,0,0
NRU,Nauru,ISL,Iceland,2010,0,0,0
NRU,Nauru,ISL,Iceland,2011,0,0,0
NRU,Nauru,ISL,Iceland,2012,0,0,0
NRU,Nauru,ISL,Iceland,2013,0,0,0
NRU,Nauru,ISL,Iceland,2014,0,0,0
NRU,Nauru,ISL,Iceland,2015,0,0,0
NRU,Nauru,ISL,Iceland,2016,0,0,0
NRU,Nauru,ISL,Iceland,2017,0,0,0
NRU,Nauru,ITA,Italy,2008,0,0,0
NRU,Nauru,ITA,Italy,2009,0,0,0
NRU,Nauru,ITA,Italy,2010,0,0,0
NRU,Nauru,ITA,Italy,2011,0,0,0
NRU,Nauru,ITA,Italy,2012,0,0,0
NRU,Nauru,ITA,Italy,2013,0,0,0
NRU,Nauru,ITA,Italy,2014,0,0,0
NRU,Nauru,ITA,Italy,2015,0,0,0
NRU,Nauru,ITA,Italy,2016,0,0,0
NRU,Nauru,ITA,Italy,2017,0,0,0
NRU,Nauru,JPN,Japan,2008,7,9,-2
NRU,Nauru,JPN,Japan,2009,12,11,1
NRU,Nauru,JPN,Japan,2010,12,12,0
NRU,Nauru,JPN,Japan,2011,5,5,0
NRU,Nauru,JPN,Japan,2012,10,11,-1
NRU,Nauru,JPN,Japan,2013,4,4,0
NRU,Nauru,JPN,Japan,2014,13,13,0
NRU,Nauru,JPN,Japan,2015,28,26,2
NRU,Nauru,JPN,Japan,2016,17,18,-1
NRU,Nauru,JPN,Japan,2017,28,28,0
NRU,Nauru,KOR,Korea,2008,0,0,0
NRU,Nauru,KOR,Korea,2009,0,0,0
NRU,Nauru,KOR,Korea,2010,0,1,-1
NRU,Nauru,KOR,Korea,2011,1,0,1
NRU,Nauru,KOR,Korea,2012,2,2,0
NRU,Nauru,KOR,Korea,2013,0,0,0
NRU,Nauru,KOR,Korea,2014,0,0,0
NRU,Nauru,KOR,Korea,2015,0,1,-1
NRU,Nauru,KOR,Korea,2016,0,0,0
NRU,Nauru,KOR,Korea,2017,0,2,-2
NRU,Nauru,LUX,Luxembourg,2008,0,0,0
NRU,Nauru,LUX,Luxembourg,2009,0,0,0
NRU,Nauru,LUX,Luxembourg,2010,0,0,0
NRU,Nauru,LUX,Luxembourg,2011,0,0,0
NRU,Nauru,LUX,Luxembourg,2012,0,0,0
NRU,Nauru,LUX,Luxembourg,2013,0,0,0
NRU,Nauru,LUX,Luxembourg,2014,0,0,0
NRU,Nauru,LUX,Luxembourg,2015,0,0,0
NRU,Nauru,LUX,Luxembourg,2016,0,0,0
NRU,Nauru,LUX,Luxembourg,2017,0,0,0
NRU,Nauru,MEX,Mexico,2012,0,0,0
NRU,Nauru,MEX,Mexico,2013,0,0,0
NRU,Nauru,MEX,Mexico,2014,0,0,0
NRU,Nauru,NZL,New Zealand,2008,0,4,-4
NRU,Nauru,NZL,New Zealand,2009,1,0,1
NRU,Nauru,NZL,New Zealand,2010,2,1,1
NRU,Nauru,NZL,New Zealand,2011,3,3,0
NRU,Nauru,NZL,New Zealand,2012,11,0,11
NRU,Nauru,NZL,New Zealand,2013,15,2,13
NRU,Nauru,NZL,New Zealand,2014,9,2,7
NRU,Nauru,NZL,New Zealand,2015,5,8,-3
NRU,Nauru,NZL,New Zealand,2016,4,8,-4
NRU,Nauru,NZL,New Zealand,2017,5,5,0
NRU,Nauru,NOR,Norway,2008,0,0,0
NRU,Nauru,NOR,Norway,2009,0,0,0
NRU,Nauru,NOR,Norway,2010,0,0,0
NRU,Nauru,NOR,Norway,2011,0,0,0
NRU,Nauru,NOR,Norway,2012,0,0,0
NRU,Nauru,NOR,Norway,2013,0,0,0
NRU,Nauru,NOR,Norway,2014,0,0,0
NRU,Nauru,NOR,Norway,2015,0,0,0
NRU,Nauru,NOR,Norway,2016,0,0,0
NRU,Nauru,NOR,Norway,2017,0,0,0
NRU,Nauru,POL,Poland,2009,0,0,0
NRU,Nauru,POL,Poland,2010,0,0,0
NRU,Nauru,POL,Poland,2011,0,0,0
NRU,Nauru,POL,Poland,2012,0,0,0
NRU,Nauru,POL,Poland,2013,0,0,0
NRU,Nauru,POL,Poland,2014,0,0,0
NRU,Nauru,POL,Poland,2015,0,0,0
NRU,Nauru,POL,Poland,2016,0,0,0
NRU,Nauru,POL,Poland,2017,0,0,0
NRU,Nauru,SVK,Slovak Republic,2008,0,0,0
NRU,Nauru,ESP,Spain,2008,0,0,0
NRU,Nauru,ESP,Spain,2009,1,0,1
NRU,Nauru,ESP,Spain,2010,0,0,0
NRU,Nauru,ESP,Spain,2011,0,6,-6
NRU,Nauru,ESP,Spain,2012,1,0,1
NRU,Nauru,ESP,Spain,2013,0,0,0
NRU,Nauru,ESP,Spain,2014,0,0,0
NRU,Nauru,ESP,Spain,2015,0,0,0
NRU,Nauru,ESP,Spain,2016,0,0,0
NRU,Nauru,ESP,Spain,2017,1,0,1
NRU,Nauru,SWE,Sweden,2008,0,0,0
NRU,Nauru,SWE,Sweden,2009,0,0,0
NRU,Nauru,SWE,Sweden,2010,0,0,0
NRU,Nauru,SWE,Sweden,2011,0,0,0
NRU,Nauru,SWE,Sweden,2012,0,0,0
NRU,Nauru,SWE,Sweden,2013,0,0,0
NRU,Nauru,SWE,Sweden,2014,0,0,0
NRU,Nauru,SWE,Sweden,2015,0,0,0
NRU,Nauru,SWE,Sweden,2016,0,0,0
NRU,Nauru,SWE,Sweden,2017,0,0,0
NRU,Nauru,CHE,Switzerland,2010,0,0,0
NRU,Nauru,CHE,Switzerland,2011,0,0,0
NRU,Nauru,CHE,Switzerland,2012,0,0,0
NRU,Nauru,CHE,Switzerland,2013,0,0,0
NRU,Nauru,USA,United States,2009,0,0,0
NRU,Nauru,USA,United States,2010,0,0,0
NRU,Nauru,USA,United States,2012,8,0,8
NRU,Nauru,USA,United States,2013,3,0,3
NRU,Nauru,USA,United States,2014,0,0,0
NRU,Nauru,USA,United States,2017,1,0,1
NRU,Nauru,CHL,Chile,2008,0,0,0
NRU,Nauru,CHL,Chile,2009,0,0,0
NRU,Nauru,CHL,Chile,2010,0,0,0
NRU,Nauru,CHL,Chile,2011,0,0,0
NRU,Nauru,CHL,Chile,2012,0,0,0
NRU,Nauru,CHL,Chile,2013,0,0,0
NRU,Nauru,CHL,Chile,2014,0,0,0
NRU,Nauru,CHL,Chile,2015,0,0,0
NRU,Nauru,CHL,Chile,2016,0,0,0
NRU,Nauru,EST,Estonia,2008,0,0,0
NRU,Nauru,EST,Estonia,2009,0,0,0
NRU,Nauru,EST,Estonia,2010,0,0,0
NRU,Nauru,EST,Estonia,2011,0,0,0
NRU,Nauru,EST,Estonia,2012,0,0,0
NRU,Nauru,EST,Estonia,2013,0,0,0
NRU,Nauru,EST,Estonia,2014,0,0,0
NRU,Nauru,EST,Estonia,2015,0,0,0
NRU,Nauru,EST,Estonia,2016,0,0,0
NRU,Nauru,EST,Estonia,2017,0,0,0
NPL,Nepal,AUS,Australia,2008,883,31,852
NPL,Nepal,AUS,Australia,2009,975,20,955
NPL,Nepal,AUS,Australia,2010,1262,16,1246
NPL,Nepal,AUS,Australia,2011,2073,31,2042
NPL,Nepal,AUS,Australia,2012,2507,41,2466
NPL,Nepal,AUS,Australia,2013,4042,29,4013
NPL,Nepal,AUS,Australia,2014,4351,49,4302
NPL,Nepal,AUS,Australia,2015,4157,100,4057
NPL,Nepal,AUS,Australia,2016,5060,100,4960
NPL,Nepal,AUS,Australia,2017,4361,0,4361
NPL,Nepal,AUT,Austria,2008,91,80,11
NPL,Nepal,AUT,Austria,2009,82,78,4
NPL,Nepal,AUT,Austria,2010,93,91,2
NPL,Nepal,AUT,Austria,2011,106,68,38
NPL,Nepal,AUT,Austria,2012,120,84,36
NPL,Nepal,AUT,Austria,2013,84,60,24
NPL,Nepal,AUT,Austria,2014,90,52,38
NPL,Nepal,AUT,Austria,2015,108,54,54
NPL,Nepal,AUT,Austria,2016,111,54,57
NPL,Nepal,AUT,Austria,2017,91,62,29
NPL,Nepal,BEL,Belgium,2008,171,0,171
NPL,Nepal,BEL,Belgium,2009,220,0,220
NPL,Nepal,BEL,Belgium,2010,216,14,202
NPL,Nepal,BEL,Belgium,2011,284,0,284
NPL,Nepal,BEL,Belgium,2012,485,168,317
NPL,Nepal,BEL,Belgium,2013,276,344,-68
NPL,Nepal,BEL,Belgium,2014,232,378,-146
NPL,Nepal,BEL,Belgium,2015,202,145,57
NPL,Nepal,BEL,Belgium,2016,138,67,71
NPL,Nepal,BEL,Belgium,2017,142,49,93
NPL,Nepal,CAN,Canada,2008,581,0,581
NPL,Nepal,CAN,Canada,2009,561,0,561
NPL,Nepal,CAN,Canada,2010,1392,0,1392
NPL,Nepal,CAN,Canada,2011,1129,0,1129
NPL,Nepal,CAN,Canada,2012,1185,0,1185
NPL,Nepal,CAN,Canada,2013,1308,0,1308
NPL,Nepal,CAN,Canada,2014,1219,0,1219
NPL,Nepal,CAN,Canada,2015,1499,0,1499
NPL,Nepal,CAN,Canada,2016,750,0,750
NPL,Nepal,CAN,Canada,2017,1110,0,1110
NPL,Nepal,CZE,Czech Republic,2008,26,1,25
NPL,Nepal,CZE,Czech Republic,2009,67,0,67
NPL,Nepal,CZE,Czech Republic,2010,29,0,29
NPL,Nepal,CZE,Czech Republic,2011,13,0,13
NPL,Nepal,CZE,Czech Republic,2012,22,10,12
NPL,Nepal,CZE,Czech Republic,2013,22,21,1
NPL,Nepal,CZE,Czech Republic,2014,35,11,24
NPL,Nepal,CZE,Czech Republic,2015,54,8,46
NPL,Nepal,CZE,Czech Republic,2016,109,23,86
NPL,Nepal,CZE,Czech Republic,2017,270,29,241
NPL,Nepal,DNK,Denmark,2008,540,85,455
NPL,Nepal,DNK,Denmark,2009,248,117,131
NPL,Nepal,DNK,Denmark,2010,200,178,22
NPL,Nepal,DNK,Denmark,2011,276,162,114
NPL,Nepal,DNK,Denmark,2012,331,136,195
NPL,Nepal,DNK,Denmark,2013,450,184,266
NPL,Nepal,DNK,Denmark,2014,544,192,352
NPL,Nepal,DNK,Denmark,2015,725,246,479
NPL,Nepal,DNK,Denmark,2016,1027,432,595
NPL,Nepal,DNK,Denmark,2017,751,502,249
NPL,Nepal,FIN,Finland,2008,234,12,222
NPL,Nepal,FIN,Finland,2009,223,3,220
NPL,Nepal,FIN,Finland,2010,258,4,254
NPL,Nepal,FIN,Finland,2011,269,10,259
NPL,Nepal,FIN,Finland,2012,386,6,380
NPL,Nepal,FIN,Finland,2013,334,9,325
NPL,Nepal,FIN,Finland,2014,342,17,325
NPL,Nepal,FIN,Finland,2015,372,18,354
NPL,Nepal,FIN,Finland,2016,356,21,335
NPL,Nepal,FIN,Finland,2017,321,27,294
NPL,Nepal,FRA,France,2008,49,0,49
NPL,Nepal,FRA,France,2009,57,0,57
NPL,Nepal,FRA,France,2010,69,0,69
NPL,Nepal,FRA,France,2011,64,0,64
NPL,Nepal,FRA,France,2012,79,0,79
NPL,Nepal,FRA,France,2013,103,0,103
NPL,Nepal,FRA,France,2014,106,0,106
NPL,Nepal,FRA,France,2015,117,0,117
NPL,Nepal,FRA,France,2016,122,0,122
NPL,Nepal,FRA,France,2017,121,0,121
NPL,Nepal,DEU,Germany,2008,428,361,67
NPL,Nepal,DEU,Germany,2009,470,318,152
NPL,Nepal,DEU,Germany,2010,559,328,231
NPL,Nepal,DEU,Germany,2011,632,278,354
NPL,Nepal,DEU,Germany,2012,800,328,472
NPL,Nepal,DEU,Germany,2013,901,398,503
NPL,Nepal,DEU,Germany,2014,1010,393,617
NPL,Nepal,DEU,Germany,2015,1213,532,681
NPL,Nepal,DEU,Germany,2016,1386,605,781
NPL,Nepal,DEU,Germany,2017,1322,546,776
NPL,Nepal,HUN,Hungary,2008,13,3,10
NPL,Nepal,HUN,Hungary,2009,10,0,10
NPL,Nepal,HUN,Hungary,2010,17,4,13
NPL,Nepal,HUN,Hungary,2011,10,2,8
NPL,Nepal,HUN,Hungary,2012,9,4,5
NPL,Nepal,HUN,Hungary,2013,11,4,7
NPL,Nepal,HUN,Hungary,2014,10,6,4
NPL,Nepal,HUN,Hungary,2015,18,2,16
NPL,Nepal,HUN,Hungary,2016,25,5,20
NPL,Nepal,HUN,Hungary,2017,51,0,51
NPL,Nepal,ISL,Iceland,2008,14,8,6
NPL,Nepal,ISL,Iceland,2009,9,7,2
NPL,Nepal,ISL,Iceland,2010,9,7,2
NPL,Nepal,ISL,Iceland,2011,4,4,0
NPL,Nepal,ISL,Iceland,2012,5,0,5
NPL,Nepal,ISL,Iceland,2013,9,7,2
NPL,Nepal,ISL,Iceland,2014,13,13,0
NPL,Nepal,ISL,Iceland,2015,9,3,6
NPL,Nepal,ISL,Iceland,2016,12,8,4
NPL,Nepal,ISL,Iceland,2017,14,12,2
NPL,Nepal,ITA,Italy,2008,178,2,176
NPL,Nepal,ITA,Italy,2009,102,2,100
NPL,Nepal,ITA,Italy,2010,187,0,187
NPL,Nepal,ITA,Italy,2011,134,8,126
NPL,Nepal,ITA,Italy,2012,160,14,146
NPL,Nepal,ITA,Italy,2013,154,8,146
NPL,Nepal,ITA,Italy,2014,169,12,157
NPL,Nepal,ITA,Italy,2015,197,15,182
NPL,Nepal,ITA,Italy,2016,187,0,187
NPL,Nepal,ITA,Italy,2017,165,21,144
NPL,Nepal,JPN,Japan,2008,3593,352,3241
NPL,Nepal,JPN,Japan,2009,3629,380,3249
NPL,Nepal,JPN,Japan,2010,2889,378,2511
NPL,Nepal,JPN,Japan,2011,3541,446,3095
NPL,Nepal,JPN,Japan,2012,4839,496,4343
NPL,Nepal,JPN,Japan,2013,8281,759,7522
NPL,Nepal,JPN,Japan,2014,11529,759,10770
NPL,Nepal,JPN,Japan,2015,13351,967,12384
NPL,Nepal,JPN,Japan,2016,14132,1098,13034
NPL,Nepal,JPN,Japan,2017,14481,1450,13031
NPL,Nepal,KOR,Korea,2008,2417,1091,1326
NPL,Nepal,KOR,Korea,2009,2606,1359,1247
NPL,Nepal,KOR,Korea,2010,2692,1133,1559
NPL,Nepal,KOR,Korea,2011,4339,1095,3244
NPL,Nepal,KOR,Korea,2012,6894,1268,5626
NPL,Nepal,KOR,Korea,2013,6017,2871,3146
NPL,Nepal,KOR,Korea,2014,6763,2077,4686
NPL,Nepal,KOR,Korea,2015,6546,3124,3422
NPL,Nepal,KOR,Korea,2016,8724,4696,4028
NPL,Nepal,KOR,Korea,2017,8649,5999,2650
NPL,Nepal,LUX,Luxembourg,2008,15,2,13
NPL,Nepal,LUX,Luxembourg,2009,16,1,15
NPL,Nepal,LUX,Luxembourg,2010,13,0,13
NPL,Nepal,LUX,Luxembourg,2011,10,1,9
NPL,Nepal,LUX,Luxembourg,2012,15,0,15
NPL,Nepal,LUX,Luxembourg,2013,31,1,30
NPL,Nepal,LUX,Luxembourg,2014,28,1,27
NPL,Nepal,LUX,Luxembourg,2015,50,6,44
NPL,Nepal,LUX,Luxembourg,2016,27,14,13
NPL,Nepal,LUX,Luxembourg,2017,52,5,47
NPL,Nepal,MEX,Mexico,2008,1,0,1
NPL,Nepal,MEX,Mexico,2009,2,0,2
NPL,Nepal,MEX,Mexico,2010,2,0,2
NPL,Nepal,MEX,Mexico,2011,3,0,3
NPL,Nepal,MEX,Mexico,2012,5,0,5
NPL,Nepal,MEX,Mexico,2013,7,0,7
NPL,Nepal,MEX,Mexico,2014,2,0,2
NPL,Nepal,MEX,Mexico,2015,3,0,3
NPL,Nepal,MEX,Mexico,2016,2,0,2
NPL,Nepal,MEX,Mexico,2017,1,0,1
NPL,Nepal,NLD,Netherlands,2008,172,119,53
NPL,Nepal,NLD,Netherlands,2009,191,70,121
NPL,Nepal,NLD,Netherlands,2010,168,127,41
NPL,Nepal,NLD,Netherlands,2011,142,133,9
NPL,Nepal,NLD,Netherlands,2012,144,110,34
NPL,Nepal,NLD,Netherlands,2013,169,113,56
NPL,Nepal,NLD,Netherlands,2014,232,77,155
NPL,Nepal,NLD,Netherlands,2015,190,126,64
NPL,Nepal,NLD,Netherlands,2016,202,118,84
NPL,Nepal,NLD,Netherlands,2017,184,126,58
NPL,Nepal,NZL,New Zealand,2008,100,9,91
NPL,Nepal,NZL,New Zealand,2009,78,32,46
NPL,Nepal,NZL,New Zealand,2010,179,20,159
NPL,Nepal,NZL,New Zealand,2011,177,22,155
NPL,Nepal,NZL,New Zealand,2012,185,38,147
NPL,Nepal,NZL,New Zealand,2013,229,38,191
NPL,Nepal,NZL,New Zealand,2014,567,28,539
NPL,Nepal,NZL,New Zealand,2015,458,34,424
NPL,Nepal,NZL,New Zealand,2016,442,35,407
NPL,Nepal,NZL,New Zealand,2017,397,85,312
NPL,Nepal,NOR,Norway,2008,138,56,82
NPL,Nepal,NOR,Norway,2009,233,76,157
NPL,Nepal,NOR,Norway,2010,246,82,164
NPL,Nepal,NOR,Norway,2011,186,94,92
NPL,Nepal,NOR,Norway,2012,272,106,166
NPL,Nepal,NOR,Norway,2013,279,154,125
NPL,Nepal,NOR,Norway,2014,250,140,110
NPL,Nepal,NOR,Norway,2015,270,202,68
NPL,Nepal,NOR,Norway,2016,276,153,123
NPL,Nepal,NOR,Norway,2017,327,110,217
NPL,Nepal,POL,Poland,2008,195,0,195
NPL,Nepal,POL,Poland,2009,254,0,254
NPL,Nepal,POL,Poland,2010,447,0,447
NPL,Nepal,POL,Poland,2011,417,0,417
NPL,Nepal,POL,Poland,2012,380,0,380
NPL,Nepal,POL,Poland,2013,416,0,416
NPL,Nepal,POL,Poland,2014,231,0,231
NPL,Nepal,POL,Poland,2015,359,0,359
NPL,Nepal,POL,Poland,2016,406,0,406
NPL,Nepal,POL,Poland,2017,681,0,681
NPL,Nepal,PRT,Portugal,2008,114,0,114
NPL,Nepal,PRT,Portugal,2009,157,0,157
NPL,Nepal,PRT,Portugal,2010,225,0,225
NPL,Nepal,PRT,Portugal,2011,365,0,365
NPL,Nepal,PRT,Portugal,2012,527,0,527
NPL,Nepal,PRT,Portugal,2013,847,0,847
NPL,Nepal,PRT,Portugal,2014,947,0,947
NPL,Nepal,PRT,Portugal,2015,1369,0,1369
NPL,Nepal,PRT,Portugal,2016,1348,0,1348
NPL,Nepal,PRT,Portugal,2017,1746,0,1746
NPL,Nepal,SVK,Slovak Republic,2008,0,0,0
NPL,Nepal,SVK,Slovak Republic,2009,2,1,1
NPL,Nepal,SVK,Slovak Republic,2010,1,1,0
NPL,Nepal,SVK,Slovak Republic,2014,1,0,1
NPL,Nepal,ESP,Spain,2008,626,116,510
NPL,Nepal,ESP,Spain,2009,422,292,130
NPL,Nepal,ESP,Spain,2010,388,274,114
NPL,Nepal,ESP,Spain,2011,431,425,6
NPL,Nepal,ESP,Spain,2012,571,255,316
NPL,Nepal,ESP,Spain,2013,487,312,175
NPL,Nepal,ESP,Spain,2014,362,240,122
NPL,Nepal,ESP,Spain,2015,309,170,139
NPL,Nepal,ESP,Spain,2016,420,134,286
NPL,Nepal,ESP,Spain,2017,623,159,464
NPL,Nepal,SWE,Sweden,2008,71,5,66
NPL,Nepal,SWE,Sweden,2009,137,6,131
NPL,Nepal,SWE,Sweden,2010,216,15,201
NPL,Nepal,SWE,Sweden,2011,73,34,39
NPL,Nepal,SWE,Sweden,2012,84,51,33
NPL,Nepal,SWE,Sweden,2013,104,46,58
NPL,Nepal,SWE,Sweden,2014,96,52,44
NPL,Nepal,SWE,Sweden,2015,58,89,-31
NPL,Nepal,SWE,Sweden,2016,66,24,42
NPL,Nepal,SWE,Sweden,2017,79,19,60
NPL,Nepal,CHE,Switzerland,2010,121,25,96
NPL,Nepal,CHE,Switzerland,2011,61,38,23
NPL,Nepal,CHE,Switzerland,2012,54,22,32
NPL,Nepal,CHE,Switzerland,2013,69,41,28
NPL,Nepal,CHE,Switzerland,2014,73,50,23
NPL,Nepal,CHE,Switzerland,2015,79,36,43
NPL,Nepal,CHE,Switzerland,2016,57,36,21
NPL,Nepal,CHE,Switzerland,2017,78,23,55
NPL,Nepal,TUR,Turkey,2010,3,0,3
NPL,Nepal,TUR,Turkey,2016,397,59,338
NPL,Nepal,TUR,Turkey,2017,1228,239,989
NPL,Nepal,GBR,United Kingdom,2008,4000,0,4000
NPL,Nepal,GBR,United Kingdom,2009,8000,0,8000
NPL,Nepal,GBR,United Kingdom,2010,6000,0,6000
NPL,Nepal,GBR,United Kingdom,2011,5000,1000,4000
NPL,Nepal,GBR,United Kingdom,2012,2000,1000,1000
NPL,Nepal,GBR,United Kingdom,2013,1000,0,1000
NPL,Nepal,GBR,United Kingdom,2014,1000,0,1000
NPL,Nepal,GBR,United Kingdom,2015,2000,1000,1000
NPL,Nepal,USA,United States,2008,4093,0,4093
NPL,Nepal,USA,United States,2009,4514,0,4514
NPL,Nepal,USA,United States,2010,7115,0,7115
NPL,Nepal,USA,United States,2011,10166,0,10166
NPL,Nepal,USA,United States,2012,11312,0,11312
NPL,Nepal,USA,United States,2013,13046,0,13046
NPL,Nepal,USA,United States,2014,12357,0,12357
NPL,Nepal,USA,United States,2015,12926,0,12926
NPL,Nepal,USA,United States,2016,12851,0,12851
NPL,Nepal,USA,United States,2017,11610,0,11610
NPL,Nepal,CHL,Chile,2008,6,0,6
NPL,Nepal,CHL,Chile,2009,8,0,8
NPL,Nepal,CHL,Chile,2010,6,0,6
NPL,Nepal,CHL,Chile,2011,5,0,5
NPL,Nepal,CHL,Chile,2012,27,0,27
NPL,Nepal,CHL,Chile,2013,8,0,8
NPL,Nepal,CHL,Chile,2014,4,0,4
NPL,Nepal,CHL,Chile,2015,6,0,6
NPL,Nepal,CHL,Chile,2016,61,0,61
NPL,Nepal,EST,Estonia,2008,0,0,0
NPL,Nepal,EST,Estonia,2009,0,0,0
NPL,Nepal,EST,Estonia,2010,3,0,3
NPL,Nepal,EST,Estonia,2011,1,0,1
NPL,Nepal,EST,Estonia,2012,3,0,3
NPL,Nepal,EST,Estonia,2013,6,0,6
NPL,Nepal,EST,Estonia,2014,7,0,7
NPL,Nepal,EST,Estonia,2015,15,0,15
NPL,Nepal,EST,Estonia,2016,13,0,13
NPL,Nepal,EST,Estonia,2017,39,0,39
NPL,Nepal,SVN,Slovenia,2009,1,0,1
NPL,Nepal,SVN,Slovenia,2010,3,0,3
NPL,Nepal,SVN,Slovenia,2011,2,0,2
NPL,Nepal,SVN,Slovenia,2012,2,0,2
NPL,Nepal,SVN,Slovenia,2014,1,0,1
NPL,Nepal,SVN,Slovenia,2015,3,0,3
NPL,Nepal,SVN,Slovenia,2016,5,0,5
NPL,Nepal,SVN,Slovenia,2017,8,1,7
NLD,Netherlands,AUS,Australia,2008,963,805,158
NLD,Netherlands,AUS,Australia,2009,978,755,223
NLD,Netherlands,AUS,Australia,2010,832,806,26
NLD,Netherlands,AUS,Australia,2011,730,784,-54
NLD,Netherlands,AUS,Australia,2012,805,758,47
NLD,Netherlands,AUS,Australia,2013,855,768,87
NLD,Netherlands,AUS,Australia,2014,731,871,-140
NLD,Netherlands,AUS,Australia,2015,684,1015,-331
NLD,Netherlands,AUS,Australia,2016,575,1113,-538
NLD,Netherlands,AUS,Australia,2017,607,1174,-567
NLD,Netherlands,AUT,Austria,2008,850,478,372
NLD,Netherlands,AUT,Austria,2009,745,402,343
NLD,Netherlands,AUT,Austria,2010,860,490,370
NLD,Netherlands,AUT,Austria,2011,853,527,326
NLD,Netherlands,AUT,Austria,2012,868,458,410
NLD,Netherlands,AUT,Austria,2013,925,489,436
NLD,Netherlands,AUT,Austria,2014,894,659,235
NLD,Netherlands,AUT,Austria,2015,975,609,366
NLD,Netherlands,AUT,Austria,2016,1033,712,321
NLD,Netherlands,AUT,Austria,2017,1008,801,207
NLD,Netherlands,BEL,Belgium,2008,11702,2054,9648
NLD,Netherlands,BEL,Belgium,2009,8774,1969,6805
NLD,Netherlands,BEL,Belgium,2010,9322,2075,7247
NLD,Netherlands,BEL,Belgium,2011,9510,2274,7236
NLD,Netherlands,BEL,Belgium,2012,9079,2568,6511
NLD,Netherlands,BEL,Belgium,2013,8967,2523,6444
NLD,Netherlands,BEL,Belgium,2014,8066,2709,5357
NLD,Netherlands,BEL,Belgium,2015,8125,2731,5394
NLD,Netherlands,BEL,Belgium,2016,7541,3247,4294
NLD,Netherlands,BEL,Belgium,2017,7696,3490,4206
NLD,Netherlands,CAN,Canada,2008,818,809,9
NLD,Netherlands,CAN,Canada,2009,786,755,31
NLD,Netherlands,CAN,Canada,2010,759,806,-47
NLD,Netherlands,CAN,Canada,2011,585,824,-239
NLD,Netherlands,CAN,Canada,2012,502,912,-410
NLD,Netherlands,CAN,Canada,2013,395,965,-570
NLD,Netherlands,CAN,Canada,2014,422,963,-541
NLD,Netherlands,CAN,Canada,2015,532,1085,-553
NLD,Netherlands,CAN,Canada,2016,515,1137,-622
NLD,Netherlands,CAN,Canada,2017,495,1263,-768
NLD,Netherlands,CZE,Czech Republic,2008,390,660,-270
NLD,Netherlands,CZE,Czech Republic,2009,183,596,-413
NLD,Netherlands,CZE,Czech Republic,2010,153,701,-548
NLD,Netherlands,CZE,Czech Republic,2011,128,647,-519
NLD,Netherlands,CZE,Czech Republic,2012,110,616,-506
NLD,Netherlands,CZE,Czech Republic,2013,137,722,-585
NLD,Netherlands,CZE,Czech Republic,2014,126,816,-690
NLD,Netherlands,CZE,Czech Republic,2015,116,747,-631
NLD,Netherlands,CZE,Czech Republic,2016,137,777,-640
NLD,Netherlands,CZE,Czech Republic,2017,126,854,-728
NLD,Netherlands,DNK,Denmark,2008,398,415,-17
NLD,Netherlands,DNK,Denmark,2009,347,328,19
NLD,Netherlands,DNK,Denmark,2010,391,394,-3
NLD,Netherlands,DNK,Denmark,2011,441,441,0
NLD,Netherlands,DNK,Denmark,2012,415,481,-66
NLD,Netherlands,DNK,Denmark,2013,463,480,-17
NLD,Netherlands,DNK,Denmark,2014,523,522,1
NLD,Netherlands,DNK,Denmark,2015,663,507,156
NLD,Netherlands,DNK,Denmark,2016,598,666,-68
NLD,Netherlands,DNK,Denmark,2017,625,704,-79
NLD,Netherlands,FIN,Finland,2008,124,471,-347
NLD,Netherlands,FIN,Finland,2009,73,475,-402
NLD,Netherlands,FIN,Finland,2010,83,541,-458
NLD,Netherlands,FIN,Finland,2011,80,651,-571
NLD,Netherlands,FIN,Finland,2012,91,665,-574
NLD,Netherlands,FIN,Finland,2013,74,592,-518
NLD,Netherlands,FIN,Finland,2014,112,688,-576
NLD,Netherlands,FIN,Finland,2015,109,832,-723
NLD,Netherlands,FIN,Finland,2016,104,1044,-940
NLD,Netherlands,FIN,Finland,2017,103,1117,-1014
NLD,Netherlands,FRA,France,2008,0,3029,-3029
NLD,Netherlands,FRA,France,2009,0,2872,-2872
NLD,Netherlands,FRA,France,2010,0,2928,-2928
NLD,Netherlands,FRA,France,2011,0,2930,-2930
NLD,Netherlands,FRA,France,2012,0,2980,-2980
NLD,Netherlands,FRA,France,2013,2678,3166,-488
NLD,Netherlands,FRA,France,2014,2063,3644,-1581
NLD,Netherlands,FRA,France,2015,2142,4038,-1896
NLD,Netherlands,FRA,France,2016,1858,4522,-2664
NLD,Netherlands,FRA,France,2017,1662,4981,-3319
NLD,Netherlands,DEU,Germany,2008,11203,9010,2193
NLD,Netherlands,DEU,Germany,2009,9441,8714,727
NLD,Netherlands,DEU,Germany,2010,9143,9812,-669
NLD,Netherlands,DEU,Germany,2011,9287,9604,-317
NLD,Netherlands,DEU,Germany,2012,9164,8730,434
NLD,Netherlands,DEU,Germany,2013,10037,8056,1981
NLD,Netherlands,DEU,Germany,2014,10197,8191,2006
NLD,Netherlands,DEU,Germany,2015,10512,8622,1890
NLD,Netherlands,DEU,Germany,2016,10238,9449,789
NLD,Netherlands,DEU,Germany,2017,9605,10541,-936
NLD,Netherlands,HUN,Hungary,2008,320,1721,-1401
NLD,Netherlands,HUN,Hungary,2009,382,2190,-1808
NLD,Netherlands,HUN,Hungary,2010,328,2400,-2072
NLD,Netherlands,HUN,Hungary,2011,320,2590,-2270
NLD,Netherlands,HUN,Hungary,2012,313,3084,-2771
NLD,Netherlands,HUN,Hungary,2013,316,2913,-2597
NLD,Netherlands,HUN,Hungary,2014,361,2906,-2545
NLD,Netherlands,HUN,Hungary,2015,363,3040,-2677
NLD,Netherlands,HUN,Hungary,2016,328,2932,-2604
NLD,Netherlands,HUN,Hungary,2017,445,3226,-2781
NLD,Netherlands,ISL,Iceland,2008,37,119,-82
NLD,Netherlands,ISL,Iceland,2009,43,90,-47
NLD,Netherlands,ISL,Iceland,2010,30,84,-54
NLD,Netherlands,ISL,Iceland,2011,27,90,-63
NLD,Netherlands,ISL,Iceland,2012,13,93,-80
NLD,Netherlands,ISL,Iceland,2013,19,85,-66
NLD,Netherlands,ISL,Iceland,2014,36,104,-68
NLD,Netherlands,ISL,Iceland,2015,31,127,-96
NLD,Netherlands,ISL,Iceland,2016,46,137,-91
NLD,Netherlands,ISL,Iceland,2017,51,134,-83
NLD,Netherlands,ITA,Italy,2008,706,2611,-1905
NLD,Netherlands,ITA,Italy,2009,530,2575,-2045
NLD,Netherlands,ITA,Italy,2010,491,2797,-2306
NLD,Netherlands,ITA,Italy,2011,437,3075,-2638
NLD,Netherlands,ITA,Italy,2012,415,3619,-3204
NLD,Netherlands,ITA,Italy,2013,441,4235,-3794
NLD,Netherlands,ITA,Italy,2014,388,5147,-4759
NLD,Netherlands,ITA,Italy,2015,455,5713,-5258
NLD,Netherlands,ITA,Italy,2016,476,6488,-6012
NLD,Netherlands,ITA,Italy,2017,492,7583,-7091
NLD,Netherlands,JPN,Japan,2008,1005,1207,-202
NLD,Netherlands,JPN,Japan,2009,941,1063,-122
NLD,Netherlands,JPN,Japan,2010,805,1018,-213
NLD,Netherlands,JPN,Japan,2011,727,1119,-392
NLD,Netherlands,JPN,Japan,2012,779,1102,-323
NLD,Netherlands,JPN,Japan,2013,920,1028,-108
NLD,Netherlands,JPN,Japan,2014,878,1137,-259
NLD,Netherlands,JPN,Japan,2015,1094,1228,-134
NLD,Netherlands,JPN,Japan,2016,1136,1522,-386
NLD,Netherlands,JPN,Japan,2017,1216,1362,-146
NLD,Netherlands,KOR,Korea,2008,160,535,-375
NLD,Netherlands,KOR,Korea,2009,129,533,-404
NLD,Netherlands,KOR,Korea,2010,146,665,-519
NLD,Netherlands,KOR,Korea,2011,284,818,-534
NLD,Netherlands,KOR,Korea,2012,254,743,-489
NLD,Netherlands,KOR,Korea,2013,268,845,-577
NLD,Netherlands,KOR,Korea,2014,327,968,-641
NLD,Netherlands,KOR,Korea,2015,371,1110,-739
NLD,Netherlands,KOR,Korea,2016,411,1344,-933
NLD,Netherlands,KOR,Korea,2017,403,1539,-1136
NLD,Netherlands,LUX,Luxembourg,2008,291,44,247
NLD,Netherlands,LUX,Luxembourg,2009,204,31,173
NLD,Netherlands,LUX,Luxembourg,2010,207,43,164
NLD,Netherlands,LUX,Luxembourg,2011,229,55,174
NLD,Netherlands,LUX,Luxembourg,2012,213,56,157
NLD,Netherlands,LUX,Luxembourg,2013,252,61,191
NLD,Netherlands,LUX,Luxembourg,2014,262,87,175
NLD,Netherlands,LUX,Luxembourg,2015,232,117,115
NLD,Netherlands,LUX,Luxembourg,2016,235,164,71
NLD,Netherlands,LUX,Luxembourg,2017,286,228,58
NLD,Netherlands,MEX,Mexico,2008,76,408,-332
NLD,Netherlands,MEX,Mexico,2009,103,391,-288
NLD,Netherlands,MEX,Mexico,2010,95,429,-334
NLD,Netherlands,MEX,Mexico,2011,108,441,-333
NLD,Netherlands,MEX,Mexico,2012,85,471,-386
NLD,Netherlands,MEX,Mexico,2013,301,510,-209
NLD,Netherlands,MEX,Mexico,2014,149,524,-375
NLD,Netherlands,MEX,Mexico,2015,98,638,-540
NLD,Netherlands,MEX,Mexico,2016,120,668,-548
NLD,Netherlands,MEX,Mexico,2017,81,762,-681
NLD,Netherlands,NZL,New Zealand,2008,456,215,241
NLD,Netherlands,NZL,New Zealand,2009,416,200,216
NLD,Netherlands,NZL,New Zealand,2010,393,232,161
NLD,Netherlands,NZL,New Zealand,2011,447,225,222
NLD,Netherlands,NZL,New Zealand,2012,437,218,219
NLD,Netherlands,NZL,New Zealand,2013,474,219,255
NLD,Netherlands,NZL,New Zealand,2014,483,252,231
NLD,Netherlands,NZL,New Zealand,2015,548,322,226
NLD,Netherlands,NZL,New Zealand,2016,680,321,359
NLD,Netherlands,NZL,New Zealand,2017,729,397,332
NLD,Netherlands,NOR,Norway,2008,908,310,598
NLD,Netherlands,NOR,Norway,2009,666,317,349
NLD,Netherlands,NOR,Norway,2010,710,403,307
NLD,Netherlands,NOR,Norway,2011,665,383,282
NLD,Netherlands,NOR,Norway,2012,594,360,234
NLD,Netherlands,NOR,Norway,2013,542,402,140
NLD,Netherlands,NOR,Norway,2014,632,416,216
NLD,Netherlands,NOR,Norway,2015,494,436,58
NLD,Netherlands,NOR,Norway,2016,462,545,-83
NLD,Netherlands,NOR,Norway,2017,483,594,-111
NLD,Netherlands,POL,Poland,2008,291,13277,-12986
NLD,Netherlands,POL,Poland,2009,273,12654,-12381
NLD,Netherlands,POL,Poland,2010,244,14477,-14233
NLD,Netherlands,POL,Poland,2011,241,18610,-18369
NLD,Netherlands,POL,Poland,2012,228,18332,-18104
NLD,Netherlands,POL,Poland,2013,246,20398,-20152
NLD,Netherlands,POL,Poland,2014,246,23773,-23527
NLD,Netherlands,POL,Poland,2015,246,22993,-22747
NLD,Netherlands,POL,Poland,2016,230,23129,-22899
NLD,Netherlands,POL,Poland,2017,233,23849,-23616
NLD,Netherlands,PRT,Portugal,2008,545,2385,-1840
NLD,Netherlands,PRT,Portugal,2009,540,2375,-1835
NLD,Netherlands,PRT,Portugal,2010,429,1958,-1529
NLD,Netherlands,PRT,Portugal,2011,432,2096,-1664
NLD,Netherlands,PRT,Portugal,2012,437,2470,-2033
NLD,Netherlands,PRT,Portugal,2013,475,2417,-1942
NLD,Netherlands,PRT,Portugal,2014,582,2291,-1709
NLD,Netherlands,PRT,Portugal,2015,834,2249,-1415
NLD,Netherlands,PRT,Portugal,2016,1165,2371,-1206
NLD,Netherlands,PRT,Portugal,2017,1345,2672,-1327
NLD,Netherlands,SVK,Slovak Republic,2008,65,996,-931
NLD,Netherlands,SVK,Slovak Republic,2009,44,766,-722
NLD,Netherlands,SVK,Slovak Republic,2010,37,1079,-1042
NLD,Netherlands,SVK,Slovak Republic,2011,28,1064,-1036
NLD,Netherlands,SVK,Slovak Republic,2012,12,987,-975
NLD,Netherlands,SVK,Slovak Republic,2013,15,905,-890
NLD,Netherlands,SVK,Slovak Republic,2014,16,1108,-1092
NLD,Netherlands,SVK,Slovak Republic,2015,17,1106,-1089
NLD,Netherlands,SVK,Slovak Republic,2016,18,1156,-1138
NLD,Netherlands,SVK,Slovak Republic,2017,17,1314,-1297
NLD,Netherlands,ESP,Spain,2008,3796,2279,1517
NLD,Netherlands,ESP,Spain,2009,2994,2631,363
NLD,Netherlands,ESP,Spain,2010,2987,3149,-162
NLD,Netherlands,ESP,Spain,2011,3153,3680,-527
NLD,Netherlands,ESP,Spain,2012,2887,4645,-1758
NLD,Netherlands,ESP,Spain,2013,2915,5256,-2341
NLD,Netherlands,ESP,Spain,2014,2973,5047,-2074
NLD,Netherlands,ESP,Spain,2015,3251,4957,-1706
NLD,Netherlands,ESP,Spain,2016,3703,5160,-1457
NLD,Netherlands,ESP,Spain,2017,4363,5851,-1488
NLD,Netherlands,SWE,Sweden,2008,1110,622,488
NLD,Netherlands,SWE,Sweden,2009,855,662,193
NLD,Netherlands,SWE,Sweden,2010,775,695,80
NLD,Netherlands,SWE,Sweden,2011,866,761,105
NLD,Netherlands,SWE,Sweden,2012,797,778,19
NLD,Netherlands,SWE,Sweden,2013,781,769,12
NLD,Netherlands,SWE,Sweden,2014,855,853,2
NLD,Netherlands,SWE,Sweden,2015,946,967,-21
NLD,Netherlands,SWE,Sweden,2016,991,950,41
NLD,Netherlands,SWE,Sweden,2017,1030,1019,11
NLD,Netherlands,CHE,Switzerland,2008,1973,288,1685
NLD,Netherlands,CHE,Switzerland,2009,1461,311,1150
NLD,Netherlands,CHE,Switzerland,2010,1607,364,1243
NLD,Netherlands,CHE,Switzerland,2011,1454,376,1078
NLD,Netherlands,CHE,Switzerland,2012,1396,363,1033
NLD,Netherlands,CHE,Switzerland,2013,1662,375,1287
NLD,Netherlands,CHE,Switzerland,2014,1627,430,1197
NLD,Netherlands,CHE,Switzerland,2015,1506,448,1058
NLD,Netherlands,CHE,Switzerland,2016,1616,539,1077
NLD,Netherlands,CHE,Switzerland,2017,1380,633,747
NLD,Netherlands,TUR,Turkey,2010,277,3712,-3435
NLD,Netherlands,TUR,Turkey,2016,861,3247,-2386
NLD,Netherlands,TUR,Turkey,2017,727,4444,-3717
NLD,Netherlands,GBR,United Kingdom,2011,1000,4434,-3434
NLD,Netherlands,GBR,United Kingdom,2012,3000,4704,-1704
NLD,Netherlands,GBR,United Kingdom,2013,4000,5122,-1122
NLD,Netherlands,GBR,United Kingdom,2014,5000,5265,-265
NLD,Netherlands,GBR,United Kingdom,2015,8000,5766,2234
NLD,Netherlands,GBR,United Kingdom,2016,6000,6521,-521
NLD,Netherlands,GBR,United Kingdom,2017,7000,7164,-164
NLD,Netherlands,USA,United States,2008,1240,3437,-2197
NLD,Netherlands,USA,United States,2009,1499,3091,-1592
NLD,Netherlands,USA,United States,2010,1321,3325,-2004
NLD,Netherlands,USA,United States,2011,1085,3749,-2664
NLD,Netherlands,USA,United States,2012,1091,3715,-2624
NLD,Netherlands,USA,United States,2013,1142,3596,-2454
NLD,Netherlands,USA,United States,2014,1195,3821,-2626
NLD,Netherlands,USA,United States,2015,1309,4653,-3344
NLD,Netherlands,USA,United States,2016,1319,4705,-3386
NLD,Netherlands,USA,United States,2017,1056,5573,-4517
NLD,Netherlands,CHL,Chile,2008,71,93,-22
NLD,Netherlands,CHL,Chile,2009,69,122,-53
NLD,Netherlands,CHL,Chile,2010,67,100,-33
NLD,Netherlands,CHL,Chile,2011,53,147,-94
NLD,Netherlands,CHL,Chile,2012,85,147,-62
NLD,Netherlands,CHL,Chile,2013,76,132,-56
NLD,Netherlands,CHL,Chile,2014,80,161,-81
NLD,Netherlands,CHL,Chile,2015,75,205,-130
NLD,Netherlands,CHL,Chile,2016,54,252,-198
NLD,Netherlands,EST,Estonia,2008,15,132,-117
NLD,Netherlands,EST,Estonia,2009,20,168,-148
NLD,Netherlands,EST,Estonia,2010,12,312,-300
NLD,Netherlands,EST,Estonia,2011,0,349,-349
NLD,Netherlands,EST,Estonia,2012,2,297,-295
NLD,Netherlands,EST,Estonia,2013,2,284,-282
NLD,Netherlands,EST,Estonia,2014,0,301,-301
NLD,Netherlands,EST,Estonia,2015,51,213,-162
NLD,Netherlands,EST,Estonia,2016,67,253,-186
NLD,Netherlands,EST,Estonia,2017,66,287,-221
NLD,Netherlands,ISR,Israel,2008,30,264,-234
NLD,Netherlands,ISR,Israel,2009,51,204,-153
NLD,Netherlands,ISR,Israel,2010,36,172,-136
NLD,Netherlands,ISR,Israel,2011,40,222,-182
NLD,Netherlands,ISR,Israel,2012,36,235,-199
NLD,Netherlands,ISR,Israel,2013,55,215,-160
NLD,Netherlands,ISR,Israel,2014,49,266,-217
NLD,Netherlands,ISR,Israel,2015,55,341,-286
NLD,Netherlands,ISR,Israel,2016,72,260,-188
NLD,Netherlands,ISR,Israel,2017,50,314,-264
NLD,Netherlands,SVN,Slovenia,2008,1,0,1
NLD,Netherlands,SVN,Slovenia,2009,34,160,-126
NLD,Netherlands,SVN,Slovenia,2010,2,187,-185
NLD,Netherlands,SVN,Slovenia,2011,26,170,-144
NLD,Netherlands,SVN,Slovenia,2012,48,208,-160
NLD,Netherlands,SVN,Slovenia,2013,42,249,-207
NLD,Netherlands,SVN,Slovenia,2014,49,343,-294
NLD,Netherlands,SVN,Slovenia,2015,39,285,-246
NLD,Netherlands,SVN,Slovenia,2016,60,320,-260
NLD,Netherlands,SVN,Slovenia,2017,85,320,-235
NZL,New Zealand,AUS,Australia,2008,34494,4282,30212
NZL,New Zealand,AUS,Australia,2009,33034,3886,29148
NZL,New Zealand,AUS,Australia,2010,24447,4143,20304
NZL,New Zealand,AUS,Australia,2011,34567,3697,30870
NZL,New Zealand,AUS,Australia,2012,44311,3580,40731
NZL,New Zealand,AUS,Australia,2013,41230,4417,36813
NZL,New Zealand,AUS,Australia,2014,27274,4894,22380
NZL,New Zealand,AUS,Australia,2015,22432,5546,16886
NZL,New Zealand,AUS,Australia,2016,19661,6033,13628
NZL,New Zealand,AUS,Australia,2017,12552,6449,6103
NZL,New Zealand,AUT,Austria,2008,57,70,-13
NZL,New Zealand,AUT,Austria,2009,41,61,-20
NZL,New Zealand,AUT,Austria,2010,60,85,-25
NZL,New Zealand,AUT,Austria,2011,41,62,-21
NZL,New Zealand,AUT,Austria,2012,61,77,-16
NZL,New Zealand,AUT,Austria,2013,55,52,3
NZL,New Zealand,AUT,Austria,2014,53,52,1
NZL,New Zealand,AUT,Austria,2015,55,56,-1
NZL,New Zealand,AUT,Austria,2016,42,71,-29
NZL,New Zealand,AUT,Austria,2017,53,71,-18
NZL,New Zealand,BEL,Belgium,2008,71,115,-44
NZL,New Zealand,BEL,Belgium,2009,56,131,-75
NZL,New Zealand,BEL,Belgium,2010,57,140,-83
NZL,New Zealand,BEL,Belgium,2012,64,132,-68
NZL,New Zealand,BEL,Belgium,2013,51,176,-125
NZL,New Zealand,BEL,Belgium,2014,34,236,-202
NZL,New Zealand,BEL,Belgium,2015,30,285,-255
NZL,New Zealand,BEL,Belgium,2016,35,378,-343
NZL,New Zealand,BEL,Belgium,2017,42,398,-356
NZL,New Zealand,CAN,Canada,2008,480,1090,-610
NZL,New Zealand,CAN,Canada,2009,520,1008,-488
NZL,New Zealand,CAN,Canada,2010,489,1046,-557
NZL,New Zealand,CAN,Canada,2011,375,1105,-730
NZL,New Zealand,CAN,Canada,2012,417,1072,-655
NZL,New Zealand,CAN,Canada,2013,415,1116,-701
NZL,New Zealand,CAN,Canada,2014,396,1271,-875
NZL,New Zealand,CAN,Canada,2015,331,1548,-1217
NZL,New Zealand,CAN,Canada,2016,500,1680,-1180
NZL,New Zealand,CAN,Canada,2017,405,1783,-1378
NZL,New Zealand,CZE,Czech Republic,2008,28,315,-287
NZL,New Zealand,CZE,Czech Republic,2009,22,323,-301
NZL,New Zealand,CZE,Czech Republic,2010,23,448,-425
NZL,New Zealand,CZE,Czech Republic,2011,14,659,-645
NZL,New Zealand,CZE,Czech Republic,2012,12,783,-771
NZL,New Zealand,CZE,Czech Republic,2013,23,683,-660
NZL,New Zealand,CZE,Czech Republic,2014,22,766,-744
NZL,New Zealand,CZE,Czech Republic,2015,18,737,-719
NZL,New Zealand,CZE,Czech Republic,2016,26,816,-790
NZL,New Zealand,CZE,Czech Republic,2017,39,788,-749
NZL,New Zealand,DNK,Denmark,2008,52,119,-67
NZL,New Zealand,DNK,Denmark,2009,37,107,-70
NZL,New Zealand,DNK,Denmark,2010,42,108,-66
NZL,New Zealand,DNK,Denmark,2011,64,121,-57
NZL,New Zealand,DNK,Denmark,2012,62,116,-54
NZL,New Zealand,DNK,Denmark,2013,65,108,-43
NZL,New Zealand,DNK,Denmark,2014,54,130,-76
NZL,New Zealand,DNK,Denmark,2015,64,134,-70
NZL,New Zealand,DNK,Denmark,2016,62,134,-72
NZL,New Zealand,DNK,Denmark,2017,80,181,-101
NZL,New Zealand,FIN,Finland,2008,16,110,-94
NZL,New Zealand,FIN,Finland,2009,15,106,-91
NZL,New Zealand,FIN,Finland,2010,7,111,-104
NZL,New Zealand,FIN,Finland,2011,17,114,-97
NZL,New Zealand,FIN,Finland,2012,8,107,-99
NZL,New Zealand,FIN,Finland,2013,12,112,-100
NZL,New Zealand,FIN,Finland,2014,16,100,-84
NZL,New Zealand,FIN,Finland,2015,24,126,-102
NZL,New Zealand,FIN,Finland,2016,15,190,-175
NZL,New Zealand,FIN,Finland,2017,15,221,-206
NZL,New Zealand,FRA,France,2008,122,1075,-953
NZL,New Zealand,FRA,France,2009,118,1422,-1304
NZL,New Zealand,FRA,France,2010,118,1429,-1311
NZL,New Zealand,FRA,France,2011,130,1860,-1730
NZL,New Zealand,FRA,France,2012,146,1883,-1737
NZL,New Zealand,FRA,France,2013,128,2718,-2590
NZL,New Zealand,FRA,France,2014,177,3787,-3610
NZL,New Zealand,FRA,France,2015,172,4481,-4309
NZL,New Zealand,FRA,France,2016,180,5028,-4848
NZL,New Zealand,FRA,France,2017,184,5263,-5079
NZL,New Zealand,DEU,Germany,2008,486,2611,-2125
NZL,New Zealand,DEU,Germany,2009,550,2588,-2038
NZL,New Zealand,DEU,Germany,2010,598,2400,-1802
NZL,New Zealand,DEU,Germany,2011,606,2722,-2116
NZL,New Zealand,DEU,Germany,2012,646,2606,-1960
NZL,New Zealand,DEU,Germany,2013,662,3338,-2676
NZL,New Zealand,DEU,Germany,2014,634,3685,-3051
NZL,New Zealand,DEU,Germany,2015,711,4009,-3298
NZL,New Zealand,DEU,Germany,2016,693,4610,-3917
NZL,New Zealand,DEU,Germany,2017,716,4496,-3780
NZL,New Zealand,HUN,Hungary,2008,24,63,-39
NZL,New Zealand,HUN,Hungary,2009,12,34,-22
NZL,New Zealand,HUN,Hungary,2010,11,30,-19
NZL,New Zealand,HUN,Hungary,2011,12,34,-22
NZL,New Zealand,HUN,Hungary,2012,22,60,-38
NZL,New Zealand,HUN,Hungary,2013,9,85,-76
NZL,New Zealand,HUN,Hungary,2014,18,84,-66
NZL,New Zealand,HUN,Hungary,2015,18,112,-94
NZL,New Zealand,HUN,Hungary,2016,14,147,-133
NZL,New Zealand,HUN,Hungary,2017,15,112,-97
NZL,New Zealand,ISL,Iceland,2008,6,6,0
NZL,New Zealand,ISL,Iceland,2009,5,14,-9
NZL,New Zealand,ISL,Iceland,2010,8,10,-2
NZL,New Zealand,ISL,Iceland,2011,5,15,-10
NZL,New Zealand,ISL,Iceland,2012,5,31,-26
NZL,New Zealand,ISL,Iceland,2013,4,15,-11
NZL,New Zealand,ISL,Iceland,2014,4,7,-3
NZL,New Zealand,ISL,Iceland,2015,4,3,1
NZL,New Zealand,ISL,Iceland,2016,10,1,9
NZL,New Zealand,ISL,Iceland,2017,9,10,-1
NZL,New Zealand,ITA,Italy,2008,47,199,-152
NZL,New Zealand,ITA,Italy,2009,36,213,-177
NZL,New Zealand,ITA,Italy,2010,54,243,-189
NZL,New Zealand,ITA,Italy,2011,28,369,-341
NZL,New Zealand,ITA,Italy,2012,41,463,-422
NZL,New Zealand,ITA,Italy,2013,28,761,-733
NZL,New Zealand,ITA,Italy,2014,26,949,-923
NZL,New Zealand,ITA,Italy,2015,27,1121,-1094
NZL,New Zealand,ITA,Italy,2016,25,1128,-1103
NZL,New Zealand,ITA,Italy,2017,39,1319,-1280
NZL,New Zealand,JPN,Japan,2008,882,2188,-1306
NZL,New Zealand,JPN,Japan,2009,780,1935,-1155
NZL,New Zealand,JPN,Japan,2010,739,1853,-1114
NZL,New Zealand,JPN,Japan,2011,759,1832,-1073
NZL,New Zealand,JPN,Japan,2012,682,1773,-1091
NZL,New Zealand,JPN,Japan,2013,798,1850,-1052
NZL,New Zealand,JPN,Japan,2014,722,2014,-1292
NZL,New Zealand,JPN,Japan,2015,775,2181,-1406
NZL,New Zealand,JPN,Japan,2016,855,2370,-1515
NZL,New Zealand,JPN,Japan,2017,970,2449,-1479
NZL,New Zealand,KOR,Korea,2008,736,1842,-1106
NZL,New Zealand,KOR,Korea,2009,745,2053,-1308
NZL,New Zealand,KOR,Korea,2010,756,1913,-1157
NZL,New Zealand,KOR,Korea,2011,898,1725,-827
NZL,New Zealand,KOR,Korea,2012,827,1565,-738
NZL,New Zealand,KOR,Korea,2013,761,1758,-997
NZL,New Zealand,KOR,Korea,2014,777,1689,-912
NZL,New Zealand,KOR,Korea,2015,630,1867,-1237
NZL,New Zealand,KOR,Korea,2016,610,2489,-1879
NZL,New Zealand,KOR,Korea,2017,620,2889,-2269
NZL,New Zealand,LUX,Luxembourg,2008,8,2,6
NZL,New Zealand,LUX,Luxembourg,2009,8,0,8
NZL,New Zealand,LUX,Luxembourg,2010,24,4,20
NZL,New Zealand,LUX,Luxembourg,2011,2,2,0
NZL,New Zealand,LUX,Luxembourg,2012,1,2,-1
NZL,New Zealand,LUX,Luxembourg,2013,7,2,5
NZL,New Zealand,LUX,Luxembourg,2014,5,0,5
NZL,New Zealand,LUX,Luxembourg,2015,11,3,8
NZL,New Zealand,LUX,Luxembourg,2016,5,2,3
NZL,New Zealand,LUX,Luxembourg,2017,12,11,1
NZL,New Zealand,MEX,Mexico,2008,4,72,-68
NZL,New Zealand,MEX,Mexico,2009,7,96,-89
NZL,New Zealand,MEX,Mexico,2010,8,125,-117
NZL,New Zealand,MEX,Mexico,2011,9,147,-138
NZL,New Zealand,MEX,Mexico,2012,1,189,-188
NZL,New Zealand,MEX,Mexico,2013,25,190,-165
NZL,New Zealand,MEX,Mexico,2014,19,210,-191
NZL,New Zealand,MEX,Mexico,2015,24,198,-174
NZL,New Zealand,MEX,Mexico,2016,16,194,-178
NZL,New Zealand,MEX,Mexico,2017,13,167,-154
NZL,New Zealand,NLD,Netherlands,2008,215,456,-241
NZL,New Zealand,NLD,Netherlands,2009,200,416,-216
NZL,New Zealand,NLD,Netherlands,2010,232,393,-161
NZL,New Zealand,NLD,Netherlands,2011,225,447,-222
NZL,New Zealand,NLD,Netherlands,2012,218,437,-219
NZL,New Zealand,NLD,Netherlands,2013,219,474,-255
NZL,New Zealand,NLD,Netherlands,2014,252,483,-231
NZL,New Zealand,NLD,Netherlands,2015,322,548,-226
NZL,New Zealand,NLD,Netherlands,2016,321,680,-359
NZL,New Zealand,NLD,Netherlands,2017,397,729,-332
NZL,New Zealand,NOR,Norway,2008,52,44,8
NZL,New Zealand,NOR,Norway,2009,53,62,-9
NZL,New Zealand,NOR,Norway,2010,44,64,-20
NZL,New Zealand,NOR,Norway,2011,53,69,-16
NZL,New Zealand,NOR,Norway,2012,48,105,-57
NZL,New Zealand,NOR,Norway,2013,39,84,-45
NZL,New Zealand,NOR,Norway,2014,55,102,-47
NZL,New Zealand,NOR,Norway,2015,36,113,-77
NZL,New Zealand,NOR,Norway,2016,28,92,-64
NZL,New Zealand,NOR,Norway,2017,49,113,-64
NZL,New Zealand,POL,Poland,2009,43,68,-25
NZL,New Zealand,POL,Poland,2010,39,90,-51
NZL,New Zealand,POL,Poland,2011,33,101,-68
NZL,New Zealand,POL,Poland,2012,36,77,-41
NZL,New Zealand,POL,Poland,2013,44,112,-68
NZL,New Zealand,POL,Poland,2014,11,139,-128
NZL,New Zealand,POL,Poland,2015,20,128,-108
NZL,New Zealand,POL,Poland,2016,20,147,-127
NZL,New Zealand,POL,Poland,2017,20,173,-153
NZL,New Zealand,SVK,Slovak Republic,2008,1,17,-16
NZL,New Zealand,SVK,Slovak Republic,2009,1,17,-16
NZL,New Zealand,SVK,Slovak Republic,2010,7,12,-5
NZL,New Zealand,SVK,Slovak Republic,2011,1,26,-25
NZL,New Zealand,SVK,Slovak Republic,2013,1,77,-76
NZL,New Zealand,SVK,Slovak Republic,2015,2,97,-95
NZL,New Zealand,SVK,Slovak Republic,2016,1,87,-86
NZL,New Zealand,SVK,Slovak Republic,2017,1,100,-99
NZL,New Zealand,ESP,Spain,2008,98,55,43
NZL,New Zealand,ESP,Spain,2009,53,65,-12
NZL,New Zealand,ESP,Spain,2010,84,92,-8
NZL,New Zealand,ESP,Spain,2011,103,178,-75
NZL,New Zealand,ESP,Spain,2012,111,144,-33
NZL,New Zealand,ESP,Spain,2013,109,238,-129
NZL,New Zealand,ESP,Spain,2014,81,224,-143
NZL,New Zealand,ESP,Spain,2015,101,209,-108
NZL,New Zealand,ESP,Spain,2016,137,229,-92
NZL,New Zealand,ESP,Spain,2017,144,264,-120
NZL,New Zealand,SWE,Sweden,2008,81,306,-225
NZL,New Zealand,SWE,Sweden,2009,85,275,-190
NZL,New Zealand,SWE,Sweden,2010,99,252,-153
NZL,New Zealand,SWE,Sweden,2011,71,315,-244
NZL,New Zealand,SWE,Sweden,2012,63,306,-243
NZL,New Zealand,SWE,Sweden,2013,72,337,-265
NZL,New Zealand,SWE,Sweden,2014,71,418,-347
NZL,New Zealand,SWE,Sweden,2015,53,449,-396
NZL,New Zealand,SWE,Sweden,2016,64,482,-418
NZL,New Zealand,SWE,Sweden,2017,83,475,-392
NZL,New Zealand,CHE,Switzerland,2010,117,101,16
NZL,New Zealand,CHE,Switzerland,2011,119,81,38
NZL,New Zealand,CHE,Switzerland,2012,134,111,23
NZL,New Zealand,CHE,Switzerland,2013,118,149,-31
NZL,New Zealand,CHE,Switzerland,2014,95,140,-45
NZL,New Zealand,CHE,Switzerland,2015,96,124,-28
NZL,New Zealand,CHE,Switzerland,2016,85,164,-79
NZL,New Zealand,CHE,Switzerland,2017,80,155,-75
NZL,New Zealand,TUR,Turkey,2010,24,44,-20
NZL,New Zealand,GBR,United Kingdom,2008,8000,11617,-3617
NZL,New Zealand,GBR,United Kingdom,2009,5000,10082,-5082
NZL,New Zealand,GBR,United Kingdom,2010,4000,8877,-4877
NZL,New Zealand,GBR,United Kingdom,2011,5000,9536,-4536
NZL,New Zealand,GBR,United Kingdom,2012,5000,9334,-4334
NZL,New Zealand,GBR,United Kingdom,2013,3000,9763,-6763
NZL,New Zealand,GBR,United Kingdom,2014,6000,10188,-4188
NZL,New Zealand,GBR,United Kingdom,2015,6000,10264,-4264
NZL,New Zealand,GBR,United Kingdom,2016,6000,10843,-4843
NZL,New Zealand,GBR,United Kingdom,2017,12000,11363,637
NZL,New Zealand,USA,United States,2008,893,2294,-1401
NZL,New Zealand,USA,United States,2009,947,2320,-1373
NZL,New Zealand,USA,United States,2010,919,2267,-1348
NZL,New Zealand,USA,United States,2011,803,2506,-1703
NZL,New Zealand,USA,United States,2012,814,2533,-1719
NZL,New Zealand,USA,United States,2013,921,2810,-1889
NZL,New Zealand,USA,United States,2014,796,2856,-2060
NZL,New Zealand,USA,United States,2015,855,3192,-2337
NZL,New Zealand,USA,United States,2016,846,3268,-2422
NZL,New Zealand,USA,United States,2017,798,3922,-3124
NZL,New Zealand,CHL,Chile,2008,66,553,-487
NZL,New Zealand,CHL,Chile,2009,50,505,-455
NZL,New Zealand,CHL,Chile,2010,36,513,-477
NZL,New Zealand,CHL,Chile,2011,41,515,-474
NZL,New Zealand,CHL,Chile,2012,47,581,-534
NZL,New Zealand,CHL,Chile,2013,48,616,-568
NZL,New Zealand,CHL,Chile,2014,46,709,-663
NZL,New Zealand,CHL,Chile,2015,39,762,-723
NZL,New Zealand,CHL,Chile,2016,29,696,-667
NZL,New Zealand,EST,Estonia,2008,0,14,-14
NZL,New Zealand,EST,Estonia,2009,3,31,-28
NZL,New Zealand,EST,Estonia,2010,0,37,-37
NZL,New Zealand,EST,Estonia,2011,0,54,-54
NZL,New Zealand,EST,Estonia,2012,2,62,-60
NZL,New Zealand,EST,Estonia,2013,1,73,-72
NZL,New Zealand,EST,Estonia,2014,1,58,-57
NZL,New Zealand,EST,Estonia,2015,3,80,-77
NZL,New Zealand,EST,Estonia,2016,1,55,-54
NZL,New Zealand,EST,Estonia,2017,3,97,-94
NZL,New Zealand,SVN,Slovenia,2008,10,6,4
NZL,New Zealand,SVN,Slovenia,2009,3,5,-2
NZL,New Zealand,SVN,Slovenia,2010,5,19,-14
NZL,New Zealand,SVN,Slovenia,2011,5,49,-44
NZL,New Zealand,SVN,Slovenia,2012,1,46,-45
NZL,New Zealand,SVN,Slovenia,2013,2,45,-43
NZL,New Zealand,SVN,Slovenia,2014,2,59,-57
NZL,New Zealand,SVN,Slovenia,2015,3,58,-55
NZL,New Zealand,SVN,Slovenia,2016,1,56,-55
NZL,New Zealand,SVN,Slovenia,2017,1,78,-77
NIC,Nicaragua,AUS,Australia,2008,4,6,-2
NIC,Nicaragua,AUS,Australia,2009,5,0,5
NIC,Nicaragua,AUS,Australia,2010,4,0,4
NIC,Nicaragua,AUS,Australia,2011,5,10,-5
NIC,Nicaragua,AUS,Australia,2012,12,6,6
NIC,Nicaragua,AUS,Australia,2013,8,11,-3
NIC,Nicaragua,AUS,Australia,2014,8,9,-1
NIC,Nicaragua,AUS,Australia,2015,0,0,0
NIC,Nicaragua,AUS,Australia,2016,8,0,8
NIC,Nicaragua,AUS,Australia,2017,9,0,9
NIC,Nicaragua,AUT,Austria,2008,12,4,8
NIC,Nicaragua,AUT,Austria,2009,13,11,2
NIC,Nicaragua,AUT,Austria,2010,21,9,12
NIC,Nicaragua,AUT,Austria,2011,21,11,10
NIC,Nicaragua,AUT,Austria,2012,18,10,8
NIC,Nicaragua,AUT,Austria,2013,18,11,7
NIC,Nicaragua,AUT,Austria,2014,14,6,8
NIC,Nicaragua,AUT,Austria,2015,14,7,7
NIC,Nicaragua,AUT,Austria,2016,16,11,5
NIC,Nicaragua,AUT,Austria,2017,25,7,18
NIC,Nicaragua,BEL,Belgium,2008,12,0,12
NIC,Nicaragua,BEL,Belgium,2009,11,0,11
NIC,Nicaragua,BEL,Belgium,2010,34,4,30
NIC,Nicaragua,BEL,Belgium,2012,12,8,4
NIC,Nicaragua,BEL,Belgium,2013,20,11,9
NIC,Nicaragua,BEL,Belgium,2014,7,10,-3
NIC,Nicaragua,BEL,Belgium,2015,16,8,8
NIC,Nicaragua,BEL,Belgium,2016,18,9,9
NIC,Nicaragua,BEL,Belgium,2017,17,3,14
NIC,Nicaragua,CAN,Canada,2008,123,0,123
NIC,Nicaragua,CAN,Canada,2009,114,0,114
NIC,Nicaragua,CAN,Canada,2010,91,0,91
NIC,Nicaragua,CAN,Canada,2011,122,0,122
NIC,Nicaragua,CAN,Canada,2012,106,0,106
NIC,Nicaragua,CAN,Canada,2013,96,0,96
NIC,Nicaragua,CAN,Canada,2014,118,0,118
NIC,Nicaragua,CAN,Canada,2015,96,0,96
NIC,Nicaragua,CAN,Canada,2016,75,0,75
NIC,Nicaragua,CAN,Canada,2017,105,0,105
NIC,Nicaragua,CZE,Czech Republic,2008,2,0,2
NIC,Nicaragua,CZE,Czech Republic,2013,2,1,1
NIC,Nicaragua,CZE,Czech Republic,2014,3,2,1
NIC,Nicaragua,CZE,Czech Republic,2015,2,2,0
NIC,Nicaragua,CZE,Czech Republic,2016,1,0,1
NIC,Nicaragua,DNK,Denmark,2008,13,2,11
NIC,Nicaragua,DNK,Denmark,2009,5,4,1
NIC,Nicaragua,DNK,Denmark,2010,5,2,3
NIC,Nicaragua,DNK,Denmark,2011,5,0,5
NIC,Nicaragua,DNK,Denmark,2012,1,1,0
NIC,Nicaragua,DNK,Denmark,2013,7,1,6
NIC,Nicaragua,DNK,Denmark,2014,8,3,5
NIC,Nicaragua,DNK,Denmark,2015,6,1,5
NIC,Nicaragua,DNK,Denmark,2016,5,6,-1
NIC,Nicaragua,DNK,Denmark,2017,11,5,6
NIC,Nicaragua,FIN,Finland,2008,7,0,7
NIC,Nicaragua,FIN,Finland,2009,5,0,5
NIC,Nicaragua,FIN,Finland,2010,4,0,4
NIC,Nicaragua,FIN,Finland,2011,3,0,3
NIC,Nicaragua,FIN,Finland,2012,5,2,3
NIC,Nicaragua,FIN,Finland,2013,5,2,3
NIC,Nicaragua,FIN,Finland,2014,4,1,3
NIC,Nicaragua,FIN,Finland,2015,4,0,4
NIC,Nicaragua,FIN,Finland,2016,5,0,5
NIC,Nicaragua,FIN,Finland,2017,3,1,2
NIC,Nicaragua,FRA,France,2008,14,0,14
NIC,Nicaragua,FRA,France,2009,22,0,22
NIC,Nicaragua,FRA,France,2010,32,0,32
NIC,Nicaragua,FRA,France,2011,31,0,31
NIC,Nicaragua,FRA,France,2012,28,0,28
NIC,Nicaragua,FRA,France,2013,20,0,20
NIC,Nicaragua,FRA,France,2014,37,0,37
NIC,Nicaragua,FRA,France,2015,34,0,34
NIC,Nicaragua,FRA,France,2016,36,0,36
NIC,Nicaragua,FRA,France,2017,37,0,37
NIC,Nicaragua,DEU,Germany,2008,77,33,44
NIC,Nicaragua,DEU,Germany,2009,83,47,36
NIC,Nicaragua,DEU,Germany,2010,77,42,35
NIC,Nicaragua,DEU,Germany,2011,90,39,51
NIC,Nicaragua,DEU,Germany,2012,92,60,32
NIC,Nicaragua,DEU,Germany,2013,106,54,52
NIC,Nicaragua,DEU,Germany,2014,112,51,61
NIC,Nicaragua,DEU,Germany,2015,108,51,57
NIC,Nicaragua,DEU,Germany,2016,145,61,84
NIC,Nicaragua,DEU,Germany,2017,137,74,63
NIC,Nicaragua,HUN,Hungary,2008,0,0,0
NIC,Nicaragua,HUN,Hungary,2009,1,0,1
NIC,Nicaragua,HUN,Hungary,2010,0,0,0
NIC,Nicaragua,HUN,Hungary,2011,1,0,1
NIC,Nicaragua,HUN,Hungary,2012,1,0,1
NIC,Nicaragua,HUN,Hungary,2013,2,0,2
NIC,Nicaragua,HUN,Hungary,2014,0,0,0
NIC,Nicaragua,HUN,Hungary,2015,3,0,3
NIC,Nicaragua,HUN,Hungary,2016,1,0,1
NIC,Nicaragua,HUN,Hungary,2017,0,0,0
NIC,Nicaragua,ISL,Iceland,2008,1,2,-1
NIC,Nicaragua,ISL,Iceland,2009,1,1,0
NIC,Nicaragua,ISL,Iceland,2010,2,2,0
NIC,Nicaragua,ISL,Iceland,2011,2,1,1
NIC,Nicaragua,ISL,Iceland,2012,2,0,2
NIC,Nicaragua,ISL,Iceland,2013,2,0,2
NIC,Nicaragua,ISL,Iceland,2014,1,5,-4
NIC,Nicaragua,ISL,Iceland,2015,0,0,0
NIC,Nicaragua,ISL,Iceland,2016,0,0,0
NIC,Nicaragua,ISL,Iceland,2017,1,0,1
NIC,Nicaragua,ITA,Italy,2008,62,0,62
NIC,Nicaragua,ITA,Italy,2009,70,0,70
NIC,Nicaragua,ITA,Italy,2010,75,5,70
NIC,Nicaragua,ITA,Italy,2011,76,8,68
NIC,Nicaragua,ITA,Italy,2012,66,5,61
NIC,Nicaragua,ITA,Italy,2013,53,5,48
NIC,Nicaragua,ITA,Italy,2014,44,8,36
NIC,Nicaragua,ITA,Italy,2015,43,3,40
NIC,Nicaragua,ITA,Italy,2016,48,0,48
NIC,Nicaragua,ITA,Italy,2017,39,4,35
NIC,Nicaragua,JPN,Japan,2008,88,83,5
NIC,Nicaragua,JPN,Japan,2009,95,90,5
NIC,Nicaragua,JPN,Japan,2010,77,81,-4
NIC,Nicaragua,JPN,Japan,2011,75,75,0
NIC,Nicaragua,JPN,Japan,2012,101,98,3
NIC,Nicaragua,JPN,Japan,2013,112,105,7
NIC,Nicaragua,JPN,Japan,2014,124,120,4
NIC,Nicaragua,JPN,Japan,2015,92,79,13
NIC,Nicaragua,JPN,Japan,2016,97,99,-2
NIC,Nicaragua,JPN,Japan,2017,113,106,7
NIC,Nicaragua,KOR,Korea,2008,6,3,3
NIC,Nicaragua,KOR,Korea,2009,5,4,1
NIC,Nicaragua,KOR,Korea,2010,4,4,0
NIC,Nicaragua,KOR,Korea,2011,5,4,1
NIC,Nicaragua,KOR,Korea,2012,5,4,1
NIC,Nicaragua,KOR,Korea,2013,7,6,1
NIC,Nicaragua,KOR,Korea,2014,8,10,-2
NIC,Nicaragua,KOR,Korea,2015,6,4,2
NIC,Nicaragua,KOR,Korea,2016,16,8,8
NIC,Nicaragua,KOR,Korea,2017,9,9,0
NIC,Nicaragua,LUX,Luxembourg,2008,2,0,2
NIC,Nicaragua,LUX,Luxembourg,2009,1,0,1
NIC,Nicaragua,LUX,Luxembourg,2010,1,0,1
NIC,Nicaragua,LUX,Luxembourg,2011,0,1,-1
NIC,Nicaragua,LUX,Luxembourg,2012,3,0,3
NIC,Nicaragua,LUX,Luxembourg,2013,3,1,2
NIC,Nicaragua,LUX,Luxembourg,2014,4,2,2
NIC,Nicaragua,LUX,Luxembourg,2015,5,2,3
NIC,Nicaragua,LUX,Luxembourg,2016,2,2,0
NIC,Nicaragua,LUX,Luxembourg,2017,2,1,1
NIC,Nicaragua,MEX,Mexico,2008,175,0,175
NIC,Nicaragua,MEX,Mexico,2009,328,0,328
NIC,Nicaragua,MEX,Mexico,2010,350,0,350
NIC,Nicaragua,MEX,Mexico,2011,235,0,235
NIC,Nicaragua,MEX,Mexico,2012,119,0,119
NIC,Nicaragua,MEX,Mexico,2013,567,0,567
NIC,Nicaragua,MEX,Mexico,2014,456,0,456
NIC,Nicaragua,MEX,Mexico,2015,324,0,324
NIC,Nicaragua,MEX,Mexico,2016,304,0,304
NIC,Nicaragua,MEX,Mexico,2017,209,0,209
NIC,Nicaragua,NLD,Netherlands,2008,24,1,23
NIC,Nicaragua,NLD,Netherlands,2009,20,1,19
NIC,Nicaragua,NLD,Netherlands,2010,18,11,7
NIC,Nicaragua,NLD,Netherlands,2011,25,6,19
NIC,Nicaragua,NLD,Netherlands,2012,32,13,19
NIC,Nicaragua,NLD,Netherlands,2013,36,19,17
NIC,Nicaragua,NLD,Netherlands,2014,31,13,18
NIC,Nicaragua,NLD,Netherlands,2015,25,6,19
NIC,Nicaragua,NLD,Netherlands,2016,24,10,14
NIC,Nicaragua,NLD,Netherlands,2017,17,11,6
NIC,Nicaragua,NZL,New Zealand,2009,0,0,0
NIC,Nicaragua,NZL,New Zealand,2010,3,0,3
NIC,Nicaragua,NZL,New Zealand,2011,2,1,1
NIC,Nicaragua,NZL,New Zealand,2012,1,0,1
NIC,Nicaragua,NZL,New Zealand,2014,5,0,5
NIC,Nicaragua,NZL,New Zealand,2015,2,0,2
NIC,Nicaragua,NZL,New Zealand,2016,1,0,1
NIC,Nicaragua,NZL,New Zealand,2017,1,3,-2
NIC,Nicaragua,NOR,Norway,2008,11,4,7
NIC,Nicaragua,NOR,Norway,2009,15,4,11
NIC,Nicaragua,NOR,Norway,2010,11,10,1
NIC,Nicaragua,NOR,Norway,2011,11,8,3
NIC,Nicaragua,NOR,Norway,2012,12,3,9
NIC,Nicaragua,NOR,Norway,2013,12,7,5
NIC,Nicaragua,NOR,Norway,2014,12,2,10
NIC,Nicaragua,NOR,Norway,2015,10,5,5
NIC,Nicaragua,NOR,Norway,2016,11,3,8
NIC,Nicaragua,NOR,Norway,2017,8,1,7
NIC,Nicaragua,POL,Poland,2009,0,0,0
NIC,Nicaragua,POL,Poland,2010,2,0,2
NIC,Nicaragua,POL,Poland,2011,5,0,5
NIC,Nicaragua,POL,Poland,2012,3,0,3
NIC,Nicaragua,POL,Poland,2013,4,0,4
NIC,Nicaragua,POL,Poland,2014,1,0,1
NIC,Nicaragua,POL,Poland,2015,7,0,7
NIC,Nicaragua,POL,Poland,2016,3,0,3
NIC,Nicaragua,POL,Poland,2017,5,0,5
NIC,Nicaragua,SVK,Slovak Republic,2008,1,1,0
NIC,Nicaragua,SVK,Slovak Republic,2010,1,0,1
NIC,Nicaragua,SVK,Slovak Republic,2012,1,0,1
NIC,Nicaragua,ESP,Spain,2008,2893,445,2448
NIC,Nicaragua,ESP,Spain,2009,2354,659,1695
NIC,Nicaragua,ESP,Spain,2010,2966,713,2253
NIC,Nicaragua,ESP,Spain,2011,3590,933,2657
NIC,Nicaragua,ESP,Spain,2012,2768,1289,1479
NIC,Nicaragua,ESP,Spain,2013,2134,2185,-51
NIC,Nicaragua,ESP,Spain,2014,2693,1425,1268
NIC,Nicaragua,ESP,Spain,2015,3098,999,2099
NIC,Nicaragua,ESP,Spain,2016,4110,1098,3012
NIC,Nicaragua,ESP,Spain,2017,6172,1483,4689
NIC,Nicaragua,SWE,Sweden,2008,33,8,25
NIC,Nicaragua,SWE,Sweden,2009,37,1,36
NIC,Nicaragua,SWE,Sweden,2010,38,4,34
NIC,Nicaragua,SWE,Sweden,2011,52,14,38
NIC,Nicaragua,SWE,Sweden,2012,49,10,39
NIC,Nicaragua,SWE,Sweden,2013,30,6,24
NIC,Nicaragua,SWE,Sweden,2014,32,6,26
NIC,Nicaragua,SWE,Sweden,2015,37,10,27
NIC,Nicaragua,SWE,Sweden,2016,29,4,25
NIC,Nicaragua,SWE,Sweden,2017,38,4,34
NIC,Nicaragua,CHE,Switzerland,2010,39,9,30
NIC,Nicaragua,CHE,Switzerland,2011,20,3,17
NIC,Nicaragua,CHE,Switzerland,2012,36,11,25
NIC,Nicaragua,CHE,Switzerland,2013,19,11,8
NIC,Nicaragua,CHE,Switzerland,2014,21,10,11
NIC,Nicaragua,CHE,Switzerland,2015,34,6,28
NIC,Nicaragua,CHE,Switzerland,2016,34,8,26
NIC,Nicaragua,CHE,Switzerland,2017,39,6,33
NIC,Nicaragua,USA,United States,2008,3614,0,3614
NIC,Nicaragua,USA,United States,2009,4137,0,4137
NIC,Nicaragua,USA,United States,2010,3565,0,3565
NIC,Nicaragua,USA,United States,2011,3401,0,3401
NIC,Nicaragua,USA,United States,2012,3046,0,3046
NIC,Nicaragua,USA,United States,2013,3048,0,3048
NIC,Nicaragua,USA,United States,2014,2886,0,2886
NIC,Nicaragua,USA,United States,2015,3324,0,3324
NIC,Nicaragua,USA,United States,2016,3486,0,3486
NIC,Nicaragua,USA,United States,2017,3072,0,3072
NIC,Nicaragua,CHL,Chile,2008,40,0,40
NIC,Nicaragua,CHL,Chile,2009,58,0,58
NIC,Nicaragua,CHL,Chile,2010,37,0,37
NIC,Nicaragua,CHL,Chile,2011,45,0,45
NIC,Nicaragua,CHL,Chile,2012,47,0,47
NIC,Nicaragua,CHL,Chile,2013,40,0,40
NIC,Nicaragua,CHL,Chile,2014,39,0,39
NIC,Nicaragua,CHL,Chile,2015,63,0,63
NIC,Nicaragua,CHL,Chile,2016,44,0,44
NIC,Nicaragua,EST,Estonia,2008,0,0,0
NIC,Nicaragua,EST,Estonia,2009,1,0,1
NIC,Nicaragua,EST,Estonia,2010,0,0,0
NIC,Nicaragua,EST,Estonia,2011,0,0,0
NIC,Nicaragua,EST,Estonia,2012,0,0,0
NIC,Nicaragua,EST,Estonia,2013,0,0,0
NIC,Nicaragua,EST,Estonia,2014,0,0,0
NIC,Nicaragua,EST,Estonia,2015,1,0,1
NIC,Nicaragua,EST,Estonia,2016,0,0,0
NIC,Nicaragua,EST,Estonia,2017,2,0,2
NIC,Nicaragua,SVN,Slovenia,2008,3,0,3
NIC,Nicaragua,SVN,Slovenia,2009,3,0,3
NIC,Nicaragua,SVN,Slovenia,2015,1,0,1
NIC,Nicaragua,SVN,Slovenia,2017,2,0,2
NER,Niger,AUS,Australia,2008,2,0,2
NER,Niger,AUS,Australia,2009,2,0,2
NER,Niger,AUS,Australia,2010,0,0,0
NER,Niger,AUS,Australia,2011,2,0,2
NER,Niger,AUS,Australia,2012,0,0,0
NER,Niger,AUS,Australia,2013,4,0,4
NER,Niger,AUS,Australia,2014,0,0,0
NER,Niger,AUS,Australia,2015,0,0,0
NER,Niger,AUS,Australia,2017,3,0,3
NER,Niger,AUT,Austria,2008,5,4,1
NER,Niger,AUT,Austria,2009,8,1,7
NER,Niger,AUT,Austria,2010,8,2,6
NER,Niger,AUT,Austria,2011,7,8,-1
NER,Niger,AUT,Austria,2012,6,3,3
NER,Niger,AUT,Austria,2013,19,6,13
NER,Niger,AUT,Austria,2014,12,9,3
NER,Niger,AUT,Austria,2015,13,7,6
NER,Niger,AUT,Austria,2016,15,7,8
NER,Niger,AUT,Austria,2017,7,14,-7
NER,Niger,BEL,Belgium,2008,80,0,80
NER,Niger,BEL,Belgium,2009,139,0,139
NER,Niger,BEL,Belgium,2010,122,47,75
NER,Niger,BEL,Belgium,2011,121,0,121
NER,Niger,BEL,Belgium,2012,171,75,96
NER,Niger,BEL,Belgium,2013,143,111,32
NER,Niger,BEL,Belgium,2014,161,114,47
NER,Niger,BEL,Belgium,2015,139,77,62
NER,Niger,BEL,Belgium,2016,86,54,32
NER,Niger,BEL,Belgium,2017,99,51,48
NER,Niger,CAN,Canada,2008,75,0,75
NER,Niger,CAN,Canada,2009,82,0,82
NER,Niger,CAN,Canada,2010,80,0,80
NER,Niger,CAN,Canada,2011,90,0,90
NER,Niger,CAN,Canada,2012,95,0,95
NER,Niger,CAN,Canada,2013,105,0,105
NER,Niger,CAN,Canada,2014,62,0,62
NER,Niger,CAN,Canada,2015,77,0,77
NER,Niger,CAN,Canada,2016,85,0,85
NER,Niger,CAN,Canada,2017,60,0,60
NER,Niger,CZE,Czech Republic,2009,1,0,1
NER,Niger,CZE,Czech Republic,2014,1,1,0
NER,Niger,CZE,Czech Republic,2015,1,0,1
NER,Niger,DNK,Denmark,2008,0,1,-1
NER,Niger,DNK,Denmark,2009,2,0,2
NER,Niger,DNK,Denmark,2012,0,1,-1
NER,Niger,DNK,Denmark,2013,0,0,0
NER,Niger,DNK,Denmark,2014,1,1,0
NER,Niger,DNK,Denmark,2015,2,0,2
NER,Niger,DNK,Denmark,2016,1,1,0
NER,Niger,DNK,Denmark,2017,3,0,3
NER,Niger,FIN,Finland,2008,6,0,6
NER,Niger,FIN,Finland,2009,3,0,3
NER,Niger,FIN,Finland,2010,2,0,2
NER,Niger,FIN,Finland,2011,4,0,4
NER,Niger,FIN,Finland,2012,0,0,0
NER,Niger,FIN,Finland,2013,3,0,3
NER,Niger,FIN,Finland,2014,4,0,4
NER,Niger,FIN,Finland,2015,1,0,1
NER,Niger,FIN,Finland,2016,6,0,6
NER,Niger,FIN,Finland,2017,0,1,-1
NER,Niger,FRA,France,2008,174,0,174
NER,Niger,FRA,France,2009,147,0,147
NER,Niger,FRA,France,2010,166,0,166
NER,Niger,FRA,France,2011,139,0,139
NER,Niger,FRA,France,2012,151,0,151
NER,Niger,FRA,France,2013,162,0,162
NER,Niger,FRA,France,2014,173,0,173
NER,Niger,FRA,France,2015,106,0,106
NER,Niger,FRA,France,2016,99,0,99
NER,Niger,FRA,France,2017,110,0,110
NER,Niger,DEU,Germany,2008,68,66,2
NER,Niger,DEU,Germany,2009,81,84,-3
NER,Niger,DEU,Germany,2010,77,64,13
NER,Niger,DEU,Germany,2011,84,75,9
NER,Niger,DEU,Germany,2012,126,73,53
NER,Niger,DEU,Germany,2013,183,82,101
NER,Niger,DEU,Germany,2014,220,131,89
NER,Niger,DEU,Germany,2015,272,145,127
NER,Niger,DEU,Germany,2016,222,172,50
NER,Niger,DEU,Germany,2017,239,185,54
NER,Niger,HUN,Hungary,2008,0,0,0
NER,Niger,HUN,Hungary,2009,0,0,0
NER,Niger,HUN,Hungary,2010,1,0,1
NER,Niger,HUN,Hungary,2011,0,0,0
NER,Niger,HUN,Hungary,2012,1,0,1
NER,Niger,HUN,Hungary,2013,1,0,1
NER,Niger,HUN,Hungary,2014,1,0,1
NER,Niger,HUN,Hungary,2015,3,0,3
NER,Niger,HUN,Hungary,2016,0,0,0
NER,Niger,HUN,Hungary,2017,2,0,2
NER,Niger,ISL,Iceland,2008,0,0,0
NER,Niger,ISL,Iceland,2009,0,0,0
NER,Niger,ISL,Iceland,2010,1,1,0
NER,Niger,ISL,Iceland,2011,1,0,1
NER,Niger,ISL,Iceland,2012,0,0,0
NER,Niger,ISL,Iceland,2013,2,3,-1
NER,Niger,ISL,Iceland,2014,2,2,0
NER,Niger,ISL,Iceland,2015,0,0,0
NER,Niger,ISL,Iceland,2016,1,1,0
NER,Niger,ISL,Iceland,2017,1,1,0
NER,Niger,ITA,Italy,2008,70,5,65
NER,Niger,ITA,Italy,2009,61,5,56
NER,Niger,ITA,Italy,2010,80,3,77
NER,Niger,ITA,Italy,2011,64,3,61
NER,Niger,ITA,Italy,2012,387,2,385
NER,Niger,ITA,Italy,2013,252,15,237
NER,Niger,ITA,Italy,2014,69,12,57
NER,Niger,ITA,Italy,2015,130,4,126
NER,Niger,ITA,Italy,2016,194,0,194
NER,Niger,ITA,Italy,2017,360,9,351
NER,Niger,JPN,Japan,2008,72,72,0
NER,Niger,JPN,Japan,2009,58,54,4
NER,Niger,JPN,Japan,2010,22,23,-1
NER,Niger,JPN,Japan,2011,13,9,4
NER,Niger,JPN,Japan,2012,46,45,1
NER,Niger,JPN,Japan,2013,53,50,3
NER,Niger,JPN,Japan,2014,45,43,2
NER,Niger,JPN,Japan,2015,67,63,4
NER,Niger,JPN,Japan,2016,43,41,2
NER,Niger,JPN,Japan,2017,49,44,5
NER,Niger,KOR,Korea,2008,0,0,0
NER,Niger,KOR,Korea,2009,1,0,1
NER,Niger,KOR,Korea,2010,0,1,-1
NER,Niger,KOR,Korea,2011,2,0,2
NER,Niger,KOR,Korea,2012,0,0,0
NER,Niger,KOR,Korea,2013,1,1,0
NER,Niger,KOR,Korea,2014,0,0,0
NER,Niger,KOR,Korea,2015,0,3,-3
NER,Niger,KOR,Korea,2016,3,0,3
NER,Niger,KOR,Korea,2017,4,2,2
NER,Niger,LUX,Luxembourg,2008,1,0,1
NER,Niger,LUX,Luxembourg,2009,2,2,0
NER,Niger,LUX,Luxembourg,2010,1,1,0
NER,Niger,LUX,Luxembourg,2011,2,1,1
NER,Niger,LUX,Luxembourg,2012,0,0,0
NER,Niger,LUX,Luxembourg,2013,2,0,2
NER,Niger,LUX,Luxembourg,2014,3,2,1
NER,Niger,LUX,Luxembourg,2015,3,0,3
NER,Niger,LUX,Luxembourg,2016,2,0,2
NER,Niger,LUX,Luxembourg,2017,7,3,4
NER,Niger,MEX,Mexico,2008,3,0,3
NER,Niger,MEX,Mexico,2009,5,0,5
NER,Niger,MEX,Mexico,2012,0,0,0
NER,Niger,MEX,Mexico,2013,0,0,0
NER,Niger,MEX,Mexico,2014,0,0,0
NER,Niger,NLD,Netherlands,2008,13,0,13
NER,Niger,NLD,Netherlands,2009,12,3,9
NER,Niger,NLD,Netherlands,2010,15,9,6
NER,Niger,NLD,Netherlands,2011,3,2,1
NER,Niger,NLD,Netherlands,2012,2,8,-6
NER,Niger,NLD,Netherlands,2013,2,4,-2
NER,Niger,NLD,Netherlands,2014,7,2,5
NER,Niger,NLD,Netherlands,2015,5,4,1
NER,Niger,NLD,Netherlands,2016,4,2,2
NER,Niger,NLD,Netherlands,2017,7,4,3
NER,Niger,NOR,Norway,2008,3,0,3
NER,Niger,NOR,Norway,2009,3,0,3
NER,Niger,NOR,Norway,2010,3,0,3
NER,Niger,NOR,Norway,2011,3,1,2
NER,Niger,NOR,Norway,2012,4,0,4
NER,Niger,NOR,Norway,2013,0,0,0
NER,Niger,NOR,Norway,2014,1,2,-1
NER,Niger,NOR,Norway,2015,12,1,11
NER,Niger,NOR,Norway,2016,2,87,-85
NER,Niger,NOR,Norway,2017,2,0,2
NER,Niger,POL,Poland,2009,0,0,0
NER,Niger,POL,Poland,2010,1,0,1
NER,Niger,POL,Poland,2011,1,0,1
NER,Niger,POL,Poland,2012,1,0,1
NER,Niger,POL,Poland,2013,0,0,0
NER,Niger,POL,Poland,2014,0,0,0
NER,Niger,POL,Poland,2015,0,0,0
NER,Niger,POL,Poland,2016,1,0,1
NER,Niger,POL,Poland,2017,1,0,1
NER,Niger,SVK,Slovak Republic,2008,0,0,0
NER,Niger,ESP,Spain,2008,33,17,16
NER,Niger,ESP,Spain,2009,36,19,17
NER,Niger,ESP,Spain,2010,18,31,-13
NER,Niger,ESP,Spain,2011,24,10,14
NER,Niger,ESP,Spain,2012,23,15,8
NER,Niger,ESP,Spain,2013,37,8,29
NER,Niger,ESP,Spain,2014,35,14,21
NER,Niger,ESP,Spain,2015,30,4,26
NER,Niger,ESP,Spain,2016,36,14,22
NER,Niger,ESP,Spain,2017,20,20,0
NER,Niger,SWE,Sweden,2008,2,1,1
NER,Niger,SWE,Sweden,2009,3,0,3
NER,Niger,SWE,Sweden,2010,2,0,2
NER,Niger,SWE,Sweden,2011,0,0,0
NER,Niger,SWE,Sweden,2012,3,0,3
NER,Niger,SWE,Sweden,2013,2,0,2
NER,Niger,SWE,Sweden,2014,0,0,0
NER,Niger,SWE,Sweden,2015,2,1,1
NER,Niger,SWE,Sweden,2016,4,0,4
NER,Niger,SWE,Sweden,2017,8,0,8
NER,Niger,CHE,Switzerland,2010,11,2,9
NER,Niger,CHE,Switzerland,2011,11,2,9
NER,Niger,CHE,Switzerland,2012,6,5,1
NER,Niger,CHE,Switzerland,2013,7,3,4
NER,Niger,CHE,Switzerland,2014,4,4,0
NER,Niger,CHE,Switzerland,2015,9,1,8
NER,Niger,CHE,Switzerland,2016,5,5,0
NER,Niger,CHE,Switzerland,2017,5,2,3
NER,Niger,TUR,Turkey,2010,5,0,5
NER,Niger,USA,United States,2008,107,0,107
NER,Niger,USA,United States,2009,183,0,183
NER,Niger,USA,United States,2010,96,0,96
NER,Niger,USA,United States,2011,96,0,96
NER,Niger,USA,United States,2012,48,0,48
NER,Niger,USA,United States,2013,37,0,37
NER,Niger,USA,United States,2014,71,0,71
NER,Niger,USA,United States,2015,55,0,55
NER,Niger,USA,United States,2016,119,0,119
NER,Niger,USA,United States,2017,116,0,116
NER,Niger,CHL,Chile,2008,0,0,0
NER,Niger,CHL,Chile,2009,0,0,0
NER,Niger,CHL,Chile,2010,0,0,0
NER,Niger,CHL,Chile,2011,0,0,0
NER,Niger,CHL,Chile,2012,0,0,0
NER,Niger,CHL,Chile,2013,0,0,0
NER,Niger,CHL,Chile,2014,0,0,0
NER,Niger,CHL,Chile,2015,0,0,0
NER,Niger,CHL,Chile,2016,0,0,0
NER,Niger,EST,Estonia,2008,0,0,0
NER,Niger,EST,Estonia,2009,0,0,0
NER,Niger,EST,Estonia,2010,0,0,0
NER,Niger,EST,Estonia,2011,0,0,0
NER,Niger,EST,Estonia,2012,0,0,0
NER,Niger,EST,Estonia,2013,0,0,0
NER,Niger,EST,Estonia,2014,0,0,0
NER,Niger,EST,Estonia,2015,0,0,0
NER,Niger,EST,Estonia,2016,0,0,0
NER,Niger,EST,Estonia,2017,0,0,0
NGA,Nigeria,AUS,Australia,2008,250,32,218
NGA,Nigeria,AUS,Australia,2009,377,38,339
NGA,Nigeria,AUS,Australia,2010,429,29,400
NGA,Nigeria,AUS,Australia,2011,338,32,306
NGA,Nigeria,AUS,Australia,2012,400,46,354
NGA,Nigeria,AUS,Australia,2013,442,40,402
NGA,Nigeria,AUS,Australia,2014,496,38,458
NGA,Nigeria,AUS,Australia,2015,478,0,478
NGA,Nigeria,AUS,Australia,2016,621,0,621
NGA,Nigeria,AUS,Australia,2017,728,0,728
NGA,Nigeria,AUT,Austria,2008,769,840,-71
NGA,Nigeria,AUT,Austria,2009,941,967,-26
NGA,Nigeria,AUT,Austria,2010,784,1126,-342
NGA,Nigeria,AUT,Austria,2011,750,892,-142
NGA,Nigeria,AUT,Austria,2012,782,668,114
NGA,Nigeria,AUT,Austria,2013,1039,645,394
NGA,Nigeria,AUT,Austria,2014,1051,590,461
NGA,Nigeria,AUT,Austria,2015,1501,676,825
NGA,Nigeria,AUT,Austria,2016,1861,1147,714
NGA,Nigeria,AUT,Austria,2017,1345,1433,-88
NGA,Nigeria,BEL,Belgium,2008,336,0,336
NGA,Nigeria,BEL,Belgium,2009,377,0,377
NGA,Nigeria,BEL,Belgium,2010,461,71,390
NGA,Nigeria,BEL,Belgium,2011,414,0,414
NGA,Nigeria,BEL,Belgium,2012,501,201,300
NGA,Nigeria,BEL,Belgium,2013,479,281,198
NGA,Nigeria,BEL,Belgium,2014,397,219,178
NGA,Nigeria,BEL,Belgium,2015,396,204,192
NGA,Nigeria,BEL,Belgium,2016,367,141,226
NGA,Nigeria,BEL,Belgium,2017,375,104,271
NGA,Nigeria,CAN,Canada,2008,2108,0,2108
NGA,Nigeria,CAN,Canada,2009,3156,0,3156
NGA,Nigeria,CAN,Canada,2010,3906,0,3906
NGA,Nigeria,CAN,Canada,2011,3102,0,3102
NGA,Nigeria,CAN,Canada,2012,3441,0,3441
NGA,Nigeria,CAN,Canada,2013,4171,0,4171
NGA,Nigeria,CAN,Canada,2014,4160,0,4160
NGA,Nigeria,CAN,Canada,2015,4133,0,4133
NGA,Nigeria,CAN,Canada,2016,4425,0,4425
NGA,Nigeria,CAN,Canada,2017,5460,0,5460
NGA,Nigeria,CZE,Czech Republic,2008,87,1,86
NGA,Nigeria,CZE,Czech Republic,2009,64,1,63
NGA,Nigeria,CZE,Czech Republic,2010,52,2,50
NGA,Nigeria,CZE,Czech Republic,2011,24,1,23
NGA,Nigeria,CZE,Czech Republic,2012,37,9,28
NGA,Nigeria,CZE,Czech Republic,2013,38,43,-5
NGA,Nigeria,CZE,Czech Republic,2014,64,29,35
NGA,Nigeria,CZE,Czech Republic,2015,55,34,21
NGA,Nigeria,CZE,Czech Republic,2016,43,29,14
NGA,Nigeria,CZE,Czech Republic,2017,62,27,35
NGA,Nigeria,DNK,Denmark,2008,79,28,51
NGA,Nigeria,DNK,Denmark,2009,138,26,112
NGA,Nigeria,DNK,Denmark,2010,125,55,70
NGA,Nigeria,DNK,Denmark,2011,129,52,77
NGA,Nigeria,DNK,Denmark,2012,93,64,29
NGA,Nigeria,DNK,Denmark,2013,117,76,41
NGA,Nigeria,DNK,Denmark,2014,141,81,60
NGA,Nigeria,DNK,Denmark,2015,95,46,49
NGA,Nigeria,DNK,Denmark,2016,95,67,28
NGA,Nigeria,DNK,Denmark,2017,80,60,20
NGA,Nigeria,FIN,Finland,2008,263,19,244
NGA,Nigeria,FIN,Finland,2009,129,19,110
NGA,Nigeria,FIN,Finland,2010,180,17,163
NGA,Nigeria,FIN,Finland,2011,242,19,223
NGA,Nigeria,FIN,Finland,2012,200,29,171
NGA,Nigeria,FIN,Finland,2013,224,35,189
NGA,Nigeria,FIN,Finland,2014,297,26,271
NGA,Nigeria,FIN,Finland,2015,271,14,257
NGA,Nigeria,FIN,Finland,2016,286,27,259
NGA,Nigeria,FIN,Finland,2017,212,26,186
NGA,Nigeria,FRA,France,2008,582,0,582
NGA,Nigeria,FRA,France,2009,594,0,594
NGA,Nigeria,FRA,France,2010,653,0,653
NGA,Nigeria,FRA,France,2011,624,0,624
NGA,Nigeria,FRA,France,2012,788,0,788
NGA,Nigeria,FRA,France,2013,904,0,904
NGA,Nigeria,FRA,France,2014,960,0,960
NGA,Nigeria,FRA,France,2015,964,0,964
NGA,Nigeria,FRA,France,2016,1121,0,1121
NGA,Nigeria,FRA,France,2017,1180,0,1180
NGA,Nigeria,DEU,Germany,2008,1796,1560,236
NGA,Nigeria,DEU,Germany,2009,2159,1550,609
NGA,Nigeria,DEU,Germany,2010,2351,1359,992
NGA,Nigeria,DEU,Germany,2011,2611,1323,1288
NGA,Nigeria,DEU,Germany,2012,2748,1559,1189
NGA,Nigeria,DEU,Germany,2013,4151,1668,2483
NGA,Nigeria,DEU,Germany,2014,6516,1796,4720
NGA,Nigeria,DEU,Germany,2015,12135,2362,9773
NGA,Nigeria,DEU,Germany,2016,10007,3308,6699
NGA,Nigeria,DEU,Germany,2017,9651,4023,5628
NGA,Nigeria,HUN,Hungary,2008,225,36,189
NGA,Nigeria,HUN,Hungary,2009,206,24,182
NGA,Nigeria,HUN,Hungary,2010,181,36,145
NGA,Nigeria,HUN,Hungary,2011,239,22,217
NGA,Nigeria,HUN,Hungary,2012,302,26,276
NGA,Nigeria,HUN,Hungary,2013,234,59,175
NGA,Nigeria,HUN,Hungary,2014,241,70,171
NGA,Nigeria,HUN,Hungary,2015,235,80,155
NGA,Nigeria,HUN,Hungary,2016,177,110,67
NGA,Nigeria,HUN,Hungary,2017,310,230,80
NGA,Nigeria,ISL,Iceland,2008,10,5,5
NGA,Nigeria,ISL,Iceland,2009,3,7,-4
NGA,Nigeria,ISL,Iceland,2010,8,4,4
NGA,Nigeria,ISL,Iceland,2011,6,2,4
NGA,Nigeria,ISL,Iceland,2012,8,3,5
NGA,Nigeria,ISL,Iceland,2013,9,5,4
NGA,Nigeria,ISL,Iceland,2014,13,4,9
NGA,Nigeria,ISL,Iceland,2015,14,1,13
NGA,Nigeria,ISL,Iceland,2016,20,4,16
NGA,Nigeria,ISL,Iceland,2017,32,4,28
NGA,Nigeria,ITA,Italy,2008,3717,96,3621
NGA,Nigeria,ITA,Italy,2009,3998,115,3883
NGA,Nigeria,ITA,Italy,2010,4842,191,4651
NGA,Nigeria,ITA,Italy,2011,4487,162,4325
NGA,Nigeria,ITA,Italy,2012,6739,188,6551
NGA,Nigeria,ITA,Italy,2013,6310,229,6081
NGA,Nigeria,ITA,Italy,2014,5273,198,5075
NGA,Nigeria,ITA,Italy,2015,8882,281,8601
NGA,Nigeria,ITA,Italy,2016,14729,0,14729
NGA,Nigeria,ITA,Italy,2017,23338,350,22988
NGA,Nigeria,JPN,Japan,2008,359,300,59
NGA,Nigeria,JPN,Japan,2009,278,187,91
NGA,Nigeria,JPN,Japan,2010,253,174,79
NGA,Nigeria,JPN,Japan,2011,243,193,50
NGA,Nigeria,JPN,Japan,2012,466,387,79
NGA,Nigeria,JPN,Japan,2013,467,386,81
NGA,Nigeria,JPN,Japan,2014,313,227,86
NGA,Nigeria,JPN,Japan,2015,309,204,105
NGA,Nigeria,JPN,Japan,2016,425,294,131
NGA,Nigeria,JPN,Japan,2017,353,250,103
NGA,Nigeria,KOR,Korea,2008,353,413,-60
NGA,Nigeria,KOR,Korea,2009,332,373,-41
NGA,Nigeria,KOR,Korea,2010,277,350,-73
NGA,Nigeria,KOR,Korea,2011,375,424,-49
NGA,Nigeria,KOR,Korea,2012,437,411,26
NGA,Nigeria,KOR,Korea,2013,412,379,33
NGA,Nigeria,KOR,Korea,2014,495,276,219
NGA,Nigeria,KOR,Korea,2015,468,424,44
NGA,Nigeria,KOR,Korea,2016,472,342,130
NGA,Nigeria,KOR,Korea,2017,576,389,187
NGA,Nigeria,LUX,Luxembourg,2008,19,25,-6
NGA,Nigeria,LUX,Luxembourg,2009,22,7,15
NGA,Nigeria,LUX,Luxembourg,2010,27,12,15
NGA,Nigeria,LUX,Luxembourg,2011,19,9,10
NGA,Nigeria,LUX,Luxembourg,2012,25,4,21
NGA,Nigeria,LUX,Luxembourg,2013,52,8,44
NGA,Nigeria,LUX,Luxembourg,2014,36,32,4
NGA,Nigeria,LUX,Luxembourg,2015,28,27,1
NGA,Nigeria,LUX,Luxembourg,2016,40,22,18
NGA,Nigeria,LUX,Luxembourg,2017,31,28,3
NGA,Nigeria,MEX,Mexico,2008,8,0,8
NGA,Nigeria,MEX,Mexico,2009,16,0,16
NGA,Nigeria,MEX,Mexico,2010,61,0,61
NGA,Nigeria,MEX,Mexico,2011,68,0,68
NGA,Nigeria,MEX,Mexico,2012,82,0,82
NGA,Nigeria,MEX,Mexico,2013,90,0,90
NGA,Nigeria,MEX,Mexico,2014,100,0,100
NGA,Nigeria,MEX,Mexico,2015,81,0,81
NGA,Nigeria,MEX,Mexico,2016,139,0,139
NGA,Nigeria,MEX,Mexico,2017,111,0,111
NGA,Nigeria,NLD,Netherlands,2008,476,158,318
NGA,Nigeria,NLD,Netherlands,2009,539,234,305
NGA,Nigeria,NLD,Netherlands,2010,467,241,226
NGA,Nigeria,NLD,Netherlands,2011,432,221,211
NGA,Nigeria,NLD,Netherlands,2012,397,259,138
NGA,Nigeria,NLD,Netherlands,2013,438,262,176
NGA,Nigeria,NLD,Netherlands,2014,492,266,226
NGA,Nigeria,NLD,Netherlands,2015,438,254,184
NGA,Nigeria,NLD,Netherlands,2016,357,275,82
NGA,Nigeria,NLD,Netherlands,2017,450,260,190
NGA,Nigeria,NZL,New Zealand,2008,51,3,48
NGA,Nigeria,NZL,New Zealand,2009,42,1,41
NGA,Nigeria,NZL,New Zealand,2010,23,11,12
NGA,Nigeria,NZL,New Zealand,2011,36,10,26
NGA,Nigeria,NZL,New Zealand,2012,39,5,34
NGA,Nigeria,NZL,New Zealand,2013,34,11,23
NGA,Nigeria,NZL,New Zealand,2014,76,5,71
NGA,Nigeria,NZL,New Zealand,2015,77,6,71
NGA,Nigeria,NZL,New Zealand,2016,81,14,67
NGA,Nigeria,NZL,New Zealand,2017,96,13,83
NGA,Nigeria,NOR,Norway,2008,126,50,76
NGA,Nigeria,NOR,Norway,2009,144,35,109
NGA,Nigeria,NOR,Norway,2010,159,43,116
NGA,Nigeria,NOR,Norway,2011,206,85,121
NGA,Nigeria,NOR,Norway,2012,194,53,141
NGA,Nigeria,NOR,Norway,2013,215,65,150
NGA,Nigeria,NOR,Norway,2014,228,73,155
NGA,Nigeria,NOR,Norway,2015,151,98,53
NGA,Nigeria,NOR,Norway,2016,131,0,131
NGA,Nigeria,NOR,Norway,2017,135,77,58
NGA,Nigeria,POL,Poland,2008,631,0,631
NGA,Nigeria,POL,Poland,2009,651,0,651
NGA,Nigeria,POL,Poland,2010,624,0,624
NGA,Nigeria,POL,Poland,2011,542,0,542
NGA,Nigeria,POL,Poland,2012,505,0,505
NGA,Nigeria,POL,Poland,2013,431,0,431
NGA,Nigeria,POL,Poland,2014,195,0,195
NGA,Nigeria,POL,Poland,2015,338,0,338
NGA,Nigeria,POL,Poland,2016,278,0,278
NGA,Nigeria,POL,Poland,2017,303,0,303
NGA,Nigeria,SVK,Slovak Republic,2008,15,2,13
NGA,Nigeria,SVK,Slovak Republic,2009,7,1,6
NGA,Nigeria,SVK,Slovak Republic,2010,6,5,1
NGA,Nigeria,SVK,Slovak Republic,2011,11,3,8
NGA,Nigeria,SVK,Slovak Republic,2012,5,0,5
NGA,Nigeria,SVK,Slovak Republic,2013,5,1,4
NGA,Nigeria,SVK,Slovak Republic,2014,2,0,2
NGA,Nigeria,SVK,Slovak Republic,2015,3,0,3
NGA,Nigeria,SVK,Slovak Republic,2016,6,0,6
NGA,Nigeria,SVK,Slovak Republic,2017,1,0,1
NGA,Nigeria,ESP,Spain,2008,4907,2741,2166
NGA,Nigeria,ESP,Spain,2009,3034,3477,-443
NGA,Nigeria,ESP,Spain,2010,2511,3552,-1041
NGA,Nigeria,ESP,Spain,2011,2284,3943,-1659
NGA,Nigeria,ESP,Spain,2012,1894,3787,-1893
NGA,Nigeria,ESP,Spain,2013,1557,4172,-2615
NGA,Nigeria,ESP,Spain,2014,1361,2808,-1447
NGA,Nigeria,ESP,Spain,2015,1360,2074,-714
NGA,Nigeria,ESP,Spain,2016,1319,1938,-619
NGA,Nigeria,ESP,Spain,2017,1466,2113,-647
NGA,Nigeria,SWE,Sweden,2008,366,75,291
NGA,Nigeria,SWE,Sweden,2009,413,41,372
NGA,Nigeria,SWE,Sweden,2010,461,80,381
NGA,Nigeria,SWE,Sweden,2011,437,88,349
NGA,Nigeria,SWE,Sweden,2012,451,143,308
NGA,Nigeria,SWE,Sweden,2013,495,71,424
NGA,Nigeria,SWE,Sweden,2014,569,75,494
NGA,Nigeria,SWE,Sweden,2015,522,131,391
NGA,Nigeria,SWE,Sweden,2016,553,65,488
NGA,Nigeria,SWE,Sweden,2017,507,62,445
NGA,Nigeria,CHE,Switzerland,2010,192,77,115
NGA,Nigeria,CHE,Switzerland,2011,194,66,128
NGA,Nigeria,CHE,Switzerland,2012,198,79,119
NGA,Nigeria,CHE,Switzerland,2013,173,87,86
NGA,Nigeria,CHE,Switzerland,2014,166,83,83
NGA,Nigeria,CHE,Switzerland,2015,173,77,96
NGA,Nigeria,CHE,Switzerland,2016,146,68,78
NGA,Nigeria,CHE,Switzerland,2017,181,75,106
NGA,Nigeria,TUR,Turkey,2010,128,0,128
NGA,Nigeria,TUR,Turkey,2016,1583,483,1100
NGA,Nigeria,TUR,Turkey,2017,1734,614,1120
NGA,Nigeria,GBR,United Kingdom,2008,11000,0,11000
NGA,Nigeria,GBR,United Kingdom,2009,12000,0,12000
NGA,Nigeria,GBR,United Kingdom,2010,10000,0,10000
NGA,Nigeria,GBR,United Kingdom,2011,8000,1000,7000
NGA,Nigeria,GBR,United Kingdom,2012,9000,2000,7000
NGA,Nigeria,GBR,United Kingdom,2013,7000,2000,5000
NGA,Nigeria,GBR,United Kingdom,2014,7000,2000,5000
NGA,Nigeria,GBR,United Kingdom,2015,8000,2000,6000
NGA,Nigeria,GBR,United Kingdom,2016,6000,0,6000
NGA,Nigeria,GBR,United Kingdom,2017,10000,0,10000
NGA,Nigeria,USA,United States,2008,12475,0,12475
NGA,Nigeria,USA,United States,2009,15253,0,15253
NGA,Nigeria,USA,United States,2010,13376,0,13376
NGA,Nigeria,USA,United States,2011,11824,0,11824
NGA,Nigeria,USA,United States,2012,13575,0,13575
NGA,Nigeria,USA,United States,2013,13840,0,13840
NGA,Nigeria,USA,United States,2014,12828,0,12828
NGA,Nigeria,USA,United States,2015,11542,0,11542
NGA,Nigeria,USA,United States,2016,14380,0,14380
NGA,Nigeria,USA,United States,2017,13539,0,13539
NGA,Nigeria,CHL,Chile,2008,3,0,3
NGA,Nigeria,CHL,Chile,2009,2,0,2
NGA,Nigeria,CHL,Chile,2010,7,0,7
NGA,Nigeria,CHL,Chile,2011,4,0,4
NGA,Nigeria,CHL,Chile,2012,2,0,2
NGA,Nigeria,CHL,Chile,2013,5,0,5
NGA,Nigeria,CHL,Chile,2014,3,0,3
NGA,Nigeria,CHL,Chile,2015,6,0,6
NGA,Nigeria,CHL,Chile,2016,2,0,2
NGA,Nigeria,EST,Estonia,2008,1,0,1
NGA,Nigeria,EST,Estonia,2009,2,0,2
NGA,Nigeria,EST,Estonia,2010,1,0,1
NGA,Nigeria,EST,Estonia,2011,7,0,7
NGA,Nigeria,EST,Estonia,2012,7,0,7
NGA,Nigeria,EST,Estonia,2013,18,0,18
NGA,Nigeria,EST,Estonia,2014,3,0,3
NGA,Nigeria,EST,Estonia,2015,109,0,109
NGA,Nigeria,EST,Estonia,2016,103,0,103
NGA,Nigeria,EST,Estonia,2017,142,0,142
NGA,Nigeria,SVN,Slovenia,2008,8,0,8
NGA,Nigeria,SVN,Slovenia,2009,8,0,8
NGA,Nigeria,SVN,Slovenia,2010,7,0,7
NGA,Nigeria,SVN,Slovenia,2011,10,0,10
NGA,Nigeria,SVN,Slovenia,2013,4,0,4
NGA,Nigeria,SVN,Slovenia,2014,5,1,4
NGA,Nigeria,SVN,Slovenia,2015,10,0,10
NGA,Nigeria,SVN,Slovenia,2016,3,1,2
NGA,Nigeria,SVN,Slovenia,2017,21,1,20
NIU,Niue,AUS,Australia,2009,0,0,0
NIU,Niue,AUS,Australia,2010,0,0,0
NIU,Niue,AUS,Australia,2011,0,0,0
NIU,Niue,AUS,Australia,2012,0,0,0
NIU,Niue,AUS,Australia,2013,0,0,0
NIU,Niue,AUS,Australia,2014,0,0,0
NIU,Niue,AUS,Australia,2015,0,0,0
NIU,Niue,AUS,Australia,2016,0,0,0
NIU,Niue,AUS,Australia,2017,0,0,0
NIU,Niue,AUT,Austria,2014,0,0,0
NIU,Niue,AUT,Austria,2015,0,0,0
NIU,Niue,AUT,Austria,2016,0,0,0
NIU,Niue,AUT,Austria,2017,0,0,0
NIU,Niue,BEL,Belgium,2010,0,0,0
NIU,Niue,CAN,Canada,2008,0,0,0
NIU,Niue,CAN,Canada,2009,0,0,0
NIU,Niue,CAN,Canada,2010,0,0,0
NIU,Niue,CAN,Canada,2011,0,0,0
NIU,Niue,CAN,Canada,2012,0,0,0
NIU,Niue,CAN,Canada,2013,0,0,0
NIU,Niue,CAN,Canada,2014,0,0,0
NIU,Niue,CAN,Canada,2015,0,0,0
NIU,Niue,CAN,Canada,2016,0,0,0
NIU,Niue,CAN,Canada,2017,0,0,0
NIU,Niue,DNK,Denmark,2015,0,0,0
NIU,Niue,DNK,Denmark,2016,0,0,0
NIU,Niue,FIN,Finland,2008,0,0,0
NIU,Niue,FIN,Finland,2009,0,0,0
NIU,Niue,FIN,Finland,2010,0,0,0
NIU,Niue,FIN,Finland,2011,0,0,0
NIU,Niue,FIN,Finland,2012,0,0,0
NIU,Niue,FIN,Finland,2013,0,0,0
NIU,Niue,FIN,Finland,2014,0,0,0
NIU,Niue,FIN,Finland,2015,0,0,0
NIU,Niue,FIN,Finland,2016,0,0,0
NIU,Niue,FIN,Finland,2017,0,0,0
NIU,Niue,FRA,France,2008,0,0,0
NIU,Niue,FRA,France,2009,0,0,0
NIU,Niue,FRA,France,2010,0,0,0
NIU,Niue,FRA,France,2011,0,0,0
NIU,Niue,FRA,France,2012,0,0,0
NIU,Niue,FRA,France,2013,0,0,0
NIU,Niue,FRA,France,2014,0,0,0
NIU,Niue,FRA,France,2015,0,0,0
NIU,Niue,FRA,France,2016,0,0,0
NIU,Niue,FRA,France,2017,0,0,0
NIU,Niue,DEU,Germany,2008,0,0,0
NIU,Niue,DEU,Germany,2009,0,0,0
NIU,Niue,DEU,Germany,2010,0,0,0
NIU,Niue,DEU,Germany,2011,0,0,0
NIU,Niue,DEU,Germany,2012,0,0,0
NIU,Niue,DEU,Germany,2013,0,0,0
NIU,Niue,DEU,Germany,2014,0,0,0
NIU,Niue,DEU,Germany,2015,0,0,0
NIU,Niue,DEU,Germany,2016,0,0,0
NIU,Niue,DEU,Germany,2017,0,0,0
NIU,Niue,HUN,Hungary,2008,0,0,0
NIU,Niue,HUN,Hungary,2009,0,0,0
NIU,Niue,HUN,Hungary,2010,0,0,0
NIU,Niue,HUN,Hungary,2011,0,0,0
NIU,Niue,HUN,Hungary,2012,0,0,0
NIU,Niue,HUN,Hungary,2013,0,0,0
NIU,Niue,HUN,Hungary,2014,0,0,0
NIU,Niue,HUN,Hungary,2015,0,0,0
NIU,Niue,HUN,Hungary,2016,0,0,0
NIU,Niue,HUN,Hungary,2017,0,0,0
NIU,Niue,ISL,Iceland,2016,0,0,0
NIU,Niue,ISL,Iceland,2017,0,0,0
NIU,Niue,JPN,Japan,2008,0,0,0
NIU,Niue,JPN,Japan,2009,0,0,0
NIU,Niue,JPN,Japan,2010,0,0,0
NIU,Niue,JPN,Japan,2011,0,0,0
NIU,Niue,JPN,Japan,2012,0,0,0
NIU,Niue,JPN,Japan,2013,0,0,0
NIU,Niue,JPN,Japan,2014,0,0,0
NIU,Niue,JPN,Japan,2015,0,0,0
NIU,Niue,JPN,Japan,2016,0,0,0
NIU,Niue,JPN,Japan,2017,0,0,0
NIU,Niue,KOR,Korea,2008,0,0,0
NIU,Niue,KOR,Korea,2009,0,0,0
NIU,Niue,KOR,Korea,2010,0,0,0
NIU,Niue,KOR,Korea,2011,0,0,0
NIU,Niue,KOR,Korea,2012,0,0,0
NIU,Niue,KOR,Korea,2013,0,0,0
NIU,Niue,KOR,Korea,2014,0,0,0
NIU,Niue,KOR,Korea,2015,0,0,0
NIU,Niue,KOR,Korea,2016,0,0,0
NIU,Niue,KOR,Korea,2017,0,0,0
NIU,Niue,LUX,Luxembourg,2008,0,0,0
NIU,Niue,LUX,Luxembourg,2009,0,0,0
NIU,Niue,LUX,Luxembourg,2010,0,0,0
NIU,Niue,LUX,Luxembourg,2011,0,0,0
NIU,Niue,LUX,Luxembourg,2012,0,0,0
NIU,Niue,LUX,Luxembourg,2013,0,0,0
NIU,Niue,LUX,Luxembourg,2014,0,0,0
NIU,Niue,LUX,Luxembourg,2015,0,0,0
NIU,Niue,LUX,Luxembourg,2016,0,0,0
NIU,Niue,LUX,Luxembourg,2017,0,0,0
NIU,Niue,MEX,Mexico,2012,0,0,0
NIU,Niue,MEX,Mexico,2013,0,0,0
NIU,Niue,MEX,Mexico,2014,0,0,0
NIU,Niue,NOR,Norway,2008,0,0,0
NIU,Niue,NOR,Norway,2009,0,0,0
NIU,Niue,NOR,Norway,2010,0,0,0
NIU,Niue,NOR,Norway,2011,0,0,0
NIU,Niue,NOR,Norway,2012,0,0,0
NIU,Niue,NOR,Norway,2013,0,0,0
NIU,Niue,NOR,Norway,2014,0,0,0
NIU,Niue,NOR,Norway,2015,0,0,0
NIU,Niue,NOR,Norway,2016,0,0,0
NIU,Niue,NOR,Norway,2017,0,0,0
NIU,Niue,POL,Poland,2009,0,0,0
NIU,Niue,POL,Poland,2010,0,0,0
NIU,Niue,POL,Poland,2011,0,0,0
NIU,Niue,POL,Poland,2012,0,0,0
NIU,Niue,POL,Poland,2013,0,0,0
NIU,Niue,POL,Poland,2014,0,0,0
NIU,Niue,POL,Poland,2015,0,0,0
NIU,Niue,POL,Poland,2016,0,0,0
NIU,Niue,POL,Poland,2017,0,0,0
NIU,Niue,ESP,Spain,2008,0,0,0
NIU,Niue,ESP,Spain,2009,0,0,0
NIU,Niue,ESP,Spain,2010,0,0,0
NIU,Niue,ESP,Spain,2011,0,0,0
NIU,Niue,ESP,Spain,2012,0,0,0
NIU,Niue,ESP,Spain,2013,0,0,0
NIU,Niue,SWE,Sweden,2008,0,0,0
NIU,Niue,SWE,Sweden,2009,0,0,0
NIU,Niue,SWE,Sweden,2010,0,0,0
NIU,Niue,SWE,Sweden,2011,0,0,0
NIU,Niue,SWE,Sweden,2012,0,0,0
NIU,Niue,SWE,Sweden,2013,0,0,0
NIU,Niue,SWE,Sweden,2014,0,0,0
NIU,Niue,SWE,Sweden,2015,0,0,0
NIU,Niue,CHL,Chile,2008,0,0,0
NIU,Niue,CHL,Chile,2009,0,0,0
NIU,Niue,CHL,Chile,2010,0,0,0
NIU,Niue,CHL,Chile,2011,0,0,0
NIU,Niue,CHL,Chile,2012,0,0,0
NIU,Niue,CHL,Chile,2013,0,0,0
NIU,Niue,CHL,Chile,2014,0,0,0
NIU,Niue,CHL,Chile,2015,0,0,0
NIU,Niue,CHL,Chile,2016,0,0,0
NIU,Niue,EST,Estonia,2017,0,0,0
NOR,Norway,AUS,Australia,2008,126,237,-111
NOR,Norway,AUS,Australia,2009,168,256,-88
NOR,Norway,AUS,Australia,2010,134,230,-96
NOR,Norway,AUS,Australia,2011,120,253,-133
NOR,Norway,AUS,Australia,2012,146,217,-71
NOR,Norway,AUS,Australia,2013,137,209,-72
NOR,Norway,AUS,Australia,2014,145,181,-36
NOR,Norway,AUS,Australia,2015,133,188,-55
NOR,Norway,AUS,Australia,2016,133,172,-39
NOR,Norway,AUS,Australia,2017,119,178,-59
NOR,Norway,AUT,Austria,2008,90,164,-74
NOR,Norway,AUT,Austria,2009,79,101,-22
NOR,Norway,AUT,Austria,2010,76,164,-88
NOR,Norway,AUT,Austria,2011,98,114,-16
NOR,Norway,AUT,Austria,2012,92,149,-57
NOR,Norway,AUT,Austria,2013,78,142,-64
NOR,Norway,AUT,Austria,2014,108,100,8
NOR,Norway,AUT,Austria,2015,128,102,26
NOR,Norway,AUT,Austria,2016,141,108,33
NOR,Norway,AUT,Austria,2017,157,92,65
NOR,Norway,BEL,Belgium,2008,248,124,124
NOR,Norway,BEL,Belgium,2009,165,119,46
NOR,Norway,BEL,Belgium,2010,232,121,111
NOR,Norway,BEL,Belgium,2011,218,146,72
NOR,Norway,BEL,Belgium,2012,164,123,41
NOR,Norway,BEL,Belgium,2013,225,151,74
NOR,Norway,BEL,Belgium,2014,130,118,12
NOR,Norway,BEL,Belgium,2015,181,120,61
NOR,Norway,BEL,Belgium,2016,175,108,67
NOR,Norway,BEL,Belgium,2017,181,99,82
NOR,Norway,CAN,Canada,2008,66,267,-201
NOR,Norway,CAN,Canada,2009,75,271,-196
NOR,Norway,CAN,Canada,2010,46,265,-219
NOR,Norway,CAN,Canada,2011,49,233,-184
NOR,Norway,CAN,Canada,2012,53,300,-247
NOR,Norway,CAN,Canada,2013,59,217,-158
NOR,Norway,CAN,Canada,2014,46,222,-176
NOR,Norway,CAN,Canada,2015,50,220,-170
NOR,Norway,CAN,Canada,2016,80,236,-156
NOR,Norway,CAN,Canada,2017,70,231,-161
NOR,Norway,CZE,Czech Republic,2008,22,185,-163
NOR,Norway,CZE,Czech Republic,2009,11,195,-184
NOR,Norway,CZE,Czech Republic,2010,14,238,-224
NOR,Norway,CZE,Czech Republic,2011,10,252,-242
NOR,Norway,CZE,Czech Republic,2012,19,253,-234
NOR,Norway,CZE,Czech Republic,2013,37,277,-240
NOR,Norway,CZE,Czech Republic,2014,33,256,-223
NOR,Norway,CZE,Czech Republic,2015,23,209,-186
NOR,Norway,CZE,Czech Republic,2016,17,163,-146
NOR,Norway,CZE,Czech Republic,2017,24,137,-113
NOR,Norway,DNK,Denmark,2008,1420,1345,75
NOR,Norway,DNK,Denmark,2009,1291,1288,3
NOR,Norway,DNK,Denmark,2010,1378,1373,5
NOR,Norway,DNK,Denmark,2011,1495,1590,-95
NOR,Norway,DNK,Denmark,2012,1356,1779,-423
NOR,Norway,DNK,Denmark,2013,1445,2018,-573
NOR,Norway,DNK,Denmark,2014,1713,1705,8
NOR,Norway,DNK,Denmark,2015,1562,1395,167
NOR,Norway,DNK,Denmark,2016,1524,1268,256
NOR,Norway,DNK,Denmark,2017,1459,1168,291
NOR,Norway,FIN,Finland,2008,55,718,-663
NOR,Norway,FIN,Finland,2009,71,565,-494
NOR,Norway,FIN,Finland,2010,65,558,-493
NOR,Norway,FIN,Finland,2011,67,546,-479
NOR,Norway,FIN,Finland,2012,55,474,-419
NOR,Norway,FIN,Finland,2013,70,517,-447
NOR,Norway,FIN,Finland,2014,51,578,-527
NOR,Norway,FIN,Finland,2015,80,528,-448
NOR,Norway,FIN,Finland,2016,78,467,-389
NOR,Norway,FIN,Finland,2017,94,429,-335
NOR,Norway,FRA,France,2008,0,750,-750
NOR,Norway,FRA,France,2009,0,664,-664
NOR,Norway,FRA,France,2010,0,819,-819
NOR,Norway,FRA,France,2011,0,865,-865
NOR,Norway,FRA,France,2012,0,731,-731
NOR,Norway,FRA,France,2013,0,832,-832
NOR,Norway,FRA,France,2014,0,831,-831
NOR,Norway,FRA,France,2015,6,746,-740
NOR,Norway,FRA,France,2016,14,641,-627
NOR,Norway,FRA,France,2017,7,623,-616
NOR,Norway,DEU,Germany,2008,762,4325,-3563
NOR,Norway,DEU,Germany,2009,631,2818,-2187
NOR,Norway,DEU,Germany,2010,767,2678,-1911
NOR,Norway,DEU,Germany,2011,840,2315,-1475
NOR,Norway,DEU,Germany,2012,855,1765,-910
NOR,Norway,DEU,Germany,2013,976,1597,-621
NOR,Norway,DEU,Germany,2014,897,1542,-645
NOR,Norway,DEU,Germany,2015,1022,1311,-289
NOR,Norway,DEU,Germany,2016,1147,1260,-113
NOR,Norway,DEU,Germany,2017,1013,1157,-144
NOR,Norway,HUN,Hungary,2008,164,255,-91
NOR,Norway,HUN,Hungary,2009,143,257,-114
NOR,Norway,HUN,Hungary,2010,146,397,-251
NOR,Norway,HUN,Hungary,2011,182,408,-226
NOR,Norway,HUN,Hungary,2012,128,496,-368
NOR,Norway,HUN,Hungary,2013,144,582,-438
NOR,Norway,HUN,Hungary,2014,240,586,-346
NOR,Norway,HUN,Hungary,2015,126,527,-401
NOR,Norway,HUN,Hungary,2016,147,347,-200
NOR,Norway,HUN,Hungary,2017,163,294,-131
NOR,Norway,ISL,Iceland,2008,47,347,-300
NOR,Norway,ISL,Iceland,2009,24,1584,-1560
NOR,Norway,ISL,Iceland,2010,37,1678,-1641
NOR,Norway,ISL,Iceland,2011,40,1726,-1686
NOR,Norway,ISL,Iceland,2012,34,1450,-1416
NOR,Norway,ISL,Iceland,2013,55,1104,-1049
NOR,Norway,ISL,Iceland,2014,37,1135,-1098
NOR,Norway,ISL,Iceland,2015,34,1002,-968
NOR,Norway,ISL,Iceland,2016,57,582,-525
NOR,Norway,ISL,Iceland,2017,59,359,-300
NOR,Norway,ITA,Italy,2008,111,372,-261
NOR,Norway,ITA,Italy,2009,92,393,-301
NOR,Norway,ITA,Italy,2010,90,494,-404
NOR,Norway,ITA,Italy,2011,79,493,-414
NOR,Norway,ITA,Italy,2012,108,597,-489
NOR,Norway,ITA,Italy,2013,92,766,-674
NOR,Norway,ITA,Italy,2014,65,794,-729
NOR,Norway,ITA,Italy,2015,65,736,-671
NOR,Norway,ITA,Italy,2016,75,656,-581
NOR,Norway,ITA,Italy,2017,62,702,-640
NOR,Norway,JPN,Japan,2008,226,135,91
NOR,Norway,JPN,Japan,2009,259,134,125
NOR,Norway,JPN,Japan,2010,298,114,184
NOR,Norway,JPN,Japan,2011,255,148,107
NOR,Norway,JPN,Japan,2012,242,139,103
NOR,Norway,JPN,Japan,2013,306,138,168
NOR,Norway,JPN,Japan,2014,415,182,233
NOR,Norway,JPN,Japan,2015,303,159,144
NOR,Norway,JPN,Japan,2016,336,155,181
NOR,Norway,JPN,Japan,2017,399,175,224
NOR,Norway,KOR,Korea,2008,157,141,16
NOR,Norway,KOR,Korea,2009,161,140,21
NOR,Norway,KOR,Korea,2010,120,135,-15
NOR,Norway,KOR,Korea,2011,135,165,-30
NOR,Norway,KOR,Korea,2012,168,158,10
NOR,Norway,KOR,Korea,2013,269,155,114
NOR,Norway,KOR,Korea,2014,323,141,182
NOR,Norway,KOR,Korea,2015,259,119,140
NOR,Norway,KOR,Korea,2016,242,109,133
NOR,Norway,KOR,Korea,2017,173,112,61
NOR,Norway,LUX,Luxembourg,2008,28,4,24
NOR,Norway,LUX,Luxembourg,2009,10,6,4
NOR,Norway,LUX,Luxembourg,2010,31,5,26
NOR,Norway,LUX,Luxembourg,2011,27,6,21
NOR,Norway,LUX,Luxembourg,2012,32,2,30
NOR,Norway,LUX,Luxembourg,2013,21,4,17
NOR,Norway,LUX,Luxembourg,2014,27,1,26
NOR,Norway,LUX,Luxembourg,2015,25,4,21
NOR,Norway,LUX,Luxembourg,2016,15,7,8
NOR,Norway,LUX,Luxembourg,2017,20,4,16
NOR,Norway,MEX,Mexico,2008,15,95,-80
NOR,Norway,MEX,Mexico,2009,15,109,-94
NOR,Norway,MEX,Mexico,2010,7,100,-93
NOR,Norway,MEX,Mexico,2011,17,120,-103
NOR,Norway,MEX,Mexico,2012,10,131,-121
NOR,Norway,MEX,Mexico,2013,33,134,-101
NOR,Norway,MEX,Mexico,2014,27,110,-83
NOR,Norway,MEX,Mexico,2015,23,96,-73
NOR,Norway,MEX,Mexico,2016,19,104,-85
NOR,Norway,MEX,Mexico,2017,10,109,-99
NOR,Norway,NLD,Netherlands,2008,310,908,-598
NOR,Norway,NLD,Netherlands,2009,317,666,-349
NOR,Norway,NLD,Netherlands,2010,403,710,-307
NOR,Norway,NLD,Netherlands,2011,383,665,-282
NOR,Norway,NLD,Netherlands,2012,360,594,-234
NOR,Norway,NLD,Netherlands,2013,402,542,-140
NOR,Norway,NLD,Netherlands,2014,416,632,-216
NOR,Norway,NLD,Netherlands,2015,436,494,-58
NOR,Norway,NLD,Netherlands,2016,545,462,83
NOR,Norway,NLD,Netherlands,2017,594,483,111
NOR,Norway,NZL,New Zealand,2008,44,52,-8
NOR,Norway,NZL,New Zealand,2009,62,53,9
NOR,Norway,NZL,New Zealand,2010,64,44,20
NOR,Norway,NZL,New Zealand,2011,69,53,16
NOR,Norway,NZL,New Zealand,2012,105,48,57
NOR,Norway,NZL,New Zealand,2013,84,39,45
NOR,Norway,NZL,New Zealand,2014,102,55,47
NOR,Norway,NZL,New Zealand,2015,113,36,77
NOR,Norway,NZL,New Zealand,2016,92,28,64
NOR,Norway,NZL,New Zealand,2017,113,49,64
NOR,Norway,NOR,Norway,2008,0,0,0
NOR,Norway,NOR,Norway,2009,0,0,0
NOR,Norway,NOR,Norway,2010,0,0,0
NOR,Norway,NOR,Norway,2011,0,0,0
NOR,Norway,NOR,Norway,2012,0,0,0
NOR,Norway,NOR,Norway,2013,0,0,0
NOR,Norway,NOR,Norway,2014,0,0,0
NOR,Norway,NOR,Norway,2015,0,0,0
NOR,Norway,NOR,Norway,2016,0,0,0
NOR,Norway,NOR,Norway,2017,0,0,0
NOR,Norway,POL,Poland,2008,82,14437,-14355
NOR,Norway,POL,Poland,2009,70,10451,-10381
NOR,Norway,POL,Poland,2010,92,11347,-11255
NOR,Norway,POL,Poland,2011,141,12861,-12720
NOR,Norway,POL,Poland,2012,201,11477,-11276
NOR,Norway,POL,Poland,2013,154,10502,-10348
NOR,Norway,POL,Poland,2014,154,9859,-9705
NOR,Norway,POL,Poland,2015,104,8182,-8078
NOR,Norway,POL,Poland,2016,130,6042,-5912
NOR,Norway,POL,Poland,2017,123,5214,-5091
NOR,Norway,SVK,Slovak Republic,2008,57,695,-638
NOR,Norway,SVK,Slovak Republic,2009,57,528,-471
NOR,Norway,SVK,Slovak Republic,2010,51,594,-543
NOR,Norway,SVK,Slovak Republic,2011,58,594,-536
NOR,Norway,SVK,Slovak Republic,2012,54,570,-516
NOR,Norway,SVK,Slovak Republic,2013,31,509,-478
NOR,Norway,SVK,Slovak Republic,2014,48,510,-462
NOR,Norway,SVK,Slovak Republic,2015,49,383,-334
NOR,Norway,SVK,Slovak Republic,2016,36,262,-226
NOR,Norway,SVK,Slovak Republic,2017,29,200,-171
NOR,Norway,ESP,Spain,2008,1084,384,700
NOR,Norway,ESP,Spain,2009,1164,477,687
NOR,Norway,ESP,Spain,2010,1330,751,579
NOR,Norway,ESP,Spain,2011,1386,973,413
NOR,Norway,ESP,Spain,2012,1316,1370,-54
NOR,Norway,ESP,Spain,2013,1218,1535,-317
NOR,Norway,ESP,Spain,2014,1229,1437,-208
NOR,Norway,ESP,Spain,2015,1027,1272,-245
NOR,Norway,ESP,Spain,2016,1056,1099,-43
NOR,Norway,ESP,Spain,2017,1179,954,225
NOR,Norway,SWE,Sweden,2008,2263,5692,-3429
NOR,Norway,SWE,Sweden,2009,1948,6033,-4085
NOR,Norway,SWE,Sweden,2010,2070,7595,-5525
NOR,Norway,SWE,Sweden,2011,2030,8201,-6171
NOR,Norway,SWE,Sweden,2012,2034,5728,-3694
NOR,Norway,SWE,Sweden,2013,2016,5271,-3255
NOR,Norway,SWE,Sweden,2014,2065,4626,-2561
NOR,Norway,SWE,Sweden,2015,2005,3603,-1598
NOR,Norway,SWE,Sweden,2016,2145,2454,-309
NOR,Norway,SWE,Sweden,2017,2123,2185,-62
NOR,Norway,CHE,Switzerland,2008,238,111,127
NOR,Norway,CHE,Switzerland,2009,215,101,114
NOR,Norway,CHE,Switzerland,2010,211,106,105
NOR,Norway,CHE,Switzerland,2011,256,136,120
NOR,Norway,CHE,Switzerland,2012,157,128,29
NOR,Norway,CHE,Switzerland,2013,186,96,90
NOR,Norway,CHE,Switzerland,2014,157,90,67
NOR,Norway,CHE,Switzerland,2015,202,105,97
NOR,Norway,CHE,Switzerland,2016,185,116,69
NOR,Norway,CHE,Switzerland,2017,186,115,71
NOR,Norway,TUR,Turkey,2010,142,293,-151
NOR,Norway,TUR,Turkey,2016,209,331,-122
NOR,Norway,TUR,Turkey,2017,309,377,-68
NOR,Norway,GBR,United Kingdom,2011,3000,1519,1481
NOR,Norway,GBR,United Kingdom,2012,3000,1408,1592
NOR,Norway,GBR,United Kingdom,2013,3000,1331,1669
NOR,Norway,GBR,United Kingdom,2014,2000,1254,746
NOR,Norway,GBR,United Kingdom,2015,4000,984,3016
NOR,Norway,USA,United States,2008,350,914,-564
NOR,Norway,USA,United States,2009,407,881,-474
NOR,Norway,USA,United States,2010,334,874,-540
NOR,Norway,USA,United States,2011,339,967,-628
NOR,Norway,USA,United States,2012,276,1137,-861
NOR,Norway,USA,United States,2013,335,994,-659
NOR,Norway,USA,United States,2014,271,874,-603
NOR,Norway,USA,United States,2015,310,930,-620
NOR,Norway,USA,United States,2016,362,895,-533
NOR,Norway,USA,United States,2017,290,867,-577
NOR,Norway,CHL,Chile,2008,33,122,-89
NOR,Norway,CHL,Chile,2009,20,136,-116
NOR,Norway,CHL,Chile,2010,38,118,-80
NOR,Norway,CHL,Chile,2011,59,109,-50
NOR,Norway,CHL,Chile,2012,50,116,-66
NOR,Norway,CHL,Chile,2013,33,94,-61
NOR,Norway,CHL,Chile,2014,38,71,-33
NOR,Norway,CHL,Chile,2015,31,78,-47
NOR,Norway,CHL,Chile,2016,25,69,-44
NOR,Norway,EST,Estonia,2008,11,535,-524
NOR,Norway,EST,Estonia,2009,19,510,-491
NOR,Norway,EST,Estonia,2010,8,1008,-1000
NOR,Norway,EST,Estonia,2011,2,1027,-1025
NOR,Norway,EST,Estonia,2012,2,908,-906
NOR,Norway,EST,Estonia,2013,0,643,-643
NOR,Norway,EST,Estonia,2014,1,579,-578
NOR,Norway,EST,Estonia,2015,34,453,-419
NOR,Norway,EST,Estonia,2016,39,267,-228
NOR,Norway,EST,Estonia,2017,43,252,-209
NOR,Norway,SVN,Slovenia,2008,6,59,-53
NOR,Norway,SVN,Slovenia,2009,11,26,-15
NOR,Norway,SVN,Slovenia,2011,3,38,-35
NOR,Norway,SVN,Slovenia,2012,7,54,-47
NOR,Norway,SVN,Slovenia,2013,6,58,-52
NOR,Norway,SVN,Slovenia,2014,4,73,-69
NOR,Norway,SVN,Slovenia,2015,5,48,-43
NOR,Norway,SVN,Slovenia,2016,8,50,-42
NOR,Norway,SVN,Slovenia,2017,5,37,-32
OMN,Oman,AUS,Australia,2008,11,5,6
OMN,Oman,AUS,Australia,2009,11,7,4
OMN,Oman,AUS,Australia,2010,0,7,-7
OMN,Oman,AUS,Australia,2011,8,11,-3
OMN,Oman,AUS,Australia,2012,2,11,-9
OMN,Oman,AUS,Australia,2013,8,13,-5
OMN,Oman,AUS,Australia,2014,13,8,5
OMN,Oman,AUS,Australia,2015,30,0,30
OMN,Oman,AUS,Australia,2016,11,0,11
OMN,Oman,AUS,Australia,2017,16,0,16
OMN,Oman,AUT,Austria,2008,2,3,-1
OMN,Oman,AUT,Austria,2009,1,1,0
OMN,Oman,AUT,Austria,2010,1,1,0
OMN,Oman,AUT,Austria,2011,3,1,2
OMN,Oman,AUT,Austria,2012,96,1,95
OMN,Oman,AUT,Austria,2013,42,7,35
OMN,Oman,AUT,Austria,2014,11,12,-1
OMN,Oman,AUT,Austria,2015,20,20,0
OMN,Oman,AUT,Austria,2016,15,35,-20
OMN,Oman,AUT,Austria,2017,2,32,-30
OMN,Oman,BEL,Belgium,2008,2,0,2
OMN,Oman,BEL,Belgium,2009,2,0,2
OMN,Oman,BEL,Belgium,2010,1,0,1
OMN,Oman,BEL,Belgium,2012,1,1,0
OMN,Oman,BEL,Belgium,2013,1,0,1
OMN,Oman,BEL,Belgium,2014,1,0,1
OMN,Oman,BEL,Belgium,2016,3,0,3
OMN,Oman,CAN,Canada,2008,10,0,10
OMN,Oman,CAN,Canada,2009,7,0,7
OMN,Oman,CAN,Canada,2010,14,0,14
OMN,Oman,CAN,Canada,2011,10,0,10
OMN,Oman,CAN,Canada,2012,13,0,13
OMN,Oman,CAN,Canada,2013,11,0,11
OMN,Oman,CAN,Canada,2014,8,0,8
OMN,Oman,CAN,Canada,2015,5,0,5
OMN,Oman,CAN,Canada,2016,0,0,0
OMN,Oman,CAN,Canada,2017,10,0,10
OMN,Oman,CZE,Czech Republic,2008,4,0,4
OMN,Oman,CZE,Czech Republic,2009,4,0,4
OMN,Oman,DNK,Denmark,2008,0,0,0
OMN,Oman,DNK,Denmark,2009,0,0,0
OMN,Oman,DNK,Denmark,2012,0,0,0
OMN,Oman,DNK,Denmark,2013,0,0,0
OMN,Oman,DNK,Denmark,2014,7,0,7
OMN,Oman,DNK,Denmark,2015,0,9,-9
OMN,Oman,DNK,Denmark,2016,0,1,-1
OMN,Oman,DNK,Denmark,2017,2,0,2
OMN,Oman,FIN,Finland,2008,0,0,0
OMN,Oman,FIN,Finland,2009,0,0,0
OMN,Oman,FIN,Finland,2010,0,0,0
OMN,Oman,FIN,Finland,2011,0,0,0
OMN,Oman,FIN,Finland,2012,1,0,1
OMN,Oman,FIN,Finland,2013,0,0,0
OMN,Oman,FIN,Finland,2014,0,0,0
OMN,Oman,FIN,Finland,2015,0,0,0
OMN,Oman,FIN,Finland,2016,0,0,0
OMN,Oman,FIN,Finland,2017,5,0,5
OMN,Oman,FRA,France,2008,6,0,6
OMN,Oman,FRA,France,2009,5,0,5
OMN,Oman,FRA,France,2010,3,0,3
OMN,Oman,FRA,France,2011,8,0,8
OMN,Oman,FRA,France,2012,11,0,11
OMN,Oman,FRA,France,2013,8,0,8
OMN,Oman,FRA,France,2014,5,0,5
OMN,Oman,FRA,France,2015,9,0,9
OMN,Oman,FRA,France,2016,6,0,6
OMN,Oman,FRA,France,2017,8,0,8
OMN,Oman,DEU,Germany,2008,81,61,20
OMN,Oman,DEU,Germany,2009,109,40,69
OMN,Oman,DEU,Germany,2010,92,73,19
OMN,Oman,DEU,Germany,2011,210,116,94
OMN,Oman,DEU,Germany,2012,87,98,-11
OMN,Oman,DEU,Germany,2013,126,121,5
OMN,Oman,DEU,Germany,2014,248,122,126
OMN,Oman,DEU,Germany,2015,159,148,11
OMN,Oman,DEU,Germany,2016,101,120,-19
OMN,Oman,DEU,Germany,2017,94,116,-22
OMN,Oman,HUN,Hungary,2008,0,0,0
OMN,Oman,HUN,Hungary,2009,2,0,2
OMN,Oman,HUN,Hungary,2010,2,0,2
OMN,Oman,HUN,Hungary,2011,4,0,4
OMN,Oman,HUN,Hungary,2012,2,0,2
OMN,Oman,HUN,Hungary,2013,0,0,0
OMN,Oman,HUN,Hungary,2014,0,1,-1
OMN,Oman,HUN,Hungary,2015,5,0,5
OMN,Oman,HUN,Hungary,2016,0,0,0
OMN,Oman,HUN,Hungary,2017,4,0,4
OMN,Oman,ISL,Iceland,2008,0,0,0
OMN,Oman,ISL,Iceland,2009,0,0,0
OMN,Oman,ISL,Iceland,2010,2,0,2
OMN,Oman,ISL,Iceland,2011,0,0,0
OMN,Oman,ISL,Iceland,2012,0,0,0
OMN,Oman,ISL,Iceland,2013,0,0,0
OMN,Oman,ISL,Iceland,2014,0,0,0
OMN,Oman,ISL,Iceland,2015,0,0,0
OMN,Oman,ISL,Iceland,2016,0,2,-2
OMN,Oman,ISL,Iceland,2017,0,0,0
OMN,Oman,ITA,Italy,2008,1,3,-2
OMN,Oman,ITA,Italy,2009,2,3,-1
OMN,Oman,ITA,Italy,2010,1,0,1
OMN,Oman,ITA,Italy,2011,2,0,2
OMN,Oman,ITA,Italy,2012,1,0,1
OMN,Oman,ITA,Italy,2013,14,8,6
OMN,Oman,ITA,Italy,2014,4,1,3
OMN,Oman,ITA,Italy,2015,11,0,11
OMN,Oman,ITA,Italy,2016,9,0,9
OMN,Oman,ITA,Italy,2017,29,15,14
OMN,Oman,JPN,Japan,2008,71,70,1
OMN,Oman,JPN,Japan,2009,92,92,0
OMN,Oman,JPN,Japan,2010,145,135,10
OMN,Oman,JPN,Japan,2011,58,64,-6
OMN,Oman,JPN,Japan,2012,114,102,12
OMN,Oman,JPN,Japan,2013,91,83,8
OMN,Oman,JPN,Japan,2014,170,169,1
OMN,Oman,JPN,Japan,2015,67,67,0
OMN,Oman,JPN,Japan,2016,50,49,1
OMN,Oman,JPN,Japan,2017,69,60,9
OMN,Oman,KOR,Korea,2008,5,5,0
OMN,Oman,KOR,Korea,2009,3,4,-1
OMN,Oman,KOR,Korea,2010,56,23,33
OMN,Oman,KOR,Korea,2011,9,52,-43
OMN,Oman,KOR,Korea,2012,10,14,-4
OMN,Oman,KOR,Korea,2013,12,6,6
OMN,Oman,KOR,Korea,2014,22,15,7
OMN,Oman,KOR,Korea,2015,18,21,-3
OMN,Oman,KOR,Korea,2016,14,10,4
OMN,Oman,KOR,Korea,2017,11,23,-12
OMN,Oman,LUX,Luxembourg,2008,0,0,0
OMN,Oman,LUX,Luxembourg,2009,0,0,0
OMN,Oman,LUX,Luxembourg,2010,0,0,0
OMN,Oman,LUX,Luxembourg,2011,0,0,0
OMN,Oman,LUX,Luxembourg,2012,0,0,0
OMN,Oman,LUX,Luxembourg,2013,0,0,0
OMN,Oman,LUX,Luxembourg,2014,0,0,0
OMN,Oman,LUX,Luxembourg,2015,0,0,0
OMN,Oman,LUX,Luxembourg,2016,0,0,0
OMN,Oman,LUX,Luxembourg,2017,0,0,0
OMN,Oman,MEX,Mexico,2009,1,0,1
OMN,Oman,MEX,Mexico,2012,0,0,0
OMN,Oman,MEX,Mexico,2013,0,0,0
OMN,Oman,MEX,Mexico,2014,0,0,0
OMN,Oman,NLD,Netherlands,2008,21,29,-8
OMN,Oman,NLD,Netherlands,2009,18,50,-32
OMN,Oman,NLD,Netherlands,2010,12,15,-3
OMN,Oman,NLD,Netherlands,2011,22,13,9
OMN,Oman,NLD,Netherlands,2012,54,16,38
OMN,Oman,NLD,Netherlands,2013,82,24,58
OMN,Oman,NLD,Netherlands,2014,83,50,33
OMN,Oman,NLD,Netherlands,2015,60,39,21
OMN,Oman,NLD,Netherlands,2016,61,56,5
OMN,Oman,NLD,Netherlands,2017,86,74,12
OMN,Oman,NZL,New Zealand,2008,50,16,34
OMN,Oman,NZL,New Zealand,2009,32,27,5
OMN,Oman,NZL,New Zealand,2010,37,36,1
OMN,Oman,NZL,New Zealand,2011,24,14,10
OMN,Oman,NZL,New Zealand,2012,32,14,18
OMN,Oman,NZL,New Zealand,2013,36,19,17
OMN,Oman,NZL,New Zealand,2014,36,12,24
OMN,Oman,NZL,New Zealand,2015,46,19,27
OMN,Oman,NZL,New Zealand,2016,63,12,51
OMN,Oman,NZL,New Zealand,2017,60,26,34
OMN,Oman,NOR,Norway,2008,0,0,0
OMN,Oman,NOR,Norway,2009,0,0,0
OMN,Oman,NOR,Norway,2010,2,0,2
OMN,Oman,NOR,Norway,2011,3,0,3
OMN,Oman,NOR,Norway,2012,2,0,2
OMN,Oman,NOR,Norway,2013,3,0,3
OMN,Oman,NOR,Norway,2014,11,2,9
OMN,Oman,NOR,Norway,2015,3,8,-5
OMN,Oman,NOR,Norway,2016,6,7,-1
OMN,Oman,NOR,Norway,2017,3,0,3
OMN,Oman,POL,Poland,2009,0,0,0
OMN,Oman,POL,Poland,2010,0,0,0
OMN,Oman,POL,Poland,2011,0,0,0
OMN,Oman,POL,Poland,2012,0,0,0
OMN,Oman,POL,Poland,2013,0,0,0
OMN,Oman,POL,Poland,2014,0,0,0
OMN,Oman,POL,Poland,2015,4,0,4
OMN,Oman,POL,Poland,2016,71,0,71
OMN,Oman,POL,Poland,2017,39,0,39
OMN,Oman,SVK,Slovak Republic,2008,0,1,-1
OMN,Oman,ESP,Spain,2008,1,7,-6
OMN,Oman,ESP,Spain,2009,2,2,0
OMN,Oman,ESP,Spain,2010,1,0,1
OMN,Oman,ESP,Spain,2011,1,2,-1
OMN,Oman,ESP,Spain,2012,7,1,6
OMN,Oman,ESP,Spain,2013,23,2,21
OMN,Oman,ESP,Spain,2014,10,2,8
OMN,Oman,ESP,Spain,2015,7,9,-2
OMN,Oman,ESP,Spain,2016,23,5,18
OMN,Oman,ESP,Spain,2017,15,9,6
OMN,Oman,SWE,Sweden,2008,8,0,8
OMN,Oman,SWE,Sweden,2009,0,0,0
OMN,Oman,SWE,Sweden,2010,1,3,-2
OMN,Oman,SWE,Sweden,2011,9,10,-1
OMN,Oman,SWE,Sweden,2012,8,4,4
OMN,Oman,SWE,Sweden,2013,7,1,6
OMN,Oman,SWE,Sweden,2014,5,7,-2
OMN,Oman,SWE,Sweden,2015,6,2,4
OMN,Oman,SWE,Sweden,2016,3,7,-4
OMN,Oman,SWE,Sweden,2017,2,1,1
OMN,Oman,CHE,Switzerland,2010,10,5,5
OMN,Oman,CHE,Switzerland,2011,8,5,3
OMN,Oman,CHE,Switzerland,2012,7,2,5
OMN,Oman,CHE,Switzerland,2013,4,3,1
OMN,Oman,CHE,Switzerland,2014,11,3,8
OMN,Oman,CHE,Switzerland,2015,10,6,4
OMN,Oman,CHE,Switzerland,2016,8,12,-4
OMN,Oman,CHE,Switzerland,2017,3,4,-1
OMN,Oman,TUR,Turkey,2010,1,0,1
OMN,Oman,GBR,United Kingdom,2011,1000,0,1000
OMN,Oman,GBR,United Kingdom,2012,1000,0,1000
OMN,Oman,GBR,United Kingdom,2013,1000,0,1000
OMN,Oman,GBR,United Kingdom,2014,1000,0,1000
OMN,Oman,GBR,United Kingdom,2015,1000,0,1000
OMN,Oman,USA,United States,2008,70,0,70
OMN,Oman,USA,United States,2009,74,0,74
OMN,Oman,USA,United States,2010,63,0,63
OMN,Oman,USA,United States,2011,60,0,60
OMN,Oman,USA,United States,2012,74,0,74
OMN,Oman,USA,United States,2013,73,0,73
OMN,Oman,USA,United States,2014,90,0,90
OMN,Oman,USA,United States,2015,85,0,85
OMN,Oman,USA,United States,2016,116,0,116
OMN,Oman,USA,United States,2017,104,0,104
OMN,Oman,CHL,Chile,2008,0,0,0
OMN,Oman,CHL,Chile,2009,0,0,0
OMN,Oman,CHL,Chile,2010,0,0,0
OMN,Oman,CHL,Chile,2011,0,0,0
OMN,Oman,CHL,Chile,2012,1,0,1
OMN,Oman,CHL,Chile,2013,1,0,1
OMN,Oman,CHL,Chile,2014,0,0,0
OMN,Oman,CHL,Chile,2015,0,0,0
OMN,Oman,CHL,Chile,2016,1,0,1
OMN,Oman,EST,Estonia,2008,0,0,0
OMN,Oman,EST,Estonia,2009,0,0,0
OMN,Oman,EST,Estonia,2010,0,0,0
OMN,Oman,EST,Estonia,2011,0,0,0
OMN,Oman,EST,Estonia,2012,0,0,0
OMN,Oman,EST,Estonia,2013,0,0,0
OMN,Oman,EST,Estonia,2014,0,0,0
OMN,Oman,EST,Estonia,2015,0,0,0
OMN,Oman,EST,Estonia,2016,0,0,0
OMN,Oman,EST,Estonia,2017,0,0,0
OMN,Oman,SVN,Slovenia,2009,1,0,1
PAK,Pakistan,AUS,Australia,2008,1881,309,1572
PAK,Pakistan,AUS,Australia,2009,1972,253,1719
PAK,Pakistan,AUS,Australia,2010,1799,281,1518
PAK,Pakistan,AUS,Australia,2011,1845,303,1542
PAK,Pakistan,AUS,Australia,2012,3891,273,3618
PAK,Pakistan,AUS,Australia,2013,3612,322,3290
PAK,Pakistan,AUS,Australia,2014,5669,342,5327
PAK,Pakistan,AUS,Australia,2015,8019,400,7619
PAK,Pakistan,AUS,Australia,2016,6958,400,6558
PAK,Pakistan,AUS,Australia,2017,6819,0,6819
PAK,Pakistan,AUT,Austria,2008,402,212,190
PAK,Pakistan,AUT,Austria,2009,376,241,135
PAK,Pakistan,AUT,Austria,2010,450,357,93
PAK,Pakistan,AUT,Austria,2011,866,433,433
PAK,Pakistan,AUT,Austria,2012,1036,588,448
PAK,Pakistan,AUT,Austria,2013,628,795,-167
PAK,Pakistan,AUT,Austria,2014,649,506,143
PAK,Pakistan,AUT,Austria,2015,1379,484,895
PAK,Pakistan,AUT,Austria,2016,863,726,137
PAK,Pakistan,AUT,Austria,2017,592,679,-87
PAK,Pakistan,BEL,Belgium,2008,400,0,400
PAK,Pakistan,BEL,Belgium,2009,574,0,574
PAK,Pakistan,BEL,Belgium,2010,597,92,505
PAK,Pakistan,BEL,Belgium,2011,751,0,751
PAK,Pakistan,BEL,Belgium,2012,1320,382,938
PAK,Pakistan,BEL,Belgium,2013,684,662,22
PAK,Pakistan,BEL,Belgium,2014,560,734,-174
PAK,Pakistan,BEL,Belgium,2015,876,559,317
PAK,Pakistan,BEL,Belgium,2016,594,250,344
PAK,Pakistan,BEL,Belgium,2017,583,263,320
PAK,Pakistan,CAN,Canada,2008,8984,0,8984
PAK,Pakistan,CAN,Canada,2009,7213,0,7213
PAK,Pakistan,CAN,Canada,2010,6810,0,6810
PAK,Pakistan,CAN,Canada,2011,7467,0,7467
PAK,Pakistan,CAN,Canada,2012,11208,0,11208
PAK,Pakistan,CAN,Canada,2013,12609,0,12609
PAK,Pakistan,CAN,Canada,2014,9114,0,9114
PAK,Pakistan,CAN,Canada,2015,11329,0,11329
PAK,Pakistan,CAN,Canada,2016,11335,0,11335
PAK,Pakistan,CAN,Canada,2017,7655,0,7655
PAK,Pakistan,CZE,Czech Republic,2008,68,0,68
PAK,Pakistan,CZE,Czech Republic,2009,52,0,52
PAK,Pakistan,CZE,Czech Republic,2010,77,0,77
PAK,Pakistan,CZE,Czech Republic,2011,20,0,20
PAK,Pakistan,CZE,Czech Republic,2012,40,8,32
PAK,Pakistan,CZE,Czech Republic,2013,33,26,7
PAK,Pakistan,CZE,Czech Republic,2014,48,20,28
PAK,Pakistan,CZE,Czech Republic,2015,40,18,22
PAK,Pakistan,CZE,Czech Republic,2016,51,24,27
PAK,Pakistan,CZE,Czech Republic,2017,64,28,36
PAK,Pakistan,DNK,Denmark,2008,346,107,239
PAK,Pakistan,DNK,Denmark,2009,463,120,343
PAK,Pakistan,DNK,Denmark,2010,721,168,553
PAK,Pakistan,DNK,Denmark,2011,653,236,417
PAK,Pakistan,DNK,Denmark,2012,495,215,280
PAK,Pakistan,DNK,Denmark,2013,795,264,531
PAK,Pakistan,DNK,Denmark,2014,735,249,486
PAK,Pakistan,DNK,Denmark,2015,548,239,309
PAK,Pakistan,DNK,Denmark,2016,497,329,168
PAK,Pakistan,DNK,Denmark,2017,467,291,176
PAK,Pakistan,FIN,Finland,2008,123,21,102
PAK,Pakistan,FIN,Finland,2009,181,11,170
PAK,Pakistan,FIN,Finland,2010,174,16,158
PAK,Pakistan,FIN,Finland,2011,227,22,205
PAK,Pakistan,FIN,Finland,2012,269,32,237
PAK,Pakistan,FIN,Finland,2013,190,31,159
PAK,Pakistan,FIN,Finland,2014,316,18,298
PAK,Pakistan,FIN,Finland,2015,287,28,259
PAK,Pakistan,FIN,Finland,2016,299,39,260
PAK,Pakistan,FIN,Finland,2017,286,37,249
PAK,Pakistan,FRA,France,2008,795,0,795
PAK,Pakistan,FRA,France,2009,789,0,789
PAK,Pakistan,FRA,France,2010,822,0,822
PAK,Pakistan,FRA,France,2011,876,0,876
PAK,Pakistan,FRA,France,2012,1001,0,1001
PAK,Pakistan,FRA,France,2013,1196,0,1196
PAK,Pakistan,FRA,France,2014,1395,0,1395
PAK,Pakistan,FRA,France,2015,1387,0,1387
PAK,Pakistan,FRA,France,2016,1440,0,1440
PAK,Pakistan,FRA,France,2017,1400,0,1400
PAK,Pakistan,DEU,Germany,2008,2169,1741,428
PAK,Pakistan,DEU,Germany,2009,2756,1809,947
PAK,Pakistan,DEU,Germany,2010,3310,1633,1677
PAK,Pakistan,DEU,Germany,2011,5395,1660,3735
PAK,Pakistan,DEU,Germany,2012,6513,1955,4558
PAK,Pakistan,DEU,Germany,2013,7966,2211,5755
PAK,Pakistan,DEU,Germany,2014,9549,2815,6734
PAK,Pakistan,DEU,Germany,2015,24496,3997,20499
PAK,Pakistan,DEU,Germany,2016,12207,9527,2680
PAK,Pakistan,DEU,Germany,2017,9007,8054,953
PAK,Pakistan,HUN,Hungary,2008,20,3,17
PAK,Pakistan,HUN,Hungary,2009,38,0,38
PAK,Pakistan,HUN,Hungary,2010,39,6,33
PAK,Pakistan,HUN,Hungary,2011,47,5,42
PAK,Pakistan,HUN,Hungary,2012,49,7,42
PAK,Pakistan,HUN,Hungary,2013,76,20,56
PAK,Pakistan,HUN,Hungary,2014,81,8,73
PAK,Pakistan,HUN,Hungary,2015,135,18,117
PAK,Pakistan,HUN,Hungary,2016,184,17,167
PAK,Pakistan,HUN,Hungary,2017,329,0,329
PAK,Pakistan,ISL,Iceland,2008,0,39,-39
PAK,Pakistan,ISL,Iceland,2009,1,8,-7
PAK,Pakistan,ISL,Iceland,2010,4,0,4
PAK,Pakistan,ISL,Iceland,2011,1,0,1
PAK,Pakistan,ISL,Iceland,2012,4,0,4
PAK,Pakistan,ISL,Iceland,2013,3,1,2
PAK,Pakistan,ISL,Iceland,2014,4,1,3
PAK,Pakistan,ISL,Iceland,2015,8,1,7
PAK,Pakistan,ISL,Iceland,2016,11,4,7
PAK,Pakistan,ISL,Iceland,2017,19,1,18
PAK,Pakistan,ITA,Italy,2008,5706,322,5384
PAK,Pakistan,ITA,Italy,2009,7858,365,7493
PAK,Pakistan,ITA,Italy,2010,10816,584,10232
PAK,Pakistan,ITA,Italy,2011,7452,577,6875
PAK,Pakistan,ITA,Italy,2012,8754,598,8156
PAK,Pakistan,ITA,Italy,2013,7794,785,7009
PAK,Pakistan,ITA,Italy,2014,9558,869,8689
PAK,Pakistan,ITA,Italy,2015,11361,859,10502
PAK,Pakistan,ITA,Italy,2016,14735,0,14735
PAK,Pakistan,ITA,Italy,2017,14978,910,14068
PAK,Pakistan,JPN,Japan,2008,1174,537,637
PAK,Pakistan,JPN,Japan,2009,1182,554,628
PAK,Pakistan,JPN,Japan,2010,1037,570,467
PAK,Pakistan,JPN,Japan,2011,1245,524,721
PAK,Pakistan,JPN,Japan,2012,1345,569,776
PAK,Pakistan,JPN,Japan,2013,1051,468,583
PAK,Pakistan,JPN,Japan,2014,1170,436,734
PAK,Pakistan,JPN,Japan,2015,1495,530,965
PAK,Pakistan,JPN,Japan,2016,1486,513,973
PAK,Pakistan,JPN,Japan,2017,1675,579,1096
PAK,Pakistan,KOR,Korea,2008,1905,2072,-167
PAK,Pakistan,KOR,Korea,2009,1458,1753,-295
PAK,Pakistan,KOR,Korea,2010,1666,1411,255
PAK,Pakistan,KOR,Korea,2011,1681,1871,-190
PAK,Pakistan,KOR,Korea,2012,2060,2285,-225
PAK,Pakistan,KOR,Korea,2013,2457,2075,382
PAK,Pakistan,KOR,Korea,2014,2190,1651,539
PAK,Pakistan,KOR,Korea,2015,2690,2133,557
PAK,Pakistan,KOR,Korea,2016,2724,1863,861
PAK,Pakistan,KOR,Korea,2017,2491,2185,306
PAK,Pakistan,LUX,Luxembourg,2008,10,0,10
PAK,Pakistan,LUX,Luxembourg,2009,9,3,6
PAK,Pakistan,LUX,Luxembourg,2010,1,2,-1
PAK,Pakistan,LUX,Luxembourg,2011,12,1,11
PAK,Pakistan,LUX,Luxembourg,2012,12,0,12
PAK,Pakistan,LUX,Luxembourg,2013,19,9,10
PAK,Pakistan,LUX,Luxembourg,2014,13,7,6
PAK,Pakistan,LUX,Luxembourg,2015,17,6,11
PAK,Pakistan,LUX,Luxembourg,2016,38,9,29
PAK,Pakistan,LUX,Luxembourg,2017,31,10,21
PAK,Pakistan,MEX,Mexico,2008,20,0,20
PAK,Pakistan,MEX,Mexico,2009,19,0,19
PAK,Pakistan,MEX,Mexico,2010,26,0,26
PAK,Pakistan,MEX,Mexico,2011,34,0,34
PAK,Pakistan,MEX,Mexico,2012,37,0,37
PAK,Pakistan,MEX,Mexico,2013,84,0,84
PAK,Pakistan,MEX,Mexico,2014,54,0,54
PAK,Pakistan,MEX,Mexico,2015,26,0,26
PAK,Pakistan,MEX,Mexico,2016,42,0,42
PAK,Pakistan,MEX,Mexico,2017,48,0,48
PAK,Pakistan,NLD,Netherlands,2008,383,279,104
PAK,Pakistan,NLD,Netherlands,2009,392,142,250
PAK,Pakistan,NLD,Netherlands,2010,406,269,137
PAK,Pakistan,NLD,Netherlands,2011,489,263,226
PAK,Pakistan,NLD,Netherlands,2012,463,286,177
PAK,Pakistan,NLD,Netherlands,2013,541,277,264
PAK,Pakistan,NLD,Netherlands,2014,512,273,239
PAK,Pakistan,NLD,Netherlands,2015,660,223,437
PAK,Pakistan,NLD,Netherlands,2016,669,249,420
PAK,Pakistan,NLD,Netherlands,2017,771,229,542
PAK,Pakistan,NZL,New Zealand,2008,210,14,196
PAK,Pakistan,NZL,New Zealand,2009,174,39,135
PAK,Pakistan,NZL,New Zealand,2010,260,50,210
PAK,Pakistan,NZL,New Zealand,2011,261,72,189
PAK,Pakistan,NZL,New Zealand,2012,263,65,198
PAK,Pakistan,NZL,New Zealand,2013,388,107,281
PAK,Pakistan,NZL,New Zealand,2014,533,70,463
PAK,Pakistan,NZL,New Zealand,2015,714,62,652
PAK,Pakistan,NZL,New Zealand,2016,764,78,686
PAK,Pakistan,NZL,New Zealand,2017,706,53,653
PAK,Pakistan,NOR,Norway,2008,572,116,456
PAK,Pakistan,NOR,Norway,2009,652,168,484
PAK,Pakistan,NOR,Norway,2010,506,168,338
PAK,Pakistan,NOR,Norway,2011,602,187,415
PAK,Pakistan,NOR,Norway,2012,781,214,567
PAK,Pakistan,NOR,Norway,2013,605,290,315
PAK,Pakistan,NOR,Norway,2014,559,221,338
PAK,Pakistan,NOR,Norway,2015,539,236,303
PAK,Pakistan,NOR,Norway,2016,591,214,377
PAK,Pakistan,NOR,Norway,2017,581,194,387
PAK,Pakistan,POL,Poland,2008,139,0,139
PAK,Pakistan,POL,Poland,2009,153,0,153
PAK,Pakistan,POL,Poland,2010,159,0,159
PAK,Pakistan,POL,Poland,2011,141,0,141
PAK,Pakistan,POL,Poland,2012,223,0,223
PAK,Pakistan,POL,Poland,2013,283,0,283
PAK,Pakistan,POL,Poland,2014,155,0,155
PAK,Pakistan,POL,Poland,2015,484,0,484
PAK,Pakistan,POL,Poland,2016,600,0,600
PAK,Pakistan,POL,Poland,2017,654,0,654
PAK,Pakistan,PRT,Portugal,2008,268,0,268
PAK,Pakistan,PRT,Portugal,2009,342,0,342
PAK,Pakistan,PRT,Portugal,2010,357,0,357
PAK,Pakistan,PRT,Portugal,2011,312,0,312
PAK,Pakistan,PRT,Portugal,2012,415,0,415
PAK,Pakistan,PRT,Portugal,2013,403,0,403
PAK,Pakistan,PRT,Portugal,2014,424,0,424
PAK,Pakistan,PRT,Portugal,2015,568,0,568
PAK,Pakistan,PRT,Portugal,2016,468,0,468
PAK,Pakistan,PRT,Portugal,2017,625,0,625
PAK,Pakistan,SVK,Slovak Republic,2008,4,6,-2
PAK,Pakistan,SVK,Slovak Republic,2009,1,1,0
PAK,Pakistan,SVK,Slovak Republic,2010,2,8,-6
PAK,Pakistan,SVK,Slovak Republic,2011,3,0,3
PAK,Pakistan,SVK,Slovak Republic,2012,1,0,1
PAK,Pakistan,SVK,Slovak Republic,2013,2,0,2
PAK,Pakistan,SVK,Slovak Republic,2014,1,0,1
PAK,Pakistan,SVK,Slovak Republic,2015,2,0,2
PAK,Pakistan,SVK,Slovak Republic,2016,1,1,0
PAK,Pakistan,SVK,Slovak Republic,2017,3,0,3
PAK,Pakistan,ESP,Spain,2008,8872,4843,4029
PAK,Pakistan,ESP,Spain,2009,6425,7056,-631
PAK,Pakistan,ESP,Spain,2010,15322,7921,7401
PAK,Pakistan,ESP,Spain,2011,11513,11305,208
PAK,Pakistan,ESP,Spain,2012,8345,12597,-4252
PAK,Pakistan,ESP,Spain,2013,6484,13560,-7076
PAK,Pakistan,ESP,Spain,2014,5311,7967,-2656
PAK,Pakistan,ESP,Spain,2015,4811,6098,-1287
PAK,Pakistan,ESP,Spain,2016,6371,5218,1153
PAK,Pakistan,ESP,Spain,2017,6556,4693,1863
PAK,Pakistan,SWE,Sweden,2008,1500,248,1252
PAK,Pakistan,SWE,Sweden,2009,1756,285,1471
PAK,Pakistan,SWE,Sweden,2010,1575,451,1124
PAK,Pakistan,SWE,Sweden,2011,896,615,281
PAK,Pakistan,SWE,Sweden,2012,931,708,223
PAK,Pakistan,SWE,Sweden,2013,796,576,220
PAK,Pakistan,SWE,Sweden,2014,796,578,218
PAK,Pakistan,SWE,Sweden,2015,1090,802,288
PAK,Pakistan,SWE,Sweden,2016,1211,235,976
PAK,Pakistan,SWE,Sweden,2017,1699,229,1470
PAK,Pakistan,CHE,Switzerland,2010,241,99,142
PAK,Pakistan,CHE,Switzerland,2011,233,102,131
PAK,Pakistan,CHE,Switzerland,2012,218,89,129
PAK,Pakistan,CHE,Switzerland,2013,217,106,111
PAK,Pakistan,CHE,Switzerland,2014,216,90,126
PAK,Pakistan,CHE,Switzerland,2015,207,96,111
PAK,Pakistan,CHE,Switzerland,2016,228,103,125
PAK,Pakistan,CHE,Switzerland,2017,198,85,113
PAK,Pakistan,TUR,Turkey,2010,143,0,143
PAK,Pakistan,TUR,Turkey,2016,1113,624,489
PAK,Pakistan,TUR,Turkey,2017,1468,627,841
PAK,Pakistan,GBR,United Kingdom,2008,17000,3000,14000
PAK,Pakistan,GBR,United Kingdom,2009,17000,4000,13000
PAK,Pakistan,GBR,United Kingdom,2010,30000,3000,27000
PAK,Pakistan,GBR,United Kingdom,2011,43000,2000,41000
PAK,Pakistan,GBR,United Kingdom,2012,19000,4000,15000
PAK,Pakistan,GBR,United Kingdom,2013,10000,4000,6000
PAK,Pakistan,GBR,United Kingdom,2014,11000,3000,8000
PAK,Pakistan,GBR,United Kingdom,2015,8000,3000,5000
PAK,Pakistan,GBR,United Kingdom,2016,11000,0,11000
PAK,Pakistan,GBR,United Kingdom,2017,15000,0,15000
PAK,Pakistan,USA,United States,2008,19719,0,19719
PAK,Pakistan,USA,United States,2009,21555,0,21555
PAK,Pakistan,USA,United States,2010,18258,0,18258
PAK,Pakistan,USA,United States,2011,15546,0,15546
PAK,Pakistan,USA,United States,2012,14740,0,14740
PAK,Pakistan,USA,United States,2013,13251,0,13251
PAK,Pakistan,USA,United States,2014,18612,0,18612
PAK,Pakistan,USA,United States,2015,18057,0,18057
PAK,Pakistan,USA,United States,2016,19313,0,19313
PAK,Pakistan,USA,United States,2017,17408,0,17408
PAK,Pakistan,CHL,Chile,2008,39,0,39
PAK,Pakistan,CHL,Chile,2009,73,0,73
PAK,Pakistan,CHL,Chile,2010,52,0,52
PAK,Pakistan,CHL,Chile,2011,44,0,44
PAK,Pakistan,CHL,Chile,2012,44,0,44
PAK,Pakistan,CHL,Chile,2013,41,0,41
PAK,Pakistan,CHL,Chile,2014,21,0,21
PAK,Pakistan,CHL,Chile,2015,57,0,57
PAK,Pakistan,CHL,Chile,2016,114,0,114
PAK,Pakistan,EST,Estonia,2008,1,0,1
PAK,Pakistan,EST,Estonia,2009,4,0,4
PAK,Pakistan,EST,Estonia,2010,1,0,1
PAK,Pakistan,EST,Estonia,2011,10,0,10
PAK,Pakistan,EST,Estonia,2012,8,0,8
PAK,Pakistan,EST,Estonia,2013,10,0,10
PAK,Pakistan,EST,Estonia,2014,1,0,1
PAK,Pakistan,EST,Estonia,2015,28,0,28
PAK,Pakistan,EST,Estonia,2016,39,0,39
PAK,Pakistan,EST,Estonia,2017,48,0,48
PAK,Pakistan,SVN,Slovenia,2008,4,0,4
PAK,Pakistan,SVN,Slovenia,2009,4,0,4
PAK,Pakistan,SVN,Slovenia,2010,4,0,4
PAK,Pakistan,SVN,Slovenia,2011,3,0,3
PAK,Pakistan,SVN,Slovenia,2012,1,0,1
PAK,Pakistan,SVN,Slovenia,2013,7,0,7
PAK,Pakistan,SVN,Slovenia,2014,9,0,9
PAK,Pakistan,SVN,Slovenia,2015,10,1,9
PAK,Pakistan,SVN,Slovenia,2016,18,0,18
PAK,Pakistan,SVN,Slovenia,2017,7,0,7
PLW,Palau,AUS,Australia,2008,0,0,0
PLW,Palau,AUS,Australia,2009,0,0,0
PLW,Palau,AUS,Australia,2010,0,0,0
PLW,Palau,AUS,Australia,2011,0,0,0
PLW,Palau,AUS,Australia,2012,0,0,0
PLW,Palau,AUS,Australia,2013,0,0,0
PLW,Palau,AUS,Australia,2014,0,0,0
PLW,Palau,AUS,Australia,2015,0,0,0
PLW,Palau,AUS,Australia,2016,0,0,0
PLW,Palau,AUS,Australia,2017,0,0,0
PLW,Palau,AUT,Austria,2008,0,0,0
PLW,Palau,AUT,Austria,2009,2,0,2
PLW,Palau,AUT,Austria,2010,0,0,0
PLW,Palau,AUT,Austria,2011,0,0,0
PLW,Palau,AUT,Austria,2012,0,0,0
PLW,Palau,AUT,Austria,2013,2,0,2
PLW,Palau,AUT,Austria,2014,6,0,6
PLW,Palau,AUT,Austria,2015,0,1,-1
PLW,Palau,AUT,Austria,2016,9,1,8
PLW,Palau,AUT,Austria,2017,0,0,0
PLW,Palau,BEL,Belgium,2010,0,0,0
PLW,Palau,CAN,Canada,2008,0,0,0
PLW,Palau,CAN,Canada,2009,0,0,0
PLW,Palau,CAN,Canada,2010,0,0,0
PLW,Palau,CAN,Canada,2011,0,0,0
PLW,Palau,CAN,Canada,2012,0,0,0
PLW,Palau,CAN,Canada,2013,0,0,0
PLW,Palau,CAN,Canada,2014,0,0,0
PLW,Palau,CAN,Canada,2015,0,0,0
PLW,Palau,CAN,Canada,2016,0,0,0
PLW,Palau,CAN,Canada,2017,0,0,0
PLW,Palau,DNK,Denmark,2013,0,0,0
PLW,Palau,DNK,Denmark,2014,0,0,0
PLW,Palau,DNK,Denmark,2015,0,0,0
PLW,Palau,DNK,Denmark,2016,0,0,0
PLW,Palau,DNK,Denmark,2017,0,0,0
PLW,Palau,FIN,Finland,2008,0,0,0
PLW,Palau,FIN,Finland,2009,0,0,0
PLW,Palau,FIN,Finland,2010,0,0,0
PLW,Palau,FIN,Finland,2011,0,0,0
PLW,Palau,FIN,Finland,2012,0,0,0
PLW,Palau,FIN,Finland,2013,0,0,0
PLW,Palau,FIN,Finland,2014,0,0,0
PLW,Palau,FIN,Finland,2015,0,0,0
PLW,Palau,FIN,Finland,2016,0,0,0
PLW,Palau,FIN,Finland,2017,0,0,0
PLW,Palau,FRA,France,2008,0,0,0
PLW,Palau,FRA,France,2009,0,0,0
PLW,Palau,FRA,France,2010,0,0,0
PLW,Palau,FRA,France,2011,0,0,0
PLW,Palau,FRA,France,2012,0,0,0
PLW,Palau,FRA,France,2013,0,0,0
PLW,Palau,FRA,France,2014,0,0,0
PLW,Palau,FRA,France,2015,0,0,0
PLW,Palau,FRA,France,2016,0,0,0
PLW,Palau,FRA,France,2017,0,0,0
PLW,Palau,DEU,Germany,2008,3,0,3
PLW,Palau,DEU,Germany,2009,3,2,1
PLW,Palau,DEU,Germany,2010,5,1,4
PLW,Palau,DEU,Germany,2011,2,2,0
PLW,Palau,DEU,Germany,2012,3,1,2
PLW,Palau,DEU,Germany,2013,3,3,0
PLW,Palau,DEU,Germany,2014,2,1,1
PLW,Palau,DEU,Germany,2015,4,1,3
PLW,Palau,DEU,Germany,2016,4,2,2
PLW,Palau,DEU,Germany,2017,0,1,-1
PLW,Palau,HUN,Hungary,2008,0,0,0
PLW,Palau,HUN,Hungary,2009,0,0,0
PLW,Palau,HUN,Hungary,2010,0,0,0
PLW,Palau,HUN,Hungary,2011,0,0,0
PLW,Palau,HUN,Hungary,2012,0,0,0
PLW,Palau,HUN,Hungary,2013,0,0,0
PLW,Palau,HUN,Hungary,2014,0,0,0
PLW,Palau,HUN,Hungary,2015,0,0,0
PLW,Palau,HUN,Hungary,2016,0,0,0
PLW,Palau,HUN,Hungary,2017,0,0,0
PLW,Palau,ISL,Iceland,2016,0,0,0
PLW,Palau,ISL,Iceland,2017,0,0,0
PLW,Palau,ITA,Italy,2008,3,0,3
PLW,Palau,ITA,Italy,2009,2,0,2
PLW,Palau,ITA,Italy,2010,3,0,3
PLW,Palau,ITA,Italy,2011,1,0,1
PLW,Palau,ITA,Italy,2012,0,0,0
PLW,Palau,ITA,Italy,2013,0,0,0
PLW,Palau,ITA,Italy,2015,0,0,0
PLW,Palau,ITA,Italy,2017,1,0,1
PLW,Palau,JPN,Japan,2008,73,74,-1
PLW,Palau,JPN,Japan,2009,59,60,-1
PLW,Palau,JPN,Japan,2010,36,32,4
PLW,Palau,JPN,Japan,2011,15,15,0
PLW,Palau,JPN,Japan,2012,22,18,4
PLW,Palau,JPN,Japan,2013,53,52,1
PLW,Palau,JPN,Japan,2014,57,57,0
PLW,Palau,JPN,Japan,2015,77,74,3
PLW,Palau,JPN,Japan,2016,64,61,3
PLW,Palau,JPN,Japan,2017,85,83,2
PLW,Palau,KOR,Korea,2008,1,0,1
PLW,Palau,KOR,Korea,2009,3,1,2
PLW,Palau,KOR,Korea,2010,1,2,-1
PLW,Palau,KOR,Korea,2011,2,1,1
PLW,Palau,KOR,Korea,2012,8,7,1
PLW,Palau,KOR,Korea,2013,1,0,1
PLW,Palau,KOR,Korea,2014,3,5,-2
PLW,Palau,KOR,Korea,2015,1,3,-2
PLW,Palau,KOR,Korea,2016,2,2,0
PLW,Palau,KOR,Korea,2017,2,0,2
PLW,Palau,LUX,Luxembourg,2008,0,0,0
PLW,Palau,LUX,Luxembourg,2009,0,0,0
PLW,Palau,LUX,Luxembourg,2010,0,0,0
PLW,Palau,LUX,Luxembourg,2011,0,0,0
PLW,Palau,LUX,Luxembourg,2012,0,0,0
PLW,Palau,LUX,Luxembourg,2013,0,0,0
PLW,Palau,LUX,Luxembourg,2014,0,0,0
PLW,Palau,LUX,Luxembourg,2015,0,0,0
PLW,Palau,LUX,Luxembourg,2016,0,0,0
PLW,Palau,LUX,Luxembourg,2017,0,0,0
PLW,Palau,MEX,Mexico,2012,0,0,0
PLW,Palau,MEX,Mexico,2013,0,0,0
PLW,Palau,MEX,Mexico,2014,0,0,0
PLW,Palau,NZL,New Zealand,2008,1,0,1
PLW,Palau,NZL,New Zealand,2010,1,3,-2
PLW,Palau,NZL,New Zealand,2011,1,0,1
PLW,Palau,NZL,New Zealand,2016,1,0,1
PLW,Palau,NOR,Norway,2008,0,0,0
PLW,Palau,NOR,Norway,2009,0,0,0
PLW,Palau,NOR,Norway,2010,0,0,0
PLW,Palau,NOR,Norway,2011,0,0,0
PLW,Palau,NOR,Norway,2012,0,0,0
PLW,Palau,NOR,Norway,2013,0,0,0
PLW,Palau,NOR,Norway,2014,0,0,0
PLW,Palau,NOR,Norway,2015,0,0,0
PLW,Palau,NOR,Norway,2016,0,0,0
PLW,Palau,NOR,Norway,2017,0,0,0
PLW,Palau,POL,Poland,2009,0,0,0
PLW,Palau,POL,Poland,2010,0,0,0
PLW,Palau,POL,Poland,2011,0,0,0
PLW,Palau,POL,Poland,2012,0,0,0
PLW,Palau,POL,Poland,2013,0,0,0
PLW,Palau,POL,Poland,2014,0,0,0
PLW,Palau,POL,Poland,2015,0,0,0
PLW,Palau,POL,Poland,2016,0,0,0
PLW,Palau,POL,Poland,2017,0,0,0
PLW,Palau,SVK,Slovak Republic,2008,0,1,-1
PLW,Palau,ESP,Spain,2008,2,3,-1
PLW,Palau,ESP,Spain,2009,3,0,3
PLW,Palau,ESP,Spain,2010,1,0,1
PLW,Palau,ESP,Spain,2011,0,0,0
PLW,Palau,ESP,Spain,2012,2,0,2
PLW,Palau,ESP,Spain,2013,1,0,1
PLW,Palau,ESP,Spain,2014,3,0,3
PLW,Palau,ESP,Spain,2015,1,0,1
PLW,Palau,ESP,Spain,2016,4,0,4
PLW,Palau,ESP,Spain,2017,4,0,4
PLW,Palau,SWE,Sweden,2008,0,0,0
PLW,Palau,SWE,Sweden,2009,0,0,0
PLW,Palau,SWE,Sweden,2010,0,0,0
PLW,Palau,SWE,Sweden,2011,0,0,0
PLW,Palau,SWE,Sweden,2012,0,0,0
PLW,Palau,SWE,Sweden,2013,0,0,0
PLW,Palau,SWE,Sweden,2014,0,0,0
PLW,Palau,SWE,Sweden,2015,0,0,0
PLW,Palau,SWE,Sweden,2016,1,0,1
PLW,Palau,SWE,Sweden,2017,0,0,0
PLW,Palau,CHE,Switzerland,2010,0,0,0
PLW,Palau,CHE,Switzerland,2011,0,0,0
PLW,Palau,CHE,Switzerland,2012,0,0,0
PLW,Palau,CHE,Switzerland,2013,0,0,0
PLW,Palau,USA,United States,2008,6,0,6
PLW,Palau,USA,United States,2009,16,0,16
PLW,Palau,USA,United States,2010,18,0,18
PLW,Palau,USA,United States,2011,7,0,7
PLW,Palau,USA,United States,2012,10,0,10
PLW,Palau,USA,United States,2013,16,0,16
PLW,Palau,USA,United States,2014,12,0,12
PLW,Palau,USA,United States,2015,15,0,15
PLW,Palau,USA,United States,2016,14,0,14
PLW,Palau,USA,United States,2017,13,0,13
PLW,Palau,CHL,Chile,2008,0,0,0
PLW,Palau,CHL,Chile,2009,0,0,0
PLW,Palau,CHL,Chile,2010,0,0,0
PLW,Palau,CHL,Chile,2011,0,0,0
PLW,Palau,CHL,Chile,2012,0,0,0
PLW,Palau,CHL,Chile,2013,0,0,0
PLW,Palau,CHL,Chile,2014,0,0,0
PLW,Palau,CHL,Chile,2015,0,0,0
PLW,Palau,CHL,Chile,2016,0,0,0
PLW,Palau,EST,Estonia,2008,0,0,0
PLW,Palau,EST,Estonia,2009,0,0,0
PLW,Palau,EST,Estonia,2010,0,0,0
PLW,Palau,EST,Estonia,2011,0,0,0
PLW,Palau,EST,Estonia,2012,0,0,0
PLW,Palau,EST,Estonia,2013,0,0,0
PLW,Palau,EST,Estonia,2014,0,0,0
PLW,Palau,EST,Estonia,2015,0,0,0
PLW,Palau,EST,Estonia,2016,0,0,0
PLW,Palau,EST,Estonia,2017,0,0,0
PSE,West Bank and Gaza Strip,AUS,Australia,2008,0,0,0
PSE,West Bank and Gaza Strip,AUS,Australia,2009,4,0,4
PSE,West Bank and Gaza Strip,AUS,Australia,2010,1,0,1
PSE,West Bank and Gaza Strip,AUS,Australia,2011,0,0,0
PSE,West Bank and Gaza Strip,AUS,Australia,2012,0,0,0
PSE,West Bank and Gaza Strip,AUS,Australia,2013,0,5,-5
PSE,West Bank and Gaza Strip,AUS,Australia,2014,0,0,0
PSE,West Bank and Gaza Strip,AUS,Australia,2015,0,0,0
PSE,West Bank and Gaza Strip,AUS,Australia,2016,0,0,0
PSE,West Bank and Gaza Strip,AUS,Australia,2017,0,0,0
PSE,West Bank and Gaza Strip,AUT,Austria,2014,0,0,0
PSE,West Bank and Gaza Strip,AUT,Austria,2015,0,0,0
PSE,West Bank and Gaza Strip,AUT,Austria,2016,0,0,0
PSE,West Bank and Gaza Strip,AUT,Austria,2017,0,0,0
PSE,West Bank and Gaza Strip,BEL,Belgium,2008,54,0,54
PSE,West Bank and Gaza Strip,BEL,Belgium,2009,69,0,69
PSE,West Bank and Gaza Strip,BEL,Belgium,2010,60,1,59
PSE,West Bank and Gaza Strip,BEL,Belgium,2012,86,25,61
PSE,West Bank and Gaza Strip,BEL,Belgium,2013,51,57,-6
PSE,West Bank and Gaza Strip,BEL,Belgium,2014,83,25,58
PSE,West Bank and Gaza Strip,BEL,Belgium,2015,109,7,102
PSE,West Bank and Gaza Strip,BEL,Belgium,2016,564,19,545
PSE,West Bank and Gaza Strip,BEL,Belgium,2017,820,18,802
PSE,West Bank and Gaza Strip,CAN,Canada,2008,481,0,481
PSE,West Bank and Gaza Strip,CAN,Canada,2009,399,0,399
PSE,West Bank and Gaza Strip,CAN,Canada,2010,652,0,652
PSE,West Bank and Gaza Strip,CAN,Canada,2011,555,0,555
PSE,West Bank and Gaza Strip,CAN,Canada,2012,531,0,531
PSE,West Bank and Gaza Strip,CAN,Canada,2013,462,0,462
PSE,West Bank and Gaza Strip,CAN,Canada,2014,443,0,443
PSE,West Bank and Gaza Strip,CAN,Canada,2015,553,0,553
PSE,West Bank and Gaza Strip,CAN,Canada,2016,440,0,440
PSE,West Bank and Gaza Strip,CAN,Canada,2017,345,0,345
PSE,West Bank and Gaza Strip,CZE,Czech Republic,2008,5,3,2
PSE,West Bank and Gaza Strip,CZE,Czech Republic,2009,11,1,10
PSE,West Bank and Gaza Strip,CZE,Czech Republic,2010,14,0,14
PSE,West Bank and Gaza Strip,CZE,Czech Republic,2011,6,0,6
PSE,West Bank and Gaza Strip,CZE,Czech Republic,2012,11,2,9
PSE,West Bank and Gaza Strip,CZE,Czech Republic,2013,8,15,-7
PSE,West Bank and Gaza Strip,CZE,Czech Republic,2014,24,4,20
PSE,West Bank and Gaza Strip,CZE,Czech Republic,2015,20,6,14
PSE,West Bank and Gaza Strip,CZE,Czech Republic,2016,16,9,7
PSE,West Bank and Gaza Strip,CZE,Czech Republic,2017,18,12,6
PSE,West Bank and Gaza Strip,DNK,Denmark,2013,0,0,0
PSE,West Bank and Gaza Strip,DNK,Denmark,2014,0,0,0
PSE,West Bank and Gaza Strip,DNK,Denmark,2015,0,0,0
PSE,West Bank and Gaza Strip,DNK,Denmark,2016,0,0,0
PSE,West Bank and Gaza Strip,DNK,Denmark,2017,0,0,0
PSE,West Bank and Gaza Strip,FIN,Finland,2008,2,0,2
PSE,West Bank and Gaza Strip,FIN,Finland,2009,19,0,19
PSE,West Bank and Gaza Strip,FIN,Finland,2010,3,0,3
PSE,West Bank and Gaza Strip,FIN,Finland,2011,4,0,4
PSE,West Bank and Gaza Strip,FIN,Finland,2012,3,0,3
PSE,West Bank and Gaza Strip,FIN,Finland,2013,0,0,0
PSE,West Bank and Gaza Strip,FIN,Finland,2014,3,0,3
PSE,West Bank and Gaza Strip,FIN,Finland,2015,2,0,2
PSE,West Bank and Gaza Strip,FIN,Finland,2016,0,0,0
PSE,West Bank and Gaza Strip,FIN,Finland,2017,0,2,-2
PSE,West Bank and Gaza Strip,FRA,France,2008,56,0,56
PSE,West Bank and Gaza Strip,FRA,France,2009,88,0,88
PSE,West Bank and Gaza Strip,FRA,France,2010,94,0,94
PSE,West Bank and Gaza Strip,FRA,France,2011,76,0,76
PSE,West Bank and Gaza Strip,FRA,France,2012,86,0,86
PSE,West Bank and Gaza Strip,FRA,France,2013,79,0,79
PSE,West Bank and Gaza Strip,FRA,France,2014,116,0,116
PSE,West Bank and Gaza Strip,FRA,France,2015,121,0,121
PSE,West Bank and Gaza Strip,FRA,France,2016,175,0,175
PSE,West Bank and Gaza Strip,FRA,France,2017,160,0,160
PSE,West Bank and Gaza Strip,DEU,Germany,2016,946,288,658
PSE,West Bank and Gaza Strip,DEU,Germany,2017,577,158,419
PSE,West Bank and Gaza Strip,HUN,Hungary,2008,8,0,8
PSE,West Bank and Gaza Strip,HUN,Hungary,2009,16,1,15
PSE,West Bank and Gaza Strip,HUN,Hungary,2010,10,3,7
PSE,West Bank and Gaza Strip,HUN,Hungary,2011,14,1,13
PSE,West Bank and Gaza Strip,HUN,Hungary,2012,19,2,17
PSE,West Bank and Gaza Strip,HUN,Hungary,2013,17,1,16
PSE,West Bank and Gaza Strip,HUN,Hungary,2014,44,3,41
PSE,West Bank and Gaza Strip,HUN,Hungary,2015,45,6,39
PSE,West Bank and Gaza Strip,HUN,Hungary,2016,58,16,42
PSE,West Bank and Gaza Strip,HUN,Hungary,2017,65,0,65
PSE,West Bank and Gaza Strip,ISL,Iceland,2008,0,0,0
PSE,West Bank and Gaza Strip,ISL,Iceland,2009,0,0,0
PSE,West Bank and Gaza Strip,ISL,Iceland,2010,2,0,2
PSE,West Bank and Gaza Strip,ISL,Iceland,2011,0,0,0
PSE,West Bank and Gaza Strip,ISL,Iceland,2012,4,0,4
PSE,West Bank and Gaza Strip,ISL,Iceland,2013,3,3,0
PSE,West Bank and Gaza Strip,ISL,Iceland,2014,2,4,-2
PSE,West Bank and Gaza Strip,ISL,Iceland,2015,8,2,6
PSE,West Bank and Gaza Strip,ISL,Iceland,2016,7,1,6
PSE,West Bank and Gaza Strip,ISL,Iceland,2017,9,4,5
PSE,West Bank and Gaza Strip,ITA,Italy,2008,25,3,22
PSE,West Bank and Gaza Strip,ITA,Italy,2009,109,3,106
PSE,West Bank and Gaza Strip,ITA,Italy,2010,130,2,128
PSE,West Bank and Gaza Strip,ITA,Italy,2011,73,2,71
PSE,West Bank and Gaza Strip,ITA,Italy,2012,87,0,87
PSE,West Bank and Gaza Strip,ITA,Italy,2013,53,2,51
PSE,West Bank and Gaza Strip,ITA,Italy,2014,123,11,112
PSE,West Bank and Gaza Strip,ITA,Italy,2015,118,12,106
PSE,West Bank and Gaza Strip,ITA,Italy,2016,115,0,115
PSE,West Bank and Gaza Strip,ITA,Italy,2017,206,7,199
PSE,West Bank and Gaza Strip,JPN,Japan,2008,54,49,5
PSE,West Bank and Gaza Strip,JPN,Japan,2009,52,47,5
PSE,West Bank and Gaza Strip,JPN,Japan,2010,82,79,3
PSE,West Bank and Gaza Strip,JPN,Japan,2011,34,34,0
PSE,West Bank and Gaza Strip,JPN,Japan,2012,55,52,3
PSE,West Bank and Gaza Strip,JPN,Japan,2013,52,50,2
PSE,West Bank and Gaza Strip,JPN,Japan,2014,58,54,4
PSE,West Bank and Gaza Strip,JPN,Japan,2015,72,56,16
PSE,West Bank and Gaza Strip,JPN,Japan,2016,70,58,12
PSE,West Bank and Gaza Strip,JPN,Japan,2017,46,37,9
PSE,West Bank and Gaza Strip,KOR,Korea,2008,6,3,3
PSE,West Bank and Gaza Strip,KOR,Korea,2009,6,8,-2
PSE,West Bank and Gaza Strip,KOR,Korea,2010,12,2,10
PSE,West Bank and Gaza Strip,KOR,Korea,2011,15,15,0
PSE,West Bank and Gaza Strip,KOR,Korea,2012,10,4,6
PSE,West Bank and Gaza Strip,KOR,Korea,2013,17,13,4
PSE,West Bank and Gaza Strip,KOR,Korea,2014,17,20,-3
PSE,West Bank and Gaza Strip,KOR,Korea,2015,16,13,3
PSE,West Bank and Gaza Strip,KOR,Korea,2016,14,13,1
PSE,West Bank and Gaza Strip,KOR,Korea,2017,22,9,13
PSE,West Bank and Gaza Strip,LUX,Luxembourg,2008,0,0,0
PSE,West Bank and Gaza Strip,LUX,Luxembourg,2009,0,0,0
PSE,West Bank and Gaza Strip,LUX,Luxembourg,2010,0,0,0
PSE,West Bank and Gaza Strip,LUX,Luxembourg,2011,1,0,1
PSE,West Bank and Gaza Strip,LUX,Luxembourg,2012,0,0,0
PSE,West Bank and Gaza Strip,LUX,Luxembourg,2013,0,0,0
PSE,West Bank and Gaza Strip,LUX,Luxembourg,2014,2,0,2
PSE,West Bank and Gaza Strip,LUX,Luxembourg,2015,1,0,1
PSE,West Bank and Gaza Strip,LUX,Luxembourg,2016,2,2,0
PSE,West Bank and Gaza Strip,LUX,Luxembourg,2017,0,2,-2
PSE,West Bank and Gaza Strip,MEX,Mexico,2008,3,0,3
PSE,West Bank and Gaza Strip,MEX,Mexico,2009,4,0,4
PSE,West Bank and Gaza Strip,MEX,Mexico,2010,5,0,5
PSE,West Bank and Gaza Strip,MEX,Mexico,2011,5,0,5
PSE,West Bank and Gaza Strip,MEX,Mexico,2012,2,0,2
PSE,West Bank and Gaza Strip,MEX,Mexico,2013,9,0,9
PSE,West Bank and Gaza Strip,MEX,Mexico,2014,4,0,4
PSE,West Bank and Gaza Strip,MEX,Mexico,2015,1,0,1
PSE,West Bank and Gaza Strip,MEX,Mexico,2016,3,0,3
PSE,West Bank and Gaza Strip,NZL,New Zealand,2008,6,0,6
PSE,West Bank and Gaza Strip,NZL,New Zealand,2009,18,0,18
PSE,West Bank and Gaza Strip,NZL,New Zealand,2010,31,1,30
PSE,West Bank and Gaza Strip,NZL,New Zealand,2011,7,0,7
PSE,West Bank and Gaza Strip,NZL,New Zealand,2012,22,1,21
PSE,West Bank and Gaza Strip,NZL,New Zealand,2013,46,2,44
PSE,West Bank and Gaza Strip,NZL,New Zealand,2014,26,2,24
PSE,West Bank and Gaza Strip,NZL,New Zealand,2015,40,0,40
PSE,West Bank and Gaza Strip,NZL,New Zealand,2016,85,0,85
PSE,West Bank and Gaza Strip,NZL,New Zealand,2017,66,0,66
PSE,West Bank and Gaza Strip,NOR,Norway,2008,0,0,0
PSE,West Bank and Gaza Strip,NOR,Norway,2009,0,0,0
PSE,West Bank and Gaza Strip,NOR,Norway,2010,0,0,0
PSE,West Bank and Gaza Strip,NOR,Norway,2011,0,0,0
PSE,West Bank and Gaza Strip,NOR,Norway,2012,0,0,0
PSE,West Bank and Gaza Strip,NOR,Norway,2013,0,0,0
PSE,West Bank and Gaza Strip,NOR,Norway,2014,0,0,0
PSE,West Bank and Gaza Strip,NOR,Norway,2015,0,0,0
PSE,West Bank and Gaza Strip,NOR,Norway,2016,0,0,0
PSE,West Bank and Gaza Strip,NOR,Norway,2017,0,0,0
PSE,West Bank and Gaza Strip,POL,Poland,2009,80,0,80
PSE,West Bank and Gaza Strip,POL,Poland,2010,68,0,68
PSE,West Bank and Gaza Strip,POL,Poland,2011,68,0,68
PSE,West Bank and Gaza Strip,POL,Poland,2012,68,0,68
PSE,West Bank and Gaza Strip,POL,Poland,2013,14,0,14
PSE,West Bank and Gaza Strip,POL,Poland,2014,33,0,33
PSE,West Bank and Gaza Strip,POL,Poland,2015,66,0,66
PSE,West Bank and Gaza Strip,POL,Poland,2016,58,0,58
PSE,West Bank and Gaza Strip,POL,Poland,2017,64,0,64
PSE,West Bank and Gaza Strip,SVK,Slovak Republic,2008,1,3,-2
PSE,West Bank and Gaza Strip,SVK,Slovak Republic,2009,1,5,-4
PSE,West Bank and Gaza Strip,SVK,Slovak Republic,2010,4,3,1
PSE,West Bank and Gaza Strip,SVK,Slovak Republic,2011,5,2,3
PSE,West Bank and Gaza Strip,SVK,Slovak Republic,2012,3,1,2
PSE,West Bank and Gaza Strip,SVK,Slovak Republic,2013,1,0,1
PSE,West Bank and Gaza Strip,SVK,Slovak Republic,2014,3,0,3
PSE,West Bank and Gaza Strip,SVK,Slovak Republic,2015,2,0,2
PSE,West Bank and Gaza Strip,SVK,Slovak Republic,2016,1,0,1
PSE,West Bank and Gaza Strip,SVK,Slovak Republic,2017,2,0,2
PSE,West Bank and Gaza Strip,ESP,Spain,2008,0,0,0
PSE,West Bank and Gaza Strip,ESP,Spain,2009,0,0,0
PSE,West Bank and Gaza Strip,ESP,Spain,2010,0,0,0
PSE,West Bank and Gaza Strip,ESP,Spain,2011,0,0,0
PSE,West Bank and Gaza Strip,ESP,Spain,2012,0,0,0
PSE,West Bank and Gaza Strip,ESP,Spain,2013,0,0,0
PSE,West Bank and Gaza Strip,SWE,Sweden,2008,0,0,0
PSE,West Bank and Gaza Strip,SWE,Sweden,2009,0,0,0
PSE,West Bank and Gaza Strip,SWE,Sweden,2010,0,0,0
PSE,West Bank and Gaza Strip,SWE,Sweden,2011,0,0,0
PSE,West Bank and Gaza Strip,SWE,Sweden,2012,0,0,0
PSE,West Bank and Gaza Strip,SWE,Sweden,2013,0,0,0
PSE,West Bank and Gaza Strip,SWE,Sweden,2014,0,0,0
PSE,West Bank and Gaza Strip,SWE,Sweden,2015,423,0,423
PSE,West Bank and Gaza Strip,SWE,Sweden,2016,824,1,823
PSE,West Bank and Gaza Strip,SWE,Sweden,2017,734,4,730
PSE,West Bank and Gaza Strip,CHE,Switzerland,2010,18,2,16
PSE,West Bank and Gaza Strip,CHE,Switzerland,2011,10,7,3
PSE,West Bank and Gaza Strip,CHE,Switzerland,2012,23,5,18
PSE,West Bank and Gaza Strip,CHE,Switzerland,2013,22,5,17
PSE,West Bank and Gaza Strip,TUR,Turkey,2010,175,0,175
PSE,West Bank and Gaza Strip,TUR,Turkey,2016,2026,486,1540
PSE,West Bank and Gaza Strip,TUR,Turkey,2017,4817,650,4167
PSE,West Bank and Gaza Strip,CHL,Chile,2008,4,0,4
PSE,West Bank and Gaza Strip,CHL,Chile,2009,3,0,3
PSE,West Bank and Gaza Strip,CHL,Chile,2010,4,0,4
PSE,West Bank and Gaza Strip,CHL,Chile,2011,4,0,4
PSE,West Bank and Gaza Strip,CHL,Chile,2012,7,0,7
PSE,West Bank and Gaza Strip,CHL,Chile,2013,16,0,16
PSE,West Bank and Gaza Strip,CHL,Chile,2014,8,0,8
PSE,West Bank and Gaza Strip,CHL,Chile,2015,12,0,12
PSE,West Bank and Gaza Strip,CHL,Chile,2016,24,0,24
PSE,West Bank and Gaza Strip,EST,Estonia,2008,1,0,1
PSE,West Bank and Gaza Strip,EST,Estonia,2009,0,0,0
PSE,West Bank and Gaza Strip,EST,Estonia,2010,0,0,0
PSE,West Bank and Gaza Strip,EST,Estonia,2011,3,0,3
PSE,West Bank and Gaza Strip,EST,Estonia,2012,0,0,0
PSE,West Bank and Gaza Strip,EST,Estonia,2013,3,0,3
PSE,West Bank and Gaza Strip,EST,Estonia,2014,1,0,1
PSE,West Bank and Gaza Strip,EST,Estonia,2015,13,0,13
PSE,West Bank and Gaza Strip,EST,Estonia,2016,12,0,12
PSE,West Bank and Gaza Strip,EST,Estonia,2017,2,0,2
PSE,West Bank and Gaza Strip,SVN,Slovenia,2009,1,0,1
PSE,West Bank and Gaza Strip,SVN,Slovenia,2010,2,0,2
PSE,West Bank and Gaza Strip,SVN,Slovenia,2013,1,0,1
PSE,West Bank and Gaza Strip,SVN,Slovenia,2015,4,0,4
PSE,West Bank and Gaza Strip,SVN,Slovenia,2016,3,0,3
PSE,West Bank and Gaza Strip,SVN,Slovenia,2017,14,0,14
PAN,Panama,AUS,Australia,2008,4,0,4
PAN,Panama,AUS,Australia,2009,8,0,8
PAN,Panama,AUS,Australia,2010,5,0,5
PAN,Panama,AUS,Australia,2011,4,0,4
PAN,Panama,AUS,Australia,2012,2,0,2
PAN,Panama,AUS,Australia,2013,7,0,7
PAN,Panama,AUS,Australia,2014,0,0,0
PAN,Panama,AUS,Australia,2015,5,0,5
PAN,Panama,AUS,Australia,2017,3,0,3
PAN,Panama,AUT,Austria,2008,2,0,2
PAN,Panama,AUT,Austria,2009,5,2,3
PAN,Panama,AUT,Austria,2010,5,6,-1
PAN,Panama,AUT,Austria,2011,9,2,7
PAN,Panama,AUT,Austria,2012,5,4,1
PAN,Panama,AUT,Austria,2013,5,5,0
PAN,Panama,AUT,Austria,2014,7,3,4
PAN,Panama,AUT,Austria,2015,7,8,-1
PAN,Panama,AUT,Austria,2016,8,4,4
PAN,Panama,AUT,Austria,2017,7,9,-2
PAN,Panama,BEL,Belgium,2008,8,0,8
PAN,Panama,BEL,Belgium,2009,15,0,15
PAN,Panama,BEL,Belgium,2010,15,4,11
PAN,Panama,BEL,Belgium,2012,8,10,-2
PAN,Panama,BEL,Belgium,2013,8,9,-1
PAN,Panama,BEL,Belgium,2014,9,1,8
PAN,Panama,BEL,Belgium,2015,12,5,7
PAN,Panama,BEL,Belgium,2016,11,4,7
PAN,Panama,BEL,Belgium,2017,14,2,12
PAN,Panama,CAN,Canada,2008,52,0,52
PAN,Panama,CAN,Canada,2009,73,0,73
PAN,Panama,CAN,Canada,2010,65,0,65
PAN,Panama,CAN,Canada,2011,49,0,49
PAN,Panama,CAN,Canada,2012,34,0,34
PAN,Panama,CAN,Canada,2013,43,0,43
PAN,Panama,CAN,Canada,2014,59,0,59
PAN,Panama,CAN,Canada,2015,39,0,39
PAN,Panama,CAN,Canada,2016,45,0,45
PAN,Panama,CAN,Canada,2017,55,0,55
PAN,Panama,CZE,Czech Republic,2008,5,0,5
PAN,Panama,CZE,Czech Republic,2009,12,0,12
PAN,Panama,CZE,Czech Republic,2010,1,0,1
PAN,Panama,CZE,Czech Republic,2011,6,0,6
PAN,Panama,CZE,Czech Republic,2012,9,1,8
PAN,Panama,CZE,Czech Republic,2013,9,10,-1
PAN,Panama,CZE,Czech Republic,2014,13,6,7
PAN,Panama,CZE,Czech Republic,2015,6,5,1
PAN,Panama,CZE,Czech Republic,2016,8,7,1
PAN,Panama,CZE,Czech Republic,2017,7,9,-2
PAN,Panama,DNK,Denmark,2008,6,1,5
PAN,Panama,DNK,Denmark,2009,4,4,0
PAN,Panama,DNK,Denmark,2010,3,3,0
PAN,Panama,DNK,Denmark,2011,5,2,3
PAN,Panama,DNK,Denmark,2012,3,0,3
PAN,Panama,DNK,Denmark,2013,4,2,2
PAN,Panama,DNK,Denmark,2014,10,4,6
PAN,Panama,DNK,Denmark,2015,4,3,1
PAN,Panama,DNK,Denmark,2016,3,6,-3
PAN,Panama,DNK,Denmark,2017,7,0,7
PAN,Panama,FIN,Finland,2008,1,1,0
PAN,Panama,FIN,Finland,2009,1,1,0
PAN,Panama,FIN,Finland,2010,1,0,1
PAN,Panama,FIN,Finland,2011,3,2,1
PAN,Panama,FIN,Finland,2012,2,0,2
PAN,Panama,FIN,Finland,2013,1,1,0
PAN,Panama,FIN,Finland,2014,1,0,1
PAN,Panama,FIN,Finland,2015,2,0,2
PAN,Panama,FIN,Finland,2016,3,2,1
PAN,Panama,FIN,Finland,2017,1,2,-1
PAN,Panama,FRA,France,2008,10,0,10
PAN,Panama,FRA,France,2009,10,0,10
PAN,Panama,FRA,France,2010,17,0,17
PAN,Panama,FRA,France,2011,15,0,15
PAN,Panama,FRA,France,2012,18,0,18
PAN,Panama,FRA,France,2013,16,0,16
PAN,Panama,FRA,France,2014,18,0,18
PAN,Panama,FRA,France,2015,23,0,23
PAN,Panama,FRA,France,2016,19,0,19
PAN,Panama,FRA,France,2017,19,0,19
PAN,Panama,DEU,Germany,2008,47,67,-20
PAN,Panama,DEU,Germany,2009,95,66,29
PAN,Panama,DEU,Germany,2010,66,75,-9
PAN,Panama,DEU,Germany,2011,81,50,31
PAN,Panama,DEU,Germany,2012,64,55,9
PAN,Panama,DEU,Germany,2013,82,50,32
PAN,Panama,DEU,Germany,2014,66,49,17
PAN,Panama,DEU,Germany,2015,91,37,54
PAN,Panama,DEU,Germany,2016,76,51,25
PAN,Panama,DEU,Germany,2017,77,46,31
PAN,Panama,HUN,Hungary,2008,2,0,2
PAN,Panama,HUN,Hungary,2009,2,0,2
PAN,Panama,HUN,Hungary,2010,3,0,3
PAN,Panama,HUN,Hungary,2011,2,0,2
PAN,Panama,HUN,Hungary,2012,0,0,0
PAN,Panama,HUN,Hungary,2013,2,0,2
PAN,Panama,HUN,Hungary,2014,4,0,4
PAN,Panama,HUN,Hungary,2015,3,0,3
PAN,Panama,HUN,Hungary,2016,1,0,1
PAN,Panama,HUN,Hungary,2017,4,0,4
PAN,Panama,ISL,Iceland,2008,2,0,2
PAN,Panama,ISL,Iceland,2009,0,0,0
PAN,Panama,ISL,Iceland,2010,0,1,-1
PAN,Panama,ISL,Iceland,2011,0,0,0
PAN,Panama,ISL,Iceland,2012,0,0,0
PAN,Panama,ISL,Iceland,2013,0,0,0
PAN,Panama,ISL,Iceland,2014,1,0,1
PAN,Panama,ISL,Iceland,2015,0,1,-1
PAN,Panama,ISL,Iceland,2016,0,0,0
PAN,Panama,ISL,Iceland,2017,1,0,1
PAN,Panama,ITA,Italy,2008,38,6,32
PAN,Panama,ITA,Italy,2009,28,6,22
PAN,Panama,ITA,Italy,2010,36,10,26
PAN,Panama,ITA,Italy,2011,28,2,26
PAN,Panama,ITA,Italy,2012,24,4,20
PAN,Panama,ITA,Italy,2013,24,3,21
PAN,Panama,ITA,Italy,2014,20,2,18
PAN,Panama,ITA,Italy,2015,19,8,11
PAN,Panama,ITA,Italy,2016,21,0,21
PAN,Panama,ITA,Italy,2017,31,6,25
PAN,Panama,JPN,Japan,2008,68,70,-2
PAN,Panama,JPN,Japan,2009,70,69,1
PAN,Panama,JPN,Japan,2010,56,54,2
PAN,Panama,JPN,Japan,2011,53,49,4
PAN,Panama,JPN,Japan,2012,115,112,3
PAN,Panama,JPN,Japan,2013,69,68,1
PAN,Panama,JPN,Japan,2014,78,71,7
PAN,Panama,JPN,Japan,2015,100,92,8
PAN,Panama,JPN,Japan,2016,152,142,10
PAN,Panama,JPN,Japan,2017,90,92,-2
PAN,Panama,KOR,Korea,2008,9,3,6
PAN,Panama,KOR,Korea,2009,12,3,9
PAN,Panama,KOR,Korea,2010,10,6,4
PAN,Panama,KOR,Korea,2011,5,7,-2
PAN,Panama,KOR,Korea,2012,12,10,2
PAN,Panama,KOR,Korea,2013,13,9,4
PAN,Panama,KOR,Korea,2014,15,6,9
PAN,Panama,KOR,Korea,2015,21,13,8
PAN,Panama,KOR,Korea,2016,19,13,6
PAN,Panama,KOR,Korea,2017,12,24,-12
PAN,Panama,LUX,Luxembourg,2008,1,1,0
PAN,Panama,LUX,Luxembourg,2009,0,0,0
PAN,Panama,LUX,Luxembourg,2010,1,1,0
PAN,Panama,LUX,Luxembourg,2011,2,0,2
PAN,Panama,LUX,Luxembourg,2012,3,0,3
PAN,Panama,LUX,Luxembourg,2013,0,3,-3
PAN,Panama,LUX,Luxembourg,2014,2,0,2
PAN,Panama,LUX,Luxembourg,2015,0,0,0
PAN,Panama,LUX,Luxembourg,2016,1,2,-1
PAN,Panama,LUX,Luxembourg,2017,0,0,0
PAN,Panama,MEX,Mexico,2008,81,0,81
PAN,Panama,MEX,Mexico,2009,126,0,126
PAN,Panama,MEX,Mexico,2010,92,0,92
PAN,Panama,MEX,Mexico,2011,60,0,60
PAN,Panama,MEX,Mexico,2012,41,0,41
PAN,Panama,MEX,Mexico,2013,215,0,215
PAN,Panama,MEX,Mexico,2014,140,0,140
PAN,Panama,MEX,Mexico,2015,87,0,87
PAN,Panama,MEX,Mexico,2016,80,0,80
PAN,Panama,MEX,Mexico,2017,58,0,58
PAN,Panama,NLD,Netherlands,2008,6,3,3
PAN,Panama,NLD,Netherlands,2009,13,12,1
PAN,Panama,NLD,Netherlands,2010,9,8,1
PAN,Panama,NLD,Netherlands,2011,15,5,10
PAN,Panama,NLD,Netherlands,2012,13,6,7
PAN,Panama,NLD,Netherlands,2013,24,9,15
PAN,Panama,NLD,Netherlands,2014,5,10,-5
PAN,Panama,NLD,Netherlands,2015,15,6,9
PAN,Panama,NLD,Netherlands,2016,17,7,10
PAN,Panama,NLD,Netherlands,2017,23,13,10
PAN,Panama,NZL,New Zealand,2008,7,0,7
PAN,Panama,NZL,New Zealand,2009,5,1,4
PAN,Panama,NZL,New Zealand,2010,3,7,-4
PAN,Panama,NZL,New Zealand,2011,2,0,2
PAN,Panama,NZL,New Zealand,2012,0,1,-1
PAN,Panama,NZL,New Zealand,2013,2,0,2
PAN,Panama,NZL,New Zealand,2016,1,0,1
PAN,Panama,NZL,New Zealand,2017,4,0,4
PAN,Panama,NOR,Norway,2008,4,3,1
PAN,Panama,NOR,Norway,2009,8,2,6
PAN,Panama,NOR,Norway,2010,3,3,0
PAN,Panama,NOR,Norway,2011,4,2,2
PAN,Panama,NOR,Norway,2012,4,5,-1
PAN,Panama,NOR,Norway,2013,6,5,1
PAN,Panama,NOR,Norway,2014,3,2,1
PAN,Panama,NOR,Norway,2015,6,1,5
PAN,Panama,NOR,Norway,2016,13,2,11
PAN,Panama,NOR,Norway,2017,2,0,2
PAN,Panama,POL,Poland,2009,2,0,2
PAN,Panama,POL,Poland,2010,2,0,2
PAN,Panama,POL,Poland,2011,5,0,5
PAN,Panama,POL,Poland,2012,1,0,1
PAN,Panama,POL,Poland,2013,3,0,3
PAN,Panama,POL,Poland,2014,3,0,3
PAN,Panama,POL,Poland,2015,4,0,4
PAN,Panama,POL,Poland,2016,5,0,5
PAN,Panama,POL,Poland,2017,7,0,7
PAN,Panama,SVK,Slovak Republic,2008,0,0,0
PAN,Panama,SVK,Slovak Republic,2009,1,0,1
PAN,Panama,SVK,Slovak Republic,2010,1,0,1
PAN,Panama,SVK,Slovak Republic,2011,1,0,1
PAN,Panama,ESP,Spain,2008,407,211,196
PAN,Panama,ESP,Spain,2009,342,238,104
PAN,Panama,ESP,Spain,2010,280,221,59
PAN,Panama,ESP,Spain,2011,325,318,7
PAN,Panama,ESP,Spain,2012,298,247,51
PAN,Panama,ESP,Spain,2013,289,317,-28
PAN,Panama,ESP,Spain,2014,306,156,150
PAN,Panama,ESP,Spain,2015,345,146,199
PAN,Panama,ESP,Spain,2016,495,141,354
PAN,Panama,ESP,Spain,2017,643,288,355
PAN,Panama,SWE,Sweden,2008,4,2,2
PAN,Panama,SWE,Sweden,2009,14,3,11
PAN,Panama,SWE,Sweden,2010,11,2,9
PAN,Panama,SWE,Sweden,2011,12,3,9
PAN,Panama,SWE,Sweden,2012,11,6,5
PAN,Panama,SWE,Sweden,2013,10,4,6
PAN,Panama,SWE,Sweden,2014,14,2,12
PAN,Panama,SWE,Sweden,2015,3,1,2
PAN,Panama,SWE,Sweden,2016,14,5,9
PAN,Panama,SWE,Sweden,2017,9,6,3
PAN,Panama,CHE,Switzerland,2010,30,36,-6
PAN,Panama,CHE,Switzerland,2011,35,64,-29
PAN,Panama,CHE,Switzerland,2012,39,70,-31
PAN,Panama,CHE,Switzerland,2013,26,23,3
PAN,Panama,CHE,Switzerland,2014,22,16,6
PAN,Panama,CHE,Switzerland,2015,21,10,11
PAN,Panama,CHE,Switzerland,2016,30,20,10
PAN,Panama,CHE,Switzerland,2017,63,17,46
PAN,Panama,TUR,Turkey,2010,1,0,1
PAN,Panama,USA,United States,2008,1678,0,1678
PAN,Panama,USA,United States,2009,1806,0,1806
PAN,Panama,USA,United States,2010,1536,0,1536
PAN,Panama,USA,United States,2011,1374,0,1374
PAN,Panama,USA,United States,2012,1281,0,1281
PAN,Panama,USA,United States,2013,1234,0,1234
PAN,Panama,USA,United States,2014,1095,0,1095
PAN,Panama,USA,United States,2015,1052,0,1052
PAN,Panama,USA,United States,2016,1029,0,1029
PAN,Panama,USA,United States,2017,889,0,889
PAN,Panama,CHL,Chile,2008,197,0,197
PAN,Panama,CHL,Chile,2009,193,0,193
PAN,Panama,CHL,Chile,2010,54,0,54
PAN,Panama,CHL,Chile,2011,66,0,66
PAN,Panama,CHL,Chile,2012,64,0,64
PAN,Panama,CHL,Chile,2013,72,0,72
PAN,Panama,CHL,Chile,2014,64,0,64
PAN,Panama,CHL,Chile,2015,48,0,48
PAN,Panama,CHL,Chile,2016,65,0,65
PAN,Panama,EST,Estonia,2008,0,0,0
PAN,Panama,EST,Estonia,2009,0,0,0
PAN,Panama,EST,Estonia,2010,0,0,0
PAN,Panama,EST,Estonia,2011,0,0,0
PAN,Panama,EST,Estonia,2012,0,0,0
PAN,Panama,EST,Estonia,2013,0,0,0
PAN,Panama,EST,Estonia,2014,0,0,0
PAN,Panama,EST,Estonia,2015,1,0,1
PAN,Panama,EST,Estonia,2016,2,0,2
PAN,Panama,EST,Estonia,2017,0,0,0
PAN,Panama,SVN,Slovenia,2011,1,0,1
PAN,Panama,SVN,Slovenia,2013,1,0,1
PNG,Papua New Guinea,AUS,Australia,2008,356,186,170
PNG,Papua New Guinea,AUS,Australia,2009,447,156,291
PNG,Papua New Guinea,AUS,Australia,2010,515,175,340
PNG,Papua New Guinea,AUS,Australia,2011,601,156,445
PNG,Papua New Guinea,AUS,Australia,2012,550,152,398
PNG,Papua New Guinea,AUS,Australia,2013,382,141,241
PNG,Papua New Guinea,AUS,Australia,2014,276,144,132
PNG,Papua New Guinea,AUS,Australia,2015,332,200,132
PNG,Papua New Guinea,AUS,Australia,2016,313,100,213
PNG,Papua New Guinea,AUS,Australia,2017,271,0,271
PNG,Papua New Guinea,AUT,Austria,2008,0,1,-1
PNG,Papua New Guinea,AUT,Austria,2009,1,1,0
PNG,Papua New Guinea,AUT,Austria,2010,1,1,0
PNG,Papua New Guinea,AUT,Austria,2011,0,2,-2
PNG,Papua New Guinea,AUT,Austria,2012,0,1,-1
PNG,Papua New Guinea,AUT,Austria,2013,0,0,0
PNG,Papua New Guinea,AUT,Austria,2014,2,0,2
PNG,Papua New Guinea,AUT,Austria,2015,0,1,-1
PNG,Papua New Guinea,AUT,Austria,2016,2,0,2
PNG,Papua New Guinea,AUT,Austria,2017,0,3,-3
PNG,Papua New Guinea,BEL,Belgium,2008,0,0,0
PNG,Papua New Guinea,BEL,Belgium,2009,0,0,0
PNG,Papua New Guinea,BEL,Belgium,2010,0,0,0
PNG,Papua New Guinea,BEL,Belgium,2014,1,0,1
PNG,Papua New Guinea,CAN,Canada,2008,9,0,9
PNG,Papua New Guinea,CAN,Canada,2009,1,0,1
PNG,Papua New Guinea,CAN,Canada,2010,3,0,3
PNG,Papua New Guinea,CAN,Canada,2011,0,0,0
PNG,Papua New Guinea,CAN,Canada,2012,3,0,3
PNG,Papua New Guinea,CAN,Canada,2013,3,0,3
PNG,Papua New Guinea,CAN,Canada,2014,0,0,0
PNG,Papua New Guinea,CAN,Canada,2015,7,0,7
PNG,Papua New Guinea,CAN,Canada,2016,5,0,5
PNG,Papua New Guinea,CAN,Canada,2017,5,0,5
PNG,Papua New Guinea,CZE,Czech Republic,2014,1,0,1
PNG,Papua New Guinea,DNK,Denmark,2012,0,0,0
PNG,Papua New Guinea,DNK,Denmark,2013,0,0,0
PNG,Papua New Guinea,DNK,Denmark,2014,0,0,0
PNG,Papua New Guinea,DNK,Denmark,2015,0,0,0
PNG,Papua New Guinea,DNK,Denmark,2016,0,0,0
PNG,Papua New Guinea,DNK,Denmark,2017,0,1,-1
PNG,Papua New Guinea,FIN,Finland,2008,0,0,0
PNG,Papua New Guinea,FIN,Finland,2009,0,0,0
PNG,Papua New Guinea,FIN,Finland,2010,0,0,0
PNG,Papua New Guinea,FIN,Finland,2011,0,0,0
PNG,Papua New Guinea,FIN,Finland,2012,0,0,0
PNG,Papua New Guinea,FIN,Finland,2013,0,0,0
PNG,Papua New Guinea,FIN,Finland,2014,1,0,1
PNG,Papua New Guinea,FIN,Finland,2015,0,0,0
PNG,Papua New Guinea,FIN,Finland,2016,0,0,0
PNG,Papua New Guinea,FIN,Finland,2017,0,0,0
PNG,Papua New Guinea,FRA,France,2008,1,0,1
PNG,Papua New Guinea,FRA,France,2009,0,0,0
PNG,Papua New Guinea,FRA,France,2010,0,0,0
PNG,Papua New Guinea,FRA,France,2011,1,0,1
PNG,Papua New Guinea,FRA,France,2012,1,0,1
PNG,Papua New Guinea,FRA,France,2013,1,0,1
PNG,Papua New Guinea,FRA,France,2014,0,0,0
PNG,Papua New Guinea,FRA,France,2015,3,0,3
PNG,Papua New Guinea,FRA,France,2016,0,0,0
PNG,Papua New Guinea,FRA,France,2017,2,0,2
PNG,Papua New Guinea,DEU,Germany,2008,2,5,-3
PNG,Papua New Guinea,DEU,Germany,2009,12,5,7
PNG,Papua New Guinea,DEU,Germany,2010,11,3,8
PNG,Papua New Guinea,DEU,Germany,2011,6,7,-1
PNG,Papua New Guinea,DEU,Germany,2012,6,1,5
PNG,Papua New Guinea,DEU,Germany,2013,12,3,9
PNG,Papua New Guinea,DEU,Germany,2014,2,7,-5
PNG,Papua New Guinea,DEU,Germany,2015,11,7,4
PNG,Papua New Guinea,DEU,Germany,2016,14,6,8
PNG,Papua New Guinea,DEU,Germany,2017,14,3,11
PNG,Papua New Guinea,HUN,Hungary,2008,0,0,0
PNG,Papua New Guinea,HUN,Hungary,2009,0,0,0
PNG,Papua New Guinea,HUN,Hungary,2010,0,0,0
PNG,Papua New Guinea,HUN,Hungary,2011,0,1,-1
PNG,Papua New Guinea,HUN,Hungary,2012,0,0,0
PNG,Papua New Guinea,HUN,Hungary,2013,0,0,0
PNG,Papua New Guinea,HUN,Hungary,2014,2,0,2
PNG,Papua New Guinea,HUN,Hungary,2015,0,0,0
PNG,Papua New Guinea,HUN,Hungary,2016,0,0,0
PNG,Papua New Guinea,HUN,Hungary,2017,0,0,0
PNG,Papua New Guinea,ISL,Iceland,2008,0,0,0
PNG,Papua New Guinea,ISL,Iceland,2009,0,0,0
PNG,Papua New Guinea,ISL,Iceland,2010,0,0,0
PNG,Papua New Guinea,ISL,Iceland,2011,0,0,0
PNG,Papua New Guinea,ISL,Iceland,2012,2,0,2
PNG,Papua New Guinea,ISL,Iceland,2013,1,0,1
PNG,Papua New Guinea,ISL,Iceland,2014,1,4,-3
PNG,Papua New Guinea,ISL,Iceland,2015,1,1,0
PNG,Papua New Guinea,ISL,Iceland,2016,0,0,0
PNG,Papua New Guinea,ISL,Iceland,2017,0,0,0
PNG,Papua New Guinea,ITA,Italy,2008,4,0,4
PNG,Papua New Guinea,ITA,Italy,2009,0,0,0
PNG,Papua New Guinea,ITA,Italy,2010,11,0,11
PNG,Papua New Guinea,ITA,Italy,2011,9,2,7
PNG,Papua New Guinea,ITA,Italy,2012,3,1,2
PNG,Papua New Guinea,ITA,Italy,2013,2,0,2
PNG,Papua New Guinea,ITA,Italy,2014,2,0,2
PNG,Papua New Guinea,ITA,Italy,2015,3,0,3
PNG,Papua New Guinea,ITA,Italy,2016,5,0,5
PNG,Papua New Guinea,ITA,Italy,2017,18,0,18
PNG,Papua New Guinea,JPN,Japan,2008,132,136,-4
PNG,Papua New Guinea,JPN,Japan,2009,199,196,3
PNG,Papua New Guinea,JPN,Japan,2010,247,247,0
PNG,Papua New Guinea,JPN,Japan,2011,157,146,11
PNG,Papua New Guinea,JPN,Japan,2012,143,151,-8
PNG,Papua New Guinea,JPN,Japan,2013,163,148,15
PNG,Papua New Guinea,JPN,Japan,2014,137,137,0
PNG,Papua New Guinea,JPN,Japan,2015,221,223,-2
PNG,Papua New Guinea,JPN,Japan,2016,184,169,15
PNG,Papua New Guinea,JPN,Japan,2017,224,220,4
PNG,Papua New Guinea,KOR,Korea,2008,2,0,2
PNG,Papua New Guinea,KOR,Korea,2009,2,0,2
PNG,Papua New Guinea,KOR,Korea,2010,3,1,2
PNG,Papua New Guinea,KOR,Korea,2011,5,6,-1
PNG,Papua New Guinea,KOR,Korea,2012,3,4,-1
PNG,Papua New Guinea,KOR,Korea,2013,4,2,2
PNG,Papua New Guinea,KOR,Korea,2014,10,5,5
PNG,Papua New Guinea,KOR,Korea,2015,21,15,6
PNG,Papua New Guinea,KOR,Korea,2016,4,18,-14
PNG,Papua New Guinea,KOR,Korea,2017,7,6,1
PNG,Papua New Guinea,LUX,Luxembourg,2008,0,0,0
PNG,Papua New Guinea,LUX,Luxembourg,2009,0,0,0
PNG,Papua New Guinea,LUX,Luxembourg,2010,0,0,0
PNG,Papua New Guinea,LUX,Luxembourg,2011,0,0,0
PNG,Papua New Guinea,LUX,Luxembourg,2012,0,0,0
PNG,Papua New Guinea,LUX,Luxembourg,2013,0,0,0
PNG,Papua New Guinea,LUX,Luxembourg,2014,0,0,0
PNG,Papua New Guinea,LUX,Luxembourg,2015,0,0,0
PNG,Papua New Guinea,LUX,Luxembourg,2016,0,0,0
PNG,Papua New Guinea,LUX,Luxembourg,2017,0,0,0
PNG,Papua New Guinea,MEX,Mexico,2012,0,0,0
PNG,Papua New Guinea,MEX,Mexico,2013,0,0,0
PNG,Papua New Guinea,MEX,Mexico,2014,0,0,0
PNG,Papua New Guinea,NLD,Netherlands,2008,3,1,2
PNG,Papua New Guinea,NLD,Netherlands,2009,1,1,0
PNG,Papua New Guinea,NLD,Netherlands,2010,1,0,1
PNG,Papua New Guinea,NLD,Netherlands,2013,2,0,2
PNG,Papua New Guinea,NLD,Netherlands,2014,1,3,-2
PNG,Papua New Guinea,NLD,Netherlands,2015,0,-1,1
PNG,Papua New Guinea,NLD,Netherlands,2016,3,1,2
PNG,Papua New Guinea,NLD,Netherlands,2017,0,2,-2
PNG,Papua New Guinea,NZL,New Zealand,2008,96,80,16
PNG,Papua New Guinea,NZL,New Zealand,2009,123,64,59
PNG,Papua New Guinea,NZL,New Zealand,2010,95,60,35
PNG,Papua New Guinea,NZL,New Zealand,2011,110,114,-4
PNG,Papua New Guinea,NZL,New Zealand,2012,137,58,79
PNG,Papua New Guinea,NZL,New Zealand,2013,88,80,8
PNG,Papua New Guinea,NZL,New Zealand,2014,106,57,49
PNG,Papua New Guinea,NZL,New Zealand,2015,113,51,62
PNG,Papua New Guinea,NZL,New Zealand,2016,112,64,48
PNG,Papua New Guinea,NZL,New Zealand,2017,124,59,65
PNG,Papua New Guinea,NOR,Norway,2008,0,0,0
PNG,Papua New Guinea,NOR,Norway,2009,0,0,0
PNG,Papua New Guinea,NOR,Norway,2010,1,2,-1
PNG,Papua New Guinea,NOR,Norway,2011,0,1,-1
PNG,Papua New Guinea,NOR,Norway,2012,0,1,-1
PNG,Papua New Guinea,NOR,Norway,2013,0,0,0
PNG,Papua New Guinea,NOR,Norway,2014,1,0,1
PNG,Papua New Guinea,NOR,Norway,2015,1,0,1
PNG,Papua New Guinea,NOR,Norway,2016,2,0,2
PNG,Papua New Guinea,NOR,Norway,2017,0,0,0
PNG,Papua New Guinea,POL,Poland,2009,2,0,2
PNG,Papua New Guinea,POL,Poland,2010,0,0,0
PNG,Papua New Guinea,POL,Poland,2011,0,0,0
PNG,Papua New Guinea,POL,Poland,2012,0,0,0
PNG,Papua New Guinea,POL,Poland,2013,0,0,0
PNG,Papua New Guinea,POL,Poland,2014,0,0,0
PNG,Papua New Guinea,POL,Poland,2015,0,0,0
PNG,Papua New Guinea,POL,Poland,2016,0,0,0
PNG,Papua New Guinea,POL,Poland,2017,0,0,0
PNG,Papua New Guinea,SVK,Slovak Republic,2008,0,0,0
PNG,Papua New Guinea,ESP,Spain,2008,0,0,0
PNG,Papua New Guinea,ESP,Spain,2009,3,0,3
PNG,Papua New Guinea,ESP,Spain,2010,0,0,0
PNG,Papua New Guinea,ESP,Spain,2011,0,2,-2
PNG,Papua New Guinea,ESP,Spain,2012,2,1,1
PNG,Papua New Guinea,ESP,Spain,2013,1,4,-3
PNG,Papua New Guinea,ESP,Spain,2014,0,0,0
PNG,Papua New Guinea,ESP,Spain,2015,1,0,1
PNG,Papua New Guinea,ESP,Spain,2016,0,1,-1
PNG,Papua New Guinea,ESP,Spain,2017,2,2,0
PNG,Papua New Guinea,SWE,Sweden,2008,0,0,0
PNG,Papua New Guinea,SWE,Sweden,2009,0,0,0
PNG,Papua New Guinea,SWE,Sweden,2010,0,0,0
PNG,Papua New Guinea,SWE,Sweden,2011,0,0,0
PNG,Papua New Guinea,SWE,Sweden,2012,0,0,0
PNG,Papua New Guinea,SWE,Sweden,2013,1,0,1
PNG,Papua New Guinea,SWE,Sweden,2014,0,0,0
PNG,Papua New Guinea,SWE,Sweden,2015,2,0,2
PNG,Papua New Guinea,SWE,Sweden,2016,1,0,1
PNG,Papua New Guinea,SWE,Sweden,2017,1,1,0
PNG,Papua New Guinea,CHE,Switzerland,2010,2,0,2
PNG,Papua New Guinea,CHE,Switzerland,2011,3,1,2
PNG,Papua New Guinea,CHE,Switzerland,2012,0,2,-2
PNG,Papua New Guinea,CHE,Switzerland,2013,1,2,-1
PNG,Papua New Guinea,CHE,Switzerland,2014,2,0,2
PNG,Papua New Guinea,CHE,Switzerland,2015,0,0,0
PNG,Papua New Guinea,CHE,Switzerland,2016,3,0,3
PNG,Papua New Guinea,CHE,Switzerland,2017,0,0,0
PNG,Papua New Guinea,USA,United States,2008,15,0,15
PNG,Papua New Guinea,USA,United States,2009,19,0,19
PNG,Papua New Guinea,USA,United States,2010,30,0,30
PNG,Papua New Guinea,USA,United States,2011,20,0,20
PNG,Papua New Guinea,USA,United States,2012,21,0,21
PNG,Papua New Guinea,USA,United States,2013,27,0,27
PNG,Papua New Guinea,USA,United States,2014,18,0,18
PNG,Papua New Guinea,USA,United States,2015,11,0,11
PNG,Papua New Guinea,USA,United States,2016,23,0,23
PNG,Papua New Guinea,USA,United States,2017,18,0,18
PNG,Papua New Guinea,CHL,Chile,2008,0,0,0
PNG,Papua New Guinea,CHL,Chile,2009,0,0,0
PNG,Papua New Guinea,CHL,Chile,2010,0,0,0
PNG,Papua New Guinea,CHL,Chile,2011,0,0,0
PNG,Papua New Guinea,CHL,Chile,2012,0,0,0
PNG,Papua New Guinea,CHL,Chile,2013,0,0,0
PNG,Papua New Guinea,CHL,Chile,2014,0,0,0
PNG,Papua New Guinea,CHL,Chile,2015,0,0,0
PNG,Papua New Guinea,CHL,Chile,2016,0,0,0
PNG,Papua New Guinea,EST,Estonia,2008,0,0,0
PNG,Papua New Guinea,EST,Estonia,2009,0,0,0
PNG,Papua New Guinea,EST,Estonia,2010,0,0,0
PNG,Papua New Guinea,EST,Estonia,2011,0,0,0
PNG,Papua New Guinea,EST,Estonia,2012,0,0,0
PNG,Papua New Guinea,EST,Estonia,2013,0,0,0
PNG,Papua New Guinea,EST,Estonia,2014,0,0,0
PNG,Papua New Guinea,EST,Estonia,2015,0,0,0
PNG,Papua New Guinea,EST,Estonia,2016,0,0,0
PNG,Papua New Guinea,EST,Estonia,2017,0,0,0
PRY,Paraguay,AUS,Australia,2008,7,5,2
PRY,Paraguay,AUS,Australia,2009,10,6,4
PRY,Paraguay,AUS,Australia,2010,12,6,6
PRY,Paraguay,AUS,Australia,2011,3,5,-2
PRY,Paraguay,AUS,Australia,2012,3,5,-2
PRY,Paraguay,AUS,Australia,2013,7,0,7
PRY,Paraguay,AUS,Australia,2014,0,0,0
PRY,Paraguay,AUS,Australia,2015,0,0,0
PRY,Paraguay,AUS,Australia,2016,8,0,8
PRY,Paraguay,AUS,Australia,2017,8,0,8
PRY,Paraguay,AUT,Austria,2008,24,10,14
PRY,Paraguay,AUT,Austria,2009,25,18,7
PRY,Paraguay,AUT,Austria,2010,26,23,3
PRY,Paraguay,AUT,Austria,2011,16,16,0
PRY,Paraguay,AUT,Austria,2012,11,8,3
PRY,Paraguay,AUT,Austria,2013,19,14,5
PRY,Paraguay,AUT,Austria,2014,16,14,2
PRY,Paraguay,AUT,Austria,2015,19,8,11
PRY,Paraguay,AUT,Austria,2016,11,13,-2
PRY,Paraguay,AUT,Austria,2017,10,14,-4
PRY,Paraguay,BEL,Belgium,2008,32,0,32
PRY,Paraguay,BEL,Belgium,2009,38,0,38
PRY,Paraguay,BEL,Belgium,2010,42,7,35
PRY,Paraguay,BEL,Belgium,2012,31,12,19
PRY,Paraguay,BEL,Belgium,2013,29,13,16
PRY,Paraguay,BEL,Belgium,2014,21,10,11
PRY,Paraguay,BEL,Belgium,2015,29,8,21
PRY,Paraguay,BEL,Belgium,2016,25,4,21
PRY,Paraguay,BEL,Belgium,2017,23,10,13
PRY,Paraguay,CAN,Canada,2008,94,0,94
PRY,Paraguay,CAN,Canada,2009,88,0,88
PRY,Paraguay,CAN,Canada,2010,89,0,89
PRY,Paraguay,CAN,Canada,2011,83,0,83
PRY,Paraguay,CAN,Canada,2012,55,0,55
PRY,Paraguay,CAN,Canada,2013,66,0,66
PRY,Paraguay,CAN,Canada,2014,38,0,38
PRY,Paraguay,CAN,Canada,2015,36,0,36
PRY,Paraguay,CAN,Canada,2016,40,0,40
PRY,Paraguay,CAN,Canada,2017,60,0,60
PRY,Paraguay,CZE,Czech Republic,2008,5,0,5
PRY,Paraguay,CZE,Czech Republic,2009,3,0,3
PRY,Paraguay,CZE,Czech Republic,2010,4,0,4
PRY,Paraguay,CZE,Czech Republic,2011,2,0,2
PRY,Paraguay,CZE,Czech Republic,2012,4,3,1
PRY,Paraguay,CZE,Czech Republic,2013,1,4,-3
PRY,Paraguay,CZE,Czech Republic,2014,4,0,4
PRY,Paraguay,CZE,Czech Republic,2015,2,6,-4
PRY,Paraguay,CZE,Czech Republic,2016,3,3,0
PRY,Paraguay,DNK,Denmark,2008,3,2,1
PRY,Paraguay,DNK,Denmark,2009,1,4,-3
PRY,Paraguay,DNK,Denmark,2010,6,0,6
PRY,Paraguay,DNK,Denmark,2011,1,5,-4
PRY,Paraguay,DNK,Denmark,2012,5,4,1
PRY,Paraguay,DNK,Denmark,2013,2,2,0
PRY,Paraguay,DNK,Denmark,2014,8,6,2
PRY,Paraguay,DNK,Denmark,2015,6,3,3
PRY,Paraguay,DNK,Denmark,2016,4,2,2
PRY,Paraguay,DNK,Denmark,2017,2,4,-2
PRY,Paraguay,FIN,Finland,2008,1,1,0
PRY,Paraguay,FIN,Finland,2009,5,0,5
PRY,Paraguay,FIN,Finland,2010,0,0,0
PRY,Paraguay,FIN,Finland,2011,2,0,2
PRY,Paraguay,FIN,Finland,2012,3,0,3
PRY,Paraguay,FIN,Finland,2013,1,0,1
PRY,Paraguay,FIN,Finland,2014,4,0,4
PRY,Paraguay,FIN,Finland,2015,2,0,2
PRY,Paraguay,FIN,Finland,2016,1,0,1
PRY,Paraguay,FIN,Finland,2017,0,0,0
PRY,Paraguay,FRA,France,2008,28,0,28
PRY,Paraguay,FRA,France,2009,58,0,58
PRY,Paraguay,FRA,France,2010,37,0,37
PRY,Paraguay,FRA,France,2011,31,0,31
PRY,Paraguay,FRA,France,2012,42,0,42
PRY,Paraguay,FRA,France,2013,83,0,83
PRY,Paraguay,FRA,France,2014,54,0,54
PRY,Paraguay,FRA,France,2015,61,0,61
PRY,Paraguay,FRA,France,2016,64,0,64
PRY,Paraguay,FRA,France,2017,73,0,73
PRY,Paraguay,DEU,Germany,2008,184,185,-1
PRY,Paraguay,DEU,Germany,2009,193,175,18
PRY,Paraguay,DEU,Germany,2010,195,148,47
PRY,Paraguay,DEU,Germany,2011,201,148,53
PRY,Paraguay,DEU,Germany,2012,205,130,75
PRY,Paraguay,DEU,Germany,2013,209,159,50
PRY,Paraguay,DEU,Germany,2014,242,160,82
PRY,Paraguay,DEU,Germany,2015,231,178,53
PRY,Paraguay,DEU,Germany,2016,231,132,99
PRY,Paraguay,DEU,Germany,2017,209,158,51
PRY,Paraguay,HUN,Hungary,2008,3,0,3
PRY,Paraguay,HUN,Hungary,2009,0,1,-1
PRY,Paraguay,HUN,Hungary,2010,2,1,1
PRY,Paraguay,HUN,Hungary,2011,2,1,1
PRY,Paraguay,HUN,Hungary,2012,0,0,0
PRY,Paraguay,HUN,Hungary,2013,0,1,-1
PRY,Paraguay,HUN,Hungary,2014,2,0,2
PRY,Paraguay,HUN,Hungary,2015,1,3,-2
PRY,Paraguay,HUN,Hungary,2016,0,1,-1
PRY,Paraguay,HUN,Hungary,2017,0,0,0
PRY,Paraguay,ISL,Iceland,2008,0,1,-1
PRY,Paraguay,ISL,Iceland,2009,0,0,0
PRY,Paraguay,ISL,Iceland,2010,1,0,1
PRY,Paraguay,ISL,Iceland,2011,1,0,1
PRY,Paraguay,ISL,Iceland,2012,2,2,0
PRY,Paraguay,ISL,Iceland,2013,0,0,0
PRY,Paraguay,ISL,Iceland,2014,0,1,-1
PRY,Paraguay,ISL,Iceland,2015,0,1,-1
PRY,Paraguay,ISL,Iceland,2016,0,0,0
PRY,Paraguay,ISL,Iceland,2017,0,0,0
PRY,Paraguay,ITA,Italy,2008,208,8,200
PRY,Paraguay,ITA,Italy,2009,260,9,251
PRY,Paraguay,ITA,Italy,2010,320,7,313
PRY,Paraguay,ITA,Italy,2011,207,12,195
PRY,Paraguay,ITA,Italy,2012,183,24,159
PRY,Paraguay,ITA,Italy,2013,155,17,138
PRY,Paraguay,ITA,Italy,2014,120,16,104
PRY,Paraguay,ITA,Italy,2015,94,9,85
PRY,Paraguay,ITA,Italy,2016,93,0,93
PRY,Paraguay,ITA,Italy,2017,91,12,79
PRY,Paraguay,JPN,Japan,2008,286,217,69
PRY,Paraguay,JPN,Japan,2009,147,297,-150
PRY,Paraguay,JPN,Japan,2010,242,191,51
PRY,Paraguay,JPN,Japan,2011,182,161,21
PRY,Paraguay,JPN,Japan,2012,255,181,74
PRY,Paraguay,JPN,Japan,2013,212,172,40
PRY,Paraguay,JPN,Japan,2014,210,137,73
PRY,Paraguay,JPN,Japan,2015,256,127,129
PRY,Paraguay,JPN,Japan,2016,231,127,104
PRY,Paraguay,JPN,Japan,2017,199,96,103
PRY,Paraguay,KOR,Korea,2008,33,25,8
PRY,Paraguay,KOR,Korea,2009,37,24,13
PRY,Paraguay,KOR,Korea,2010,35,20,15
PRY,Paraguay,KOR,Korea,2011,24,8,16
PRY,Paraguay,KOR,Korea,2012,27,22,5
PRY,Paraguay,KOR,Korea,2013,30,17,13
PRY,Paraguay,KOR,Korea,2014,16,13,3
PRY,Paraguay,KOR,Korea,2015,19,16,3
PRY,Paraguay,KOR,Korea,2016,26,16,10
PRY,Paraguay,KOR,Korea,2017,33,21,12
PRY,Paraguay,LUX,Luxembourg,2008,2,0,2
PRY,Paraguay,LUX,Luxembourg,2009,4,1,3
PRY,Paraguay,LUX,Luxembourg,2010,0,0,0
PRY,Paraguay,LUX,Luxembourg,2011,2,0,2
PRY,Paraguay,LUX,Luxembourg,2012,2,0,2
PRY,Paraguay,LUX,Luxembourg,2013,2,2,0
PRY,Paraguay,LUX,Luxembourg,2014,2,1,1
PRY,Paraguay,LUX,Luxembourg,2015,0,0,0
PRY,Paraguay,LUX,Luxembourg,2016,1,0,1
PRY,Paraguay,LUX,Luxembourg,2017,2,5,-3
PRY,Paraguay,MEX,Mexico,2008,29,0,29
PRY,Paraguay,MEX,Mexico,2009,58,0,58
PRY,Paraguay,MEX,Mexico,2010,55,0,55
PRY,Paraguay,MEX,Mexico,2011,46,0,46
PRY,Paraguay,MEX,Mexico,2012,29,0,29
PRY,Paraguay,MEX,Mexico,2013,111,0,111
PRY,Paraguay,MEX,Mexico,2014,79,0,79
PRY,Paraguay,MEX,Mexico,2015,56,0,56
PRY,Paraguay,MEX,Mexico,2016,62,0,62
PRY,Paraguay,MEX,Mexico,2017,48,0,48
PRY,Paraguay,NLD,Netherlands,2008,9,2,7
PRY,Paraguay,NLD,Netherlands,2009,8,5,3
PRY,Paraguay,NLD,Netherlands,2010,6,3,3
PRY,Paraguay,NLD,Netherlands,2011,9,1,8
PRY,Paraguay,NLD,Netherlands,2012,7,5,2
PRY,Paraguay,NLD,Netherlands,2013,11,0,11
PRY,Paraguay,NLD,Netherlands,2014,10,4,6
PRY,Paraguay,NLD,Netherlands,2015,10,8,2
PRY,Paraguay,NLD,Netherlands,2016,10,10,0
PRY,Paraguay,NLD,Netherlands,2017,13,11,2
PRY,Paraguay,NZL,New Zealand,2008,4,1,3
PRY,Paraguay,NZL,New Zealand,2009,9,8,1
PRY,Paraguay,NZL,New Zealand,2010,6,1,5
PRY,Paraguay,NZL,New Zealand,2011,4,3,1
PRY,Paraguay,NZL,New Zealand,2012,2,0,2
PRY,Paraguay,NZL,New Zealand,2013,3,2,1
PRY,Paraguay,NZL,New Zealand,2014,1,0,1
PRY,Paraguay,NZL,New Zealand,2015,2,0,2
PRY,Paraguay,NZL,New Zealand,2016,6,0,6
PRY,Paraguay,NOR,Norway,2008,18,3,15
PRY,Paraguay,NOR,Norway,2009,8,2,6
PRY,Paraguay,NOR,Norway,2010,7,43,-36
PRY,Paraguay,NOR,Norway,2011,4,10,-6
PRY,Paraguay,NOR,Norway,2012,7,5,2
PRY,Paraguay,NOR,Norway,2013,5,2,3
PRY,Paraguay,NOR,Norway,2014,11,1,10
PRY,Paraguay,NOR,Norway,2015,4,1,3
PRY,Paraguay,NOR,Norway,2016,10,4,6
PRY,Paraguay,NOR,Norway,2017,5,2,3
PRY,Paraguay,POL,Poland,2009,8,0,8
PRY,Paraguay,POL,Poland,2010,8,0,8
PRY,Paraguay,POL,Poland,2011,3,0,3
PRY,Paraguay,POL,Poland,2012,9,0,9
PRY,Paraguay,POL,Poland,2013,4,0,4
PRY,Paraguay,POL,Poland,2014,1,0,1
PRY,Paraguay,POL,Poland,2015,4,0,4
PRY,Paraguay,POL,Poland,2016,5,0,5
PRY,Paraguay,POL,Poland,2017,7,0,7
PRY,Paraguay,SVK,Slovak Republic,2008,3,1,2
PRY,Paraguay,SVK,Slovak Republic,2009,2,2,0
PRY,Paraguay,SVK,Slovak Republic,2010,1,1,0
PRY,Paraguay,SVK,Slovak Republic,2011,1,0,1
PRY,Paraguay,ESP,Spain,2008,17407,4602,12805
PRY,Paraguay,ESP,Spain,2009,10765,7157,3608
PRY,Paraguay,ESP,Spain,2010,9371,8105,1266
PRY,Paraguay,ESP,Spain,2011,8224,10169,-1945
PRY,Paraguay,ESP,Spain,2012,4797,12342,-7545
PRY,Paraguay,ESP,Spain,2013,3762,14270,-10508
PRY,Paraguay,ESP,Spain,2014,4239,6959,-2720
PRY,Paraguay,ESP,Spain,2015,4668,4022,646
PRY,Paraguay,ESP,Spain,2016,7169,3314,3855
PRY,Paraguay,ESP,Spain,2017,8384,3428,4956
PRY,Paraguay,SWE,Sweden,2008,7,0,7
PRY,Paraguay,SWE,Sweden,2009,10,0,10
PRY,Paraguay,SWE,Sweden,2010,8,3,5
PRY,Paraguay,SWE,Sweden,2011,5,0,5
PRY,Paraguay,SWE,Sweden,2012,9,0,9
PRY,Paraguay,SWE,Sweden,2013,4,0,4
PRY,Paraguay,SWE,Sweden,2014,4,2,2
PRY,Paraguay,SWE,Sweden,2015,4,2,2
PRY,Paraguay,SWE,Sweden,2016,6,4,2
PRY,Paraguay,SWE,Sweden,2017,8,2,6
PRY,Paraguay,CHE,Switzerland,2010,37,13,24
PRY,Paraguay,CHE,Switzerland,2011,49,9,40
PRY,Paraguay,CHE,Switzerland,2012,48,20,28
PRY,Paraguay,CHE,Switzerland,2013,33,11,22
PRY,Paraguay,CHE,Switzerland,2014,43,10,33
PRY,Paraguay,CHE,Switzerland,2015,47,19,28
PRY,Paraguay,CHE,Switzerland,2016,43,14,29
PRY,Paraguay,CHE,Switzerland,2017,54,8,46
PRY,Paraguay,TUR,Turkey,2010,1,0,1
PRY,Paraguay,USA,United States,2008,481,0,481
PRY,Paraguay,USA,United States,2009,530,0,530
PRY,Paraguay,USA,United States,2010,467,0,467
PRY,Paraguay,USA,United States,2011,500,0,500
PRY,Paraguay,USA,United States,2012,467,0,467
PRY,Paraguay,USA,United States,2013,448,0,448
PRY,Paraguay,USA,United States,2014,391,0,391
PRY,Paraguay,USA,United States,2015,382,0,382
PRY,Paraguay,USA,United States,2016,434,0,434
PRY,Paraguay,USA,United States,2017,391,0,391
PRY,Paraguay,CHL,Chile,2008,423,0,423
PRY,Paraguay,CHL,Chile,2009,381,0,381
PRY,Paraguay,CHL,Chile,2010,415,0,415
PRY,Paraguay,CHL,Chile,2011,564,0,564
PRY,Paraguay,CHL,Chile,2012,614,0,614
PRY,Paraguay,CHL,Chile,2013,735,0,735
PRY,Paraguay,CHL,Chile,2014,679,0,679
PRY,Paraguay,CHL,Chile,2015,775,0,775
PRY,Paraguay,CHL,Chile,2016,757,0,757
PRY,Paraguay,EST,Estonia,2008,0,0,0
PRY,Paraguay,EST,Estonia,2009,0,0,0
PRY,Paraguay,EST,Estonia,2010,0,0,0
PRY,Paraguay,EST,Estonia,2011,0,0,0
PRY,Paraguay,EST,Estonia,2012,0,0,0
PRY,Paraguay,EST,Estonia,2013,1,0,1
PRY,Paraguay,EST,Estonia,2014,0,0,0
PRY,Paraguay,EST,Estonia,2015,0,0,0
PRY,Paraguay,EST,Estonia,2016,0,0,0
PRY,Paraguay,EST,Estonia,2017,0,0,0
PRY,Paraguay,SVN,Slovenia,2009,2,0,2
PRY,Paraguay,SVN,Slovenia,2015,2,0,2
PRY,Paraguay,SVN,Slovenia,2017,1,0,1
PER,Peru,AUS,Australia,2008,323,60,263
PER,Peru,AUS,Australia,2009,375,72,303
PER,Peru,AUS,Australia,2010,358,67,291
PER,Peru,AUS,Australia,2011,343,60,283
PER,Peru,AUS,Australia,2012,340,76,264
PER,Peru,AUS,Australia,2013,376,76,300
PER,Peru,AUS,Australia,2014,290,70,220
PER,Peru,AUS,Australia,2015,257,100,157
PER,Peru,AUS,Australia,2016,225,100,125
PER,Peru,AUS,Australia,2017,267,0,267
PER,Peru,AUT,Austria,2008,114,77,37
PER,Peru,AUT,Austria,2009,107,78,29
PER,Peru,AUT,Austria,2010,95,71,24
PER,Peru,AUT,Austria,2011,95,61,34
PER,Peru,AUT,Austria,2012,106,74,32
PER,Peru,AUT,Austria,2013,87,73,14
PER,Peru,AUT,Austria,2014,79,57,22
PER,Peru,AUT,Austria,2015,82,51,31
PER,Peru,AUT,Austria,2016,81,55,26
PER,Peru,AUT,Austria,2017,95,72,23
PER,Peru,BEL,Belgium,2008,223,0,223
PER,Peru,BEL,Belgium,2009,232,0,232
PER,Peru,BEL,Belgium,2010,268,82,186
PER,Peru,BEL,Belgium,2011,200,0,200
PER,Peru,BEL,Belgium,2012,188,86,102
PER,Peru,BEL,Belgium,2013,152,116,36
PER,Peru,BEL,Belgium,2014,98,77,21
PER,Peru,BEL,Belgium,2015,104,69,35
PER,Peru,BEL,Belgium,2016,133,44,89
PER,Peru,BEL,Belgium,2017,167,33,134
PER,Peru,CAN,Canada,2008,1094,0,1094
PER,Peru,CAN,Canada,2009,1881,0,1881
PER,Peru,CAN,Canada,2010,1282,0,1282
PER,Peru,CAN,Canada,2011,886,0,886
PER,Peru,CAN,Canada,2012,787,0,787
PER,Peru,CAN,Canada,2013,683,0,683
PER,Peru,CAN,Canada,2014,712,0,712
PER,Peru,CAN,Canada,2015,559,0,559
PER,Peru,CAN,Canada,2016,435,0,435
PER,Peru,CAN,Canada,2017,425,0,425
PER,Peru,CZE,Czech Republic,2008,24,0,24
PER,Peru,CZE,Czech Republic,2009,30,0,30
PER,Peru,CZE,Czech Republic,2010,19,1,18
PER,Peru,CZE,Czech Republic,2011,21,0,21
PER,Peru,CZE,Czech Republic,2012,18,7,11
PER,Peru,CZE,Czech Republic,2013,20,13,7
PER,Peru,CZE,Czech Republic,2014,18,11,7
PER,Peru,CZE,Czech Republic,2015,30,16,14
PER,Peru,CZE,Czech Republic,2016,16,15,1
PER,Peru,CZE,Czech Republic,2017,30,13,17
PER,Peru,DNK,Denmark,2008,57,19,38
PER,Peru,DNK,Denmark,2009,54,16,38
PER,Peru,DNK,Denmark,2010,52,21,31
PER,Peru,DNK,Denmark,2011,39,27,12
PER,Peru,DNK,Denmark,2012,34,21,13
PER,Peru,DNK,Denmark,2013,34,33,1
PER,Peru,DNK,Denmark,2014,25,25,0
PER,Peru,DNK,Denmark,2015,39,15,24
PER,Peru,DNK,Denmark,2016,30,20,10
PER,Peru,DNK,Denmark,2017,40,27,13
PER,Peru,FIN,Finland,2008,22,12,10
PER,Peru,FIN,Finland,2009,18,3,15
PER,Peru,FIN,Finland,2010,30,7,23
PER,Peru,FIN,Finland,2011,24,8,16
PER,Peru,FIN,Finland,2012,24,5,19
PER,Peru,FIN,Finland,2013,23,3,20
PER,Peru,FIN,Finland,2014,15,6,9
PER,Peru,FIN,Finland,2015,21,9,12
PER,Peru,FIN,Finland,2016,30,3,27
PER,Peru,FIN,Finland,2017,16,2,14
PER,Peru,FRA,France,2008,502,0,502
PER,Peru,FRA,France,2009,487,0,487
PER,Peru,FRA,France,2010,511,0,511
PER,Peru,FRA,France,2011,475,0,475
PER,Peru,FRA,France,2012,531,0,531
PER,Peru,FRA,France,2013,523,0,523
PER,Peru,FRA,France,2014,507,0,507
PER,Peru,FRA,France,2015,409,0,409
PER,Peru,FRA,France,2016,380,0,380
PER,Peru,FRA,France,2017,391,0,391
PER,Peru,DEU,Germany,2008,944,865,79
PER,Peru,DEU,Germany,2009,853,828,25
PER,Peru,DEU,Germany,2010,862,638,224
PER,Peru,DEU,Germany,2011,821,570,251
PER,Peru,DEU,Germany,2012,953,580,373
PER,Peru,DEU,Germany,2013,989,550,439
PER,Peru,DEU,Germany,2014,926,563,363
PER,Peru,DEU,Germany,2015,968,564,404
PER,Peru,DEU,Germany,2016,1101,543,558
PER,Peru,DEU,Germany,2017,1209,565,644
PER,Peru,HUN,Hungary,2008,24,1,23
PER,Peru,HUN,Hungary,2009,19,1,18
PER,Peru,HUN,Hungary,2010,12,1,11
PER,Peru,HUN,Hungary,2011,8,2,6
PER,Peru,HUN,Hungary,2012,10,3,7
PER,Peru,HUN,Hungary,2013,18,0,18
PER,Peru,HUN,Hungary,2014,8,3,5
PER,Peru,HUN,Hungary,2015,13,0,13
PER,Peru,HUN,Hungary,2016,14,0,14
PER,Peru,HUN,Hungary,2017,28,0,28
PER,Peru,ISL,Iceland,2008,5,3,2
PER,Peru,ISL,Iceland,2009,2,2,0
PER,Peru,ISL,Iceland,2010,5,1,4
PER,Peru,ISL,Iceland,2011,1,4,-3
PER,Peru,ISL,Iceland,2012,3,2,1
PER,Peru,ISL,Iceland,2013,5,4,1
PER,Peru,ISL,Iceland,2014,3,1,2
PER,Peru,ISL,Iceland,2015,1,1,0
PER,Peru,ISL,Iceland,2016,5,1,4
PER,Peru,ISL,Iceland,2017,8,0,8
PER,Peru,ITA,Italy,2008,7182,163,7019
PER,Peru,ITA,Italy,2009,10421,181,10240
PER,Peru,ITA,Italy,2010,12166,353,11813
PER,Peru,ITA,Italy,2011,8686,390,8296
PER,Peru,ITA,Italy,2012,5614,430,5184
PER,Peru,ITA,Italy,2013,4338,631,3707
PER,Peru,ITA,Italy,2014,2760,690,2070
PER,Peru,ITA,Italy,2015,1906,541,1365
PER,Peru,ITA,Italy,2016,1701,0,1701
PER,Peru,ITA,Italy,2017,2159,363,1796
PER,Peru,JPN,Japan,2008,1647,627,1020
PER,Peru,JPN,Japan,2009,1121,1447,-326
PER,Peru,JPN,Japan,2010,1193,934,259
PER,Peru,JPN,Japan,2011,749,536,213
PER,Peru,JPN,Japan,2012,1014,514,500
PER,Peru,JPN,Japan,2013,919,349,570
PER,Peru,JPN,Japan,2014,897,309,588
PER,Peru,JPN,Japan,2015,1054,362,692
PER,Peru,JPN,Japan,2016,963,319,644
PER,Peru,JPN,Japan,2017,1061,397,664
PER,Peru,KOR,Korea,2008,141,203,-62
PER,Peru,KOR,Korea,2009,92,198,-106
PER,Peru,KOR,Korea,2010,109,178,-69
PER,Peru,KOR,Korea,2011,110,122,-12
PER,Peru,KOR,Korea,2012,152,193,-41
PER,Peru,KOR,Korea,2013,106,104,2
PER,Peru,KOR,Korea,2014,136,138,-2
PER,Peru,KOR,Korea,2015,153,134,19
PER,Peru,KOR,Korea,2016,142,157,-15
PER,Peru,KOR,Korea,2017,130,135,-5
PER,Peru,LUX,Luxembourg,2008,13,0,13
PER,Peru,LUX,Luxembourg,2009,17,3,14
PER,Peru,LUX,Luxembourg,2010,12,3,9
PER,Peru,LUX,Luxembourg,2011,16,1,15
PER,Peru,LUX,Luxembourg,2012,12,7,5
PER,Peru,LUX,Luxembourg,2013,8,6,2
PER,Peru,LUX,Luxembourg,2014,9,3,6
PER,Peru,LUX,Luxembourg,2015,13,2,11
PER,Peru,LUX,Luxembourg,2016,13,3,10
PER,Peru,LUX,Luxembourg,2017,15,9,6
PER,Peru,MEX,Mexico,2008,412,0,412
PER,Peru,MEX,Mexico,2009,667,0,667
PER,Peru,MEX,Mexico,2010,825,0,825
PER,Peru,MEX,Mexico,2011,550,0,550
PER,Peru,MEX,Mexico,2012,377,0,377
PER,Peru,MEX,Mexico,2013,1226,0,1226
PER,Peru,MEX,Mexico,2014,932,0,932
PER,Peru,MEX,Mexico,2015,630,0,630
PER,Peru,MEX,Mexico,2016,577,0,577
PER,Peru,MEX,Mexico,2017,506,0,506
PER,Peru,NLD,Netherlands,2008,290,165,125
PER,Peru,NLD,Netherlands,2009,243,135,108
PER,Peru,NLD,Netherlands,2010,244,128,116
PER,Peru,NLD,Netherlands,2011,214,108,106
PER,Peru,NLD,Netherlands,2012,204,113,91
PER,Peru,NLD,Netherlands,2013,172,147,25
PER,Peru,NLD,Netherlands,2014,157,100,57
PER,Peru,NLD,Netherlands,2015,176,109,67
PER,Peru,NLD,Netherlands,2016,163,106,57
PER,Peru,NLD,Netherlands,2017,231,128,103
PER,Peru,NZL,New Zealand,2008,24,10,14
PER,Peru,NZL,New Zealand,2009,19,4,15
PER,Peru,NZL,New Zealand,2010,22,10,12
PER,Peru,NZL,New Zealand,2011,48,13,35
PER,Peru,NZL,New Zealand,2012,41,17,24
PER,Peru,NZL,New Zealand,2013,48,7,41
PER,Peru,NZL,New Zealand,2014,71,19,52
PER,Peru,NZL,New Zealand,2015,64,15,49
PER,Peru,NZL,New Zealand,2016,86,21,65
PER,Peru,NZL,New Zealand,2017,99,29,70
PER,Peru,NOR,Norway,2008,77,33,44
PER,Peru,NOR,Norway,2009,103,26,77
PER,Peru,NOR,Norway,2010,80,0,80
PER,Peru,NOR,Norway,2011,56,57,-1
PER,Peru,NOR,Norway,2012,79,31,48
PER,Peru,NOR,Norway,2013,80,34,46
PER,Peru,NOR,Norway,2014,74,28,46
PER,Peru,NOR,Norway,2015,57,53,4
PER,Peru,NOR,Norway,2016,66,33,33
PER,Peru,NOR,Norway,2017,43,24,19
PER,Peru,POL,Poland,2008,72,0,72
PER,Peru,POL,Poland,2009,56,0,56
PER,Peru,POL,Poland,2010,53,0,53
PER,Peru,POL,Poland,2011,40,0,40
PER,Peru,POL,Poland,2012,50,0,50
PER,Peru,POL,Poland,2013,39,0,39
PER,Peru,POL,Poland,2014,34,0,34
PER,Peru,POL,Poland,2015,38,0,38
PER,Peru,POL,Poland,2016,45,0,45
PER,Peru,POL,Poland,2017,40,0,40
PER,Peru,SVK,Slovak Republic,2008,1,1,0
PER,Peru,SVK,Slovak Republic,2009,3,4,-1
PER,Peru,SVK,Slovak Republic,2010,1,1,0
PER,Peru,SVK,Slovak Republic,2011,3,1,2
PER,Peru,SVK,Slovak Republic,2012,1,0,1
PER,Peru,SVK,Slovak Republic,2014,2,0,2
PER,Peru,SVK,Slovak Republic,2015,1,0,1
PER,Peru,SVK,Slovak Republic,2017,1,0,1
PER,Peru,ESP,Spain,2008,27523,4388,23135
PER,Peru,ESP,Spain,2009,13664,6673,6991
PER,Peru,ESP,Spain,2010,8021,8378,-357
PER,Peru,ESP,Spain,2011,7660,9074,-1414
PER,Peru,ESP,Spain,2012,5593,9542,-3949
PER,Peru,ESP,Spain,2013,4844,11065,-6221
PER,Peru,ESP,Spain,2014,4674,5934,-1260
PER,Peru,ESP,Spain,2015,5255,3477,1778
PER,Peru,ESP,Spain,2016,7954,2974,4980
PER,Peru,ESP,Spain,2017,13936,3743,10193
PER,Peru,SWE,Sweden,2008,265,16,249
PER,Peru,SWE,Sweden,2009,275,18,257
PER,Peru,SWE,Sweden,2010,251,27,224
PER,Peru,SWE,Sweden,2011,224,33,191
PER,Peru,SWE,Sweden,2012,205,42,163
PER,Peru,SWE,Sweden,2013,154,39,115
PER,Peru,SWE,Sweden,2014,130,47,83
PER,Peru,SWE,Sweden,2015,141,69,72
PER,Peru,SWE,Sweden,2016,132,42,90
PER,Peru,SWE,Sweden,2017,136,31,105
PER,Peru,CHE,Switzerland,2010,275,117,158
PER,Peru,CHE,Switzerland,2011,260,102,158
PER,Peru,CHE,Switzerland,2012,217,94,123
PER,Peru,CHE,Switzerland,2013,211,73,138
PER,Peru,CHE,Switzerland,2014,191,83,108
PER,Peru,CHE,Switzerland,2015,197,87,110
PER,Peru,CHE,Switzerland,2016,195,84,111
PER,Peru,CHE,Switzerland,2017,222,81,141
PER,Peru,TUR,Turkey,2010,4,0,4
PER,Peru,USA,United States,2008,15184,0,15184
PER,Peru,USA,United States,2009,16957,0,16957
PER,Peru,USA,United States,2010,14247,0,14247
PER,Peru,USA,United States,2011,14064,0,14064
PER,Peru,USA,United States,2012,12609,0,12609
PER,Peru,USA,United States,2013,12564,0,12564
PER,Peru,USA,United States,2014,10606,0,10606
PER,Peru,USA,United States,2015,10148,0,10148
PER,Peru,USA,United States,2016,10940,0,10940
PER,Peru,USA,United States,2017,10115,0,10115
PER,Peru,CHL,Chile,2008,22345,0,22345
PER,Peru,CHL,Chile,2009,14892,0,14892
PER,Peru,CHL,Chile,2010,14746,0,14746
PER,Peru,CHL,Chile,2011,16371,0,16371
PER,Peru,CHL,Chile,2012,18918,0,18918
PER,Peru,CHL,Chile,2013,18925,0,18925
PER,Peru,CHL,Chile,2014,19818,0,19818
PER,Peru,CHL,Chile,2015,24687,0,24687
PER,Peru,CHL,Chile,2016,25482,0,25482
PER,Peru,EST,Estonia,2008,2,0,2
PER,Peru,EST,Estonia,2009,1,0,1
PER,Peru,EST,Estonia,2010,0,0,0
PER,Peru,EST,Estonia,2011,0,0,0
PER,Peru,EST,Estonia,2012,0,0,0
PER,Peru,EST,Estonia,2013,3,0,3
PER,Peru,EST,Estonia,2014,0,0,0
PER,Peru,EST,Estonia,2015,2,0,2
PER,Peru,EST,Estonia,2016,3,0,3
PER,Peru,EST,Estonia,2017,4,0,4
PER,Peru,ISR,Israel,2008,138,0,138
PER,Peru,ISR,Israel,2009,102,0,102
PER,Peru,ISR,Israel,2010,121,0,121
PER,Peru,ISR,Israel,2011,79,0,79
PER,Peru,ISR,Israel,2012,37,0,37
PER,Peru,ISR,Israel,2013,101,0,101
PER,Peru,ISR,Israel,2014,31,0,31
PER,Peru,ISR,Israel,2015,30,0,30
PER,Peru,ISR,Israel,2016,45,0,45
PER,Peru,ISR,Israel,2017,59,0,59
PER,Peru,SVN,Slovenia,2008,8,0,8
PER,Peru,SVN,Slovenia,2009,3,0,3
PER,Peru,SVN,Slovenia,2010,3,0,3
PER,Peru,SVN,Slovenia,2011,9,0,9
PER,Peru,SVN,Slovenia,2012,1,0,1
PER,Peru,SVN,Slovenia,2013,2,0,2
PER,Peru,SVN,Slovenia,2014,1,0,1
PER,Peru,SVN,Slovenia,2015,7,0,7
PER,Peru,SVN,Slovenia,2016,1,0,1
PHL,Philippines,AUS,Australia,2008,7078,760,6318
PHL,Philippines,AUS,Australia,2009,8904,789,8115
PHL,Philippines,AUS,Australia,2010,10248,711,9537
PHL,Philippines,AUS,Australia,2011,10651,850,9801
PHL,Philippines,AUS,Australia,2012,12777,820,11957
PHL,Philippines,AUS,Australia,2013,11032,838,10194
PHL,Philippines,AUS,Australia,2014,10345,926,9419
PHL,Philippines,AUS,Australia,2015,11942,1000,10942
PHL,Philippines,AUS,Australia,2016,11968,900,11068
PHL,Philippines,AUS,Australia,2017,12145,0,12145
PHL,Philippines,AUT,Austria,2008,347,147,200
PHL,Philippines,AUT,Austria,2009,330,159,171
PHL,Philippines,AUT,Austria,2010,241,151,90
PHL,Philippines,AUT,Austria,2011,279,168,111
PHL,Philippines,AUT,Austria,2012,288,122,166
PHL,Philippines,AUT,Austria,2013,341,140,201
PHL,Philippines,AUT,Austria,2014,335,161,174
PHL,Philippines,AUT,Austria,2015,370,159,211
PHL,Philippines,AUT,Austria,2016,315,162,153
PHL,Philippines,AUT,Austria,2017,339,163,176
PHL,Philippines,BEL,Belgium,2008,494,134,360
PHL,Philippines,BEL,Belgium,2009,503,149,354
PHL,Philippines,BEL,Belgium,2010,609,132,477
PHL,Philippines,BEL,Belgium,2011,662,133,529
PHL,Philippines,BEL,Belgium,2012,557,146,411
PHL,Philippines,BEL,Belgium,2013,524,224,300
PHL,Philippines,BEL,Belgium,2014,448,128,320
PHL,Philippines,BEL,Belgium,2015,430,162,268
PHL,Philippines,BEL,Belgium,2016,493,127,366
PHL,Philippines,BEL,Belgium,2017,456,105,351
PHL,Philippines,CAN,Canada,2008,24883,0,24883
PHL,Philippines,CAN,Canada,2009,28568,0,28568
PHL,Philippines,CAN,Canada,2010,38614,0,38614
PHL,Philippines,CAN,Canada,2011,36758,0,36758
PHL,Philippines,CAN,Canada,2012,34299,0,34299
PHL,Philippines,CAN,Canada,2013,29532,0,29532
PHL,Philippines,CAN,Canada,2014,40031,0,40031
PHL,Philippines,CAN,Canada,2015,50825,0,50825
PHL,Philippines,CAN,Canada,2016,41815,0,41815
PHL,Philippines,CAN,Canada,2017,40855,0,40855
PHL,Philippines,CZE,Czech Republic,2008,113,0,113
PHL,Philippines,CZE,Czech Republic,2009,279,0,279
PHL,Philippines,CZE,Czech Republic,2010,100,0,100
PHL,Philippines,CZE,Czech Republic,2011,62,0,62
PHL,Philippines,CZE,Czech Republic,2012,86,42,44
PHL,Philippines,CZE,Czech Republic,2013,71,105,-34
PHL,Philippines,CZE,Czech Republic,2014,169,68,101
PHL,Philippines,CZE,Czech Republic,2015,105,47,58
PHL,Philippines,CZE,Czech Republic,2016,197,55,142
PHL,Philippines,CZE,Czech Republic,2017,317,56,261
PHL,Philippines,DNK,Denmark,2008,1659,777,882
PHL,Philippines,DNK,Denmark,2009,1770,910,860
PHL,Philippines,DNK,Denmark,2010,1842,1214,628
PHL,Philippines,DNK,Denmark,2011,1651,1209,442
PHL,Philippines,DNK,Denmark,2012,1431,1069,362
PHL,Philippines,DNK,Denmark,2013,1653,1133,520
PHL,Philippines,DNK,Denmark,2014,1468,1039,429
PHL,Philippines,DNK,Denmark,2015,1324,953,371
PHL,Philippines,DNK,Denmark,2016,1133,1002,131
PHL,Philippines,DNK,Denmark,2017,1283,1030,253
PHL,Philippines,FIN,Finland,2008,226,17,209
PHL,Philippines,FIN,Finland,2009,207,9,198
PHL,Philippines,FIN,Finland,2010,178,8,170
PHL,Philippines,FIN,Finland,2011,225,12,213
PHL,Philippines,FIN,Finland,2012,290,22,268
PHL,Philippines,FIN,Finland,2013,345,12,333
PHL,Philippines,FIN,Finland,2014,485,19,466
PHL,Philippines,FIN,Finland,2015,379,19,360
PHL,Philippines,FIN,Finland,2016,416,28,388
PHL,Philippines,FIN,Finland,2017,409,23,386
PHL,Philippines,FRA,France,2008,766,0,766
PHL,Philippines,FRA,France,2009,833,0,833
PHL,Philippines,FRA,France,2010,724,0,724
PHL,Philippines,FRA,France,2011,736,0,736
PHL,Philippines,FRA,France,2012,779,0,779
PHL,Philippines,FRA,France,2013,1063,0,1063
PHL,Philippines,FRA,France,2014,1077,0,1077
PHL,Philippines,FRA,France,2015,1162,0,1162
PHL,Philippines,FRA,France,2016,1358,0,1358
PHL,Philippines,FRA,France,2017,1531,0,1531
PHL,Philippines,DEU,Germany,2008,5609,5056,553
PHL,Philippines,DEU,Germany,2009,6037,5575,462
PHL,Philippines,DEU,Germany,2010,5316,4462,854
PHL,Philippines,DEU,Germany,2011,5653,4412,1241
PHL,Philippines,DEU,Germany,2012,4724,4075,649
PHL,Philippines,DEU,Germany,2013,4250,3192,1058
PHL,Philippines,DEU,Germany,2014,4090,3233,857
PHL,Philippines,DEU,Germany,2015,3909,2959,950
PHL,Philippines,DEU,Germany,2016,3665,2390,1275
PHL,Philippines,DEU,Germany,2017,3851,2081,1770
PHL,Philippines,GRC,Greece,2008,771,0,771
PHL,Philippines,GRC,Greece,2009,1077,0,1077
PHL,Philippines,GRC,Greece,2010,522,0,522
PHL,Philippines,GRC,Greece,2011,345,0,345
PHL,Philippines,HUN,Hungary,2008,41,0,41
PHL,Philippines,HUN,Hungary,2009,68,3,65
PHL,Philippines,HUN,Hungary,2010,39,8,31
PHL,Philippines,HUN,Hungary,2011,51,5,46
PHL,Philippines,HUN,Hungary,2012,48,4,44
PHL,Philippines,HUN,Hungary,2013,29,2,27
PHL,Philippines,HUN,Hungary,2014,51,8,43
PHL,Philippines,HUN,Hungary,2015,50,9,41
PHL,Philippines,HUN,Hungary,2016,69,18,51
PHL,Philippines,HUN,Hungary,2017,94,0,94
PHL,Philippines,ISL,Iceland,2008,92,38,54
PHL,Philippines,ISL,Iceland,2009,49,34,15
PHL,Philippines,ISL,Iceland,2010,50,21,29
PHL,Philippines,ISL,Iceland,2011,54,10,44
PHL,Philippines,ISL,Iceland,2012,53,15,38
PHL,Philippines,ISL,Iceland,2013,74,13,61
PHL,Philippines,ISL,Iceland,2014,46,16,30
PHL,Philippines,ISL,Iceland,2015,86,13,73
PHL,Philippines,ISL,Iceland,2016,110,23,87
PHL,Philippines,ISL,Iceland,2017,180,32,148
PHL,Philippines,ITA,Italy,2008,7849,202,7647
PHL,Philippines,ITA,Italy,2009,9995,240,9755
PHL,Philippines,ITA,Italy,2010,10745,298,10447
PHL,Philippines,ITA,Italy,2011,10351,289,10062
PHL,Philippines,ITA,Italy,2012,9893,439,9454
PHL,Philippines,ITA,Italy,2013,7565,401,7164
PHL,Philippines,ITA,Italy,2014,5816,408,5408
PHL,Philippines,ITA,Italy,2015,3773,455,3318
PHL,Philippines,ITA,Italy,2016,3181,0,3181
PHL,Philippines,ITA,Italy,2017,3081,390,2691
PHL,Philippines,JPN,Japan,2008,20973,10711,10262
PHL,Philippines,JPN,Japan,2009,15780,10331,5449
PHL,Philippines,JPN,Japan,2010,13264,9540,3724
PHL,Philippines,JPN,Japan,2011,13599,9089,4510
PHL,Philippines,JPN,Japan,2012,15412,8612,6800
PHL,Philippines,JPN,Japan,2013,16430,9171,7259
PHL,Philippines,JPN,Japan,2014,19912,10236,9676
PHL,Philippines,JPN,Japan,2015,23957,11780,12177
PHL,Philippines,JPN,Japan,2016,26226,12785,13441
PHL,Philippines,JPN,Japan,2017,29617,16756,12861
PHL,Philippines,KOR,Korea,2008,9125,11552,-2427
PHL,Philippines,KOR,Korea,2009,8895,11203,-2308
PHL,Philippines,KOR,Korea,2010,9079,8802,277
PHL,Philippines,KOR,Korea,2011,9565,10944,-1379
PHL,Philippines,KOR,Korea,2012,9858,14393,-4535
PHL,Philippines,KOR,Korea,2013,11963,6891,5072
PHL,Philippines,KOR,Korea,2014,10717,6232,4485
PHL,Philippines,KOR,Korea,2015,9867,8144,1723
PHL,Philippines,KOR,Korea,2016,9530,8397,1133
PHL,Philippines,KOR,Korea,2017,8988,8663,325
PHL,Philippines,LUX,Luxembourg,2008,25,9,16
PHL,Philippines,LUX,Luxembourg,2009,27,5,22
PHL,Philippines,LUX,Luxembourg,2010,23,13,10
PHL,Philippines,LUX,Luxembourg,2011,20,8,12
PHL,Philippines,LUX,Luxembourg,2012,18,7,11
PHL,Philippines,LUX,Luxembourg,2013,24,5,19
PHL,Philippines,LUX,Luxembourg,2014,42,9,33
PHL,Philippines,LUX,Luxembourg,2015,50,20,30
PHL,Philippines,LUX,Luxembourg,2016,60,11,49
PHL,Philippines,LUX,Luxembourg,2017,90,10,80
PHL,Philippines,MEX,Mexico,2008,32,0,32
PHL,Philippines,MEX,Mexico,2009,44,0,44
PHL,Philippines,MEX,Mexico,2010,52,0,52
PHL,Philippines,MEX,Mexico,2011,50,0,50
PHL,Philippines,MEX,Mexico,2012,36,0,36
PHL,Philippines,MEX,Mexico,2013,177,0,177
PHL,Philippines,MEX,Mexico,2014,181,0,181
PHL,Philippines,MEX,Mexico,2015,68,0,68
PHL,Philippines,MEX,Mexico,2016,84,0,84
PHL,Philippines,MEX,Mexico,2017,76,0,76
PHL,Philippines,NLD,Netherlands,2008,1017,392,625
PHL,Philippines,NLD,Netherlands,2009,980,523,457
PHL,Philippines,NLD,Netherlands,2010,958,553,405
PHL,Philippines,NLD,Netherlands,2011,845,586,259
PHL,Philippines,NLD,Netherlands,2012,869,471,398
PHL,Philippines,NLD,Netherlands,2013,949,529,420
PHL,Philippines,NLD,Netherlands,2014,942,505,437
PHL,Philippines,NLD,Netherlands,2015,928,490,438
PHL,Philippines,NLD,Netherlands,2016,1022,475,547
PHL,Philippines,NLD,Netherlands,2017,1185,514,671
PHL,Philippines,NZL,New Zealand,2008,4139,216,3923
PHL,Philippines,NZL,New Zealand,2009,2751,386,2365
PHL,Philippines,NZL,New Zealand,2010,1972,402,1570
PHL,Philippines,NZL,New Zealand,2011,2425,550,1875
PHL,Philippines,NZL,New Zealand,2012,2888,412,2476
PHL,Philippines,NZL,New Zealand,2013,3178,358,2820
PHL,Philippines,NZL,New Zealand,2014,4657,238,4419
PHL,Philippines,NZL,New Zealand,2015,6304,253,6051
PHL,Philippines,NZL,New Zealand,2016,6010,385,5625
PHL,Philippines,NZL,New Zealand,2017,6610,539,6071
PHL,Philippines,NOR,Norway,2008,1765,384,1381
PHL,Philippines,NOR,Norway,2009,1673,595,1078
PHL,Philippines,NOR,Norway,2010,2126,887,1239
PHL,Philippines,NOR,Norway,2011,2553,1046,1507
PHL,Philippines,NOR,Norway,2012,2490,1047,1443
PHL,Philippines,NOR,Norway,2013,2815,1079,1736
PHL,Philippines,NOR,Norway,2014,2157,1144,1013
PHL,Philippines,NOR,Norway,2015,2241,1525,716
PHL,Philippines,NOR,Norway,2016,2074,1308,766
PHL,Philippines,NOR,Norway,2017,1884,1009,875
PHL,Philippines,POL,Poland,2008,93,0,93
PHL,Philippines,POL,Poland,2009,133,0,133
PHL,Philippines,POL,Poland,2010,166,0,166
PHL,Philippines,POL,Poland,2011,185,0,185
PHL,Philippines,POL,Poland,2012,172,0,172
PHL,Philippines,POL,Poland,2013,200,0,200
PHL,Philippines,POL,Poland,2014,123,0,123
PHL,Philippines,POL,Poland,2015,193,0,193
PHL,Philippines,POL,Poland,2016,193,0,193
PHL,Philippines,POL,Poland,2017,228,0,228
PHL,Philippines,SVK,Slovak Republic,2008,15,12,3
PHL,Philippines,SVK,Slovak Republic,2009,10,3,7
PHL,Philippines,SVK,Slovak Republic,2010,1,10,-9
PHL,Philippines,SVK,Slovak Republic,2011,2,1,1
PHL,Philippines,SVK,Slovak Republic,2012,1,0,1
PHL,Philippines,SVK,Slovak Republic,2013,1,0,1
PHL,Philippines,SVK,Slovak Republic,2014,3,0,3
PHL,Philippines,SVK,Slovak Republic,2015,3,0,3
PHL,Philippines,SVK,Slovak Republic,2016,5,0,5
PHL,Philippines,SVK,Slovak Republic,2017,6,0,6
PHL,Philippines,ESP,Spain,2008,4849,809,4040
PHL,Philippines,ESP,Spain,2009,3124,1049,2075
PHL,Philippines,ESP,Spain,2010,2135,1152,983
PHL,Philippines,ESP,Spain,2011,2483,1424,1059
PHL,Philippines,ESP,Spain,2012,2140,1458,682
PHL,Philippines,ESP,Spain,2013,2095,1946,149
PHL,Philippines,ESP,Spain,2014,2001,1315,686
PHL,Philippines,ESP,Spain,2015,2465,900,1565
PHL,Philippines,ESP,Spain,2016,2525,931,1594
PHL,Philippines,ESP,Spain,2017,2824,990,1834
PHL,Philippines,SWE,Sweden,2008,560,38,522
PHL,Philippines,SWE,Sweden,2009,632,34,598
PHL,Philippines,SWE,Sweden,2010,588,47,541
PHL,Philippines,SWE,Sweden,2011,580,54,526
PHL,Philippines,SWE,Sweden,2012,662,60,602
PHL,Philippines,SWE,Sweden,2013,546,44,502
PHL,Philippines,SWE,Sweden,2014,575,54,521
PHL,Philippines,SWE,Sweden,2015,524,96,428
PHL,Philippines,SWE,Sweden,2016,612,57,555
PHL,Philippines,SWE,Sweden,2017,810,61,749
PHL,Philippines,CHE,Switzerland,2010,440,139,301
PHL,Philippines,CHE,Switzerland,2011,415,145,270
PHL,Philippines,CHE,Switzerland,2012,411,153,258
PHL,Philippines,CHE,Switzerland,2013,487,178,309
PHL,Philippines,CHE,Switzerland,2014,486,149,337
PHL,Philippines,CHE,Switzerland,2015,504,194,310
PHL,Philippines,CHE,Switzerland,2016,578,224,354
PHL,Philippines,CHE,Switzerland,2017,475,159,316
PHL,Philippines,TUR,Turkey,2010,87,0,87
PHL,Philippines,TUR,Turkey,2016,1005,386,619
PHL,Philippines,TUR,Turkey,2017,1224,488,736
PHL,Philippines,GBR,United Kingdom,2008,13000,0,13000
PHL,Philippines,GBR,United Kingdom,2009,12000,0,12000
PHL,Philippines,GBR,United Kingdom,2010,9000,0,9000
PHL,Philippines,GBR,United Kingdom,2011,4000,1000,3000
PHL,Philippines,GBR,United Kingdom,2012,2000,1000,1000
PHL,Philippines,GBR,United Kingdom,2013,2000,1000,1000
PHL,Philippines,GBR,United Kingdom,2014,4000,1000,3000
PHL,Philippines,GBR,United Kingdom,2015,3000,0,3000
PHL,Philippines,GBR,United Kingdom,2016,3000,0,3000
PHL,Philippines,GBR,United Kingdom,2017,5000,0,5000
PHL,Philippines,USA,United States,2008,54030,0,54030
PHL,Philippines,USA,United States,2009,60029,0,60029
PHL,Philippines,USA,United States,2010,58173,0,58173
PHL,Philippines,USA,United States,2011,57011,0,57011
PHL,Philippines,USA,United States,2012,57327,0,57327
PHL,Philippines,USA,United States,2013,54446,0,54446
PHL,Philippines,USA,United States,2014,49996,0,49996
PHL,Philippines,USA,United States,2015,56478,0,56478
PHL,Philippines,USA,United States,2016,53287,0,53287
PHL,Philippines,USA,United States,2017,49147,0,49147
PHL,Philippines,CHL,Chile,2008,20,0,20
PHL,Philippines,CHL,Chile,2009,31,0,31
PHL,Philippines,CHL,Chile,2010,54,0,54
PHL,Philippines,CHL,Chile,2011,58,0,58
PHL,Philippines,CHL,Chile,2012,31,0,31
PHL,Philippines,CHL,Chile,2013,31,0,31
PHL,Philippines,CHL,Chile,2014,44,0,44
PHL,Philippines,CHL,Chile,2015,81,0,81
PHL,Philippines,CHL,Chile,2016,76,0,76
PHL,Philippines,EST,Estonia,2008,0,0,0
PHL,Philippines,EST,Estonia,2009,6,0,6
PHL,Philippines,EST,Estonia,2010,3,0,3
PHL,Philippines,EST,Estonia,2011,9,0,9
PHL,Philippines,EST,Estonia,2012,2,0,2
PHL,Philippines,EST,Estonia,2013,8,0,8
PHL,Philippines,EST,Estonia,2014,9,0,9
PHL,Philippines,EST,Estonia,2015,7,0,7
PHL,Philippines,EST,Estonia,2016,16,0,16
PHL,Philippines,EST,Estonia,2017,21,0,21
PHL,Philippines,SVN,Slovenia,2009,37,0,37
PHL,Philippines,SVN,Slovenia,2011,26,2,24
PHL,Philippines,SVN,Slovenia,2012,5,1,4
PHL,Philippines,SVN,Slovenia,2013,1,0,1
PHL,Philippines,SVN,Slovenia,2014,7,1,6
PHL,Philippines,SVN,Slovenia,2015,21,0,21
PHL,Philippines,SVN,Slovenia,2016,5,0,5
PHL,Philippines,SVN,Slovenia,2017,16,0,16
POL,Poland,AUS,Australia,2008,525,109,416
POL,Poland,AUS,Australia,2009,524,104,420
POL,Poland,AUS,Australia,2010,523,83,440
POL,Poland,AUS,Australia,2011,497,104,393
POL,Poland,AUS,Australia,2012,590,92,498
POL,Poland,AUS,Australia,2013,578,79,499
POL,Poland,AUS,Australia,2014,599,52,547
POL,Poland,AUS,Australia,2015,612,120,492
POL,Poland,AUS,Australia,2016,613,86,527
POL,Poland,AUS,Australia,2017,588,64,524
POL,Poland,AUT,Austria,2008,4385,168,4217
POL,Poland,AUT,Austria,2009,3845,178,3667
POL,Poland,AUT,Austria,2010,4037,185,3852
POL,Poland,AUT,Austria,2011,6428,176,6252
POL,Poland,AUT,Austria,2012,7105,139,6966
POL,Poland,AUT,Austria,2013,7297,111,7186
POL,Poland,AUT,Austria,2014,6936,112,6824
POL,Poland,AUT,Austria,2015,6136,111,6025
POL,Poland,AUT,Austria,2016,5386,76,5310
POL,Poland,AUT,Austria,2017,5232,88,5144
POL,Poland,BEL,Belgium,2008,8963,117,8846
POL,Poland,BEL,Belgium,2009,9911,99,9812
POL,Poland,BEL,Belgium,2010,8887,129,8758
POL,Poland,BEL,Belgium,2011,9287,100,9187
POL,Poland,BEL,Belgium,2012,8616,132,8484
POL,Poland,BEL,Belgium,2013,7488,147,7341
POL,Poland,BEL,Belgium,2014,5767,147,5620
POL,Poland,BEL,Belgium,2015,5320,139,5181
POL,Poland,BEL,Belgium,2016,4414,127,4287
POL,Poland,BEL,Belgium,2017,4301,120,4181
POL,Poland,CAN,Canada,2008,1267,164,1103
POL,Poland,CAN,Canada,2009,1013,205,808
POL,Poland,CAN,Canada,2010,795,178,617
POL,Poland,CAN,Canada,2011,720,200,520
POL,Poland,CAN,Canada,2012,779,214,565
POL,Poland,CAN,Canada,2013,853,198,655
POL,Poland,CAN,Canada,2014,773,92,681
POL,Poland,CAN,Canada,2015,981,226,755
POL,Poland,CAN,Canada,2016,1000,195,805
POL,Poland,CAN,Canada,2017,1005,159,846
POL,Poland,CZE,Czech Republic,2008,1223,146,1077
POL,Poland,CZE,Czech Republic,2009,858,176,682
POL,Poland,CZE,Czech Republic,2010,723,195,528
POL,Poland,CZE,Czech Republic,2011,612,205,407
POL,Poland,CZE,Czech Republic,2012,576,185,391
POL,Poland,CZE,Czech Republic,2013,587,215,372
POL,Poland,CZE,Czech Republic,2014,640,216,424
POL,Poland,CZE,Czech Republic,2015,606,223,383
POL,Poland,CZE,Czech Republic,2016,740,229,511
POL,Poland,CZE,Czech Republic,2017,779,223,556
POL,Poland,DNK,Denmark,2008,6529,93,6436
POL,Poland,DNK,Denmark,2009,3383,131,3252
POL,Poland,DNK,Denmark,2010,2928,90,2838
POL,Poland,DNK,Denmark,2011,3158,109,3049
POL,Poland,DNK,Denmark,2012,3313,90,3223
POL,Poland,DNK,Denmark,2013,3623,97,3526
POL,Poland,DNK,Denmark,2014,3990,96,3894
POL,Poland,DNK,Denmark,2015,4085,88,3997
POL,Poland,DNK,Denmark,2016,3777,99,3678
POL,Poland,DNK,Denmark,2017,3719,73,3646
POL,Poland,FIN,Finland,2008,562,126,436
POL,Poland,FIN,Finland,2009,321,53,268
POL,Poland,FIN,Finland,2010,250,60,190
POL,Poland,FIN,Finland,2011,325,89,236
POL,Poland,FIN,Finland,2012,538,81,457
POL,Poland,FIN,Finland,2013,506,111,395
POL,Poland,FIN,Finland,2014,513,111,402
POL,Poland,FIN,Finland,2015,395,135,260
POL,Poland,FIN,Finland,2016,432,136,296
POL,Poland,FIN,Finland,2017,355,91,264
POL,Poland,FRA,France,2008,0,559,-559
POL,Poland,FRA,France,2009,0,560,-560
POL,Poland,FRA,France,2010,0,496,-496
POL,Poland,FRA,France,2011,0,586,-586
POL,Poland,FRA,France,2012,0,591,-591
POL,Poland,FRA,France,2013,3474,572,2902
POL,Poland,FRA,France,2014,3094,572,2522
POL,Poland,FRA,France,2015,2831,619,2212
POL,Poland,FRA,France,2016,2272,588,1684
POL,Poland,FRA,France,2017,2381,539,1842
POL,Poland,DEU,Germany,2008,119867,2927,116940
POL,Poland,DEU,Germany,2009,112027,1681,110346
POL,Poland,DEU,Germany,2010,115587,1774,113813
POL,Poland,DEU,Germany,2011,164705,1915,162790
POL,Poland,DEU,Germany,2012,177758,2281,175477
POL,Poland,DEU,Germany,2013,190424,1981,188443
POL,Poland,DEU,Germany,2014,192172,1981,190191
POL,Poland,DEU,Germany,2015,190834,2321,188513
POL,Poland,DEU,Germany,2016,160677,2334,158343
POL,Poland,DEU,Germany,2017,149663,2242,147421
POL,Poland,HUN,Hungary,2008,177,108,69
POL,Poland,HUN,Hungary,2009,218,99,119
POL,Poland,HUN,Hungary,2010,192,111,81
POL,Poland,HUN,Hungary,2011,193,121,72
POL,Poland,HUN,Hungary,2012,215,171,44
POL,Poland,HUN,Hungary,2013,231,411,-180
POL,Poland,HUN,Hungary,2014,212,411,-199
POL,Poland,HUN,Hungary,2015,246,194,52
POL,Poland,HUN,Hungary,2016,232,214,18
POL,Poland,HUN,Hungary,2017,267,238,29
POL,Poland,ISL,Iceland,2008,3890,0,3890
POL,Poland,ISL,Iceland,2009,1237,1,1236
POL,Poland,ISL,Iceland,2010,830,5,825
POL,Poland,ISL,Iceland,2011,783,6,777
POL,Poland,ISL,Iceland,2012,899,6,893
POL,Poland,ISL,Iceland,2013,1329,5,1324
POL,Poland,ISL,Iceland,2014,1410,5,1405
POL,Poland,ISL,Iceland,2015,1624,1,1623
POL,Poland,ISL,Iceland,2016,2873,7,2866
POL,Poland,ISL,Iceland,2017,4549,9,4540
POL,Poland,ITA,Italy,2008,12314,524,11790
POL,Poland,ITA,Italy,2009,9123,626,8497
POL,Poland,ITA,Italy,2010,7174,530,6644
POL,Poland,ITA,Italy,2011,5471,637,4834
POL,Poland,ITA,Italy,2012,4618,670,3948
POL,Poland,ITA,Italy,2013,3506,851,2655
POL,Poland,ITA,Italy,2014,2953,852,2101
POL,Poland,ITA,Italy,2015,2657,1001,1656
POL,Poland,ITA,Italy,2016,2424,1047,1377
POL,Poland,ITA,Italy,2017,2065,1025,1040
POL,Poland,JPN,Japan,2008,1056,782,274
POL,Poland,JPN,Japan,2009,753,669,84
POL,Poland,JPN,Japan,2010,841,573,268
POL,Poland,JPN,Japan,2011,698,503,195
POL,Poland,JPN,Japan,2012,830,498,332
POL,Poland,JPN,Japan,2013,731,549,182
POL,Poland,JPN,Japan,2014,809,213,596
POL,Poland,JPN,Japan,2015,1365,506,859
POL,Poland,JPN,Japan,2016,1100,456,644
POL,Poland,JPN,Japan,2017,1031,392,639
POL,Poland,KOR,Korea,2008,131,1078,-947
POL,Poland,KOR,Korea,2009,127,1000,-873
POL,Poland,KOR,Korea,2010,142,1070,-928
POL,Poland,KOR,Korea,2011,154,984,-830
POL,Poland,KOR,Korea,2012,143,990,-847
POL,Poland,KOR,Korea,2013,169,1148,-979
POL,Poland,KOR,Korea,2014,185,619,-434
POL,Poland,KOR,Korea,2015,175,1039,-864
POL,Poland,KOR,Korea,2016,170,838,-668
POL,Poland,KOR,Korea,2017,146,662,-516
POL,Poland,LUX,Luxembourg,2008,489,4,485
POL,Poland,LUX,Luxembourg,2009,365,3,362
POL,Poland,LUX,Luxembourg,2010,361,0,361
POL,Poland,LUX,Luxembourg,2011,417,4,413
POL,Poland,LUX,Luxembourg,2012,400,1,399
POL,Poland,LUX,Luxembourg,2013,362,4,358
POL,Poland,LUX,Luxembourg,2014,504,6,498
POL,Poland,LUX,Luxembourg,2015,514,9,505
POL,Poland,LUX,Luxembourg,2016,427,22,405
POL,Poland,LUX,Luxembourg,2017,443,3,440
POL,Poland,MEX,Mexico,2008,34,120,-86
POL,Poland,MEX,Mexico,2009,40,156,-116
POL,Poland,MEX,Mexico,2010,44,163,-119
POL,Poland,MEX,Mexico,2011,49,168,-119
POL,Poland,MEX,Mexico,2012,40,165,-125
POL,Poland,MEX,Mexico,2013,128,171,-43
POL,Poland,MEX,Mexico,2014,95,97,-2
POL,Poland,MEX,Mexico,2015,66,190,-124
POL,Poland,MEX,Mexico,2016,60,168,-108
POL,Poland,MEX,Mexico,2017,54,177,-123
POL,Poland,NLD,Netherlands,2008,13277,291,12986
POL,Poland,NLD,Netherlands,2009,12654,273,12381
POL,Poland,NLD,Netherlands,2010,14477,244,14233
POL,Poland,NLD,Netherlands,2011,18610,241,18369
POL,Poland,NLD,Netherlands,2012,18332,228,18104
POL,Poland,NLD,Netherlands,2013,20398,246,20152
POL,Poland,NLD,Netherlands,2014,23773,246,23527
POL,Poland,NLD,Netherlands,2015,22993,246,22747
POL,Poland,NLD,Netherlands,2016,23129,230,22899
POL,Poland,NLD,Netherlands,2017,23849,233,23616
POL,Poland,NZL,New Zealand,2008,44,0,44
POL,Poland,NZL,New Zealand,2009,68,43,25
POL,Poland,NZL,New Zealand,2010,90,39,51
POL,Poland,NZL,New Zealand,2011,101,33,68
POL,Poland,NZL,New Zealand,2012,77,36,41
POL,Poland,NZL,New Zealand,2013,112,44,68
POL,Poland,NZL,New Zealand,2014,139,11,128
POL,Poland,NZL,New Zealand,2015,128,20,108
POL,Poland,NZL,New Zealand,2016,147,20,127
POL,Poland,NZL,New Zealand,2017,173,20,153
POL,Poland,NOR,Norway,2008,14437,82,14355
POL,Poland,NOR,Norway,2009,10451,70,10381
POL,Poland,NOR,Norway,2010,11347,92,11255
POL,Poland,NOR,Norway,2011,12861,141,12720
POL,Poland,NOR,Norway,2012,11477,201,11276
POL,Poland,NOR,Norway,2013,10502,154,10348
POL,Poland,NOR,Norway,2014,9859,154,9705
POL,Poland,NOR,Norway,2015,8182,104,8078
POL,Poland,NOR,Norway,2016,6042,130,5912
POL,Poland,NOR,Norway,2017,5214,123,5091
POL,Poland,POL,Poland,2009,0,0,0
POL,Poland,POL,Poland,2010,0,0,0
POL,Poland,POL,Poland,2011,0,0,0
POL,Poland,POL,Poland,2012,0,0,0
POL,Poland,POL,Poland,2013,0,0,0
POL,Poland,POL,Poland,2014,0,0,0
POL,Poland,POL,Poland,2015,0,0,0
POL,Poland,POL,Poland,2016,0,0,0
POL,Poland,POL,Poland,2017,0,0,0
POL,Poland,SVK,Slovak Republic,2008,391,166,225
POL,Poland,SVK,Slovak Republic,2009,376,166,210
POL,Poland,SVK,Slovak Republic,2010,280,175,105
POL,Poland,SVK,Slovak Republic,2011,190,210,-20
POL,Poland,SVK,Slovak Republic,2012,115,201,-86
POL,Poland,SVK,Slovak Republic,2013,158,305,-147
POL,Poland,SVK,Slovak Republic,2014,122,306,-184
POL,Poland,SVK,Slovak Republic,2015,205,224,-19
POL,Poland,SVK,Slovak Republic,2016,208,210,-2
POL,Poland,SVK,Slovak Republic,2017,151,213,-62
POL,Poland,ESP,Spain,2008,6698,246,6452
POL,Poland,ESP,Spain,2009,3714,312,3402
POL,Poland,ESP,Spain,2010,3431,373,3058
POL,Poland,ESP,Spain,2011,3329,424,2905
POL,Poland,ESP,Spain,2012,2801,625,2176
POL,Poland,ESP,Spain,2013,2645,904,1741
POL,Poland,ESP,Spain,2014,2440,904,1536
POL,Poland,ESP,Spain,2015,2460,776,1684
POL,Poland,ESP,Spain,2016,2613,610,2003
POL,Poland,ESP,Spain,2017,3249,650,2599
POL,Poland,SWE,Sweden,2008,6970,199,6771
POL,Poland,SWE,Sweden,2009,5167,201,4966
POL,Poland,SWE,Sweden,2010,4414,257,4157
POL,Poland,SWE,Sweden,2011,4403,298,4105
POL,Poland,SWE,Sweden,2012,4433,298,4135
POL,Poland,SWE,Sweden,2013,4611,312,4299
POL,Poland,SWE,Sweden,2014,5058,313,4745
POL,Poland,SWE,Sweden,2015,5552,257,5295
POL,Poland,SWE,Sweden,2016,5045,252,4793
POL,Poland,SWE,Sweden,2017,4351,225,4126
POL,Poland,CHE,Switzerland,2008,2437,46,2391
POL,Poland,CHE,Switzerland,2009,2123,44,2079
POL,Poland,CHE,Switzerland,2010,2047,28,2019
POL,Poland,CHE,Switzerland,2011,3413,40,3373
POL,Poland,CHE,Switzerland,2012,3340,40,3300
POL,Poland,CHE,Switzerland,2013,2936,53,2883
POL,Poland,CHE,Switzerland,2014,4782,53,4729
POL,Poland,CHE,Switzerland,2015,4821,36,4785
POL,Poland,CHE,Switzerland,2016,4069,39,4030
POL,Poland,CHE,Switzerland,2017,4123,56,4067
POL,Poland,TUR,Turkey,2010,109,1122,-1013
POL,Poland,TUR,Turkey,2016,289,1703,-1414
POL,Poland,TUR,Turkey,2017,251,1995,-1744
POL,Poland,GBR,United Kingdom,2008,55000,1515,53485
POL,Poland,GBR,United Kingdom,2009,32000,526,31474
POL,Poland,GBR,United Kingdom,2010,34000,522,33478
POL,Poland,GBR,United Kingdom,2011,33000,536,32464
POL,Poland,GBR,United Kingdom,2012,30000,511,29489
POL,Poland,GBR,United Kingdom,2013,28000,525,27475
POL,Poland,GBR,United Kingdom,2014,32000,523,31477
POL,Poland,GBR,United Kingdom,2015,40000,553,39447
POL,Poland,GBR,United Kingdom,2016,29000,596,28404
POL,Poland,GBR,United Kingdom,2017,25000,664,24336
POL,Poland,USA,United States,2008,8354,1017,7337
POL,Poland,USA,United States,2009,8754,984,7770
POL,Poland,USA,United States,2010,7643,984,6659
POL,Poland,USA,United States,2011,6863,993,5870
POL,Poland,USA,United States,2012,6300,1052,5248
POL,Poland,USA,United States,2013,6430,1126,5304
POL,Poland,USA,United States,2014,5689,0,5689
POL,Poland,USA,United States,2015,5275,0,5275
POL,Poland,USA,United States,2016,5603,0,5603
POL,Poland,USA,United States,2017,4845,0,4845
POL,Poland,CHL,Chile,2008,25,0,25
POL,Poland,CHL,Chile,2009,32,18,14
POL,Poland,CHL,Chile,2010,33,37,-4
POL,Poland,CHL,Chile,2011,108,34,74
POL,Poland,CHL,Chile,2012,36,29,7
POL,Poland,CHL,Chile,2013,78,31,47
POL,Poland,CHL,Chile,2014,58,20,38
POL,Poland,CHL,Chile,2015,91,51,40
POL,Poland,CHL,Chile,2016,61,46,15
POL,Poland,EST,Estonia,2008,31,11,20
POL,Poland,EST,Estonia,2009,47,13,34
POL,Poland,EST,Estonia,2010,12,5,7
POL,Poland,EST,Estonia,2011,3,20,-17
POL,Poland,EST,Estonia,2012,2,15,-13
POL,Poland,EST,Estonia,2013,2,12,-10
POL,Poland,EST,Estonia,2014,4,12,-8
POL,Poland,EST,Estonia,2015,110,24,86
POL,Poland,EST,Estonia,2016,83,23,60
POL,Poland,EST,Estonia,2017,92,22,70
POL,Poland,ISR,Israel,2008,24,147,-123
POL,Poland,ISR,Israel,2009,18,113,-95
POL,Poland,ISR,Israel,2010,15,99,-84
POL,Poland,ISR,Israel,2011,17,118,-101
POL,Poland,ISR,Israel,2012,15,145,-130
POL,Poland,ISR,Israel,2013,25,123,-98
POL,Poland,ISR,Israel,2014,29,74,-45
POL,Poland,ISR,Israel,2015,21,144,-123
POL,Poland,ISR,Israel,2016,14,118,-104
POL,Poland,ISR,Israel,2017,17,113,-96
POL,Poland,SVN,Slovenia,2008,208,24,184
POL,Poland,SVN,Slovenia,2009,197,14,183
POL,Poland,SVN,Slovenia,2010,34,26,8
POL,Poland,SVN,Slovenia,2011,172,26,146
POL,Poland,SVN,Slovenia,2012,442,29,413
POL,Poland,SVN,Slovenia,2013,817,34,783
POL,Poland,SVN,Slovenia,2014,278,34,244
POL,Poland,SVN,Slovenia,2015,206,35,171
POL,Poland,SVN,Slovenia,2016,224,49,175
POL,Poland,SVN,Slovenia,2017,199,48,151
PRT,Portugal,AUS,Australia,2008,182,0,182
PRT,Portugal,AUS,Australia,2009,185,0,185
PRT,Portugal,AUS,Australia,2010,226,0,226
PRT,Portugal,AUS,Australia,2011,216,0,216
PRT,Portugal,AUS,Australia,2012,279,0,279
PRT,Portugal,AUS,Australia,2013,289,0,289
PRT,Portugal,AUS,Australia,2014,322,0,322
PRT,Portugal,AUS,Australia,2015,331,0,331
PRT,Portugal,AUS,Australia,2016,283,0,283
PRT,Portugal,AUS,Australia,2017,330,0,330
PRT,Portugal,AUT,Austria,2008,349,0,349
PRT,Portugal,AUT,Austria,2009,357,0,357
PRT,Portugal,AUT,Austria,2010,444,0,444
PRT,Portugal,AUT,Austria,2011,531,0,531
PRT,Portugal,AUT,Austria,2012,693,0,693
PRT,Portugal,AUT,Austria,2013,878,0,878
PRT,Portugal,AUT,Austria,2014,581,0,581
PRT,Portugal,AUT,Austria,2015,663,0,663
PRT,Portugal,AUT,Austria,2016,561,0,561
PRT,Portugal,AUT,Austria,2017,618,0,618
PRT,Portugal,BEL,Belgium,2008,3200,0,3200
PRT,Portugal,BEL,Belgium,2009,2854,0,2854
PRT,Portugal,BEL,Belgium,2010,2717,0,2717
PRT,Portugal,BEL,Belgium,2011,3140,0,3140
PRT,Portugal,BEL,Belgium,2012,4228,0,4228
PRT,Portugal,BEL,Belgium,2013,4332,0,4332
PRT,Portugal,BEL,Belgium,2014,2993,0,2993
PRT,Portugal,BEL,Belgium,2015,2927,0,2927
PRT,Portugal,BEL,Belgium,2016,2863,0,2863
PRT,Portugal,BEL,Belgium,2017,2691,0,2691
PRT,Portugal,CAN,Canada,2008,664,55,609
PRT,Portugal,CAN,Canada,2009,622,49,573
PRT,Portugal,CAN,Canada,2010,629,67,562
PRT,Portugal,CAN,Canada,2011,528,46,482
PRT,Portugal,CAN,Canada,2012,560,64,496
PRT,Portugal,CAN,Canada,2013,630,59,571
PRT,Portugal,CAN,Canada,2014,637,59,578
PRT,Portugal,CAN,Canada,2015,821,64,757
PRT,Portugal,CAN,Canada,2016,845,76,769
PRT,Portugal,CAN,Canada,2017,785,142,643
PRT,Portugal,CZE,Czech Republic,2008,32,0,32
PRT,Portugal,CZE,Czech Republic,2009,22,0,22
PRT,Portugal,CZE,Czech Republic,2010,35,0,35
PRT,Portugal,CZE,Czech Republic,2011,38,0,38
PRT,Portugal,CZE,Czech Republic,2012,30,0,30
PRT,Portugal,CZE,Czech Republic,2013,46,0,46
PRT,Portugal,CZE,Czech Republic,2014,79,0,79
PRT,Portugal,CZE,Czech Republic,2015,60,0,60
PRT,Portugal,CZE,Czech Republic,2016,61,0,61
PRT,Portugal,CZE,Czech Republic,2017,76,0,76
PRT,Portugal,DNK,Denmark,2008,136,0,136
PRT,Portugal,DNK,Denmark,2009,152,0,152
PRT,Portugal,DNK,Denmark,2010,168,0,168
PRT,Portugal,DNK,Denmark,2011,182,0,182
PRT,Portugal,DNK,Denmark,2012,307,0,307
PRT,Portugal,DNK,Denmark,2013,335,0,335
PRT,Portugal,DNK,Denmark,2014,494,0,494
PRT,Portugal,DNK,Denmark,2015,617,0,617
PRT,Portugal,DNK,Denmark,2016,467,0,467
PRT,Portugal,DNK,Denmark,2017,473,0,473
PRT,Portugal,FIN,Finland,2008,56,0,56
PRT,Portugal,FIN,Finland,2009,40,0,40
PRT,Portugal,FIN,Finland,2010,41,0,41
PRT,Portugal,FIN,Finland,2011,42,0,42
PRT,Portugal,FIN,Finland,2012,83,0,83
PRT,Portugal,FIN,Finland,2013,71,0,71
PRT,Portugal,FIN,Finland,2014,108,0,108
PRT,Portugal,FIN,Finland,2015,63,0,63
PRT,Portugal,FIN,Finland,2016,65,0,65
PRT,Portugal,FIN,Finland,2017,72,0,72
PRT,Portugal,FRA,France,2008,0,732,-732
PRT,Portugal,FRA,France,2009,0,718,-718
PRT,Portugal,FRA,France,2010,0,696,-696
PRT,Portugal,FRA,France,2011,0,666,-666
PRT,Portugal,FRA,France,2012,0,537,-537
PRT,Portugal,FRA,France,2013,18804,703,18101
PRT,Portugal,FRA,France,2014,14733,1930,12803
PRT,Portugal,FRA,France,2015,11615,2495,9120
PRT,Portugal,FRA,France,2016,12377,3475,8902
PRT,Portugal,FRA,France,2017,8315,4662,3653
PRT,Portugal,DEU,Germany,2008,5911,1135,4776
PRT,Portugal,DEU,Germany,2009,6779,1096,5683
PRT,Portugal,DEU,Germany,2010,6513,998,5515
PRT,Portugal,DEU,Germany,2011,8297,802,7495
PRT,Portugal,DEU,Germany,2012,11820,649,11171
PRT,Portugal,DEU,Germany,2013,13635,761,12874
PRT,Portugal,DEU,Germany,2014,11394,1003,10391
PRT,Portugal,DEU,Germany,2015,10145,1024,9121
PRT,Portugal,DEU,Germany,2016,9755,1587,8168
PRT,Portugal,DEU,Germany,2017,8952,1913,7039
PRT,Portugal,HUN,Hungary,2008,69,0,69
PRT,Portugal,HUN,Hungary,2009,49,0,49
PRT,Portugal,HUN,Hungary,2010,36,0,36
PRT,Portugal,HUN,Hungary,2011,68,0,68
PRT,Portugal,HUN,Hungary,2012,68,0,68
PRT,Portugal,HUN,Hungary,2013,77,0,77
PRT,Portugal,HUN,Hungary,2014,64,0,64
PRT,Portugal,HUN,Hungary,2015,86,0,86
PRT,Portugal,HUN,Hungary,2016,92,0,92
PRT,Portugal,HUN,Hungary,2017,108,0,108
PRT,Portugal,ISL,Iceland,2008,288,0,288
PRT,Portugal,ISL,Iceland,2009,58,0,58
PRT,Portugal,ISL,Iceland,2010,25,0,25
PRT,Portugal,ISL,Iceland,2011,39,0,39
PRT,Portugal,ISL,Iceland,2012,46,0,46
PRT,Portugal,ISL,Iceland,2013,92,0,92
PRT,Portugal,ISL,Iceland,2014,97,0,97
PRT,Portugal,ISL,Iceland,2015,120,0,120
PRT,Portugal,ISL,Iceland,2016,238,0,238
PRT,Portugal,ISL,Iceland,2017,287,0,287
PRT,Portugal,ITA,Italy,2008,503,990,-487
PRT,Portugal,ITA,Italy,2009,516,1016,-500
PRT,Portugal,ITA,Italy,2010,420,977,-557
PRT,Portugal,ITA,Italy,2011,452,810,-358
PRT,Portugal,ITA,Italy,2012,446,743,-297
PRT,Portugal,ITA,Italy,2013,374,814,-440
PRT,Portugal,ITA,Italy,2014,376,1071,-695
PRT,Portugal,ITA,Italy,2015,354,1577,-1223
PRT,Portugal,ITA,Italy,2016,443,3106,-2663
PRT,Portugal,ITA,Italy,2017,465,5267,-4802
PRT,Portugal,JPN,Japan,2008,120,0,120
PRT,Portugal,JPN,Japan,2009,116,0,116
PRT,Portugal,JPN,Japan,2010,129,0,129
PRT,Portugal,JPN,Japan,2011,94,0,94
PRT,Portugal,JPN,Japan,2012,129,0,129
PRT,Portugal,JPN,Japan,2013,138,0,138
PRT,Portugal,JPN,Japan,2014,132,0,132
PRT,Portugal,JPN,Japan,2015,238,0,238
PRT,Portugal,JPN,Japan,2016,248,0,248
PRT,Portugal,JPN,Japan,2017,292,0,292
PRT,Portugal,KOR,Korea,2008,25,0,25
PRT,Portugal,KOR,Korea,2009,23,0,23
PRT,Portugal,KOR,Korea,2010,30,0,30
PRT,Portugal,KOR,Korea,2011,29,0,29
PRT,Portugal,KOR,Korea,2012,50,0,50
PRT,Portugal,KOR,Korea,2013,35,0,35
PRT,Portugal,KOR,Korea,2014,37,0,37
PRT,Portugal,KOR,Korea,2015,42,0,42
PRT,Portugal,KOR,Korea,2016,34,0,34
PRT,Portugal,KOR,Korea,2017,55,0,55
PRT,Portugal,LUX,Luxembourg,2008,4531,0,4531
PRT,Portugal,LUX,Luxembourg,2009,3844,0,3844
PRT,Portugal,LUX,Luxembourg,2010,3845,0,3845
PRT,Portugal,LUX,Luxembourg,2011,4977,0,4977
PRT,Portugal,LUX,Luxembourg,2012,5193,0,5193
PRT,Portugal,LUX,Luxembourg,2013,4590,0,4590
PRT,Portugal,LUX,Luxembourg,2014,3832,0,3832
PRT,Portugal,LUX,Luxembourg,2015,3525,0,3525
PRT,Portugal,LUX,Luxembourg,2016,3355,0,3355
PRT,Portugal,LUX,Luxembourg,2017,3342,0,3342
PRT,Portugal,MEX,Mexico,2008,24,0,24
PRT,Portugal,MEX,Mexico,2009,38,0,38
PRT,Portugal,MEX,Mexico,2010,34,0,34
PRT,Portugal,MEX,Mexico,2011,46,0,46
PRT,Portugal,MEX,Mexico,2012,40,0,40
PRT,Portugal,MEX,Mexico,2013,117,0,117
PRT,Portugal,MEX,Mexico,2014,83,0,83
PRT,Portugal,MEX,Mexico,2015,72,0,72
PRT,Portugal,MEX,Mexico,2016,80,0,80
PRT,Portugal,MEX,Mexico,2017,72,0,72
PRT,Portugal,NLD,Netherlands,2008,2385,545,1840
PRT,Portugal,NLD,Netherlands,2009,2375,540,1835
PRT,Portugal,NLD,Netherlands,2010,1958,429,1529
PRT,Portugal,NLD,Netherlands,2011,2096,432,1664
PRT,Portugal,NLD,Netherlands,2012,2470,437,2033
PRT,Portugal,NLD,Netherlands,2013,2417,475,1942
PRT,Portugal,NLD,Netherlands,2014,2291,582,1709
PRT,Portugal,NLD,Netherlands,2015,2249,834,1415
PRT,Portugal,NLD,Netherlands,2016,2371,1165,1206
PRT,Portugal,NLD,Netherlands,2017,2672,1345,1327
PRT,Portugal,NZL,New Zealand,2008,23,0,23
PRT,Portugal,NZL,New Zealand,2009,25,0,25
PRT,Portugal,NZL,New Zealand,2010,20,0,20
PRT,Portugal,NZL,New Zealand,2011,20,0,20
PRT,Portugal,NZL,New Zealand,2012,47,0,47
PRT,Portugal,NZL,New Zealand,2013,37,0,37
PRT,Portugal,NZL,New Zealand,2014,55,0,55
PRT,Portugal,NZL,New Zealand,2015,43,0,43
PRT,Portugal,NZL,New Zealand,2016,43,0,43
PRT,Portugal,NZL,New Zealand,2017,61,0,61
PRT,Portugal,NOR,Norway,2008,271,0,271
PRT,Portugal,NOR,Norway,2009,257,0,257
PRT,Portugal,NOR,Norway,2010,284,0,284
PRT,Portugal,NOR,Norway,2011,458,0,458
PRT,Portugal,NOR,Norway,2012,582,0,582
PRT,Portugal,NOR,Norway,2013,815,0,815
PRT,Portugal,NOR,Norway,2014,653,0,653
PRT,Portugal,NOR,Norway,2015,488,0,488
PRT,Portugal,NOR,Norway,2016,427,0,427
PRT,Portugal,NOR,Norway,2017,375,0,375
PRT,Portugal,POL,Poland,2008,119,0,119
PRT,Portugal,POL,Poland,2009,163,0,163
PRT,Portugal,POL,Poland,2010,101,0,101
PRT,Portugal,POL,Poland,2011,142,0,142
PRT,Portugal,POL,Poland,2012,182,0,182
PRT,Portugal,POL,Poland,2013,312,0,312
PRT,Portugal,POL,Poland,2014,312,0,312
PRT,Portugal,POL,Poland,2015,246,0,246
PRT,Portugal,POL,Poland,2016,277,0,277
PRT,Portugal,POL,Poland,2017,274,0,274
PRT,Portugal,SVK,Slovak Republic,2008,17,0,17
PRT,Portugal,SVK,Slovak Republic,2009,34,0,34
PRT,Portugal,SVK,Slovak Republic,2010,13,0,13
PRT,Portugal,SVK,Slovak Republic,2011,28,0,28
PRT,Portugal,SVK,Slovak Republic,2012,16,0,16
PRT,Portugal,SVK,Slovak Republic,2013,11,0,11
PRT,Portugal,SVK,Slovak Republic,2014,12,0,12
PRT,Portugal,SVK,Slovak Republic,2015,36,0,36
PRT,Portugal,SVK,Slovak Republic,2016,19,0,19
PRT,Portugal,SVK,Slovak Republic,2017,26,0,26
PRT,Portugal,ESP,Spain,2008,13954,1310,12644
PRT,Portugal,ESP,Spain,2009,7885,1465,6420
PRT,Portugal,ESP,Spain,2010,6153,1664,4489
PRT,Portugal,ESP,Spain,2011,6132,1533,4599
PRT,Portugal,ESP,Spain,2012,5202,1356,3846
PRT,Portugal,ESP,Spain,2013,4499,1474,3025
PRT,Portugal,ESP,Spain,2014,4554,1452,3102
PRT,Portugal,ESP,Spain,2015,5026,1662,3364
PRT,Portugal,ESP,Spain,2016,5949,2214,3735
PRT,Portugal,ESP,Spain,2017,7554,2738,4816
PRT,Portugal,SWE,Sweden,2008,200,0,200
PRT,Portugal,SWE,Sweden,2009,209,0,209
PRT,Portugal,SWE,Sweden,2010,186,0,186
PRT,Portugal,SWE,Sweden,2011,189,0,189
PRT,Portugal,SWE,Sweden,2012,307,0,307
PRT,Portugal,SWE,Sweden,2013,309,0,309
PRT,Portugal,SWE,Sweden,2014,309,0,309
PRT,Portugal,SWE,Sweden,2015,330,0,330
PRT,Portugal,SWE,Sweden,2016,380,0,380
PRT,Portugal,SWE,Sweden,2017,390,0,390
PRT,Portugal,CHE,Switzerland,2008,17772,0,17772
PRT,Portugal,CHE,Switzerland,2009,13670,0,13670
PRT,Portugal,CHE,Switzerland,2010,12826,0,12826
PRT,Portugal,CHE,Switzerland,2011,15358,0,15358
PRT,Portugal,CHE,Switzerland,2012,18577,0,18577
PRT,Portugal,CHE,Switzerland,2013,19925,0,19925
PRT,Portugal,CHE,Switzerland,2014,14893,0,14893
PRT,Portugal,CHE,Switzerland,2015,12617,0,12617
PRT,Portugal,CHE,Switzerland,2016,10146,0,10146
PRT,Portugal,CHE,Switzerland,2017,9231,0,9231
PRT,Portugal,TUR,Turkey,2010,33,0,33
PRT,Portugal,TUR,Turkey,2016,102,0,102
PRT,Portugal,TUR,Turkey,2017,101,0,101
PRT,Portugal,GBR,United Kingdom,2010,4000,1763,2237
PRT,Portugal,GBR,United Kingdom,2011,5000,1692,3308
PRT,Portugal,GBR,United Kingdom,2012,7000,1246,5754
PRT,Portugal,GBR,United Kingdom,2013,12000,1402,10598
PRT,Portugal,GBR,United Kingdom,2014,15000,1486,13514
PRT,Portugal,GBR,United Kingdom,2015,10000,1866,8134
PRT,Portugal,GBR,United Kingdom,2016,12000,3066,8934
PRT,Portugal,GBR,United Kingdom,2017,15000,3832,11168
PRT,Portugal,USA,United States,2008,772,353,419
PRT,Portugal,USA,United States,2009,946,329,617
PRT,Portugal,USA,United States,2010,755,255,500
PRT,Portugal,USA,United States,2011,821,346,475
PRT,Portugal,USA,United States,2012,811,327,484
PRT,Portugal,USA,United States,2013,918,314,604
PRT,Portugal,USA,United States,2014,892,312,580
PRT,Portugal,USA,United States,2015,857,329,528
PRT,Portugal,USA,United States,2016,1006,501,505
PRT,Portugal,USA,United States,2017,939,614,325
PRT,Portugal,CHL,Chile,2008,26,0,26
PRT,Portugal,CHL,Chile,2009,23,0,23
PRT,Portugal,CHL,Chile,2010,41,0,41
PRT,Portugal,CHL,Chile,2011,41,0,41
PRT,Portugal,CHL,Chile,2012,129,0,129
PRT,Portugal,CHL,Chile,2013,277,0,277
PRT,Portugal,CHL,Chile,2014,220,0,220
PRT,Portugal,CHL,Chile,2015,267,0,267
PRT,Portugal,CHL,Chile,2016,208,0,208
PRT,Portugal,EST,Estonia,2008,18,0,18
PRT,Portugal,EST,Estonia,2009,13,0,13
PRT,Portugal,EST,Estonia,2010,12,0,12
PRT,Portugal,EST,Estonia,2011,1,0,1
PRT,Portugal,EST,Estonia,2012,0,0,0
PRT,Portugal,EST,Estonia,2013,0,0,0
PRT,Portugal,EST,Estonia,2014,0,0,0
PRT,Portugal,EST,Estonia,2015,55,0,55
PRT,Portugal,EST,Estonia,2016,47,0,47
PRT,Portugal,EST,Estonia,2017,67,0,67
PRT,Portugal,SVN,Slovenia,2008,760,0,760
PRT,Portugal,SVN,Slovenia,2009,45,0,45
PRT,Portugal,SVN,Slovenia,2010,1,0,1
PRT,Portugal,SVN,Slovenia,2011,92,0,92
PRT,Portugal,SVN,Slovenia,2012,122,0,122
PRT,Portugal,SVN,Slovenia,2013,148,0,148
PRT,Portugal,SVN,Slovenia,2014,115,0,115
PRT,Portugal,SVN,Slovenia,2015,127,0,127
PRT,Portugal,SVN,Slovenia,2016,145,0,145
PRT,Portugal,SVN,Slovenia,2017,136,0,136
PRI,Puerto Rico,AUS,Australia,2009,0,5,-5
PRI,Puerto Rico,AUS,Australia,2010,0,0,0
PRI,Puerto Rico,AUS,Australia,2011,0,0,0
PRI,Puerto Rico,AUS,Australia,2012,0,0,0
PRI,Puerto Rico,AUS,Australia,2013,0,0,0
PRI,Puerto Rico,AUS,Australia,2014,0,0,0
PRI,Puerto Rico,AUS,Australia,2015,0,0,0
PRI,Puerto Rico,AUS,Australia,2016,0,0,0
PRI,Puerto Rico,AUS,Australia,2017,0,0,0
PRI,Puerto Rico,AUT,Austria,2014,0,0,0
PRI,Puerto Rico,AUT,Austria,2015,0,0,0
PRI,Puerto Rico,AUT,Austria,2016,0,0,0
PRI,Puerto Rico,AUT,Austria,2017,0,0,0
PRI,Puerto Rico,BEL,Belgium,2010,0,0,0
PRI,Puerto Rico,CAN,Canada,2008,6,0,6
PRI,Puerto Rico,CAN,Canada,2009,5,0,5
PRI,Puerto Rico,CAN,Canada,2010,10,0,10
PRI,Puerto Rico,CAN,Canada,2011,10,0,10
PRI,Puerto Rico,CAN,Canada,2012,5,0,5
PRI,Puerto Rico,CAN,Canada,2013,0,0,0
PRI,Puerto Rico,CAN,Canada,2014,0,0,0
PRI,Puerto Rico,CAN,Canada,2015,0,0,0
PRI,Puerto Rico,CAN,Canada,2016,0,0,0
PRI,Puerto Rico,CAN,Canada,2017,0,0,0
PRI,Puerto Rico,DNK,Denmark,2015,0,0,0
PRI,Puerto Rico,DNK,Denmark,2016,0,0,0
PRI,Puerto Rico,FIN,Finland,2008,0,0,0
PRI,Puerto Rico,FIN,Finland,2009,0,0,0
PRI,Puerto Rico,FIN,Finland,2010,0,0,0
PRI,Puerto Rico,FIN,Finland,2011,0,0,0
PRI,Puerto Rico,FIN,Finland,2012,0,0,0
PRI,Puerto Rico,FIN,Finland,2013,0,0,0
PRI,Puerto Rico,FIN,Finland,2014,0,0,0
PRI,Puerto Rico,FIN,Finland,2015,0,0,0
PRI,Puerto Rico,FIN,Finland,2016,0,0,0
PRI,Puerto Rico,FIN,Finland,2017,0,0,0
PRI,Puerto Rico,FRA,France,2008,0,0,0
PRI,Puerto Rico,FRA,France,2009,0,0,0
PRI,Puerto Rico,FRA,France,2010,0,0,0
PRI,Puerto Rico,FRA,France,2011,0,0,0
PRI,Puerto Rico,FRA,France,2012,0,0,0
PRI,Puerto Rico,FRA,France,2013,0,0,0
PRI,Puerto Rico,FRA,France,2014,0,0,0
PRI,Puerto Rico,FRA,France,2015,0,0,0
PRI,Puerto Rico,FRA,France,2016,0,0,0
PRI,Puerto Rico,FRA,France,2017,0,0,0
PRI,Puerto Rico,HUN,Hungary,2008,0,0,0
PRI,Puerto Rico,HUN,Hungary,2009,0,0,0
PRI,Puerto Rico,HUN,Hungary,2010,0,0,0
PRI,Puerto Rico,HUN,Hungary,2011,0,0,0
PRI,Puerto Rico,HUN,Hungary,2012,0,0,0
PRI,Puerto Rico,HUN,Hungary,2013,0,0,0
PRI,Puerto Rico,HUN,Hungary,2014,0,0,0
PRI,Puerto Rico,HUN,Hungary,2015,0,0,0
PRI,Puerto Rico,HUN,Hungary,2016,0,0,0
PRI,Puerto Rico,HUN,Hungary,2017,0,0,0
PRI,Puerto Rico,ISL,Iceland,2008,0,0,0
PRI,Puerto Rico,ISL,Iceland,2009,0,0,0
PRI,Puerto Rico,ISL,Iceland,2010,0,0,0
PRI,Puerto Rico,ISL,Iceland,2011,0,0,0
PRI,Puerto Rico,ISL,Iceland,2012,0,0,0
PRI,Puerto Rico,ISL,Iceland,2013,0,0,0
PRI,Puerto Rico,ISL,Iceland,2014,0,0,0
PRI,Puerto Rico,ISL,Iceland,2015,0,0,0
PRI,Puerto Rico,ISL,Iceland,2016,0,0,0
PRI,Puerto Rico,ISL,Iceland,2017,0,0,0
PRI,Puerto Rico,JPN,Japan,2008,0,0,0
PRI,Puerto Rico,JPN,Japan,2009,0,0,0
PRI,Puerto Rico,JPN,Japan,2010,0,0,0
PRI,Puerto Rico,JPN,Japan,2011,0,0,0
PRI,Puerto Rico,JPN,Japan,2012,0,0,0
PRI,Puerto Rico,JPN,Japan,2013,0,0,0
PRI,Puerto Rico,JPN,Japan,2014,0,0,0
PRI,Puerto Rico,JPN,Japan,2015,0,0,0
PRI,Puerto Rico,JPN,Japan,2016,0,0,0
PRI,Puerto Rico,JPN,Japan,2017,0,0,0
PRI,Puerto Rico,KOR,Korea,2008,0,0,0
PRI,Puerto Rico,KOR,Korea,2009,0,0,0
PRI,Puerto Rico,KOR,Korea,2010,0,0,0
PRI,Puerto Rico,KOR,Korea,2011,0,0,0
PRI,Puerto Rico,KOR,Korea,2012,0,0,0
PRI,Puerto Rico,KOR,Korea,2013,0,0,0
PRI,Puerto Rico,KOR,Korea,2014,0,0,0
PRI,Puerto Rico,KOR,Korea,2015,0,0,0
PRI,Puerto Rico,KOR,Korea,2016,0,0,0
PRI,Puerto Rico,KOR,Korea,2017,0,0,0
PRI,Puerto Rico,LUX,Luxembourg,2008,0,0,0
PRI,Puerto Rico,LUX,Luxembourg,2009,0,0,0
PRI,Puerto Rico,LUX,Luxembourg,2010,0,0,0
PRI,Puerto Rico,LUX,Luxembourg,2011,0,0,0
PRI,Puerto Rico,LUX,Luxembourg,2012,0,0,0
PRI,Puerto Rico,LUX,Luxembourg,2013,0,0,0
PRI,Puerto Rico,LUX,Luxembourg,2014,0,0,0
PRI,Puerto Rico,LUX,Luxembourg,2015,0,0,0
PRI,Puerto Rico,LUX,Luxembourg,2016,0,0,0
PRI,Puerto Rico,LUX,Luxembourg,2017,0,0,0
PRI,Puerto Rico,MEX,Mexico,2012,0,0,0
PRI,Puerto Rico,MEX,Mexico,2013,0,0,0
PRI,Puerto Rico,MEX,Mexico,2014,0,0,0
PRI,Puerto Rico,NOR,Norway,2008,0,0,0
PRI,Puerto Rico,NOR,Norway,2009,0,0,0
PRI,Puerto Rico,NOR,Norway,2010,0,0,0
PRI,Puerto Rico,NOR,Norway,2011,0,0,0
PRI,Puerto Rico,NOR,Norway,2012,0,0,0
PRI,Puerto Rico,NOR,Norway,2013,0,0,0
PRI,Puerto Rico,NOR,Norway,2014,0,0,0
PRI,Puerto Rico,NOR,Norway,2015,0,0,0
PRI,Puerto Rico,NOR,Norway,2016,1,0,1
PRI,Puerto Rico,NOR,Norway,2017,0,0,0
PRI,Puerto Rico,POL,Poland,2009,0,0,0
PRI,Puerto Rico,POL,Poland,2010,0,0,0
PRI,Puerto Rico,POL,Poland,2011,0,0,0
PRI,Puerto Rico,POL,Poland,2012,0,0,0
PRI,Puerto Rico,POL,Poland,2013,0,0,0
PRI,Puerto Rico,POL,Poland,2014,0,0,0
PRI,Puerto Rico,POL,Poland,2015,0,0,0
PRI,Puerto Rico,POL,Poland,2016,0,0,0
PRI,Puerto Rico,POL,Poland,2017,0,0,0
PRI,Puerto Rico,ESP,Spain,2008,0,0,0
PRI,Puerto Rico,ESP,Spain,2009,0,0,0
PRI,Puerto Rico,ESP,Spain,2010,0,0,0
PRI,Puerto Rico,ESP,Spain,2011,0,0,0
PRI,Puerto Rico,ESP,Spain,2012,0,0,0
PRI,Puerto Rico,ESP,Spain,2013,0,0,0
PRI,Puerto Rico,SWE,Sweden,2008,0,0,0
PRI,Puerto Rico,SWE,Sweden,2009,0,0,0
PRI,Puerto Rico,SWE,Sweden,2010,0,0,0
PRI,Puerto Rico,SWE,Sweden,2011,0,0,0
PRI,Puerto Rico,SWE,Sweden,2012,0,0,0
PRI,Puerto Rico,SWE,Sweden,2013,0,0,0
PRI,Puerto Rico,SWE,Sweden,2014,0,0,0
PRI,Puerto Rico,SWE,Sweden,2015,0,0,0
PRI,Puerto Rico,USA,United States,2017,6,0,6
PRI,Puerto Rico,CHL,Chile,2008,0,0,0
PRI,Puerto Rico,CHL,Chile,2009,0,0,0
PRI,Puerto Rico,CHL,Chile,2010,0,0,0
PRI,Puerto Rico,CHL,Chile,2011,0,0,0
PRI,Puerto Rico,CHL,Chile,2012,1,0,1
PRI,Puerto Rico,CHL,Chile,2013,0,0,0
PRI,Puerto Rico,CHL,Chile,2014,0,0,0
PRI,Puerto Rico,CHL,Chile,2015,1,0,1
PRI,Puerto Rico,CHL,Chile,2016,0,0,0
PRI,Puerto Rico,EST,Estonia,2017,0,0,0
QAT,Qatar,AUS,Australia,2008,1,13,-12
QAT,Qatar,AUS,Australia,2009,1,10,-9
QAT,Qatar,AUS,Australia,2010,2,9,-7
QAT,Qatar,AUS,Australia,2011,0,11,-11
QAT,Qatar,AUS,Australia,2012,1,10,-9
QAT,Qatar,AUS,Australia,2013,1,10,-9
QAT,Qatar,AUS,Australia,2014,0,14,-14
QAT,Qatar,AUS,Australia,2015,5,0,5
QAT,Qatar,AUS,Australia,2017,3,0,3
QAT,Qatar,AUT,Austria,2008,0,0,0
QAT,Qatar,AUT,Austria,2009,2,1,1
QAT,Qatar,AUT,Austria,2010,0,1,-1
QAT,Qatar,AUT,Austria,2011,0,1,-1
QAT,Qatar,AUT,Austria,2012,1,0,1
QAT,Qatar,AUT,Austria,2013,1,0,1
QAT,Qatar,AUT,Austria,2014,3,1,2
QAT,Qatar,AUT,Austria,2015,7,0,7
QAT,Qatar,AUT,Austria,2016,11,6,5
QAT,Qatar,AUT,Austria,2017,5,2,3
QAT,Qatar,BEL,Belgium,2009,0,0,0
QAT,Qatar,BEL,Belgium,2010,1,0,1
QAT,Qatar,BEL,Belgium,2013,4,0,4
QAT,Qatar,BEL,Belgium,2014,2,1,1
QAT,Qatar,BEL,Belgium,2015,1,2,-1
QAT,Qatar,BEL,Belgium,2016,4,2,2
QAT,Qatar,BEL,Belgium,2017,4,2,2
QAT,Qatar,CAN,Canada,2008,9,0,9
QAT,Qatar,CAN,Canada,2009,6,0,6
QAT,Qatar,CAN,Canada,2010,18,0,18
QAT,Qatar,CAN,Canada,2011,3,0,3
QAT,Qatar,CAN,Canada,2012,14,0,14
QAT,Qatar,CAN,Canada,2013,6,0,6
QAT,Qatar,CAN,Canada,2014,9,0,9
QAT,Qatar,CAN,Canada,2015,0,0,0
QAT,Qatar,CAN,Canada,2016,0,0,0
QAT,Qatar,CAN,Canada,2017,0,0,0
QAT,Qatar,CZE,Czech Republic,2008,3,0,3
QAT,Qatar,CZE,Czech Republic,2009,1,0,1
QAT,Qatar,CZE,Czech Republic,2010,2,0,2
QAT,Qatar,DNK,Denmark,2010,3,0,3
QAT,Qatar,DNK,Denmark,2012,1,0,1
QAT,Qatar,DNK,Denmark,2013,0,1,-1
QAT,Qatar,DNK,Denmark,2014,1,0,1
QAT,Qatar,DNK,Denmark,2015,1,0,1
QAT,Qatar,DNK,Denmark,2016,0,7,-7
QAT,Qatar,DNK,Denmark,2017,2,2,0
QAT,Qatar,FIN,Finland,2008,0,0,0
QAT,Qatar,FIN,Finland,2009,0,0,0
QAT,Qatar,FIN,Finland,2010,0,0,0
QAT,Qatar,FIN,Finland,2011,0,0,0
QAT,Qatar,FIN,Finland,2012,0,0,0
QAT,Qatar,FIN,Finland,2013,0,0,0
QAT,Qatar,FIN,Finland,2014,0,0,0
QAT,Qatar,FIN,Finland,2015,0,0,0
QAT,Qatar,FIN,Finland,2016,0,0,0
QAT,Qatar,FIN,Finland,2017,0,0,0
QAT,Qatar,FRA,France,2008,7,0,7
QAT,Qatar,FRA,France,2009,4,0,4
QAT,Qatar,FRA,France,2010,39,0,39
QAT,Qatar,FRA,France,2011,4,0,4
QAT,Qatar,FRA,France,2012,13,0,13
QAT,Qatar,FRA,France,2013,5,0,5
QAT,Qatar,FRA,France,2014,9,0,9
QAT,Qatar,FRA,France,2015,1,0,1
QAT,Qatar,FRA,France,2016,3,0,3
QAT,Qatar,FRA,France,2017,3,0,3
QAT,Qatar,DEU,Germany,2008,82,84,-2
QAT,Qatar,DEU,Germany,2009,119,69,50
QAT,Qatar,DEU,Germany,2010,167,139,28
QAT,Qatar,DEU,Germany,2011,121,153,-32
QAT,Qatar,DEU,Germany,2012,189,105,84
QAT,Qatar,DEU,Germany,2013,354,200,154
QAT,Qatar,DEU,Germany,2014,365,247,118
QAT,Qatar,DEU,Germany,2015,307,314,-7
QAT,Qatar,DEU,Germany,2016,574,400,174
QAT,Qatar,DEU,Germany,2017,459,449,10
QAT,Qatar,HUN,Hungary,2008,0,0,0
QAT,Qatar,HUN,Hungary,2009,4,0,4
QAT,Qatar,HUN,Hungary,2010,7,0,7
QAT,Qatar,HUN,Hungary,2011,0,4,-4
QAT,Qatar,HUN,Hungary,2012,9,0,9
QAT,Qatar,HUN,Hungary,2013,3,0,3
QAT,Qatar,HUN,Hungary,2014,0,0,0
QAT,Qatar,HUN,Hungary,2015,6,2,4
QAT,Qatar,HUN,Hungary,2016,15,9,6
QAT,Qatar,HUN,Hungary,2017,8,0,8
QAT,Qatar,ISL,Iceland,2008,0,0,0
QAT,Qatar,ISL,Iceland,2009,0,0,0
QAT,Qatar,ISL,Iceland,2010,0,0,0
QAT,Qatar,ISL,Iceland,2011,0,1,-1
QAT,Qatar,ISL,Iceland,2012,0,0,0
QAT,Qatar,ISL,Iceland,2016,0,0,0
QAT,Qatar,ISL,Iceland,2017,0,0,0
QAT,Qatar,ITA,Italy,2008,8,1,7
QAT,Qatar,ITA,Italy,2009,1,1,0
QAT,Qatar,ITA,Italy,2010,1,0,1
QAT,Qatar,ITA,Italy,2011,4,0,4
QAT,Qatar,ITA,Italy,2012,0,0,0
QAT,Qatar,ITA,Italy,2013,2,4,-2
QAT,Qatar,ITA,Italy,2014,1,0,1
QAT,Qatar,ITA,Italy,2015,2,0,2
QAT,Qatar,ITA,Italy,2016,3,0,3
QAT,Qatar,JPN,Japan,2008,42,41,1
QAT,Qatar,JPN,Japan,2009,97,106,-9
QAT,Qatar,JPN,Japan,2010,30,30,0
QAT,Qatar,JPN,Japan,2011,107,77,30
QAT,Qatar,JPN,Japan,2012,150,162,-12
QAT,Qatar,JPN,Japan,2013,151,139,12
QAT,Qatar,JPN,Japan,2014,126,122,4
QAT,Qatar,JPN,Japan,2015,260,254,6
QAT,Qatar,JPN,Japan,2016,72,68,4
QAT,Qatar,JPN,Japan,2017,62,61,1
QAT,Qatar,KOR,Korea,2008,12,10,2
QAT,Qatar,KOR,Korea,2009,6,7,-1
QAT,Qatar,KOR,Korea,2010,3,5,-2
QAT,Qatar,KOR,Korea,2011,1,2,-1
QAT,Qatar,KOR,Korea,2012,16,23,-7
QAT,Qatar,KOR,Korea,2013,1,6,-5
QAT,Qatar,KOR,Korea,2014,7,6,1
QAT,Qatar,KOR,Korea,2015,4,6,-2
QAT,Qatar,KOR,Korea,2016,7,12,-5
QAT,Qatar,KOR,Korea,2017,3,3,0
QAT,Qatar,LUX,Luxembourg,2008,0,0,0
QAT,Qatar,LUX,Luxembourg,2009,0,0,0
QAT,Qatar,LUX,Luxembourg,2010,0,0,0
QAT,Qatar,LUX,Luxembourg,2011,0,0,0
QAT,Qatar,LUX,Luxembourg,2012,0,0,0
QAT,Qatar,LUX,Luxembourg,2013,0,0,0
QAT,Qatar,LUX,Luxembourg,2014,0,0,0
QAT,Qatar,LUX,Luxembourg,2015,1,0,1
QAT,Qatar,LUX,Luxembourg,2016,0,0,0
QAT,Qatar,LUX,Luxembourg,2017,0,0,0
QAT,Qatar,MEX,Mexico,2012,0,0,0
QAT,Qatar,MEX,Mexico,2013,0,0,0
QAT,Qatar,MEX,Mexico,2014,0,0,0
QAT,Qatar,NLD,Netherlands,2009,2,3,-1
QAT,Qatar,NLD,Netherlands,2010,3,1,2
QAT,Qatar,NLD,Netherlands,2011,5,3,2
QAT,Qatar,NLD,Netherlands,2012,4,2,2
QAT,Qatar,NLD,Netherlands,2013,11,5,6
QAT,Qatar,NLD,Netherlands,2014,9,6,3
QAT,Qatar,NLD,Netherlands,2015,26,12,14
QAT,Qatar,NLD,Netherlands,2016,10,20,-10
QAT,Qatar,NLD,Netherlands,2017,5,16,-11
QAT,Qatar,NZL,New Zealand,2009,5,0,5
QAT,Qatar,NZL,New Zealand,2012,4,0,4
QAT,Qatar,NZL,New Zealand,2014,1,0,1
QAT,Qatar,NZL,New Zealand,2015,2,0,2
QAT,Qatar,NZL,New Zealand,2017,1,0,1
QAT,Qatar,NOR,Norway,2008,0,0,0
QAT,Qatar,NOR,Norway,2009,4,0,4
QAT,Qatar,NOR,Norway,2010,0,1,-1
QAT,Qatar,NOR,Norway,2011,1,0,1
QAT,Qatar,NOR,Norway,2012,0,0,0
QAT,Qatar,NOR,Norway,2013,0,0,0
QAT,Qatar,NOR,Norway,2014,0,1,-1
QAT,Qatar,NOR,Norway,2015,1,0,1
QAT,Qatar,NOR,Norway,2016,0,0,0
QAT,Qatar,NOR,Norway,2017,0,1,-1
QAT,Qatar,POL,Poland,2009,0,0,0
QAT,Qatar,POL,Poland,2010,0,0,0
QAT,Qatar,POL,Poland,2011,0,0,0
QAT,Qatar,POL,Poland,2012,0,0,0
QAT,Qatar,POL,Poland,2013,0,0,0
QAT,Qatar,POL,Poland,2014,0,0,0
QAT,Qatar,POL,Poland,2015,0,0,0
QAT,Qatar,POL,Poland,2016,10,0,10
QAT,Qatar,POL,Poland,2017,10,0,10
QAT,Qatar,SVK,Slovak Republic,2008,0,0,0
QAT,Qatar,ESP,Spain,2008,2,3,-1
QAT,Qatar,ESP,Spain,2009,3,1,2
QAT,Qatar,ESP,Spain,2010,3,1,2
QAT,Qatar,ESP,Spain,2011,2,1,1
QAT,Qatar,ESP,Spain,2012,2,0,2
QAT,Qatar,ESP,Spain,2013,2,0,2
QAT,Qatar,ESP,Spain,2014,12,1,11
QAT,Qatar,ESP,Spain,2015,19,2,17
QAT,Qatar,ESP,Spain,2016,22,6,16
QAT,Qatar,ESP,Spain,2017,12,7,5
QAT,Qatar,SWE,Sweden,2008,2,0,2
QAT,Qatar,SWE,Sweden,2009,1,1,0
QAT,Qatar,SWE,Sweden,2010,1,11,-10
QAT,Qatar,SWE,Sweden,2011,2,1,1
QAT,Qatar,SWE,Sweden,2012,1,3,-2
QAT,Qatar,SWE,Sweden,2013,1,1,0
QAT,Qatar,SWE,Sweden,2014,0,1,-1
QAT,Qatar,SWE,Sweden,2015,2,3,-1
QAT,Qatar,SWE,Sweden,2016,0,0,0
QAT,Qatar,SWE,Sweden,2017,1,1,0
QAT,Qatar,CHE,Switzerland,2010,3,3,0
QAT,Qatar,CHE,Switzerland,2011,10,3,7
QAT,Qatar,CHE,Switzerland,2012,1,4,-3
QAT,Qatar,CHE,Switzerland,2013,7,1,6
QAT,Qatar,CHE,Switzerland,2014,0,2,-2
QAT,Qatar,CHE,Switzerland,2015,5,1,4
QAT,Qatar,CHE,Switzerland,2016,4,18,-14
QAT,Qatar,CHE,Switzerland,2017,7,3,4
QAT,Qatar,TUR,Turkey,2010,1,0,1
QAT,Qatar,GBR,United Kingdom,2014,1000,0,1000
QAT,Qatar,USA,United States,2008,151,0,151
QAT,Qatar,USA,United States,2009,134,0,134
QAT,Qatar,USA,United States,2010,148,0,148
QAT,Qatar,USA,United States,2011,193,0,193
QAT,Qatar,USA,United States,2012,141,0,141
QAT,Qatar,USA,United States,2013,191,0,191
QAT,Qatar,USA,United States,2014,202,0,202
QAT,Qatar,USA,United States,2015,229,0,229
QAT,Qatar,USA,United States,2016,272,0,272
QAT,Qatar,USA,United States,2017,224,0,224
QAT,Qatar,CHL,Chile,2008,0,0,0
QAT,Qatar,CHL,Chile,2009,0,0,0
QAT,Qatar,CHL,Chile,2010,0,0,0
QAT,Qatar,CHL,Chile,2011,0,0,0
QAT,Qatar,CHL,Chile,2012,0,0,0
QAT,Qatar,CHL,Chile,2013,0,0,0
QAT,Qatar,CHL,Chile,2014,0,0,0
QAT,Qatar,CHL,Chile,2015,0,0,0
QAT,Qatar,CHL,Chile,2016,0,0,0
QAT,Qatar,EST,Estonia,2008,0,0,0
QAT,Qatar,EST,Estonia,2009,0,0,0
QAT,Qatar,EST,Estonia,2010,0,0,0
QAT,Qatar,EST,Estonia,2011,0,0,0
QAT,Qatar,EST,Estonia,2012,0,0,0
QAT,Qatar,EST,Estonia,2013,0,0,0
QAT,Qatar,EST,Estonia,2014,0,0,0
QAT,Qatar,EST,Estonia,2015,0,0,0
QAT,Qatar,EST,Estonia,2016,0,0,0
QAT,Qatar,EST,Estonia,2017,0,0,0
ROU,Romania,AUS,Australia,2008,303,106,197
ROU,Romania,AUS,Australia,2009,300,101,199
ROU,Romania,AUS,Australia,2010,294,115,179
ROU,Romania,AUS,Australia,2011,247,89,158
ROU,Romania,AUS,Australia,2012,300,94,206
ROU,Romania,AUS,Australia,2013,305,109,196
ROU,Romania,AUS,Australia,2014,310,139,171
ROU,Romania,AUS,Australia,2015,297,100,197
ROU,Romania,AUS,Australia,2016,271,100,171
ROU,Romania,AUS,Australia,2017,206,0,206
ROU,Romania,AUT,Austria,2008,9234,4718,4516
ROU,Romania,AUT,Austria,2009,9319,5827,3492
ROU,Romania,AUT,Austria,2010,11344,6358,4986
ROU,Romania,AUT,Austria,2011,12907,7707,5200
ROU,Romania,AUT,Austria,2012,13362,8004,5358
ROU,Romania,AUT,Austria,2013,13491,7791,5700
ROU,Romania,AUT,Austria,2014,20715,8005,12710
ROU,Romania,AUT,Austria,2015,17455,9205,8250
ROU,Romania,AUT,Austria,2016,16665,9134,7531
ROU,Romania,AUT,Austria,2017,17863,9447,8416
ROU,Romania,BEL,Belgium,2008,6779,879,5900
ROU,Romania,BEL,Belgium,2009,6066,1392,4674
ROU,Romania,BEL,Belgium,2010,8020,1831,6189
ROU,Romania,BEL,Belgium,2011,10889,2710,8179
ROU,Romania,BEL,Belgium,2012,11216,3241,7975
ROU,Romania,BEL,Belgium,2013,10046,4258,5788
ROU,Romania,BEL,Belgium,2014,11345,3243,8102
ROU,Romania,BEL,Belgium,2015,10627,3303,7324
ROU,Romania,BEL,Belgium,2016,10301,3025,7276
ROU,Romania,BEL,Belgium,2017,11569,3114,8455
ROU,Romania,CAN,Canada,2008,2836,0,2836
ROU,Romania,CAN,Canada,2009,2076,0,2076
ROU,Romania,CAN,Canada,2010,1922,0,1922
ROU,Romania,CAN,Canada,2011,1776,0,1776
ROU,Romania,CAN,Canada,2012,1588,0,1588
ROU,Romania,CAN,Canada,2013,1512,0,1512
ROU,Romania,CAN,Canada,2014,1553,0,1553
ROU,Romania,CAN,Canada,2015,1183,0,1183
ROU,Romania,CAN,Canada,2016,1360,0,1360
ROU,Romania,CAN,Canada,2017,975,0,975
ROU,Romania,CZE,Czech Republic,2008,634,112,522
ROU,Romania,CZE,Czech Republic,2009,460,47,413
ROU,Romania,CZE,Czech Republic,2010,432,103,329
ROU,Romania,CZE,Czech Republic,2011,437,19,418
ROU,Romania,CZE,Czech Republic,2012,661,54,607
ROU,Romania,CZE,Czech Republic,2013,931,66,865
ROU,Romania,CZE,Czech Republic,2014,1231,140,1091
ROU,Romania,CZE,Czech Republic,2015,1334,96,1238
ROU,Romania,CZE,Czech Republic,2016,1648,121,1527
ROU,Romania,CZE,Czech Republic,2017,1829,227,1602
ROU,Romania,DNK,Denmark,2008,1390,287,1103
ROU,Romania,DNK,Denmark,2009,1484,475,1009
ROU,Romania,DNK,Denmark,2010,2027,556,1471
ROU,Romania,DNK,Denmark,2011,2725,702,2023
ROU,Romania,DNK,Denmark,2012,3239,1093,2146
ROU,Romania,DNK,Denmark,2013,3587,1401,2186
ROU,Romania,DNK,Denmark,2014,4200,1705,2495
ROU,Romania,DNK,Denmark,2015,4306,1890,2416
ROU,Romania,DNK,Denmark,2016,4185,2535,1650
ROU,Romania,DNK,Denmark,2017,4109,3064,1045
ROU,Romania,FIN,Finland,2008,197,66,131
ROU,Romania,FIN,Finland,2009,164,41,123
ROU,Romania,FIN,Finland,2010,206,26,180
ROU,Romania,FIN,Finland,2011,258,28,230
ROU,Romania,FIN,Finland,2012,302,63,239
ROU,Romania,FIN,Finland,2013,257,47,210
ROU,Romania,FIN,Finland,2014,400,51,349
ROU,Romania,FIN,Finland,2015,355,40,315
ROU,Romania,FIN,Finland,2016,440,72,368
ROU,Romania,FIN,Finland,2017,413,56,357
ROU,Romania,FRA,France,2008,0,0,0
ROU,Romania,FRA,France,2009,0,0,0
ROU,Romania,FRA,France,2010,0,0,0
ROU,Romania,FRA,France,2011,0,0,0
ROU,Romania,FRA,France,2012,0,0,0
ROU,Romania,FRA,France,2013,6108,0,6108
ROU,Romania,FRA,France,2014,8056,0,8056
ROU,Romania,FRA,France,2015,10059,0,10059
ROU,Romania,FRA,France,2016,8547,0,8547
ROU,Romania,FRA,France,2017,8071,0,8071
ROU,Romania,DEU,Germany,2008,48225,37778,10447
ROU,Romania,DEU,Germany,2009,57273,44305,12968
ROU,Romania,DEU,Germany,2010,75531,48943,26588
ROU,Romania,DEU,Germany,2011,97518,59821,37697
ROU,Romania,DEU,Germany,2012,120524,71715,48809
ROU,Romania,DEU,Germany,2013,139487,86742,52745
ROU,Romania,DEU,Germany,2014,198705,118346,80359
ROU,Romania,DEU,Germany,2015,221405,129059,92346
ROU,Romania,DEU,Germany,2016,222298,162209,60089
ROU,Romania,DEU,Germany,2017,230603,157415,73188
ROU,Romania,HUN,Hungary,2008,9987,1718,8269
ROU,Romania,HUN,Hungary,2009,7104,1602,5502
ROU,Romania,HUN,Hungary,2010,6581,1132,5449
ROU,Romania,HUN,Hungary,2011,5804,168,5636
ROU,Romania,HUN,Hungary,2012,4243,4245,-2
ROU,Romania,HUN,Hungary,2013,4039,6056,-2017
ROU,Romania,HUN,Hungary,2014,3675,3516,159
ROU,Romania,HUN,Hungary,2015,3494,2519,975
ROU,Romania,HUN,Hungary,2016,3090,2576,514
ROU,Romania,HUN,Hungary,2017,2934,2401,533
ROU,Romania,ISL,Iceland,2008,53,25,28
ROU,Romania,ISL,Iceland,2009,36,54,-18
ROU,Romania,ISL,Iceland,2010,23,19,4
ROU,Romania,ISL,Iceland,2011,19,9,10
ROU,Romania,ISL,Iceland,2012,62,7,55
ROU,Romania,ISL,Iceland,2013,60,22,38
ROU,Romania,ISL,Iceland,2014,115,24,91
ROU,Romania,ISL,Iceland,2015,163,32,131
ROU,Romania,ISL,Iceland,2016,257,65,192
ROU,Romania,ISL,Iceland,2017,485,84,401
ROU,Romania,ITA,Italy,2008,174554,8308,166246
ROU,Romania,ITA,Italy,2009,105597,9924,95673
ROU,Romania,ITA,Italy,2010,92116,7488,84628
ROU,Romania,ITA,Italy,2011,90096,7693,82403
ROU,Romania,ITA,Italy,2012,81666,9131,72535
ROU,Romania,ITA,Italy,2013,58227,11014,47213
ROU,Romania,ITA,Italy,2014,50705,13518,37187
ROU,Romania,ITA,Italy,2015,46439,12914,33525
ROU,Romania,ITA,Italy,2016,45238,0,45238
ROU,Romania,ITA,Italy,2017,43485,12220,31265
ROU,Romania,JPN,Japan,2008,381,395,-14
ROU,Romania,JPN,Japan,2009,391,366,25
ROU,Romania,JPN,Japan,2010,367,356,11
ROU,Romania,JPN,Japan,2011,221,217,4
ROU,Romania,JPN,Japan,2012,294,277,17
ROU,Romania,JPN,Japan,2013,292,257,35
ROU,Romania,JPN,Japan,2014,269,250,19
ROU,Romania,JPN,Japan,2015,497,323,174
ROU,Romania,JPN,Japan,2016,412,266,146
ROU,Romania,JPN,Japan,2017,370,358,12
ROU,Romania,KOR,Korea,2008,200,282,-82
ROU,Romania,KOR,Korea,2009,96,146,-50
ROU,Romania,KOR,Korea,2010,93,103,-10
ROU,Romania,KOR,Korea,2011,117,114,3
ROU,Romania,KOR,Korea,2012,131,129,2
ROU,Romania,KOR,Korea,2013,131,118,13
ROU,Romania,KOR,Korea,2014,119,127,-8
ROU,Romania,KOR,Korea,2015,100,125,-25
ROU,Romania,KOR,Korea,2016,100,105,-5
ROU,Romania,KOR,Korea,2017,89,130,-41
ROU,Romania,LUX,Luxembourg,2008,277,66,211
ROU,Romania,LUX,Luxembourg,2009,238,67,171
ROU,Romania,LUX,Luxembourg,2010,317,75,242
ROU,Romania,LUX,Luxembourg,2011,453,103,350
ROU,Romania,LUX,Luxembourg,2012,409,130,279
ROU,Romania,LUX,Luxembourg,2013,402,149,253
ROU,Romania,LUX,Luxembourg,2014,755,88,667
ROU,Romania,LUX,Luxembourg,2015,726,158,568
ROU,Romania,LUX,Luxembourg,2016,642,306,336
ROU,Romania,LUX,Luxembourg,2017,717,198,519
ROU,Romania,MEX,Mexico,2008,28,0,28
ROU,Romania,MEX,Mexico,2009,39,0,39
ROU,Romania,MEX,Mexico,2010,46,0,46
ROU,Romania,MEX,Mexico,2011,47,0,47
ROU,Romania,MEX,Mexico,2012,45,0,45
ROU,Romania,MEX,Mexico,2013,121,0,121
ROU,Romania,MEX,Mexico,2014,77,0,77
ROU,Romania,MEX,Mexico,2015,86,0,86
ROU,Romania,MEX,Mexico,2016,83,0,83
ROU,Romania,MEX,Mexico,2017,59,0,59
ROU,Romania,NLD,Netherlands,2008,2411,1004,1407
ROU,Romania,NLD,Netherlands,2009,2167,1233,934
ROU,Romania,NLD,Netherlands,2010,2627,1388,1239
ROU,Romania,NLD,Netherlands,2011,2743,1825,918
ROU,Romania,NLD,Netherlands,2012,2535,1972,563
ROU,Romania,NLD,Netherlands,2013,2521,1893,628
ROU,Romania,NLD,Netherlands,2014,4553,2420,2133
ROU,Romania,NLD,Netherlands,2015,4287,2548,1739
ROU,Romania,NLD,Netherlands,2016,5190,2783,2407
ROU,Romania,NLD,Netherlands,2017,7544,3580,3964
ROU,Romania,NZL,New Zealand,2008,39,57,-18
ROU,Romania,NZL,New Zealand,2009,30,32,-2
ROU,Romania,NZL,New Zealand,2010,42,27,15
ROU,Romania,NZL,New Zealand,2011,41,23,18
ROU,Romania,NZL,New Zealand,2012,54,17,37
ROU,Romania,NZL,New Zealand,2013,60,20,40
ROU,Romania,NZL,New Zealand,2014,66,15,51
ROU,Romania,NZL,New Zealand,2015,32,19,13
ROU,Romania,NZL,New Zealand,2016,41,20,21
ROU,Romania,NZL,New Zealand,2017,36,16,20
ROU,Romania,NOR,Norway,2008,1104,73,1031
ROU,Romania,NOR,Norway,2009,1142,184,958
ROU,Romania,NOR,Norway,2010,1322,285,1037
ROU,Romania,NOR,Norway,2011,1424,315,1109
ROU,Romania,NOR,Norway,2012,2020,300,1720
ROU,Romania,NOR,Norway,2013,2544,236,2308
ROU,Romania,NOR,Norway,2014,2148,237,1911
ROU,Romania,NOR,Norway,2015,1933,324,1609
ROU,Romania,NOR,Norway,2016,1235,720,515
ROU,Romania,NOR,Norway,2017,1202,877,325
ROU,Romania,POL,Poland,2008,185,0,185
ROU,Romania,POL,Poland,2009,176,0,176
ROU,Romania,POL,Poland,2010,168,0,168
ROU,Romania,POL,Poland,2011,283,0,283
ROU,Romania,POL,Poland,2012,368,0,368
ROU,Romania,POL,Poland,2013,340,0,340
ROU,Romania,POL,Poland,2014,340,0,340
ROU,Romania,POL,Poland,2015,562,0,562
ROU,Romania,POL,Poland,2016,634,0,634
ROU,Romania,POL,Poland,2017,661,0,661
ROU,Romania,PRT,Portugal,2008,5252,0,5252
ROU,Romania,PRT,Portugal,2009,8111,0,8111
ROU,Romania,PRT,Portugal,2010,6047,0,6047
ROU,Romania,PRT,Portugal,2011,4582,0,4582
ROU,Romania,PRT,Portugal,2012,3010,0,3010
ROU,Romania,PRT,Portugal,2013,2665,0,2665
ROU,Romania,PRT,Portugal,2014,2455,0,2455
ROU,Romania,PRT,Portugal,2015,2569,0,2569
ROU,Romania,PRT,Portugal,2016,2479,0,2479
ROU,Romania,PRT,Portugal,2017,2421,0,2421
ROU,Romania,SVK,Slovak Republic,2008,2122,25,2097
ROU,Romania,SVK,Slovak Republic,2009,579,46,533
ROU,Romania,SVK,Slovak Republic,2010,412,14,398
ROU,Romania,SVK,Slovak Republic,2011,458,13,445
ROU,Romania,SVK,Slovak Republic,2012,275,12,263
ROU,Romania,SVK,Slovak Republic,2013,274,3,271
ROU,Romania,SVK,Slovak Republic,2014,290,1,289
ROU,Romania,SVK,Slovak Republic,2015,498,1,497
ROU,Romania,SVK,Slovak Republic,2016,471,6,465
ROU,Romania,SVK,Slovak Republic,2017,238,0,238
ROU,Romania,ESP,Spain,2008,61262,32411,28851
ROU,Romania,ESP,Spain,2009,44079,50473,-6394
ROU,Romania,ESP,Spain,2010,51915,49792,2123
ROU,Romania,ESP,Spain,2011,50831,42501,8330
ROU,Romania,ESP,Spain,2012,27273,64714,-37441
ROU,Romania,ESP,Spain,2013,22774,70678,-47904
ROU,Romania,ESP,Spain,2014,29721,55969,-26248
ROU,Romania,ESP,Spain,2015,28785,49123,-20338
ROU,Romania,ESP,Spain,2016,28629,46328,-17699
ROU,Romania,ESP,Spain,2017,31184,47396,-16212
ROU,Romania,SWE,Sweden,2008,2544,269,2275
ROU,Romania,SWE,Sweden,2009,1829,529,1300
ROU,Romania,SWE,Sweden,2010,1726,443,1283
ROU,Romania,SWE,Sweden,2011,1928,541,1387
ROU,Romania,SWE,Sweden,2012,1737,530,1207
ROU,Romania,SWE,Sweden,2013,1863,468,1395
ROU,Romania,SWE,Sweden,2014,1994,435,1559
ROU,Romania,SWE,Sweden,2015,2309,480,1829
ROU,Romania,SWE,Sweden,2016,2279,533,1746
ROU,Romania,SWE,Sweden,2017,2211,473,1738
ROU,Romania,CHE,Switzerland,2008,808,270,538
ROU,Romania,CHE,Switzerland,2009,1003,262,741
ROU,Romania,CHE,Switzerland,2010,1407,334,1073
ROU,Romania,CHE,Switzerland,2011,1722,395,1327
ROU,Romania,CHE,Switzerland,2012,2258,480,1778
ROU,Romania,CHE,Switzerland,2013,2659,813,1846
ROU,Romania,CHE,Switzerland,2014,2387,971,1416
ROU,Romania,CHE,Switzerland,2015,2014,786,1228
ROU,Romania,CHE,Switzerland,2016,2883,855,2028
ROU,Romania,CHE,Switzerland,2017,2882,861,2021
ROU,Romania,TUR,Turkey,2010,142,0,142
ROU,Romania,TUR,Turkey,2016,505,476,29
ROU,Romania,TUR,Turkey,2017,553,409,144
ROU,Romania,GBR,United Kingdom,2009,10000,0,10000
ROU,Romania,GBR,United Kingdom,2010,7000,0,7000
ROU,Romania,GBR,United Kingdom,2011,8000,4000,4000
ROU,Romania,GBR,United Kingdom,2012,6000,2000,4000
ROU,Romania,GBR,United Kingdom,2013,19000,2000,17000
ROU,Romania,GBR,United Kingdom,2014,37000,3000,34000
ROU,Romania,GBR,United Kingdom,2015,56000,5000,51000
ROU,Romania,GBR,United Kingdom,2016,55000,10000,45000
ROU,Romania,GBR,United Kingdom,2017,51000,15000,36000
ROU,Romania,USA,United States,2008,4930,0,4930
ROU,Romania,USA,United States,2009,4910,0,4910
ROU,Romania,USA,United States,2010,4003,0,4003
ROU,Romania,USA,United States,2011,3882,0,3882
ROU,Romania,USA,United States,2012,3748,0,3748
ROU,Romania,USA,United States,2013,3773,0,3773
ROU,Romania,USA,United States,2014,3246,0,3246
ROU,Romania,USA,United States,2015,3376,0,3376
ROU,Romania,USA,United States,2016,3554,0,3554
ROU,Romania,USA,United States,2017,2953,0,2953
ROU,Romania,CHL,Chile,2008,18,0,18
ROU,Romania,CHL,Chile,2009,22,0,22
ROU,Romania,CHL,Chile,2010,27,0,27
ROU,Romania,CHL,Chile,2011,46,0,46
ROU,Romania,CHL,Chile,2012,39,0,39
ROU,Romania,CHL,Chile,2013,91,0,91
ROU,Romania,CHL,Chile,2014,75,0,75
ROU,Romania,CHL,Chile,2015,70,0,70
ROU,Romania,CHL,Chile,2016,102,0,102
ROU,Romania,EST,Estonia,2008,10,0,10
ROU,Romania,EST,Estonia,2009,4,0,4
ROU,Romania,EST,Estonia,2010,3,0,3
ROU,Romania,EST,Estonia,2011,1,0,1
ROU,Romania,EST,Estonia,2012,0,0,0
ROU,Romania,EST,Estonia,2013,1,0,1
ROU,Romania,EST,Estonia,2014,6,0,6
ROU,Romania,EST,Estonia,2015,52,0,52
ROU,Romania,EST,Estonia,2016,60,0,60
ROU,Romania,EST,Estonia,2017,153,0,153
ROU,Romania,ISR,Israel,2008,29,0,29
ROU,Romania,ISR,Israel,2009,35,0,35
ROU,Romania,ISR,Israel,2010,54,0,54
ROU,Romania,ISR,Israel,2011,41,0,41
ROU,Romania,ISR,Israel,2012,51,0,51
ROU,Romania,ISR,Israel,2013,41,0,41
ROU,Romania,ISR,Israel,2014,22,0,22
ROU,Romania,ISR,Israel,2015,21,0,21
ROU,Romania,ISR,Israel,2016,15,0,15
ROU,Romania,ISR,Israel,2017,9,0,9
ROU,Romania,SVN,Slovenia,2008,437,46,391
ROU,Romania,SVN,Slovenia,2009,205,111,94
ROU,Romania,SVN,Slovenia,2010,1,48,-47
ROU,Romania,SVN,Slovenia,2011,307,14,293
ROU,Romania,SVN,Slovenia,2012,269,18,251
ROU,Romania,SVN,Slovenia,2013,448,0,448
ROU,Romania,SVN,Slovenia,2014,350,10,340
ROU,Romania,SVN,Slovenia,2015,212,7,205
ROU,Romania,SVN,Slovenia,2016,227,16,211
ROU,Romania,SVN,Slovenia,2017,200,14,186
RUS,Russia,AUS,Australia,2008,906,160,746
RUS,Russia,AUS,Australia,2009,1213,135,1078
RUS,Russia,AUS,Australia,2010,1109,141,968
RUS,Russia,AUS,Australia,2011,1090,156,934
RUS,Russia,AUS,Australia,2012,1175,148,1027
RUS,Russia,AUS,Australia,2013,1397,161,1236
RUS,Russia,AUS,Australia,2014,1217,185,1032
RUS,Russia,AUS,Australia,2015,1270,200,1070
RUS,Russia,AUS,Australia,2016,1010,200,810
RUS,Russia,AUS,Australia,2017,1126,0,1126
RUS,Russia,AUT,Austria,2008,2885,1215,1670
RUS,Russia,AUT,Austria,2009,2404,1781,623
RUS,Russia,AUT,Austria,2010,2205,1639,566
RUS,Russia,AUT,Austria,2011,2643,1578,1065
RUS,Russia,AUT,Austria,2012,3438,1600,1838
RUS,Russia,AUT,Austria,2013,3471,1972,1499
RUS,Russia,AUT,Austria,2014,3139,1823,1316
RUS,Russia,AUT,Austria,2015,2949,1814,1135
RUS,Russia,AUT,Austria,2016,2699,1852,847
RUS,Russia,AUT,Austria,2017,2378,2023,355
RUS,Russia,BEL,Belgium,2008,809,269,540
RUS,Russia,BEL,Belgium,2009,810,271,539
RUS,Russia,BEL,Belgium,2010,900,406,494
RUS,Russia,BEL,Belgium,2011,970,410,560
RUS,Russia,BEL,Belgium,2012,2041,1417,624
RUS,Russia,BEL,Belgium,2013,1507,1820,-313
RUS,Russia,BEL,Belgium,2014,1114,1571,-457
RUS,Russia,BEL,Belgium,2015,1098,1156,-58
RUS,Russia,BEL,Belgium,2016,941,652,289
RUS,Russia,BEL,Belgium,2017,933,361,572
RUS,Russia,CAN,Canada,2008,2690,0,2690
RUS,Russia,CAN,Canada,2009,2931,0,2931
RUS,Russia,CAN,Canada,2010,2288,0,2288
RUS,Russia,CAN,Canada,2011,1963,0,1963
RUS,Russia,CAN,Canada,2012,2077,0,2077
RUS,Russia,CAN,Canada,2013,2462,0,2462
RUS,Russia,CAN,Canada,2014,1772,0,1772
RUS,Russia,CAN,Canada,2015,2147,0,2147
RUS,Russia,CAN,Canada,2016,2430,0,2430
RUS,Russia,CAN,Canada,2017,2295,0,2295
RUS,Russia,CZE,Czech Republic,2008,5763,35,5728
RUS,Russia,CZE,Czech Republic,2009,4115,9,4106
RUS,Russia,CZE,Czech Republic,2010,3681,11,3670
RUS,Russia,CZE,Czech Republic,2011,2146,23,2123
RUS,Russia,CZE,Czech Republic,2012,3201,1635,1566
RUS,Russia,CZE,Czech Republic,2013,3050,3231,-181
RUS,Russia,CZE,Czech Republic,2014,4862,1757,3105
RUS,Russia,CZE,Czech Republic,2015,2852,2061,791
RUS,Russia,CZE,Czech Republic,2016,2404,1867,537
RUS,Russia,CZE,Czech Republic,2017,2891,1545,1346
RUS,Russia,DNK,Denmark,2008,431,226,205
RUS,Russia,DNK,Denmark,2009,400,218,182
RUS,Russia,DNK,Denmark,2010,363,201,162
RUS,Russia,DNK,Denmark,2011,388,147,241
RUS,Russia,DNK,Denmark,2012,371,180,191
RUS,Russia,DNK,Denmark,2013,495,191,304
RUS,Russia,DNK,Denmark,2014,387,183,204
RUS,Russia,DNK,Denmark,2015,323,145,178
RUS,Russia,DNK,Denmark,2016,278,210,68
RUS,Russia,DNK,Denmark,2017,282,246,36
RUS,Russia,FIN,Finland,2008,2950,301,2649
RUS,Russia,FIN,Finland,2009,2336,252,2084
RUS,Russia,FIN,Finland,2010,2297,264,2033
RUS,Russia,FIN,Finland,2011,2795,198,2597
RUS,Russia,FIN,Finland,2012,3050,275,2775
RUS,Russia,FIN,Finland,2013,2875,292,2583
RUS,Russia,FIN,Finland,2014,2420,393,2027
RUS,Russia,FIN,Finland,2015,2086,278,1808
RUS,Russia,FIN,Finland,2016,2540,446,2094
RUS,Russia,FIN,Finland,2017,1549,493,1056
RUS,Russia,FRA,France,2008,3112,0,3112
RUS,Russia,FRA,France,2009,3408,0,3408
RUS,Russia,FRA,France,2010,3494,0,3494
RUS,Russia,FRA,France,2011,3784,0,3784
RUS,Russia,FRA,France,2012,3837,0,3837
RUS,Russia,FRA,France,2013,4066,0,4066
RUS,Russia,FRA,France,2014,4349,0,4349
RUS,Russia,FRA,France,2015,3898,0,3898
RUS,Russia,FRA,France,2016,4075,0,4075
RUS,Russia,FRA,France,2017,4028,0,4028
RUS,Russia,DEU,Germany,2008,15052,13881,1171
RUS,Russia,DEU,Germany,2009,15652,13267,2385
RUS,Russia,DEU,Germany,2010,16063,11424,4639
RUS,Russia,DEU,Germany,2011,17487,10544,6943
RUS,Russia,DEU,Germany,2012,18812,9553,9259
RUS,Russia,DEU,Germany,2013,31367,14408,16959
RUS,Russia,DEU,Germany,2014,20629,13888,6741
RUS,Russia,DEU,Germany,2015,21633,10584,11049
RUS,Russia,DEU,Germany,2016,23085,11173,11912
RUS,Russia,DEU,Germany,2017,18137,11287,6850
RUS,Russia,GRC,Greece,2008,1040,0,1040
RUS,Russia,GRC,Greece,2009,1200,0,1200
RUS,Russia,GRC,Greece,2010,1221,0,1221
RUS,Russia,GRC,Greece,2011,1436,0,1436
RUS,Russia,HUN,Hungary,2008,366,15,351
RUS,Russia,HUN,Hungary,2009,450,55,395
RUS,Russia,HUN,Hungary,2010,391,72,319
RUS,Russia,HUN,Hungary,2011,434,70,364
RUS,Russia,HUN,Hungary,2012,527,51,476
RUS,Russia,HUN,Hungary,2013,590,50,540
RUS,Russia,HUN,Hungary,2014,1040,88,952
RUS,Russia,HUN,Hungary,2015,907,149,758
RUS,Russia,HUN,Hungary,2016,655,199,456
RUS,Russia,HUN,Hungary,2017,814,276,538
RUS,Russia,ISL,Iceland,2008,32,28,4
RUS,Russia,ISL,Iceland,2009,19,18,1
RUS,Russia,ISL,Iceland,2010,21,6,15
RUS,Russia,ISL,Iceland,2011,25,10,15
RUS,Russia,ISL,Iceland,2012,21,6,15
RUS,Russia,ISL,Iceland,2013,23,19,4
RUS,Russia,ISL,Iceland,2014,27,15,12
RUS,Russia,ISL,Iceland,2016,53,16,37
RUS,Russia,ISL,Iceland,2017,32,14,18
RUS,Russia,ITA,Italy,2008,3752,104,3648
RUS,Russia,ITA,Italy,2009,4061,120,3941
RUS,Russia,ITA,Italy,2010,5138,152,4986
RUS,Russia,ITA,Italy,2011,4269,168,4101
RUS,Russia,ITA,Italy,2012,3970,243,3727
RUS,Russia,ITA,Italy,2013,4384,387,3997
RUS,Russia,ITA,Italy,2014,3193,337,2856
RUS,Russia,ITA,Italy,2015,3035,328,2707
RUS,Russia,ITA,Italy,2016,2877,0,2877
RUS,Russia,ITA,Italy,2017,2787,307,2480
RUS,Russia,JPN,Japan,2008,4531,4190,341
RUS,Russia,JPN,Japan,2009,4531,3608,923
RUS,Russia,JPN,Japan,2010,3462,3191,271
RUS,Russia,JPN,Japan,2011,2761,2531,230
RUS,Russia,JPN,Japan,2012,3829,3542,287
RUS,Russia,JPN,Japan,2013,2540,2173,367
RUS,Russia,JPN,Japan,2014,3047,2555,492
RUS,Russia,JPN,Japan,2015,3431,2868,563
RUS,Russia,JPN,Japan,2016,3905,3403,502
RUS,Russia,JPN,Japan,2017,3629,2323,1306
RUS,Russia,KOR,Korea,2008,2587,3170,-583
RUS,Russia,KOR,Korea,2009,2895,2578,317
RUS,Russia,KOR,Korea,2010,2601,2298,303
RUS,Russia,KOR,Korea,2011,2560,2298,262
RUS,Russia,KOR,Korea,2012,2723,2371,352
RUS,Russia,KOR,Korea,2013,2846,2398,448
RUS,Russia,KOR,Korea,2014,3207,2627,580
RUS,Russia,KOR,Korea,2015,6784,2837,3947
RUS,Russia,KOR,Korea,2016,15025,5187,9838
RUS,Russia,KOR,Korea,2017,18638,8621,10017
RUS,Russia,LUX,Luxembourg,2008,96,47,49
RUS,Russia,LUX,Luxembourg,2009,93,53,40
RUS,Russia,LUX,Luxembourg,2010,101,34,67
RUS,Russia,LUX,Luxembourg,2011,127,23,104
RUS,Russia,LUX,Luxembourg,2012,130,48,82
RUS,Russia,LUX,Luxembourg,2013,210,48,162
RUS,Russia,LUX,Luxembourg,2014,212,48,164
RUS,Russia,LUX,Luxembourg,2015,259,67,192
RUS,Russia,LUX,Luxembourg,2016,239,83,156
RUS,Russia,LUX,Luxembourg,2017,306,66,240
RUS,Russia,MEX,Mexico,2008,91,0,91
RUS,Russia,MEX,Mexico,2009,132,0,132
RUS,Russia,MEX,Mexico,2010,95,0,95
RUS,Russia,MEX,Mexico,2011,95,0,95
RUS,Russia,MEX,Mexico,2012,101,0,101
RUS,Russia,MEX,Mexico,2013,290,0,290
RUS,Russia,MEX,Mexico,2014,199,0,199
RUS,Russia,MEX,Mexico,2015,173,0,173
RUS,Russia,MEX,Mexico,2016,212,0,212
RUS,Russia,MEX,Mexico,2017,201,0,201
RUS,Russia,NLD,Netherlands,2009,876,421,455
RUS,Russia,NLD,Netherlands,2010,969,419,550
RUS,Russia,NLD,Netherlands,2011,1173,447,726
RUS,Russia,NLD,Netherlands,2012,1234,489,745
RUS,Russia,NLD,Netherlands,2013,1318,650,668
RUS,Russia,NLD,Netherlands,2014,1453,557,896
RUS,Russia,NLD,Netherlands,2015,1640,618,1022
RUS,Russia,NLD,Netherlands,2016,1766,724,1042
RUS,Russia,NLD,Netherlands,2017,1968,762,1206
RUS,Russia,NZL,New Zealand,2008,297,53,244
RUS,Russia,NZL,New Zealand,2009,265,64,201
RUS,Russia,NZL,New Zealand,2010,281,85,196
RUS,Russia,NZL,New Zealand,2011,361,80,281
RUS,Russia,NZL,New Zealand,2012,340,89,251
RUS,Russia,NZL,New Zealand,2013,370,84,286
RUS,Russia,NZL,New Zealand,2014,438,83,355
RUS,Russia,NZL,New Zealand,2015,394,79,315
RUS,Russia,NZL,New Zealand,2016,448,66,382
RUS,Russia,NZL,New Zealand,2017,468,109,359
RUS,Russia,NOR,Norway,2008,1157,182,975
RUS,Russia,NOR,Norway,2009,999,322,677
RUS,Russia,NOR,Norway,2010,934,294,640
RUS,Russia,NOR,Norway,2011,1020,435,585
RUS,Russia,NOR,Norway,2012,1080,317,763
RUS,Russia,NOR,Norway,2013,1016,434,582
RUS,Russia,NOR,Norway,2014,732,392,340
RUS,Russia,NOR,Norway,2015,699,377,322
RUS,Russia,NOR,Norway,2016,525,362,163
RUS,Russia,NOR,Norway,2017,498,227,271
RUS,Russia,POL,Poland,2008,1806,0,1806
RUS,Russia,POL,Poland,2009,1567,0,1567
RUS,Russia,POL,Poland,2010,1604,0,1604
RUS,Russia,POL,Poland,2011,1620,0,1620
RUS,Russia,POL,Poland,2012,1871,0,1871
RUS,Russia,POL,Poland,2013,1894,0,1894
RUS,Russia,POL,Poland,2014,1113,0,1113
RUS,Russia,POL,Poland,2015,2499,0,2499
RUS,Russia,POL,Poland,2016,2609,0,2609
RUS,Russia,POL,Poland,2017,2706,0,2706
RUS,Russia,PRT,Portugal,2008,501,0,501
RUS,Russia,PRT,Portugal,2009,396,0,396
RUS,Russia,PRT,Portugal,2010,311,0,311
RUS,Russia,PRT,Portugal,2011,324,0,324
RUS,Russia,PRT,Portugal,2012,320,0,320
RUS,Russia,PRT,Portugal,2013,332,0,332
RUS,Russia,PRT,Portugal,2014,365,0,365
RUS,Russia,PRT,Portugal,2015,293,0,293
RUS,Russia,PRT,Portugal,2016,314,0,314
RUS,Russia,PRT,Portugal,2017,421,0,421
RUS,Russia,SVK,Slovak Republic,2008,29,1,28
RUS,Russia,SVK,Slovak Republic,2009,52,82,-30
RUS,Russia,SVK,Slovak Republic,2010,61,94,-33
RUS,Russia,SVK,Slovak Republic,2011,40,81,-41
RUS,Russia,SVK,Slovak Republic,2012,34,1,33
RUS,Russia,SVK,Slovak Republic,2013,43,0,43
RUS,Russia,SVK,Slovak Republic,2014,39,3,36
RUS,Russia,SVK,Slovak Republic,2015,53,1,52
RUS,Russia,SVK,Slovak Republic,2016,49,0,49
RUS,Russia,SVK,Slovak Republic,2017,60,2,58
RUS,Russia,ESP,Spain,2008,5752,2879,2873
RUS,Russia,ESP,Spain,2009,5288,3172,2116
RUS,Russia,ESP,Spain,2010,6171,3134,3037
RUS,Russia,ESP,Spain,2011,7635,3127,4508
RUS,Russia,ESP,Spain,2012,7642,3466,4176
RUS,Russia,ESP,Spain,2013,8440,5529,2911
RUS,Russia,ESP,Spain,2014,8208,3735,4473
RUS,Russia,ESP,Spain,2015,7042,3254,3788
RUS,Russia,ESP,Spain,2016,6236,3847,2389
RUS,Russia,ESP,Spain,2017,6971,5159,1812
RUS,Russia,SWE,Sweden,2008,914,139,775
RUS,Russia,SWE,Sweden,2009,1094,126,968
RUS,Russia,SWE,Sweden,2010,1221,132,1089
RUS,Russia,SWE,Sweden,2011,1186,213,973
RUS,Russia,SWE,Sweden,2012,1266,250,1016
RUS,Russia,SWE,Sweden,2013,1125,156,969
RUS,Russia,SWE,Sweden,2014,1140,278,862
RUS,Russia,SWE,Sweden,2015,814,387,427
RUS,Russia,SWE,Sweden,2016,1072,210,862
RUS,Russia,SWE,Sweden,2017,1017,208,809
RUS,Russia,CHE,Switzerland,2010,1926,890,1036
RUS,Russia,CHE,Switzerland,2011,2048,805,1243
RUS,Russia,CHE,Switzerland,2012,2057,813,1244
RUS,Russia,CHE,Switzerland,2013,2145,840,1305
RUS,Russia,CHE,Switzerland,2014,1914,859,1055
RUS,Russia,CHE,Switzerland,2015,1768,962,806
RUS,Russia,CHE,Switzerland,2016,1634,947,687
RUS,Russia,CHE,Switzerland,2017,1544,857,687
RUS,Russia,TUR,Turkey,2010,1778,0,1778
RUS,Russia,TUR,Turkey,2016,6425,3680,2745
RUS,Russia,TUR,Turkey,2017,7311,5767,1544
RUS,Russia,GBR,United Kingdom,2013,1000,0,1000
RUS,Russia,GBR,United Kingdom,2014,3000,0,3000
RUS,Russia,GBR,United Kingdom,2015,1000,0,1000
RUS,Russia,USA,United States,2008,11695,0,11695
RUS,Russia,USA,United States,2009,8238,0,8238
RUS,Russia,USA,United States,2010,6718,0,6718
RUS,Russia,USA,United States,2011,7944,0,7944
RUS,Russia,USA,United States,2012,9969,0,9969
RUS,Russia,USA,United States,2013,9753,0,9753
RUS,Russia,USA,United States,2014,9079,0,9079
RUS,Russia,USA,United States,2015,8799,0,8799
RUS,Russia,USA,United States,2016,9297,0,9297
RUS,Russia,USA,United States,2017,8918,0,8918
RUS,Russia,CHL,Chile,2008,77,0,77
RUS,Russia,CHL,Chile,2009,90,0,90
RUS,Russia,CHL,Chile,2010,92,0,92
RUS,Russia,CHL,Chile,2011,144,0,144
RUS,Russia,CHL,Chile,2012,107,0,107
RUS,Russia,CHL,Chile,2013,165,0,165
RUS,Russia,CHL,Chile,2014,168,0,168
RUS,Russia,CHL,Chile,2015,194,0,194
RUS,Russia,CHL,Chile,2016,181,0,181
RUS,Russia,EST,Estonia,2008,435,151,284
RUS,Russia,EST,Estonia,2009,505,193,312
RUS,Russia,EST,Estonia,2010,356,189,167
RUS,Russia,EST,Estonia,2011,913,154,759
RUS,Russia,EST,Estonia,2012,460,114,346
RUS,Russia,EST,Estonia,2013,544,106,438
RUS,Russia,EST,Estonia,2014,421,115,306
RUS,Russia,EST,Estonia,2015,1294,677,617
RUS,Russia,EST,Estonia,2016,1290,981,309
RUS,Russia,EST,Estonia,2017,1272,915,357
RUS,Russia,SVN,Slovenia,2008,174,49,125
RUS,Russia,SVN,Slovenia,2009,126,59,67
RUS,Russia,SVN,Slovenia,2010,140,41,99
RUS,Russia,SVN,Slovenia,2011,273,10,263
RUS,Russia,SVN,Slovenia,2012,315,18,297
RUS,Russia,SVN,Slovenia,2013,511,11,500
RUS,Russia,SVN,Slovenia,2014,727,21,706
RUS,Russia,SVN,Slovenia,2015,562,63,499
RUS,Russia,SVN,Slovenia,2016,394,64,330
RUS,Russia,SVN,Slovenia,2017,504,50,454
RWA,Rwanda,AUS,Australia,2008,78,0,78
RWA,Rwanda,AUS,Australia,2009,66,5,61
RWA,Rwanda,AUS,Australia,2010,139,0,139
RWA,Rwanda,AUS,Australia,2011,73,0,73
RWA,Rwanda,AUS,Australia,2012,46,0,46
RWA,Rwanda,AUS,Australia,2013,43,0,43
RWA,Rwanda,AUS,Australia,2014,36,0,36
RWA,Rwanda,AUS,Australia,2015,25,0,25
RWA,Rwanda,AUS,Australia,2016,66,0,66
RWA,Rwanda,AUS,Australia,2017,50,0,50
RWA,Rwanda,AUT,Austria,2008,10,3,7
RWA,Rwanda,AUT,Austria,2009,7,4,3
RWA,Rwanda,AUT,Austria,2010,10,8,2
RWA,Rwanda,AUT,Austria,2011,25,6,19
RWA,Rwanda,AUT,Austria,2012,18,6,12
RWA,Rwanda,AUT,Austria,2013,17,4,13
RWA,Rwanda,AUT,Austria,2014,20,10,10
RWA,Rwanda,AUT,Austria,2015,30,8,22
RWA,Rwanda,AUT,Austria,2016,27,9,18
RWA,Rwanda,AUT,Austria,2017,14,15,-1
RWA,Rwanda,BEL,Belgium,2008,216,0,216
RWA,Rwanda,BEL,Belgium,2009,313,0,313
RWA,Rwanda,BEL,Belgium,2010,321,67,254
RWA,Rwanda,BEL,Belgium,2011,334,0,334
RWA,Rwanda,BEL,Belgium,2012,439,156,283
RWA,Rwanda,BEL,Belgium,2013,326,239,87
RWA,Rwanda,BEL,Belgium,2014,324,240,84
RWA,Rwanda,BEL,Belgium,2015,295,175,120
RWA,Rwanda,BEL,Belgium,2016,318,128,190
RWA,Rwanda,BEL,Belgium,2017,308,83,225
RWA,Rwanda,CAN,Canada,2008,358,0,358
RWA,Rwanda,CAN,Canada,2009,415,0,415
RWA,Rwanda,CAN,Canada,2010,396,0,396
RWA,Rwanda,CAN,Canada,2011,492,0,492
RWA,Rwanda,CAN,Canada,2012,562,0,562
RWA,Rwanda,CAN,Canada,2013,415,0,415
RWA,Rwanda,CAN,Canada,2014,335,0,335
RWA,Rwanda,CAN,Canada,2015,362,0,362
RWA,Rwanda,CAN,Canada,2016,365,0,365
RWA,Rwanda,CAN,Canada,2017,355,0,355
RWA,Rwanda,CZE,Czech Republic,2008,1,0,1
RWA,Rwanda,CZE,Czech Republic,2009,1,0,1
RWA,Rwanda,CZE,Czech Republic,2012,2,1,1
RWA,Rwanda,CZE,Czech Republic,2013,5,1,4
RWA,Rwanda,CZE,Czech Republic,2014,1,1,0
RWA,Rwanda,CZE,Czech Republic,2015,2,2,0
RWA,Rwanda,CZE,Czech Republic,2016,4,0,4
RWA,Rwanda,DNK,Denmark,2008,27,3,24
RWA,Rwanda,DNK,Denmark,2009,10,0,10
RWA,Rwanda,DNK,Denmark,2010,22,2,20
RWA,Rwanda,DNK,Denmark,2011,17,1,16
RWA,Rwanda,DNK,Denmark,2012,12,2,10
RWA,Rwanda,DNK,Denmark,2013,10,6,4
RWA,Rwanda,DNK,Denmark,2014,18,2,16
RWA,Rwanda,DNK,Denmark,2015,12,4,8
RWA,Rwanda,DNK,Denmark,2016,7,5,2
RWA,Rwanda,DNK,Denmark,2017,10,2,8
RWA,Rwanda,FIN,Finland,2008,30,1,29
RWA,Rwanda,FIN,Finland,2009,9,2,7
RWA,Rwanda,FIN,Finland,2010,12,0,12
RWA,Rwanda,FIN,Finland,2011,10,1,9
RWA,Rwanda,FIN,Finland,2012,13,1,12
RWA,Rwanda,FIN,Finland,2013,16,0,16
RWA,Rwanda,FIN,Finland,2014,25,1,24
RWA,Rwanda,FIN,Finland,2015,8,0,8
RWA,Rwanda,FIN,Finland,2016,13,2,11
RWA,Rwanda,FIN,Finland,2017,26,3,23
RWA,Rwanda,FRA,France,2008,321,0,321
RWA,Rwanda,FRA,France,2009,235,0,235
RWA,Rwanda,FRA,France,2010,244,0,244
RWA,Rwanda,FRA,France,2011,236,0,236
RWA,Rwanda,FRA,France,2012,301,0,301
RWA,Rwanda,FRA,France,2013,257,0,257
RWA,Rwanda,FRA,France,2014,272,0,272
RWA,Rwanda,FRA,France,2015,198,0,198
RWA,Rwanda,FRA,France,2016,207,0,207
RWA,Rwanda,FRA,France,2017,318,0,318
RWA,Rwanda,DEU,Germany,2008,72,53,19
RWA,Rwanda,DEU,Germany,2009,113,72,41
RWA,Rwanda,DEU,Germany,2010,86,69,17
RWA,Rwanda,DEU,Germany,2011,110,45,65
RWA,Rwanda,DEU,Germany,2012,120,29,91
RWA,Rwanda,DEU,Germany,2013,104,37,67
RWA,Rwanda,DEU,Germany,2014,152,52,100
RWA,Rwanda,DEU,Germany,2015,115,51,64
RWA,Rwanda,DEU,Germany,2016,187,58,129
RWA,Rwanda,DEU,Germany,2017,159,59,100
RWA,Rwanda,HUN,Hungary,2008,0,0,0
RWA,Rwanda,HUN,Hungary,2009,4,2,2
RWA,Rwanda,HUN,Hungary,2010,2,0,2
RWA,Rwanda,HUN,Hungary,2011,2,1,1
RWA,Rwanda,HUN,Hungary,2012,0,0,0
RWA,Rwanda,HUN,Hungary,2013,0,0,0
RWA,Rwanda,HUN,Hungary,2014,5,0,5
RWA,Rwanda,HUN,Hungary,2015,2,0,2
RWA,Rwanda,HUN,Hungary,2016,3,0,3
RWA,Rwanda,HUN,Hungary,2017,2,0,2
RWA,Rwanda,ISL,Iceland,2008,1,1,0
RWA,Rwanda,ISL,Iceland,2009,2,2,0
RWA,Rwanda,ISL,Iceland,2010,2,1,1
RWA,Rwanda,ISL,Iceland,2011,1,1,0
RWA,Rwanda,ISL,Iceland,2012,2,1,1
RWA,Rwanda,ISL,Iceland,2013,2,0,2
RWA,Rwanda,ISL,Iceland,2014,2,5,-3
RWA,Rwanda,ISL,Iceland,2015,0,1,-1
RWA,Rwanda,ISL,Iceland,2016,1,1,0
RWA,Rwanda,ISL,Iceland,2017,0,0,0
RWA,Rwanda,ITA,Italy,2008,30,4,26
RWA,Rwanda,ITA,Italy,2009,45,4,41
RWA,Rwanda,ITA,Italy,2010,41,2,39
RWA,Rwanda,ITA,Italy,2011,50,3,47
RWA,Rwanda,ITA,Italy,2012,44,1,43
RWA,Rwanda,ITA,Italy,2013,39,2,37
RWA,Rwanda,ITA,Italy,2014,36,4,32
RWA,Rwanda,ITA,Italy,2015,32,4,28
RWA,Rwanda,ITA,Italy,2016,22,0,22
RWA,Rwanda,ITA,Italy,2017,46,1,45
RWA,Rwanda,JPN,Japan,2008,85,86,-1
RWA,Rwanda,JPN,Japan,2009,0,61,-61
RWA,Rwanda,JPN,Japan,2010,75,70,5
RWA,Rwanda,JPN,Japan,2011,75,67,8
RWA,Rwanda,JPN,Japan,2012,105,96,9
RWA,Rwanda,JPN,Japan,2013,106,92,14
RWA,Rwanda,JPN,Japan,2014,84,67,17
RWA,Rwanda,JPN,Japan,2015,89,86,3
RWA,Rwanda,JPN,Japan,2016,86,59,27
RWA,Rwanda,JPN,Japan,2017,101,83,18
RWA,Rwanda,KOR,Korea,2008,17,4,13
RWA,Rwanda,KOR,Korea,2009,22,20,2
RWA,Rwanda,KOR,Korea,2010,30,7,23
RWA,Rwanda,KOR,Korea,2011,25,8,17
RWA,Rwanda,KOR,Korea,2012,28,37,-9
RWA,Rwanda,KOR,Korea,2013,46,11,35
RWA,Rwanda,KOR,Korea,2014,56,29,27
RWA,Rwanda,KOR,Korea,2015,58,46,12
RWA,Rwanda,KOR,Korea,2016,63,33,30
RWA,Rwanda,KOR,Korea,2017,67,39,28
RWA,Rwanda,LUX,Luxembourg,2008,0,4,-4
RWA,Rwanda,LUX,Luxembourg,2009,4,0,4
RWA,Rwanda,LUX,Luxembourg,2010,7,2,5
RWA,Rwanda,LUX,Luxembourg,2011,1,1,0
RWA,Rwanda,LUX,Luxembourg,2012,1,1,0
RWA,Rwanda,LUX,Luxembourg,2013,2,0,2
RWA,Rwanda,LUX,Luxembourg,2014,1,1,0
RWA,Rwanda,LUX,Luxembourg,2015,1,1,0
RWA,Rwanda,LUX,Luxembourg,2016,2,1,1
RWA,Rwanda,LUX,Luxembourg,2017,2,1,1
RWA,Rwanda,MEX,Mexico,2008,2,0,2
RWA,Rwanda,MEX,Mexico,2009,1,0,1
RWA,Rwanda,MEX,Mexico,2012,0,0,0
RWA,Rwanda,MEX,Mexico,2013,0,0,0
RWA,Rwanda,MEX,Mexico,2014,0,0,0
RWA,Rwanda,MEX,Mexico,2017,1,0,1
RWA,Rwanda,NLD,Netherlands,2008,54,22,32
RWA,Rwanda,NLD,Netherlands,2009,81,46,35
RWA,Rwanda,NLD,Netherlands,2010,84,57,27
RWA,Rwanda,NLD,Netherlands,2011,57,72,-15
RWA,Rwanda,NLD,Netherlands,2012,67,48,19
RWA,Rwanda,NLD,Netherlands,2013,62,73,-11
RWA,Rwanda,NLD,Netherlands,2014,76,66,10
RWA,Rwanda,NLD,Netherlands,2015,47,51,-4
RWA,Rwanda,NLD,Netherlands,2016,50,71,-21
RWA,Rwanda,NLD,Netherlands,2017,55,32,23
RWA,Rwanda,NZL,New Zealand,2008,5,0,5
RWA,Rwanda,NZL,New Zealand,2009,8,1,7
RWA,Rwanda,NZL,New Zealand,2011,0,0,0
RWA,Rwanda,NZL,New Zealand,2012,6,0,6
RWA,Rwanda,NZL,New Zealand,2013,1,0,1
RWA,Rwanda,NZL,New Zealand,2014,12,0,12
RWA,Rwanda,NZL,New Zealand,2015,10,0,10
RWA,Rwanda,NZL,New Zealand,2016,1,3,-2
RWA,Rwanda,NZL,New Zealand,2017,3,0,3
RWA,Rwanda,NOR,Norway,2008,44,0,44
RWA,Rwanda,NOR,Norway,2009,18,8,10
RWA,Rwanda,NOR,Norway,2010,31,7,24
RWA,Rwanda,NOR,Norway,2011,26,8,18
RWA,Rwanda,NOR,Norway,2012,33,6,27
RWA,Rwanda,NOR,Norway,2013,20,8,12
RWA,Rwanda,NOR,Norway,2014,24,4,20
RWA,Rwanda,NOR,Norway,2015,28,7,21
RWA,Rwanda,NOR,Norway,2016,7,13,-6
RWA,Rwanda,NOR,Norway,2017,13,3,10
RWA,Rwanda,POL,Poland,2009,8,0,8
RWA,Rwanda,POL,Poland,2010,14,0,14
RWA,Rwanda,POL,Poland,2011,13,0,13
RWA,Rwanda,POL,Poland,2012,13,0,13
RWA,Rwanda,POL,Poland,2013,15,0,15
RWA,Rwanda,POL,Poland,2014,9,0,9
RWA,Rwanda,POL,Poland,2015,10,0,10
RWA,Rwanda,POL,Poland,2016,12,0,12
RWA,Rwanda,POL,Poland,2017,18,0,18
RWA,Rwanda,SVK,Slovak Republic,2008,0,0,0
RWA,Rwanda,SVK,Slovak Republic,2012,1,0,1
RWA,Rwanda,ESP,Spain,2008,21,5,16
RWA,Rwanda,ESP,Spain,2009,21,10,11
RWA,Rwanda,ESP,Spain,2010,17,9,8
RWA,Rwanda,ESP,Spain,2011,17,7,10
RWA,Rwanda,ESP,Spain,2012,23,3,20
RWA,Rwanda,ESP,Spain,2013,26,3,23
RWA,Rwanda,ESP,Spain,2014,18,10,8
RWA,Rwanda,ESP,Spain,2015,30,8,22
RWA,Rwanda,ESP,Spain,2016,18,5,13
RWA,Rwanda,ESP,Spain,2017,17,11,6
RWA,Rwanda,SWE,Sweden,2008,25,1,24
RWA,Rwanda,SWE,Sweden,2009,44,1,43
RWA,Rwanda,SWE,Sweden,2010,46,3,43
RWA,Rwanda,SWE,Sweden,2011,47,6,41
RWA,Rwanda,SWE,Sweden,2012,56,9,47
RWA,Rwanda,SWE,Sweden,2013,42,6,36
RWA,Rwanda,SWE,Sweden,2014,68,24,44
RWA,Rwanda,SWE,Sweden,2015,64,10,54
RWA,Rwanda,SWE,Sweden,2016,48,10,38
RWA,Rwanda,SWE,Sweden,2017,74,11,63
RWA,Rwanda,CHE,Switzerland,2010,33,9,24
RWA,Rwanda,CHE,Switzerland,2011,46,9,37
RWA,Rwanda,CHE,Switzerland,2012,31,12,19
RWA,Rwanda,CHE,Switzerland,2013,23,13,10
RWA,Rwanda,CHE,Switzerland,2014,18,5,13
RWA,Rwanda,CHE,Switzerland,2015,27,3,24
RWA,Rwanda,CHE,Switzerland,2016,24,10,14
RWA,Rwanda,CHE,Switzerland,2017,19,9,10
RWA,Rwanda,USA,United States,2008,378,0,378
RWA,Rwanda,USA,United States,2009,952,0,952
RWA,Rwanda,USA,United States,2010,489,0,489
RWA,Rwanda,USA,United States,2011,520,0,520
RWA,Rwanda,USA,United States,2012,592,0,592
RWA,Rwanda,USA,United States,2013,540,0,540
RWA,Rwanda,USA,United States,2014,555,0,555
RWA,Rwanda,USA,United States,2015,732,0,732
RWA,Rwanda,USA,United States,2016,1357,0,1357
RWA,Rwanda,USA,United States,2017,1394,0,1394
RWA,Rwanda,CHL,Chile,2008,0,0,0
RWA,Rwanda,CHL,Chile,2009,0,0,0
RWA,Rwanda,CHL,Chile,2010,0,0,0
RWA,Rwanda,CHL,Chile,2011,0,0,0
RWA,Rwanda,CHL,Chile,2012,0,0,0
RWA,Rwanda,CHL,Chile,2013,0,0,0
RWA,Rwanda,CHL,Chile,2014,0,0,0
RWA,Rwanda,CHL,Chile,2015,0,0,0
RWA,Rwanda,CHL,Chile,2016,0,0,0
RWA,Rwanda,EST,Estonia,2008,0,0,0
RWA,Rwanda,EST,Estonia,2009,0,0,0
RWA,Rwanda,EST,Estonia,2010,0,0,0
RWA,Rwanda,EST,Estonia,2011,0,0,0
RWA,Rwanda,EST,Estonia,2012,1,0,1
RWA,Rwanda,EST,Estonia,2013,0,0,0
RWA,Rwanda,EST,Estonia,2014,0,0,0
RWA,Rwanda,EST,Estonia,2015,0,0,0
RWA,Rwanda,EST,Estonia,2016,0,0,0
RWA,Rwanda,EST,Estonia,2017,1,0,1
RWA,Rwanda,SVN,Slovenia,2015,1,0,1
KNA,Saint Kitts and Nevis,AUS,Australia,2008,1,0,1
KNA,Saint Kitts and Nevis,AUS,Australia,2009,1,0,1
KNA,Saint Kitts and Nevis,AUS,Australia,2010,0,0,0
KNA,Saint Kitts and Nevis,AUS,Australia,2011,2,0,2
KNA,Saint Kitts and Nevis,AUS,Australia,2012,0,0,0
KNA,Saint Kitts and Nevis,AUS,Australia,2013,1,0,1
KNA,Saint Kitts and Nevis,AUS,Australia,2014,0,0,0
KNA,Saint Kitts and Nevis,AUS,Australia,2015,0,0,0
KNA,Saint Kitts and Nevis,AUS,Australia,2017,5,0,5
KNA,Saint Kitts and Nevis,AUT,Austria,2008,0,0,0
KNA,Saint Kitts and Nevis,AUT,Austria,2009,1,0,1
KNA,Saint Kitts and Nevis,AUT,Austria,2010,2,1,1
KNA,Saint Kitts and Nevis,AUT,Austria,2011,0,2,-2
KNA,Saint Kitts and Nevis,AUT,Austria,2012,0,0,0
KNA,Saint Kitts and Nevis,AUT,Austria,2013,1,0,1
KNA,Saint Kitts and Nevis,AUT,Austria,2014,0,1,-1
KNA,Saint Kitts and Nevis,AUT,Austria,2015,6,0,6
KNA,Saint Kitts and Nevis,AUT,Austria,2016,3,0,3
KNA,Saint Kitts and Nevis,AUT,Austria,2017,3,0,3
KNA,Saint Kitts and Nevis,BEL,Belgium,2008,1,0,1
KNA,Saint Kitts and Nevis,BEL,Belgium,2009,0,0,0
KNA,Saint Kitts and Nevis,BEL,Belgium,2010,0,0,0
KNA,Saint Kitts and Nevis,BEL,Belgium,2013,1,0,1
KNA,Saint Kitts and Nevis,BEL,Belgium,2014,2,1,1
KNA,Saint Kitts and Nevis,BEL,Belgium,2015,3,0,3
KNA,Saint Kitts and Nevis,BEL,Belgium,2016,1,1,0
KNA,Saint Kitts and Nevis,CAN,Canada,2008,25,0,25
KNA,Saint Kitts and Nevis,CAN,Canada,2009,11,0,11
KNA,Saint Kitts and Nevis,CAN,Canada,2010,21,0,21
KNA,Saint Kitts and Nevis,CAN,Canada,2011,12,0,12
KNA,Saint Kitts and Nevis,CAN,Canada,2012,21,0,21
KNA,Saint Kitts and Nevis,CAN,Canada,2013,17,0,17
KNA,Saint Kitts and Nevis,CAN,Canada,2014,24,0,24
KNA,Saint Kitts and Nevis,CAN,Canada,2015,23,0,23
KNA,Saint Kitts and Nevis,CAN,Canada,2016,40,0,40
KNA,Saint Kitts and Nevis,CAN,Canada,2017,35,0,35
KNA,Saint Kitts and Nevis,CZE,Czech Republic,2014,1,0,1
KNA,Saint Kitts and Nevis,DNK,Denmark,2013,0,0,0
KNA,Saint Kitts and Nevis,DNK,Denmark,2014,0,0,0
KNA,Saint Kitts and Nevis,DNK,Denmark,2015,2,0,2
KNA,Saint Kitts and Nevis,DNK,Denmark,2016,0,0,0
KNA,Saint Kitts and Nevis,DNK,Denmark,2017,0,0,0
KNA,Saint Kitts and Nevis,FIN,Finland,2008,0,0,0
KNA,Saint Kitts and Nevis,FIN,Finland,2009,0,0,0
KNA,Saint Kitts and Nevis,FIN,Finland,2010,0,0,0
KNA,Saint Kitts and Nevis,FIN,Finland,2011,0,0,0
KNA,Saint Kitts and Nevis,FIN,Finland,2012,0,0,0
KNA,Saint Kitts and Nevis,FIN,Finland,2013,0,0,0
KNA,Saint Kitts and Nevis,FIN,Finland,2014,0,0,0
KNA,Saint Kitts and Nevis,FIN,Finland,2015,1,0,1
KNA,Saint Kitts and Nevis,FIN,Finland,2016,0,0,0
KNA,Saint Kitts and Nevis,FIN,Finland,2017,0,0,0
KNA,Saint Kitts and Nevis,FRA,France,2008,4,0,4
KNA,Saint Kitts and Nevis,FRA,France,2009,1,0,1
KNA,Saint Kitts and Nevis,FRA,France,2010,2,0,2
KNA,Saint Kitts and Nevis,FRA,France,2011,6,0,6
KNA,Saint Kitts and Nevis,FRA,France,2012,5,0,5
KNA,Saint Kitts and Nevis,FRA,France,2013,5,0,5
KNA,Saint Kitts and Nevis,FRA,France,2014,8,0,8
KNA,Saint Kitts and Nevis,FRA,France,2015,4,0,4
KNA,Saint Kitts and Nevis,FRA,France,2016,11,0,11
KNA,Saint Kitts and Nevis,FRA,France,2017,5,0,5
KNA,Saint Kitts and Nevis,DEU,Germany,2008,1,0,1
KNA,Saint Kitts and Nevis,DEU,Germany,2009,0,0,0
KNA,Saint Kitts and Nevis,DEU,Germany,2010,2,2,0
KNA,Saint Kitts and Nevis,DEU,Germany,2011,3,0,3
KNA,Saint Kitts and Nevis,DEU,Germany,2012,1,1,0
KNA,Saint Kitts and Nevis,DEU,Germany,2013,4,1,3
KNA,Saint Kitts and Nevis,DEU,Germany,2014,14,8,6
KNA,Saint Kitts and Nevis,DEU,Germany,2015,7,1,6
KNA,Saint Kitts and Nevis,DEU,Germany,2016,16,10,6
KNA,Saint Kitts and Nevis,DEU,Germany,2017,11,5,6
KNA,Saint Kitts and Nevis,HUN,Hungary,2008,0,0,0
KNA,Saint Kitts and Nevis,HUN,Hungary,2009,0,0,0
KNA,Saint Kitts and Nevis,HUN,Hungary,2010,0,0,0
KNA,Saint Kitts and Nevis,HUN,Hungary,2011,0,0,0
KNA,Saint Kitts and Nevis,HUN,Hungary,2012,0,0,0
KNA,Saint Kitts and Nevis,HUN,Hungary,2013,1,0,1
KNA,Saint Kitts and Nevis,HUN,Hungary,2014,1,0,1
KNA,Saint Kitts and Nevis,HUN,Hungary,2015,6,0,6
KNA,Saint Kitts and Nevis,HUN,Hungary,2016,4,0,4
KNA,Saint Kitts and Nevis,HUN,Hungary,2017,0,0,0
KNA,Saint Kitts and Nevis,ISL,Iceland,2008,0,0,0
KNA,Saint Kitts and Nevis,ISL,Iceland,2009,0,0,0
KNA,Saint Kitts and Nevis,ISL,Iceland,2010,1,1,0
KNA,Saint Kitts and Nevis,ISL,Iceland,2011,0,0,0
KNA,Saint Kitts and Nevis,ISL,Iceland,2012,1,0,1
KNA,Saint Kitts and Nevis,ISL,Iceland,2013,0,0,0
KNA,Saint Kitts and Nevis,ISL,Iceland,2014,0,1,-1
KNA,Saint Kitts and Nevis,ISL,Iceland,2015,0,0,0
KNA,Saint Kitts and Nevis,ISL,Iceland,2016,0,0,0
KNA,Saint Kitts and Nevis,ISL,Iceland,2017,0,0,0
KNA,Saint Kitts and Nevis,ITA,Italy,2008,0,0,0
KNA,Saint Kitts and Nevis,ITA,Italy,2009,4,0,4
KNA,Saint Kitts and Nevis,ITA,Italy,2010,1,0,1
KNA,Saint Kitts and Nevis,ITA,Italy,2011,0,0,0
KNA,Saint Kitts and Nevis,ITA,Italy,2012,3,0,3
KNA,Saint Kitts and Nevis,ITA,Italy,2013,0,2,-2
KNA,Saint Kitts and Nevis,ITA,Italy,2015,1,0,1
KNA,Saint Kitts and Nevis,ITA,Italy,2016,2,0,2
KNA,Saint Kitts and Nevis,JPN,Japan,2008,3,3,0
KNA,Saint Kitts and Nevis,JPN,Japan,2009,7,8,-1
KNA,Saint Kitts and Nevis,JPN,Japan,2010,8,8,0
KNA,Saint Kitts and Nevis,JPN,Japan,2011,5,5,0
KNA,Saint Kitts and Nevis,JPN,Japan,2012,6,6,0
KNA,Saint Kitts and Nevis,JPN,Japan,2013,6,6,0
KNA,Saint Kitts and Nevis,JPN,Japan,2014,7,7,0
KNA,Saint Kitts and Nevis,JPN,Japan,2015,14,14,0
KNA,Saint Kitts and Nevis,JPN,Japan,2016,13,11,2
KNA,Saint Kitts and Nevis,JPN,Japan,2017,10,9,1
KNA,Saint Kitts and Nevis,KOR,Korea,2008,0,0,0
KNA,Saint Kitts and Nevis,KOR,Korea,2009,1,0,1
KNA,Saint Kitts and Nevis,KOR,Korea,2010,0,0,0
KNA,Saint Kitts and Nevis,KOR,Korea,2011,0,0,0
KNA,Saint Kitts and Nevis,KOR,Korea,2012,2,2,0
KNA,Saint Kitts and Nevis,KOR,Korea,2013,0,0,0
KNA,Saint Kitts and Nevis,KOR,Korea,2014,1,1,0
KNA,Saint Kitts and Nevis,KOR,Korea,2015,2,0,2
KNA,Saint Kitts and Nevis,KOR,Korea,2016,1,1,0
KNA,Saint Kitts and Nevis,KOR,Korea,2017,0,1,-1
KNA,Saint Kitts and Nevis,LUX,Luxembourg,2008,0,0,0
KNA,Saint Kitts and Nevis,LUX,Luxembourg,2009,0,0,0
KNA,Saint Kitts and Nevis,LUX,Luxembourg,2010,0,0,0
KNA,Saint Kitts and Nevis,LUX,Luxembourg,2011,0,0,0
KNA,Saint Kitts and Nevis,LUX,Luxembourg,2012,0,0,0
KNA,Saint Kitts and Nevis,LUX,Luxembourg,2013,0,0,0
KNA,Saint Kitts and Nevis,LUX,Luxembourg,2014,0,0,0
KNA,Saint Kitts and Nevis,LUX,Luxembourg,2015,1,0,1
KNA,Saint Kitts and Nevis,LUX,Luxembourg,2016,0,0,0
KNA,Saint Kitts and Nevis,LUX,Luxembourg,2017,1,0,1
KNA,Saint Kitts and Nevis,MEX,Mexico,2012,0,0,0
KNA,Saint Kitts and Nevis,MEX,Mexico,2013,0,0,0
KNA,Saint Kitts and Nevis,MEX,Mexico,2014,0,0,0
KNA,Saint Kitts and Nevis,MEX,Mexico,2016,1,0,1
KNA,Saint Kitts and Nevis,NLD,Netherlands,2009,1,0,1
KNA,Saint Kitts and Nevis,NLD,Netherlands,2010,2,1,1
KNA,Saint Kitts and Nevis,NLD,Netherlands,2013,1,0,1
KNA,Saint Kitts and Nevis,NLD,Netherlands,2015,0,2,-2
KNA,Saint Kitts and Nevis,NLD,Netherlands,2016,2,0,2
KNA,Saint Kitts and Nevis,NLD,Netherlands,2017,2,0,2
KNA,Saint Kitts and Nevis,NZL,New Zealand,2010,1,0,1
KNA,Saint Kitts and Nevis,NZL,New Zealand,2011,1,0,1
KNA,Saint Kitts and Nevis,NZL,New Zealand,2012,0,0,0
KNA,Saint Kitts and Nevis,NZL,New Zealand,2016,1,0,1
KNA,Saint Kitts and Nevis,NZL,New Zealand,2017,1,0,1
KNA,Saint Kitts and Nevis,NOR,Norway,2008,0,0,0
KNA,Saint Kitts and Nevis,NOR,Norway,2009,0,0,0
KNA,Saint Kitts and Nevis,NOR,Norway,2010,0,1,-1
KNA,Saint Kitts and Nevis,NOR,Norway,2011,0,0,0
KNA,Saint Kitts and Nevis,NOR,Norway,2012,0,0,0
KNA,Saint Kitts and Nevis,NOR,Norway,2013,0,0,0
KNA,Saint Kitts and Nevis,NOR,Norway,2014,0,0,0
KNA,Saint Kitts and Nevis,NOR,Norway,2015,0,0,0
KNA,Saint Kitts and Nevis,NOR,Norway,2016,0,0,0
KNA,Saint Kitts and Nevis,NOR,Norway,2017,0,0,0
KNA,Saint Kitts and Nevis,POL,Poland,2009,0,0,0
KNA,Saint Kitts and Nevis,POL,Poland,2010,0,0,0
KNA,Saint Kitts and Nevis,POL,Poland,2011,0,0,0
KNA,Saint Kitts and Nevis,POL,Poland,2012,0,0,0
KNA,Saint Kitts and Nevis,POL,Poland,2013,0,0,0
KNA,Saint Kitts and Nevis,POL,Poland,2014,0,0,0
KNA,Saint Kitts and Nevis,POL,Poland,2015,0,0,0
KNA,Saint Kitts and Nevis,POL,Poland,2016,0,0,0
KNA,Saint Kitts and Nevis,POL,Poland,2017,0,0,0
KNA,Saint Kitts and Nevis,SVK,Slovak Republic,2008,0,0,0
KNA,Saint Kitts and Nevis,SVK,Slovak Republic,2009,2,0,2
KNA,Saint Kitts and Nevis,ESP,Spain,2008,1,0,1
KNA,Saint Kitts and Nevis,ESP,Spain,2009,1,0,1
KNA,Saint Kitts and Nevis,ESP,Spain,2010,1,0,1
KNA,Saint Kitts and Nevis,ESP,Spain,2011,3,4,-1
KNA,Saint Kitts and Nevis,ESP,Spain,2012,9,0,9
KNA,Saint Kitts and Nevis,ESP,Spain,2013,6,2,4
KNA,Saint Kitts and Nevis,ESP,Spain,2014,5,1,4
KNA,Saint Kitts and Nevis,ESP,Spain,2015,7,2,5
KNA,Saint Kitts and Nevis,ESP,Spain,2016,7,1,6
KNA,Saint Kitts and Nevis,ESP,Spain,2017,7,2,5
KNA,Saint Kitts and Nevis,SWE,Sweden,2008,0,0,0
KNA,Saint Kitts and Nevis,SWE,Sweden,2009,0,0,0
KNA,Saint Kitts and Nevis,SWE,Sweden,2010,0,0,0
KNA,Saint Kitts and Nevis,SWE,Sweden,2011,0,0,0
KNA,Saint Kitts and Nevis,SWE,Sweden,2012,0,0,0
KNA,Saint Kitts and Nevis,SWE,Sweden,2013,0,0,0
KNA,Saint Kitts and Nevis,SWE,Sweden,2014,1,0,1
KNA,Saint Kitts and Nevis,SWE,Sweden,2015,1,0,1
KNA,Saint Kitts and Nevis,SWE,Sweden,2016,4,1,3
KNA,Saint Kitts and Nevis,SWE,Sweden,2017,1,3,-2
KNA,Saint Kitts and Nevis,CHE,Switzerland,2010,0,3,-3
KNA,Saint Kitts and Nevis,CHE,Switzerland,2011,5,1,4
KNA,Saint Kitts and Nevis,CHE,Switzerland,2012,1,6,-5
KNA,Saint Kitts and Nevis,CHE,Switzerland,2013,10,3,7
KNA,Saint Kitts and Nevis,CHE,Switzerland,2014,7,3,4
KNA,Saint Kitts and Nevis,CHE,Switzerland,2015,4,5,-1
KNA,Saint Kitts and Nevis,CHE,Switzerland,2016,8,1,7
KNA,Saint Kitts and Nevis,CHE,Switzerland,2017,11,2,9
KNA,Saint Kitts and Nevis,USA,United States,2008,363,0,363
KNA,Saint Kitts and Nevis,USA,United States,2009,310,0,310
KNA,Saint Kitts and Nevis,USA,United States,2010,339,0,339
KNA,Saint Kitts and Nevis,USA,United States,2011,350,0,350
KNA,Saint Kitts and Nevis,USA,United States,2012,311,0,311
KNA,Saint Kitts and Nevis,USA,United States,2013,259,0,259
KNA,Saint Kitts and Nevis,USA,United States,2014,263,0,263
KNA,Saint Kitts and Nevis,USA,United States,2015,222,0,222
KNA,Saint Kitts and Nevis,USA,United States,2016,250,0,250
KNA,Saint Kitts and Nevis,USA,United States,2017,238,0,238
KNA,Saint Kitts and Nevis,CHL,Chile,2008,0,0,0
KNA,Saint Kitts and Nevis,CHL,Chile,2009,0,0,0
KNA,Saint Kitts and Nevis,CHL,Chile,2010,1,0,1
KNA,Saint Kitts and Nevis,CHL,Chile,2011,1,0,1
KNA,Saint Kitts and Nevis,CHL,Chile,2012,0,0,0
KNA,Saint Kitts and Nevis,CHL,Chile,2013,1,0,1
KNA,Saint Kitts and Nevis,CHL,Chile,2014,2,0,2
KNA,Saint Kitts and Nevis,CHL,Chile,2015,0,0,0
KNA,Saint Kitts and Nevis,CHL,Chile,2016,0,0,0
KNA,Saint Kitts and Nevis,EST,Estonia,2008,0,0,0
KNA,Saint Kitts and Nevis,EST,Estonia,2009,0,0,0
KNA,Saint Kitts and Nevis,EST,Estonia,2010,0,0,0
KNA,Saint Kitts and Nevis,EST,Estonia,2011,0,0,0
KNA,Saint Kitts and Nevis,EST,Estonia,2012,0,0,0
KNA,Saint Kitts and Nevis,EST,Estonia,2013,0,0,0
KNA,Saint Kitts and Nevis,EST,Estonia,2014,0,0,0
KNA,Saint Kitts and Nevis,EST,Estonia,2015,1,0,1
KNA,Saint Kitts and Nevis,EST,Estonia,2016,0,0,0
KNA,Saint Kitts and Nevis,EST,Estonia,2017,0,0,0
LCA,Saint Lucia,AUS,Australia,2008,1,0,1
LCA,Saint Lucia,AUS,Australia,2009,0,0,0
LCA,Saint Lucia,AUS,Australia,2010,0,0,0
LCA,Saint Lucia,AUS,Australia,2011,3,0,3
LCA,Saint Lucia,AUS,Australia,2012,11,0,11
LCA,Saint Lucia,AUS,Australia,2013,2,0,2
LCA,Saint Lucia,AUS,Australia,2014,0,0,0
LCA,Saint Lucia,AUS,Australia,2015,0,0,0
LCA,Saint Lucia,AUS,Australia,2017,0,0,0
LCA,Saint Lucia,AUT,Austria,2008,4,0,4
LCA,Saint Lucia,AUT,Austria,2009,0,3,-3
LCA,Saint Lucia,AUT,Austria,2010,1,2,-1
LCA,Saint Lucia,AUT,Austria,2011,1,0,1
LCA,Saint Lucia,AUT,Austria,2012,1,1,0
LCA,Saint Lucia,AUT,Austria,2013,1,1,0
LCA,Saint Lucia,AUT,Austria,2014,1,0,1
LCA,Saint Lucia,AUT,Austria,2015,0,0,0
LCA,Saint Lucia,AUT,Austria,2016,1,1,0
LCA,Saint Lucia,AUT,Austria,2017,2,0,2
LCA,Saint Lucia,BEL,Belgium,2008,1,0,1
LCA,Saint Lucia,BEL,Belgium,2009,1,0,1
LCA,Saint Lucia,BEL,Belgium,2010,2,1,1
LCA,Saint Lucia,BEL,Belgium,2013,4,1,3
LCA,Saint Lucia,BEL,Belgium,2015,1,0,1
LCA,Saint Lucia,BEL,Belgium,2016,1,0,1
LCA,Saint Lucia,BEL,Belgium,2017,1,0,1
LCA,Saint Lucia,CAN,Canada,2008,298,0,298
LCA,Saint Lucia,CAN,Canada,2009,257,0,257
LCA,Saint Lucia,CAN,Canada,2010,249,0,249
LCA,Saint Lucia,CAN,Canada,2011,261,0,261
LCA,Saint Lucia,CAN,Canada,2012,382,0,382
LCA,Saint Lucia,CAN,Canada,2013,392,0,392
LCA,Saint Lucia,CAN,Canada,2014,505,0,505
LCA,Saint Lucia,CAN,Canada,2015,437,0,437
LCA,Saint Lucia,CAN,Canada,2016,330,0,330
LCA,Saint Lucia,CAN,Canada,2017,385,0,385
LCA,Saint Lucia,CZE,Czech Republic,2008,1,0,1
LCA,Saint Lucia,CZE,Czech Republic,2011,1,0,1
LCA,Saint Lucia,DNK,Denmark,2008,1,0,1
LCA,Saint Lucia,DNK,Denmark,2009,1,0,1
LCA,Saint Lucia,DNK,Denmark,2010,1,0,1
LCA,Saint Lucia,DNK,Denmark,2011,1,0,1
LCA,Saint Lucia,DNK,Denmark,2012,0,0,0
LCA,Saint Lucia,DNK,Denmark,2013,1,0,1
LCA,Saint Lucia,DNK,Denmark,2014,1,0,1
LCA,Saint Lucia,DNK,Denmark,2015,0,0,0
LCA,Saint Lucia,DNK,Denmark,2016,1,0,1
LCA,Saint Lucia,DNK,Denmark,2017,0,1,-1
LCA,Saint Lucia,FIN,Finland,2008,1,0,1
LCA,Saint Lucia,FIN,Finland,2009,0,0,0
LCA,Saint Lucia,FIN,Finland,2010,0,0,0
LCA,Saint Lucia,FIN,Finland,2011,1,0,1
LCA,Saint Lucia,FIN,Finland,2012,0,0,0
LCA,Saint Lucia,FIN,Finland,2013,0,0,0
LCA,Saint Lucia,FIN,Finland,2014,1,1,0
LCA,Saint Lucia,FIN,Finland,2015,0,0,0
LCA,Saint Lucia,FIN,Finland,2016,0,0,0
LCA,Saint Lucia,FIN,Finland,2017,0,0,0
LCA,Saint Lucia,FRA,France,2008,136,0,136
LCA,Saint Lucia,FRA,France,2009,136,0,136
LCA,Saint Lucia,FRA,France,2010,91,0,91
LCA,Saint Lucia,FRA,France,2011,149,0,149
LCA,Saint Lucia,FRA,France,2012,96,0,96
LCA,Saint Lucia,FRA,France,2013,136,0,136
LCA,Saint Lucia,FRA,France,2014,160,0,160
LCA,Saint Lucia,FRA,France,2015,151,0,151
LCA,Saint Lucia,FRA,France,2016,140,0,140
LCA,Saint Lucia,FRA,France,2017,141,0,141
LCA,Saint Lucia,DEU,Germany,2008,12,9,3
LCA,Saint Lucia,DEU,Germany,2009,10,9,1
LCA,Saint Lucia,DEU,Germany,2010,5,9,-4
LCA,Saint Lucia,DEU,Germany,2011,13,6,7
LCA,Saint Lucia,DEU,Germany,2012,6,3,3
LCA,Saint Lucia,DEU,Germany,2013,6,3,3
LCA,Saint Lucia,DEU,Germany,2014,9,13,-4
LCA,Saint Lucia,DEU,Germany,2015,8,8,0
LCA,Saint Lucia,DEU,Germany,2016,9,2,7
LCA,Saint Lucia,DEU,Germany,2017,10,9,1
LCA,Saint Lucia,HUN,Hungary,2008,0,0,0
LCA,Saint Lucia,HUN,Hungary,2009,0,0,0
LCA,Saint Lucia,HUN,Hungary,2010,0,0,0
LCA,Saint Lucia,HUN,Hungary,2011,0,0,0
LCA,Saint Lucia,HUN,Hungary,2012,0,0,0
LCA,Saint Lucia,HUN,Hungary,2013,0,0,0
LCA,Saint Lucia,HUN,Hungary,2014,0,0,0
LCA,Saint Lucia,HUN,Hungary,2015,0,0,0
LCA,Saint Lucia,HUN,Hungary,2016,0,0,0
LCA,Saint Lucia,HUN,Hungary,2017,0,0,0
LCA,Saint Lucia,ISL,Iceland,2016,0,0,0
LCA,Saint Lucia,ISL,Iceland,2017,1,0,1
LCA,Saint Lucia,ITA,Italy,2008,2,0,2
LCA,Saint Lucia,ITA,Italy,2009,5,0,5
LCA,Saint Lucia,ITA,Italy,2010,2,0,2
LCA,Saint Lucia,ITA,Italy,2011,0,0,0
LCA,Saint Lucia,ITA,Italy,2012,2,0,2
LCA,Saint Lucia,ITA,Italy,2013,2,0,2
LCA,Saint Lucia,ITA,Italy,2014,1,0,1
LCA,Saint Lucia,ITA,Italy,2015,0,0,0
LCA,Saint Lucia,ITA,Italy,2017,4,0,4
LCA,Saint Lucia,JPN,Japan,2008,11,13,-2
LCA,Saint Lucia,JPN,Japan,2009,24,21,3
LCA,Saint Lucia,JPN,Japan,2010,26,25,1
LCA,Saint Lucia,JPN,Japan,2011,15,19,-4
LCA,Saint Lucia,JPN,Japan,2012,16,15,1
LCA,Saint Lucia,JPN,Japan,2013,19,18,1
LCA,Saint Lucia,JPN,Japan,2014,17,17,0
LCA,Saint Lucia,JPN,Japan,2015,20,20,0
LCA,Saint Lucia,JPN,Japan,2016,13,11,2
LCA,Saint Lucia,JPN,Japan,2017,24,23,1
LCA,Saint Lucia,KOR,Korea,2008,0,0,0
LCA,Saint Lucia,KOR,Korea,2009,0,0,0
LCA,Saint Lucia,KOR,Korea,2010,0,0,0
LCA,Saint Lucia,KOR,Korea,2011,0,0,0
LCA,Saint Lucia,KOR,Korea,2012,1,0,1
LCA,Saint Lucia,KOR,Korea,2013,3,2,1
LCA,Saint Lucia,KOR,Korea,2014,0,0,0
LCA,Saint Lucia,KOR,Korea,2015,0,0,0
LCA,Saint Lucia,KOR,Korea,2016,0,0,0
LCA,Saint Lucia,KOR,Korea,2017,0,0,0
LCA,Saint Lucia,LUX,Luxembourg,2008,0,0,0
LCA,Saint Lucia,LUX,Luxembourg,2009,0,0,0
LCA,Saint Lucia,LUX,Luxembourg,2010,0,0,0
LCA,Saint Lucia,LUX,Luxembourg,2011,0,0,0
LCA,Saint Lucia,LUX,Luxembourg,2012,0,0,0
LCA,Saint Lucia,LUX,Luxembourg,2013,0,0,0
LCA,Saint Lucia,LUX,Luxembourg,2014,0,0,0
LCA,Saint Lucia,LUX,Luxembourg,2015,0,0,0
LCA,Saint Lucia,LUX,Luxembourg,2016,0,0,0
LCA,Saint Lucia,LUX,Luxembourg,2017,0,1,-1
LCA,Saint Lucia,MEX,Mexico,2008,1,0,1
LCA,Saint Lucia,MEX,Mexico,2009,1,0,1
LCA,Saint Lucia,MEX,Mexico,2012,1,0,1
LCA,Saint Lucia,MEX,Mexico,2013,2,0,2
LCA,Saint Lucia,MEX,Mexico,2014,0,0,0
LCA,Saint Lucia,MEX,Mexico,2015,1,0,1
LCA,Saint Lucia,MEX,Mexico,2016,2,0,2
LCA,Saint Lucia,MEX,Mexico,2017,1,0,1
LCA,Saint Lucia,NLD,Netherlands,2008,1,0,1
LCA,Saint Lucia,NLD,Netherlands,2009,4,0,4
LCA,Saint Lucia,NLD,Netherlands,2011,2,2,0
LCA,Saint Lucia,NLD,Netherlands,2012,1,3,-2
LCA,Saint Lucia,NLD,Netherlands,2013,1,0,1
LCA,Saint Lucia,NLD,Netherlands,2015,3,0,3
LCA,Saint Lucia,NLD,Netherlands,2016,4,1,3
LCA,Saint Lucia,NLD,Netherlands,2017,1,4,-3
LCA,Saint Lucia,NZL,New Zealand,2009,2,5,-3
LCA,Saint Lucia,NZL,New Zealand,2010,2,1,1
LCA,Saint Lucia,NZL,New Zealand,2012,3,1,2
LCA,Saint Lucia,NZL,New Zealand,2013,2,1,1
LCA,Saint Lucia,NZL,New Zealand,2014,5,0,5
LCA,Saint Lucia,NZL,New Zealand,2016,1,2,-1
LCA,Saint Lucia,NZL,New Zealand,2017,4,0,4
LCA,Saint Lucia,NOR,Norway,2008,0,0,0
LCA,Saint Lucia,NOR,Norway,2009,0,0,0
LCA,Saint Lucia,NOR,Norway,2010,0,0,0
LCA,Saint Lucia,NOR,Norway,2011,0,0,0
LCA,Saint Lucia,NOR,Norway,2012,0,0,0
LCA,Saint Lucia,NOR,Norway,2013,0,0,0
LCA,Saint Lucia,NOR,Norway,2014,0,0,0
LCA,Saint Lucia,NOR,Norway,2015,0,0,0
LCA,Saint Lucia,NOR,Norway,2016,0,0,0
LCA,Saint Lucia,NOR,Norway,2017,0,0,0
LCA,Saint Lucia,POL,Poland,2009,0,0,0
LCA,Saint Lucia,POL,Poland,2010,0,0,0
LCA,Saint Lucia,POL,Poland,2011,0,0,0
LCA,Saint Lucia,POL,Poland,2012,0,0,0
LCA,Saint Lucia,POL,Poland,2013,0,0,0
LCA,Saint Lucia,POL,Poland,2014,0,0,0
LCA,Saint Lucia,POL,Poland,2015,1,0,1
LCA,Saint Lucia,POL,Poland,2016,0,0,0
LCA,Saint Lucia,POL,Poland,2017,1,0,1
LCA,Saint Lucia,SVK,Slovak Republic,2008,0,0,0
LCA,Saint Lucia,ESP,Spain,2008,3,0,3
LCA,Saint Lucia,ESP,Spain,2009,4,1,3
LCA,Saint Lucia,ESP,Spain,2010,1,0,1
LCA,Saint Lucia,ESP,Spain,2011,4,0,4
LCA,Saint Lucia,ESP,Spain,2012,3,1,2
LCA,Saint Lucia,ESP,Spain,2013,4,1,3
LCA,Saint Lucia,ESP,Spain,2014,0,0,0
LCA,Saint Lucia,ESP,Spain,2015,1,1,0
LCA,Saint Lucia,ESP,Spain,2016,4,0,4
LCA,Saint Lucia,ESP,Spain,2017,3,1,2
LCA,Saint Lucia,SWE,Sweden,2008,0,0,0
LCA,Saint Lucia,SWE,Sweden,2009,1,0,1
LCA,Saint Lucia,SWE,Sweden,2010,1,0,1
LCA,Saint Lucia,SWE,Sweden,2011,0,0,0
LCA,Saint Lucia,SWE,Sweden,2012,1,0,1
LCA,Saint Lucia,SWE,Sweden,2013,2,0,2
LCA,Saint Lucia,SWE,Sweden,2014,1,0,1
LCA,Saint Lucia,SWE,Sweden,2015,0,1,-1
LCA,Saint Lucia,SWE,Sweden,2016,0,0,0
LCA,Saint Lucia,SWE,Sweden,2017,3,0,3
LCA,Saint Lucia,CHE,Switzerland,2010,1,0,1
LCA,Saint Lucia,CHE,Switzerland,2011,1,0,1
LCA,Saint Lucia,CHE,Switzerland,2012,1,2,-1
LCA,Saint Lucia,CHE,Switzerland,2013,3,0,3
LCA,Saint Lucia,CHE,Switzerland,2014,1,1,0
LCA,Saint Lucia,CHE,Switzerland,2015,2,2,0
LCA,Saint Lucia,CHE,Switzerland,2016,1,1,0
LCA,Saint Lucia,CHE,Switzerland,2017,5,0,5
LCA,Saint Lucia,USA,United States,2008,946,0,946
LCA,Saint Lucia,USA,United States,2009,1027,0,1027
LCA,Saint Lucia,USA,United States,2010,872,0,872
LCA,Saint Lucia,USA,United States,2011,785,0,785
LCA,Saint Lucia,USA,United States,2012,919,0,919
LCA,Saint Lucia,USA,United States,2013,853,0,853
LCA,Saint Lucia,USA,United States,2014,844,0,844
LCA,Saint Lucia,USA,United States,2015,739,0,739
LCA,Saint Lucia,USA,United States,2016,777,0,777
LCA,Saint Lucia,USA,United States,2017,777,0,777
LCA,Saint Lucia,CHL,Chile,2008,0,0,0
LCA,Saint Lucia,CHL,Chile,2009,0,0,0
LCA,Saint Lucia,CHL,Chile,2010,0,0,0
LCA,Saint Lucia,CHL,Chile,2011,0,0,0
LCA,Saint Lucia,CHL,Chile,2012,0,0,0
LCA,Saint Lucia,CHL,Chile,2013,1,0,1
LCA,Saint Lucia,CHL,Chile,2014,1,0,1
LCA,Saint Lucia,CHL,Chile,2015,1,0,1
LCA,Saint Lucia,CHL,Chile,2016,0,0,0
LCA,Saint Lucia,EST,Estonia,2008,0,0,0
LCA,Saint Lucia,EST,Estonia,2009,0,0,0
LCA,Saint Lucia,EST,Estonia,2010,0,0,0
LCA,Saint Lucia,EST,Estonia,2011,0,0,0
LCA,Saint Lucia,EST,Estonia,2012,0,0,0
LCA,Saint Lucia,EST,Estonia,2013,0,0,0
LCA,Saint Lucia,EST,Estonia,2014,0,0,0
LCA,Saint Lucia,EST,Estonia,2015,0,0,0
LCA,Saint Lucia,EST,Estonia,2016,0,0,0
LCA,Saint Lucia,EST,Estonia,2017,1,0,1
VCT,Saint Vincent and the Grenadines,AUS,Australia,2008,0,0,0
VCT,Saint Vincent and the Grenadines,AUS,Australia,2009,1,0,1
VCT,Saint Vincent and the Grenadines,AUS,Australia,2010,1,0,1
VCT,Saint Vincent and the Grenadines,AUS,Australia,2011,1,0,1
VCT,Saint Vincent and the Grenadines,AUS,Australia,2012,0,0,0
VCT,Saint Vincent and the Grenadines,AUS,Australia,2013,0,0,0
VCT,Saint Vincent and the Grenadines,AUS,Australia,2014,0,0,0
VCT,Saint Vincent and the Grenadines,AUS,Australia,2015,0,0,0
VCT,Saint Vincent and the Grenadines,AUS,Australia,2017,3,0,3
VCT,Saint Vincent and the Grenadines,AUT,Austria,2008,4,1,3
VCT,Saint Vincent and the Grenadines,AUT,Austria,2009,1,3,-2
VCT,Saint Vincent and the Grenadines,AUT,Austria,2010,0,0,0
VCT,Saint Vincent and the Grenadines,AUT,Austria,2011,3,0,3
VCT,Saint Vincent and the Grenadines,AUT,Austria,2012,1,2,-1
VCT,Saint Vincent and the Grenadines,AUT,Austria,2013,2,2,0
VCT,Saint Vincent and the Grenadines,AUT,Austria,2014,0,1,-1
VCT,Saint Vincent and the Grenadines,AUT,Austria,2015,2,1,1
VCT,Saint Vincent and the Grenadines,AUT,Austria,2016,2,1,1
VCT,Saint Vincent and the Grenadines,AUT,Austria,2017,3,1,2
VCT,Saint Vincent and the Grenadines,BEL,Belgium,2010,0,0,0
VCT,Saint Vincent and the Grenadines,BEL,Belgium,2012,1,0,1
VCT,Saint Vincent and the Grenadines,BEL,Belgium,2015,1,0,1
VCT,Saint Vincent and the Grenadines,BEL,Belgium,2017,2,0,2
VCT,Saint Vincent and the Grenadines,CAN,Canada,2008,433,0,433
VCT,Saint Vincent and the Grenadines,CAN,Canada,2009,511,0,511
VCT,Saint Vincent and the Grenadines,CAN,Canada,2010,434,0,434
VCT,Saint Vincent and the Grenadines,CAN,Canada,2011,451,0,451
VCT,Saint Vincent and the Grenadines,CAN,Canada,2012,523,0,523
VCT,Saint Vincent and the Grenadines,CAN,Canada,2013,539,0,539
VCT,Saint Vincent and the Grenadines,CAN,Canada,2014,607,0,607
VCT,Saint Vincent and the Grenadines,CAN,Canada,2015,490,0,490
VCT,Saint Vincent and the Grenadines,CAN,Canada,2016,425,0,425
VCT,Saint Vincent and the Grenadines,CAN,Canada,2017,475,0,475
VCT,Saint Vincent and the Grenadines,CZE,Czech Republic,2013,1,0,1
VCT,Saint Vincent and the Grenadines,DNK,Denmark,2008,0,0,0
VCT,Saint Vincent and the Grenadines,DNK,Denmark,2009,0,1,-1
VCT,Saint Vincent and the Grenadines,DNK,Denmark,2012,0,0,0
VCT,Saint Vincent and the Grenadines,DNK,Denmark,2013,0,0,0
VCT,Saint Vincent and the Grenadines,DNK,Denmark,2014,0,0,0
VCT,Saint Vincent and the Grenadines,DNK,Denmark,2015,0,0,0
VCT,Saint Vincent and the Grenadines,DNK,Denmark,2016,0,0,0
VCT,Saint Vincent and the Grenadines,DNK,Denmark,2017,0,0,0
VCT,Saint Vincent and the Grenadines,FIN,Finland,2008,0,0,0
VCT,Saint Vincent and the Grenadines,FIN,Finland,2009,0,0,0
VCT,Saint Vincent and the Grenadines,FIN,Finland,2010,1,0,1
VCT,Saint Vincent and the Grenadines,FIN,Finland,2011,0,0,0
VCT,Saint Vincent and the Grenadines,FIN,Finland,2012,0,1,-1
VCT,Saint Vincent and the Grenadines,FIN,Finland,2013,0,0,0
VCT,Saint Vincent and the Grenadines,FIN,Finland,2014,0,0,0
VCT,Saint Vincent and the Grenadines,FIN,Finland,2015,0,0,0
VCT,Saint Vincent and the Grenadines,FIN,Finland,2016,0,0,0
VCT,Saint Vincent and the Grenadines,FIN,Finland,2017,0,0,0
VCT,Saint Vincent and the Grenadines,FRA,France,2008,1,0,1
VCT,Saint Vincent and the Grenadines,FRA,France,2009,2,0,2
VCT,Saint Vincent and the Grenadines,FRA,France,2010,7,0,7
VCT,Saint Vincent and the Grenadines,FRA,France,2011,3,0,3
VCT,Saint Vincent and the Grenadines,FRA,France,2012,1,0,1
VCT,Saint Vincent and the Grenadines,FRA,France,2013,3,0,3
VCT,Saint Vincent and the Grenadines,FRA,France,2014,3,0,3
VCT,Saint Vincent and the Grenadines,FRA,France,2015,1,0,1
VCT,Saint Vincent and the Grenadines,FRA,France,2016,1,0,1
VCT,Saint Vincent and the Grenadines,FRA,France,2017,3,0,3
VCT,Saint Vincent and the Grenadines,DEU,Germany,2008,1,0,1
VCT,Saint Vincent and the Grenadines,DEU,Germany,2009,5,5,0
VCT,Saint Vincent and the Grenadines,DEU,Germany,2010,4,3,1
VCT,Saint Vincent and the Grenadines,DEU,Germany,2011,5,2,3
VCT,Saint Vincent and the Grenadines,DEU,Germany,2012,7,2,5
VCT,Saint Vincent and the Grenadines,DEU,Germany,2013,1,3,-2
VCT,Saint Vincent and the Grenadines,DEU,Germany,2014,0,2,-2
VCT,Saint Vincent and the Grenadines,DEU,Germany,2015,5,3,2
VCT,Saint Vincent and the Grenadines,DEU,Germany,2016,4,3,1
VCT,Saint Vincent and the Grenadines,DEU,Germany,2017,5,0,5
VCT,Saint Vincent and the Grenadines,HUN,Hungary,2008,1,0,1
VCT,Saint Vincent and the Grenadines,HUN,Hungary,2009,0,0,0
VCT,Saint Vincent and the Grenadines,HUN,Hungary,2010,0,0,0
VCT,Saint Vincent and the Grenadines,HUN,Hungary,2011,0,0,0
VCT,Saint Vincent and the Grenadines,HUN,Hungary,2012,0,0,0
VCT,Saint Vincent and the Grenadines,HUN,Hungary,2013,0,0,0
VCT,Saint Vincent and the Grenadines,HUN,Hungary,2014,0,0,0
VCT,Saint Vincent and the Grenadines,HUN,Hungary,2015,2,1,1
VCT,Saint Vincent and the Grenadines,HUN,Hungary,2016,0,0,0
VCT,Saint Vincent and the Grenadines,HUN,Hungary,2017,1,0,1
VCT,Saint Vincent and the Grenadines,ISL,Iceland,2008,0,0,0
VCT,Saint Vincent and the Grenadines,ISL,Iceland,2009,0,0,0
VCT,Saint Vincent and the Grenadines,ISL,Iceland,2010,0,0,0
VCT,Saint Vincent and the Grenadines,ISL,Iceland,2011,0,0,0
VCT,Saint Vincent and the Grenadines,ISL,Iceland,2012,2,0,2
VCT,Saint Vincent and the Grenadines,ISL,Iceland,2013,1,1,0
VCT,Saint Vincent and the Grenadines,ISL,Iceland,2014,2,2,0
VCT,Saint Vincent and the Grenadines,ISL,Iceland,2015,0,1,-1
VCT,Saint Vincent and the Grenadines,ISL,Iceland,2016,1,0,1
VCT,Saint Vincent and the Grenadines,ISL,Iceland,2017,1,0,1
VCT,Saint Vincent and the Grenadines,ITA,Italy,2008,0,0,0
VCT,Saint Vincent and the Grenadines,ITA,Italy,2009,1,0,1
VCT,Saint Vincent and the Grenadines,ITA,Italy,2010,0,0,0
VCT,Saint Vincent and the Grenadines,ITA,Italy,2011,1,0,1
VCT,Saint Vincent and the Grenadines,ITA,Italy,2012,0,0,0
VCT,Saint Vincent and the Grenadines,ITA,Italy,2013,0,0,0
VCT,Saint Vincent and the Grenadines,ITA,Italy,2015,0,0,0
VCT,Saint Vincent and the Grenadines,ITA,Italy,2017,1,0,1
VCT,Saint Vincent and the Grenadines,JPN,Japan,2008,10,10,0
VCT,Saint Vincent and the Grenadines,JPN,Japan,2009,7,8,-1
VCT,Saint Vincent and the Grenadines,JPN,Japan,2010,13,11,2
VCT,Saint Vincent and the Grenadines,JPN,Japan,2011,5,3,2
VCT,Saint Vincent and the Grenadines,JPN,Japan,2012,9,9,0
VCT,Saint Vincent and the Grenadines,JPN,Japan,2013,11,11,0
VCT,Saint Vincent and the Grenadines,JPN,Japan,2014,11,10,1
VCT,Saint Vincent and the Grenadines,JPN,Japan,2015,17,16,1
VCT,Saint Vincent and the Grenadines,JPN,Japan,2016,9,10,-1
VCT,Saint Vincent and the Grenadines,JPN,Japan,2017,11,11,0
VCT,Saint Vincent and the Grenadines,KOR,Korea,2008,0,0,0
VCT,Saint Vincent and the Grenadines,KOR,Korea,2009,0,0,0
VCT,Saint Vincent and the Grenadines,KOR,Korea,2010,0,0,0
VCT,Saint Vincent and the Grenadines,KOR,Korea,2011,1,0,1
VCT,Saint Vincent and the Grenadines,KOR,Korea,2012,0,1,-1
VCT,Saint Vincent and the Grenadines,KOR,Korea,2013,0,0,0
VCT,Saint Vincent and the Grenadines,KOR,Korea,2014,0,0,0
VCT,Saint Vincent and the Grenadines,KOR,Korea,2015,0,0,0
VCT,Saint Vincent and the Grenadines,KOR,Korea,2016,0,0,0
VCT,Saint Vincent and the Grenadines,KOR,Korea,2017,1,2,-1
VCT,Saint Vincent and the Grenadines,LUX,Luxembourg,2008,0,0,0
VCT,Saint Vincent and the Grenadines,LUX,Luxembourg,2009,0,0,0
VCT,Saint Vincent and the Grenadines,LUX,Luxembourg,2010,0,0,0
VCT,Saint Vincent and the Grenadines,LUX,Luxembourg,2011,0,0,0
VCT,Saint Vincent and the Grenadines,LUX,Luxembourg,2012,0,0,0
VCT,Saint Vincent and the Grenadines,LUX,Luxembourg,2013,0,0,0
VCT,Saint Vincent and the Grenadines,LUX,Luxembourg,2014,0,0,0
VCT,Saint Vincent and the Grenadines,LUX,Luxembourg,2015,0,0,0
VCT,Saint Vincent and the Grenadines,LUX,Luxembourg,2016,0,0,0
VCT,Saint Vincent and the Grenadines,LUX,Luxembourg,2017,0,0,0
VCT,Saint Vincent and the Grenadines,MEX,Mexico,2008,1,0,1
VCT,Saint Vincent and the Grenadines,MEX,Mexico,2009,1,0,1
VCT,Saint Vincent and the Grenadines,MEX,Mexico,2010,3,0,3
VCT,Saint Vincent and the Grenadines,MEX,Mexico,2011,1,0,1
VCT,Saint Vincent and the Grenadines,MEX,Mexico,2012,1,0,1
VCT,Saint Vincent and the Grenadines,MEX,Mexico,2013,8,0,8
VCT,Saint Vincent and the Grenadines,MEX,Mexico,2014,2,0,2
VCT,Saint Vincent and the Grenadines,MEX,Mexico,2015,1,0,1
VCT,Saint Vincent and the Grenadines,MEX,Mexico,2016,2,0,2
VCT,Saint Vincent and the Grenadines,MEX,Mexico,2017,1,0,1
VCT,Saint Vincent and the Grenadines,NLD,Netherlands,2008,2,3,-1
VCT,Saint Vincent and the Grenadines,NLD,Netherlands,2009,12,0,12
VCT,Saint Vincent and the Grenadines,NLD,Netherlands,2010,2,0,2
VCT,Saint Vincent and the Grenadines,NLD,Netherlands,2011,1,1,0
VCT,Saint Vincent and the Grenadines,NLD,Netherlands,2013,0,1,-1
VCT,Saint Vincent and the Grenadines,NLD,Netherlands,2015,0,1,-1
VCT,Saint Vincent and the Grenadines,NLD,Netherlands,2016,2,0,2
VCT,Saint Vincent and the Grenadines,NLD,Netherlands,2017,1,0,1
VCT,Saint Vincent and the Grenadines,NZL,New Zealand,2008,3,1,2
VCT,Saint Vincent and the Grenadines,NZL,New Zealand,2009,1,0,1
VCT,Saint Vincent and the Grenadines,NZL,New Zealand,2010,2,0,2
VCT,Saint Vincent and the Grenadines,NZL,New Zealand,2011,2,2,0
VCT,Saint Vincent and the Grenadines,NZL,New Zealand,2013,1,0,1
VCT,Saint Vincent and the Grenadines,NZL,New Zealand,2015,1,0,1
VCT,Saint Vincent and the Grenadines,NZL,New Zealand,2017,2,0,2
VCT,Saint Vincent and the Grenadines,NOR,Norway,2008,0,0,0
VCT,Saint Vincent and the Grenadines,NOR,Norway,2009,0,0,0
VCT,Saint Vincent and the Grenadines,NOR,Norway,2010,0,0,0
VCT,Saint Vincent and the Grenadines,NOR,Norway,2011,0,0,0
VCT,Saint Vincent and the Grenadines,NOR,Norway,2012,1,0,1
VCT,Saint Vincent and the Grenadines,NOR,Norway,2013,0,0,0
VCT,Saint Vincent and the Grenadines,NOR,Norway,2014,0,0,0
VCT,Saint Vincent and the Grenadines,NOR,Norway,2015,0,0,0
VCT,Saint Vincent and the Grenadines,NOR,Norway,2016,0,0,0
VCT,Saint Vincent and the Grenadines,NOR,Norway,2017,0,0,0
VCT,Saint Vincent and the Grenadines,POL,Poland,2009,0,0,0
VCT,Saint Vincent and the Grenadines,POL,Poland,2010,0,0,0
VCT,Saint Vincent and the Grenadines,POL,Poland,2011,1,0,1
VCT,Saint Vincent and the Grenadines,POL,Poland,2012,1,0,1
VCT,Saint Vincent and the Grenadines,POL,Poland,2013,0,0,0
VCT,Saint Vincent and the Grenadines,POL,Poland,2014,0,0,0
VCT,Saint Vincent and the Grenadines,POL,Poland,2015,0,0,0
VCT,Saint Vincent and the Grenadines,POL,Poland,2016,0,0,0
VCT,Saint Vincent and the Grenadines,POL,Poland,2017,1,0,1
VCT,Saint Vincent and the Grenadines,SVK,Slovak Republic,2008,0,0,0
VCT,Saint Vincent and the Grenadines,ESP,Spain,2008,0,0,0
VCT,Saint Vincent and the Grenadines,ESP,Spain,2009,3,0,3
VCT,Saint Vincent and the Grenadines,ESP,Spain,2010,0,0,0
VCT,Saint Vincent and the Grenadines,ESP,Spain,2011,3,0,3
VCT,Saint Vincent and the Grenadines,ESP,Spain,2012,1,0,1
VCT,Saint Vincent and the Grenadines,ESP,Spain,2013,2,0,2
VCT,Saint Vincent and the Grenadines,ESP,Spain,2014,3,0,3
VCT,Saint Vincent and the Grenadines,ESP,Spain,2015,1,0,1
VCT,Saint Vincent and the Grenadines,ESP,Spain,2016,1,0,1
VCT,Saint Vincent and the Grenadines,ESP,Spain,2017,5,0,5
VCT,Saint Vincent and the Grenadines,SWE,Sweden,2008,1,0,1
VCT,Saint Vincent and the Grenadines,SWE,Sweden,2009,0,0,0
VCT,Saint Vincent and the Grenadines,SWE,Sweden,2010,0,1,-1
VCT,Saint Vincent and the Grenadines,SWE,Sweden,2011,1,0,1
VCT,Saint Vincent and the Grenadines,SWE,Sweden,2012,0,0,0
VCT,Saint Vincent and the Grenadines,SWE,Sweden,2013,0,0,0
VCT,Saint Vincent and the Grenadines,SWE,Sweden,2014,0,0,0
VCT,Saint Vincent and the Grenadines,SWE,Sweden,2015,1,0,1
VCT,Saint Vincent and the Grenadines,SWE,Sweden,2016,2,0,2
VCT,Saint Vincent and the Grenadines,SWE,Sweden,2017,1,1,0
VCT,Saint Vincent and the Grenadines,CHE,Switzerland,2010,0,1,-1
VCT,Saint Vincent and the Grenadines,CHE,Switzerland,2011,0,0,0
VCT,Saint Vincent and the Grenadines,CHE,Switzerland,2012,0,0,0
VCT,Saint Vincent and the Grenadines,CHE,Switzerland,2013,0,1,-1
VCT,Saint Vincent and the Grenadines,CHE,Switzerland,2014,0,1,-1
VCT,Saint Vincent and the Grenadines,CHE,Switzerland,2015,0,1,-1
VCT,Saint Vincent and the Grenadines,CHE,Switzerland,2016,1,0,1
VCT,Saint Vincent and the Grenadines,CHE,Switzerland,2017,0,1,-1
VCT,Saint Vincent and the Grenadines,USA,United States,2008,568,0,568
VCT,Saint Vincent and the Grenadines,USA,United States,2009,591,0,591
VCT,Saint Vincent and the Grenadines,USA,United States,2010,576,0,576
VCT,Saint Vincent and the Grenadines,USA,United States,2011,468,0,468
VCT,Saint Vincent and the Grenadines,USA,United States,2012,503,0,503
VCT,Saint Vincent and the Grenadines,USA,United States,2013,529,0,529
VCT,Saint Vincent and the Grenadines,USA,United States,2014,448,0,448
VCT,Saint Vincent and the Grenadines,USA,United States,2015,415,0,415
VCT,Saint Vincent and the Grenadines,USA,United States,2016,422,0,422
VCT,Saint Vincent and the Grenadines,USA,United States,2017,361,0,361
VCT,Saint Vincent and the Grenadines,CHL,Chile,2008,0,0,0
VCT,Saint Vincent and the Grenadines,CHL,Chile,2009,1,0,1
VCT,Saint Vincent and the Grenadines,CHL,Chile,2010,0,0,0
VCT,Saint Vincent and the Grenadines,CHL,Chile,2011,0,0,0
VCT,Saint Vincent and the Grenadines,CHL,Chile,2012,0,0,0
VCT,Saint Vincent and the Grenadines,CHL,Chile,2013,1,0,1
VCT,Saint Vincent and the Grenadines,CHL,Chile,2014,0,0,0
VCT,Saint Vincent and the Grenadines,CHL,Chile,2015,0,0,0
VCT,Saint Vincent and the Grenadines,CHL,Chile,2016,0,0,0
VCT,Saint Vincent and the Grenadines,EST,Estonia,2008,0,0,0
VCT,Saint Vincent and the Grenadines,EST,Estonia,2009,0,0,0
VCT,Saint Vincent and the Grenadines,EST,Estonia,2010,0,0,0
VCT,Saint Vincent and the Grenadines,EST,Estonia,2011,0,0,0
VCT,Saint Vincent and the Grenadines,EST,Estonia,2012,0,0,0
VCT,Saint Vincent and the Grenadines,EST,Estonia,2013,0,0,0
VCT,Saint Vincent and the Grenadines,EST,Estonia,2014,0,0,0
VCT,Saint Vincent and the Grenadines,EST,Estonia,2015,0,0,0
VCT,Saint Vincent and the Grenadines,EST,Estonia,2016,0,0,0
VCT,Saint Vincent and the Grenadines,EST,Estonia,2017,0,0,0
WSM,Samoa,AUS,Australia,2008,57,106,-49
WSM,Samoa,AUS,Australia,2009,72,101,-29
WSM,Samoa,AUS,Australia,2010,98,116,-18
WSM,Samoa,AUS,Australia,2011,58,99,-41
WSM,Samoa,AUS,Australia,2012,75,83,-8
WSM,Samoa,AUS,Australia,2013,76,89,-13
WSM,Samoa,AUS,Australia,2014,65,69,-4
WSM,Samoa,AUS,Australia,2015,56,100,-44
WSM,Samoa,AUS,Australia,2016,46,100,-54
WSM,Samoa,AUS,Australia,2017,42,0,42
WSM,Samoa,AUT,Austria,2008,0,0,0
WSM,Samoa,AUT,Austria,2009,0,0,0
WSM,Samoa,AUT,Austria,2010,0,1,-1
WSM,Samoa,AUT,Austria,2011,1,0,1
WSM,Samoa,AUT,Austria,2012,0,0,0
WSM,Samoa,AUT,Austria,2013,0,0,0
WSM,Samoa,AUT,Austria,2014,0,0,0
WSM,Samoa,AUT,Austria,2015,0,0,0
WSM,Samoa,AUT,Austria,2016,0,0,0
WSM,Samoa,AUT,Austria,2017,1,0,1
WSM,Samoa,BEL,Belgium,2010,0,0,0
WSM,Samoa,BEL,Belgium,2012,1,0,1
WSM,Samoa,BEL,Belgium,2015,3,0,3
WSM,Samoa,CAN,Canada,2008,4,0,4
WSM,Samoa,CAN,Canada,2009,2,0,2
WSM,Samoa,CAN,Canada,2010,5,0,5
WSM,Samoa,CAN,Canada,2011,3,0,3
WSM,Samoa,CAN,Canada,2012,2,0,2
WSM,Samoa,CAN,Canada,2013,0,0,0
WSM,Samoa,CAN,Canada,2014,1,0,1
WSM,Samoa,CAN,Canada,2015,0,0,0
WSM,Samoa,CAN,Canada,2016,5,0,5
WSM,Samoa,CAN,Canada,2017,0,0,0
WSM,Samoa,CZE,Czech Republic,2011,1,0,1
WSM,Samoa,CZE,Czech Republic,2013,1,0,1
WSM,Samoa,DNK,Denmark,2008,1,0,1
WSM,Samoa,DNK,Denmark,2009,0,0,0
WSM,Samoa,DNK,Denmark,2011,1,0,1
WSM,Samoa,DNK,Denmark,2012,0,0,0
WSM,Samoa,DNK,Denmark,2013,1,0,1
WSM,Samoa,DNK,Denmark,2014,0,0,0
WSM,Samoa,DNK,Denmark,2015,1,1,0
WSM,Samoa,DNK,Denmark,2016,0,0,0
WSM,Samoa,DNK,Denmark,2017,0,0,0
WSM,Samoa,FIN,Finland,2008,0,0,0
WSM,Samoa,FIN,Finland,2009,0,0,0
WSM,Samoa,FIN,Finland,2010,0,0,0
WSM,Samoa,FIN,Finland,2011,0,0,0
WSM,Samoa,FIN,Finland,2012,0,0,0
WSM,Samoa,FIN,Finland,2013,0,0,0
WSM,Samoa,FIN,Finland,2014,0,0,0
WSM,Samoa,FIN,Finland,2015,0,0,0
WSM,Samoa,FIN,Finland,2016,0,0,0
WSM,Samoa,FIN,Finland,2017,0,0,0
WSM,Samoa,FRA,France,2008,12,0,12
WSM,Samoa,FRA,France,2009,4,0,4
WSM,Samoa,FRA,France,2010,4,0,4
WSM,Samoa,FRA,France,2011,5,0,5
WSM,Samoa,FRA,France,2012,5,0,5
WSM,Samoa,FRA,France,2013,4,0,4
WSM,Samoa,FRA,France,2014,7,0,7
WSM,Samoa,FRA,France,2015,6,0,6
WSM,Samoa,FRA,France,2016,11,0,11
WSM,Samoa,FRA,France,2017,2,0,2
WSM,Samoa,DEU,Germany,2008,7,2,5
WSM,Samoa,DEU,Germany,2009,1,2,-1
WSM,Samoa,DEU,Germany,2010,3,2,1
WSM,Samoa,DEU,Germany,2011,0,3,-3
WSM,Samoa,DEU,Germany,2012,2,0,2
WSM,Samoa,DEU,Germany,2013,1,1,0
WSM,Samoa,DEU,Germany,2014,4,2,2
WSM,Samoa,DEU,Germany,2015,7,0,7
WSM,Samoa,DEU,Germany,2016,4,5,-1
WSM,Samoa,DEU,Germany,2017,4,0,4
WSM,Samoa,HUN,Hungary,2008,0,1,-1
WSM,Samoa,HUN,Hungary,2009,0,0,0
WSM,Samoa,HUN,Hungary,2010,0,0,0
WSM,Samoa,HUN,Hungary,2011,0,0,0
WSM,Samoa,HUN,Hungary,2012,0,0,0
WSM,Samoa,HUN,Hungary,2013,0,0,0
WSM,Samoa,HUN,Hungary,2014,0,0,0
WSM,Samoa,HUN,Hungary,2015,0,0,0
WSM,Samoa,HUN,Hungary,2016,0,0,0
WSM,Samoa,HUN,Hungary,2017,0,0,0
WSM,Samoa,ISL,Iceland,2016,0,0,0
WSM,Samoa,ISL,Iceland,2017,0,0,0
WSM,Samoa,ITA,Italy,2008,5,5,0
WSM,Samoa,ITA,Italy,2009,3,7,-4
WSM,Samoa,ITA,Italy,2010,1,0,1
WSM,Samoa,ITA,Italy,2011,1,0,1
WSM,Samoa,ITA,Italy,2012,4,0,4
WSM,Samoa,ITA,Italy,2013,0,0,0
WSM,Samoa,ITA,Italy,2014,3,0,3
WSM,Samoa,ITA,Italy,2015,2,0,2
WSM,Samoa,ITA,Italy,2016,3,0,3
WSM,Samoa,ITA,Italy,2017,3,2,1
WSM,Samoa,JPN,Japan,2008,53,59,-6
WSM,Samoa,JPN,Japan,2009,79,71,8
WSM,Samoa,JPN,Japan,2010,62,66,-4
WSM,Samoa,JPN,Japan,2011,55,60,-5
WSM,Samoa,JPN,Japan,2012,63,58,5
WSM,Samoa,JPN,Japan,2013,47,47,0
WSM,Samoa,JPN,Japan,2014,60,54,6
WSM,Samoa,JPN,Japan,2015,75,58,17
WSM,Samoa,JPN,Japan,2016,61,57,4
WSM,Samoa,JPN,Japan,2017,84,84,0
WSM,Samoa,KOR,Korea,2008,1,1,0
WSM,Samoa,KOR,Korea,2009,5,1,4
WSM,Samoa,KOR,Korea,2010,1,5,-4
WSM,Samoa,KOR,Korea,2011,0,1,-1
WSM,Samoa,KOR,Korea,2012,2,3,-1
WSM,Samoa,KOR,Korea,2013,1,1,0
WSM,Samoa,KOR,Korea,2014,7,7,0
WSM,Samoa,KOR,Korea,2015,9,8,1
WSM,Samoa,KOR,Korea,2016,0,1,-1
WSM,Samoa,KOR,Korea,2017,0,3,-3
WSM,Samoa,LUX,Luxembourg,2008,0,0,0
WSM,Samoa,LUX,Luxembourg,2009,0,0,0
WSM,Samoa,LUX,Luxembourg,2010,0,0,0
WSM,Samoa,LUX,Luxembourg,2011,0,0,0
WSM,Samoa,LUX,Luxembourg,2012,0,0,0
WSM,Samoa,LUX,Luxembourg,2013,0,0,0
WSM,Samoa,LUX,Luxembourg,2014,0,0,0
WSM,Samoa,LUX,Luxembourg,2015,0,0,0
WSM,Samoa,LUX,Luxembourg,2016,1,0,1
WSM,Samoa,LUX,Luxembourg,2017,0,0,0
WSM,Samoa,MEX,Mexico,2012,1,0,1
WSM,Samoa,MEX,Mexico,2013,0,0,0
WSM,Samoa,MEX,Mexico,2014,1,0,1
WSM,Samoa,NLD,Netherlands,2010,1,0,1
WSM,Samoa,NLD,Netherlands,2011,5,0,5
WSM,Samoa,NLD,Netherlands,2012,4,0,4
WSM,Samoa,NLD,Netherlands,2015,1,5,-4
WSM,Samoa,NLD,Netherlands,2016,0,1,-1
WSM,Samoa,NZL,New Zealand,2008,1267,453,814
WSM,Samoa,NZL,New Zealand,2009,1193,487,706
WSM,Samoa,NZL,New Zealand,2010,1040,555,485
WSM,Samoa,NZL,New Zealand,2011,1489,482,1007
WSM,Samoa,NZL,New Zealand,2012,1427,444,983
WSM,Samoa,NZL,New Zealand,2013,1355,338,1017
WSM,Samoa,NZL,New Zealand,2014,1528,239,1289
WSM,Samoa,NZL,New Zealand,2015,1668,244,1424
WSM,Samoa,NZL,New Zealand,2016,1653,188,1465
WSM,Samoa,NZL,New Zealand,2017,1884,186,1698
WSM,Samoa,NOR,Norway,2008,0,0,0
WSM,Samoa,NOR,Norway,2009,0,0,0
WSM,Samoa,NOR,Norway,2010,0,0,0
WSM,Samoa,NOR,Norway,2011,0,0,0
WSM,Samoa,NOR,Norway,2012,0,0,0
WSM,Samoa,NOR,Norway,2013,0,0,0
WSM,Samoa,NOR,Norway,2014,0,0,0
WSM,Samoa,NOR,Norway,2015,0,0,0
WSM,Samoa,NOR,Norway,2016,0,0,0
WSM,Samoa,NOR,Norway,2017,0,0,0
WSM,Samoa,POL,Poland,2009,2,0,2
WSM,Samoa,POL,Poland,2010,0,0,0
WSM,Samoa,POL,Poland,2011,0,0,0
WSM,Samoa,POL,Poland,2012,0,0,0
WSM,Samoa,POL,Poland,2013,0,0,0
WSM,Samoa,POL,Poland,2014,0,0,0
WSM,Samoa,POL,Poland,2015,0,0,0
WSM,Samoa,POL,Poland,2016,0,0,0
WSM,Samoa,POL,Poland,2017,0,0,0
WSM,Samoa,SVK,Slovak Republic,2008,0,0,0
WSM,Samoa,ESP,Spain,2008,0,0,0
WSM,Samoa,ESP,Spain,2009,0,0,0
WSM,Samoa,ESP,Spain,2010,1,0,1
WSM,Samoa,ESP,Spain,2011,0,0,0
WSM,Samoa,ESP,Spain,2012,0,0,0
WSM,Samoa,ESP,Spain,2013,1,0,1
WSM,Samoa,ESP,Spain,2014,0,0,0
WSM,Samoa,ESP,Spain,2015,1,1,0
WSM,Samoa,ESP,Spain,2016,0,0,0
WSM,Samoa,ESP,Spain,2017,1,0,1
WSM,Samoa,SWE,Sweden,2008,0,0,0
WSM,Samoa,SWE,Sweden,2009,2,0,2
WSM,Samoa,SWE,Sweden,2010,0,0,0
WSM,Samoa,SWE,Sweden,2011,0,0,0
WSM,Samoa,SWE,Sweden,2012,1,1,0
WSM,Samoa,SWE,Sweden,2013,0,0,0
WSM,Samoa,SWE,Sweden,2014,0,1,-1
WSM,Samoa,SWE,Sweden,2015,0,0,0
WSM,Samoa,SWE,Sweden,2016,3,0,3
WSM,Samoa,SWE,Sweden,2017,0,1,-1
WSM,Samoa,CHE,Switzerland,2010,0,0,0
WSM,Samoa,CHE,Switzerland,2011,0,0,0
WSM,Samoa,CHE,Switzerland,2012,3,0,3
WSM,Samoa,CHE,Switzerland,2013,1,1,0
WSM,Samoa,CHE,Switzerland,2015,0,1,-1
WSM,Samoa,CHE,Switzerland,2016,0,0,0
WSM,Samoa,CHE,Switzerland,2017,0,0,0
WSM,Samoa,USA,United States,2008,227,0,227
WSM,Samoa,USA,United States,2009,250,0,250
WSM,Samoa,USA,United States,2010,219,0,219
WSM,Samoa,USA,United States,2011,267,0,267
WSM,Samoa,USA,United States,2012,238,0,238
WSM,Samoa,USA,United States,2013,237,0,237
WSM,Samoa,USA,United States,2014,239,0,239
WSM,Samoa,USA,United States,2015,207,0,207
WSM,Samoa,USA,United States,2016,219,0,219
WSM,Samoa,USA,United States,2017,194,0,194
WSM,Samoa,CHL,Chile,2008,0,0,0
WSM,Samoa,CHL,Chile,2009,1,0,1
WSM,Samoa,CHL,Chile,2010,0,0,0
WSM,Samoa,CHL,Chile,2011,0,0,0
WSM,Samoa,CHL,Chile,2012,0,0,0
WSM,Samoa,CHL,Chile,2013,0,0,0
WSM,Samoa,CHL,Chile,2014,0,0,0
WSM,Samoa,CHL,Chile,2015,0,0,0
WSM,Samoa,CHL,Chile,2016,0,0,0
WSM,Samoa,EST,Estonia,2008,0,0,0
WSM,Samoa,EST,Estonia,2009,0,0,0
WSM,Samoa,EST,Estonia,2010,0,0,0
WSM,Samoa,EST,Estonia,2011,0,0,0
WSM,Samoa,EST,Estonia,2012,0,0,0
WSM,Samoa,EST,Estonia,2013,0,0,0
WSM,Samoa,EST,Estonia,2014,0,0,0
WSM,Samoa,EST,Estonia,2015,0,0,0
WSM,Samoa,EST,Estonia,2016,0,0,0
WSM,Samoa,EST,Estonia,2017,0,0,0
SMR,San Marino,AUS,Australia,2008,0,0,0
SMR,San Marino,AUS,Australia,2009,0,0,0
SMR,San Marino,AUS,Australia,2010,0,0,0
SMR,San Marino,AUS,Australia,2011,0,0,0
SMR,San Marino,AUS,Australia,2012,0,0,0
SMR,San Marino,AUS,Australia,2013,0,0,0
SMR,San Marino,AUS,Australia,2014,0,0,0
SMR,San Marino,AUS,Australia,2015,0,0,0
SMR,San Marino,AUS,Australia,2016,0,0,0
SMR,San Marino,AUS,Australia,2017,3,0,3
SMR,San Marino,AUT,Austria,2008,0,1,-1
SMR,San Marino,AUT,Austria,2009,0,0,0
SMR,San Marino,AUT,Austria,2010,0,0,0
SMR,San Marino,AUT,Austria,2011,0,0,0
SMR,San Marino,AUT,Austria,2012,0,0,0
SMR,San Marino,AUT,Austria,2013,0,0,0
SMR,San Marino,AUT,Austria,2014,0,0,0
SMR,San Marino,AUT,Austria,2015,1,0,1
SMR,San Marino,AUT,Austria,2016,0,1,-1
SMR,San Marino,AUT,Austria,2017,1,1,0
SMR,San Marino,BEL,Belgium,2008,0,0,0
SMR,San Marino,BEL,Belgium,2009,2,0,2
SMR,San Marino,BEL,Belgium,2010,0,2,-2
SMR,San Marino,BEL,Belgium,2012,1,0,1
SMR,San Marino,BEL,Belgium,2014,1,0,1
SMR,San Marino,BEL,Belgium,2015,1,1,0
SMR,San Marino,BEL,Belgium,2017,1,0,1
SMR,San Marino,CAN,Canada,2008,0,0,0
SMR,San Marino,CAN,Canada,2009,0,0,0
SMR,San Marino,CAN,Canada,2010,0,0,0
SMR,San Marino,CAN,Canada,2011,0,0,0
SMR,San Marino,CAN,Canada,2012,0,0,0
SMR,San Marino,CAN,Canada,2013,0,0,0
SMR,San Marino,CAN,Canada,2014,0,0,0
SMR,San Marino,CAN,Canada,2015,0,0,0
SMR,San Marino,CAN,Canada,2016,0,0,0
SMR,San Marino,CAN,Canada,2017,0,0,0
SMR,San Marino,DNK,Denmark,2008,0,0,0
SMR,San Marino,DNK,Denmark,2009,0,0,0
SMR,San Marino,DNK,Denmark,2012,1,0,1
SMR,San Marino,DNK,Denmark,2013,0,0,0
SMR,San Marino,DNK,Denmark,2014,0,0,0
SMR,San Marino,DNK,Denmark,2015,0,0,0
SMR,San Marino,DNK,Denmark,2016,0,0,0
SMR,San Marino,DNK,Denmark,2017,0,1,-1
SMR,San Marino,FIN,Finland,2008,0,0,0
SMR,San Marino,FIN,Finland,2009,0,0,0
SMR,San Marino,FIN,Finland,2010,0,0,0
SMR,San Marino,FIN,Finland,2011,0,0,0
SMR,San Marino,FIN,Finland,2012,0,0,0
SMR,San Marino,FIN,Finland,2013,0,0,0
SMR,San Marino,FIN,Finland,2014,0,0,0
SMR,San Marino,FIN,Finland,2015,0,0,0
SMR,San Marino,FIN,Finland,2016,0,0,0
SMR,San Marino,FIN,Finland,2017,0,0,0
SMR,San Marino,FRA,France,2008,2,0,2
SMR,San Marino,FRA,France,2009,2,0,2
SMR,San Marino,FRA,France,2010,0,0,0
SMR,San Marino,FRA,France,2011,0,0,0
SMR,San Marino,FRA,France,2012,0,0,0
SMR,San Marino,FRA,France,2013,0,0,0
SMR,San Marino,FRA,France,2014,0,0,0
SMR,San Marino,FRA,France,2015,1,0,1
SMR,San Marino,FRA,France,2016,2,0,2
SMR,San Marino,FRA,France,2017,1,0,1
SMR,San Marino,DEU,Germany,2008,1,4,-3
SMR,San Marino,DEU,Germany,2009,5,7,-2
SMR,San Marino,DEU,Germany,2010,8,4,4
SMR,San Marino,DEU,Germany,2011,6,3,3
SMR,San Marino,DEU,Germany,2012,8,3,5
SMR,San Marino,DEU,Germany,2013,13,4,9
SMR,San Marino,DEU,Germany,2014,13,5,8
SMR,San Marino,DEU,Germany,2015,9,4,5
SMR,San Marino,DEU,Germany,2016,7,6,1
SMR,San Marino,DEU,Germany,2017,5,1,4
SMR,San Marino,HUN,Hungary,2008,0,0,0
SMR,San Marino,HUN,Hungary,2009,0,0,0
SMR,San Marino,HUN,Hungary,2010,0,0,0
SMR,San Marino,HUN,Hungary,2011,0,0,0
SMR,San Marino,HUN,Hungary,2012,0,0,0
SMR,San Marino,HUN,Hungary,2013,0,0,0
SMR,San Marino,HUN,Hungary,2014,0,0,0
SMR,San Marino,HUN,Hungary,2015,0,0,0
SMR,San Marino,HUN,Hungary,2016,0,0,0
SMR,San Marino,HUN,Hungary,2017,0,0,0
SMR,San Marino,ISL,Iceland,2016,0,0,0
SMR,San Marino,ISL,Iceland,2017,2,0,2
SMR,San Marino,ITA,Italy,2008,49,8,41
SMR,San Marino,ITA,Italy,2009,24,7,17
SMR,San Marino,ITA,Italy,2010,38,4,34
SMR,San Marino,ITA,Italy,2011,27,7,20
SMR,San Marino,ITA,Italy,2012,28,11,17
SMR,San Marino,ITA,Italy,2013,27,6,21
SMR,San Marino,ITA,Italy,2014,30,13,17
SMR,San Marino,ITA,Italy,2015,18,16,2
SMR,San Marino,ITA,Italy,2016,24,0,24
SMR,San Marino,ITA,Italy,2017,26,11,15
SMR,San Marino,JPN,Japan,2008,3,2,1
SMR,San Marino,JPN,Japan,2009,1,2,-1
SMR,San Marino,JPN,Japan,2010,2,2,0
SMR,San Marino,JPN,Japan,2011,2,2,0
SMR,San Marino,JPN,Japan,2012,2,2,0
SMR,San Marino,JPN,Japan,2013,2,1,1
SMR,San Marino,JPN,Japan,2014,2,3,-1
SMR,San Marino,JPN,Japan,2015,2,2,0
SMR,San Marino,JPN,Japan,2016,4,2,2
SMR,San Marino,JPN,Japan,2017,1,2,-1
SMR,San Marino,KOR,Korea,2008,0,0,0
SMR,San Marino,KOR,Korea,2009,1,0,1
SMR,San Marino,KOR,Korea,2010,0,0,0
SMR,San Marino,KOR,Korea,2011,0,0,0
SMR,San Marino,KOR,Korea,2012,0,0,0
SMR,San Marino,KOR,Korea,2013,0,0,0
SMR,San Marino,KOR,Korea,2014,0,0,0
SMR,San Marino,KOR,Korea,2015,0,1,-1
SMR,San Marino,KOR,Korea,2016,0,0,0
SMR,San Marino,KOR,Korea,2017,0,0,0
SMR,San Marino,LUX,Luxembourg,2008,0,0,0
SMR,San Marino,LUX,Luxembourg,2009,0,0,0
SMR,San Marino,LUX,Luxembourg,2010,0,0,0
SMR,San Marino,LUX,Luxembourg,2011,0,0,0
SMR,San Marino,LUX,Luxembourg,2012,1,0,1
SMR,San Marino,LUX,Luxembourg,2013,1,0,1
SMR,San Marino,LUX,Luxembourg,2014,0,1,-1
SMR,San Marino,LUX,Luxembourg,2015,1,0,1
SMR,San Marino,LUX,Luxembourg,2016,0,0,0
SMR,San Marino,LUX,Luxembourg,2017,0,0,0
SMR,San Marino,MEX,Mexico,2012,0,0,0
SMR,San Marino,MEX,Mexico,2013,0,0,0
SMR,San Marino,MEX,Mexico,2014,0,0,0
SMR,San Marino,NLD,Netherlands,2014,1,0,1
SMR,San Marino,NLD,Netherlands,2015,0,1,-1
SMR,San Marino,NLD,Netherlands,2016,1,1,0
SMR,San Marino,NOR,Norway,2008,0,0,0
SMR,San Marino,NOR,Norway,2009,1,0,1
SMR,San Marino,NOR,Norway,2010,1,0,1
SMR,San Marino,NOR,Norway,2011,0,0,0
SMR,San Marino,NOR,Norway,2012,0,0,0
SMR,San Marino,NOR,Norway,2013,0,0,0
SMR,San Marino,NOR,Norway,2014,0,0,0
SMR,San Marino,NOR,Norway,2015,1,0,1
SMR,San Marino,NOR,Norway,2016,0,0,0
SMR,San Marino,NOR,Norway,2017,0,0,0
SMR,San Marino,POL,Poland,2009,0,0,0
SMR,San Marino,POL,Poland,2010,0,0,0
SMR,San Marino,POL,Poland,2011,0,0,0
SMR,San Marino,POL,Poland,2012,0,0,0
SMR,San Marino,POL,Poland,2013,0,0,0
SMR,San Marino,POL,Poland,2014,0,0,0
SMR,San Marino,POL,Poland,2015,0,0,0
SMR,San Marino,POL,Poland,2016,0,0,0
SMR,San Marino,POL,Poland,2017,0,0,0
SMR,San Marino,SVK,Slovak Republic,2008,0,0,0
SMR,San Marino,ESP,Spain,2008,5,4,1
SMR,San Marino,ESP,Spain,2009,6,4,2
SMR,San Marino,ESP,Spain,2010,1,3,-2
SMR,San Marino,ESP,Spain,2011,2,0,2
SMR,San Marino,ESP,Spain,2012,3,0,3
SMR,San Marino,ESP,Spain,2013,2,0,2
SMR,San Marino,ESP,Spain,2014,7,1,6
SMR,San Marino,ESP,Spain,2015,0,0,0
SMR,San Marino,ESP,Spain,2016,6,1,5
SMR,San Marino,ESP,Spain,2017,2,0,2
SMR,San Marino,SWE,Sweden,2008,0,0,0
SMR,San Marino,SWE,Sweden,2009,0,0,0
SMR,San Marino,SWE,Sweden,2010,0,0,0
SMR,San Marino,SWE,Sweden,2011,2,0,2
SMR,San Marino,SWE,Sweden,2012,1,1,0
SMR,San Marino,SWE,Sweden,2013,0,0,0
SMR,San Marino,SWE,Sweden,2014,0,0,0
SMR,San Marino,SWE,Sweden,2015,0,0,0
SMR,San Marino,SWE,Sweden,2016,0,0,0
SMR,San Marino,SWE,Sweden,2017,0,0,0
SMR,San Marino,CHE,Switzerland,2010,1,0,1
SMR,San Marino,CHE,Switzerland,2012,1,0,1
SMR,San Marino,CHE,Switzerland,2013,1,2,-1
SMR,San Marino,CHE,Switzerland,2014,3,0,3
SMR,San Marino,CHE,Switzerland,2015,2,1,1
SMR,San Marino,CHE,Switzerland,2016,2,0,2
SMR,San Marino,CHE,Switzerland,2017,4,1,3
SMR,San Marino,USA,United States,2017,1,0,1
SMR,San Marino,CHL,Chile,2008,0,0,0
SMR,San Marino,CHL,Chile,2009,0,0,0
SMR,San Marino,CHL,Chile,2010,0,0,0
SMR,San Marino,CHL,Chile,2011,1,0,1
SMR,San Marino,CHL,Chile,2012,0,0,0
SMR,San Marino,CHL,Chile,2013,0,0,0
SMR,San Marino,CHL,Chile,2014,0,0,0
SMR,San Marino,CHL,Chile,2015,0,0,0
SMR,San Marino,CHL,Chile,2016,0,0,0
SMR,San Marino,EST,Estonia,2008,0,0,0
SMR,San Marino,EST,Estonia,2009,0,0,0
SMR,San Marino,EST,Estonia,2010,0,0,0
SMR,San Marino,EST,Estonia,2011,0,0,0
SMR,San Marino,EST,Estonia,2012,0,0,0
SMR,San Marino,EST,Estonia,2013,0,0,0
SMR,San Marino,EST,Estonia,2014,0,0,0
SMR,San Marino,EST,Estonia,2015,1,0,1
SMR,San Marino,EST,Estonia,2016,0,0,0
SMR,San Marino,EST,Estonia,2017,0,0,0
STP,Sao Tome and Principe,AUS,Australia,2008,2,0,2
STP,Sao Tome and Principe,AUS,Australia,2009,0,0,0
STP,Sao Tome and Principe,AUS,Australia,2010,0,0,0
STP,Sao Tome and Principe,AUS,Australia,2011,0,0,0
STP,Sao Tome and Principe,AUS,Australia,2012,0,0,0
STP,Sao Tome and Principe,AUS,Australia,2013,0,0,0
STP,Sao Tome and Principe,AUS,Australia,2014,0,0,0
STP,Sao Tome and Principe,AUS,Australia,2015,0,0,0
STP,Sao Tome and Principe,AUS,Australia,2016,0,0,0
STP,Sao Tome and Principe,AUS,Australia,2017,0,0,0
STP,Sao Tome and Principe,AUT,Austria,2008,0,0,0
STP,Sao Tome and Principe,AUT,Austria,2009,0,0,0
STP,Sao Tome and Principe,AUT,Austria,2010,0,0,0
STP,Sao Tome and Principe,AUT,Austria,2011,0,0,0
STP,Sao Tome and Principe,AUT,Austria,2012,0,0,0
STP,Sao Tome and Principe,AUT,Austria,2013,0,0,0
STP,Sao Tome and Principe,AUT,Austria,2014,0,0,0
STP,Sao Tome and Principe,AUT,Austria,2015,0,0,0
STP,Sao Tome and Principe,AUT,Austria,2016,0,0,0
STP,Sao Tome and Principe,AUT,Austria,2017,0,0,0
STP,Sao Tome and Principe,BEL,Belgium,2008,1,0,1
STP,Sao Tome and Principe,BEL,Belgium,2009,5,0,5
STP,Sao Tome and Principe,BEL,Belgium,2010,3,0,3
STP,Sao Tome and Principe,BEL,Belgium,2012,1,2,-1
STP,Sao Tome and Principe,BEL,Belgium,2013,2,0,2
STP,Sao Tome and Principe,BEL,Belgium,2014,2,2,0
STP,Sao Tome and Principe,BEL,Belgium,2015,3,1,2
STP,Sao Tome and Principe,BEL,Belgium,2016,5,0,5
STP,Sao Tome and Principe,BEL,Belgium,2017,2,0,2
STP,Sao Tome and Principe,CAN,Canada,2008,0,0,0
STP,Sao Tome and Principe,CAN,Canada,2009,1,0,1
STP,Sao Tome and Principe,CAN,Canada,2010,2,0,2
STP,Sao Tome and Principe,CAN,Canada,2011,0,0,0
STP,Sao Tome and Principe,CAN,Canada,2012,0,0,0
STP,Sao Tome and Principe,CAN,Canada,2013,1,0,1
STP,Sao Tome and Principe,CAN,Canada,2014,1,0,1
STP,Sao Tome and Principe,CAN,Canada,2015,0,0,0
STP,Sao Tome and Principe,CAN,Canada,2016,0,0,0
STP,Sao Tome and Principe,CAN,Canada,2017,0,0,0
STP,Sao Tome and Principe,DNK,Denmark,2013,0,0,0
STP,Sao Tome and Principe,DNK,Denmark,2014,0,0,0
STP,Sao Tome and Principe,DNK,Denmark,2015,0,0,0
STP,Sao Tome and Principe,DNK,Denmark,2016,0,0,0
STP,Sao Tome and Principe,DNK,Denmark,2017,0,0,0
STP,Sao Tome and Principe,FIN,Finland,2008,0,0,0
STP,Sao Tome and Principe,FIN,Finland,2009,0,0,0
STP,Sao Tome and Principe,FIN,Finland,2010,0,0,0
STP,Sao Tome and Principe,FIN,Finland,2011,0,0,0
STP,Sao Tome and Principe,FIN,Finland,2012,0,0,0
STP,Sao Tome and Principe,FIN,Finland,2013,0,0,0
STP,Sao Tome and Principe,FIN,Finland,2014,0,0,0
STP,Sao Tome and Principe,FIN,Finland,2015,0,0,0
STP,Sao Tome and Principe,FIN,Finland,2016,0,0,0
STP,Sao Tome and Principe,FIN,Finland,2017,0,0,0
STP,Sao Tome and Principe,FRA,France,2008,6,0,6
STP,Sao Tome and Principe,FRA,France,2009,12,0,12
STP,Sao Tome and Principe,FRA,France,2010,8,0,8
STP,Sao Tome and Principe,FRA,France,2011,10,0,10
STP,Sao Tome and Principe,FRA,France,2012,10,0,10
STP,Sao Tome and Principe,FRA,France,2013,13,0,13
STP,Sao Tome and Principe,FRA,France,2014,14,0,14
STP,Sao Tome and Principe,FRA,France,2015,20,0,20
STP,Sao Tome and Principe,FRA,France,2016,17,0,17
STP,Sao Tome and Principe,FRA,France,2017,13,0,13
STP,Sao Tome and Principe,DEU,Germany,2008,2,2,0
STP,Sao Tome and Principe,DEU,Germany,2009,5,5,0
STP,Sao Tome and Principe,DEU,Germany,2010,3,3,0
STP,Sao Tome and Principe,DEU,Germany,2011,5,0,5
STP,Sao Tome and Principe,DEU,Germany,2012,3,2,1
STP,Sao Tome and Principe,DEU,Germany,2013,4,2,2
STP,Sao Tome and Principe,DEU,Germany,2014,8,2,6
STP,Sao Tome and Principe,DEU,Germany,2015,5,1,4
STP,Sao Tome and Principe,DEU,Germany,2016,0,1,-1
STP,Sao Tome and Principe,DEU,Germany,2017,5,1,4
STP,Sao Tome and Principe,HUN,Hungary,2008,0,0,0
STP,Sao Tome and Principe,HUN,Hungary,2009,0,0,0
STP,Sao Tome and Principe,HUN,Hungary,2010,0,0,0
STP,Sao Tome and Principe,HUN,Hungary,2011,0,0,0
STP,Sao Tome and Principe,HUN,Hungary,2012,0,0,0
STP,Sao Tome and Principe,HUN,Hungary,2013,0,0,0
STP,Sao Tome and Principe,HUN,Hungary,2014,0,0,0
STP,Sao Tome and Principe,HUN,Hungary,2015,0,0,0
STP,Sao Tome and Principe,HUN,Hungary,2016,0,0,0
STP,Sao Tome and Principe,HUN,Hungary,2017,0,0,0
STP,Sao Tome and Principe,ISL,Iceland,2008,0,0,0
STP,Sao Tome and Principe,ISL,Iceland,2009,0,0,0
STP,Sao Tome and Principe,ISL,Iceland,2010,0,0,0
STP,Sao Tome and Principe,ISL,Iceland,2011,0,0,0
STP,Sao Tome and Principe,ISL,Iceland,2012,0,0,0
STP,Sao Tome and Principe,ISL,Iceland,2016,0,0,0
STP,Sao Tome and Principe,ISL,Iceland,2017,0,0,0
STP,Sao Tome and Principe,ITA,Italy,2008,3,0,3
STP,Sao Tome and Principe,ITA,Italy,2009,6,0,6
STP,Sao Tome and Principe,ITA,Italy,2010,1,2,-1
STP,Sao Tome and Principe,ITA,Italy,2011,2,0,2
STP,Sao Tome and Principe,ITA,Italy,2012,5,1,4
STP,Sao Tome and Principe,ITA,Italy,2015,1,0,1
STP,Sao Tome and Principe,ITA,Italy,2016,0,0,0
STP,Sao Tome and Principe,ITA,Italy,2017,0,0,0
STP,Sao Tome and Principe,JPN,Japan,2008,4,4,0
STP,Sao Tome and Principe,JPN,Japan,2009,7,7,0
STP,Sao Tome and Principe,JPN,Japan,2010,8,8,0
STP,Sao Tome and Principe,JPN,Japan,2011,5,5,0
STP,Sao Tome and Principe,JPN,Japan,2012,8,8,0
STP,Sao Tome and Principe,JPN,Japan,2013,5,5,0
STP,Sao Tome and Principe,JPN,Japan,2014,6,5,1
STP,Sao Tome and Principe,JPN,Japan,2015,4,4,0
STP,Sao Tome and Principe,JPN,Japan,2016,7,7,0
STP,Sao Tome and Principe,JPN,Japan,2017,9,6,3
STP,Sao Tome and Principe,KOR,Korea,2008,0,0,0
STP,Sao Tome and Principe,KOR,Korea,2009,1,1,0
STP,Sao Tome and Principe,KOR,Korea,2010,1,0,1
STP,Sao Tome and Principe,KOR,Korea,2011,0,0,0
STP,Sao Tome and Principe,KOR,Korea,2012,0,0,0
STP,Sao Tome and Principe,KOR,Korea,2013,0,1,-1
STP,Sao Tome and Principe,KOR,Korea,2014,0,0,0
STP,Sao Tome and Principe,KOR,Korea,2015,0,0,0
STP,Sao Tome and Principe,KOR,Korea,2016,0,1,-1
STP,Sao Tome and Principe,KOR,Korea,2017,0,0,0
STP,Sao Tome and Principe,LUX,Luxembourg,2008,0,0,0
STP,Sao Tome and Principe,LUX,Luxembourg,2009,4,0,4
STP,Sao Tome and Principe,LUX,Luxembourg,2010,3,0,3
STP,Sao Tome and Principe,LUX,Luxembourg,2011,3,0,3
STP,Sao Tome and Principe,LUX,Luxembourg,2012,5,1,4
STP,Sao Tome and Principe,LUX,Luxembourg,2013,0,0,0
STP,Sao Tome and Principe,LUX,Luxembourg,2014,3,0,3
STP,Sao Tome and Principe,LUX,Luxembourg,2015,1,0,1
STP,Sao Tome and Principe,LUX,Luxembourg,2016,3,1,2
STP,Sao Tome and Principe,LUX,Luxembourg,2017,2,0,2
STP,Sao Tome and Principe,MEX,Mexico,2012,0,0,0
STP,Sao Tome and Principe,MEX,Mexico,2013,1,0,1
STP,Sao Tome and Principe,MEX,Mexico,2014,0,0,0
STP,Sao Tome and Principe,NLD,Netherlands,2009,2,0,2
STP,Sao Tome and Principe,NLD,Netherlands,2011,1,1,0
STP,Sao Tome and Principe,NLD,Netherlands,2013,3,1,2
STP,Sao Tome and Principe,NLD,Netherlands,2015,0,2,-2
STP,Sao Tome and Principe,NLD,Netherlands,2016,1,0,1
STP,Sao Tome and Principe,NLD,Netherlands,2017,1,0,1
STP,Sao Tome and Principe,NOR,Norway,2008,0,0,0
STP,Sao Tome and Principe,NOR,Norway,2009,0,0,0
STP,Sao Tome and Principe,NOR,Norway,2010,0,0,0
STP,Sao Tome and Principe,NOR,Norway,2011,0,0,0
STP,Sao Tome and Principe,NOR,Norway,2012,0,0,0
STP,Sao Tome and Principe,NOR,Norway,2013,0,0,0
STP,Sao Tome and Principe,NOR,Norway,2014,0,0,0
STP,Sao Tome and Principe,NOR,Norway,2015,0,0,0
STP,Sao Tome and Principe,NOR,Norway,2016,0,0,0
STP,Sao Tome and Principe,NOR,Norway,2017,0,0,0
STP,Sao Tome and Principe,POL,Poland,2009,0,0,0
STP,Sao Tome and Principe,POL,Poland,2010,0,0,0
STP,Sao Tome and Principe,POL,Poland,2011,0,0,0
STP,Sao Tome and Principe,POL,Poland,2012,0,0,0
STP,Sao Tome and Principe,POL,Poland,2013,0,0,0
STP,Sao Tome and Principe,POL,Poland,2014,0,0,0
STP,Sao Tome and Principe,POL,Poland,2015,0,0,0
STP,Sao Tome and Principe,POL,Poland,2016,0,0,0
STP,Sao Tome and Principe,POL,Poland,2017,1,0,1
STP,Sao Tome and Principe,PRT,Portugal,2008,1072,0,1072
STP,Sao Tome and Principe,PRT,Portugal,2009,1072,0,1072
STP,Sao Tome and Principe,PRT,Portugal,2010,1273,0,1273
STP,Sao Tome and Principe,PRT,Portugal,2011,1322,0,1322
STP,Sao Tome and Principe,PRT,Portugal,2012,1007,0,1007
STP,Sao Tome and Principe,PRT,Portugal,2013,762,0,762
STP,Sao Tome and Principe,PRT,Portugal,2014,582,0,582
STP,Sao Tome and Principe,PRT,Portugal,2015,505,0,505
STP,Sao Tome and Principe,PRT,Portugal,2016,548,0,548
STP,Sao Tome and Principe,PRT,Portugal,2017,772,0,772
STP,Sao Tome and Principe,SVK,Slovak Republic,2008,0,0,0
STP,Sao Tome and Principe,ESP,Spain,2008,21,14,7
STP,Sao Tome and Principe,ESP,Spain,2009,11,18,-7
STP,Sao Tome and Principe,ESP,Spain,2010,10,5,5
STP,Sao Tome and Principe,ESP,Spain,2011,6,20,-14
STP,Sao Tome and Principe,ESP,Spain,2012,4,3,1
STP,Sao Tome and Principe,ESP,Spain,2013,11,2,9
STP,Sao Tome and Principe,ESP,Spain,2014,5,2,3
STP,Sao Tome and Principe,ESP,Spain,2015,8,4,4
STP,Sao Tome and Principe,ESP,Spain,2016,11,4,7
STP,Sao Tome and Principe,ESP,Spain,2017,8,4,4
STP,Sao Tome and Principe,SWE,Sweden,2008,0,0,0
STP,Sao Tome and Principe,SWE,Sweden,2009,0,0,0
STP,Sao Tome and Principe,SWE,Sweden,2010,1,0,1
STP,Sao Tome and Principe,SWE,Sweden,2011,1,0,1
STP,Sao Tome and Principe,SWE,Sweden,2012,1,1,0
STP,Sao Tome and Principe,SWE,Sweden,2013,0,0,0
STP,Sao Tome and Principe,SWE,Sweden,2014,0,0,0
STP,Sao Tome and Principe,SWE,Sweden,2015,0,0,0
STP,Sao Tome and Principe,SWE,Sweden,2016,0,0,0
STP,Sao Tome and Principe,SWE,Sweden,2017,0,0,0
STP,Sao Tome and Principe,CHE,Switzerland,2010,1,0,1
STP,Sao Tome and Principe,CHE,Switzerland,2011,1,0,1
STP,Sao Tome and Principe,CHE,Switzerland,2012,1,0,1
STP,Sao Tome and Principe,CHE,Switzerland,2013,4,0,4
STP,Sao Tome and Principe,CHE,Switzerland,2015,0,0,0
STP,Sao Tome and Principe,CHE,Switzerland,2016,3,1,2
STP,Sao Tome and Principe,CHE,Switzerland,2017,0,0,0
STP,Sao Tome and Principe,USA,United States,2008,7,0,7
STP,Sao Tome and Principe,USA,United States,2009,11,0,11
STP,Sao Tome and Principe,USA,United States,2010,10,0,10
STP,Sao Tome and Principe,USA,United States,2011,9,0,9
STP,Sao Tome and Principe,USA,United States,2012,12,0,12
STP,Sao Tome and Principe,USA,United States,2013,6,0,6
STP,Sao Tome and Principe,USA,United States,2014,5,0,5
STP,Sao Tome and Principe,USA,United States,2015,6,0,6
STP,Sao Tome and Principe,USA,United States,2016,12,0,12
STP,Sao Tome and Principe,USA,United States,2017,10,0,10
STP,Sao Tome and Principe,CHL,Chile,2008,0,0,0
STP,Sao Tome and Principe,CHL,Chile,2009,1,0,1
STP,Sao Tome and Principe,CHL,Chile,2010,0,0,0
STP,Sao Tome and Principe,CHL,Chile,2011,0,0,0
STP,Sao Tome and Principe,CHL,Chile,2012,0,0,0
STP,Sao Tome and Principe,CHL,Chile,2013,0,0,0
STP,Sao Tome and Principe,CHL,Chile,2014,0,0,0
STP,Sao Tome and Principe,CHL,Chile,2015,0,0,0
STP,Sao Tome and Principe,CHL,Chile,2016,0,0,0
STP,Sao Tome and Principe,EST,Estonia,2008,0,0,0
STP,Sao Tome and Principe,EST,Estonia,2009,0,0,0
STP,Sao Tome and Principe,EST,Estonia,2010,0,0,0
STP,Sao Tome and Principe,EST,Estonia,2011,0,0,0
STP,Sao Tome and Principe,EST,Estonia,2012,0,0,0
STP,Sao Tome and Principe,EST,Estonia,2013,0,0,0
STP,Sao Tome and Principe,EST,Estonia,2014,0,0,0
STP,Sao Tome and Principe,EST,Estonia,2015,0,0,0
STP,Sao Tome and Principe,EST,Estonia,2016,0,0,0
STP,Sao Tome and Principe,EST,Estonia,2017,0,0,0
STP,Sao Tome and Principe,SVN,Slovenia,2012,1,0,1
SAU,Saudi Arabia,AUS,Australia,2008,17,50,-33
SAU,Saudi Arabia,AUS,Australia,2009,20,58,-38
SAU,Saudi Arabia,AUS,Australia,2010,25,49,-24
SAU,Saudi Arabia,AUS,Australia,2011,31,51,-20
SAU,Saudi Arabia,AUS,Australia,2012,24,63,-39
SAU,Saudi Arabia,AUS,Australia,2013,31,52,-21
SAU,Saudi Arabia,AUS,Australia,2014,45,49,-4
SAU,Saudi Arabia,AUS,Australia,2015,56,0,56
SAU,Saudi Arabia,AUS,Australia,2016,57,100,-43
SAU,Saudi Arabia,AUS,Australia,2017,54,0,54
SAU,Saudi Arabia,AUT,Austria,2008,31,38,-7
SAU,Saudi Arabia,AUT,Austria,2009,65,29,36
SAU,Saudi Arabia,AUT,Austria,2010,59,44,15
SAU,Saudi Arabia,AUT,Austria,2011,52,26,26
SAU,Saudi Arabia,AUT,Austria,2012,31,31,0
SAU,Saudi Arabia,AUT,Austria,2013,115,30,85
SAU,Saudi Arabia,AUT,Austria,2014,60,25,35
SAU,Saudi Arabia,AUT,Austria,2015,79,60,19
SAU,Saudi Arabia,AUT,Austria,2016,58,94,-36
SAU,Saudi Arabia,AUT,Austria,2017,81,84,-3
SAU,Saudi Arabia,BEL,Belgium,2008,7,0,7
SAU,Saudi Arabia,BEL,Belgium,2009,9,0,9
SAU,Saudi Arabia,BEL,Belgium,2010,15,10,5
SAU,Saudi Arabia,BEL,Belgium,2012,20,13,7
SAU,Saudi Arabia,BEL,Belgium,2013,31,13,18
SAU,Saudi Arabia,BEL,Belgium,2014,18,22,-4
SAU,Saudi Arabia,BEL,Belgium,2015,29,23,6
SAU,Saudi Arabia,BEL,Belgium,2016,19,7,12
SAU,Saudi Arabia,BEL,Belgium,2017,40,2,38
SAU,Saudi Arabia,CAN,Canada,2008,249,0,249
SAU,Saudi Arabia,CAN,Canada,2009,246,0,246
SAU,Saudi Arabia,CAN,Canada,2010,330,0,330
SAU,Saudi Arabia,CAN,Canada,2011,278,0,278
SAU,Saudi Arabia,CAN,Canada,2012,286,0,286
SAU,Saudi Arabia,CAN,Canada,2013,267,0,267
SAU,Saudi Arabia,CAN,Canada,2014,232,0,232
SAU,Saudi Arabia,CAN,Canada,2015,196,0,196
SAU,Saudi Arabia,CAN,Canada,2016,175,0,175
SAU,Saudi Arabia,CAN,Canada,2017,205,0,205
SAU,Saudi Arabia,CZE,Czech Republic,2008,73,0,73
SAU,Saudi Arabia,CZE,Czech Republic,2009,67,0,67
SAU,Saudi Arabia,CZE,Czech Republic,2010,71,0,71
SAU,Saudi Arabia,CZE,Czech Republic,2011,62,0,62
SAU,Saudi Arabia,CZE,Czech Republic,2012,44,7,37
SAU,Saudi Arabia,CZE,Czech Republic,2013,25,45,-20
SAU,Saudi Arabia,CZE,Czech Republic,2014,44,19,25
SAU,Saudi Arabia,CZE,Czech Republic,2015,25,21,4
SAU,Saudi Arabia,CZE,Czech Republic,2016,35,23,12
SAU,Saudi Arabia,CZE,Czech Republic,2017,25,37,-12
SAU,Saudi Arabia,DNK,Denmark,2008,2,3,-1
SAU,Saudi Arabia,DNK,Denmark,2009,0,3,-3
SAU,Saudi Arabia,DNK,Denmark,2010,5,1,4
SAU,Saudi Arabia,DNK,Denmark,2012,3,1,2
SAU,Saudi Arabia,DNK,Denmark,2013,0,0,0
SAU,Saudi Arabia,DNK,Denmark,2014,12,1,11
SAU,Saudi Arabia,DNK,Denmark,2015,5,7,-2
SAU,Saudi Arabia,DNK,Denmark,2016,11,8,3
SAU,Saudi Arabia,DNK,Denmark,2017,7,4,3
SAU,Saudi Arabia,FIN,Finland,2008,0,0,0
SAU,Saudi Arabia,FIN,Finland,2009,0,0,0
SAU,Saudi Arabia,FIN,Finland,2010,0,0,0
SAU,Saudi Arabia,FIN,Finland,2011,1,0,1
SAU,Saudi Arabia,FIN,Finland,2012,0,0,0
SAU,Saudi Arabia,FIN,Finland,2013,0,0,0
SAU,Saudi Arabia,FIN,Finland,2014,4,0,4
SAU,Saudi Arabia,FIN,Finland,2015,3,0,3
SAU,Saudi Arabia,FIN,Finland,2016,0,0,0
SAU,Saudi Arabia,FIN,Finland,2017,1,4,-3
SAU,Saudi Arabia,FRA,France,2008,88,0,88
SAU,Saudi Arabia,FRA,France,2009,113,0,113
SAU,Saudi Arabia,FRA,France,2010,87,0,87
SAU,Saudi Arabia,FRA,France,2011,96,0,96
SAU,Saudi Arabia,FRA,France,2012,101,0,101
SAU,Saudi Arabia,FRA,France,2013,122,0,122
SAU,Saudi Arabia,FRA,France,2014,113,0,113
SAU,Saudi Arabia,FRA,France,2015,80,0,80
SAU,Saudi Arabia,FRA,France,2016,105,0,105
SAU,Saudi Arabia,FRA,France,2017,77,0,77
SAU,Saudi Arabia,DEU,Germany,2008,471,618,-147
SAU,Saudi Arabia,DEU,Germany,2009,510,426,84
SAU,Saudi Arabia,DEU,Germany,2010,782,393,389
SAU,Saudi Arabia,DEU,Germany,2011,854,529,325
SAU,Saudi Arabia,DEU,Germany,2012,1091,673,418
SAU,Saudi Arabia,DEU,Germany,2013,1502,910,592
SAU,Saudi Arabia,DEU,Germany,2014,2010,1241,769
SAU,Saudi Arabia,DEU,Germany,2015,2959,1949,1010
SAU,Saudi Arabia,DEU,Germany,2016,2133,2663,-530
SAU,Saudi Arabia,DEU,Germany,2017,1040,1443,-403
SAU,Saudi Arabia,HUN,Hungary,2008,126,6,120
SAU,Saudi Arabia,HUN,Hungary,2009,87,1,86
SAU,Saudi Arabia,HUN,Hungary,2010,88,21,67
SAU,Saudi Arabia,HUN,Hungary,2011,70,12,58
SAU,Saudi Arabia,HUN,Hungary,2012,32,6,26
SAU,Saudi Arabia,HUN,Hungary,2013,50,27,23
SAU,Saudi Arabia,HUN,Hungary,2014,45,29,16
SAU,Saudi Arabia,HUN,Hungary,2015,90,24,66
SAU,Saudi Arabia,HUN,Hungary,2016,40,36,4
SAU,Saudi Arabia,HUN,Hungary,2017,80,0,80
SAU,Saudi Arabia,ISL,Iceland,2008,0,0,0
SAU,Saudi Arabia,ISL,Iceland,2009,0,0,0
SAU,Saudi Arabia,ISL,Iceland,2010,0,0,0
SAU,Saudi Arabia,ISL,Iceland,2011,0,0,0
SAU,Saudi Arabia,ISL,Iceland,2012,1,0,1
SAU,Saudi Arabia,ISL,Iceland,2013,0,0,0
SAU,Saudi Arabia,ISL,Iceland,2014,0,0,0
SAU,Saudi Arabia,ISL,Iceland,2015,0,0,0
SAU,Saudi Arabia,ISL,Iceland,2016,0,0,0
SAU,Saudi Arabia,ISL,Iceland,2017,0,0,0
SAU,Saudi Arabia,ITA,Italy,2008,5,1,4
SAU,Saudi Arabia,ITA,Italy,2009,15,1,14
SAU,Saudi Arabia,ITA,Italy,2010,32,7,25
SAU,Saudi Arabia,ITA,Italy,2011,18,1,17
SAU,Saudi Arabia,ITA,Italy,2012,19,1,18
SAU,Saudi Arabia,ITA,Italy,2013,65,5,60
SAU,Saudi Arabia,ITA,Italy,2014,19,2,17
SAU,Saudi Arabia,ITA,Italy,2015,39,4,35
SAU,Saudi Arabia,ITA,Italy,2016,22,0,22
SAU,Saudi Arabia,ITA,Italy,2017,30,6,24
SAU,Saudi Arabia,JPN,Japan,2008,239,200,39
SAU,Saudi Arabia,JPN,Japan,2009,384,204,180
SAU,Saudi Arabia,JPN,Japan,2010,317,257,60
SAU,Saudi Arabia,JPN,Japan,2011,375,212,163
SAU,Saudi Arabia,JPN,Japan,2012,505,353,152
SAU,Saudi Arabia,JPN,Japan,2013,488,278,210
SAU,Saudi Arabia,JPN,Japan,2014,696,590,106
SAU,Saudi Arabia,JPN,Japan,2015,536,480,56
SAU,Saudi Arabia,JPN,Japan,2016,630,579,51
SAU,Saudi Arabia,JPN,Japan,2017,1057,1115,-58
SAU,Saudi Arabia,KOR,Korea,2008,202,151,51
SAU,Saudi Arabia,KOR,Korea,2009,216,157,59
SAU,Saudi Arabia,KOR,Korea,2010,291,278,13
SAU,Saudi Arabia,KOR,Korea,2011,865,216,649
SAU,Saudi Arabia,KOR,Korea,2012,546,880,-334
SAU,Saudi Arabia,KOR,Korea,2013,662,429,233
SAU,Saudi Arabia,KOR,Korea,2014,343,586,-243
SAU,Saudi Arabia,KOR,Korea,2015,329,291,38
SAU,Saudi Arabia,KOR,Korea,2016,346,311,35
SAU,Saudi Arabia,KOR,Korea,2017,352,468,-116
SAU,Saudi Arabia,LUX,Luxembourg,2008,0,0,0
SAU,Saudi Arabia,LUX,Luxembourg,2009,0,0,0
SAU,Saudi Arabia,LUX,Luxembourg,2010,0,0,0
SAU,Saudi Arabia,LUX,Luxembourg,2011,0,0,0
SAU,Saudi Arabia,LUX,Luxembourg,2012,1,0,1
SAU,Saudi Arabia,LUX,Luxembourg,2013,0,1,-1
SAU,Saudi Arabia,LUX,Luxembourg,2014,3,0,3
SAU,Saudi Arabia,LUX,Luxembourg,2015,0,3,-3
SAU,Saudi Arabia,LUX,Luxembourg,2016,0,0,0
SAU,Saudi Arabia,LUX,Luxembourg,2017,1,0,1
SAU,Saudi Arabia,MEX,Mexico,2010,1,0,1
SAU,Saudi Arabia,MEX,Mexico,2012,1,0,1
SAU,Saudi Arabia,MEX,Mexico,2013,0,0,0
SAU,Saudi Arabia,MEX,Mexico,2014,0,0,0
SAU,Saudi Arabia,MEX,Mexico,2015,2,0,2
SAU,Saudi Arabia,MEX,Mexico,2016,3,0,3
SAU,Saudi Arabia,MEX,Mexico,2017,1,0,1
SAU,Saudi Arabia,NLD,Netherlands,2008,121,72,49
SAU,Saudi Arabia,NLD,Netherlands,2009,231,98,133
SAU,Saudi Arabia,NLD,Netherlands,2010,337,174,163
SAU,Saudi Arabia,NLD,Netherlands,2011,175,176,-1
SAU,Saudi Arabia,NLD,Netherlands,2012,121,135,-14
SAU,Saudi Arabia,NLD,Netherlands,2013,194,170,24
SAU,Saudi Arabia,NLD,Netherlands,2014,149,159,-10
SAU,Saudi Arabia,NLD,Netherlands,2015,156,138,18
SAU,Saudi Arabia,NLD,Netherlands,2016,176,118,58
SAU,Saudi Arabia,NLD,Netherlands,2017,167,172,-5
SAU,Saudi Arabia,NZL,New Zealand,2008,556,55,501
SAU,Saudi Arabia,NZL,New Zealand,2009,550,61,489
SAU,Saudi Arabia,NZL,New Zealand,2010,588,156,432
SAU,Saudi Arabia,NZL,New Zealand,2011,490,156,334
SAU,Saudi Arabia,NZL,New Zealand,2012,269,200,69
SAU,Saudi Arabia,NZL,New Zealand,2013,217,211,6
SAU,Saudi Arabia,NZL,New Zealand,2014,432,167,265
SAU,Saudi Arabia,NZL,New Zealand,2015,216,153,63
SAU,Saudi Arabia,NZL,New Zealand,2016,175,139,36
SAU,Saudi Arabia,NZL,New Zealand,2017,141,107,34
SAU,Saudi Arabia,NOR,Norway,2008,12,0,12
SAU,Saudi Arabia,NOR,Norway,2009,7,5,2
SAU,Saudi Arabia,NOR,Norway,2010,4,8,-4
SAU,Saudi Arabia,NOR,Norway,2011,4,0,4
SAU,Saudi Arabia,NOR,Norway,2012,1,8,-7
SAU,Saudi Arabia,NOR,Norway,2013,2,1,1
SAU,Saudi Arabia,NOR,Norway,2014,5,1,4
SAU,Saudi Arabia,NOR,Norway,2015,4,4,0
SAU,Saudi Arabia,NOR,Norway,2016,10,4,6
SAU,Saudi Arabia,NOR,Norway,2017,7,2,5
SAU,Saudi Arabia,POL,Poland,2009,94,0,94
SAU,Saudi Arabia,POL,Poland,2010,169,0,169
SAU,Saudi Arabia,POL,Poland,2011,381,0,381
SAU,Saudi Arabia,POL,Poland,2012,359,0,359
SAU,Saudi Arabia,POL,Poland,2013,326,0,326
SAU,Saudi Arabia,POL,Poland,2014,201,0,201
SAU,Saudi Arabia,POL,Poland,2015,754,0,754
SAU,Saudi Arabia,POL,Poland,2016,746,0,746
SAU,Saudi Arabia,POL,Poland,2017,551,0,551
SAU,Saudi Arabia,SVK,Slovak Republic,2008,1,6,-5
SAU,Saudi Arabia,SVK,Slovak Republic,2009,67,5,62
SAU,Saudi Arabia,SVK,Slovak Republic,2010,46,6,40
SAU,Saudi Arabia,SVK,Slovak Republic,2011,14,2,12
SAU,Saudi Arabia,SVK,Slovak Republic,2012,1,0,1
SAU,Saudi Arabia,SVK,Slovak Republic,2013,1,0,1
SAU,Saudi Arabia,ESP,Spain,2008,66,62,4
SAU,Saudi Arabia,ESP,Spain,2009,50,56,-6
SAU,Saudi Arabia,ESP,Spain,2010,110,54,56
SAU,Saudi Arabia,ESP,Spain,2011,159,62,97
SAU,Saudi Arabia,ESP,Spain,2012,143,113,30
SAU,Saudi Arabia,ESP,Spain,2013,228,119,109
SAU,Saudi Arabia,ESP,Spain,2014,204,140,64
SAU,Saudi Arabia,ESP,Spain,2015,162,109,53
SAU,Saudi Arabia,ESP,Spain,2016,214,152,62
SAU,Saudi Arabia,ESP,Spain,2017,136,186,-50
SAU,Saudi Arabia,SWE,Sweden,2008,22,3,19
SAU,Saudi Arabia,SWE,Sweden,2009,108,6,102
SAU,Saudi Arabia,SWE,Sweden,2010,30,19,11
SAU,Saudi Arabia,SWE,Sweden,2011,87,16,71
SAU,Saudi Arabia,SWE,Sweden,2012,52,30,22
SAU,Saudi Arabia,SWE,Sweden,2013,102,17,85
SAU,Saudi Arabia,SWE,Sweden,2014,59,81,-22
SAU,Saudi Arabia,SWE,Sweden,2015,101,106,-5
SAU,Saudi Arabia,SWE,Sweden,2016,60,57,3
SAU,Saudi Arabia,SWE,Sweden,2017,91,48,43
SAU,Saudi Arabia,CHE,Switzerland,2010,106,97,9
SAU,Saudi Arabia,CHE,Switzerland,2011,105,89,16
SAU,Saudi Arabia,CHE,Switzerland,2012,105,85,20
SAU,Saudi Arabia,CHE,Switzerland,2013,110,67,43
SAU,Saudi Arabia,CHE,Switzerland,2014,110,92,18
SAU,Saudi Arabia,CHE,Switzerland,2015,104,86,18
SAU,Saudi Arabia,CHE,Switzerland,2016,91,99,-8
SAU,Saudi Arabia,CHE,Switzerland,2017,97,87,10
SAU,Saudi Arabia,TUR,Turkey,2010,18,0,18
SAU,Saudi Arabia,TUR,Turkey,2016,759,351,408
SAU,Saudi Arabia,TUR,Turkey,2017,1538,370,1168
SAU,Saudi Arabia,GBR,United Kingdom,2008,6000,0,6000
SAU,Saudi Arabia,GBR,United Kingdom,2009,5000,0,5000
SAU,Saudi Arabia,GBR,United Kingdom,2010,6000,0,6000
SAU,Saudi Arabia,GBR,United Kingdom,2011,3000,1000,2000
SAU,Saudi Arabia,GBR,United Kingdom,2012,2000,2000,0
SAU,Saudi Arabia,GBR,United Kingdom,2013,4000,1000,3000
SAU,Saudi Arabia,GBR,United Kingdom,2014,5000,1000,4000
SAU,Saudi Arabia,GBR,United Kingdom,2015,6000,1000,5000
SAU,Saudi Arabia,USA,United States,2008,1194,0,1194
SAU,Saudi Arabia,USA,United States,2009,1418,0,1418
SAU,Saudi Arabia,USA,United States,2010,1263,0,1263
SAU,Saudi Arabia,USA,United States,2011,1396,0,1396
SAU,Saudi Arabia,USA,United States,2012,1343,0,1343
SAU,Saudi Arabia,USA,United States,2013,1463,0,1463
SAU,Saudi Arabia,USA,United States,2014,1696,0,1696
SAU,Saudi Arabia,USA,United States,2015,1744,0,1744
SAU,Saudi Arabia,USA,United States,2016,2117,0,2117
SAU,Saudi Arabia,USA,United States,2017,2135,0,2135
SAU,Saudi Arabia,CHL,Chile,2008,0,0,0
SAU,Saudi Arabia,CHL,Chile,2009,1,0,1
SAU,Saudi Arabia,CHL,Chile,2010,0,0,0
SAU,Saudi Arabia,CHL,Chile,2011,0,0,0
SAU,Saudi Arabia,CHL,Chile,2012,1,0,1
SAU,Saudi Arabia,CHL,Chile,2013,0,0,0
SAU,Saudi Arabia,CHL,Chile,2014,0,0,0
SAU,Saudi Arabia,CHL,Chile,2015,0,0,0
SAU,Saudi Arabia,CHL,Chile,2016,0,0,0
SAU,Saudi Arabia,EST,Estonia,2008,0,0,0
SAU,Saudi Arabia,EST,Estonia,2009,0,0,0
SAU,Saudi Arabia,EST,Estonia,2010,0,0,0
SAU,Saudi Arabia,EST,Estonia,2011,0,0,0
SAU,Saudi Arabia,EST,Estonia,2012,0,0,0
SAU,Saudi Arabia,EST,Estonia,2013,0,0,0
SAU,Saudi Arabia,EST,Estonia,2014,0,0,0
SAU,Saudi Arabia,EST,Estonia,2015,0,0,0
SAU,Saudi Arabia,EST,Estonia,2016,0,0,0
SAU,Saudi Arabia,EST,Estonia,2017,0,0,0
SAU,Saudi Arabia,SVN,Slovenia,2008,3,0,3
SAU,Saudi Arabia,SVN,Slovenia,2010,1,0,1
SAU,Saudi Arabia,SVN,Slovenia,2013,1,0,1
SAU,Saudi Arabia,SVN,Slovenia,2015,2,0,2
SAU,Saudi Arabia,SVN,Slovenia,2016,1,0,1
SAU,Saudi Arabia,SVN,Slovenia,2017,2,0,2
SEN,Senegal,AUS,Australia,2008,7,0,7
SEN,Senegal,AUS,Australia,2009,7,0,7
SEN,Senegal,AUS,Australia,2010,8,0,8
SEN,Senegal,AUS,Australia,2011,10,0,10
SEN,Senegal,AUS,Australia,2012,8,0,8
SEN,Senegal,AUS,Australia,2013,12,0,12
SEN,Senegal,AUS,Australia,2014,6,0,6
SEN,Senegal,AUS,Australia,2015,0,0,0
SEN,Senegal,AUS,Australia,2016,13,0,13
SEN,Senegal,AUS,Australia,2017,7,0,7
SEN,Senegal,AUT,Austria,2008,30,20,10
SEN,Senegal,AUT,Austria,2009,35,19,16
SEN,Senegal,AUT,Austria,2010,51,31,20
SEN,Senegal,AUT,Austria,2011,47,29,18
SEN,Senegal,AUT,Austria,2012,47,40,7
SEN,Senegal,AUT,Austria,2013,46,34,12
SEN,Senegal,AUT,Austria,2014,54,32,22
SEN,Senegal,AUT,Austria,2015,74,37,37
SEN,Senegal,AUT,Austria,2016,61,55,6
SEN,Senegal,AUT,Austria,2017,30,32,-2
SEN,Senegal,BEL,Belgium,2008,235,0,235
SEN,Senegal,BEL,Belgium,2009,300,0,300
SEN,Senegal,BEL,Belgium,2010,276,26,250
SEN,Senegal,BEL,Belgium,2011,304,0,304
SEN,Senegal,BEL,Belgium,2012,702,130,572
SEN,Senegal,BEL,Belgium,2013,517,249,268
SEN,Senegal,BEL,Belgium,2014,395,303,92
SEN,Senegal,BEL,Belgium,2015,448,178,270
SEN,Senegal,BEL,Belgium,2016,338,130,208
SEN,Senegal,BEL,Belgium,2017,390,116,274
SEN,Senegal,CAN,Canada,2008,555,0,555
SEN,Senegal,CAN,Canada,2009,668,0,668
SEN,Senegal,CAN,Canada,2010,765,0,765
SEN,Senegal,CAN,Canada,2011,740,0,740
SEN,Senegal,CAN,Canada,2012,948,0,948
SEN,Senegal,CAN,Canada,2013,818,0,818
SEN,Senegal,CAN,Canada,2014,731,0,731
SEN,Senegal,CAN,Canada,2015,649,0,649
SEN,Senegal,CAN,Canada,2016,595,0,595
SEN,Senegal,CAN,Canada,2017,515,0,515
SEN,Senegal,CZE,Czech Republic,2008,5,0,5
SEN,Senegal,CZE,Czech Republic,2009,6,0,6
SEN,Senegal,CZE,Czech Republic,2010,3,0,3
SEN,Senegal,CZE,Czech Republic,2011,5,0,5
SEN,Senegal,CZE,Czech Republic,2012,2,2,0
SEN,Senegal,CZE,Czech Republic,2013,1,1,0
SEN,Senegal,CZE,Czech Republic,2014,4,0,4
SEN,Senegal,CZE,Czech Republic,2015,7,0,7
SEN,Senegal,CZE,Czech Republic,2016,6,0,6
SEN,Senegal,CZE,Czech Republic,2017,4,0,4
SEN,Senegal,DNK,Denmark,2008,9,1,8
SEN,Senegal,DNK,Denmark,2009,9,4,5
SEN,Senegal,DNK,Denmark,2010,11,6,5
SEN,Senegal,DNK,Denmark,2011,9,1,8
SEN,Senegal,DNK,Denmark,2012,9,6,3
SEN,Senegal,DNK,Denmark,2013,21,1,20
SEN,Senegal,DNK,Denmark,2014,12,6,6
SEN,Senegal,DNK,Denmark,2015,9,8,1
SEN,Senegal,DNK,Denmark,2016,7,4,3
SEN,Senegal,DNK,Denmark,2017,3,1,2
SEN,Senegal,FIN,Finland,2008,11,0,11
SEN,Senegal,FIN,Finland,2009,12,0,12
SEN,Senegal,FIN,Finland,2010,6,0,6
SEN,Senegal,FIN,Finland,2011,5,2,3
SEN,Senegal,FIN,Finland,2012,14,0,14
SEN,Senegal,FIN,Finland,2013,15,1,14
SEN,Senegal,FIN,Finland,2014,17,0,17
SEN,Senegal,FIN,Finland,2015,15,2,13
SEN,Senegal,FIN,Finland,2016,15,2,13
SEN,Senegal,FIN,Finland,2017,9,3,6
SEN,Senegal,FRA,France,2008,3345,0,3345
SEN,Senegal,FRA,France,2009,3862,0,3862
SEN,Senegal,FRA,France,2010,4034,0,4034
SEN,Senegal,FRA,France,2011,4019,0,4019
SEN,Senegal,FRA,France,2012,4201,0,4201
SEN,Senegal,FRA,France,2013,4361,0,4361
SEN,Senegal,FRA,France,2014,4566,0,4566
SEN,Senegal,FRA,France,2015,3700,0,3700
SEN,Senegal,FRA,France,2016,3869,0,3869
SEN,Senegal,FRA,France,2017,4130,0,4130
SEN,Senegal,DEU,Germany,2008,226,173,53
SEN,Senegal,DEU,Germany,2009,277,228,49
SEN,Senegal,DEU,Germany,2010,265,175,90
SEN,Senegal,DEU,Germany,2011,270,168,102
SEN,Senegal,DEU,Germany,2012,410,198,212
SEN,Senegal,DEU,Germany,2013,929,259,670
SEN,Senegal,DEU,Germany,2014,1252,499,753
SEN,Senegal,DEU,Germany,2015,2255,514,1741
SEN,Senegal,DEU,Germany,2016,1355,1316,39
SEN,Senegal,DEU,Germany,2017,734,1324,-590
SEN,Senegal,HUN,Hungary,2008,4,0,4
SEN,Senegal,HUN,Hungary,2009,2,1,1
SEN,Senegal,HUN,Hungary,2010,4,2,2
SEN,Senegal,HUN,Hungary,2011,3,0,3
SEN,Senegal,HUN,Hungary,2012,5,1,4
SEN,Senegal,HUN,Hungary,2013,3,0,3
SEN,Senegal,HUN,Hungary,2014,4,1,3
SEN,Senegal,HUN,Hungary,2015,4,0,4
SEN,Senegal,HUN,Hungary,2016,7,1,6
SEN,Senegal,HUN,Hungary,2017,8,0,8
SEN,Senegal,ISL,Iceland,2008,1,0,1
SEN,Senegal,ISL,Iceland,2009,0,0,0
SEN,Senegal,ISL,Iceland,2010,2,0,2
SEN,Senegal,ISL,Iceland,2011,4,0,4
SEN,Senegal,ISL,Iceland,2012,2,0,2
SEN,Senegal,ISL,Iceland,2013,1,3,-2
SEN,Senegal,ISL,Iceland,2014,3,2,1
SEN,Senegal,ISL,Iceland,2015,3,1,2
SEN,Senegal,ISL,Iceland,2016,0,1,-1
SEN,Senegal,ISL,Iceland,2017,1,1,0
SEN,Senegal,ITA,Italy,2008,4770,178,4592
SEN,Senegal,ITA,Italy,2009,4858,216,4642
SEN,Senegal,ITA,Italy,2010,8851,234,8617
SEN,Senegal,ITA,Italy,2011,6608,246,6362
SEN,Senegal,ITA,Italy,2012,5493,397,5096
SEN,Senegal,ITA,Italy,2013,6451,434,6017
SEN,Senegal,ITA,Italy,2014,6270,495,5775
SEN,Senegal,ITA,Italy,2015,7471,455,7016
SEN,Senegal,ITA,Italy,2016,8524,0,8524
SEN,Senegal,ITA,Italy,2017,10862,441,10421
SEN,Senegal,JPN,Japan,2008,185,182,3
SEN,Senegal,JPN,Japan,2009,121,94,27
SEN,Senegal,JPN,Japan,2010,145,123,22
SEN,Senegal,JPN,Japan,2011,161,132,29
SEN,Senegal,JPN,Japan,2012,169,148,21
SEN,Senegal,JPN,Japan,2013,225,204,21
SEN,Senegal,JPN,Japan,2014,155,112,43
SEN,Senegal,JPN,Japan,2015,193,144,49
SEN,Senegal,JPN,Japan,2016,229,171,58
SEN,Senegal,JPN,Japan,2017,244,177,67
SEN,Senegal,KOR,Korea,2008,14,11,3
SEN,Senegal,KOR,Korea,2009,21,15,6
SEN,Senegal,KOR,Korea,2010,15,14,1
SEN,Senegal,KOR,Korea,2011,19,16,3
SEN,Senegal,KOR,Korea,2012,27,23,4
SEN,Senegal,KOR,Korea,2013,36,15,21
SEN,Senegal,KOR,Korea,2014,49,29,20
SEN,Senegal,KOR,Korea,2015,32,24,8
SEN,Senegal,KOR,Korea,2016,83,30,53
SEN,Senegal,KOR,Korea,2017,193,36,157
SEN,Senegal,LUX,Luxembourg,2008,25,6,19
SEN,Senegal,LUX,Luxembourg,2009,28,6,22
SEN,Senegal,LUX,Luxembourg,2010,37,6,31
SEN,Senegal,LUX,Luxembourg,2011,38,5,33
SEN,Senegal,LUX,Luxembourg,2012,25,6,19
SEN,Senegal,LUX,Luxembourg,2013,37,5,32
SEN,Senegal,LUX,Luxembourg,2014,30,16,14
SEN,Senegal,LUX,Luxembourg,2015,47,16,31
SEN,Senegal,LUX,Luxembourg,2016,60,8,52
SEN,Senegal,LUX,Luxembourg,2017,47,24,23
SEN,Senegal,MEX,Mexico,2008,2,0,2
SEN,Senegal,MEX,Mexico,2009,4,0,4
SEN,Senegal,MEX,Mexico,2010,3,0,3
SEN,Senegal,MEX,Mexico,2011,2,0,2
SEN,Senegal,MEX,Mexico,2012,1,0,1
SEN,Senegal,MEX,Mexico,2013,1,0,1
SEN,Senegal,MEX,Mexico,2014,6,0,6
SEN,Senegal,MEX,Mexico,2016,3,0,3
SEN,Senegal,MEX,Mexico,2017,4,0,4
SEN,Senegal,NLD,Netherlands,2008,28,21,7
SEN,Senegal,NLD,Netherlands,2009,36,13,23
SEN,Senegal,NLD,Netherlands,2010,24,18,6
SEN,Senegal,NLD,Netherlands,2011,25,6,19
SEN,Senegal,NLD,Netherlands,2012,28,19,9
SEN,Senegal,NLD,Netherlands,2013,36,11,25
SEN,Senegal,NLD,Netherlands,2014,28,9,19
SEN,Senegal,NLD,Netherlands,2015,25,-1,26
SEN,Senegal,NLD,Netherlands,2016,39,16,23
SEN,Senegal,NLD,Netherlands,2017,28,10,18
SEN,Senegal,NZL,New Zealand,2008,1,0,1
SEN,Senegal,NZL,New Zealand,2009,0,0,0
SEN,Senegal,NZL,New Zealand,2011,0,1,-1
SEN,Senegal,NZL,New Zealand,2015,1,1,0
SEN,Senegal,NOR,Norway,2008,8,3,5
SEN,Senegal,NOR,Norway,2009,22,2,20
SEN,Senegal,NOR,Norway,2010,12,0,12
SEN,Senegal,NOR,Norway,2011,20,8,12
SEN,Senegal,NOR,Norway,2012,21,4,17
SEN,Senegal,NOR,Norway,2013,10,6,4
SEN,Senegal,NOR,Norway,2014,17,5,12
SEN,Senegal,NOR,Norway,2015,18,5,13
SEN,Senegal,NOR,Norway,2016,16,8,8
SEN,Senegal,NOR,Norway,2017,9,2,7
SEN,Senegal,POL,Poland,2008,27,0,27
SEN,Senegal,POL,Poland,2009,41,0,41
SEN,Senegal,POL,Poland,2010,42,0,42
SEN,Senegal,POL,Poland,2011,29,0,29
SEN,Senegal,POL,Poland,2012,48,0,48
SEN,Senegal,POL,Poland,2013,31,0,31
SEN,Senegal,POL,Poland,2014,18,0,18
SEN,Senegal,POL,Poland,2015,25,0,25
SEN,Senegal,POL,Poland,2016,19,0,19
SEN,Senegal,POL,Poland,2017,24,0,24
SEN,Senegal,SVK,Slovak Republic,2008,1,0,1
SEN,Senegal,SVK,Slovak Republic,2009,4,2,2
SEN,Senegal,SVK,Slovak Republic,2010,1,2,-1
SEN,Senegal,SVK,Slovak Republic,2011,1,0,1
SEN,Senegal,SVK,Slovak Republic,2012,1,0,1
SEN,Senegal,SVK,Slovak Republic,2014,1,0,1
SEN,Senegal,SVK,Slovak Republic,2015,1,0,1
SEN,Senegal,ESP,Spain,2008,10568,2220,8348
SEN,Senegal,ESP,Spain,2009,7176,3049,4127
SEN,Senegal,ESP,Spain,2010,3824,3950,-126
SEN,Senegal,ESP,Spain,2011,3601,4548,-947
SEN,Senegal,ESP,Spain,2012,2923,5303,-2380
SEN,Senegal,ESP,Spain,2013,3091,6181,-3090
SEN,Senegal,ESP,Spain,2014,2982,3829,-847
SEN,Senegal,ESP,Spain,2015,3386,2964,422
SEN,Senegal,ESP,Spain,2016,3830,2750,1080
SEN,Senegal,ESP,Spain,2017,4313,2800,1513
SEN,Senegal,SWE,Sweden,2008,39,2,37
SEN,Senegal,SWE,Sweden,2009,51,4,47
SEN,Senegal,SWE,Sweden,2010,51,5,46
SEN,Senegal,SWE,Sweden,2011,58,1,57
SEN,Senegal,SWE,Sweden,2012,72,8,64
SEN,Senegal,SWE,Sweden,2013,61,8,53
SEN,Senegal,SWE,Sweden,2014,48,8,40
SEN,Senegal,SWE,Sweden,2015,56,6,50
SEN,Senegal,SWE,Sweden,2016,43,3,40
SEN,Senegal,SWE,Sweden,2017,40,8,32
SEN,Senegal,CHE,Switzerland,2010,121,43,78
SEN,Senegal,CHE,Switzerland,2011,118,46,72
SEN,Senegal,CHE,Switzerland,2012,102,43,59
SEN,Senegal,CHE,Switzerland,2013,112,44,68
SEN,Senegal,CHE,Switzerland,2014,112,47,65
SEN,Senegal,CHE,Switzerland,2015,169,31,138
SEN,Senegal,CHE,Switzerland,2016,105,35,70
SEN,Senegal,CHE,Switzerland,2017,109,38,71
SEN,Senegal,TUR,Turkey,2010,20,0,20
SEN,Senegal,TUR,Turkey,2016,323,78,245
SEN,Senegal,TUR,Turkey,2017,249,137,112
SEN,Senegal,USA,United States,2008,1149,0,1149
SEN,Senegal,USA,United States,2009,1524,0,1524
SEN,Senegal,USA,United States,2010,1285,0,1285
SEN,Senegal,USA,United States,2011,1424,0,1424
SEN,Senegal,USA,United States,2012,1615,0,1615
SEN,Senegal,USA,United States,2013,1340,0,1340
SEN,Senegal,USA,United States,2014,1273,0,1273
SEN,Senegal,USA,United States,2015,1244,0,1244
SEN,Senegal,USA,United States,2016,1533,0,1533
SEN,Senegal,USA,United States,2017,1470,0,1470
SEN,Senegal,CHL,Chile,2008,0,0,0
SEN,Senegal,CHL,Chile,2009,0,0,0
SEN,Senegal,CHL,Chile,2010,7,0,7
SEN,Senegal,CHL,Chile,2011,0,0,0
SEN,Senegal,CHL,Chile,2012,2,0,2
SEN,Senegal,CHL,Chile,2013,0,0,0
SEN,Senegal,CHL,Chile,2014,3,0,3
SEN,Senegal,CHL,Chile,2015,3,0,3
SEN,Senegal,CHL,Chile,2016,4,0,4
SEN,Senegal,EST,Estonia,2008,0,0,0
SEN,Senegal,EST,Estonia,2009,0,0,0
SEN,Senegal,EST,Estonia,2010,0,0,0
SEN,Senegal,EST,Estonia,2011,0,0,0
SEN,Senegal,EST,Estonia,2012,0,0,0
SEN,Senegal,EST,Estonia,2013,0,0,0
SEN,Senegal,EST,Estonia,2014,0,0,0
SEN,Senegal,EST,Estonia,2015,0,0,0
SEN,Senegal,EST,Estonia,2016,0,0,0
SEN,Senegal,EST,Estonia,2017,0,0,0
SEN,Senegal,SVN,Slovenia,2010,1,0,1
SEN,Senegal,SVN,Slovenia,2011,2,0,2
SEN,Senegal,SVN,Slovenia,2012,1,0,1
SEN,Senegal,SVN,Slovenia,2014,1,0,1
SCG,Serbia and Montenegro,AUS,Australia,2008,155,0,155
SCG,Serbia and Montenegro,AUS,Australia,2009,73,0,73
SCG,Serbia and Montenegro,AUS,Australia,2010,50,0,50
SCG,Serbia and Montenegro,AUS,Australia,2011,21,0,21
SCG,Serbia and Montenegro,AUS,Australia,2012,14,0,14
SCG,Serbia and Montenegro,AUS,Australia,2013,11,0,11
SCG,Serbia and Montenegro,AUS,Australia,2014,11,0,11
SCG,Serbia and Montenegro,AUS,Australia,2015,0,0,0
SCG,Serbia and Montenegro,AUS,Australia,2016,8,0,8
SCG,Serbia and Montenegro,AUS,Australia,2017,0,0,0
SCG,Serbia and Montenegro,AUT,Austria,2014,0,0,0
SCG,Serbia and Montenegro,AUT,Austria,2015,0,0,0
SCG,Serbia and Montenegro,AUT,Austria,2016,0,0,0
SCG,Serbia and Montenegro,AUT,Austria,2017,0,0,0
SCG,Serbia and Montenegro,BEL,Belgium,2010,55,53,2
SCG,Serbia and Montenegro,BEL,Belgium,2012,29,911,-882
SCG,Serbia and Montenegro,BEL,Belgium,2013,16,181,-165
SCG,Serbia and Montenegro,BEL,Belgium,2014,25,301,-276
SCG,Serbia and Montenegro,BEL,Belgium,2015,21,83,-62
SCG,Serbia and Montenegro,BEL,Belgium,2016,24,54,-30
SCG,Serbia and Montenegro,BEL,Belgium,2017,23,32,-9
SCG,Serbia and Montenegro,CAN,Canada,2008,456,0,456
SCG,Serbia and Montenegro,CAN,Canada,2009,204,0,204
SCG,Serbia and Montenegro,CAN,Canada,2010,109,0,109
SCG,Serbia and Montenegro,CAN,Canada,2011,39,0,39
SCG,Serbia and Montenegro,CAN,Canada,2012,32,0,32
SCG,Serbia and Montenegro,CAN,Canada,2013,34,0,34
SCG,Serbia and Montenegro,CAN,Canada,2014,17,0,17
SCG,Serbia and Montenegro,CAN,Canada,2015,18,0,18
SCG,Serbia and Montenegro,CAN,Canada,2016,0,0,0
SCG,Serbia and Montenegro,CAN,Canada,2017,0,0,0
SCG,Serbia and Montenegro,CZE,Czech Republic,2008,297,8,289
SCG,Serbia and Montenegro,CZE,Czech Republic,2009,184,9,175
SCG,Serbia and Montenegro,CZE,Czech Republic,2010,201,6,195
SCG,Serbia and Montenegro,CZE,Czech Republic,2011,740,9,731
SCG,Serbia and Montenegro,CZE,Czech Republic,2012,179,74,105
SCG,Serbia and Montenegro,DNK,Denmark,2008,10,9,1
SCG,Serbia and Montenegro,DNK,Denmark,2009,5,3,2
SCG,Serbia and Montenegro,DNK,Denmark,2012,0,0,0
SCG,Serbia and Montenegro,DNK,Denmark,2013,8,2,6
SCG,Serbia and Montenegro,DNK,Denmark,2014,2,0,2
SCG,Serbia and Montenegro,DNK,Denmark,2015,4,4,0
SCG,Serbia and Montenegro,DNK,Denmark,2016,2,7,-5
SCG,Serbia and Montenegro,DNK,Denmark,2017,3,6,-3
SCG,Serbia and Montenegro,FIN,Finland,2008,7,17,-10
SCG,Serbia and Montenegro,FIN,Finland,2009,4,4,0
SCG,Serbia and Montenegro,FIN,Finland,2010,5,10,-5
SCG,Serbia and Montenegro,FIN,Finland,2011,0,8,-8
SCG,Serbia and Montenegro,FIN,Finland,2012,1,10,-9
SCG,Serbia and Montenegro,FIN,Finland,2013,8,4,4
SCG,Serbia and Montenegro,FIN,Finland,2014,4,15,-11
SCG,Serbia and Montenegro,FIN,Finland,2015,0,10,-10
SCG,Serbia and Montenegro,FIN,Finland,2016,0,10,-10
SCG,Serbia and Montenegro,FIN,Finland,2017,299,11,288
SCG,Serbia and Montenegro,FRA,France,2008,0,0,0
SCG,Serbia and Montenegro,FRA,France,2009,0,0,0
SCG,Serbia and Montenegro,FRA,France,2010,0,0,0
SCG,Serbia and Montenegro,FRA,France,2011,0,0,0
SCG,Serbia and Montenegro,FRA,France,2012,0,0,0
SCG,Serbia and Montenegro,FRA,France,2013,0,0,0
SCG,Serbia and Montenegro,FRA,France,2014,0,0,0
SCG,Serbia and Montenegro,FRA,France,2015,0,0,0
SCG,Serbia and Montenegro,FRA,France,2016,0,0,0
SCG,Serbia and Montenegro,FRA,France,2017,0,0,0
SCG,Serbia and Montenegro,DEU,Germany,2008,1230,4898,-3668
SCG,Serbia and Montenegro,DEU,Germany,2009,1643,6673,-5030
SCG,Serbia and Montenegro,DEU,Germany,2010,1752,4546,-2794
SCG,Serbia and Montenegro,DEU,Germany,2011,1270,2708,-1438
SCG,Serbia and Montenegro,DEU,Germany,2012,998,2270,-1272
SCG,Serbia and Montenegro,DEU,Germany,2013,373,1765,-1392
SCG,Serbia and Montenegro,DEU,Germany,2014,340,1009,-669
SCG,Serbia and Montenegro,DEU,Germany,2015,290,883,-593
SCG,Serbia and Montenegro,DEU,Germany,2016,260,927,-667
SCG,Serbia and Montenegro,DEU,Germany,2017,208,634,-426
SCG,Serbia and Montenegro,HUN,Hungary,2008,22,33,-11
SCG,Serbia and Montenegro,HUN,Hungary,2009,5,18,-13
SCG,Serbia and Montenegro,HUN,Hungary,2010,1,44,-43
SCG,Serbia and Montenegro,HUN,Hungary,2011,0,67,-67
SCG,Serbia and Montenegro,HUN,Hungary,2012,1,32,-31
SCG,Serbia and Montenegro,HUN,Hungary,2013,2,3,-1
SCG,Serbia and Montenegro,HUN,Hungary,2014,2,3,-1
SCG,Serbia and Montenegro,HUN,Hungary,2015,0,0,0
SCG,Serbia and Montenegro,HUN,Hungary,2016,0,0,0
SCG,Serbia and Montenegro,HUN,Hungary,2017,0,0,0
SCG,Serbia and Montenegro,ISL,Iceland,2008,0,0,0
SCG,Serbia and Montenegro,ISL,Iceland,2009,0,0,0
SCG,Serbia and Montenegro,ISL,Iceland,2010,0,0,0
SCG,Serbia and Montenegro,ISL,Iceland,2011,0,0,0
SCG,Serbia and Montenegro,ISL,Iceland,2012,0,0,0
SCG,Serbia and Montenegro,ISL,Iceland,2013,0,0,0
SCG,Serbia and Montenegro,ISL,Iceland,2014,0,0,0
SCG,Serbia and Montenegro,ISL,Iceland,2015,0,0,0
SCG,Serbia and Montenegro,ISL,Iceland,2016,0,0,0
SCG,Serbia and Montenegro,ISL,Iceland,2017,0,0,0
SCG,Serbia and Montenegro,JPN,Japan,2008,110,100,10
SCG,Serbia and Montenegro,JPN,Japan,2009,48,52,-4
SCG,Serbia and Montenegro,JPN,Japan,2010,9,15,-6
SCG,Serbia and Montenegro,JPN,Japan,2011,0,7,-7
SCG,Serbia and Montenegro,JPN,Japan,2012,0,6,-6
SCG,Serbia and Montenegro,JPN,Japan,2013,0,2,-2
SCG,Serbia and Montenegro,JPN,Japan,2014,0,0,0
SCG,Serbia and Montenegro,JPN,Japan,2015,0,0,0
SCG,Serbia and Montenegro,JPN,Japan,2016,0,3,-3
SCG,Serbia and Montenegro,JPN,Japan,2017,0,0,0
SCG,Serbia and Montenegro,KOR,Korea,2008,28,8,20
SCG,Serbia and Montenegro,KOR,Korea,2009,4,9,-5
SCG,Serbia and Montenegro,KOR,Korea,2010,1,2,-1
SCG,Serbia and Montenegro,KOR,Korea,2011,0,3,-3
SCG,Serbia and Montenegro,KOR,Korea,2012,0,2,-2
SCG,Serbia and Montenegro,KOR,Korea,2013,0,1,-1
SCG,Serbia and Montenegro,KOR,Korea,2014,0,0,0
SCG,Serbia and Montenegro,KOR,Korea,2015,0,0,0
SCG,Serbia and Montenegro,KOR,Korea,2016,0,0,0
SCG,Serbia and Montenegro,KOR,Korea,2017,0,1,-1
SCG,Serbia and Montenegro,LUX,Luxembourg,2008,125,130,-5
SCG,Serbia and Montenegro,LUX,Luxembourg,2009,28,46,-18
SCG,Serbia and Montenegro,LUX,Luxembourg,2010,16,26,-10
SCG,Serbia and Montenegro,LUX,Luxembourg,2011,14,19,-5
SCG,Serbia and Montenegro,LUX,Luxembourg,2012,6,17,-11
SCG,Serbia and Montenegro,LUX,Luxembourg,2013,5,6,-1
SCG,Serbia and Montenegro,LUX,Luxembourg,2014,1,3,-2
SCG,Serbia and Montenegro,LUX,Luxembourg,2015,2,1,1
SCG,Serbia and Montenegro,LUX,Luxembourg,2016,5,6,-1
SCG,Serbia and Montenegro,LUX,Luxembourg,2017,3,1,2
SCG,Serbia and Montenegro,MEX,Mexico,2012,0,0,0
SCG,Serbia and Montenegro,MEX,Mexico,2013,0,0,0
SCG,Serbia and Montenegro,MEX,Mexico,2014,0,0,0
SCG,Serbia and Montenegro,NLD,Netherlands,2012,1,3,-2
SCG,Serbia and Montenegro,NLD,Netherlands,2013,0,2,-2
SCG,Serbia and Montenegro,NLD,Netherlands,2015,0,2,-2
SCG,Serbia and Montenegro,NLD,Netherlands,2017,0,1,-1
SCG,Serbia and Montenegro,NZL,New Zealand,2008,0,0,0
SCG,Serbia and Montenegro,NZL,New Zealand,2009,0,0,0
SCG,Serbia and Montenegro,NZL,New Zealand,2012,0,0,0
SCG,Serbia and Montenegro,NOR,Norway,2008,52,51,1
SCG,Serbia and Montenegro,NOR,Norway,2009,0,0,0
SCG,Serbia and Montenegro,NOR,Norway,2010,0,53,-53
SCG,Serbia and Montenegro,NOR,Norway,2011,0,0,0
SCG,Serbia and Montenegro,NOR,Norway,2012,0,0,0
SCG,Serbia and Montenegro,NOR,Norway,2013,0,0,0
SCG,Serbia and Montenegro,NOR,Norway,2014,0,0,0
SCG,Serbia and Montenegro,NOR,Norway,2015,0,0,0
SCG,Serbia and Montenegro,NOR,Norway,2016,0,0,0
SCG,Serbia and Montenegro,NOR,Norway,2017,0,0,0
SCG,Serbia and Montenegro,POL,Poland,2008,156,0,156
SCG,Serbia and Montenegro,POL,Poland,2009,0,0,0
SCG,Serbia and Montenegro,POL,Poland,2010,0,0,0
SCG,Serbia and Montenegro,POL,Poland,2011,0,0,0
SCG,Serbia and Montenegro,POL,Poland,2012,0,0,0
SCG,Serbia and Montenegro,POL,Poland,2013,8,0,8
SCG,Serbia and Montenegro,POL,Poland,2014,70,0,70
SCG,Serbia and Montenegro,POL,Poland,2015,304,0,304
SCG,Serbia and Montenegro,POL,Poland,2016,359,0,359
SCG,Serbia and Montenegro,POL,Poland,2017,298,0,298
SCG,Serbia and Montenegro,SVK,Slovak Republic,2008,0,0,0
SCG,Serbia and Montenegro,SWE,Sweden,2008,0,0,0
SCG,Serbia and Montenegro,SWE,Sweden,2009,0,0,0
SCG,Serbia and Montenegro,SWE,Sweden,2010,0,0,0
SCG,Serbia and Montenegro,SWE,Sweden,2011,0,0,0
SCG,Serbia and Montenegro,SWE,Sweden,2012,0,0,0
SCG,Serbia and Montenegro,SWE,Sweden,2013,0,0,0
SCG,Serbia and Montenegro,SWE,Sweden,2014,0,0,0
SCG,Serbia and Montenegro,SWE,Sweden,2015,0,0,0
SCG,Serbia and Montenegro,SWE,Sweden,2016,0,0,0
SCG,Serbia and Montenegro,SWE,Sweden,2017,0,0,0
SCG,Serbia and Montenegro,USA,United States,2008,3255,0,3255
SCG,Serbia and Montenegro,USA,United States,2009,3166,0,3166
SCG,Serbia and Montenegro,USA,United States,2010,2196,0,2196
SCG,Serbia and Montenegro,USA,United States,2011,1398,0,1398
SCG,Serbia and Montenegro,USA,United States,2012,801,0,801
SCG,Serbia and Montenegro,USA,United States,2013,653,0,653
SCG,Serbia and Montenegro,USA,United States,2014,267,0,267
SCG,Serbia and Montenegro,USA,United States,2015,232,0,232
SCG,Serbia and Montenegro,USA,United States,2016,202,0,202
SCG,Serbia and Montenegro,USA,United States,2017,144,0,144
SCG,Serbia and Montenegro,CHL,Chile,2008,5,0,5
SCG,Serbia and Montenegro,CHL,Chile,2009,5,0,5
SCG,Serbia and Montenegro,CHL,Chile,2010,0,0,0
SCG,Serbia and Montenegro,CHL,Chile,2011,0,0,0
SCG,Serbia and Montenegro,CHL,Chile,2012,1,0,1
SCG,Serbia and Montenegro,CHL,Chile,2013,9,0,9
SCG,Serbia and Montenegro,CHL,Chile,2014,5,0,5
SCG,Serbia and Montenegro,CHL,Chile,2015,5,0,5
SCG,Serbia and Montenegro,CHL,Chile,2016,2,0,2
SCG,Serbia and Montenegro,EST,Estonia,2017,0,0,0
SYC,Seychelles,AUS,Australia,2008,41,13,28
SYC,Seychelles,AUS,Australia,2009,38,11,27
SYC,Seychelles,AUS,Australia,2010,58,17,41
SYC,Seychelles,AUS,Australia,2011,37,17,20
SYC,Seychelles,AUS,Australia,2012,55,24,31
SYC,Seychelles,AUS,Australia,2013,32,11,21
SYC,Seychelles,AUS,Australia,2014,47,13,34
SYC,Seychelles,AUS,Australia,2015,25,0,25
SYC,Seychelles,AUS,Australia,2016,28,0,28
SYC,Seychelles,AUS,Australia,2017,14,0,14
SYC,Seychelles,AUT,Austria,2008,1,0,1
SYC,Seychelles,AUT,Austria,2009,4,0,4
SYC,Seychelles,AUT,Austria,2010,1,0,1
SYC,Seychelles,AUT,Austria,2011,0,2,-2
SYC,Seychelles,AUT,Austria,2012,1,1,0
SYC,Seychelles,AUT,Austria,2013,5,1,4
SYC,Seychelles,AUT,Austria,2014,2,4,-2
SYC,Seychelles,AUT,Austria,2015,8,3,5
SYC,Seychelles,AUT,Austria,2016,3,2,1
SYC,Seychelles,AUT,Austria,2017,1,1,0
SYC,Seychelles,BEL,Belgium,2008,4,0,4
SYC,Seychelles,BEL,Belgium,2009,1,0,1
SYC,Seychelles,BEL,Belgium,2010,1,0,1
SYC,Seychelles,BEL,Belgium,2012,2,3,-1
SYC,Seychelles,BEL,Belgium,2013,2,1,1
SYC,Seychelles,BEL,Belgium,2014,1,2,-1
SYC,Seychelles,BEL,Belgium,2015,5,1,4
SYC,Seychelles,BEL,Belgium,2016,4,0,4
SYC,Seychelles,BEL,Belgium,2017,1,0,1
SYC,Seychelles,CAN,Canada,2008,18,0,18
SYC,Seychelles,CAN,Canada,2009,4,0,4
SYC,Seychelles,CAN,Canada,2010,10,0,10
SYC,Seychelles,CAN,Canada,2011,10,0,10
SYC,Seychelles,CAN,Canada,2012,6,0,6
SYC,Seychelles,CAN,Canada,2013,5,0,5
SYC,Seychelles,CAN,Canada,2014,2,0,2
SYC,Seychelles,CAN,Canada,2015,0,0,0
SYC,Seychelles,CAN,Canada,2016,5,0,5
SYC,Seychelles,CAN,Canada,2017,5,0,5
SYC,Seychelles,CZE,Czech Republic,2010,1,0,1
SYC,Seychelles,CZE,Czech Republic,2012,2,1,1
SYC,Seychelles,CZE,Czech Republic,2013,2,2,0
SYC,Seychelles,CZE,Czech Republic,2014,3,0,3
SYC,Seychelles,DNK,Denmark,2008,0,0,0
SYC,Seychelles,DNK,Denmark,2009,0,0,0
SYC,Seychelles,DNK,Denmark,2010,1,0,1
SYC,Seychelles,DNK,Denmark,2012,0,0,0
SYC,Seychelles,DNK,Denmark,2013,0,0,0
SYC,Seychelles,DNK,Denmark,2014,0,0,0
SYC,Seychelles,DNK,Denmark,2015,1,1,0
SYC,Seychelles,DNK,Denmark,2016,1,0,1
SYC,Seychelles,DNK,Denmark,2017,0,1,-1
SYC,Seychelles,FIN,Finland,2008,0,0,0
SYC,Seychelles,FIN,Finland,2009,1,1,0
SYC,Seychelles,FIN,Finland,2010,0,0,0
SYC,Seychelles,FIN,Finland,2011,2,0,2
SYC,Seychelles,FIN,Finland,2012,0,0,0
SYC,Seychelles,FIN,Finland,2013,0,0,0
SYC,Seychelles,FIN,Finland,2014,0,0,0
SYC,Seychelles,FIN,Finland,2015,0,0,0
SYC,Seychelles,FIN,Finland,2016,0,0,0
SYC,Seychelles,FIN,Finland,2017,0,0,0
SYC,Seychelles,FRA,France,2008,6,0,6
SYC,Seychelles,FRA,France,2009,10,0,10
SYC,Seychelles,FRA,France,2010,11,0,11
SYC,Seychelles,FRA,France,2011,29,0,29
SYC,Seychelles,FRA,France,2012,9,0,9
SYC,Seychelles,FRA,France,2013,20,0,20
SYC,Seychelles,FRA,France,2014,13,0,13
SYC,Seychelles,FRA,France,2015,14,0,14
SYC,Seychelles,FRA,France,2016,14,0,14
SYC,Seychelles,FRA,France,2017,5,0,5
SYC,Seychelles,DEU,Germany,2008,8,13,-5
SYC,Seychelles,DEU,Germany,2009,13,12,1
SYC,Seychelles,DEU,Germany,2010,17,12,5
SYC,Seychelles,DEU,Germany,2011,14,12,2
SYC,Seychelles,DEU,Germany,2012,12,10,2
SYC,Seychelles,DEU,Germany,2013,16,14,2
SYC,Seychelles,DEU,Germany,2014,12,19,-7
SYC,Seychelles,DEU,Germany,2015,11,11,0
SYC,Seychelles,DEU,Germany,2016,11,13,-2
SYC,Seychelles,DEU,Germany,2017,6,10,-4
SYC,Seychelles,HUN,Hungary,2008,0,0,0
SYC,Seychelles,HUN,Hungary,2009,1,0,1
SYC,Seychelles,HUN,Hungary,2010,2,0,2
SYC,Seychelles,HUN,Hungary,2011,1,0,1
SYC,Seychelles,HUN,Hungary,2012,1,0,1
SYC,Seychelles,HUN,Hungary,2013,2,0,2
SYC,Seychelles,HUN,Hungary,2014,3,0,3
SYC,Seychelles,HUN,Hungary,2015,0,0,0
SYC,Seychelles,HUN,Hungary,2016,3,1,2
SYC,Seychelles,HUN,Hungary,2017,0,0,0
SYC,Seychelles,ISL,Iceland,2016,0,0,0
SYC,Seychelles,ISL,Iceland,2017,0,0,0
SYC,Seychelles,ITA,Italy,2008,22,1,21
SYC,Seychelles,ITA,Italy,2009,30,2,28
SYC,Seychelles,ITA,Italy,2010,15,6,9
SYC,Seychelles,ITA,Italy,2011,14,1,13
SYC,Seychelles,ITA,Italy,2012,5,1,4
SYC,Seychelles,ITA,Italy,2013,7,12,-5
SYC,Seychelles,ITA,Italy,2014,13,4,9
SYC,Seychelles,ITA,Italy,2015,8,1,7
SYC,Seychelles,ITA,Italy,2016,12,0,12
SYC,Seychelles,ITA,Italy,2017,6,1,5
SYC,Seychelles,JPN,Japan,2008,16,17,-1
SYC,Seychelles,JPN,Japan,2009,16,16,0
SYC,Seychelles,JPN,Japan,2010,15,14,1
SYC,Seychelles,JPN,Japan,2011,19,17,2
SYC,Seychelles,JPN,Japan,2012,21,21,0
SYC,Seychelles,JPN,Japan,2013,25,25,0
SYC,Seychelles,JPN,Japan,2014,14,14,0
SYC,Seychelles,JPN,Japan,2015,18,18,0
SYC,Seychelles,JPN,Japan,2016,15,14,1
SYC,Seychelles,JPN,Japan,2017,11,9,2
SYC,Seychelles,KOR,Korea,2008,0,0,0
SYC,Seychelles,KOR,Korea,2009,1,1,0
SYC,Seychelles,KOR,Korea,2010,0,0,0
SYC,Seychelles,KOR,Korea,2011,0,0,0
SYC,Seychelles,KOR,Korea,2012,0,0,0
SYC,Seychelles,KOR,Korea,2013,1,3,-2
SYC,Seychelles,KOR,Korea,2014,0,0,0
SYC,Seychelles,KOR,Korea,2015,0,0,0
SYC,Seychelles,KOR,Korea,2016,0,0,0
SYC,Seychelles,KOR,Korea,2017,0,0,0
SYC,Seychelles,LUX,Luxembourg,2008,0,0,0
SYC,Seychelles,LUX,Luxembourg,2009,0,0,0
SYC,Seychelles,LUX,Luxembourg,2010,0,0,0
SYC,Seychelles,LUX,Luxembourg,2011,0,0,0
SYC,Seychelles,LUX,Luxembourg,2012,0,0,0
SYC,Seychelles,LUX,Luxembourg,2013,0,0,0
SYC,Seychelles,LUX,Luxembourg,2014,0,0,0
SYC,Seychelles,LUX,Luxembourg,2015,0,0,0
SYC,Seychelles,LUX,Luxembourg,2016,0,0,0
SYC,Seychelles,LUX,Luxembourg,2017,1,0,1
SYC,Seychelles,MEX,Mexico,2012,0,0,0
SYC,Seychelles,MEX,Mexico,2013,0,0,0
SYC,Seychelles,MEX,Mexico,2014,0,0,0
SYC,Seychelles,NLD,Netherlands,2008,2,1,1
SYC,Seychelles,NLD,Netherlands,2010,3,0,3
SYC,Seychelles,NLD,Netherlands,2012,3,1,2
SYC,Seychelles,NLD,Netherlands,2013,0,0,0
SYC,Seychelles,NLD,Netherlands,2015,3,0,3
SYC,Seychelles,NLD,Netherlands,2016,0,2,-2
SYC,Seychelles,NLD,Netherlands,2017,3,0,3
SYC,Seychelles,NZL,New Zealand,2008,12,2,10
SYC,Seychelles,NZL,New Zealand,2009,16,7,9
SYC,Seychelles,NZL,New Zealand,2010,4,1,3
SYC,Seychelles,NZL,New Zealand,2011,1,2,-1
SYC,Seychelles,NZL,New Zealand,2012,4,1,3
SYC,Seychelles,NZL,New Zealand,2013,3,2,1
SYC,Seychelles,NZL,New Zealand,2014,2,3,-1
SYC,Seychelles,NZL,New Zealand,2015,2,3,-1
SYC,Seychelles,NZL,New Zealand,2016,3,4,-1
SYC,Seychelles,NZL,New Zealand,2017,1,0,1
SYC,Seychelles,NOR,Norway,2008,0,0,0
SYC,Seychelles,NOR,Norway,2009,0,1,-1
SYC,Seychelles,NOR,Norway,2010,1,5,-4
SYC,Seychelles,NOR,Norway,2011,1,1,0
SYC,Seychelles,NOR,Norway,2012,0,0,0
SYC,Seychelles,NOR,Norway,2013,0,0,0
SYC,Seychelles,NOR,Norway,2014,0,0,0
SYC,Seychelles,NOR,Norway,2015,0,1,-1
SYC,Seychelles,NOR,Norway,2016,1,1,0
SYC,Seychelles,NOR,Norway,2017,2,0,2
SYC,Seychelles,POL,Poland,2009,0,0,0
SYC,Seychelles,POL,Poland,2010,0,0,0
SYC,Seychelles,POL,Poland,2011,0,0,0
SYC,Seychelles,POL,Poland,2012,1,0,1
SYC,Seychelles,POL,Poland,2013,1,0,1
SYC,Seychelles,POL,Poland,2014,0,0,0
SYC,Seychelles,POL,Poland,2015,2,0,2
SYC,Seychelles,POL,Poland,2016,1,0,1
SYC,Seychelles,POL,Poland,2017,1,0,1
SYC,Seychelles,SVK,Slovak Republic,2008,0,0,0
SYC,Seychelles,SVK,Slovak Republic,2009,1,2,-1
SYC,Seychelles,ESP,Spain,2008,2,1,1
SYC,Seychelles,ESP,Spain,2009,3,1,2
SYC,Seychelles,ESP,Spain,2010,3,0,3
SYC,Seychelles,ESP,Spain,2011,2,6,-4
SYC,Seychelles,ESP,Spain,2012,3,1,2
SYC,Seychelles,ESP,Spain,2013,3,0,3
SYC,Seychelles,ESP,Spain,2014,0,1,-1
SYC,Seychelles,ESP,Spain,2015,3,0,3
SYC,Seychelles,ESP,Spain,2016,4,0,4
SYC,Seychelles,ESP,Spain,2017,6,1,5
SYC,Seychelles,SWE,Sweden,2008,0,2,-2
SYC,Seychelles,SWE,Sweden,2009,0,2,-2
SYC,Seychelles,SWE,Sweden,2010,5,0,5
SYC,Seychelles,SWE,Sweden,2011,4,0,4
SYC,Seychelles,SWE,Sweden,2012,1,0,1
SYC,Seychelles,SWE,Sweden,2013,2,1,1
SYC,Seychelles,SWE,Sweden,2014,3,0,3
SYC,Seychelles,SWE,Sweden,2015,0,0,0
SYC,Seychelles,SWE,Sweden,2016,1,0,1
SYC,Seychelles,SWE,Sweden,2017,3,0,3
SYC,Seychelles,CHE,Switzerland,2010,3,6,-3
SYC,Seychelles,CHE,Switzerland,2011,6,1,5
SYC,Seychelles,CHE,Switzerland,2012,1,3,-2
SYC,Seychelles,CHE,Switzerland,2013,2,0,2
SYC,Seychelles,CHE,Switzerland,2014,7,3,4
SYC,Seychelles,CHE,Switzerland,2015,5,3,2
SYC,Seychelles,CHE,Switzerland,2016,2,2,0
SYC,Seychelles,CHE,Switzerland,2017,5,3,2
SYC,Seychelles,USA,United States,2008,16,0,16
SYC,Seychelles,USA,United States,2009,10,0,10
SYC,Seychelles,USA,United States,2010,8,0,8
SYC,Seychelles,USA,United States,2011,15,0,15
SYC,Seychelles,USA,United States,2012,7,0,7
SYC,Seychelles,USA,United States,2013,6,0,6
SYC,Seychelles,USA,United States,2014,7,0,7
SYC,Seychelles,USA,United States,2015,11,0,11
SYC,Seychelles,USA,United States,2016,16,0,16
SYC,Seychelles,USA,United States,2017,10,0,10
SYC,Seychelles,CHL,Chile,2008,0,0,0
SYC,Seychelles,CHL,Chile,2009,0,0,0
SYC,Seychelles,CHL,Chile,2010,0,0,0
SYC,Seychelles,CHL,Chile,2011,0,0,0
SYC,Seychelles,CHL,Chile,2012,0,0,0
SYC,Seychelles,CHL,Chile,2013,0,0,0
SYC,Seychelles,CHL,Chile,2014,0,0,0
SYC,Seychelles,CHL,Chile,2015,0,0,0
SYC,Seychelles,CHL,Chile,2016,0,0,0
SYC,Seychelles,EST,Estonia,2008,0,0,0
SYC,Seychelles,EST,Estonia,2009,0,0,0
SYC,Seychelles,EST,Estonia,2010,0,0,0
SYC,Seychelles,EST,Estonia,2011,0,0,0
SYC,Seychelles,EST,Estonia,2012,0,0,0
SYC,Seychelles,EST,Estonia,2013,0,0,0
SYC,Seychelles,EST,Estonia,2014,0,0,0
SYC,Seychelles,EST,Estonia,2015,0,0,0
SYC,Seychelles,EST,Estonia,2016,0,0,0
SYC,Seychelles,EST,Estonia,2017,0,0,0
SLE,Sierra Leone,AUS,Australia,2008,290,22,268
SLE,Sierra Leone,AUS,Australia,2009,212,0,212
SLE,Sierra Leone,AUS,Australia,2010,463,17,446
SLE,Sierra Leone,AUS,Australia,2011,153,14,139
SLE,Sierra Leone,AUS,Australia,2012,144,21,123
SLE,Sierra Leone,AUS,Australia,2013,95,17,78
SLE,Sierra Leone,AUS,Australia,2014,99,23,76
SLE,Sierra Leone,AUS,Australia,2015,48,0,48
SLE,Sierra Leone,AUS,Australia,2016,34,0,34
SLE,Sierra Leone,AUS,Australia,2017,100,0,100
SLE,Sierra Leone,AUT,Austria,2008,16,43,-27
SLE,Sierra Leone,AUT,Austria,2009,30,34,-4
SLE,Sierra Leone,AUT,Austria,2010,28,48,-20
SLE,Sierra Leone,AUT,Austria,2011,36,27,9
SLE,Sierra Leone,AUT,Austria,2012,44,31,13
SLE,Sierra Leone,AUT,Austria,2013,36,30,6
SLE,Sierra Leone,AUT,Austria,2014,30,19,11
SLE,Sierra Leone,AUT,Austria,2015,35,20,15
SLE,Sierra Leone,AUT,Austria,2016,36,36,0
SLE,Sierra Leone,AUT,Austria,2017,33,26,7
SLE,Sierra Leone,BEL,Belgium,2008,42,0,42
SLE,Sierra Leone,BEL,Belgium,2009,52,0,52
SLE,Sierra Leone,BEL,Belgium,2010,53,6,47
SLE,Sierra Leone,BEL,Belgium,2012,163,52,111
SLE,Sierra Leone,BEL,Belgium,2013,124,66,58
SLE,Sierra Leone,BEL,Belgium,2014,119,61,58
SLE,Sierra Leone,BEL,Belgium,2015,93,69,24
SLE,Sierra Leone,BEL,Belgium,2016,82,20,62
SLE,Sierra Leone,BEL,Belgium,2017,96,21,75
SLE,Sierra Leone,CAN,Canada,2008,103,0,103
SLE,Sierra Leone,CAN,Canada,2009,70,0,70
SLE,Sierra Leone,CAN,Canada,2010,63,0,63
SLE,Sierra Leone,CAN,Canada,2011,96,0,96
SLE,Sierra Leone,CAN,Canada,2012,72,0,72
SLE,Sierra Leone,CAN,Canada,2013,63,0,63
SLE,Sierra Leone,CAN,Canada,2014,60,0,60
SLE,Sierra Leone,CAN,Canada,2015,94,0,94
SLE,Sierra Leone,CAN,Canada,2016,90,0,90
SLE,Sierra Leone,CAN,Canada,2017,40,0,40
SLE,Sierra Leone,CZE,Czech Republic,2008,3,0,3
SLE,Sierra Leone,CZE,Czech Republic,2009,5,0,5
SLE,Sierra Leone,CZE,Czech Republic,2012,1,1,0
SLE,Sierra Leone,CZE,Czech Republic,2014,2,1,1
SLE,Sierra Leone,CZE,Czech Republic,2015,3,0,3
SLE,Sierra Leone,DNK,Denmark,2008,8,0,8
SLE,Sierra Leone,DNK,Denmark,2009,8,2,6
SLE,Sierra Leone,DNK,Denmark,2010,10,3,7
SLE,Sierra Leone,DNK,Denmark,2011,5,0,5
SLE,Sierra Leone,DNK,Denmark,2012,6,7,-1
SLE,Sierra Leone,DNK,Denmark,2013,4,3,1
SLE,Sierra Leone,DNK,Denmark,2014,6,3,3
SLE,Sierra Leone,DNK,Denmark,2015,2,2,0
SLE,Sierra Leone,DNK,Denmark,2016,3,3,0
SLE,Sierra Leone,DNK,Denmark,2017,2,1,1
SLE,Sierra Leone,FIN,Finland,2008,14,2,12
SLE,Sierra Leone,FIN,Finland,2009,6,2,4
SLE,Sierra Leone,FIN,Finland,2010,5,0,5
SLE,Sierra Leone,FIN,Finland,2011,5,1,4
SLE,Sierra Leone,FIN,Finland,2012,8,1,7
SLE,Sierra Leone,FIN,Finland,2013,11,0,11
SLE,Sierra Leone,FIN,Finland,2014,9,1,8
SLE,Sierra Leone,FIN,Finland,2015,2,0,2
SLE,Sierra Leone,FIN,Finland,2016,4,0,4
SLE,Sierra Leone,FIN,Finland,2017,5,1,4
SLE,Sierra Leone,FRA,France,2008,91,0,91
SLE,Sierra Leone,FRA,France,2009,83,0,83
SLE,Sierra Leone,FRA,France,2010,88,0,88
SLE,Sierra Leone,FRA,France,2011,77,0,77
SLE,Sierra Leone,FRA,France,2012,69,0,69
SLE,Sierra Leone,FRA,France,2013,90,0,90
SLE,Sierra Leone,FRA,France,2014,84,0,84
SLE,Sierra Leone,FRA,France,2015,91,0,91
SLE,Sierra Leone,FRA,France,2016,91,0,91
SLE,Sierra Leone,FRA,France,2017,84,0,84
SLE,Sierra Leone,DEU,Germany,2008,257,336,-79
SLE,Sierra Leone,DEU,Germany,2009,231,327,-96
SLE,Sierra Leone,DEU,Germany,2010,219,203,16
SLE,Sierra Leone,DEU,Germany,2011,201,183,18
SLE,Sierra Leone,DEU,Germany,2012,198,135,63
SLE,Sierra Leone,DEU,Germany,2013,278,113,165
SLE,Sierra Leone,DEU,Germany,2014,313,136,177
SLE,Sierra Leone,DEU,Germany,2015,551,129,422
SLE,Sierra Leone,DEU,Germany,2016,906,182,724
SLE,Sierra Leone,DEU,Germany,2017,939,308,631
SLE,Sierra Leone,HUN,Hungary,2008,1,0,1
SLE,Sierra Leone,HUN,Hungary,2009,2,0,2
SLE,Sierra Leone,HUN,Hungary,2010,3,0,3
SLE,Sierra Leone,HUN,Hungary,2011,0,0,0
SLE,Sierra Leone,HUN,Hungary,2012,0,0,0
SLE,Sierra Leone,HUN,Hungary,2013,0,0,0
SLE,Sierra Leone,HUN,Hungary,2014,1,0,1
SLE,Sierra Leone,HUN,Hungary,2015,0,0,0
SLE,Sierra Leone,HUN,Hungary,2016,2,0,2
SLE,Sierra Leone,HUN,Hungary,2017,1,0,1
SLE,Sierra Leone,ISL,Iceland,2008,0,0,0
SLE,Sierra Leone,ISL,Iceland,2009,2,0,2
SLE,Sierra Leone,ISL,Iceland,2010,1,1,0
SLE,Sierra Leone,ISL,Iceland,2011,1,0,1
SLE,Sierra Leone,ISL,Iceland,2012,1,0,1
SLE,Sierra Leone,ISL,Iceland,2013,0,1,-1
SLE,Sierra Leone,ISL,Iceland,2014,1,0,1
SLE,Sierra Leone,ISL,Iceland,2015,0,0,0
SLE,Sierra Leone,ISL,Iceland,2016,0,0,0
SLE,Sierra Leone,ISL,Iceland,2017,1,0,1
SLE,Sierra Leone,ITA,Italy,2008,84,3,81
SLE,Sierra Leone,ITA,Italy,2009,78,4,74
SLE,Sierra Leone,ITA,Italy,2010,106,4,102
SLE,Sierra Leone,ITA,Italy,2011,68,2,66
SLE,Sierra Leone,ITA,Italy,2012,114,5,109
SLE,Sierra Leone,ITA,Italy,2013,68,6,62
SLE,Sierra Leone,ITA,Italy,2014,68,1,67
SLE,Sierra Leone,ITA,Italy,2015,122,6,116
SLE,Sierra Leone,ITA,Italy,2016,207,0,207
SLE,Sierra Leone,ITA,Italy,2017,690,5,685
SLE,Sierra Leone,JPN,Japan,2008,42,41,1
SLE,Sierra Leone,JPN,Japan,2009,34,32,2
SLE,Sierra Leone,JPN,Japan,2010,30,22,8
SLE,Sierra Leone,JPN,Japan,2011,35,36,-1
SLE,Sierra Leone,JPN,Japan,2012,53,51,2
SLE,Sierra Leone,JPN,Japan,2013,68,66,2
SLE,Sierra Leone,JPN,Japan,2014,23,27,-4
SLE,Sierra Leone,JPN,Japan,2015,21,17,4
SLE,Sierra Leone,JPN,Japan,2016,61,57,4
SLE,Sierra Leone,JPN,Japan,2017,78,74,4
SLE,Sierra Leone,KOR,Korea,2008,0,1,-1
SLE,Sierra Leone,KOR,Korea,2009,3,1,2
SLE,Sierra Leone,KOR,Korea,2010,1,1,0
SLE,Sierra Leone,KOR,Korea,2011,5,2,3
SLE,Sierra Leone,KOR,Korea,2012,2,2,0
SLE,Sierra Leone,KOR,Korea,2013,4,1,3
SLE,Sierra Leone,KOR,Korea,2014,3,6,-3
SLE,Sierra Leone,KOR,Korea,2015,16,2,14
SLE,Sierra Leone,KOR,Korea,2016,3,9,-6
SLE,Sierra Leone,KOR,Korea,2017,6,4,2
SLE,Sierra Leone,LUX,Luxembourg,2008,3,5,-2
SLE,Sierra Leone,LUX,Luxembourg,2009,2,1,1
SLE,Sierra Leone,LUX,Luxembourg,2010,1,0,1
SLE,Sierra Leone,LUX,Luxembourg,2011,1,0,1
SLE,Sierra Leone,LUX,Luxembourg,2012,0,1,-1
SLE,Sierra Leone,LUX,Luxembourg,2013,1,0,1
SLE,Sierra Leone,LUX,Luxembourg,2014,1,1,0
SLE,Sierra Leone,LUX,Luxembourg,2015,1,1,0
SLE,Sierra Leone,LUX,Luxembourg,2016,4,2,2
SLE,Sierra Leone,LUX,Luxembourg,2017,1,3,-2
SLE,Sierra Leone,MEX,Mexico,2012,0,0,0
SLE,Sierra Leone,MEX,Mexico,2013,0,0,0
SLE,Sierra Leone,MEX,Mexico,2014,0,0,0
SLE,Sierra Leone,MEX,Mexico,2015,1,0,1
SLE,Sierra Leone,MEX,Mexico,2017,3,0,3
SLE,Sierra Leone,NLD,Netherlands,2008,67,2,65
SLE,Sierra Leone,NLD,Netherlands,2009,82,9,73
SLE,Sierra Leone,NLD,Netherlands,2010,67,12,55
SLE,Sierra Leone,NLD,Netherlands,2011,29,15,14
SLE,Sierra Leone,NLD,Netherlands,2012,51,9,42
SLE,Sierra Leone,NLD,Netherlands,2013,59,14,45
SLE,Sierra Leone,NLD,Netherlands,2014,92,9,83
SLE,Sierra Leone,NLD,Netherlands,2015,72,2,70
SLE,Sierra Leone,NLD,Netherlands,2016,77,7,70
SLE,Sierra Leone,NLD,Netherlands,2017,92,11,81
SLE,Sierra Leone,NZL,New Zealand,2008,3,1,2
SLE,Sierra Leone,NZL,New Zealand,2010,1,5,-4
SLE,Sierra Leone,NZL,New Zealand,2013,1,0,1
SLE,Sierra Leone,NZL,New Zealand,2016,3,0,3
SLE,Sierra Leone,NOR,Norway,2008,24,6,18
SLE,Sierra Leone,NOR,Norway,2009,12,5,7
SLE,Sierra Leone,NOR,Norway,2010,12,42,-30
SLE,Sierra Leone,NOR,Norway,2011,18,7,11
SLE,Sierra Leone,NOR,Norway,2012,19,5,14
SLE,Sierra Leone,NOR,Norway,2013,13,3,10
SLE,Sierra Leone,NOR,Norway,2014,22,6,16
SLE,Sierra Leone,NOR,Norway,2015,7,9,-2
SLE,Sierra Leone,NOR,Norway,2016,8,5,3
SLE,Sierra Leone,NOR,Norway,2017,6,3,3
SLE,Sierra Leone,POL,Poland,2009,8,0,8
SLE,Sierra Leone,POL,Poland,2010,8,0,8
SLE,Sierra Leone,POL,Poland,2011,9,0,9
SLE,Sierra Leone,POL,Poland,2012,10,0,10
SLE,Sierra Leone,POL,Poland,2013,4,0,4
SLE,Sierra Leone,POL,Poland,2014,5,0,5
SLE,Sierra Leone,POL,Poland,2015,3,0,3
SLE,Sierra Leone,POL,Poland,2016,2,0,2
SLE,Sierra Leone,POL,Poland,2017,1,0,1
SLE,Sierra Leone,SVK,Slovak Republic,2008,0,0,0
SLE,Sierra Leone,ESP,Spain,2008,75,53,22
SLE,Sierra Leone,ESP,Spain,2009,48,59,-11
SLE,Sierra Leone,ESP,Spain,2010,43,57,-14
SLE,Sierra Leone,ESP,Spain,2011,35,52,-17
SLE,Sierra Leone,ESP,Spain,2012,41,27,14
SLE,Sierra Leone,ESP,Spain,2013,42,49,-7
SLE,Sierra Leone,ESP,Spain,2014,28,21,7
SLE,Sierra Leone,ESP,Spain,2015,38,11,27
SLE,Sierra Leone,ESP,Spain,2016,34,14,20
SLE,Sierra Leone,ESP,Spain,2017,47,40,7
SLE,Sierra Leone,SWE,Sweden,2008,47,7,40
SLE,Sierra Leone,SWE,Sweden,2009,33,4,29
SLE,Sierra Leone,SWE,Sweden,2010,44,9,35
SLE,Sierra Leone,SWE,Sweden,2011,39,7,32
SLE,Sierra Leone,SWE,Sweden,2012,47,4,43
SLE,Sierra Leone,SWE,Sweden,2013,46,5,41
SLE,Sierra Leone,SWE,Sweden,2014,42,5,37
SLE,Sierra Leone,SWE,Sweden,2015,43,8,35
SLE,Sierra Leone,SWE,Sweden,2016,44,5,39
SLE,Sierra Leone,SWE,Sweden,2017,38,3,35
SLE,Sierra Leone,CHE,Switzerland,2010,17,2,15
SLE,Sierra Leone,CHE,Switzerland,2011,8,5,3
SLE,Sierra Leone,CHE,Switzerland,2012,10,3,7
SLE,Sierra Leone,CHE,Switzerland,2013,6,6,0
SLE,Sierra Leone,CHE,Switzerland,2014,5,0,5
SLE,Sierra Leone,CHE,Switzerland,2015,12,2,10
SLE,Sierra Leone,CHE,Switzerland,2016,1,1,0
SLE,Sierra Leone,CHE,Switzerland,2017,12,1,11
SLE,Sierra Leone,TUR,Turkey,2010,5,0,5
SLE,Sierra Leone,GBR,United Kingdom,2012,1000,0,1000
SLE,Sierra Leone,USA,United States,2008,2795,0,2795
SLE,Sierra Leone,USA,United States,2009,2687,0,2687
SLE,Sierra Leone,USA,United States,2010,2011,0,2011
SLE,Sierra Leone,USA,United States,2011,1985,0,1985
SLE,Sierra Leone,USA,United States,2012,1688,0,1688
SLE,Sierra Leone,USA,United States,2013,1651,0,1651
SLE,Sierra Leone,USA,United States,2014,1740,0,1740
SLE,Sierra Leone,USA,United States,2015,1599,0,1599
SLE,Sierra Leone,USA,United States,2016,1535,0,1535
SLE,Sierra Leone,USA,United States,2017,2058,0,2058
SLE,Sierra Leone,CHL,Chile,2008,0,0,0
SLE,Sierra Leone,CHL,Chile,2009,0,0,0
SLE,Sierra Leone,CHL,Chile,2010,0,0,0
SLE,Sierra Leone,CHL,Chile,2011,0,0,0
SLE,Sierra Leone,CHL,Chile,2012,0,0,0
SLE,Sierra Leone,CHL,Chile,2013,0,0,0
SLE,Sierra Leone,CHL,Chile,2014,0,0,0
SLE,Sierra Leone,CHL,Chile,2015,0,0,0
SLE,Sierra Leone,CHL,Chile,2016,0,0,0
SLE,Sierra Leone,EST,Estonia,2008,0,0,0
SLE,Sierra Leone,EST,Estonia,2009,0,0,0
SLE,Sierra Leone,EST,Estonia,2010,0,0,0
SLE,Sierra Leone,EST,Estonia,2011,0,0,0
SLE,Sierra Leone,EST,Estonia,2012,0,0,0
SLE,Sierra Leone,EST,Estonia,2013,1,0,1
SLE,Sierra Leone,EST,Estonia,2014,0,0,0
SLE,Sierra Leone,EST,Estonia,2015,1,0,1
SLE,Sierra Leone,EST,Estonia,2016,3,0,3
SLE,Sierra Leone,EST,Estonia,2017,3,0,3
SLE,Sierra Leone,SVN,Slovenia,2010,1,0,1
SRB,Serbia,AUS,Australia,2008,202,94,108
SRB,Serbia,AUS,Australia,2009,228,107,121
SRB,Serbia,AUS,Australia,2010,275,107,168
SRB,Serbia,AUS,Australia,2011,237,124,113
SRB,Serbia,AUS,Australia,2012,227,113,114
SRB,Serbia,AUS,Australia,2013,244,139,105
SRB,Serbia,AUS,Australia,2014,276,126,150
SRB,Serbia,AUS,Australia,2015,255,100,155
SRB,Serbia,AUS,Australia,2016,234,200,34
SRB,Serbia,AUS,Australia,2017,235,0,235
SRB,Serbia,AUT,Austria,2008,6037,4834,1203
SRB,Serbia,AUT,Austria,2009,4560,4471,89
SRB,Serbia,AUT,Austria,2010,7134,5650,1484
SRB,Serbia,AUT,Austria,2011,6051,5818,233
SRB,Serbia,AUT,Austria,2012,6715,4966,1749
SRB,Serbia,AUT,Austria,2013,7089,5029,2060
SRB,Serbia,AUT,Austria,2014,7416,4873,2543
SRB,Serbia,AUT,Austria,2015,7637,4690,2947
SRB,Serbia,AUT,Austria,2016,7309,4875,2434
SRB,Serbia,AUT,Austria,2017,7221,5096,2125
SRB,Serbia,BEL,Belgium,2008,175,0,175
SRB,Serbia,BEL,Belgium,2009,201,0,201
SRB,Serbia,BEL,Belgium,2010,362,56,306
SRB,Serbia,BEL,Belgium,2011,329,0,329
SRB,Serbia,BEL,Belgium,2012,671,810,-139
SRB,Serbia,BEL,Belgium,2013,453,949,-496
SRB,Serbia,BEL,Belgium,2014,369,715,-346
SRB,Serbia,BEL,Belgium,2015,406,575,-169
SRB,Serbia,BEL,Belgium,2016,323,215,108
SRB,Serbia,BEL,Belgium,2017,395,254,141
SRB,Serbia,CAN,Canada,2008,251,0,251
SRB,Serbia,CAN,Canada,2009,349,0,349
SRB,Serbia,CAN,Canada,2010,243,0,243
SRB,Serbia,CAN,Canada,2011,280,0,280
SRB,Serbia,CAN,Canada,2012,381,0,381
SRB,Serbia,CAN,Canada,2013,295,0,295
SRB,Serbia,CAN,Canada,2014,319,0,319
SRB,Serbia,CAN,Canada,2015,576,0,576
SRB,Serbia,CAN,Canada,2016,475,0,475
SRB,Serbia,CAN,Canada,2017,375,0,375
SRB,Serbia,CZE,Czech Republic,2008,297,8,289
SRB,Serbia,CZE,Czech Republic,2009,184,9,175
SRB,Serbia,CZE,Czech Republic,2010,201,6,195
SRB,Serbia,CZE,Czech Republic,2011,123,9,114
SRB,Serbia,CZE,Czech Republic,2012,179,74,105
SRB,Serbia,CZE,Czech Republic,2013,151,146,5
SRB,Serbia,CZE,Czech Republic,2014,215,140,75
SRB,Serbia,CZE,Czech Republic,2015,232,151,81
SRB,Serbia,CZE,Czech Republic,2016,230,155,75
SRB,Serbia,CZE,Czech Republic,2017,414,113,301
SRB,Serbia,DNK,Denmark,2008,83,9,74
SRB,Serbia,DNK,Denmark,2009,77,13,64
SRB,Serbia,DNK,Denmark,2010,106,24,82
SRB,Serbia,DNK,Denmark,2011,87,29,58
SRB,Serbia,DNK,Denmark,2012,87,42,45
SRB,Serbia,DNK,Denmark,2013,111,39,72
SRB,Serbia,DNK,Denmark,2014,120,51,69
SRB,Serbia,DNK,Denmark,2015,135,75,60
SRB,Serbia,DNK,Denmark,2016,122,60,62
SRB,Serbia,DNK,Denmark,2017,136,73,63
SRB,Serbia,FIN,Finland,2008,219,3,216
SRB,Serbia,FIN,Finland,2009,55,8,47
SRB,Serbia,FIN,Finland,2010,41,4,37
SRB,Serbia,FIN,Finland,2011,32,5,27
SRB,Serbia,FIN,Finland,2012,29,7,22
SRB,Serbia,FIN,Finland,2013,48,6,42
SRB,Serbia,FIN,Finland,2014,48,5,43
SRB,Serbia,FIN,Finland,2015,63,9,54
SRB,Serbia,FIN,Finland,2016,49,6,43
SRB,Serbia,FIN,Finland,2017,44,14,30
SRB,Serbia,FRA,France,2008,1471,0,1471
SRB,Serbia,FRA,France,2009,1261,0,1261
SRB,Serbia,FRA,France,2010,919,0,919
SRB,Serbia,FRA,France,2011,901,0,901
SRB,Serbia,FRA,France,2012,915,0,915
SRB,Serbia,FRA,France,2013,1032,0,1032
SRB,Serbia,FRA,France,2014,991,0,991
SRB,Serbia,FRA,France,2015,945,0,945
SRB,Serbia,FRA,France,2016,1089,0,1089
SRB,Serbia,FRA,France,2017,963,0,963
SRB,Serbia,DEU,Germany,2008,5396,7019,-1623
SRB,Serbia,DEU,Germany,2009,7024,7730,-706
SRB,Serbia,DEU,Germany,2010,16666,10682,5984
SRB,Serbia,DEU,Germany,2011,16524,14721,1803
SRB,Serbia,DEU,Germany,2012,22107,16498,5609
SRB,Serbia,DEU,Germany,2013,27302,19977,7325
SRB,Serbia,DEU,Germany,2014,38440,23278,15162
SRB,Serbia,DEU,Germany,2015,39719,33153,6566
SRB,Serbia,DEU,Germany,2016,22896,32754,-9858
SRB,Serbia,DEU,Germany,2017,24475,18554,5921
SRB,Serbia,HUN,Hungary,2008,4094,165,3929
SRB,Serbia,HUN,Hungary,2009,1190,296,894
SRB,Serbia,HUN,Hungary,2010,985,284,701
SRB,Serbia,HUN,Hungary,2011,845,523,322
SRB,Serbia,HUN,Hungary,2012,637,563,74
SRB,Serbia,HUN,Hungary,2013,522,365,157
SRB,Serbia,HUN,Hungary,2014,462,160,302
SRB,Serbia,HUN,Hungary,2015,583,146,437
SRB,Serbia,HUN,Hungary,2016,578,150,428
SRB,Serbia,HUN,Hungary,2017,1659,684,975
SRB,Serbia,ISL,Iceland,2008,17,16,1
SRB,Serbia,ISL,Iceland,2009,13,20,-7
SRB,Serbia,ISL,Iceland,2010,10,11,-1
SRB,Serbia,ISL,Iceland,2011,15,4,11
SRB,Serbia,ISL,Iceland,2012,9,11,-2
SRB,Serbia,ISL,Iceland,2013,22,17,5
SRB,Serbia,ISL,Iceland,2014,16,19,-3
SRB,Serbia,ISL,Iceland,2015,25,13,12
SRB,Serbia,ISL,Iceland,2016,38,13,25
SRB,Serbia,ISL,Iceland,2017,55,15,40
SRB,Serbia,ITA,Italy,2008,5581,339,5242
SRB,Serbia,ITA,Italy,2009,4778,435,4343
SRB,Serbia,ITA,Italy,2010,5056,515,4541
SRB,Serbia,ITA,Italy,2011,1489,372,1117
SRB,Serbia,ITA,Italy,2012,1289,675,614
SRB,Serbia,ITA,Italy,2013,1028,319,709
SRB,Serbia,ITA,Italy,2014,727,317,410
SRB,Serbia,ITA,Italy,2015,788,308,480
SRB,Serbia,ITA,Italy,2016,784,0,784
SRB,Serbia,ITA,Italy,2017,903,234,669
SRB,Serbia,JPN,Japan,2008,26,23,3
SRB,Serbia,JPN,Japan,2009,102,95,7
SRB,Serbia,JPN,Japan,2010,210,196,14
SRB,Serbia,JPN,Japan,2011,113,102,11
SRB,Serbia,JPN,Japan,2012,96,81,15
SRB,Serbia,JPN,Japan,2013,106,88,18
SRB,Serbia,JPN,Japan,2014,85,72,13
SRB,Serbia,JPN,Japan,2015,84,93,-9
SRB,Serbia,JPN,Japan,2016,119,111,8
SRB,Serbia,JPN,Japan,2017,173,150,23
SRB,Serbia,KOR,Korea,2008,0,0,0
SRB,Serbia,KOR,Korea,2009,22,3,19
SRB,Serbia,KOR,Korea,2010,11,14,-3
SRB,Serbia,KOR,Korea,2011,18,14,4
SRB,Serbia,KOR,Korea,2012,15,13,2
SRB,Serbia,KOR,Korea,2013,21,24,-3
SRB,Serbia,KOR,Korea,2014,20,20,0
SRB,Serbia,KOR,Korea,2015,20,17,3
SRB,Serbia,KOR,Korea,2016,26,33,-7
SRB,Serbia,KOR,Korea,2017,20,31,-11
SRB,Serbia,LUX,Luxembourg,2008,48,30,18
SRB,Serbia,LUX,Luxembourg,2009,28,21,7
SRB,Serbia,LUX,Luxembourg,2010,189,20,169
SRB,Serbia,LUX,Luxembourg,2011,727,74,653
SRB,Serbia,LUX,Luxembourg,2012,231,445,-214
SRB,Serbia,LUX,Luxembourg,2013,131,167,-36
SRB,Serbia,LUX,Luxembourg,2014,126,84,42
SRB,Serbia,LUX,Luxembourg,2015,154,119,35
SRB,Serbia,LUX,Luxembourg,2016,214,60,154
SRB,Serbia,LUX,Luxembourg,2017,182,115,67
SRB,Serbia,MEX,Mexico,2008,3,0,3
SRB,Serbia,MEX,Mexico,2009,11,0,11
SRB,Serbia,MEX,Mexico,2010,8,0,8
SRB,Serbia,MEX,Mexico,2011,5,0,5
SRB,Serbia,MEX,Mexico,2012,5,0,5
SRB,Serbia,MEX,Mexico,2013,17,0,17
SRB,Serbia,MEX,Mexico,2014,18,0,18
SRB,Serbia,MEX,Mexico,2015,19,0,19
SRB,Serbia,MEX,Mexico,2016,13,0,13
SRB,Serbia,MEX,Mexico,2017,12,0,12
SRB,Serbia,NLD,Netherlands,2010,279,71,208
SRB,Serbia,NLD,Netherlands,2011,250,104,146
SRB,Serbia,NLD,Netherlands,2012,261,115,146
SRB,Serbia,NLD,Netherlands,2013,273,136,137
SRB,Serbia,NLD,Netherlands,2014,303,176,127
SRB,Serbia,NLD,Netherlands,2015,315,129,186
SRB,Serbia,NLD,Netherlands,2016,361,139,222
SRB,Serbia,NLD,Netherlands,2017,356,163,193
SRB,Serbia,NZL,New Zealand,2008,5,0,5
SRB,Serbia,NZL,New Zealand,2009,15,8,7
SRB,Serbia,NZL,New Zealand,2010,10,4,6
SRB,Serbia,NZL,New Zealand,2011,19,1,18
SRB,Serbia,NZL,New Zealand,2012,26,4,22
SRB,Serbia,NZL,New Zealand,2013,31,6,25
SRB,Serbia,NZL,New Zealand,2014,40,1,39
SRB,Serbia,NZL,New Zealand,2015,56,6,50
SRB,Serbia,NZL,New Zealand,2016,70,1,69
SRB,Serbia,NZL,New Zealand,2017,92,10,82
SRB,Serbia,NOR,Norway,2008,397,18,379
SRB,Serbia,NOR,Norway,2009,224,32,192
SRB,Serbia,NOR,Norway,2010,212,3,209
SRB,Serbia,NOR,Norway,2011,329,80,249
SRB,Serbia,NOR,Norway,2012,502,67,435
SRB,Serbia,NOR,Norway,2013,574,94,480
SRB,Serbia,NOR,Norway,2014,562,81,481
SRB,Serbia,NOR,Norway,2015,731,92,639
SRB,Serbia,NOR,Norway,2016,751,115,636
SRB,Serbia,NOR,Norway,2017,705,98,607
SRB,Serbia,POL,Poland,2009,126,0,126
SRB,Serbia,POL,Poland,2010,130,0,130
SRB,Serbia,POL,Poland,2011,115,0,115
SRB,Serbia,POL,Poland,2012,122,0,122
SRB,Serbia,POL,Poland,2013,107,0,107
SRB,Serbia,POL,Poland,2014,63,0,63
SRB,Serbia,POL,Poland,2015,265,0,265
SRB,Serbia,POL,Poland,2016,332,0,332
SRB,Serbia,POL,Poland,2017,270,0,270
SRB,Serbia,SVK,Slovak Republic,2008,66,7,59
SRB,Serbia,SVK,Slovak Republic,2009,47,68,-21
SRB,Serbia,SVK,Slovak Republic,2010,31,89,-58
SRB,Serbia,SVK,Slovak Republic,2011,15,44,-29
SRB,Serbia,SVK,Slovak Republic,2012,20,2,18
SRB,Serbia,SVK,Slovak Republic,2013,27,0,27
SRB,Serbia,SVK,Slovak Republic,2014,15,1,14
SRB,Serbia,SVK,Slovak Republic,2015,46,0,46
SRB,Serbia,SVK,Slovak Republic,2016,26,0,26
SRB,Serbia,SVK,Slovak Republic,2017,35,0,35
SRB,Serbia,ESP,Spain,2008,287,230,57
SRB,Serbia,ESP,Spain,2009,233,254,-21
SRB,Serbia,ESP,Spain,2010,342,242,100
SRB,Serbia,ESP,Spain,2011,353,204,149
SRB,Serbia,ESP,Spain,2012,288,215,73
SRB,Serbia,ESP,Spain,2013,269,265,4
SRB,Serbia,ESP,Spain,2014,341,177,164
SRB,Serbia,ESP,Spain,2015,351,152,199
SRB,Serbia,ESP,Spain,2016,427,152,275
SRB,Serbia,ESP,Spain,2017,435,235,200
SRB,Serbia,SWE,Sweden,2008,1791,39,1752
SRB,Serbia,SWE,Sweden,2009,1021,54,967
SRB,Serbia,SWE,Sweden,2010,864,83,781
SRB,Serbia,SWE,Sweden,2011,1028,94,934
SRB,Serbia,SWE,Sweden,2012,1264,84,1180
SRB,Serbia,SWE,Sweden,2013,961,105,856
SRB,Serbia,SWE,Sweden,2014,1696,143,1553
SRB,Serbia,SWE,Sweden,2015,1693,226,1467
SRB,Serbia,SWE,Sweden,2016,1598,157,1441
SRB,Serbia,SWE,Sweden,2017,1961,142,1819
SRB,Serbia,CHE,Switzerland,2008,4937,1123,3814
SRB,Serbia,CHE,Switzerland,2009,2624,1090,1534
SRB,Serbia,CHE,Switzerland,2010,2346,1085,1261
SRB,Serbia,CHE,Switzerland,2011,1967,912,1055
SRB,Serbia,CHE,Switzerland,2012,1658,874,784
SRB,Serbia,CHE,Switzerland,2013,1731,880,851
SRB,Serbia,CHE,Switzerland,2014,1506,843,663
SRB,Serbia,CHE,Switzerland,2015,1506,892,614
SRB,Serbia,CHE,Switzerland,2016,1528,888,640
SRB,Serbia,CHE,Switzerland,2017,1395,883,512
SRB,Serbia,TUR,Turkey,2010,156,0,156
SRB,Serbia,TUR,Turkey,2016,228,245,-17
SRB,Serbia,TUR,Turkey,2017,229,271,-42
SRB,Serbia,USA,United States,2010,20,0,20
SRB,Serbia,USA,United States,2011,244,0,244
SRB,Serbia,USA,United States,2012,704,0,704
SRB,Serbia,USA,United States,2013,866,0,866
SRB,Serbia,USA,United States,2014,1143,0,1143
SRB,Serbia,USA,United States,2015,1278,0,1278
SRB,Serbia,USA,United States,2016,1351,0,1351
SRB,Serbia,USA,United States,2017,1410,0,1410
SRB,Serbia,CHL,Chile,2008,1,0,1
SRB,Serbia,CHL,Chile,2009,7,0,7
SRB,Serbia,CHL,Chile,2010,7,0,7
SRB,Serbia,CHL,Chile,2011,14,0,14
SRB,Serbia,CHL,Chile,2012,13,0,13
SRB,Serbia,CHL,Chile,2013,4,0,4
SRB,Serbia,CHL,Chile,2014,4,0,4
SRB,Serbia,CHL,Chile,2015,13,0,13
SRB,Serbia,CHL,Chile,2016,8,0,8
SRB,Serbia,EST,Estonia,2008,0,0,0
SRB,Serbia,EST,Estonia,2009,3,0,3
SRB,Serbia,EST,Estonia,2010,1,0,1
SRB,Serbia,EST,Estonia,2011,3,0,3
SRB,Serbia,EST,Estonia,2012,2,0,2
SRB,Serbia,EST,Estonia,2013,3,0,3
SRB,Serbia,EST,Estonia,2014,4,0,4
SRB,Serbia,EST,Estonia,2015,8,0,8
SRB,Serbia,EST,Estonia,2016,5,0,5
SRB,Serbia,EST,Estonia,2017,12,0,12
SRB,Serbia,SVN,Slovenia,2008,7436,1393,6043
SRB,Serbia,SVN,Slovenia,2009,2494,2207,287
SRB,Serbia,SVN,Slovenia,2010,1506,1255,251
SRB,Serbia,SVN,Slovenia,2011,1753,188,1565
SRB,Serbia,SVN,Slovenia,2012,1565,167,1398
SRB,Serbia,SVN,Slovenia,2013,1439,61,1378
SRB,Serbia,SVN,Slovenia,2014,1543,110,1433
SRB,Serbia,SVN,Slovenia,2015,2236,207,2029
SRB,Serbia,SVN,Slovenia,2016,2721,256,2465
SRB,Serbia,SVN,Slovenia,2017,3828,338,3490
SGP,Singapore,AUS,Australia,2008,2448,400,2048
SGP,Singapore,AUS,Australia,2009,2102,360,1742
SGP,Singapore,AUS,Australia,2010,1873,377,1496
SGP,Singapore,AUS,Australia,2011,1493,434,1059
SGP,Singapore,AUS,Australia,2012,1786,385,1401
SGP,Singapore,AUS,Australia,2013,2039,421,1618
SGP,Singapore,AUS,Australia,2014,1880,453,1427
SGP,Singapore,AUS,Australia,2015,1931,400,1531
SGP,Singapore,AUS,Australia,2016,1715,400,1315
SGP,Singapore,AUS,Australia,2017,1560,0,1560
SGP,Singapore,AUT,Austria,2008,30,15,15
SGP,Singapore,AUT,Austria,2009,24,30,-6
SGP,Singapore,AUT,Austria,2010,32,30,2
SGP,Singapore,AUT,Austria,2011,49,28,21
SGP,Singapore,AUT,Austria,2012,52,36,16
SGP,Singapore,AUT,Austria,2013,53,46,7
SGP,Singapore,AUT,Austria,2014,57,48,9
SGP,Singapore,AUT,Austria,2015,43,38,5
SGP,Singapore,AUT,Austria,2016,38,45,-7
SGP,Singapore,AUT,Austria,2017,57,44,13
SGP,Singapore,BEL,Belgium,2008,44,0,44
SGP,Singapore,BEL,Belgium,2009,40,0,40
SGP,Singapore,BEL,Belgium,2010,50,40,10
SGP,Singapore,BEL,Belgium,2012,44,26,18
SGP,Singapore,BEL,Belgium,2013,42,37,5
SGP,Singapore,BEL,Belgium,2014,32,44,-12
SGP,Singapore,BEL,Belgium,2015,33,31,2
SGP,Singapore,BEL,Belgium,2016,38,28,10
SGP,Singapore,BEL,Belgium,2017,41,25,16
SGP,Singapore,CAN,Canada,2008,734,0,734
SGP,Singapore,CAN,Canada,2009,366,0,366
SGP,Singapore,CAN,Canada,2010,805,0,805
SGP,Singapore,CAN,Canada,2011,219,0,219
SGP,Singapore,CAN,Canada,2012,145,0,145
SGP,Singapore,CAN,Canada,2013,141,0,141
SGP,Singapore,CAN,Canada,2014,179,0,179
SGP,Singapore,CAN,Canada,2015,255,0,255
SGP,Singapore,CAN,Canada,2016,260,0,260
SGP,Singapore,CAN,Canada,2017,315,0,315
SGP,Singapore,CZE,Czech Republic,2008,11,0,11
SGP,Singapore,CZE,Czech Republic,2009,13,0,13
SGP,Singapore,CZE,Czech Republic,2010,21,0,21
SGP,Singapore,CZE,Czech Republic,2011,6,0,6
SGP,Singapore,CZE,Czech Republic,2012,10,1,9
SGP,Singapore,CZE,Czech Republic,2013,4,6,-2
SGP,Singapore,CZE,Czech Republic,2014,19,4,15
SGP,Singapore,CZE,Czech Republic,2015,29,14,15
SGP,Singapore,CZE,Czech Republic,2016,50,25,25
SGP,Singapore,CZE,Czech Republic,2017,116,49,67
SGP,Singapore,DNK,Denmark,2008,52,48,4
SGP,Singapore,DNK,Denmark,2009,40,95,-55
SGP,Singapore,DNK,Denmark,2010,43,110,-67
SGP,Singapore,DNK,Denmark,2011,52,75,-23
SGP,Singapore,DNK,Denmark,2012,52,123,-71
SGP,Singapore,DNK,Denmark,2013,58,108,-50
SGP,Singapore,DNK,Denmark,2014,29,122,-93
SGP,Singapore,DNK,Denmark,2015,77,142,-65
SGP,Singapore,DNK,Denmark,2016,70,147,-77
SGP,Singapore,DNK,Denmark,2017,52,150,-98
SGP,Singapore,FIN,Finland,2008,23,3,20
SGP,Singapore,FIN,Finland,2009,16,9,7
SGP,Singapore,FIN,Finland,2010,6,2,4
SGP,Singapore,FIN,Finland,2011,16,12,4
SGP,Singapore,FIN,Finland,2012,13,11,2
SGP,Singapore,FIN,Finland,2013,8,5,3
SGP,Singapore,FIN,Finland,2014,16,1,15
SGP,Singapore,FIN,Finland,2015,16,5,11
SGP,Singapore,FIN,Finland,2016,9,7,2
SGP,Singapore,FIN,Finland,2017,11,6,5
SGP,Singapore,FRA,France,2008,102,0,102
SGP,Singapore,FRA,France,2009,113,0,113
SGP,Singapore,FRA,France,2010,108,0,108
SGP,Singapore,FRA,France,2011,106,0,106
SGP,Singapore,FRA,France,2012,102,0,102
SGP,Singapore,FRA,France,2013,98,0,98
SGP,Singapore,FRA,France,2014,84,0,84
SGP,Singapore,FRA,France,2015,113,0,113
SGP,Singapore,FRA,France,2016,108,0,108
SGP,Singapore,FRA,France,2017,120,0,120
SGP,Singapore,DEU,Germany,2008,346,374,-28
SGP,Singapore,DEU,Germany,2009,331,355,-24
SGP,Singapore,DEU,Germany,2010,470,340,130
SGP,Singapore,DEU,Germany,2011,456,374,82
SGP,Singapore,DEU,Germany,2012,464,374,90
SGP,Singapore,DEU,Germany,2013,496,372,124
SGP,Singapore,DEU,Germany,2014,586,407,179
SGP,Singapore,DEU,Germany,2015,604,446,158
SGP,Singapore,DEU,Germany,2016,595,529,66
SGP,Singapore,DEU,Germany,2017,591,462,129
SGP,Singapore,HUN,Hungary,2008,19,0,19
SGP,Singapore,HUN,Hungary,2009,21,1,20
SGP,Singapore,HUN,Hungary,2010,13,3,10
SGP,Singapore,HUN,Hungary,2011,21,1,20
SGP,Singapore,HUN,Hungary,2012,12,0,12
SGP,Singapore,HUN,Hungary,2013,12,8,4
SGP,Singapore,HUN,Hungary,2014,15,1,14
SGP,Singapore,HUN,Hungary,2015,18,3,15
SGP,Singapore,HUN,Hungary,2016,14,2,12
SGP,Singapore,HUN,Hungary,2017,20,0,20
SGP,Singapore,ISL,Iceland,2008,0,1,-1
SGP,Singapore,ISL,Iceland,2009,1,2,-1
SGP,Singapore,ISL,Iceland,2010,0,1,-1
SGP,Singapore,ISL,Iceland,2011,1,0,1
SGP,Singapore,ISL,Iceland,2012,1,2,-1
SGP,Singapore,ISL,Iceland,2013,4,0,4
SGP,Singapore,ISL,Iceland,2014,1,3,-2
SGP,Singapore,ISL,Iceland,2015,2,2,0
SGP,Singapore,ISL,Iceland,2016,2,3,-1
SGP,Singapore,ISL,Iceland,2017,2,1,1
SGP,Singapore,ITA,Italy,2008,19,3,16
SGP,Singapore,ITA,Italy,2009,29,4,25
SGP,Singapore,ITA,Italy,2010,20,4,16
SGP,Singapore,ITA,Italy,2011,17,10,7
SGP,Singapore,ITA,Italy,2012,16,11,5
SGP,Singapore,ITA,Italy,2013,24,7,17
SGP,Singapore,ITA,Italy,2014,20,9,11
SGP,Singapore,ITA,Italy,2015,22,8,14
SGP,Singapore,ITA,Italy,2016,5,0,5
SGP,Singapore,ITA,Italy,2017,21,4,17
SGP,Singapore,JPN,Japan,2008,561,377,184
SGP,Singapore,JPN,Japan,2009,398,368,30
SGP,Singapore,JPN,Japan,2010,486,422,64
SGP,Singapore,JPN,Japan,2011,438,343,95
SGP,Singapore,JPN,Japan,2012,473,357,116
SGP,Singapore,JPN,Japan,2013,500,350,150
SGP,Singapore,JPN,Japan,2014,524,367,157
SGP,Singapore,JPN,Japan,2015,618,412,206
SGP,Singapore,JPN,Japan,2016,700,541,159
SGP,Singapore,JPN,Japan,2017,742,541,201
SGP,Singapore,KOR,Korea,2008,239,212,27
SGP,Singapore,KOR,Korea,2009,227,273,-46
SGP,Singapore,KOR,Korea,2010,377,380,-3
SGP,Singapore,KOR,Korea,2011,448,513,-65
SGP,Singapore,KOR,Korea,2012,630,493,137
SGP,Singapore,KOR,Korea,2013,621,658,-37
SGP,Singapore,KOR,Korea,2014,620,678,-58
SGP,Singapore,KOR,Korea,2015,616,785,-169
SGP,Singapore,KOR,Korea,2016,719,878,-159
SGP,Singapore,KOR,Korea,2017,743,879,-136
SGP,Singapore,LUX,Luxembourg,2008,3,0,3
SGP,Singapore,LUX,Luxembourg,2009,3,5,-2
SGP,Singapore,LUX,Luxembourg,2010,4,1,3
SGP,Singapore,LUX,Luxembourg,2011,4,2,2
SGP,Singapore,LUX,Luxembourg,2012,4,2,2
SGP,Singapore,LUX,Luxembourg,2013,5,5,0
SGP,Singapore,LUX,Luxembourg,2014,18,1,17
SGP,Singapore,LUX,Luxembourg,2015,7,7,0
SGP,Singapore,LUX,Luxembourg,2016,11,3,8
SGP,Singapore,LUX,Luxembourg,2017,17,4,13
SGP,Singapore,MEX,Mexico,2008,1,0,1
SGP,Singapore,MEX,Mexico,2009,1,0,1
SGP,Singapore,MEX,Mexico,2010,3,0,3
SGP,Singapore,MEX,Mexico,2011,1,0,1
SGP,Singapore,MEX,Mexico,2012,4,0,4
SGP,Singapore,MEX,Mexico,2013,8,0,8
SGP,Singapore,MEX,Mexico,2014,1,0,1
SGP,Singapore,MEX,Mexico,2015,2,0,2
SGP,Singapore,MEX,Mexico,2016,2,0,2
SGP,Singapore,MEX,Mexico,2017,1,0,1
SGP,Singapore,NLD,Netherlands,2008,153,104,49
SGP,Singapore,NLD,Netherlands,2009,151,125,26
SGP,Singapore,NLD,Netherlands,2010,197,151,46
SGP,Singapore,NLD,Netherlands,2011,221,177,44
SGP,Singapore,NLD,Netherlands,2012,290,187,103
SGP,Singapore,NLD,Netherlands,2013,264,231,33
SGP,Singapore,NLD,Netherlands,2014,335,265,70
SGP,Singapore,NLD,Netherlands,2015,351,274,77
SGP,Singapore,NLD,Netherlands,2016,428,329,99
SGP,Singapore,NLD,Netherlands,2017,444,354,90
SGP,Singapore,NZL,New Zealand,2008,218,97,121
SGP,Singapore,NZL,New Zealand,2009,186,112,74
SGP,Singapore,NZL,New Zealand,2010,232,123,109
SGP,Singapore,NZL,New Zealand,2011,234,106,128
SGP,Singapore,NZL,New Zealand,2012,288,96,192
SGP,Singapore,NZL,New Zealand,2013,272,96,176
SGP,Singapore,NZL,New Zealand,2014,263,81,182
SGP,Singapore,NZL,New Zealand,2015,355,101,254
SGP,Singapore,NZL,New Zealand,2016,376,89,287
SGP,Singapore,NZL,New Zealand,2017,363,127,236
SGP,Singapore,NOR,Norway,2008,59,22,37
SGP,Singapore,NOR,Norway,2009,58,36,22
SGP,Singapore,NOR,Norway,2010,58,271,-213
SGP,Singapore,NOR,Norway,2011,69,49,20
SGP,Singapore,NOR,Norway,2012,51,35,16
SGP,Singapore,NOR,Norway,2013,60,28,32
SGP,Singapore,NOR,Norway,2014,27,39,-12
SGP,Singapore,NOR,Norway,2015,29,28,1
SGP,Singapore,NOR,Norway,2016,24,30,-6
SGP,Singapore,NOR,Norway,2017,31,24,7
SGP,Singapore,POL,Poland,2009,8,0,8
SGP,Singapore,POL,Poland,2010,9,0,9
SGP,Singapore,POL,Poland,2011,8,0,8
SGP,Singapore,POL,Poland,2012,24,0,24
SGP,Singapore,POL,Poland,2013,25,0,25
SGP,Singapore,POL,Poland,2014,13,0,13
SGP,Singapore,POL,Poland,2015,19,0,19
SGP,Singapore,POL,Poland,2016,6,0,6
SGP,Singapore,POL,Poland,2017,26,0,26
SGP,Singapore,SVK,Slovak Republic,2008,1,0,1
SGP,Singapore,SVK,Slovak Republic,2010,1,0,1
SGP,Singapore,SVK,Slovak Republic,2011,1,0,1
SGP,Singapore,ESP,Spain,2008,26,17,9
SGP,Singapore,ESP,Spain,2009,25,16,9
SGP,Singapore,ESP,Spain,2010,28,24,4
SGP,Singapore,ESP,Spain,2011,32,11,21
SGP,Singapore,ESP,Spain,2012,47,8,39
SGP,Singapore,ESP,Spain,2013,38,26,12
SGP,Singapore,ESP,Spain,2014,36,22,14
SGP,Singapore,ESP,Spain,2015,40,10,30
SGP,Singapore,ESP,Spain,2016,35,7,28
SGP,Singapore,ESP,Spain,2017,60,21,39
SGP,Singapore,SWE,Sweden,2008,107,23,84
SGP,Singapore,SWE,Sweden,2009,66,22,44
SGP,Singapore,SWE,Sweden,2010,59,40,19
SGP,Singapore,SWE,Sweden,2011,21,70,-49
SGP,Singapore,SWE,Sweden,2012,29,122,-93
SGP,Singapore,SWE,Sweden,2013,44,11,33
SGP,Singapore,SWE,Sweden,2014,29,43,-14
SGP,Singapore,SWE,Sweden,2015,23,47,-24
SGP,Singapore,SWE,Sweden,2016,36,19,17
SGP,Singapore,SWE,Sweden,2017,70,18,52
SGP,Singapore,CHE,Switzerland,2010,219,148,71
SGP,Singapore,CHE,Switzerland,2011,204,175,29
SGP,Singapore,CHE,Switzerland,2012,193,160,33
SGP,Singapore,CHE,Switzerland,2013,168,166,2
SGP,Singapore,CHE,Switzerland,2014,155,154,1
SGP,Singapore,CHE,Switzerland,2015,162,141,21
SGP,Singapore,CHE,Switzerland,2016,139,107,32
SGP,Singapore,CHE,Switzerland,2017,159,110,49
SGP,Singapore,TUR,Turkey,2010,9,0,9
SGP,Singapore,GBR,United Kingdom,2011,4000,1000,3000
SGP,Singapore,GBR,United Kingdom,2012,4000,1000,3000
SGP,Singapore,GBR,United Kingdom,2013,2000,1000,1000
SGP,Singapore,GBR,United Kingdom,2014,3000,1000,2000
SGP,Singapore,GBR,United Kingdom,2015,1000,0,1000
SGP,Singapore,GBR,United Kingdom,2016,1000,0,1000
SGP,Singapore,GBR,United Kingdom,2017,6000,0,6000
SGP,Singapore,USA,United States,2008,922,0,922
SGP,Singapore,USA,United States,2009,832,0,832
SGP,Singapore,USA,United States,2010,774,0,774
SGP,Singapore,USA,United States,2011,690,0,690
SGP,Singapore,USA,United States,2012,712,0,712
SGP,Singapore,USA,United States,2013,835,0,835
SGP,Singapore,USA,United States,2014,779,0,779
SGP,Singapore,USA,United States,2015,781,0,781
SGP,Singapore,USA,United States,2016,812,0,812
SGP,Singapore,USA,United States,2017,818,0,818
SGP,Singapore,CHL,Chile,2008,1,0,1
SGP,Singapore,CHL,Chile,2009,5,0,5
SGP,Singapore,CHL,Chile,2010,6,0,6
SGP,Singapore,CHL,Chile,2011,4,0,4
SGP,Singapore,CHL,Chile,2012,4,0,4
SGP,Singapore,CHL,Chile,2013,4,0,4
SGP,Singapore,CHL,Chile,2014,1,0,1
SGP,Singapore,CHL,Chile,2015,3,0,3
SGP,Singapore,CHL,Chile,2016,4,0,4
SGP,Singapore,EST,Estonia,2008,0,0,0
SGP,Singapore,EST,Estonia,2009,0,0,0
SGP,Singapore,EST,Estonia,2010,0,0,0
SGP,Singapore,EST,Estonia,2011,1,0,1
SGP,Singapore,EST,Estonia,2012,1,0,1
SGP,Singapore,EST,Estonia,2013,1,0,1
SGP,Singapore,EST,Estonia,2014,0,0,0
SGP,Singapore,EST,Estonia,2015,4,0,4
SGP,Singapore,EST,Estonia,2016,1,0,1
SGP,Singapore,EST,Estonia,2017,1,0,1
SGP,Singapore,SVN,Slovenia,2013,5,0,5
SGP,Singapore,SVN,Slovenia,2014,1,0,1
SGP,Singapore,SVN,Slovenia,2017,1,0,1
SVK,Slovak Republic,AUS,Australia,2008,150,2,148
SVK,Slovak Republic,AUS,Australia,2009,142,7,135
SVK,Slovak Republic,AUS,Australia,2010,138,3,135
SVK,Slovak Republic,AUS,Australia,2011,147,4,143
SVK,Slovak Republic,AUS,Australia,2012,133,3,130
SVK,Slovak Republic,AUS,Australia,2013,164,4,160
SVK,Slovak Republic,AUS,Australia,2014,157,3,154
SVK,Slovak Republic,AUS,Australia,2015,186,5,181
SVK,Slovak Republic,AUS,Australia,2016,172,3,169
SVK,Slovak Republic,AUS,Australia,2017,157,6,151
SVK,Slovak Republic,AUT,Austria,2008,4926,244,4682
SVK,Slovak Republic,AUT,Austria,2009,4011,226,3785
SVK,Slovak Republic,AUT,Austria,2010,3997,160,3837
SVK,Slovak Republic,AUT,Austria,2011,5314,105,5209
SVK,Slovak Republic,AUT,Austria,2012,5957,63,5894
SVK,Slovak Republic,AUT,Austria,2013,6234,29,6205
SVK,Slovak Republic,AUT,Austria,2014,6467,44,6423
SVK,Slovak Republic,AUT,Austria,2015,6080,91,5989
SVK,Slovak Republic,AUT,Austria,2016,5575,61,5514
SVK,Slovak Republic,AUT,Austria,2017,5054,51,5003
SVK,Slovak Republic,BEL,Belgium,2008,549,53,496
SVK,Slovak Republic,BEL,Belgium,2009,599,62,537
SVK,Slovak Republic,BEL,Belgium,2010,735,51,684
SVK,Slovak Republic,BEL,Belgium,2011,746,53,693
SVK,Slovak Republic,BEL,Belgium,2012,682,28,654
SVK,Slovak Republic,BEL,Belgium,2013,638,41,597
SVK,Slovak Republic,BEL,Belgium,2014,542,21,521
SVK,Slovak Republic,BEL,Belgium,2015,523,26,497
SVK,Slovak Republic,BEL,Belgium,2016,430,21,409
SVK,Slovak Republic,BEL,Belgium,2017,542,11,531
SVK,Slovak Republic,CAN,Canada,2008,125,5,120
SVK,Slovak Republic,CAN,Canada,2009,128,2,126
SVK,Slovak Republic,CAN,Canada,2010,135,1,134
SVK,Slovak Republic,CAN,Canada,2011,134,4,130
SVK,Slovak Republic,CAN,Canada,2012,136,3,133
SVK,Slovak Republic,CAN,Canada,2013,105,2,103
SVK,Slovak Republic,CAN,Canada,2014,161,4,157
SVK,Slovak Republic,CAN,Canada,2015,208,1,207
SVK,Slovak Republic,CAN,Canada,2016,270,3,267
SVK,Slovak Republic,CAN,Canada,2017,260,5,255
SVK,Slovak Republic,CZE,Czech Republic,2008,7592,1037,6555
SVK,Slovak Republic,CZE,Czech Republic,2009,5609,1037,4572
SVK,Slovak Republic,CZE,Czech Republic,2010,5086,786,4300
SVK,Slovak Republic,CZE,Czech Republic,2011,4368,600,3768
SVK,Slovak Republic,CZE,Czech Republic,2012,4825,462,4363
SVK,Slovak Republic,CZE,Czech Republic,2013,6475,402,6073
SVK,Slovak Republic,CZE,Czech Republic,2014,6903,414,6489
SVK,Slovak Republic,CZE,Czech Republic,2015,6682,589,6093
SVK,Slovak Republic,CZE,Czech Republic,2016,6706,545,6161
SVK,Slovak Republic,CZE,Czech Republic,2017,6328,475,5853
SVK,Slovak Republic,DNK,Denmark,2008,316,29,287
SVK,Slovak Republic,DNK,Denmark,2009,172,39,133
SVK,Slovak Republic,DNK,Denmark,2010,188,37,151
SVK,Slovak Republic,DNK,Denmark,2011,233,14,219
SVK,Slovak Republic,DNK,Denmark,2012,334,6,328
SVK,Slovak Republic,DNK,Denmark,2013,346,7,339
SVK,Slovak Republic,DNK,Denmark,2014,499,9,490
SVK,Slovak Republic,DNK,Denmark,2015,650,7,643
SVK,Slovak Republic,DNK,Denmark,2016,557,5,552
SVK,Slovak Republic,DNK,Denmark,2017,557,5,552
SVK,Slovak Republic,FIN,Finland,2008,71,16,55
SVK,Slovak Republic,FIN,Finland,2009,40,11,29
SVK,Slovak Republic,FIN,Finland,2010,19,22,-3
SVK,Slovak Republic,FIN,Finland,2011,37,10,27
SVK,Slovak Republic,FIN,Finland,2012,44,10,34
SVK,Slovak Republic,FIN,Finland,2013,41,8,33
SVK,Slovak Republic,FIN,Finland,2014,51,3,48
SVK,Slovak Republic,FIN,Finland,2015,57,12,45
SVK,Slovak Republic,FIN,Finland,2016,91,10,81
SVK,Slovak Republic,FIN,Finland,2017,54,7,47
SVK,Slovak Republic,FRA,France,2008,0,154,-154
SVK,Slovak Republic,FRA,France,2009,0,163,-163
SVK,Slovak Republic,FRA,France,2010,0,118,-118
SVK,Slovak Republic,FRA,France,2011,0,100,-100
SVK,Slovak Republic,FRA,France,2012,0,51,-51
SVK,Slovak Republic,FRA,France,2013,656,50,606
SVK,Slovak Republic,FRA,France,2014,289,52,237
SVK,Slovak Republic,FRA,France,2015,271,77,194
SVK,Slovak Republic,FRA,France,2016,395,78,317
SVK,Slovak Republic,FRA,France,2017,390,68,322
SVK,Slovak Republic,DEU,Germany,2008,8749,754,7995
SVK,Slovak Republic,DEU,Germany,2009,8499,387,8112
SVK,Slovak Republic,DEU,Germany,2010,8590,247,8343
SVK,Slovak Republic,DEU,Germany,2011,12224,191,12033
SVK,Slovak Republic,DEU,Germany,2012,13892,129,13763
SVK,Slovak Republic,DEU,Germany,2013,15038,90,14948
SVK,Slovak Republic,DEU,Germany,2014,15518,76,15442
SVK,Slovak Republic,DEU,Germany,2015,14541,147,14394
SVK,Slovak Republic,DEU,Germany,2016,12507,131,12376
SVK,Slovak Republic,DEU,Germany,2017,12239,149,12090
SVK,Slovak Republic,HUN,Hungary,2008,1286,904,382
SVK,Slovak Republic,HUN,Hungary,2009,1169,783,386
SVK,Slovak Republic,HUN,Hungary,2010,1195,678,517
SVK,Slovak Republic,HUN,Hungary,2011,1129,662,467
SVK,Slovak Republic,HUN,Hungary,2012,1013,706,307
SVK,Slovak Republic,HUN,Hungary,2013,1092,379,713
SVK,Slovak Republic,HUN,Hungary,2014,1239,510,729
SVK,Slovak Republic,HUN,Hungary,2015,1275,560,715
SVK,Slovak Republic,HUN,Hungary,2016,1338,605,733
SVK,Slovak Republic,HUN,Hungary,2017,1508,449,1059
SVK,Slovak Republic,ISL,Iceland,2008,181,2,179
SVK,Slovak Republic,ISL,Iceland,2009,42,1,41
SVK,Slovak Republic,ISL,Iceland,2010,28,1,27
SVK,Slovak Republic,ISL,Iceland,2011,40,2,38
SVK,Slovak Republic,ISL,Iceland,2012,44,4,40
SVK,Slovak Republic,ISL,Iceland,2013,62,14,48
SVK,Slovak Republic,ISL,Iceland,2014,84,17,67
SVK,Slovak Republic,ISL,Iceland,2015,61,7,54
SVK,Slovak Republic,ISL,Iceland,2016,156,5,151
SVK,Slovak Republic,ISL,Iceland,2017,168,8,160
SVK,Slovak Republic,ITA,Italy,2008,1274,171,1103
SVK,Slovak Republic,ITA,Italy,2009,1074,214,860
SVK,Slovak Republic,ITA,Italy,2010,895,206,689
SVK,Slovak Republic,ITA,Italy,2011,730,175,555
SVK,Slovak Republic,ITA,Italy,2012,645,164,481
SVK,Slovak Republic,ITA,Italy,2013,539,150,389
SVK,Slovak Republic,ITA,Italy,2014,478,107,371
SVK,Slovak Republic,ITA,Italy,2015,471,211,260
SVK,Slovak Republic,ITA,Italy,2016,421,200,221
SVK,Slovak Republic,ITA,Italy,2017,374,218,156
SVK,Slovak Republic,JPN,Japan,2008,263,12,251
SVK,Slovak Republic,JPN,Japan,2009,178,4,174
SVK,Slovak Republic,JPN,Japan,2010,285,5,280
SVK,Slovak Republic,JPN,Japan,2011,140,6,134
SVK,Slovak Republic,JPN,Japan,2012,306,1,305
SVK,Slovak Republic,JPN,Japan,2013,232,3,229
SVK,Slovak Republic,JPN,Japan,2014,190,1,189
SVK,Slovak Republic,JPN,Japan,2015,279,2,277
SVK,Slovak Republic,JPN,Japan,2016,212,1,211
SVK,Slovak Republic,JPN,Japan,2017,179,2,177
SVK,Slovak Republic,KOR,Korea,2008,13,88,-75
SVK,Slovak Republic,KOR,Korea,2009,25,43,-18
SVK,Slovak Republic,KOR,Korea,2010,32,39,-7
SVK,Slovak Republic,KOR,Korea,2011,23,34,-11
SVK,Slovak Republic,KOR,Korea,2012,28,22,6
SVK,Slovak Republic,KOR,Korea,2013,36,14,22
SVK,Slovak Republic,KOR,Korea,2014,33,15,18
SVK,Slovak Republic,KOR,Korea,2015,27,21,6
SVK,Slovak Republic,KOR,Korea,2016,32,17,15
SVK,Slovak Republic,KOR,Korea,2017,25,26,-1
SVK,Slovak Republic,LUX,Luxembourg,2008,82,2,80
SVK,Slovak Republic,LUX,Luxembourg,2009,64,3,61
SVK,Slovak Republic,LUX,Luxembourg,2010,79,1,78
SVK,Slovak Republic,LUX,Luxembourg,2011,62,1,61
SVK,Slovak Republic,LUX,Luxembourg,2012,75,0,75
SVK,Slovak Republic,LUX,Luxembourg,2013,62,0,62
SVK,Slovak Republic,LUX,Luxembourg,2014,81,0,81
SVK,Slovak Republic,LUX,Luxembourg,2015,86,0,86
SVK,Slovak Republic,LUX,Luxembourg,2016,84,0,84
SVK,Slovak Republic,LUX,Luxembourg,2017,69,4,65
SVK,Slovak Republic,MEX,Mexico,2008,4,3,1
SVK,Slovak Republic,MEX,Mexico,2009,9,2,7
SVK,Slovak Republic,MEX,Mexico,2010,17,3,14
SVK,Slovak Republic,MEX,Mexico,2011,14,4,10
SVK,Slovak Republic,MEX,Mexico,2012,9,2,7
SVK,Slovak Republic,MEX,Mexico,2013,36,3,33
SVK,Slovak Republic,MEX,Mexico,2014,30,3,27
SVK,Slovak Republic,MEX,Mexico,2015,21,12,9
SVK,Slovak Republic,MEX,Mexico,2016,19,3,16
SVK,Slovak Republic,MEX,Mexico,2017,11,3,8
SVK,Slovak Republic,NLD,Netherlands,2008,996,65,931
SVK,Slovak Republic,NLD,Netherlands,2009,766,44,722
SVK,Slovak Republic,NLD,Netherlands,2010,1079,37,1042
SVK,Slovak Republic,NLD,Netherlands,2011,1064,28,1036
SVK,Slovak Republic,NLD,Netherlands,2012,987,12,975
SVK,Slovak Republic,NLD,Netherlands,2013,905,15,890
SVK,Slovak Republic,NLD,Netherlands,2014,1108,16,1092
SVK,Slovak Republic,NLD,Netherlands,2015,1106,17,1089
SVK,Slovak Republic,NLD,Netherlands,2016,1156,18,1138
SVK,Slovak Republic,NLD,Netherlands,2017,1314,17,1297
SVK,Slovak Republic,NZL,New Zealand,2008,17,1,16
SVK,Slovak Republic,NZL,New Zealand,2009,17,1,16
SVK,Slovak Republic,NZL,New Zealand,2010,12,7,5
SVK,Slovak Republic,NZL,New Zealand,2011,26,1,25
SVK,Slovak Republic,NZL,New Zealand,2012,56,0,56
SVK,Slovak Republic,NZL,New Zealand,2013,77,1,76
SVK,Slovak Republic,NZL,New Zealand,2014,85,0,85
SVK,Slovak Republic,NZL,New Zealand,2015,97,2,95
SVK,Slovak Republic,NZL,New Zealand,2016,87,1,86
SVK,Slovak Republic,NZL,New Zealand,2017,100,1,99
SVK,Slovak Republic,NOR,Norway,2008,695,57,638
SVK,Slovak Republic,NOR,Norway,2009,528,57,471
SVK,Slovak Republic,NOR,Norway,2010,594,51,543
SVK,Slovak Republic,NOR,Norway,2011,594,58,536
SVK,Slovak Republic,NOR,Norway,2012,570,54,516
SVK,Slovak Republic,NOR,Norway,2013,509,31,478
SVK,Slovak Republic,NOR,Norway,2014,510,48,462
SVK,Slovak Republic,NOR,Norway,2015,383,49,334
SVK,Slovak Republic,NOR,Norway,2016,262,36,226
SVK,Slovak Republic,NOR,Norway,2017,200,29,171
SVK,Slovak Republic,POL,Poland,2008,166,391,-225
SVK,Slovak Republic,POL,Poland,2009,166,376,-210
SVK,Slovak Republic,POL,Poland,2010,175,280,-105
SVK,Slovak Republic,POL,Poland,2011,210,190,20
SVK,Slovak Republic,POL,Poland,2012,201,115,86
SVK,Slovak Republic,POL,Poland,2013,305,158,147
SVK,Slovak Republic,POL,Poland,2014,306,122,184
SVK,Slovak Republic,POL,Poland,2015,224,205,19
SVK,Slovak Republic,POL,Poland,2016,210,208,2
SVK,Slovak Republic,POL,Poland,2017,213,151,62
SVK,Slovak Republic,SVK,Slovak Republic,2008,0,0,0
SVK,Slovak Republic,ESP,Spain,2008,649,63,586
SVK,Slovak Republic,ESP,Spain,2009,417,110,307
SVK,Slovak Republic,ESP,Spain,2010,459,63,396
SVK,Slovak Republic,ESP,Spain,2011,503,64,439
SVK,Slovak Republic,ESP,Spain,2012,446,57,389
SVK,Slovak Republic,ESP,Spain,2013,430,39,391
SVK,Slovak Republic,ESP,Spain,2014,366,42,324
SVK,Slovak Republic,ESP,Spain,2015,384,85,299
SVK,Slovak Republic,ESP,Spain,2016,389,85,304
SVK,Slovak Republic,ESP,Spain,2017,504,81,423
SVK,Slovak Republic,SWE,Sweden,2008,208,30,178
SVK,Slovak Republic,SWE,Sweden,2009,224,35,189
SVK,Slovak Republic,SWE,Sweden,2010,234,20,214
SVK,Slovak Republic,SWE,Sweden,2011,155,10,145
SVK,Slovak Republic,SWE,Sweden,2012,139,20,119
SVK,Slovak Republic,SWE,Sweden,2013,131,22,109
SVK,Slovak Republic,SWE,Sweden,2014,183,11,172
SVK,Slovak Republic,SWE,Sweden,2015,172,14,158
SVK,Slovak Republic,SWE,Sweden,2016,178,21,157
SVK,Slovak Republic,SWE,Sweden,2017,182,12,170
SVK,Slovak Republic,CHE,Switzerland,2008,1209,38,1171
SVK,Slovak Republic,CHE,Switzerland,2009,1115,28,1087
SVK,Slovak Republic,CHE,Switzerland,2010,981,27,954
SVK,Slovak Republic,CHE,Switzerland,2011,1865,15,1850
SVK,Slovak Republic,CHE,Switzerland,2012,1625,14,1611
SVK,Slovak Republic,CHE,Switzerland,2013,1498,5,1493
SVK,Slovak Republic,CHE,Switzerland,2014,2716,10,2706
SVK,Slovak Republic,CHE,Switzerland,2015,2583,9,2574
SVK,Slovak Republic,CHE,Switzerland,2016,2347,14,2333
SVK,Slovak Republic,CHE,Switzerland,2017,2087,5,2082
SVK,Slovak Republic,TUR,Turkey,2010,57,16,41
SVK,Slovak Republic,GBR,United Kingdom,2013,6000,48,5952
SVK,Slovak Republic,USA,United States,2008,653,27,626
SVK,Slovak Republic,USA,United States,2009,706,28,678
SVK,Slovak Republic,USA,United States,2010,538,30,508
SVK,Slovak Republic,USA,United States,2011,594,20,574
SVK,Slovak Republic,USA,United States,2012,528,11,517
SVK,Slovak Republic,USA,United States,2013,507,14,493
SVK,Slovak Republic,USA,United States,2014,460,23,437
SVK,Slovak Republic,USA,United States,2015,424,15,409
SVK,Slovak Republic,USA,United States,2016,483,13,470
SVK,Slovak Republic,USA,United States,2017,388,17,371
SVK,Slovak Republic,CHL,Chile,2008,3,1,2
SVK,Slovak Republic,CHL,Chile,2009,6,1,5
SVK,Slovak Republic,CHL,Chile,2010,25,4,21
SVK,Slovak Republic,CHL,Chile,2011,20,0,20
SVK,Slovak Republic,CHL,Chile,2012,12,2,10
SVK,Slovak Republic,CHL,Chile,2013,89,1,88
SVK,Slovak Republic,CHL,Chile,2014,32,0,32
SVK,Slovak Republic,CHL,Chile,2015,6,1,5
SVK,Slovak Republic,CHL,Chile,2016,11,1,10
SVK,Slovak Republic,EST,Estonia,2008,3,7,-4
SVK,Slovak Republic,EST,Estonia,2009,4,5,-1
SVK,Slovak Republic,EST,Estonia,2010,1,8,-7
SVK,Slovak Republic,EST,Estonia,2011,0,7,-7
SVK,Slovak Republic,EST,Estonia,2012,1,4,-3
SVK,Slovak Republic,EST,Estonia,2013,2,3,-1
SVK,Slovak Republic,EST,Estonia,2014,1,2,-1
SVK,Slovak Republic,EST,Estonia,2015,43,1,42
SVK,Slovak Republic,EST,Estonia,2016,60,4,56
SVK,Slovak Republic,EST,Estonia,2017,69,1,68
SVK,Slovak Republic,SVN,Slovenia,2008,533,24,509
SVK,Slovak Republic,SVN,Slovenia,2009,286,24,262
SVK,Slovak Republic,SVN,Slovenia,2010,5,23,-18
SVK,Slovak Republic,SVN,Slovenia,2011,645,22,623
SVK,Slovak Republic,SVN,Slovenia,2012,367,8,359
SVK,Slovak Republic,SVN,Slovenia,2013,397,9,388
SVK,Slovak Republic,SVN,Slovenia,2014,305,5,300
SVK,Slovak Republic,SVN,Slovenia,2015,316,16,300
SVK,Slovak Republic,SVN,Slovenia,2016,292,13,279
SVK,Slovak Republic,SVN,Slovenia,2017,206,8,198
SVN,Slovenia,AUS,Australia,2008,81,0,81
SVN,Slovenia,AUS,Australia,2009,63,27,36
SVN,Slovenia,AUS,Australia,2010,51,17,34
SVN,Slovenia,AUS,Australia,2011,47,9,38
SVN,Slovenia,AUS,Australia,2012,73,12,61
SVN,Slovenia,AUS,Australia,2013,62,6,56
SVN,Slovenia,AUS,Australia,2014,91,6,85
SVN,Slovenia,AUS,Australia,2015,54,8,46
SVN,Slovenia,AUS,Australia,2016,66,8,58
SVN,Slovenia,AUS,Australia,2017,57,5,52
SVN,Slovenia,AUT,Austria,2008,742,119,623
SVN,Slovenia,AUT,Austria,2009,756,111,645
SVN,Slovenia,AUT,Austria,2010,815,89,726
SVN,Slovenia,AUT,Austria,2011,1344,135,1209
SVN,Slovenia,AUT,Austria,2012,1876,105,1771
SVN,Slovenia,AUT,Austria,2013,2520,82,2438
SVN,Slovenia,AUT,Austria,2014,3083,88,2995
SVN,Slovenia,AUT,Austria,2015,2834,77,2757
SVN,Slovenia,AUT,Austria,2016,2697,97,2600
SVN,Slovenia,AUT,Austria,2017,2496,95,2401
SVN,Slovenia,BEL,Belgium,2008,149,20,129
SVN,Slovenia,BEL,Belgium,2009,193,27,166
SVN,Slovenia,BEL,Belgium,2010,181,23,158
SVN,Slovenia,BEL,Belgium,2011,140,28,112
SVN,Slovenia,BEL,Belgium,2012,149,45,104
SVN,Slovenia,BEL,Belgium,2013,157,47,110
SVN,Slovenia,BEL,Belgium,2014,110,47,63
SVN,Slovenia,BEL,Belgium,2015,159,44,115
SVN,Slovenia,BEL,Belgium,2016,132,47,85
SVN,Slovenia,BEL,Belgium,2017,113,60,53
SVN,Slovenia,CAN,Canada,2008,18,22,-4
SVN,Slovenia,CAN,Canada,2009,27,21,6
SVN,Slovenia,CAN,Canada,2010,12,35,-23
SVN,Slovenia,CAN,Canada,2011,13,35,-22
SVN,Slovenia,CAN,Canada,2012,36,15,21
SVN,Slovenia,CAN,Canada,2013,20,3,17
SVN,Slovenia,CAN,Canada,2014,30,8,22
SVN,Slovenia,CAN,Canada,2015,41,19,22
SVN,Slovenia,CAN,Canada,2016,35,16,19
SVN,Slovenia,CAN,Canada,2017,50,27,23
SVN,Slovenia,CZE,Czech Republic,2008,23,113,-90
SVN,Slovenia,CZE,Czech Republic,2009,31,171,-140
SVN,Slovenia,CZE,Czech Republic,2010,18,28,-10
SVN,Slovenia,CZE,Czech Republic,2011,16,180,-164
SVN,Slovenia,CZE,Czech Republic,2012,13,212,-199
SVN,Slovenia,CZE,Czech Republic,2013,28,200,-172
SVN,Slovenia,CZE,Czech Republic,2014,42,228,-186
SVN,Slovenia,CZE,Czech Republic,2015,29,233,-204
SVN,Slovenia,CZE,Czech Republic,2016,30,262,-232
SVN,Slovenia,CZE,Czech Republic,2017,38,197,-159
SVN,Slovenia,DNK,Denmark,2008,60,13,47
SVN,Slovenia,DNK,Denmark,2009,45,10,35
SVN,Slovenia,DNK,Denmark,2010,44,5,39
SVN,Slovenia,DNK,Denmark,2011,46,9,37
SVN,Slovenia,DNK,Denmark,2012,69,13,56
SVN,Slovenia,DNK,Denmark,2013,59,9,50
SVN,Slovenia,DNK,Denmark,2014,45,10,35
SVN,Slovenia,DNK,Denmark,2015,72,8,64
SVN,Slovenia,DNK,Denmark,2016,54,9,45
SVN,Slovenia,DNK,Denmark,2017,65,19,46
SVN,Slovenia,FIN,Finland,2008,19,38,-19
SVN,Slovenia,FIN,Finland,2009,16,3,13
SVN,Slovenia,FIN,Finland,2010,7,0,7
SVN,Slovenia,FIN,Finland,2011,11,45,-34
SVN,Slovenia,FIN,Finland,2012,5,38,-33
SVN,Slovenia,FIN,Finland,2013,13,59,-46
SVN,Slovenia,FIN,Finland,2014,20,40,-20
SVN,Slovenia,FIN,Finland,2015,19,45,-26
SVN,Slovenia,FIN,Finland,2016,28,66,-38
SVN,Slovenia,FIN,Finland,2017,18,54,-36
SVN,Slovenia,FRA,France,2008,0,130,-130
SVN,Slovenia,FRA,France,2009,0,117,-117
SVN,Slovenia,FRA,France,2010,0,2,-2
SVN,Slovenia,FRA,France,2011,0,117,-117
SVN,Slovenia,FRA,France,2012,0,126,-126
SVN,Slovenia,FRA,France,2013,231,221,10
SVN,Slovenia,FRA,France,2014,127,151,-24
SVN,Slovenia,FRA,France,2015,191,178,13
SVN,Slovenia,FRA,France,2016,59,191,-132
SVN,Slovenia,FRA,France,2017,124,178,-54
SVN,Slovenia,DEU,Germany,2008,1218,221,997
SVN,Slovenia,DEU,Germany,2009,1242,194,1048
SVN,Slovenia,DEU,Germany,2010,1591,8,1583
SVN,Slovenia,DEU,Germany,2011,2486,202,2284
SVN,Slovenia,DEU,Germany,2012,3592,254,3338
SVN,Slovenia,DEU,Germany,2013,4331,248,4083
SVN,Slovenia,DEU,Germany,2014,4515,246,4269
SVN,Slovenia,DEU,Germany,2015,4754,286,4468
SVN,Slovenia,DEU,Germany,2016,3348,253,3095
SVN,Slovenia,DEU,Germany,2017,3074,291,2783
SVN,Slovenia,HUN,Hungary,2008,34,187,-153
SVN,Slovenia,HUN,Hungary,2009,28,47,-19
SVN,Slovenia,HUN,Hungary,2010,54,1,53
SVN,Slovenia,HUN,Hungary,2011,46,201,-155
SVN,Slovenia,HUN,Hungary,2012,50,222,-172
SVN,Slovenia,HUN,Hungary,2013,29,300,-271
SVN,Slovenia,HUN,Hungary,2014,35,285,-250
SVN,Slovenia,HUN,Hungary,2015,34,333,-299
SVN,Slovenia,HUN,Hungary,2016,53,339,-286
SVN,Slovenia,HUN,Hungary,2017,53,367,-314
SVN,Slovenia,ISL,Iceland,2008,16,1,15
SVN,Slovenia,ISL,Iceland,2009,7,0,7
SVN,Slovenia,ISL,Iceland,2010,6,0,6
SVN,Slovenia,ISL,Iceland,2011,6,2,4
SVN,Slovenia,ISL,Iceland,2012,1,1,0
SVN,Slovenia,ISL,Iceland,2013,7,2,5
SVN,Slovenia,ISL,Iceland,2014,6,1,5
SVN,Slovenia,ISL,Iceland,2015,8,0,8
SVN,Slovenia,ISL,Iceland,2016,15,2,13
SVN,Slovenia,ISL,Iceland,2017,28,1,27
SVN,Slovenia,ITA,Italy,2008,314,10,304
SVN,Slovenia,ITA,Italy,2009,203,233,-30
SVN,Slovenia,ITA,Italy,2010,191,3,188
SVN,Slovenia,ITA,Italy,2011,192,356,-164
SVN,Slovenia,ITA,Italy,2012,208,501,-293
SVN,Slovenia,ITA,Italy,2013,122,566,-444
SVN,Slovenia,ITA,Italy,2014,155,735,-580
SVN,Slovenia,ITA,Italy,2015,167,828,-661
SVN,Slovenia,ITA,Italy,2016,166,775,-609
SVN,Slovenia,ITA,Italy,2017,183,786,-603
SVN,Slovenia,JPN,Japan,2008,106,32,74
SVN,Slovenia,JPN,Japan,2009,28,25,3
SVN,Slovenia,JPN,Japan,2010,56,29,27
SVN,Slovenia,JPN,Japan,2011,41,58,-17
SVN,Slovenia,JPN,Japan,2012,67,25,42
SVN,Slovenia,JPN,Japan,2013,70,31,39
SVN,Slovenia,JPN,Japan,2014,325,22,303
SVN,Slovenia,JPN,Japan,2015,81,20,61
SVN,Slovenia,JPN,Japan,2016,89,16,73
SVN,Slovenia,JPN,Japan,2017,87,26,61
SVN,Slovenia,KOR,Korea,2008,4,10,-6
SVN,Slovenia,KOR,Korea,2009,11,14,-3
SVN,Slovenia,KOR,Korea,2010,8,0,8
SVN,Slovenia,KOR,Korea,2011,13,19,-6
SVN,Slovenia,KOR,Korea,2012,12,15,-3
SVN,Slovenia,KOR,Korea,2013,9,44,-35
SVN,Slovenia,KOR,Korea,2014,20,14,6
SVN,Slovenia,KOR,Korea,2015,16,4,12
SVN,Slovenia,KOR,Korea,2016,18,13,5
SVN,Slovenia,KOR,Korea,2017,21,16,5
SVN,Slovenia,LUX,Luxembourg,2008,49,4,45
SVN,Slovenia,LUX,Luxembourg,2009,52,1,51
SVN,Slovenia,LUX,Luxembourg,2010,46,0,46
SVN,Slovenia,LUX,Luxembourg,2011,61,0,61
SVN,Slovenia,LUX,Luxembourg,2012,41,0,41
SVN,Slovenia,LUX,Luxembourg,2013,66,0,66
SVN,Slovenia,LUX,Luxembourg,2014,63,1,62
SVN,Slovenia,LUX,Luxembourg,2015,60,2,58
SVN,Slovenia,LUX,Luxembourg,2016,62,0,62
SVN,Slovenia,LUX,Luxembourg,2017,59,3,56
SVN,Slovenia,MEX,Mexico,2008,11,9,2
SVN,Slovenia,MEX,Mexico,2009,15,9,6
SVN,Slovenia,MEX,Mexico,2010,10,7,3
SVN,Slovenia,MEX,Mexico,2011,8,9,-1
SVN,Slovenia,MEX,Mexico,2012,4,1,3
SVN,Slovenia,MEX,Mexico,2013,22,5,17
SVN,Slovenia,MEX,Mexico,2014,10,25,-15
SVN,Slovenia,MEX,Mexico,2015,9,13,-4
SVN,Slovenia,MEX,Mexico,2016,6,8,-2
SVN,Slovenia,MEX,Mexico,2017,9,14,-5
SVN,Slovenia,NLD,Netherlands,2009,160,34,126
SVN,Slovenia,NLD,Netherlands,2010,187,2,185
SVN,Slovenia,NLD,Netherlands,2011,170,26,144
SVN,Slovenia,NLD,Netherlands,2012,208,48,160
SVN,Slovenia,NLD,Netherlands,2013,249,42,207
SVN,Slovenia,NLD,Netherlands,2014,343,49,294
SVN,Slovenia,NLD,Netherlands,2015,285,39,246
SVN,Slovenia,NLD,Netherlands,2016,320,60,260
SVN,Slovenia,NLD,Netherlands,2017,320,85,235
SVN,Slovenia,NZL,New Zealand,2008,6,10,-4
SVN,Slovenia,NZL,New Zealand,2009,5,3,2
SVN,Slovenia,NZL,New Zealand,2010,19,5,14
SVN,Slovenia,NZL,New Zealand,2011,49,5,44
SVN,Slovenia,NZL,New Zealand,2012,46,1,45
SVN,Slovenia,NZL,New Zealand,2013,45,2,43
SVN,Slovenia,NZL,New Zealand,2014,59,2,57
SVN,Slovenia,NZL,New Zealand,2015,58,3,55
SVN,Slovenia,NZL,New Zealand,2016,56,1,55
SVN,Slovenia,NZL,New Zealand,2017,78,1,77
SVN,Slovenia,NOR,Norway,2008,59,6,53
SVN,Slovenia,NOR,Norway,2009,26,11,15
SVN,Slovenia,NOR,Norway,2010,46,0,46
SVN,Slovenia,NOR,Norway,2011,38,3,35
SVN,Slovenia,NOR,Norway,2012,54,7,47
SVN,Slovenia,NOR,Norway,2013,58,6,52
SVN,Slovenia,NOR,Norway,2014,73,4,69
SVN,Slovenia,NOR,Norway,2015,48,5,43
SVN,Slovenia,NOR,Norway,2016,50,8,42
SVN,Slovenia,NOR,Norway,2017,37,5,32
SVN,Slovenia,POL,Poland,2008,24,208,-184
SVN,Slovenia,POL,Poland,2009,14,197,-183
SVN,Slovenia,POL,Poland,2010,26,34,-8
SVN,Slovenia,POL,Poland,2011,26,172,-146
SVN,Slovenia,POL,Poland,2012,29,442,-413
SVN,Slovenia,POL,Poland,2013,34,817,-783
SVN,Slovenia,POL,Poland,2014,34,278,-244
SVN,Slovenia,POL,Poland,2015,35,206,-171
SVN,Slovenia,POL,Poland,2016,49,224,-175
SVN,Slovenia,POL,Poland,2017,48,199,-151
SVN,Slovenia,SVK,Slovak Republic,2008,24,533,-509
SVN,Slovenia,SVK,Slovak Republic,2009,24,286,-262
SVN,Slovenia,SVK,Slovak Republic,2010,23,5,18
SVN,Slovenia,SVK,Slovak Republic,2011,22,645,-623
SVN,Slovenia,SVK,Slovak Republic,2012,8,367,-359
SVN,Slovenia,SVK,Slovak Republic,2013,9,397,-388
SVN,Slovenia,SVK,Slovak Republic,2014,5,305,-300
SVN,Slovenia,SVK,Slovak Republic,2015,16,316,-300
SVN,Slovenia,SVK,Slovak Republic,2016,13,292,-279
SVN,Slovenia,SVK,Slovak Republic,2017,8,206,-198
SVN,Slovenia,ESP,Spain,2008,173,96,77
SVN,Slovenia,ESP,Spain,2009,122,129,-7
SVN,Slovenia,ESP,Spain,2010,134,1,133
SVN,Slovenia,ESP,Spain,2011,168,244,-76
SVN,Slovenia,ESP,Spain,2012,156,278,-122
SVN,Slovenia,ESP,Spain,2013,171,283,-112
SVN,Slovenia,ESP,Spain,2014,158,283,-125
SVN,Slovenia,ESP,Spain,2015,202,299,-97
SVN,Slovenia,ESP,Spain,2016,201,281,-80
SVN,Slovenia,ESP,Spain,2017,233,344,-111
SVN,Slovenia,SWE,Sweden,2008,74,24,50
SVN,Slovenia,SWE,Sweden,2009,60,30,30
SVN,Slovenia,SWE,Sweden,2010,48,31,17
SVN,Slovenia,SWE,Sweden,2011,68,28,40
SVN,Slovenia,SWE,Sweden,2012,73,20,53
SVN,Slovenia,SWE,Sweden,2013,122,18,104
SVN,Slovenia,SWE,Sweden,2014,98,20,78
SVN,Slovenia,SWE,Sweden,2015,125,25,100
SVN,Slovenia,SWE,Sweden,2016,87,21,66
SVN,Slovenia,SWE,Sweden,2017,102,17,85
SVN,Slovenia,CHE,Switzerland,2008,186,14,172
SVN,Slovenia,CHE,Switzerland,2009,167,14,153
SVN,Slovenia,CHE,Switzerland,2010,144,11,133
SVN,Slovenia,CHE,Switzerland,2011,382,13,369
SVN,Slovenia,CHE,Switzerland,2012,470,15,455
SVN,Slovenia,CHE,Switzerland,2013,564,15,549
SVN,Slovenia,CHE,Switzerland,2014,1152,13,1139
SVN,Slovenia,CHE,Switzerland,2015,1083,10,1073
SVN,Slovenia,CHE,Switzerland,2016,917,9,908
SVN,Slovenia,CHE,Switzerland,2017,836,17,819
SVN,Slovenia,TUR,Turkey,2010,9,118,-109
SVN,Slovenia,GBR,United Kingdom,2012,1000,115,885
SVN,Slovenia,GBR,United Kingdom,2013,1000,84,916
SVN,Slovenia,USA,United States,2008,79,111,-32
SVN,Slovenia,USA,United States,2009,108,149,-41
SVN,Slovenia,USA,United States,2010,74,170,-96
SVN,Slovenia,USA,United States,2011,69,89,-20
SVN,Slovenia,USA,United States,2012,86,148,-62
SVN,Slovenia,USA,United States,2013,62,32,30
SVN,Slovenia,USA,United States,2014,78,61,17
SVN,Slovenia,USA,United States,2015,107,187,-80
SVN,Slovenia,USA,United States,2016,119,91,28
SVN,Slovenia,USA,United States,2017,108,108,0
SVN,Slovenia,CHL,Chile,2008,2,2,0
SVN,Slovenia,CHL,Chile,2009,5,2,3
SVN,Slovenia,CHL,Chile,2010,1,2,-1
SVN,Slovenia,CHL,Chile,2011,11,1,10
SVN,Slovenia,CHL,Chile,2012,8,1,7
SVN,Slovenia,CHL,Chile,2013,7,1,6
SVN,Slovenia,CHL,Chile,2014,10,0,10
SVN,Slovenia,CHL,Chile,2015,7,2,5
SVN,Slovenia,CHL,Chile,2016,4,0,4
SVN,Slovenia,EST,Estonia,2008,3,4,-1
SVN,Slovenia,EST,Estonia,2009,2,8,-6
SVN,Slovenia,EST,Estonia,2010,2,0,2
SVN,Slovenia,EST,Estonia,2011,0,8,-8
SVN,Slovenia,EST,Estonia,2012,0,14,-14
SVN,Slovenia,EST,Estonia,2013,0,8,-8
SVN,Slovenia,EST,Estonia,2014,0,15,-15
SVN,Slovenia,EST,Estonia,2015,6,11,-5
SVN,Slovenia,EST,Estonia,2016,14,8,6
SVN,Slovenia,EST,Estonia,2017,15,16,-1
SLB,Solomon Islands,AUS,Australia,2008,41,22,19
SLB,Solomon Islands,AUS,Australia,2009,59,10,49
SLB,Solomon Islands,AUS,Australia,2010,50,18,32
SLB,Solomon Islands,AUS,Australia,2011,47,6,41
SLB,Solomon Islands,AUS,Australia,2012,46,14,32
SLB,Solomon Islands,AUS,Australia,2013,68,16,52
SLB,Solomon Islands,AUS,Australia,2014,37,11,26
SLB,Solomon Islands,AUS,Australia,2015,28,0,28
SLB,Solomon Islands,AUS,Australia,2016,51,0,51
SLB,Solomon Islands,AUS,Australia,2017,47,0,47
SLB,Solomon Islands,AUT,Austria,2008,1,0,1
SLB,Solomon Islands,AUT,Austria,2009,0,0,0
SLB,Solomon Islands,AUT,Austria,2010,3,0,3
SLB,Solomon Islands,AUT,Austria,2011,1,0,1
SLB,Solomon Islands,AUT,Austria,2012,1,1,0
SLB,Solomon Islands,AUT,Austria,2013,1,0,1
SLB,Solomon Islands,AUT,Austria,2014,0,0,0
SLB,Solomon Islands,AUT,Austria,2015,1,0,1
SLB,Solomon Islands,AUT,Austria,2016,0,0,0
SLB,Solomon Islands,AUT,Austria,2017,2,0,2
SLB,Solomon Islands,BEL,Belgium,2008,5,0,5
SLB,Solomon Islands,BEL,Belgium,2009,0,0,0
SLB,Solomon Islands,BEL,Belgium,2010,1,1,0
SLB,Solomon Islands,BEL,Belgium,2012,1,0,1
SLB,Solomon Islands,CAN,Canada,2008,12,0,12
SLB,Solomon Islands,CAN,Canada,2009,14,0,14
SLB,Solomon Islands,CAN,Canada,2010,5,0,5
SLB,Solomon Islands,CAN,Canada,2011,10,0,10
SLB,Solomon Islands,CAN,Canada,2012,0,0,0
SLB,Solomon Islands,CAN,Canada,2013,3,0,3
SLB,Solomon Islands,CAN,Canada,2014,1,0,1
SLB,Solomon Islands,CAN,Canada,2015,0,0,0
SLB,Solomon Islands,CAN,Canada,2016,0,0,0
SLB,Solomon Islands,CAN,Canada,2017,0,0,0
SLB,Solomon Islands,DNK,Denmark,2013,0,0,0
SLB,Solomon Islands,DNK,Denmark,2014,0,0,0
SLB,Solomon Islands,DNK,Denmark,2015,2,0,2
SLB,Solomon Islands,DNK,Denmark,2016,0,0,0
SLB,Solomon Islands,DNK,Denmark,2017,0,0,0
SLB,Solomon Islands,FIN,Finland,2008,0,0,0
SLB,Solomon Islands,FIN,Finland,2009,0,0,0
SLB,Solomon Islands,FIN,Finland,2010,0,0,0
SLB,Solomon Islands,FIN,Finland,2011,0,0,0
SLB,Solomon Islands,FIN,Finland,2012,1,0,1
SLB,Solomon Islands,FIN,Finland,2013,0,0,0
SLB,Solomon Islands,FIN,Finland,2014,0,0,0
SLB,Solomon Islands,FIN,Finland,2015,0,0,0
SLB,Solomon Islands,FIN,Finland,2016,0,1,-1
SLB,Solomon Islands,FIN,Finland,2017,1,1,0
SLB,Solomon Islands,FRA,France,2008,0,0,0
SLB,Solomon Islands,FRA,France,2009,0,0,0
SLB,Solomon Islands,FRA,France,2010,0,0,0
SLB,Solomon Islands,FRA,France,2011,0,0,0
SLB,Solomon Islands,FRA,France,2012,0,0,0
SLB,Solomon Islands,FRA,France,2013,0,0,0
SLB,Solomon Islands,FRA,France,2014,0,0,0
SLB,Solomon Islands,FRA,France,2015,0,0,0
SLB,Solomon Islands,FRA,France,2016,0,0,0
SLB,Solomon Islands,FRA,France,2017,0,0,0
SLB,Solomon Islands,DEU,Germany,2008,0,2,-2
SLB,Solomon Islands,DEU,Germany,2009,2,0,2
SLB,Solomon Islands,DEU,Germany,2010,7,0,7
SLB,Solomon Islands,DEU,Germany,2011,3,2,1
SLB,Solomon Islands,DEU,Germany,2012,2,1,1
SLB,Solomon Islands,DEU,Germany,2013,8,0,8
SLB,Solomon Islands,DEU,Germany,2014,7,1,6
SLB,Solomon Islands,DEU,Germany,2015,16,3,13
SLB,Solomon Islands,DEU,Germany,2016,4,3,1
SLB,Solomon Islands,DEU,Germany,2017,3,1,2
SLB,Solomon Islands,HUN,Hungary,2008,0,0,0
SLB,Solomon Islands,HUN,Hungary,2009,0,0,0
SLB,Solomon Islands,HUN,Hungary,2010,0,0,0
SLB,Solomon Islands,HUN,Hungary,2011,0,0,0
SLB,Solomon Islands,HUN,Hungary,2012,0,0,0
SLB,Solomon Islands,HUN,Hungary,2013,0,0,0
SLB,Solomon Islands,HUN,Hungary,2014,0,0,0
SLB,Solomon Islands,HUN,Hungary,2015,0,0,0
SLB,Solomon Islands,HUN,Hungary,2016,0,0,0
SLB,Solomon Islands,HUN,Hungary,2017,0,0,0
SLB,Solomon Islands,ISL,Iceland,2016,0,0,0
SLB,Solomon Islands,ISL,Iceland,2017,0,0,0
SLB,Solomon Islands,ITA,Italy,2008,2,0,2
SLB,Solomon Islands,ITA,Italy,2009,1,0,1
SLB,Solomon Islands,ITA,Italy,2010,0,0,0
SLB,Solomon Islands,ITA,Italy,2011,0,0,0
SLB,Solomon Islands,ITA,Italy,2012,1,0,1
SLB,Solomon Islands,ITA,Italy,2013,0,0,0
SLB,Solomon Islands,ITA,Italy,2015,0,0,0
SLB,Solomon Islands,ITA,Italy,2016,0,0,0
SLB,Solomon Islands,ITA,Italy,2017,1,0,1
SLB,Solomon Islands,JPN,Japan,2008,66,69,-3
SLB,Solomon Islands,JPN,Japan,2009,88,80,8
SLB,Solomon Islands,JPN,Japan,2010,79,77,2
SLB,Solomon Islands,JPN,Japan,2011,60,60,0
SLB,Solomon Islands,JPN,Japan,2012,79,79,0
SLB,Solomon Islands,JPN,Japan,2013,67,62,5
SLB,Solomon Islands,JPN,Japan,2014,55,54,1
SLB,Solomon Islands,JPN,Japan,2015,80,74,6
SLB,Solomon Islands,JPN,Japan,2016,76,75,1
SLB,Solomon Islands,JPN,Japan,2017,79,78,1
SLB,Solomon Islands,KOR,Korea,2008,0,2,-2
SLB,Solomon Islands,KOR,Korea,2009,2,2,0
SLB,Solomon Islands,KOR,Korea,2010,1,1,0
SLB,Solomon Islands,KOR,Korea,2011,1,0,1
SLB,Solomon Islands,KOR,Korea,2012,8,5,3
SLB,Solomon Islands,KOR,Korea,2013,5,3,2
SLB,Solomon Islands,KOR,Korea,2014,5,5,0
SLB,Solomon Islands,KOR,Korea,2015,6,5,1
SLB,Solomon Islands,KOR,Korea,2016,9,8,1
SLB,Solomon Islands,KOR,Korea,2017,5,6,-1
SLB,Solomon Islands,LUX,Luxembourg,2008,0,0,0
SLB,Solomon Islands,LUX,Luxembourg,2009,0,0,0
SLB,Solomon Islands,LUX,Luxembourg,2010,0,0,0
SLB,Solomon Islands,LUX,Luxembourg,2011,0,0,0
SLB,Solomon Islands,LUX,Luxembourg,2012,0,0,0
SLB,Solomon Islands,LUX,Luxembourg,2013,0,0,0
SLB,Solomon Islands,LUX,Luxembourg,2014,0,0,0
SLB,Solomon Islands,LUX,Luxembourg,2015,0,0,0
SLB,Solomon Islands,LUX,Luxembourg,2016,0,0,0
SLB,Solomon Islands,LUX,Luxembourg,2017,0,0,0
SLB,Solomon Islands,MEX,Mexico,2012,0,0,0
SLB,Solomon Islands,MEX,Mexico,2013,0,0,0
SLB,Solomon Islands,MEX,Mexico,2014,0,0,0
SLB,Solomon Islands,NLD,Netherlands,2009,1,0,1
SLB,Solomon Islands,NLD,Netherlands,2015,0,1,-1
SLB,Solomon Islands,NZL,New Zealand,2008,83,57,26
SLB,Solomon Islands,NZL,New Zealand,2009,65,25,40
SLB,Solomon Islands,NZL,New Zealand,2010,66,72,-6
SLB,Solomon Islands,NZL,New Zealand,2011,71,64,7
SLB,Solomon Islands,NZL,New Zealand,2012,61,44,17
SLB,Solomon Islands,NZL,New Zealand,2013,43,42,1
SLB,Solomon Islands,NZL,New Zealand,2014,51,29,22
SLB,Solomon Islands,NZL,New Zealand,2015,40,13,27
SLB,Solomon Islands,NZL,New Zealand,2016,51,16,35
SLB,Solomon Islands,NZL,New Zealand,2017,43,21,22
SLB,Solomon Islands,NOR,Norway,2008,0,0,0
SLB,Solomon Islands,NOR,Norway,2009,0,0,0
SLB,Solomon Islands,NOR,Norway,2010,0,0,0
SLB,Solomon Islands,NOR,Norway,2011,0,0,0
SLB,Solomon Islands,NOR,Norway,2012,1,0,1
SLB,Solomon Islands,NOR,Norway,2013,0,0,0
SLB,Solomon Islands,NOR,Norway,2014,0,0,0
SLB,Solomon Islands,NOR,Norway,2015,0,0,0
SLB,Solomon Islands,NOR,Norway,2016,0,1,-1
SLB,Solomon Islands,NOR,Norway,2017,0,0,0
SLB,Solomon Islands,POL,Poland,2009,0,0,0
SLB,Solomon Islands,POL,Poland,2010,0,0,0
SLB,Solomon Islands,POL,Poland,2011,0,0,0
SLB,Solomon Islands,POL,Poland,2012,0,0,0
SLB,Solomon Islands,POL,Poland,2013,0,0,0
SLB,Solomon Islands,POL,Poland,2014,0,0,0
SLB,Solomon Islands,POL,Poland,2015,0,0,0
SLB,Solomon Islands,POL,Poland,2016,0,0,0
SLB,Solomon Islands,POL,Poland,2017,0,0,0
SLB,Solomon Islands,SVK,Slovak Republic,2008,0,0,0
SLB,Solomon Islands,ESP,Spain,2008,0,0,0
SLB,Solomon Islands,ESP,Spain,2009,0,0,0
SLB,Solomon Islands,ESP,Spain,2010,0,0,0
SLB,Solomon Islands,ESP,Spain,2011,0,0,0
SLB,Solomon Islands,ESP,Spain,2012,0,0,0
SLB,Solomon Islands,ESP,Spain,2013,2,0,2
SLB,Solomon Islands,ESP,Spain,2014,0,0,0
SLB,Solomon Islands,ESP,Spain,2015,0,0,0
SLB,Solomon Islands,ESP,Spain,2016,1,0,1
SLB,Solomon Islands,ESP,Spain,2017,2,0,2
SLB,Solomon Islands,SWE,Sweden,2008,0,0,0
SLB,Solomon Islands,SWE,Sweden,2009,0,0,0
SLB,Solomon Islands,SWE,Sweden,2010,0,0,0
SLB,Solomon Islands,SWE,Sweden,2011,0,0,0
SLB,Solomon Islands,SWE,Sweden,2012,0,0,0
SLB,Solomon Islands,SWE,Sweden,2013,0,0,0
SLB,Solomon Islands,SWE,Sweden,2014,0,0,0
SLB,Solomon Islands,SWE,Sweden,2015,0,0,0
SLB,Solomon Islands,SWE,Sweden,2016,1,0,1
SLB,Solomon Islands,SWE,Sweden,2017,1,1,0
SLB,Solomon Islands,CHE,Switzerland,2010,0,0,0
SLB,Solomon Islands,CHE,Switzerland,2011,0,0,0
SLB,Solomon Islands,CHE,Switzerland,2012,1,0,1
SLB,Solomon Islands,CHE,Switzerland,2013,0,0,0
SLB,Solomon Islands,CHE,Switzerland,2015,556,0,556
SLB,Solomon Islands,CHE,Switzerland,2016,0,0,0
SLB,Solomon Islands,CHE,Switzerland,2017,0,0,0
SLB,Solomon Islands,USA,United States,2008,7,0,7
SLB,Solomon Islands,USA,United States,2010,6,0,6
SLB,Solomon Islands,USA,United States,2013,3,0,3
SLB,Solomon Islands,USA,United States,2014,5,0,5
SLB,Solomon Islands,USA,United States,2016,3,0,3
SLB,Solomon Islands,USA,United States,2017,6,0,6
SLB,Solomon Islands,CHL,Chile,2008,0,0,0
SLB,Solomon Islands,CHL,Chile,2009,0,0,0
SLB,Solomon Islands,CHL,Chile,2010,0,0,0
SLB,Solomon Islands,CHL,Chile,2011,0,0,0
SLB,Solomon Islands,CHL,Chile,2012,0,0,0
SLB,Solomon Islands,CHL,Chile,2013,0,0,0
SLB,Solomon Islands,CHL,Chile,2014,0,0,0
SLB,Solomon Islands,CHL,Chile,2015,0,0,0
SLB,Solomon Islands,CHL,Chile,2016,0,0,0
SLB,Solomon Islands,EST,Estonia,2008,0,0,0
SLB,Solomon Islands,EST,Estonia,2009,0,0,0
SLB,Solomon Islands,EST,Estonia,2010,0,0,0
SLB,Solomon Islands,EST,Estonia,2011,0,0,0
SLB,Solomon Islands,EST,Estonia,2012,0,0,0
SLB,Solomon Islands,EST,Estonia,2013,0,0,0
SLB,Solomon Islands,EST,Estonia,2014,0,0,0
SLB,Solomon Islands,EST,Estonia,2015,0,0,0
SLB,Solomon Islands,EST,Estonia,2016,0,0,0
SLB,Solomon Islands,EST,Estonia,2017,0,0,0
SLB,Solomon Islands,SVN,Slovenia,2008,1,0,1
SOM,Somalia,AUS,Australia,2008,155,92,63
SOM,Somalia,AUS,Australia,2009,419,85,334
SOM,Somalia,AUS,Australia,2010,657,82,575
SOM,Somalia,AUS,Australia,2011,370,127,243
SOM,Somalia,AUS,Australia,2012,346,138,208
SOM,Somalia,AUS,Australia,2013,293,86,207
SOM,Somalia,AUS,Australia,2014,523,97,426
SOM,Somalia,AUS,Australia,2015,501,100,401
SOM,Somalia,AUS,Australia,2016,676,100,576
SOM,Somalia,AUS,Australia,2017,238,0,238
SOM,Somalia,AUT,Austria,2008,258,46,212
SOM,Somalia,AUT,Austria,2009,250,35,215
SOM,Somalia,AUT,Austria,2010,180,59,121
SOM,Somalia,AUT,Austria,2011,485,44,441
SOM,Somalia,AUT,Austria,2012,486,118,368
SOM,Somalia,AUT,Austria,2013,336,79,257
SOM,Somalia,AUT,Austria,2014,978,118,860
SOM,Somalia,AUT,Austria,2015,1902,239,1663
SOM,Somalia,AUT,Austria,2016,1470,368,1102
SOM,Somalia,AUT,Austria,2017,498,383,115
SOM,Somalia,BEL,Belgium,2008,53,0,53
SOM,Somalia,BEL,Belgium,2009,48,0,48
SOM,Somalia,BEL,Belgium,2010,89,19,70
SOM,Somalia,BEL,Belgium,2012,409,103,306
SOM,Somalia,BEL,Belgium,2013,300,121,179
SOM,Somalia,BEL,Belgium,2014,364,102,262
SOM,Somalia,BEL,Belgium,2015,1985,101,1884
SOM,Somalia,BEL,Belgium,2016,843,63,780
SOM,Somalia,BEL,Belgium,2017,636,170,466
SOM,Somalia,CAN,Canada,2008,1014,0,1014
SOM,Somalia,CAN,Canada,2009,1214,0,1214
SOM,Somalia,CAN,Canada,2010,1526,0,1526
SOM,Somalia,CAN,Canada,2011,1532,0,1532
SOM,Somalia,CAN,Canada,2012,1574,0,1574
SOM,Somalia,CAN,Canada,2013,2029,0,2029
SOM,Somalia,CAN,Canada,2014,1491,0,1491
SOM,Somalia,CAN,Canada,2015,1157,0,1157
SOM,Somalia,CAN,Canada,2016,1310,0,1310
SOM,Somalia,CAN,Canada,2017,1390,0,1390
SOM,Somalia,CZE,Czech Republic,2008,12,0,12
SOM,Somalia,CZE,Czech Republic,2010,1,1,0
SOM,Somalia,CZE,Czech Republic,2011,1,1,0
SOM,Somalia,CZE,Czech Republic,2012,2,0,2
SOM,Somalia,CZE,Czech Republic,2014,1,6,-5
SOM,Somalia,CZE,Czech Republic,2015,1,0,1
SOM,Somalia,CZE,Czech Republic,2016,1,0,1
SOM,Somalia,DNK,Denmark,2008,82,46,36
SOM,Somalia,DNK,Denmark,2009,80,88,-8
SOM,Somalia,DNK,Denmark,2010,79,60,19
SOM,Somalia,DNK,Denmark,2011,135,62,73
SOM,Somalia,DNK,Denmark,2012,332,53,279
SOM,Somalia,DNK,Denmark,2013,585,65,520
SOM,Somalia,DNK,Denmark,2014,789,61,728
SOM,Somalia,DNK,Denmark,2015,482,58,424
SOM,Somalia,DNK,Denmark,2016,242,63,179
SOM,Somalia,DNK,Denmark,2017,157,199,-42
SOM,Somalia,FIN,Finland,2008,601,48,553
SOM,Somalia,FIN,Finland,2009,840,20,820
SOM,Somalia,FIN,Finland,2010,1041,9,1032
SOM,Somalia,FIN,Finland,2011,745,6,739
SOM,Somalia,FIN,Finland,2012,445,22,423
SOM,Somalia,FIN,Finland,2013,724,55,669
SOM,Somalia,FIN,Finland,2014,633,161,472
SOM,Somalia,FIN,Finland,2015,654,88,566
SOM,Somalia,FIN,Finland,2016,693,88,605
SOM,Somalia,FIN,Finland,2017,517,38,479
SOM,Somalia,FRA,France,2008,81,0,81
SOM,Somalia,FRA,France,2009,133,0,133
SOM,Somalia,FRA,France,2010,215,0,215
SOM,Somalia,FRA,France,2011,223,0,223
SOM,Somalia,FRA,France,2012,251,0,251
SOM,Somalia,FRA,France,2013,208,0,208
SOM,Somalia,FRA,France,2014,284,0,284
SOM,Somalia,FRA,France,2015,197,0,197
SOM,Somalia,FRA,France,2016,297,0,297
SOM,Somalia,FRA,France,2017,510,0,510
SOM,Somalia,DEU,Germany,2008,255,263,-8
SOM,Somalia,DEU,Germany,2009,441,289,152
SOM,Somalia,DEU,Germany,2010,2486,439,2047
SOM,Somalia,DEU,Germany,2011,1266,893,373
SOM,Somalia,DEU,Germany,2012,1519,631,888
SOM,Somalia,DEU,Germany,2013,4174,455,3719
SOM,Somalia,DEU,Germany,2014,6464,1304,5160
SOM,Somalia,DEU,Germany,2015,9653,2362,7291
SOM,Somalia,DEU,Germany,2016,8537,4058,4479
SOM,Somalia,DEU,Germany,2017,6383,2780,3603
SOM,Somalia,HUN,Hungary,2008,0,1,-1
SOM,Somalia,HUN,Hungary,2009,0,0,0
SOM,Somalia,HUN,Hungary,2010,1,0,1
SOM,Somalia,HUN,Hungary,2011,0,0,0
SOM,Somalia,HUN,Hungary,2012,0,0,0
SOM,Somalia,HUN,Hungary,2013,0,0,0
SOM,Somalia,HUN,Hungary,2014,69,0,69
SOM,Somalia,HUN,Hungary,2015,60,0,60
SOM,Somalia,HUN,Hungary,2016,31,0,31
SOM,Somalia,HUN,Hungary,2017,11,0,11
SOM,Somalia,ISL,Iceland,2008,0,0,0
SOM,Somalia,ISL,Iceland,2009,0,0,0
SOM,Somalia,ISL,Iceland,2010,0,0,0
SOM,Somalia,ISL,Iceland,2011,0,0,0
SOM,Somalia,ISL,Iceland,2012,1,0,1
SOM,Somalia,ISL,Iceland,2013,0,0,0
SOM,Somalia,ISL,Iceland,2014,0,0,0
SOM,Somalia,ISL,Iceland,2015,3,0,3
SOM,Somalia,ISL,Iceland,2016,3,0,3
SOM,Somalia,ISL,Iceland,2017,5,0,5
SOM,Somalia,ITA,Italy,2008,1070,20,1050
SOM,Somalia,ITA,Italy,2009,1545,20,1525
SOM,Somalia,ITA,Italy,2010,1185,26,1159
SOM,Somalia,ITA,Italy,2011,711,34,677
SOM,Somalia,ITA,Italy,2012,868,34,834
SOM,Somalia,ITA,Italy,2013,982,33,949
SOM,Somalia,ITA,Italy,2014,1664,77,1587
SOM,Somalia,ITA,Italy,2015,1395,98,1297
SOM,Somalia,ITA,Italy,2016,1230,0,1230
SOM,Somalia,ITA,Italy,2017,2119,72,2047
SOM,Somalia,JPN,Japan,2008,1,0,1
SOM,Somalia,JPN,Japan,2009,1,1,0
SOM,Somalia,JPN,Japan,2010,0,0,0
SOM,Somalia,JPN,Japan,2011,2,0,2
SOM,Somalia,JPN,Japan,2012,0,0,0
SOM,Somalia,JPN,Japan,2013,13,12,1
SOM,Somalia,JPN,Japan,2014,21,19,2
SOM,Somalia,JPN,Japan,2015,16,15,1
SOM,Somalia,JPN,Japan,2016,20,15,5
SOM,Somalia,JPN,Japan,2017,13,11,2
SOM,Somalia,KOR,Korea,2008,0,2,-2
SOM,Somalia,KOR,Korea,2009,0,0,0
SOM,Somalia,KOR,Korea,2010,2,1,1
SOM,Somalia,KOR,Korea,2011,5,1,4
SOM,Somalia,KOR,Korea,2012,4,1,3
SOM,Somalia,KOR,Korea,2013,2,1,1
SOM,Somalia,KOR,Korea,2014,2,4,-2
SOM,Somalia,KOR,Korea,2015,5,2,3
SOM,Somalia,KOR,Korea,2016,5,4,1
SOM,Somalia,KOR,Korea,2017,4,3,1
SOM,Somalia,LUX,Luxembourg,2008,8,5,3
SOM,Somalia,LUX,Luxembourg,2009,4,1,3
SOM,Somalia,LUX,Luxembourg,2010,26,1,25
SOM,Somalia,LUX,Luxembourg,2011,6,11,-5
SOM,Somalia,LUX,Luxembourg,2012,8,0,8
SOM,Somalia,LUX,Luxembourg,2013,6,2,4
SOM,Somalia,LUX,Luxembourg,2014,4,3,1
SOM,Somalia,LUX,Luxembourg,2015,8,4,4
SOM,Somalia,LUX,Luxembourg,2016,5,6,-1
SOM,Somalia,LUX,Luxembourg,2017,11,7,4
SOM,Somalia,MEX,Mexico,2008,1,0,1
SOM,Somalia,MEX,Mexico,2009,1,0,1
SOM,Somalia,MEX,Mexico,2012,0,0,0
SOM,Somalia,MEX,Mexico,2013,0,0,0
SOM,Somalia,MEX,Mexico,2014,0,0,0
SOM,Somalia,NLD,Netherlands,2008,19,38,-19
SOM,Somalia,NLD,Netherlands,2009,36,-6,42
SOM,Somalia,NLD,Netherlands,2010,25,9,16
SOM,Somalia,NLD,Netherlands,2011,25,14,11
SOM,Somalia,NLD,Netherlands,2012,133,7,126
SOM,Somalia,NLD,Netherlands,2013,988,9,979
SOM,Somalia,NLD,Netherlands,2014,1216,17,1199
SOM,Somalia,NLD,Netherlands,2015,628,22,606
SOM,Somalia,NLD,Netherlands,2016,433,17,416
SOM,Somalia,NLD,Netherlands,2017,222,25,197
SOM,Somalia,NZL,New Zealand,2008,22,0,22
SOM,Somalia,NZL,New Zealand,2009,23,0,23
SOM,Somalia,NZL,New Zealand,2010,29,0,29
SOM,Somalia,NZL,New Zealand,2011,22,0,22
SOM,Somalia,NZL,New Zealand,2012,34,0,34
SOM,Somalia,NZL,New Zealand,2013,19,0,19
SOM,Somalia,NZL,New Zealand,2014,57,0,57
SOM,Somalia,NZL,New Zealand,2015,64,0,64
SOM,Somalia,NZL,New Zealand,2016,26,1,25
SOM,Somalia,NZL,New Zealand,2017,32,1,31
SOM,Somalia,NOR,Norway,2008,1231,113,1118
SOM,Somalia,NOR,Norway,2009,1270,106,1164
SOM,Somalia,NOR,Norway,2010,1641,207,1434
SOM,Somalia,NOR,Norway,2011,1704,253,1451
SOM,Somalia,NOR,Norway,2012,3607,213,3394
SOM,Somalia,NOR,Norway,2013,2765,190,2575
SOM,Somalia,NOR,Norway,2014,1653,200,1453
SOM,Somalia,NOR,Norway,2015,1884,249,1635
SOM,Somalia,NOR,Norway,2016,911,222,689
SOM,Somalia,NOR,Norway,2017,57,200,-143
SOM,Somalia,POL,Poland,2009,7,0,7
SOM,Somalia,POL,Poland,2010,7,0,7
SOM,Somalia,POL,Poland,2011,6,0,6
SOM,Somalia,POL,Poland,2012,15,0,15
SOM,Somalia,POL,Poland,2013,9,0,9
SOM,Somalia,POL,Poland,2014,5,0,5
SOM,Somalia,POL,Poland,2015,19,0,19
SOM,Somalia,POL,Poland,2016,17,0,17
SOM,Somalia,POL,Poland,2017,7,0,7
SOM,Somalia,SVK,Slovak Republic,2008,2,5,-3
SOM,Somalia,SVK,Slovak Republic,2009,6,1,5
SOM,Somalia,SVK,Slovak Republic,2010,26,2,24
SOM,Somalia,SVK,Slovak Republic,2011,18,0,18
SOM,Somalia,SVK,Slovak Republic,2014,2,0,2
SOM,Somalia,SVK,Slovak Republic,2015,1,0,1
SOM,Somalia,ESP,Spain,2008,97,7,90
SOM,Somalia,ESP,Spain,2009,53,31,22
SOM,Somalia,ESP,Spain,2010,21,48,-27
SOM,Somalia,ESP,Spain,2011,19,49,-30
SOM,Somalia,ESP,Spain,2012,20,33,-13
SOM,Somalia,ESP,Spain,2013,48,11,37
SOM,Somalia,ESP,Spain,2014,47,8,39
SOM,Somalia,ESP,Spain,2015,72,16,56
SOM,Somalia,ESP,Spain,2016,100,12,88
SOM,Somalia,ESP,Spain,2017,46,23,23
SOM,Somalia,SWE,Sweden,2008,4064,259,3805
SOM,Somalia,SWE,Sweden,2009,6902,133,6769
SOM,Somalia,SWE,Sweden,2010,6819,328,6491
SOM,Somalia,SWE,Sweden,2011,3082,358,2724
SOM,Somalia,SWE,Sweden,2012,4541,447,4094
SOM,Somalia,SWE,Sweden,2013,10966,371,10595
SOM,Somalia,SWE,Sweden,2014,4241,368,3873
SOM,Somalia,SWE,Sweden,2015,3500,496,3004
SOM,Somalia,SWE,Sweden,2016,3811,288,3523
SOM,Somalia,SWE,Sweden,2017,2837,191,2646
SOM,Somalia,CHE,Switzerland,2010,455,7,448
SOM,Somalia,CHE,Switzerland,2011,400,12,388
SOM,Somalia,CHE,Switzerland,2012,306,18,288
SOM,Somalia,CHE,Switzerland,2013,502,20,482
SOM,Somalia,CHE,Switzerland,2014,536,25,511
SOM,Somalia,CHE,Switzerland,2015,420,18,402
SOM,Somalia,CHE,Switzerland,2016,443,32,411
SOM,Somalia,CHE,Switzerland,2017,351,33,318
SOM,Somalia,TUR,Turkey,2010,213,0,213
SOM,Somalia,TUR,Turkey,2016,701,793,-92
SOM,Somalia,TUR,Turkey,2017,1452,609,843
SOM,Somalia,GBR,United Kingdom,2012,1000,0,1000
SOM,Somalia,USA,United States,2008,10745,0,10745
SOM,Somalia,USA,United States,2009,13390,0,13390
SOM,Somalia,USA,United States,2010,4558,0,4558
SOM,Somalia,USA,United States,2011,4451,0,4451
SOM,Somalia,USA,United States,2012,5204,0,5204
SOM,Somalia,USA,United States,2013,3764,0,3764
SOM,Somalia,USA,United States,2014,5190,0,5190
SOM,Somalia,USA,United States,2015,6796,0,6796
SOM,Somalia,USA,United States,2016,6958,0,6958
SOM,Somalia,USA,United States,2017,7404,0,7404
SOM,Somalia,CHL,Chile,2008,0,0,0
SOM,Somalia,CHL,Chile,2009,0,0,0
SOM,Somalia,CHL,Chile,2010,2,0,2
SOM,Somalia,CHL,Chile,2011,0,0,0
SOM,Somalia,CHL,Chile,2012,0,0,0
SOM,Somalia,CHL,Chile,2013,0,0,0
SOM,Somalia,CHL,Chile,2014,0,0,0
SOM,Somalia,CHL,Chile,2015,0,0,0
SOM,Somalia,CHL,Chile,2016,0,0,0
SOM,Somalia,EST,Estonia,2008,0,0,0
SOM,Somalia,EST,Estonia,2009,0,0,0
SOM,Somalia,EST,Estonia,2010,0,0,0
SOM,Somalia,EST,Estonia,2011,0,0,0
SOM,Somalia,EST,Estonia,2012,0,0,0
SOM,Somalia,EST,Estonia,2013,0,0,0
SOM,Somalia,EST,Estonia,2014,0,0,0
SOM,Somalia,EST,Estonia,2015,0,0,0
SOM,Somalia,EST,Estonia,2016,1,0,1
SOM,Somalia,EST,Estonia,2017,1,0,1
SOM,Somalia,SVN,Slovenia,2015,1,0,1
ZAF,South Africa,AUS,Australia,2008,6936,824,6112
ZAF,South Africa,AUS,Australia,2009,11264,733,10531
ZAF,South Africa,AUS,Australia,2010,11098,895,10203
ZAF,South Africa,AUS,Australia,2011,8089,896,7193
ZAF,South Africa,AUS,Australia,2012,8033,916,7117
ZAF,South Africa,AUS,Australia,2013,5798,1022,4776
ZAF,South Africa,AUS,Australia,2014,4883,1067,3816
ZAF,South Africa,AUS,Australia,2015,4669,1200,3469
ZAF,South Africa,AUS,Australia,2016,3975,1100,2875
ZAF,South Africa,AUS,Australia,2017,4783,0,4783
ZAF,South Africa,AUT,Austria,2008,65,50,15
ZAF,South Africa,AUT,Austria,2009,75,61,14
ZAF,South Africa,AUT,Austria,2010,75,44,31
ZAF,South Africa,AUT,Austria,2011,44,45,-1
ZAF,South Africa,AUT,Austria,2012,61,42,19
ZAF,South Africa,AUT,Austria,2013,70,27,43
ZAF,South Africa,AUT,Austria,2014,65,47,18
ZAF,South Africa,AUT,Austria,2015,99,36,63
ZAF,South Africa,AUT,Austria,2016,95,43,52
ZAF,South Africa,AUT,Austria,2017,112,39,73
ZAF,South Africa,BEL,Belgium,2008,213,0,213
ZAF,South Africa,BEL,Belgium,2009,156,0,156
ZAF,South Africa,BEL,Belgium,2010,182,100,82
ZAF,South Africa,BEL,Belgium,2011,207,167,40
ZAF,South Africa,BEL,Belgium,2012,172,159,13
ZAF,South Africa,BEL,Belgium,2013,159,141,18
ZAF,South Africa,BEL,Belgium,2014,103,85,18
ZAF,South Africa,BEL,Belgium,2015,117,70,47
ZAF,South Africa,BEL,Belgium,2016,166,77,89
ZAF,South Africa,BEL,Belgium,2017,193,63,130
ZAF,South Africa,CAN,Canada,2008,1122,0,1122
ZAF,South Africa,CAN,Canada,2009,1188,0,1188
ZAF,South Africa,CAN,Canada,2010,1238,0,1238
ZAF,South Africa,CAN,Canada,2011,959,0,959
ZAF,South Africa,CAN,Canada,2012,1242,0,1242
ZAF,South Africa,CAN,Canada,2013,1238,0,1238
ZAF,South Africa,CAN,Canada,2014,1001,0,1001
ZAF,South Africa,CAN,Canada,2015,960,0,960
ZAF,South Africa,CAN,Canada,2016,1075,0,1075
ZAF,South Africa,CAN,Canada,2017,1570,0,1570
ZAF,South Africa,CZE,Czech Republic,2008,75,0,75
ZAF,South Africa,CZE,Czech Republic,2009,42,1,41
ZAF,South Africa,CZE,Czech Republic,2010,35,0,35
ZAF,South Africa,CZE,Czech Republic,2011,20,0,20
ZAF,South Africa,CZE,Czech Republic,2012,38,20,18
ZAF,South Africa,CZE,Czech Republic,2013,18,23,-5
ZAF,South Africa,CZE,Czech Republic,2014,39,32,7
ZAF,South Africa,CZE,Czech Republic,2015,38,25,13
ZAF,South Africa,CZE,Czech Republic,2016,47,24,23
ZAF,South Africa,CZE,Czech Republic,2017,78,21,57
ZAF,South Africa,DNK,Denmark,2008,47,39,8
ZAF,South Africa,DNK,Denmark,2009,53,23,30
ZAF,South Africa,DNK,Denmark,2010,48,31,17
ZAF,South Africa,DNK,Denmark,2011,38,38,0
ZAF,South Africa,DNK,Denmark,2012,37,41,-4
ZAF,South Africa,DNK,Denmark,2013,44,26,18
ZAF,South Africa,DNK,Denmark,2014,48,35,13
ZAF,South Africa,DNK,Denmark,2015,81,33,48
ZAF,South Africa,DNK,Denmark,2016,90,36,54
ZAF,South Africa,DNK,Denmark,2017,90,26,64
ZAF,South Africa,FIN,Finland,2008,27,15,12
ZAF,South Africa,FIN,Finland,2009,25,11,14
ZAF,South Africa,FIN,Finland,2010,30,10,20
ZAF,South Africa,FIN,Finland,2011,15,12,3
ZAF,South Africa,FIN,Finland,2012,22,10,12
ZAF,South Africa,FIN,Finland,2013,14,8,6
ZAF,South Africa,FIN,Finland,2014,20,9,11
ZAF,South Africa,FIN,Finland,2015,13,6,7
ZAF,South Africa,FIN,Finland,2016,14,2,12
ZAF,South Africa,FIN,Finland,2017,32,10,22
ZAF,South Africa,FRA,France,2008,168,0,168
ZAF,South Africa,FRA,France,2009,193,0,193
ZAF,South Africa,FRA,France,2010,174,0,174
ZAF,South Africa,FRA,France,2011,179,0,179
ZAF,South Africa,FRA,France,2012,191,0,191
ZAF,South Africa,FRA,France,2013,191,0,191
ZAF,South Africa,FRA,France,2014,192,0,192
ZAF,South Africa,FRA,France,2015,272,0,272
ZAF,South Africa,FRA,France,2016,259,0,259
ZAF,South Africa,FRA,France,2017,271,0,271
ZAF,South Africa,DEU,Germany,2008,886,956,-70
ZAF,South Africa,DEU,Germany,2009,699,800,-101
ZAF,South Africa,DEU,Germany,2010,698,640,58
ZAF,South Africa,DEU,Germany,2011,804,540,264
ZAF,South Africa,DEU,Germany,2012,760,507,253
ZAF,South Africa,DEU,Germany,2013,810,559,251
ZAF,South Africa,DEU,Germany,2014,785,543,242
ZAF,South Africa,DEU,Germany,2015,882,511,371
ZAF,South Africa,DEU,Germany,2016,914,480,434
ZAF,South Africa,DEU,Germany,2017,1128,466,662
ZAF,South Africa,HUN,Hungary,2008,39,3,36
ZAF,South Africa,HUN,Hungary,2009,10,4,6
ZAF,South Africa,HUN,Hungary,2010,31,6,25
ZAF,South Africa,HUN,Hungary,2011,22,1,21
ZAF,South Africa,HUN,Hungary,2012,16,1,15
ZAF,South Africa,HUN,Hungary,2013,11,0,11
ZAF,South Africa,HUN,Hungary,2014,26,1,25
ZAF,South Africa,HUN,Hungary,2015,20,3,17
ZAF,South Africa,HUN,Hungary,2016,33,2,31
ZAF,South Africa,HUN,Hungary,2017,88,0,88
ZAF,South Africa,ISL,Iceland,2008,3,1,2
ZAF,South Africa,ISL,Iceland,2009,5,2,3
ZAF,South Africa,ISL,Iceland,2010,2,3,-1
ZAF,South Africa,ISL,Iceland,2011,10,1,9
ZAF,South Africa,ISL,Iceland,2012,10,1,9
ZAF,South Africa,ISL,Iceland,2013,2,8,-6
ZAF,South Africa,ISL,Iceland,2014,2,7,-5
ZAF,South Africa,ISL,Iceland,2015,2,1,1
ZAF,South Africa,ISL,Iceland,2016,8,3,5
ZAF,South Africa,ISL,Iceland,2017,7,5,2
ZAF,South Africa,ITA,Italy,2008,99,4,95
ZAF,South Africa,ITA,Italy,2009,77,6,71
ZAF,South Africa,ITA,Italy,2010,69,7,62
ZAF,South Africa,ITA,Italy,2011,59,9,50
ZAF,South Africa,ITA,Italy,2012,73,8,65
ZAF,South Africa,ITA,Italy,2013,97,12,85
ZAF,South Africa,ITA,Italy,2014,106,21,85
ZAF,South Africa,ITA,Italy,2015,61,58,3
ZAF,South Africa,ITA,Italy,2016,59,0,59
ZAF,South Africa,ITA,Italy,2017,84,14,70
ZAF,South Africa,JPN,Japan,2008,590,518,72
ZAF,South Africa,JPN,Japan,2009,333,357,-24
ZAF,South Africa,JPN,Japan,2010,371,349,22
ZAF,South Africa,JPN,Japan,2011,371,340,31
ZAF,South Africa,JPN,Japan,2012,425,357,68
ZAF,South Africa,JPN,Japan,2013,523,473,50
ZAF,South Africa,JPN,Japan,2014,417,335,82
ZAF,South Africa,JPN,Japan,2015,516,419,97
ZAF,South Africa,JPN,Japan,2016,699,529,170
ZAF,South Africa,JPN,Japan,2017,775,602,173
ZAF,South Africa,KOR,Korea,2008,788,436,352
ZAF,South Africa,KOR,Korea,2009,909,584,325
ZAF,South Africa,KOR,Korea,2010,765,728,37
ZAF,South Africa,KOR,Korea,2011,919,736,183
ZAF,South Africa,KOR,Korea,2012,959,792,167
ZAF,South Africa,KOR,Korea,2013,750,869,-119
ZAF,South Africa,KOR,Korea,2014,705,720,-15
ZAF,South Africa,KOR,Korea,2015,618,720,-102
ZAF,South Africa,KOR,Korea,2016,873,634,239
ZAF,South Africa,KOR,Korea,2017,866,784,82
ZAF,South Africa,LUX,Luxembourg,2008,44,6,38
ZAF,South Africa,LUX,Luxembourg,2009,22,14,8
ZAF,South Africa,LUX,Luxembourg,2010,26,3,23
ZAF,South Africa,LUX,Luxembourg,2011,23,9,14
ZAF,South Africa,LUX,Luxembourg,2012,26,14,12
ZAF,South Africa,LUX,Luxembourg,2013,28,21,7
ZAF,South Africa,LUX,Luxembourg,2014,10,11,-1
ZAF,South Africa,LUX,Luxembourg,2015,23,8,15
ZAF,South Africa,LUX,Luxembourg,2016,20,7,13
ZAF,South Africa,LUX,Luxembourg,2017,59,15,44
ZAF,South Africa,MEX,Mexico,2008,14,0,14
ZAF,South Africa,MEX,Mexico,2009,15,0,15
ZAF,South Africa,MEX,Mexico,2010,14,0,14
ZAF,South Africa,MEX,Mexico,2011,15,0,15
ZAF,South Africa,MEX,Mexico,2012,19,0,19
ZAF,South Africa,MEX,Mexico,2013,33,0,33
ZAF,South Africa,MEX,Mexico,2014,28,0,28
ZAF,South Africa,MEX,Mexico,2015,20,0,20
ZAF,South Africa,MEX,Mexico,2016,27,0,27
ZAF,South Africa,MEX,Mexico,2017,14,0,14
ZAF,South Africa,NLD,Netherlands,2008,873,561,312
ZAF,South Africa,NLD,Netherlands,2009,670,576,94
ZAF,South Africa,NLD,Netherlands,2010,586,615,-29
ZAF,South Africa,NLD,Netherlands,2011,658,482,176
ZAF,South Africa,NLD,Netherlands,2012,614,564,50
ZAF,South Africa,NLD,Netherlands,2013,630,528,102
ZAF,South Africa,NLD,Netherlands,2014,696,484,212
ZAF,South Africa,NLD,Netherlands,2015,820,529,291
ZAF,South Africa,NLD,Netherlands,2016,1110,615,495
ZAF,South Africa,NLD,Netherlands,2017,1124,584,540
ZAF,South Africa,NZL,New Zealand,2008,3087,493,2594
ZAF,South Africa,NZL,New Zealand,2009,1742,674,1068
ZAF,South Africa,NZL,New Zealand,2010,1225,736,489
ZAF,South Africa,NZL,New Zealand,2011,1231,668,563
ZAF,South Africa,NZL,New Zealand,2012,1135,503,632
ZAF,South Africa,NZL,New Zealand,2013,1215,354,861
ZAF,South Africa,NZL,New Zealand,2014,1593,237,1356
ZAF,South Africa,NZL,New Zealand,2015,2273,168,2105
ZAF,South Africa,NZL,New Zealand,2016,4494,213,4281
ZAF,South Africa,NZL,New Zealand,2017,5200,296,4904
ZAF,South Africa,NOR,Norway,2008,63,39,24
ZAF,South Africa,NOR,Norway,2009,67,41,26
ZAF,South Africa,NOR,Norway,2010,59,51,8
ZAF,South Africa,NOR,Norway,2011,59,58,1
ZAF,South Africa,NOR,Norway,2012,80,30,50
ZAF,South Africa,NOR,Norway,2013,64,44,20
ZAF,South Africa,NOR,Norway,2014,58,43,15
ZAF,South Africa,NOR,Norway,2015,52,28,24
ZAF,South Africa,NOR,Norway,2016,59,43,16
ZAF,South Africa,NOR,Norway,2017,570,17,553
ZAF,South Africa,POL,Poland,2008,69,0,69
ZAF,South Africa,POL,Poland,2009,61,0,61
ZAF,South Africa,POL,Poland,2010,76,0,76
ZAF,South Africa,POL,Poland,2011,58,0,58
ZAF,South Africa,POL,Poland,2012,73,0,73
ZAF,South Africa,POL,Poland,2013,0,0,0
ZAF,South Africa,POL,Poland,2014,28,0,28
ZAF,South Africa,POL,Poland,2015,69,0,69
ZAF,South Africa,POL,Poland,2016,63,0,63
ZAF,South Africa,POL,Poland,2017,45,0,45
ZAF,South Africa,SVK,Slovak Republic,2008,6,10,-4
ZAF,South Africa,SVK,Slovak Republic,2009,3,3,0
ZAF,South Africa,SVK,Slovak Republic,2010,3,1,2
ZAF,South Africa,SVK,Slovak Republic,2011,4,4,0
ZAF,South Africa,SVK,Slovak Republic,2012,3,0,3
ZAF,South Africa,SVK,Slovak Republic,2013,2,0,2
ZAF,South Africa,SVK,Slovak Republic,2014,2,0,2
ZAF,South Africa,SVK,Slovak Republic,2015,3,0,3
ZAF,South Africa,SVK,Slovak Republic,2016,1,0,1
ZAF,South Africa,ESP,Spain,2008,132,68,64
ZAF,South Africa,ESP,Spain,2009,83,53,30
ZAF,South Africa,ESP,Spain,2010,104,59,45
ZAF,South Africa,ESP,Spain,2011,158,68,90
ZAF,South Africa,ESP,Spain,2012,162,46,116
ZAF,South Africa,ESP,Spain,2013,161,66,95
ZAF,South Africa,ESP,Spain,2014,152,66,86
ZAF,South Africa,ESP,Spain,2015,156,55,101
ZAF,South Africa,ESP,Spain,2016,196,52,144
ZAF,South Africa,ESP,Spain,2017,209,109,100
ZAF,South Africa,SWE,Sweden,2008,100,47,53
ZAF,South Africa,SWE,Sweden,2009,96,39,57
ZAF,South Africa,SWE,Sweden,2010,78,37,41
ZAF,South Africa,SWE,Sweden,2011,97,31,66
ZAF,South Africa,SWE,Sweden,2012,89,48,41
ZAF,South Africa,SWE,Sweden,2013,68,24,44
ZAF,South Africa,SWE,Sweden,2014,104,37,67
ZAF,South Africa,SWE,Sweden,2015,116,48,68
ZAF,South Africa,SWE,Sweden,2016,169,27,142
ZAF,South Africa,SWE,Sweden,2017,169,31,138
ZAF,South Africa,CHE,Switzerland,2010,253,143,110
ZAF,South Africa,CHE,Switzerland,2011,244,186,58
ZAF,South Africa,CHE,Switzerland,2012,236,141,95
ZAF,South Africa,CHE,Switzerland,2013,211,175,36
ZAF,South Africa,CHE,Switzerland,2014,184,131,53
ZAF,South Africa,CHE,Switzerland,2015,192,96,96
ZAF,South Africa,CHE,Switzerland,2016,236,132,104
ZAF,South Africa,CHE,Switzerland,2017,187,152,35
ZAF,South Africa,TUR,Turkey,2010,24,0,24
ZAF,South Africa,TUR,Turkey,2016,238,127,111
ZAF,South Africa,TUR,Turkey,2017,229,137,92
ZAF,South Africa,GBR,United Kingdom,2008,14000,6000,8000
ZAF,South Africa,GBR,United Kingdom,2009,8000,4000,4000
ZAF,South Africa,GBR,United Kingdom,2011,4000,2000,2000
ZAF,South Africa,GBR,United Kingdom,2012,3000,2000,1000
ZAF,South Africa,GBR,United Kingdom,2013,2000,2000,0
ZAF,South Africa,GBR,United Kingdom,2014,4000,1000,3000
ZAF,South Africa,GBR,United Kingdom,2015,4000,1000,3000
ZAF,South Africa,GBR,United Kingdom,2016,6000,0,6000
ZAF,South Africa,USA,United States,2008,2723,0,2723
ZAF,South Africa,USA,United States,2009,3171,0,3171
ZAF,South Africa,USA,United States,2010,2758,0,2758
ZAF,South Africa,USA,United States,2011,2649,0,2649
ZAF,South Africa,USA,United States,2012,2781,0,2781
ZAF,South Africa,USA,United States,2013,2629,0,2629
ZAF,South Africa,USA,United States,2014,2676,0,2676
ZAF,South Africa,USA,United States,2015,2907,0,2907
ZAF,South Africa,USA,United States,2016,3023,0,3023
ZAF,South Africa,USA,United States,2017,2912,0,2912
ZAF,South Africa,CHL,Chile,2008,55,0,55
ZAF,South Africa,CHL,Chile,2009,67,0,67
ZAF,South Africa,CHL,Chile,2010,36,0,36
ZAF,South Africa,CHL,Chile,2011,36,0,36
ZAF,South Africa,CHL,Chile,2012,54,0,54
ZAF,South Africa,CHL,Chile,2013,70,0,70
ZAF,South Africa,CHL,Chile,2014,47,0,47
ZAF,South Africa,CHL,Chile,2015,56,0,56
ZAF,South Africa,CHL,Chile,2016,27,0,27
ZAF,South Africa,EST,Estonia,2008,5,0,5
ZAF,South Africa,EST,Estonia,2009,0,0,0
ZAF,South Africa,EST,Estonia,2010,6,0,6
ZAF,South Africa,EST,Estonia,2011,2,0,2
ZAF,South Africa,EST,Estonia,2012,1,0,1
ZAF,South Africa,EST,Estonia,2013,1,0,1
ZAF,South Africa,EST,Estonia,2014,2,0,2
ZAF,South Africa,EST,Estonia,2015,0,0,0
ZAF,South Africa,EST,Estonia,2016,4,0,4
ZAF,South Africa,EST,Estonia,2017,6,0,6
ZAF,South Africa,ISR,Israel,2008,257,0,257
ZAF,South Africa,ISR,Israel,2009,274,0,274
ZAF,South Africa,ISR,Israel,2010,212,0,212
ZAF,South Africa,ISR,Israel,2011,174,0,174
ZAF,South Africa,ISR,Israel,2012,125,0,125
ZAF,South Africa,ISR,Israel,2013,161,0,161
ZAF,South Africa,ISR,Israel,2014,117,0,117
ZAF,South Africa,ISR,Israel,2015,189,0,189
ZAF,South Africa,ISR,Israel,2016,220,0,220
ZAF,South Africa,ISR,Israel,2017,281,0,281
ZAF,South Africa,SVN,Slovenia,2009,2,0,2
ZAF,South Africa,SVN,Slovenia,2011,2,0,2
ZAF,South Africa,SVN,Slovenia,2012,3,0,3
ZAF,South Africa,SVN,Slovenia,2013,6,0,6
ZAF,South Africa,SVN,Slovenia,2014,4,0,4
ZAF,South Africa,SVN,Slovenia,2015,2,0,2
ZAF,South Africa,SVN,Slovenia,2016,2,0,2
ZAF,South Africa,SVN,Slovenia,2017,10,0,10
ESP,Spain,AUS,Australia,2008,145,307,-162
ESP,Spain,AUS,Australia,2009,211,274,-63
ESP,Spain,AUS,Australia,2010,194,243,-49
ESP,Spain,AUS,Australia,2011,243,353,-110
ESP,Spain,AUS,Australia,2012,297,344,-47
ESP,Spain,AUS,Australia,2013,383,351,32
ESP,Spain,AUS,Australia,2014,440,367,73
ESP,Spain,AUS,Australia,2015,552,411,141
ESP,Spain,AUS,Australia,2016,477,429,48
ESP,Spain,AUS,Australia,2017,502,554,-52
ESP,Spain,AUT,Austria,2008,567,845,-278
ESP,Spain,AUT,Austria,2009,660,676,-16
ESP,Spain,AUT,Austria,2010,839,658,181
ESP,Spain,AUT,Austria,2011,984,620,364
ESP,Spain,AUT,Austria,2012,1430,607,823
ESP,Spain,AUT,Austria,2013,1816,584,1232
ESP,Spain,AUT,Austria,2014,1570,553,1017
ESP,Spain,AUT,Austria,2015,1613,539,1074
ESP,Spain,AUT,Austria,2016,1480,584,896
ESP,Spain,AUT,Austria,2017,1443,743,700
ESP,Spain,BEL,Belgium,2008,2829,1914,915
ESP,Spain,BEL,Belgium,2009,3592,1726,1866
ESP,Spain,BEL,Belgium,2010,4618,1844,2774
ESP,Spain,BEL,Belgium,2011,5288,1975,3313
ESP,Spain,BEL,Belgium,2012,5999,2198,3801
ESP,Spain,BEL,Belgium,2013,6130,2319,3811
ESP,Spain,BEL,Belgium,2014,5024,2266,2758
ESP,Spain,BEL,Belgium,2015,4137,2705,1432
ESP,Spain,BEL,Belgium,2016,3668,2964,704
ESP,Spain,BEL,Belgium,2017,4044,3803,241
ESP,Spain,CAN,Canada,2008,168,417,-249
ESP,Spain,CAN,Canada,2009,195,407,-212
ESP,Spain,CAN,Canada,2010,174,493,-319
ESP,Spain,CAN,Canada,2011,179,662,-483
ESP,Spain,CAN,Canada,2012,259,636,-377
ESP,Spain,CAN,Canada,2013,330,678,-348
ESP,Spain,CAN,Canada,2014,494,684,-190
ESP,Spain,CAN,Canada,2015,709,713,-4
ESP,Spain,CAN,Canada,2016,645,731,-86
ESP,Spain,CAN,Canada,2017,675,883,-208
ESP,Spain,CZE,Czech Republic,2008,98,792,-694
ESP,Spain,CZE,Czech Republic,2009,65,671,-606
ESP,Spain,CZE,Czech Republic,2010,112,670,-558
ESP,Spain,CZE,Czech Republic,2011,74,685,-611
ESP,Spain,CZE,Czech Republic,2012,103,605,-502
ESP,Spain,CZE,Czech Republic,2013,131,531,-400
ESP,Spain,CZE,Czech Republic,2014,145,606,-461
ESP,Spain,CZE,Czech Republic,2015,112,618,-506
ESP,Spain,CZE,Czech Republic,2016,141,556,-415
ESP,Spain,CZE,Czech Republic,2017,151,606,-455
ESP,Spain,DNK,Denmark,2008,481,728,-247
ESP,Spain,DNK,Denmark,2009,466,586,-120
ESP,Spain,DNK,Denmark,2010,685,639,46
ESP,Spain,DNK,Denmark,2011,754,658,96
ESP,Spain,DNK,Denmark,2012,890,773,117
ESP,Spain,DNK,Denmark,2013,1005,668,337
ESP,Spain,DNK,Denmark,2014,1084,707,377
ESP,Spain,DNK,Denmark,2015,1030,707,323
ESP,Spain,DNK,Denmark,2016,1110,737,373
ESP,Spain,DNK,Denmark,2017,1136,896,240
ESP,Spain,FIN,Finland,2008,208,707,-499
ESP,Spain,FIN,Finland,2009,126,670,-544
ESP,Spain,FIN,Finland,2010,143,931,-788
ESP,Spain,FIN,Finland,2011,183,967,-784
ESP,Spain,FIN,Finland,2012,258,912,-654
ESP,Spain,FIN,Finland,2013,396,868,-472
ESP,Spain,FIN,Finland,2014,445,881,-436
ESP,Spain,FIN,Finland,2015,284,855,-571
ESP,Spain,FIN,Finland,2016,269,910,-641
ESP,Spain,FIN,Finland,2017,243,1077,-834
ESP,Spain,FRA,France,2008,0,8898,-8898
ESP,Spain,FRA,France,2009,0,7742,-7742
ESP,Spain,FRA,France,2010,0,7788,-7788
ESP,Spain,FRA,France,2011,0,7807,-7807
ESP,Spain,FRA,France,2012,0,7431,-7431
ESP,Spain,FRA,France,2013,13665,7287,6378
ESP,Spain,FRA,France,2014,12874,8095,4779
ESP,Spain,FRA,France,2015,12363,9020,3343
ESP,Spain,FRA,France,2016,10658,9338,1320
ESP,Spain,FRA,France,2017,10849,11410,-561
ESP,Spain,DEU,Germany,2008,7778,11282,-3504
ESP,Spain,DEU,Germany,2009,8965,9268,-303
ESP,Spain,DEU,Germany,2010,10657,8319,2338
ESP,Spain,DEU,Germany,2011,16168,8263,7905
ESP,Spain,DEU,Germany,2012,23345,8005,15340
ESP,Spain,DEU,Germany,2013,28980,7241,21739
ESP,Spain,DEU,Germany,2014,27072,6823,20249
ESP,Spain,DEU,Germany,2015,23598,6745,16853
ESP,Spain,DEU,Germany,2016,21922,7253,14669
ESP,Spain,DEU,Germany,2017,18537,9097,9440
ESP,Spain,HUN,Hungary,2008,107,1205,-1098
ESP,Spain,HUN,Hungary,2009,141,888,-747
ESP,Spain,HUN,Hungary,2010,191,855,-664
ESP,Spain,HUN,Hungary,2011,161,997,-836
ESP,Spain,HUN,Hungary,2012,214,997,-783
ESP,Spain,HUN,Hungary,2013,257,938,-681
ESP,Spain,HUN,Hungary,2014,277,916,-639
ESP,Spain,HUN,Hungary,2015,322,959,-637
ESP,Spain,HUN,Hungary,2016,265,1025,-760
ESP,Spain,HUN,Hungary,2017,278,1225,-947
ESP,Spain,ISL,Iceland,2008,53,135,-82
ESP,Spain,ISL,Iceland,2009,61,76,-15
ESP,Spain,ISL,Iceland,2010,84,99,-15
ESP,Spain,ISL,Iceland,2011,59,138,-79
ESP,Spain,ISL,Iceland,2012,64,107,-43
ESP,Spain,ISL,Iceland,2013,152,109,43
ESP,Spain,ISL,Iceland,2014,200,127,73
ESP,Spain,ISL,Iceland,2015,178,179,-1
ESP,Spain,ISL,Iceland,2016,213,174,39
ESP,Spain,ISL,Iceland,2017,288,237,51
ESP,Spain,ITA,Italy,2008,1512,15882,-14370
ESP,Spain,ITA,Italy,2009,1386,11763,-10377
ESP,Spain,ITA,Italy,2010,1514,11196,-9682
ESP,Spain,ITA,Italy,2011,1666,11643,-9977
ESP,Spain,ITA,Italy,2012,1956,12016,-10060
ESP,Spain,ITA,Italy,2013,1836,12183,-10347
ESP,Spain,ITA,Italy,2014,1830,14890,-13060
ESP,Spain,ITA,Italy,2015,1906,18645,-16739
ESP,Spain,ITA,Italy,2016,2075,21667,-19592
ESP,Spain,ITA,Italy,2017,1972,28702,-26730
ESP,Spain,JPN,Japan,2008,1139,572,567
ESP,Spain,JPN,Japan,2009,1177,562,615
ESP,Spain,JPN,Japan,2010,1007,558,449
ESP,Spain,JPN,Japan,2011,1028,737,291
ESP,Spain,JPN,Japan,2012,1248,794,454
ESP,Spain,JPN,Japan,2013,1480,717,763
ESP,Spain,JPN,Japan,2014,1506,701,805
ESP,Spain,JPN,Japan,2015,1827,710,1117
ESP,Spain,JPN,Japan,2016,1884,679,1205
ESP,Spain,JPN,Japan,2017,1937,766,1171
ESP,Spain,KOR,Korea,2008,149,359,-210
ESP,Spain,KOR,Korea,2009,132,268,-136
ESP,Spain,KOR,Korea,2010,182,356,-174
ESP,Spain,KOR,Korea,2011,211,590,-379
ESP,Spain,KOR,Korea,2012,290,687,-397
ESP,Spain,KOR,Korea,2013,233,662,-429
ESP,Spain,KOR,Korea,2014,255,610,-355
ESP,Spain,KOR,Korea,2015,244,627,-383
ESP,Spain,KOR,Korea,2016,294,612,-318
ESP,Spain,KOR,Korea,2017,286,718,-432
ESP,Spain,LUX,Luxembourg,2008,248,52,196
ESP,Spain,LUX,Luxembourg,2009,236,44,192
ESP,Spain,LUX,Luxembourg,2010,308,48,260
ESP,Spain,LUX,Luxembourg,2011,455,41,414
ESP,Spain,LUX,Luxembourg,2012,494,49,445
ESP,Spain,LUX,Luxembourg,2013,563,43,520
ESP,Spain,LUX,Luxembourg,2014,579,48,531
ESP,Spain,LUX,Luxembourg,2015,689,52,637
ESP,Spain,LUX,Luxembourg,2016,771,57,714
ESP,Spain,LUX,Luxembourg,2017,795,72,723
ESP,Spain,MEX,Mexico,2008,566,4832,-4266
ESP,Spain,MEX,Mexico,2009,865,3815,-2950
ESP,Spain,MEX,Mexico,2010,969,3921,-2952
ESP,Spain,MEX,Mexico,2011,841,4591,-3750
ESP,Spain,MEX,Mexico,2012,980,4294,-3314
ESP,Spain,MEX,Mexico,2013,2607,3332,-725
ESP,Spain,MEX,Mexico,2014,1767,3555,-1788
ESP,Spain,MEX,Mexico,2015,1596,3914,-2318
ESP,Spain,MEX,Mexico,2016,1706,3849,-2143
ESP,Spain,MEX,Mexico,2017,1489,5077,-3588
ESP,Spain,NLD,Netherlands,2008,2279,3796,-1517
ESP,Spain,NLD,Netherlands,2009,2631,2994,-363
ESP,Spain,NLD,Netherlands,2010,3149,2987,162
ESP,Spain,NLD,Netherlands,2011,3680,3153,527
ESP,Spain,NLD,Netherlands,2012,4645,2887,1758
ESP,Spain,NLD,Netherlands,2013,5256,2915,2341
ESP,Spain,NLD,Netherlands,2014,5047,2973,2074
ESP,Spain,NLD,Netherlands,2015,4957,3251,1706
ESP,Spain,NLD,Netherlands,2016,5160,3703,1457
ESP,Spain,NLD,Netherlands,2017,5851,4363,1488
ESP,Spain,NZL,New Zealand,2008,55,98,-43
ESP,Spain,NZL,New Zealand,2009,65,53,12
ESP,Spain,NZL,New Zealand,2010,92,84,8
ESP,Spain,NZL,New Zealand,2011,178,103,75
ESP,Spain,NZL,New Zealand,2012,144,111,33
ESP,Spain,NZL,New Zealand,2013,238,109,129
ESP,Spain,NZL,New Zealand,2014,224,81,143
ESP,Spain,NZL,New Zealand,2015,209,101,108
ESP,Spain,NZL,New Zealand,2016,229,137,92
ESP,Spain,NZL,New Zealand,2017,264,144,120
ESP,Spain,NOR,Norway,2008,384,1084,-700
ESP,Spain,NOR,Norway,2009,477,1164,-687
ESP,Spain,NOR,Norway,2010,751,1330,-579
ESP,Spain,NOR,Norway,2011,973,1386,-413
ESP,Spain,NOR,Norway,2012,1370,1316,54
ESP,Spain,NOR,Norway,2013,1535,1218,317
ESP,Spain,NOR,Norway,2014,1437,1229,208
ESP,Spain,NOR,Norway,2015,1272,1027,245
ESP,Spain,NOR,Norway,2016,1099,1056,43
ESP,Spain,NOR,Norway,2017,954,1179,-225
ESP,Spain,POL,Poland,2008,246,6698,-6452
ESP,Spain,POL,Poland,2009,312,3714,-3402
ESP,Spain,POL,Poland,2010,373,3431,-3058
ESP,Spain,POL,Poland,2011,424,3329,-2905
ESP,Spain,POL,Poland,2012,625,2801,-2176
ESP,Spain,POL,Poland,2013,904,2645,-1741
ESP,Spain,POL,Poland,2014,904,2440,-1536
ESP,Spain,POL,Poland,2015,776,2460,-1684
ESP,Spain,POL,Poland,2016,610,2613,-2003
ESP,Spain,POL,Poland,2017,650,3249,-2599
ESP,Spain,PRT,Portugal,2008,1310,13954,-12644
ESP,Spain,PRT,Portugal,2009,1465,7885,-6420
ESP,Spain,PRT,Portugal,2010,1664,6153,-4489
ESP,Spain,PRT,Portugal,2011,1533,6132,-4599
ESP,Spain,PRT,Portugal,2012,1356,5202,-3846
ESP,Spain,PRT,Portugal,2013,1474,4499,-3025
ESP,Spain,PRT,Portugal,2014,1452,4554,-3102
ESP,Spain,PRT,Portugal,2015,1662,5026,-3364
ESP,Spain,PRT,Portugal,2016,2214,5949,-3735
ESP,Spain,PRT,Portugal,2017,2738,7554,-4816
ESP,Spain,SVK,Slovak Republic,2008,63,649,-586
ESP,Spain,SVK,Slovak Republic,2009,110,417,-307
ESP,Spain,SVK,Slovak Republic,2010,63,459,-396
ESP,Spain,SVK,Slovak Republic,2011,64,503,-439
ESP,Spain,SVK,Slovak Republic,2012,57,446,-389
ESP,Spain,SVK,Slovak Republic,2013,39,430,-391
ESP,Spain,SVK,Slovak Republic,2014,42,366,-324
ESP,Spain,SVK,Slovak Republic,2015,85,384,-299
ESP,Spain,SVK,Slovak Republic,2016,85,389,-304
ESP,Spain,SVK,Slovak Republic,2017,81,504,-423
ESP,Spain,SWE,Sweden,2008,611,1556,-945
ESP,Spain,SWE,Sweden,2009,702,1433,-731
ESP,Spain,SWE,Sweden,2010,674,1665,-991
ESP,Spain,SWE,Sweden,2011,762,1635,-873
ESP,Spain,SWE,Sweden,2012,1052,1715,-663
ESP,Spain,SWE,Sweden,2013,1387,1593,-206
ESP,Spain,SWE,Sweden,2014,1421,1700,-279
ESP,Spain,SWE,Sweden,2015,1286,1673,-387
ESP,Spain,SWE,Sweden,2016,1343,1876,-533
ESP,Spain,SWE,Sweden,2017,1378,2285,-907
ESP,Spain,CHE,Switzerland,2008,2365,906,1459
ESP,Spain,CHE,Switzerland,2009,2480,871,1609
ESP,Spain,CHE,Switzerland,2010,3258,890,2368
ESP,Spain,CHE,Switzerland,2011,4584,876,3708
ESP,Spain,CHE,Switzerland,2012,6525,937,5588
ESP,Spain,CHE,Switzerland,2013,8778,869,7909
ESP,Spain,CHE,Switzerland,2014,7593,910,6683
ESP,Spain,CHE,Switzerland,2015,7042,1031,6011
ESP,Spain,CHE,Switzerland,2016,5787,1119,4668
ESP,Spain,CHE,Switzerland,2017,5243,1499,3744
ESP,Spain,TUR,Turkey,2010,199,427,-228
ESP,Spain,TUR,Turkey,2016,391,706,-315
ESP,Spain,TUR,Turkey,2017,304,1078,-774
ESP,Spain,GBR,United Kingdom,2009,11000,17938,-6938
ESP,Spain,GBR,United Kingdom,2010,5000,16173,-11173
ESP,Spain,GBR,United Kingdom,2011,8000,15731,-7731
ESP,Spain,GBR,United Kingdom,2012,17000,16375,625
ESP,Spain,GBR,United Kingdom,2013,21000,14145,6855
ESP,Spain,GBR,United Kingdom,2014,21000,14230,6770
ESP,Spain,GBR,United Kingdom,2015,20000,14991,5009
ESP,Spain,GBR,United Kingdom,2016,18000,18549,-549
ESP,Spain,GBR,United Kingdom,2017,18000,21186,-3186
ESP,Spain,USA,United States,2008,1621,3690,-2069
ESP,Spain,USA,United States,2009,1769,3492,-1723
ESP,Spain,USA,United States,2010,1684,3695,-2011
ESP,Spain,USA,United States,2011,1890,5019,-3129
ESP,Spain,USA,United States,2012,1842,4946,-3104
ESP,Spain,USA,United States,2013,2480,5527,-3047
ESP,Spain,USA,United States,2014,2928,5290,-2362
ESP,Spain,USA,United States,2015,3303,5626,-2323
ESP,Spain,USA,United States,2016,3519,5918,-2399
ESP,Spain,USA,United States,2017,3045,7548,-4503
ESP,Spain,CHL,Chile,2008,554,5197,-4643
ESP,Spain,CHL,Chile,2009,580,3060,-2480
ESP,Spain,CHL,Chile,2010,699,2757,-2058
ESP,Spain,CHL,Chile,2011,950,2669,-1719
ESP,Spain,CHL,Chile,2012,2068,2005,63
ESP,Spain,CHL,Chile,2013,4109,1647,2462
ESP,Spain,CHL,Chile,2014,3410,1885,1525
ESP,Spain,CHL,Chile,2015,2519,2122,397
ESP,Spain,CHL,Chile,2016,1860,2705,-845
ESP,Spain,EST,Estonia,2008,40,177,-137
ESP,Spain,EST,Estonia,2009,38,178,-140
ESP,Spain,EST,Estonia,2010,8,215,-207
ESP,Spain,EST,Estonia,2011,0,230,-230
ESP,Spain,EST,Estonia,2012,1,287,-286
ESP,Spain,EST,Estonia,2013,2,321,-319
ESP,Spain,EST,Estonia,2014,1,282,-281
ESP,Spain,EST,Estonia,2015,143,334,-191
ESP,Spain,EST,Estonia,2016,157,362,-205
ESP,Spain,EST,Estonia,2017,199,393,-194
ESP,Spain,ISR,Israel,2008,22,232,-210
ESP,Spain,ISR,Israel,2009,29,259,-230
ESP,Spain,ISR,Israel,2010,35,196,-161
ESP,Spain,ISR,Israel,2011,53,279,-226
ESP,Spain,ISR,Israel,2012,76,262,-186
ESP,Spain,ISR,Israel,2013,70,241,-171
ESP,Spain,ISR,Israel,2014,77,250,-173
ESP,Spain,ISR,Israel,2015,87,261,-174
ESP,Spain,ISR,Israel,2016,74,328,-254
ESP,Spain,ISR,Israel,2017,90,432,-342
ESP,Spain,SVN,Slovenia,2008,96,173,-77
ESP,Spain,SVN,Slovenia,2009,129,122,7
ESP,Spain,SVN,Slovenia,2010,1,134,-133
ESP,Spain,SVN,Slovenia,2011,244,168,76
ESP,Spain,SVN,Slovenia,2012,278,156,122
ESP,Spain,SVN,Slovenia,2013,283,171,112
ESP,Spain,SVN,Slovenia,2014,283,158,125
ESP,Spain,SVN,Slovenia,2015,299,202,97
ESP,Spain,SVN,Slovenia,2016,281,201,80
ESP,Spain,SVN,Slovenia,2017,344,233,111
LKA,Sri Lanka,AUS,Australia,2008,4795,409,4386
LKA,Sri Lanka,AUS,Australia,2009,4808,336,4472
LKA,Sri Lanka,AUS,Australia,2010,5245,417,4828
LKA,Sri Lanka,AUS,Australia,2011,4529,528,4001
LKA,Sri Lanka,AUS,Australia,2012,5722,519,5203
LKA,Sri Lanka,AUS,Australia,2013,5343,457,4886
LKA,Sri Lanka,AUS,Australia,2014,4525,502,4023
LKA,Sri Lanka,AUS,Australia,2015,3857,500,3357
LKA,Sri Lanka,AUS,Australia,2016,3819,500,3319
LKA,Sri Lanka,AUS,Australia,2017,3191,0,3191
LKA,Sri Lanka,AUT,Austria,2008,50,29,21
LKA,Sri Lanka,AUT,Austria,2009,51,27,24
LKA,Sri Lanka,AUT,Austria,2010,30,35,-5
LKA,Sri Lanka,AUT,Austria,2011,36,30,6
LKA,Sri Lanka,AUT,Austria,2012,20,19,1
LKA,Sri Lanka,AUT,Austria,2013,46,20,26
LKA,Sri Lanka,AUT,Austria,2014,47,19,28
LKA,Sri Lanka,AUT,Austria,2015,44,24,20
LKA,Sri Lanka,AUT,Austria,2016,52,27,25
LKA,Sri Lanka,AUT,Austria,2017,68,28,40
LKA,Sri Lanka,BEL,Belgium,2008,53,0,53
LKA,Sri Lanka,BEL,Belgium,2009,54,0,54
LKA,Sri Lanka,BEL,Belgium,2010,71,22,49
LKA,Sri Lanka,BEL,Belgium,2012,138,89,49
LKA,Sri Lanka,BEL,Belgium,2013,127,93,34
LKA,Sri Lanka,BEL,Belgium,2014,145,66,79
LKA,Sri Lanka,BEL,Belgium,2015,184,36,148
LKA,Sri Lanka,BEL,Belgium,2016,127,34,93
LKA,Sri Lanka,BEL,Belgium,2017,120,21,99
LKA,Sri Lanka,CAN,Canada,2008,4751,0,4751
LKA,Sri Lanka,CAN,Canada,2009,4543,0,4543
LKA,Sri Lanka,CAN,Canada,2010,4419,0,4419
LKA,Sri Lanka,CAN,Canada,2011,3309,0,3309
LKA,Sri Lanka,CAN,Canada,2012,3338,0,3338
LKA,Sri Lanka,CAN,Canada,2013,2394,0,2394
LKA,Sri Lanka,CAN,Canada,2014,2604,0,2604
LKA,Sri Lanka,CAN,Canada,2015,1795,0,1795
LKA,Sri Lanka,CAN,Canada,2016,1545,0,1545
LKA,Sri Lanka,CAN,Canada,2017,2150,0,2150
LKA,Sri Lanka,CZE,Czech Republic,2008,14,1,13
LKA,Sri Lanka,CZE,Czech Republic,2009,17,0,17
LKA,Sri Lanka,CZE,Czech Republic,2010,9,0,9
LKA,Sri Lanka,CZE,Czech Republic,2011,5,0,5
LKA,Sri Lanka,CZE,Czech Republic,2012,14,5,9
LKA,Sri Lanka,CZE,Czech Republic,2013,12,13,-1
LKA,Sri Lanka,CZE,Czech Republic,2014,19,5,14
LKA,Sri Lanka,CZE,Czech Republic,2015,14,14,0
LKA,Sri Lanka,CZE,Czech Republic,2016,25,14,11
LKA,Sri Lanka,CZE,Czech Republic,2017,25,6,19
LKA,Sri Lanka,DNK,Denmark,2008,90,38,52
LKA,Sri Lanka,DNK,Denmark,2009,106,53,53
LKA,Sri Lanka,DNK,Denmark,2010,96,36,60
LKA,Sri Lanka,DNK,Denmark,2011,70,26,44
LKA,Sri Lanka,DNK,Denmark,2012,54,28,26
LKA,Sri Lanka,DNK,Denmark,2013,113,28,85
LKA,Sri Lanka,DNK,Denmark,2014,120,19,101
LKA,Sri Lanka,DNK,Denmark,2015,84,38,46
LKA,Sri Lanka,DNK,Denmark,2016,76,80,-4
LKA,Sri Lanka,DNK,Denmark,2017,76,38,38
LKA,Sri Lanka,FIN,Finland,2008,74,3,71
LKA,Sri Lanka,FIN,Finland,2009,94,2,92
LKA,Sri Lanka,FIN,Finland,2010,43,5,38
LKA,Sri Lanka,FIN,Finland,2011,89,5,84
LKA,Sri Lanka,FIN,Finland,2012,96,6,90
LKA,Sri Lanka,FIN,Finland,2013,64,3,61
LKA,Sri Lanka,FIN,Finland,2014,60,9,51
LKA,Sri Lanka,FIN,Finland,2015,48,6,42
LKA,Sri Lanka,FIN,Finland,2016,58,8,50
LKA,Sri Lanka,FIN,Finland,2017,43,11,32
LKA,Sri Lanka,FRA,France,2008,1937,0,1937
LKA,Sri Lanka,FRA,France,2009,2849,0,2849
LKA,Sri Lanka,FRA,France,2010,2719,0,2719
LKA,Sri Lanka,FRA,France,2011,2415,0,2415
LKA,Sri Lanka,FRA,France,2012,2452,0,2452
LKA,Sri Lanka,FRA,France,2013,2461,0,2461
LKA,Sri Lanka,FRA,France,2014,2534,0,2534
LKA,Sri Lanka,FRA,France,2015,2335,0,2335
LKA,Sri Lanka,FRA,France,2016,2545,0,2545
LKA,Sri Lanka,FRA,France,2017,2242,0,2242
LKA,Sri Lanka,DEU,Germany,2008,1090,866,224
LKA,Sri Lanka,DEU,Germany,2009,1212,879,333
LKA,Sri Lanka,DEU,Germany,2010,1181,724,457
LKA,Sri Lanka,DEU,Germany,2011,1332,576,756
LKA,Sri Lanka,DEU,Germany,2012,1248,554,694
LKA,Sri Lanka,DEU,Germany,2013,1290,591,699
LKA,Sri Lanka,DEU,Germany,2014,1214,511,703
LKA,Sri Lanka,DEU,Germany,2015,1178,534,644
LKA,Sri Lanka,DEU,Germany,2016,1065,555,510
LKA,Sri Lanka,DEU,Germany,2017,1221,497,724
LKA,Sri Lanka,HUN,Hungary,2008,6,0,6
LKA,Sri Lanka,HUN,Hungary,2009,4,0,4
LKA,Sri Lanka,HUN,Hungary,2010,3,2,1
LKA,Sri Lanka,HUN,Hungary,2011,6,1,5
LKA,Sri Lanka,HUN,Hungary,2012,6,0,6
LKA,Sri Lanka,HUN,Hungary,2013,10,2,8
LKA,Sri Lanka,HUN,Hungary,2014,9,0,9
LKA,Sri Lanka,HUN,Hungary,2015,11,2,9
LKA,Sri Lanka,HUN,Hungary,2016,11,5,6
LKA,Sri Lanka,HUN,Hungary,2017,19,0,19
LKA,Sri Lanka,ISL,Iceland,2008,9,10,-1
LKA,Sri Lanka,ISL,Iceland,2009,7,3,4
LKA,Sri Lanka,ISL,Iceland,2010,4,4,0
LKA,Sri Lanka,ISL,Iceland,2011,4,4,0
LKA,Sri Lanka,ISL,Iceland,2012,7,3,4
LKA,Sri Lanka,ISL,Iceland,2013,7,4,3
LKA,Sri Lanka,ISL,Iceland,2014,6,7,-1
LKA,Sri Lanka,ISL,Iceland,2015,11,6,5
LKA,Sri Lanka,ISL,Iceland,2016,3,4,-1
LKA,Sri Lanka,ISL,Iceland,2017,6,3,3
LKA,Sri Lanka,ITA,Italy,2008,6610,270,6340
LKA,Sri Lanka,ITA,Italy,2009,6317,326,5991
LKA,Sri Lanka,ITA,Italy,2010,7105,442,6663
LKA,Sri Lanka,ITA,Italy,2011,6789,497,6292
LKA,Sri Lanka,ITA,Italy,2012,7138,596,6542
LKA,Sri Lanka,ITA,Italy,2013,6286,692,5594
LKA,Sri Lanka,ITA,Italy,2014,5255,588,4667
LKA,Sri Lanka,ITA,Italy,2015,4848,554,4294
LKA,Sri Lanka,ITA,Italy,2016,3968,0,3968
LKA,Sri Lanka,ITA,Italy,2017,3732,509,3223
LKA,Sri Lanka,JPN,Japan,2008,1145,637,508
LKA,Sri Lanka,JPN,Japan,2009,1309,668,641
LKA,Sri Lanka,JPN,Japan,2010,1200,635,565
LKA,Sri Lanka,JPN,Japan,2011,1364,779,585
LKA,Sri Lanka,JPN,Japan,2012,1472,798,674
LKA,Sri Lanka,JPN,Japan,2013,1538,713,825
LKA,Sri Lanka,JPN,Japan,2014,2159,669,1490
LKA,Sri Lanka,JPN,Japan,2015,3064,667,2397
LKA,Sri Lanka,JPN,Japan,2016,4682,820,3862
LKA,Sri Lanka,JPN,Japan,2017,5551,1026,4525
LKA,Sri Lanka,KOR,Korea,2008,4795,2252,2543
LKA,Sri Lanka,KOR,Korea,2009,1722,2184,-462
LKA,Sri Lanka,KOR,Korea,2010,4202,1846,2356
LKA,Sri Lanka,KOR,Korea,2011,5892,2974,2918
LKA,Sri Lanka,KOR,Korea,2012,4675,3819,856
LKA,Sri Lanka,KOR,Korea,2013,5274,4160,1114
LKA,Sri Lanka,KOR,Korea,2014,4836,2241,2595
LKA,Sri Lanka,KOR,Korea,2015,5462,4876,586
LKA,Sri Lanka,KOR,Korea,2016,7093,6005,1088
LKA,Sri Lanka,KOR,Korea,2017,3878,4596,-718
LKA,Sri Lanka,LUX,Luxembourg,2008,1,1,0
LKA,Sri Lanka,LUX,Luxembourg,2009,2,0,2
LKA,Sri Lanka,LUX,Luxembourg,2010,5,0,5
LKA,Sri Lanka,LUX,Luxembourg,2011,3,1,2
LKA,Sri Lanka,LUX,Luxembourg,2012,2,1,1
LKA,Sri Lanka,LUX,Luxembourg,2013,7,0,7
LKA,Sri Lanka,LUX,Luxembourg,2014,2,0,2
LKA,Sri Lanka,LUX,Luxembourg,2015,4,0,4
LKA,Sri Lanka,LUX,Luxembourg,2016,2,0,2
LKA,Sri Lanka,LUX,Luxembourg,2017,0,1,-1
LKA,Sri Lanka,MEX,Mexico,2010,2,0,2
LKA,Sri Lanka,MEX,Mexico,2011,4,0,4
LKA,Sri Lanka,MEX,Mexico,2012,7,0,7
LKA,Sri Lanka,MEX,Mexico,2013,1,0,1
LKA,Sri Lanka,MEX,Mexico,2014,11,0,11
LKA,Sri Lanka,MEX,Mexico,2015,7,0,7
LKA,Sri Lanka,MEX,Mexico,2017,2,0,2
LKA,Sri Lanka,NLD,Netherlands,2008,149,70,79
LKA,Sri Lanka,NLD,Netherlands,2009,120,57,63
LKA,Sri Lanka,NLD,Netherlands,2010,142,72,70
LKA,Sri Lanka,NLD,Netherlands,2011,161,79,82
LKA,Sri Lanka,NLD,Netherlands,2012,151,56,95
LKA,Sri Lanka,NLD,Netherlands,2013,158,66,92
LKA,Sri Lanka,NLD,Netherlands,2014,199,38,161
LKA,Sri Lanka,NLD,Netherlands,2015,147,56,91
LKA,Sri Lanka,NLD,Netherlands,2016,154,49,105
LKA,Sri Lanka,NLD,Netherlands,2017,124,50,74
LKA,Sri Lanka,NZL,New Zealand,2008,667,54,613
LKA,Sri Lanka,NZL,New Zealand,2009,523,89,434
LKA,Sri Lanka,NZL,New Zealand,2010,585,125,460
LKA,Sri Lanka,NZL,New Zealand,2011,677,96,581
LKA,Sri Lanka,NZL,New Zealand,2012,785,102,683
LKA,Sri Lanka,NZL,New Zealand,2013,791,118,673
LKA,Sri Lanka,NZL,New Zealand,2014,746,93,653
LKA,Sri Lanka,NZL,New Zealand,2015,1036,131,905
LKA,Sri Lanka,NZL,New Zealand,2016,1128,99,1029
LKA,Sri Lanka,NZL,New Zealand,2017,1329,139,1190
LKA,Sri Lanka,NOR,Norway,2008,293,111,182
LKA,Sri Lanka,NOR,Norway,2009,226,70,156
LKA,Sri Lanka,NOR,Norway,2010,178,94,84
LKA,Sri Lanka,NOR,Norway,2011,204,117,87
LKA,Sri Lanka,NOR,Norway,2012,205,77,128
LKA,Sri Lanka,NOR,Norway,2013,191,94,97
LKA,Sri Lanka,NOR,Norway,2014,137,55,82
LKA,Sri Lanka,NOR,Norway,2015,144,60,84
LKA,Sri Lanka,NOR,Norway,2016,142,57,85
LKA,Sri Lanka,NOR,Norway,2017,125,38,87
LKA,Sri Lanka,POL,Poland,2008,18,0,18
LKA,Sri Lanka,POL,Poland,2009,32,0,32
LKA,Sri Lanka,POL,Poland,2010,32,0,32
LKA,Sri Lanka,POL,Poland,2011,25,0,25
LKA,Sri Lanka,POL,Poland,2012,23,0,23
LKA,Sri Lanka,POL,Poland,2013,41,0,41
LKA,Sri Lanka,POL,Poland,2014,19,0,19
LKA,Sri Lanka,POL,Poland,2015,41,0,41
LKA,Sri Lanka,POL,Poland,2016,38,0,38
LKA,Sri Lanka,POL,Poland,2017,54,0,54
LKA,Sri Lanka,SVK,Slovak Republic,2008,1,0,1
LKA,Sri Lanka,SVK,Slovak Republic,2009,1,0,1
LKA,Sri Lanka,SVK,Slovak Republic,2010,1,4,-3
LKA,Sri Lanka,SVK,Slovak Republic,2011,4,0,4
LKA,Sri Lanka,SVK,Slovak Republic,2014,1,0,1
LKA,Sri Lanka,ESP,Spain,2008,72,18,54
LKA,Sri Lanka,ESP,Spain,2009,50,26,24
LKA,Sri Lanka,ESP,Spain,2010,35,25,10
LKA,Sri Lanka,ESP,Spain,2011,40,18,22
LKA,Sri Lanka,ESP,Spain,2012,38,16,22
LKA,Sri Lanka,ESP,Spain,2013,40,9,31
LKA,Sri Lanka,ESP,Spain,2014,36,13,23
LKA,Sri Lanka,ESP,Spain,2015,23,7,16
LKA,Sri Lanka,ESP,Spain,2016,48,23,25
LKA,Sri Lanka,ESP,Spain,2017,32,35,-3
LKA,Sri Lanka,SWE,Sweden,2008,165,35,130
LKA,Sri Lanka,SWE,Sweden,2009,154,24,130
LKA,Sri Lanka,SWE,Sweden,2010,138,40,98
LKA,Sri Lanka,SWE,Sweden,2011,122,32,90
LKA,Sri Lanka,SWE,Sweden,2012,159,41,118
LKA,Sri Lanka,SWE,Sweden,2013,105,51,54
LKA,Sri Lanka,SWE,Sweden,2014,126,54,72
LKA,Sri Lanka,SWE,Sweden,2015,126,46,80
LKA,Sri Lanka,SWE,Sweden,2016,118,22,96
LKA,Sri Lanka,SWE,Sweden,2017,146,40,106
LKA,Sri Lanka,CHE,Switzerland,2010,673,174,499
LKA,Sri Lanka,CHE,Switzerland,2011,511,167,344
LKA,Sri Lanka,CHE,Switzerland,2012,515,123,392
LKA,Sri Lanka,CHE,Switzerland,2013,593,116,477
LKA,Sri Lanka,CHE,Switzerland,2014,1659,138,1521
LKA,Sri Lanka,CHE,Switzerland,2015,1635,116,1519
LKA,Sri Lanka,CHE,Switzerland,2016,1101,133,968
LKA,Sri Lanka,CHE,Switzerland,2017,811,142,669
LKA,Sri Lanka,GBR,United Kingdom,2008,5000,0,5000
LKA,Sri Lanka,GBR,United Kingdom,2009,7000,0,7000
LKA,Sri Lanka,GBR,United Kingdom,2010,11000,0,11000
LKA,Sri Lanka,GBR,United Kingdom,2011,6000,1000,5000
LKA,Sri Lanka,GBR,United Kingdom,2012,4000,2000,2000
LKA,Sri Lanka,GBR,United Kingdom,2013,1000,2000,-1000
LKA,Sri Lanka,GBR,United Kingdom,2014,2000,1000,1000
LKA,Sri Lanka,GBR,United Kingdom,2015,3000,0,3000
LKA,Sri Lanka,USA,United States,2008,1935,0,1935
LKA,Sri Lanka,USA,United States,2009,2009,0,2009
LKA,Sri Lanka,USA,United States,2010,2036,0,2036
LKA,Sri Lanka,USA,United States,2011,2053,0,2053
LKA,Sri Lanka,USA,United States,2012,1994,0,1994
LKA,Sri Lanka,USA,United States,2013,1847,0,1847
LKA,Sri Lanka,USA,United States,2014,1767,0,1767
LKA,Sri Lanka,USA,United States,2015,1763,0,1763
LKA,Sri Lanka,USA,United States,2016,1913,0,1913
LKA,Sri Lanka,USA,United States,2017,1627,0,1627
LKA,Sri Lanka,CHL,Chile,2008,9,0,9
LKA,Sri Lanka,CHL,Chile,2009,4,0,4
LKA,Sri Lanka,CHL,Chile,2010,3,0,3
LKA,Sri Lanka,CHL,Chile,2011,0,0,0
LKA,Sri Lanka,CHL,Chile,2012,3,0,3
LKA,Sri Lanka,CHL,Chile,2013,2,0,2
LKA,Sri Lanka,CHL,Chile,2014,2,0,2
LKA,Sri Lanka,CHL,Chile,2015,6,0,6
LKA,Sri Lanka,CHL,Chile,2016,3,0,3
LKA,Sri Lanka,EST,Estonia,2008,1,0,1
LKA,Sri Lanka,EST,Estonia,2009,0,0,0
LKA,Sri Lanka,EST,Estonia,2010,0,0,0
LKA,Sri Lanka,EST,Estonia,2011,1,0,1
LKA,Sri Lanka,EST,Estonia,2012,0,0,0
LKA,Sri Lanka,EST,Estonia,2013,4,0,4
LKA,Sri Lanka,EST,Estonia,2014,2,0,2
LKA,Sri Lanka,EST,Estonia,2015,8,0,8
LKA,Sri Lanka,EST,Estonia,2016,5,0,5
LKA,Sri Lanka,EST,Estonia,2017,17,0,17
LKA,Sri Lanka,SVN,Slovenia,2008,1,0,1
LKA,Sri Lanka,SVN,Slovenia,2009,2,0,2
LKA,Sri Lanka,SVN,Slovenia,2012,1,0,1
LKA,Sri Lanka,SVN,Slovenia,2014,1,0,1
LKA,Sri Lanka,SVN,Slovenia,2015,1,0,1
LKA,Sri Lanka,SVN,Slovenia,2017,2,0,2
SDN,Sudan,AUS,Australia,2008,1198,140,1058
SDN,Sudan,AUS,Australia,2009,1071,194,877
SDN,Sudan,AUS,Australia,2010,786,186,600
SDN,Sudan,AUS,Australia,2011,694,229,465
SDN,Sudan,AUS,Australia,2012,406,223,183
SDN,Sudan,AUS,Australia,2013,475,183,292
SDN,Sudan,AUS,Australia,2014,282,175,107
SDN,Sudan,AUS,Australia,2015,216,200,16
SDN,Sudan,AUS,Australia,2016,212,100,112
SDN,Sudan,AUS,Australia,2017,135,0,135
SDN,Sudan,AUT,Austria,2008,57,36,21
SDN,Sudan,AUT,Austria,2009,69,47,22
SDN,Sudan,AUT,Austria,2010,43,50,-7
SDN,Sudan,AUT,Austria,2011,92,33,59
SDN,Sudan,AUT,Austria,2012,81,47,34
SDN,Sudan,AUT,Austria,2013,63,39,24
SDN,Sudan,AUT,Austria,2014,116,31,85
SDN,Sudan,AUT,Austria,2015,123,46,77
SDN,Sudan,AUT,Austria,2016,64,43,21
SDN,Sudan,AUT,Austria,2017,57,56,1
SDN,Sudan,BEL,Belgium,2008,23,0,23
SDN,Sudan,BEL,Belgium,2009,26,0,26
SDN,Sudan,BEL,Belgium,2010,28,8,20
SDN,Sudan,BEL,Belgium,2012,92,58,34
SDN,Sudan,BEL,Belgium,2013,60,29,31
SDN,Sudan,BEL,Belgium,2014,114,34,80
SDN,Sudan,BEL,Belgium,2015,111,36,75
SDN,Sudan,BEL,Belgium,2016,72,38,34
SDN,Sudan,BEL,Belgium,2017,121,23,98
SDN,Sudan,CAN,Canada,2008,620,0,620
SDN,Sudan,CAN,Canada,2009,422,0,422
SDN,Sudan,CAN,Canada,2010,612,0,612
SDN,Sudan,CAN,Canada,2011,530,0,530
SDN,Sudan,CAN,Canada,2012,444,0,444
SDN,Sudan,CAN,Canada,2013,343,0,343
SDN,Sudan,CAN,Canada,2014,484,0,484
SDN,Sudan,CAN,Canada,2015,359,0,359
SDN,Sudan,CAN,Canada,2016,445,0,445
SDN,Sudan,CAN,Canada,2017,430,0,430
SDN,Sudan,CZE,Czech Republic,2008,7,0,7
SDN,Sudan,CZE,Czech Republic,2009,7,0,7
SDN,Sudan,CZE,Czech Republic,2010,2,0,2
SDN,Sudan,CZE,Czech Republic,2011,5,2,3
SDN,Sudan,CZE,Czech Republic,2012,2,3,-1
SDN,Sudan,CZE,Czech Republic,2013,2,5,-3
SDN,Sudan,CZE,Czech Republic,2014,7,1,6
SDN,Sudan,CZE,Czech Republic,2015,9,3,6
SDN,Sudan,CZE,Czech Republic,2016,6,2,4
SDN,Sudan,CZE,Czech Republic,2017,3,3,0
SDN,Sudan,DNK,Denmark,2008,46,11,35
SDN,Sudan,DNK,Denmark,2009,14,5,9
SDN,Sudan,DNK,Denmark,2010,24,12,12
SDN,Sudan,DNK,Denmark,2011,31,8,23
SDN,Sudan,DNK,Denmark,2012,18,9,9
SDN,Sudan,DNK,Denmark,2013,31,13,18
SDN,Sudan,DNK,Denmark,2014,60,9,51
SDN,Sudan,DNK,Denmark,2015,32,7,25
SDN,Sudan,DNK,Denmark,2016,31,20,11
SDN,Sudan,DNK,Denmark,2017,29,9,20
SDN,Sudan,FIN,Finland,2008,27,6,21
SDN,Sudan,FIN,Finland,2009,9,3,6
SDN,Sudan,FIN,Finland,2010,16,7,9
SDN,Sudan,FIN,Finland,2011,10,2,8
SDN,Sudan,FIN,Finland,2012,16,2,14
SDN,Sudan,FIN,Finland,2013,13,0,13
SDN,Sudan,FIN,Finland,2014,63,0,63
SDN,Sudan,FIN,Finland,2015,212,1,211
SDN,Sudan,FIN,Finland,2016,50,3,47
SDN,Sudan,FIN,Finland,2017,27,1,26
SDN,Sudan,FRA,France,2008,241,0,241
SDN,Sudan,FRA,France,2009,237,0,237
SDN,Sudan,FRA,France,2010,274,0,274
SDN,Sudan,FRA,France,2011,328,0,328
SDN,Sudan,FRA,France,2012,356,0,356
SDN,Sudan,FRA,France,2013,297,0,297
SDN,Sudan,FRA,France,2014,308,0,308
SDN,Sudan,FRA,France,2015,772,0,772
SDN,Sudan,FRA,France,2016,1990,0,1990
SDN,Sudan,FRA,France,2017,4047,0,4047
SDN,Sudan,DEU,Germany,2008,429,417,12
SDN,Sudan,DEU,Germany,2009,396,384,12
SDN,Sudan,DEU,Germany,2010,381,341,40
SDN,Sudan,DEU,Germany,2011,259,237,22
SDN,Sudan,DEU,Germany,2012,46,150,-104
SDN,Sudan,DEU,Germany,2013,18,76,-58
SDN,Sudan,DEU,Germany,2014,1497,385,1112
SDN,Sudan,DEU,Germany,2015,5776,844,4932
SDN,Sudan,DEU,Germany,2016,2543,3598,-1055
SDN,Sudan,DEU,Germany,2017,1900,1855,45
SDN,Sudan,HUN,Hungary,2008,10,0,10
SDN,Sudan,HUN,Hungary,2009,12,0,12
SDN,Sudan,HUN,Hungary,2010,4,2,2
SDN,Sudan,HUN,Hungary,2011,4,0,4
SDN,Sudan,HUN,Hungary,2012,7,0,7
SDN,Sudan,HUN,Hungary,2013,12,2,10
SDN,Sudan,HUN,Hungary,2014,25,0,25
SDN,Sudan,HUN,Hungary,2015,43,1,42
SDN,Sudan,HUN,Hungary,2016,24,2,22
SDN,Sudan,HUN,Hungary,2017,42,0,42
SDN,Sudan,ISL,Iceland,2008,0,0,0
SDN,Sudan,ISL,Iceland,2009,0,0,0
SDN,Sudan,ISL,Iceland,2010,0,0,0
SDN,Sudan,ISL,Iceland,2011,0,0,0
SDN,Sudan,ISL,Iceland,2012,0,0,0
SDN,Sudan,ISL,Iceland,2013,0,0,0
SDN,Sudan,ISL,Iceland,2014,1,0,1
SDN,Sudan,ISL,Iceland,2015,1,1,0
SDN,Sudan,ISL,Iceland,2016,1,0,1
SDN,Sudan,ISL,Iceland,2017,1,0,1
SDN,Sudan,ITA,Italy,2008,480,4,476
SDN,Sudan,ITA,Italy,2009,256,5,251
SDN,Sudan,ITA,Italy,2010,128,11,117
SDN,Sudan,ITA,Italy,2011,114,2,112
SDN,Sudan,ITA,Italy,2012,459,14,445
SDN,Sudan,ITA,Italy,2013,217,12,205
SDN,Sudan,ITA,Italy,2014,171,11,160
SDN,Sudan,ITA,Italy,2015,174,13,161
SDN,Sudan,ITA,Italy,2016,169,0,169
SDN,Sudan,ITA,Italy,2017,316,7,309
SDN,Sudan,JPN,Japan,2008,137,123,14
SDN,Sudan,JPN,Japan,2009,121,107,14
SDN,Sudan,JPN,Japan,2010,85,50,35
SDN,Sudan,JPN,Japan,2011,150,138,12
SDN,Sudan,JPN,Japan,2012,210,198,12
SDN,Sudan,JPN,Japan,2013,215,193,22
SDN,Sudan,JPN,Japan,2014,192,177,15
SDN,Sudan,JPN,Japan,2015,245,224,21
SDN,Sudan,JPN,Japan,2016,182,161,21
SDN,Sudan,JPN,Japan,2017,215,207,8
SDN,Sudan,KOR,Korea,2008,69,86,-17
SDN,Sudan,KOR,Korea,2009,85,63,22
SDN,Sudan,KOR,Korea,2010,104,108,-4
SDN,Sudan,KOR,Korea,2011,84,73,11
SDN,Sudan,KOR,Korea,2012,69,80,-11
SDN,Sudan,KOR,Korea,2013,66,64,2
SDN,Sudan,KOR,Korea,2014,62,66,-4
SDN,Sudan,KOR,Korea,2015,71,62,9
SDN,Sudan,KOR,Korea,2016,122,57,65
SDN,Sudan,KOR,Korea,2017,63,59,4
SDN,Sudan,LUX,Luxembourg,2008,0,3,-3
SDN,Sudan,LUX,Luxembourg,2009,2,3,-1
SDN,Sudan,LUX,Luxembourg,2010,6,0,6
SDN,Sudan,LUX,Luxembourg,2011,1,4,-3
SDN,Sudan,LUX,Luxembourg,2012,1,0,1
SDN,Sudan,LUX,Luxembourg,2013,4,0,4
SDN,Sudan,LUX,Luxembourg,2014,5,4,1
SDN,Sudan,LUX,Luxembourg,2015,5,4,1
SDN,Sudan,LUX,Luxembourg,2016,9,2,7
SDN,Sudan,LUX,Luxembourg,2017,18,6,12
SDN,Sudan,MEX,Mexico,2012,0,0,0
SDN,Sudan,MEX,Mexico,2013,0,0,0
SDN,Sudan,MEX,Mexico,2014,0,0,0
SDN,Sudan,NLD,Netherlands,2008,56,22,34
SDN,Sudan,NLD,Netherlands,2009,60,41,19
SDN,Sudan,NLD,Netherlands,2010,71,29,42
SDN,Sudan,NLD,Netherlands,2011,78,28,50
SDN,Sudan,NLD,Netherlands,2012,75,22,53
SDN,Sudan,NLD,Netherlands,2013,62,29,33
SDN,Sudan,NLD,Netherlands,2014,131,30,101
SDN,Sudan,NLD,Netherlands,2015,197,46,151
SDN,Sudan,NLD,Netherlands,2016,238,26,212
SDN,Sudan,NLD,Netherlands,2017,159,60,99
SDN,Sudan,NZL,New Zealand,2008,4,1,3
SDN,Sudan,NZL,New Zealand,2009,26,2,24
SDN,Sudan,NZL,New Zealand,2010,7,0,7
SDN,Sudan,NZL,New Zealand,2011,11,0,11
SDN,Sudan,NZL,New Zealand,2012,9,1,8
SDN,Sudan,NZL,New Zealand,2013,23,1,22
SDN,Sudan,NZL,New Zealand,2014,6,0,6
SDN,Sudan,NZL,New Zealand,2015,11,0,11
SDN,Sudan,NZL,New Zealand,2016,24,1,23
SDN,Sudan,NZL,New Zealand,2017,26,1,25
SDN,Sudan,NOR,Norway,2008,88,10,78
SDN,Sudan,NOR,Norway,2009,133,16,117
SDN,Sudan,NOR,Norway,2010,173,30,143
SDN,Sudan,NOR,Norway,2011,224,40,184
SDN,Sudan,NOR,Norway,2012,493,28,465
SDN,Sudan,NOR,Norway,2013,472,25,447
SDN,Sudan,NOR,Norway,2014,325,19,306
SDN,Sudan,NOR,Norway,2015,557,71,486
SDN,Sudan,NOR,Norway,2016,543,44,499
SDN,Sudan,NOR,Norway,2017,265,31,234
SDN,Sudan,POL,Poland,2009,15,0,15
SDN,Sudan,POL,Poland,2010,13,0,13
SDN,Sudan,POL,Poland,2011,13,0,13
SDN,Sudan,POL,Poland,2012,13,0,13
SDN,Sudan,POL,Poland,2013,16,0,16
SDN,Sudan,POL,Poland,2014,9,0,9
SDN,Sudan,POL,Poland,2015,22,0,22
SDN,Sudan,POL,Poland,2016,17,0,17
SDN,Sudan,POL,Poland,2017,18,0,18
SDN,Sudan,SVK,Slovak Republic,2008,1,1,0
SDN,Sudan,SVK,Slovak Republic,2009,88,5,83
SDN,Sudan,SVK,Slovak Republic,2010,13,7,6
SDN,Sudan,SVK,Slovak Republic,2011,2,4,-2
SDN,Sudan,SVK,Slovak Republic,2012,1,0,1
SDN,Sudan,ESP,Spain,2008,49,43,6
SDN,Sudan,ESP,Spain,2009,29,21,8
SDN,Sudan,ESP,Spain,2010,15,24,-9
SDN,Sudan,ESP,Spain,2011,20,18,2
SDN,Sudan,ESP,Spain,2012,58,20,38
SDN,Sudan,ESP,Spain,2013,26,7,19
SDN,Sudan,ESP,Spain,2014,48,9,39
SDN,Sudan,ESP,Spain,2015,48,7,41
SDN,Sudan,ESP,Spain,2016,38,24,14
SDN,Sudan,ESP,Spain,2017,44,39,5
SDN,Sudan,SWE,Sweden,2008,99,18,81
SDN,Sudan,SWE,Sweden,2009,146,17,129
SDN,Sudan,SWE,Sweden,2010,132,15,117
SDN,Sudan,SWE,Sweden,2011,194,31,163
SDN,Sudan,SWE,Sweden,2012,206,40,166
SDN,Sudan,SWE,Sweden,2013,228,8,220
SDN,Sudan,SWE,Sweden,2014,211,32,179
SDN,Sudan,SWE,Sweden,2015,130,32,98
SDN,Sudan,SWE,Sweden,2016,408,13,395
SDN,Sudan,SWE,Sweden,2017,319,12,307
SDN,Sudan,CHE,Switzerland,2010,28,4,24
SDN,Sudan,CHE,Switzerland,2011,34,13,21
SDN,Sudan,CHE,Switzerland,2012,46,4,42
SDN,Sudan,CHE,Switzerland,2013,39,5,34
SDN,Sudan,CHE,Switzerland,2014,63,4,59
SDN,Sudan,CHE,Switzerland,2015,44,3,41
SDN,Sudan,CHE,Switzerland,2016,59,3,56
SDN,Sudan,CHE,Switzerland,2017,66,9,57
SDN,Sudan,TUR,Turkey,2010,34,0,34
SDN,Sudan,TUR,Turkey,2016,442,149,293
SDN,Sudan,TUR,Turkey,2017,656,188,468
SDN,Sudan,USA,United States,2008,3598,0,3598
SDN,Sudan,USA,United States,2009,3577,0,3577
SDN,Sudan,USA,United States,2010,2397,0,2397
SDN,Sudan,USA,United States,2011,2628,0,2628
SDN,Sudan,USA,United States,2012,2471,0,2471
SDN,Sudan,USA,United States,2013,1945,0,1945
SDN,Sudan,USA,United States,2014,2442,0,2442
SDN,Sudan,USA,United States,2015,3580,0,3580
SDN,Sudan,USA,United States,2016,3159,0,3159
SDN,Sudan,USA,United States,2017,3515,0,3515
SDN,Sudan,CHL,Chile,2008,0,0,0
SDN,Sudan,CHL,Chile,2009,0,0,0
SDN,Sudan,CHL,Chile,2010,0,0,0
SDN,Sudan,CHL,Chile,2011,0,0,0
SDN,Sudan,CHL,Chile,2012,0,0,0
SDN,Sudan,CHL,Chile,2013,0,0,0
SDN,Sudan,CHL,Chile,2014,0,0,0
SDN,Sudan,CHL,Chile,2015,0,0,0
SDN,Sudan,CHL,Chile,2016,0,0,0
SDN,Sudan,EST,Estonia,2008,0,0,0
SDN,Sudan,EST,Estonia,2009,0,0,0
SDN,Sudan,EST,Estonia,2010,0,0,0
SDN,Sudan,EST,Estonia,2011,0,0,0
SDN,Sudan,EST,Estonia,2012,0,0,0
SDN,Sudan,EST,Estonia,2013,1,0,1
SDN,Sudan,EST,Estonia,2014,0,0,0
SDN,Sudan,EST,Estonia,2015,7,0,7
SDN,Sudan,EST,Estonia,2016,5,0,5
SDN,Sudan,EST,Estonia,2017,7,0,7
SDN,Sudan,SVN,Slovenia,2014,1,0,1
SDN,Sudan,SVN,Slovenia,2015,2,0,2
SUR,Suriname,AUS,Australia,2008,4,0,4
SUR,Suriname,AUS,Australia,2009,2,0,2
SUR,Suriname,AUS,Australia,2010,2,0,2
SUR,Suriname,AUS,Australia,2011,4,0,4
SUR,Suriname,AUS,Australia,2012,0,0,0
SUR,Suriname,AUS,Australia,2013,5,0,5
SUR,Suriname,AUS,Australia,2014,0,0,0
SUR,Suriname,AUS,Australia,2015,0,0,0
SUR,Suriname,AUS,Australia,2017,0,0,0
SUR,Suriname,AUT,Austria,2008,2,1,1
SUR,Suriname,AUT,Austria,2009,0,0,0
SUR,Suriname,AUT,Austria,2010,4,1,3
SUR,Suriname,AUT,Austria,2011,1,0,1
SUR,Suriname,AUT,Austria,2012,0,0,0
SUR,Suriname,AUT,Austria,2013,0,1,-1
SUR,Suriname,AUT,Austria,2014,1,2,-1
SUR,Suriname,AUT,Austria,2015,0,1,-1
SUR,Suriname,AUT,Austria,2016,1,0,1
SUR,Suriname,AUT,Austria,2017,0,1,-1
SUR,Suriname,BEL,Belgium,2008,60,0,60
SUR,Suriname,BEL,Belgium,2009,105,0,105
SUR,Suriname,BEL,Belgium,2010,148,23,125
SUR,Suriname,BEL,Belgium,2011,219,0,219
SUR,Suriname,BEL,Belgium,2012,279,61,218
SUR,Suriname,BEL,Belgium,2013,263,92,171
SUR,Suriname,BEL,Belgium,2014,249,57,192
SUR,Suriname,BEL,Belgium,2015,238,72,166
SUR,Suriname,BEL,Belgium,2016,223,64,159
SUR,Suriname,BEL,Belgium,2017,303,52,251
SUR,Suriname,CAN,Canada,2008,9,0,9
SUR,Suriname,CAN,Canada,2009,12,0,12
SUR,Suriname,CAN,Canada,2010,13,0,13
SUR,Suriname,CAN,Canada,2011,11,0,11
SUR,Suriname,CAN,Canada,2012,16,0,16
SUR,Suriname,CAN,Canada,2013,4,0,4
SUR,Suriname,CAN,Canada,2014,6,0,6
SUR,Suriname,CAN,Canada,2015,10,0,10
SUR,Suriname,CAN,Canada,2016,10,0,10
SUR,Suriname,CAN,Canada,2017,5,0,5
SUR,Suriname,CZE,Czech Republic,2012,2,0,2
SUR,Suriname,DNK,Denmark,2008,1,0,1
SUR,Suriname,DNK,Denmark,2009,0,0,0
SUR,Suriname,DNK,Denmark,2010,1,0,1
SUR,Suriname,DNK,Denmark,2012,1,0,1
SUR,Suriname,DNK,Denmark,2013,0,0,0
SUR,Suriname,DNK,Denmark,2014,0,0,0
SUR,Suriname,DNK,Denmark,2015,0,0,0
SUR,Suriname,DNK,Denmark,2016,0,0,0
SUR,Suriname,DNK,Denmark,2017,1,1,0
SUR,Suriname,FIN,Finland,2008,0,0,0
SUR,Suriname,FIN,Finland,2009,0,0,0
SUR,Suriname,FIN,Finland,2010,0,0,0
SUR,Suriname,FIN,Finland,2011,0,0,0
SUR,Suriname,FIN,Finland,2012,0,0,0
SUR,Suriname,FIN,Finland,2013,0,0,0
SUR,Suriname,FIN,Finland,2014,0,0,0
SUR,Suriname,FIN,Finland,2015,0,0,0
SUR,Suriname,FIN,Finland,2016,1,0,1
SUR,Suriname,FIN,Finland,2017,0,0,0
SUR,Suriname,FRA,France,2008,531,0,531
SUR,Suriname,FRA,France,2009,408,0,408
SUR,Suriname,FRA,France,2010,598,0,598
SUR,Suriname,FRA,France,2011,693,0,693
SUR,Suriname,FRA,France,2012,736,0,736
SUR,Suriname,FRA,France,2013,650,0,650
SUR,Suriname,FRA,France,2014,649,0,649
SUR,Suriname,FRA,France,2015,666,0,666
SUR,Suriname,FRA,France,2016,390,0,390
SUR,Suriname,FRA,France,2017,417,0,417
SUR,Suriname,DEU,Germany,2008,10,5,5
SUR,Suriname,DEU,Germany,2009,7,4,3
SUR,Suriname,DEU,Germany,2010,8,9,-1
SUR,Suriname,DEU,Germany,2011,3,4,-1
SUR,Suriname,DEU,Germany,2012,10,5,5
SUR,Suriname,DEU,Germany,2013,7,4,3
SUR,Suriname,DEU,Germany,2014,6,4,2
SUR,Suriname,DEU,Germany,2015,6,5,1
SUR,Suriname,DEU,Germany,2016,10,4,6
SUR,Suriname,DEU,Germany,2017,11,4,7
SUR,Suriname,HUN,Hungary,2008,0,0,0
SUR,Suriname,HUN,Hungary,2009,0,0,0
SUR,Suriname,HUN,Hungary,2010,0,0,0
SUR,Suriname,HUN,Hungary,2011,0,0,0
SUR,Suriname,HUN,Hungary,2012,1,0,1
SUR,Suriname,HUN,Hungary,2013,0,0,0
SUR,Suriname,HUN,Hungary,2014,0,0,0
SUR,Suriname,HUN,Hungary,2015,0,0,0
SUR,Suriname,HUN,Hungary,2016,0,0,0
SUR,Suriname,HUN,Hungary,2017,1,0,1
SUR,Suriname,ISL,Iceland,2008,0,0,0
SUR,Suriname,ISL,Iceland,2009,0,0,0
SUR,Suriname,ISL,Iceland,2010,0,0,0
SUR,Suriname,ISL,Iceland,2011,0,0,0
SUR,Suriname,ISL,Iceland,2012,0,0,0
SUR,Suriname,ISL,Iceland,2016,1,0,1
SUR,Suriname,ISL,Iceland,2017,1,1,0
SUR,Suriname,ITA,Italy,2008,2,0,2
SUR,Suriname,ITA,Italy,2009,1,0,1
SUR,Suriname,ITA,Italy,2010,0,0,0
SUR,Suriname,ITA,Italy,2011,2,0,2
SUR,Suriname,ITA,Italy,2012,0,0,0
SUR,Suriname,ITA,Italy,2013,1,2,-1
SUR,Suriname,ITA,Italy,2014,1,0,1
SUR,Suriname,ITA,Italy,2015,2,0,2
SUR,Suriname,ITA,Italy,2016,5,0,5
SUR,Suriname,ITA,Italy,2017,1,0,1
SUR,Suriname,JPN,Japan,2008,5,5,0
SUR,Suriname,JPN,Japan,2009,2,2,0
SUR,Suriname,JPN,Japan,2010,4,4,0
SUR,Suriname,JPN,Japan,2011,4,4,0
SUR,Suriname,JPN,Japan,2012,2,2,0
SUR,Suriname,JPN,Japan,2013,6,6,0
SUR,Suriname,JPN,Japan,2014,6,6,0
SUR,Suriname,JPN,Japan,2015,3,4,-1
SUR,Suriname,JPN,Japan,2016,4,4,0
SUR,Suriname,JPN,Japan,2017,10,10,0
SUR,Suriname,KOR,Korea,2008,1,1,0
SUR,Suriname,KOR,Korea,2009,0,0,0
SUR,Suriname,KOR,Korea,2010,0,1,-1
SUR,Suriname,KOR,Korea,2011,4,2,2
SUR,Suriname,KOR,Korea,2012,2,4,-2
SUR,Suriname,KOR,Korea,2013,0,0,0
SUR,Suriname,KOR,Korea,2014,2,1,1
SUR,Suriname,KOR,Korea,2015,0,3,-3
SUR,Suriname,KOR,Korea,2016,2,1,1
SUR,Suriname,KOR,Korea,2017,2,1,1
SUR,Suriname,LUX,Luxembourg,2008,0,0,0
SUR,Suriname,LUX,Luxembourg,2009,0,0,0
SUR,Suriname,LUX,Luxembourg,2010,0,0,0
SUR,Suriname,LUX,Luxembourg,2011,0,0,0
SUR,Suriname,LUX,Luxembourg,2012,0,0,0
SUR,Suriname,LUX,Luxembourg,2013,0,0,0
SUR,Suriname,LUX,Luxembourg,2014,0,0,0
SUR,Suriname,LUX,Luxembourg,2015,0,0,0
SUR,Suriname,LUX,Luxembourg,2016,0,0,0
SUR,Suriname,LUX,Luxembourg,2017,0,0,0
SUR,Suriname,MEX,Mexico,2008,1,0,1
SUR,Suriname,MEX,Mexico,2009,1,0,1
SUR,Suriname,MEX,Mexico,2010,1,0,1
SUR,Suriname,MEX,Mexico,2011,3,0,3
SUR,Suriname,MEX,Mexico,2012,0,0,0
SUR,Suriname,MEX,Mexico,2013,1,0,1
SUR,Suriname,MEX,Mexico,2014,1,0,1
SUR,Suriname,MEX,Mexico,2015,1,0,1
SUR,Suriname,MEX,Mexico,2017,1,0,1
SUR,Suriname,NLD,Netherlands,2008,1210,296,914
SUR,Suriname,NLD,Netherlands,2009,1156,203,953
SUR,Suriname,NLD,Netherlands,2010,1023,227,796
SUR,Suriname,NLD,Netherlands,2011,967,232,735
SUR,Suriname,NLD,Netherlands,2012,817,274,543
SUR,Suriname,NLD,Netherlands,2013,673,255,418
SUR,Suriname,NLD,Netherlands,2014,614,268,346
SUR,Suriname,NLD,Netherlands,2015,578,167,411
SUR,Suriname,NLD,Netherlands,2016,634,177,457
SUR,Suriname,NLD,Netherlands,2017,846,163,683
SUR,Suriname,NZL,New Zealand,2008,1,0,1
SUR,Suriname,NZL,New Zealand,2010,1,0,1
SUR,Suriname,NZL,New Zealand,2011,0,0,0
SUR,Suriname,NZL,New Zealand,2012,2,0,2
SUR,Suriname,NZL,New Zealand,2014,1,0,1
SUR,Suriname,NOR,Norway,2008,3,0,3
SUR,Suriname,NOR,Norway,2009,1,2,-1
SUR,Suriname,NOR,Norway,2010,0,0,0
SUR,Suriname,NOR,Norway,2011,1,0,1
SUR,Suriname,NOR,Norway,2012,0,0,0
SUR,Suriname,NOR,Norway,2013,0,0,0
SUR,Suriname,NOR,Norway,2014,0,0,0
SUR,Suriname,NOR,Norway,2015,0,0,0
SUR,Suriname,NOR,Norway,2016,0,0,0
SUR,Suriname,NOR,Norway,2017,0,0,0
SUR,Suriname,POL,Poland,2009,0,0,0
SUR,Suriname,POL,Poland,2010,0,0,0
SUR,Suriname,POL,Poland,2011,0,0,0
SUR,Suriname,POL,Poland,2012,0,0,0
SUR,Suriname,POL,Poland,2013,0,0,0
SUR,Suriname,POL,Poland,2014,1,0,1
SUR,Suriname,POL,Poland,2015,0,0,0
SUR,Suriname,POL,Poland,2016,3,0,3
SUR,Suriname,POL,Poland,2017,7,0,7
SUR,Suriname,SVK,Slovak Republic,2008,0,0,0
SUR,Suriname,SVK,Slovak Republic,2009,1,0,1
SUR,Suriname,ESP,Spain,2008,10,3,7
SUR,Suriname,ESP,Spain,2009,4,5,-1
SUR,Suriname,ESP,Spain,2010,1,7,-6
SUR,Suriname,ESP,Spain,2011,3,4,-1
SUR,Suriname,ESP,Spain,2012,3,1,2
SUR,Suriname,ESP,Spain,2013,3,1,2
SUR,Suriname,ESP,Spain,2014,2,1,1
SUR,Suriname,ESP,Spain,2015,4,0,4
SUR,Suriname,ESP,Spain,2016,4,0,4
SUR,Suriname,ESP,Spain,2017,2,1,1
SUR,Suriname,SWE,Sweden,2008,0,0,0
SUR,Suriname,SWE,Sweden,2009,0,0,0
SUR,Suriname,SWE,Sweden,2010,0,0,0
SUR,Suriname,SWE,Sweden,2011,0,0,0
SUR,Suriname,SWE,Sweden,2012,1,0,1
SUR,Suriname,SWE,Sweden,2013,0,0,0
SUR,Suriname,SWE,Sweden,2014,0,0,0
SUR,Suriname,SWE,Sweden,2015,2,0,2
SUR,Suriname,SWE,Sweden,2016,0,0,0
SUR,Suriname,SWE,Sweden,2017,0,0,0
SUR,Suriname,CHE,Switzerland,2010,1,0,1
SUR,Suriname,CHE,Switzerland,2011,3,0,3
SUR,Suriname,CHE,Switzerland,2012,0,0,0
SUR,Suriname,CHE,Switzerland,2013,0,0,0
SUR,Suriname,CHE,Switzerland,2014,0,0,0
SUR,Suriname,CHE,Switzerland,2015,0,0,0
SUR,Suriname,CHE,Switzerland,2016,0,0,0
SUR,Suriname,CHE,Switzerland,2017,1,0,1
SUR,Suriname,USA,United States,2008,218,0,218
SUR,Suriname,USA,United States,2009,227,0,227
SUR,Suriname,USA,United States,2010,216,0,216
SUR,Suriname,USA,United States,2011,196,0,196
SUR,Suriname,USA,United States,2012,187,0,187
SUR,Suriname,USA,United States,2013,178,0,178
SUR,Suriname,USA,United States,2014,158,0,158
SUR,Suriname,USA,United States,2015,134,0,134
SUR,Suriname,USA,United States,2016,156,0,156
SUR,Suriname,USA,United States,2017,136,0,136
SUR,Suriname,CHL,Chile,2008,0,0,0
SUR,Suriname,CHL,Chile,2009,0,0,0
SUR,Suriname,CHL,Chile,2010,1,0,1
SUR,Suriname,CHL,Chile,2011,0,0,0
SUR,Suriname,CHL,Chile,2012,0,0,0
SUR,Suriname,CHL,Chile,2013,0,0,0
SUR,Suriname,CHL,Chile,2014,0,0,0
SUR,Suriname,CHL,Chile,2015,5,0,5
SUR,Suriname,CHL,Chile,2016,4,0,4
SUR,Suriname,EST,Estonia,2008,0,0,0
SUR,Suriname,EST,Estonia,2009,0,0,0
SUR,Suriname,EST,Estonia,2010,0,0,0
SUR,Suriname,EST,Estonia,2011,0,0,0
SUR,Suriname,EST,Estonia,2012,0,0,0
SUR,Suriname,EST,Estonia,2013,0,0,0
SUR,Suriname,EST,Estonia,2014,0,0,0
SUR,Suriname,EST,Estonia,2015,0,0,0
SUR,Suriname,EST,Estonia,2016,0,0,0
SUR,Suriname,EST,Estonia,2017,0,0,0
SWZ,Swaziland,AUS,Australia,2008,6,0,6
SWZ,Swaziland,AUS,Australia,2009,13,5,8
SWZ,Swaziland,AUS,Australia,2010,1,0,1
SWZ,Swaziland,AUS,Australia,2011,1,0,1
SWZ,Swaziland,AUS,Australia,2012,0,0,0
SWZ,Swaziland,AUS,Australia,2013,0,5,-5
SWZ,Swaziland,AUS,Australia,2014,0,7,-7
SWZ,Swaziland,AUS,Australia,2015,0,0,0
SWZ,Swaziland,AUS,Australia,2016,0,0,0
SWZ,Swaziland,AUS,Australia,2017,0,0,0
SWZ,Swaziland,AUT,Austria,2008,0,0,0
SWZ,Swaziland,AUT,Austria,2009,0,0,0
SWZ,Swaziland,AUT,Austria,2010,0,0,0
SWZ,Swaziland,AUT,Austria,2011,0,0,0
SWZ,Swaziland,AUT,Austria,2012,3,0,3
SWZ,Swaziland,AUT,Austria,2013,0,0,0
SWZ,Swaziland,AUT,Austria,2014,4,0,4
SWZ,Swaziland,AUT,Austria,2015,10,0,10
SWZ,Swaziland,AUT,Austria,2016,1,0,1
SWZ,Swaziland,AUT,Austria,2017,1,0,1
SWZ,Swaziland,BEL,Belgium,2008,2,0,2
SWZ,Swaziland,BEL,Belgium,2009,0,0,0
SWZ,Swaziland,BEL,Belgium,2010,4,3,1
SWZ,Swaziland,BEL,Belgium,2012,3,0,3
SWZ,Swaziland,BEL,Belgium,2013,1,1,0
SWZ,Swaziland,BEL,Belgium,2014,4,0,4
SWZ,Swaziland,BEL,Belgium,2015,1,3,-2
SWZ,Swaziland,BEL,Belgium,2016,1,2,-1
SWZ,Swaziland,CAN,Canada,2008,6,0,6
SWZ,Swaziland,CAN,Canada,2009,10,0,10
SWZ,Swaziland,CAN,Canada,2010,3,0,3
SWZ,Swaziland,CAN,Canada,2011,13,0,13
SWZ,Swaziland,CAN,Canada,2012,17,0,17
SWZ,Swaziland,CAN,Canada,2013,40,0,40
SWZ,Swaziland,CAN,Canada,2014,38,0,38
SWZ,Swaziland,CAN,Canada,2015,36,0,36
SWZ,Swaziland,CAN,Canada,2016,15,0,15
SWZ,Swaziland,CAN,Canada,2017,40,0,40
SWZ,Swaziland,DNK,Denmark,2008,0,0,0
SWZ,Swaziland,DNK,Denmark,2009,1,0,1
SWZ,Swaziland,DNK,Denmark,2010,2,3,-1
SWZ,Swaziland,DNK,Denmark,2012,3,0,3
SWZ,Swaziland,DNK,Denmark,2013,4,1,3
SWZ,Swaziland,DNK,Denmark,2014,0,0,0
SWZ,Swaziland,DNK,Denmark,2015,3,3,0
SWZ,Swaziland,DNK,Denmark,2016,4,4,0
SWZ,Swaziland,DNK,Denmark,2017,1,5,-4
SWZ,Swaziland,FIN,Finland,2008,0,0,0
SWZ,Swaziland,FIN,Finland,2009,0,0,0
SWZ,Swaziland,FIN,Finland,2010,0,0,0
SWZ,Swaziland,FIN,Finland,2011,2,0,2
SWZ,Swaziland,FIN,Finland,2012,0,0,0
SWZ,Swaziland,FIN,Finland,2013,0,0,0
SWZ,Swaziland,FIN,Finland,2014,1,0,1
SWZ,Swaziland,FIN,Finland,2015,0,0,0
SWZ,Swaziland,FIN,Finland,2016,0,0,0
SWZ,Swaziland,FIN,Finland,2017,2,2,0
SWZ,Swaziland,FRA,France,2008,0,0,0
SWZ,Swaziland,FRA,France,2009,1,0,1
SWZ,Swaziland,FRA,France,2010,4,0,4
SWZ,Swaziland,FRA,France,2011,1,0,1
SWZ,Swaziland,FRA,France,2012,2,0,2
SWZ,Swaziland,FRA,France,2013,0,0,0
SWZ,Swaziland,FRA,France,2014,0,0,0
SWZ,Swaziland,FRA,France,2015,0,0,0
SWZ,Swaziland,FRA,France,2016,1,0,1
SWZ,Swaziland,FRA,France,2017,1,0,1
SWZ,Swaziland,DEU,Germany,2008,3,7,-4
SWZ,Swaziland,DEU,Germany,2009,2,0,2
SWZ,Swaziland,DEU,Germany,2010,2,7,-5
SWZ,Swaziland,DEU,Germany,2011,13,4,9
SWZ,Swaziland,DEU,Germany,2012,11,7,4
SWZ,Swaziland,DEU,Germany,2013,17,11,6
SWZ,Swaziland,DEU,Germany,2014,7,5,2
SWZ,Swaziland,DEU,Germany,2015,24,5,19
SWZ,Swaziland,DEU,Germany,2016,6,8,-2
SWZ,Swaziland,DEU,Germany,2017,6,4,2
SWZ,Swaziland,HUN,Hungary,2008,0,0,0
SWZ,Swaziland,HUN,Hungary,2009,0,0,0
SWZ,Swaziland,HUN,Hungary,2010,0,0,0
SWZ,Swaziland,HUN,Hungary,2011,0,0,0
SWZ,Swaziland,HUN,Hungary,2012,0,0,0
SWZ,Swaziland,HUN,Hungary,2013,0,0,0
SWZ,Swaziland,HUN,Hungary,2014,0,0,0
SWZ,Swaziland,HUN,Hungary,2015,0,0,0
SWZ,Swaziland,HUN,Hungary,2016,0,0,0
SWZ,Swaziland,HUN,Hungary,2017,2,0,2
SWZ,Swaziland,ISL,Iceland,2016,0,0,0
SWZ,Swaziland,ISL,Iceland,2017,0,0,0
SWZ,Swaziland,ITA,Italy,2008,1,0,1
SWZ,Swaziland,ITA,Italy,2009,7,0,7
SWZ,Swaziland,ITA,Italy,2010,2,0,2
SWZ,Swaziland,ITA,Italy,2011,1,0,1
SWZ,Swaziland,ITA,Italy,2012,1,0,1
SWZ,Swaziland,ITA,Italy,2013,2,0,2
SWZ,Swaziland,ITA,Italy,2014,2,1,1
SWZ,Swaziland,ITA,Italy,2015,11,0,11
SWZ,Swaziland,ITA,Italy,2016,1,0,1
SWZ,Swaziland,ITA,Italy,2017,4,1,3
SWZ,Swaziland,JPN,Japan,2008,93,93,0
SWZ,Swaziland,JPN,Japan,2009,23,24,-1
SWZ,Swaziland,JPN,Japan,2010,36,35,1
SWZ,Swaziland,JPN,Japan,2011,19,19,0
SWZ,Swaziland,JPN,Japan,2012,49,47,2
SWZ,Swaziland,JPN,Japan,2013,201,202,-1
SWZ,Swaziland,JPN,Japan,2014,33,31,2
SWZ,Swaziland,JPN,Japan,2015,122,122,0
SWZ,Swaziland,JPN,Japan,2016,37,33,4
SWZ,Swaziland,JPN,Japan,2017,34,37,-3
SWZ,Swaziland,KOR,Korea,2008,0,1,-1
SWZ,Swaziland,KOR,Korea,2009,0,1,-1
SWZ,Swaziland,KOR,Korea,2010,2,0,2
SWZ,Swaziland,KOR,Korea,2011,0,1,-1
SWZ,Swaziland,KOR,Korea,2012,4,0,4
SWZ,Swaziland,KOR,Korea,2013,5,3,2
SWZ,Swaziland,KOR,Korea,2014,3,1,2
SWZ,Swaziland,KOR,Korea,2015,0,3,-3
SWZ,Swaziland,KOR,Korea,2016,2,6,-4
SWZ,Swaziland,KOR,Korea,2017,3,1,2
SWZ,Swaziland,LUX,Luxembourg,2008,0,0,0
SWZ,Swaziland,LUX,Luxembourg,2009,0,0,0
SWZ,Swaziland,LUX,Luxembourg,2010,0,0,0
SWZ,Swaziland,LUX,Luxembourg,2011,0,0,0
SWZ,Swaziland,LUX,Luxembourg,2012,0,0,0
SWZ,Swaziland,LUX,Luxembourg,2013,0,0,0
SWZ,Swaziland,LUX,Luxembourg,2014,0,0,0
SWZ,Swaziland,LUX,Luxembourg,2015,0,0,0
SWZ,Swaziland,LUX,Luxembourg,2016,0,0,0
SWZ,Swaziland,LUX,Luxembourg,2017,0,0,0
SWZ,Swaziland,MEX,Mexico,2008,1,0,1
SWZ,Swaziland,MEX,Mexico,2012,0,0,0
SWZ,Swaziland,MEX,Mexico,2013,0,0,0
SWZ,Swaziland,MEX,Mexico,2014,0,0,0
SWZ,Swaziland,NLD,Netherlands,2008,0,4,-4
SWZ,Swaziland,NLD,Netherlands,2009,1,2,-1
SWZ,Swaziland,NLD,Netherlands,2010,1,1,0
SWZ,Swaziland,NLD,Netherlands,2011,4,0,4
SWZ,Swaziland,NLD,Netherlands,2013,6,2,4
SWZ,Swaziland,NLD,Netherlands,2015,5,4,1
SWZ,Swaziland,NLD,Netherlands,2016,5,2,3
SWZ,Swaziland,NLD,Netherlands,2017,3,3,0
SWZ,Swaziland,NZL,New Zealand,2010,1,0,1
SWZ,Swaziland,NZL,New Zealand,2012,0,0,0
SWZ,Swaziland,NZL,New Zealand,2015,1,0,1
SWZ,Swaziland,NZL,New Zealand,2016,1,0,1
SWZ,Swaziland,NZL,New Zealand,2017,2,1,1
SWZ,Swaziland,NOR,Norway,2008,0,0,0
SWZ,Swaziland,NOR,Norway,2009,1,0,1
SWZ,Swaziland,NOR,Norway,2010,0,0,0
SWZ,Swaziland,NOR,Norway,2011,3,2,1
SWZ,Swaziland,NOR,Norway,2012,1,0,1
SWZ,Swaziland,NOR,Norway,2013,1,3,-2
SWZ,Swaziland,NOR,Norway,2014,1,1,0
SWZ,Swaziland,NOR,Norway,2015,1,1,0
SWZ,Swaziland,NOR,Norway,2016,3,1,2
SWZ,Swaziland,NOR,Norway,2017,2,1,1
SWZ,Swaziland,POL,Poland,2009,0,0,0
SWZ,Swaziland,POL,Poland,2010,0,0,0
SWZ,Swaziland,POL,Poland,2011,0,0,0
SWZ,Swaziland,POL,Poland,2012,0,0,0
SWZ,Swaziland,POL,Poland,2013,0,0,0
SWZ,Swaziland,POL,Poland,2014,0,0,0
SWZ,Swaziland,POL,Poland,2015,0,0,0
SWZ,Swaziland,POL,Poland,2016,1,0,1
SWZ,Swaziland,POL,Poland,2017,0,0,0
SWZ,Swaziland,SVK,Slovak Republic,2008,0,0,0
SWZ,Swaziland,ESP,Spain,2008,0,0,0
SWZ,Swaziland,ESP,Spain,2009,0,0,0
SWZ,Swaziland,ESP,Spain,2010,0,0,0
SWZ,Swaziland,ESP,Spain,2011,0,0,0
SWZ,Swaziland,ESP,Spain,2012,0,0,0
SWZ,Swaziland,ESP,Spain,2013,1,0,1
SWZ,Swaziland,ESP,Spain,2014,0,0,0
SWZ,Swaziland,ESP,Spain,2015,2,0,2
SWZ,Swaziland,ESP,Spain,2016,0,0,0
SWZ,Swaziland,ESP,Spain,2017,3,1,2
SWZ,Swaziland,SWE,Sweden,2008,0,1,-1
SWZ,Swaziland,SWE,Sweden,2009,0,0,0
SWZ,Swaziland,SWE,Sweden,2010,4,0,4
SWZ,Swaziland,SWE,Sweden,2011,1,0,1
SWZ,Swaziland,SWE,Sweden,2012,2,0,2
SWZ,Swaziland,SWE,Sweden,2013,1,0,1
SWZ,Swaziland,SWE,Sweden,2014,0,0,0
SWZ,Swaziland,SWE,Sweden,2015,3,0,3
SWZ,Swaziland,SWE,Sweden,2016,2,0,2
SWZ,Swaziland,SWE,Sweden,2017,1,1,0
SWZ,Swaziland,CHE,Switzerland,2010,0,0,0
SWZ,Swaziland,CHE,Switzerland,2011,0,0,0
SWZ,Swaziland,CHE,Switzerland,2012,0,0,0
SWZ,Swaziland,CHE,Switzerland,2013,2,1,1
SWZ,Swaziland,CHE,Switzerland,2014,1,0,1
SWZ,Swaziland,CHE,Switzerland,2015,0,0,0
SWZ,Swaziland,CHE,Switzerland,2016,2,0,2
SWZ,Swaziland,CHE,Switzerland,2017,1,1,0
SWZ,Swaziland,TUR,Turkey,2010,1,0,1
SWZ,Swaziland,USA,United States,2008,18,0,18
SWZ,Swaziland,USA,United States,2009,42,0,42
SWZ,Swaziland,USA,United States,2010,22,0,22
SWZ,Swaziland,USA,United States,2011,19,0,19
SWZ,Swaziland,USA,United States,2012,24,0,24
SWZ,Swaziland,USA,United States,2013,15,0,15
SWZ,Swaziland,USA,United States,2014,23,0,23
SWZ,Swaziland,USA,United States,2015,19,0,19
SWZ,Swaziland,USA,United States,2016,20,0,20
SWZ,Swaziland,USA,United States,2017,19,0,19
SWZ,Swaziland,CHL,Chile,2008,0,0,0
SWZ,Swaziland,CHL,Chile,2009,0,0,0
SWZ,Swaziland,CHL,Chile,2010,0,0,0
SWZ,Swaziland,CHL,Chile,2011,1,0,1
SWZ,Swaziland,CHL,Chile,2012,0,0,0
SWZ,Swaziland,CHL,Chile,2013,0,0,0
SWZ,Swaziland,CHL,Chile,2014,0,0,0
SWZ,Swaziland,CHL,Chile,2015,0,0,0
SWZ,Swaziland,CHL,Chile,2016,0,0,0
SWZ,Swaziland,EST,Estonia,2008,1,0,1
SWZ,Swaziland,EST,Estonia,2009,0,0,0
SWZ,Swaziland,EST,Estonia,2010,0,0,0
SWZ,Swaziland,EST,Estonia,2011,0,0,0
SWZ,Swaziland,EST,Estonia,2012,0,0,0
SWZ,Swaziland,EST,Estonia,2013,0,0,0
SWZ,Swaziland,EST,Estonia,2014,0,0,0
SWZ,Swaziland,EST,Estonia,2015,0,0,0
SWZ,Swaziland,EST,Estonia,2016,0,0,0
SWZ,Swaziland,EST,Estonia,2017,0,0,0
SWE,Sweden,AUS,Australia,2008,425,310,115
SWE,Sweden,AUS,Australia,2009,456,286,170
SWE,Sweden,AUS,Australia,2010,429,319,110
SWE,Sweden,AUS,Australia,2011,352,304,48
SWE,Sweden,AUS,Australia,2012,425,294,131
SWE,Sweden,AUS,Australia,2013,475,289,186
SWE,Sweden,AUS,Australia,2014,492,320,172
SWE,Sweden,AUS,Australia,2015,448,334,114
SWE,Sweden,AUS,Australia,2016,409,357,52
SWE,Sweden,AUS,Australia,2017,408,353,55
SWE,Sweden,AUT,Austria,2008,317,228,89
SWE,Sweden,AUT,Austria,2009,317,219,98
SWE,Sweden,AUT,Austria,2010,333,185,148
SWE,Sweden,AUT,Austria,2011,323,151,172
SWE,Sweden,AUT,Austria,2012,355,218,137
SWE,Sweden,AUT,Austria,2013,311,171,140
SWE,Sweden,AUT,Austria,2014,351,228,123
SWE,Sweden,AUT,Austria,2015,393,192,201
SWE,Sweden,AUT,Austria,2016,349,242,107
SWE,Sweden,AUT,Austria,2017,369,235,134
SWE,Sweden,BEL,Belgium,2008,627,170,457
SWE,Sweden,BEL,Belgium,2009,519,163,356
SWE,Sweden,BEL,Belgium,2010,487,145,342
SWE,Sweden,BEL,Belgium,2011,476,176,300
SWE,Sweden,BEL,Belgium,2012,414,187,227
SWE,Sweden,BEL,Belgium,2013,342,198,144
SWE,Sweden,BEL,Belgium,2014,286,204,82
SWE,Sweden,BEL,Belgium,2015,339,203,136
SWE,Sweden,BEL,Belgium,2016,325,248,77
SWE,Sweden,BEL,Belgium,2017,299,261,38
SWE,Sweden,CAN,Canada,2008,165,268,-103
SWE,Sweden,CAN,Canada,2009,167,344,-177
SWE,Sweden,CAN,Canada,2010,159,336,-177
SWE,Sweden,CAN,Canada,2011,133,280,-147
SWE,Sweden,CAN,Canada,2012,140,338,-198
SWE,Sweden,CAN,Canada,2013,140,301,-161
SWE,Sweden,CAN,Canada,2014,157,311,-154
SWE,Sweden,CAN,Canada,2015,176,330,-154
SWE,Sweden,CAN,Canada,2016,175,316,-141
SWE,Sweden,CAN,Canada,2017,175,370,-195
SWE,Sweden,CZE,Czech Republic,2008,46,325,-279
SWE,Sweden,CZE,Czech Republic,2009,43,198,-155
SWE,Sweden,CZE,Czech Republic,2010,59,164,-105
SWE,Sweden,CZE,Czech Republic,2011,65,189,-124
SWE,Sweden,CZE,Czech Republic,2012,67,200,-133
SWE,Sweden,CZE,Czech Republic,2013,49,209,-160
SWE,Sweden,CZE,Czech Republic,2014,66,210,-144
SWE,Sweden,CZE,Czech Republic,2015,83,238,-155
SWE,Sweden,CZE,Czech Republic,2016,86,227,-141
SWE,Sweden,CZE,Czech Republic,2017,111,225,-114
SWE,Sweden,DNK,Denmark,2008,1268,4129,-2861
SWE,Sweden,DNK,Denmark,2009,1141,3761,-2620
SWE,Sweden,DNK,Denmark,2010,1125,3437,-2312
SWE,Sweden,DNK,Denmark,2011,1138,3196,-2058
SWE,Sweden,DNK,Denmark,2012,1115,2633,-1518
SWE,Sweden,DNK,Denmark,2013,1299,2495,-1196
SWE,Sweden,DNK,Denmark,2014,1377,2025,-648
SWE,Sweden,DNK,Denmark,2015,1324,2130,-806
SWE,Sweden,DNK,Denmark,2016,1422,2120,-698
SWE,Sweden,DNK,Denmark,2017,1544,1913,-369
SWE,Sweden,FIN,Finland,2008,884,2405,-1521
SWE,Sweden,FIN,Finland,2009,836,2398,-1562
SWE,Sweden,FIN,Finland,2010,671,2300,-1629
SWE,Sweden,FIN,Finland,2011,674,2331,-1657
SWE,Sweden,FIN,Finland,2012,593,2329,-1736
SWE,Sweden,FIN,Finland,2013,624,2306,-1682
SWE,Sweden,FIN,Finland,2014,604,2635,-2031
SWE,Sweden,FIN,Finland,2015,547,2811,-2264
SWE,Sweden,FIN,Finland,2016,579,3047,-2468
SWE,Sweden,FIN,Finland,2017,584,2885,-2301
SWE,Sweden,FRA,France,2008,0,957,-957
SWE,Sweden,FRA,France,2009,0,847,-847
SWE,Sweden,FRA,France,2010,0,723,-723
SWE,Sweden,FRA,France,2011,0,852,-852
SWE,Sweden,FRA,France,2012,0,737,-737
SWE,Sweden,FRA,France,2013,568,823,-255
SWE,Sweden,FRA,France,2014,587,846,-259
SWE,Sweden,FRA,France,2015,860,1001,-141
SWE,Sweden,FRA,France,2016,728,1060,-332
SWE,Sweden,FRA,France,2017,560,1212,-652
SWE,Sweden,DEU,Germany,2008,2192,3405,-1213
SWE,Sweden,DEU,Germany,2009,2218,2773,-555
SWE,Sweden,DEU,Germany,2010,2280,2202,78
SWE,Sweden,DEU,Germany,2011,2479,2205,274
SWE,Sweden,DEU,Germany,2012,2615,2150,465
SWE,Sweden,DEU,Germany,2013,2665,2196,469
SWE,Sweden,DEU,Germany,2014,2814,2165,649
SWE,Sweden,DEU,Germany,2015,2763,2293,470
SWE,Sweden,DEU,Germany,2016,2541,2485,56
SWE,Sweden,DEU,Germany,2017,2610,2441,169
SWE,Sweden,HUN,Hungary,2008,178,1018,-840
SWE,Sweden,HUN,Hungary,2009,202,893,-691
SWE,Sweden,HUN,Hungary,2010,143,770,-627
SWE,Sweden,HUN,Hungary,2011,148,706,-558
SWE,Sweden,HUN,Hungary,2012,125,857,-732
SWE,Sweden,HUN,Hungary,2013,112,907,-795
SWE,Sweden,HUN,Hungary,2014,112,939,-827
SWE,Sweden,HUN,Hungary,2015,127,1013,-886
SWE,Sweden,HUN,Hungary,2016,153,878,-725
SWE,Sweden,HUN,Hungary,2017,173,828,-655
SWE,Sweden,ISL,Iceland,2008,81,454,-373
SWE,Sweden,ISL,Iceland,2009,65,671,-606
SWE,Sweden,ISL,Iceland,2010,64,661,-597
SWE,Sweden,ISL,Iceland,2011,83,732,-649
SWE,Sweden,ISL,Iceland,2012,88,715,-627
SWE,Sweden,ISL,Iceland,2013,79,541,-462
SWE,Sweden,ISL,Iceland,2014,78,601,-523
SWE,Sweden,ISL,Iceland,2015,75,796,-721
SWE,Sweden,ISL,Iceland,2016,96,667,-571
SWE,Sweden,ISL,Iceland,2017,104,654,-550
SWE,Sweden,ITA,Italy,2008,343,732,-389
SWE,Sweden,ITA,Italy,2009,257,677,-420
SWE,Sweden,ITA,Italy,2010,224,692,-468
SWE,Sweden,ITA,Italy,2011,260,696,-436
SWE,Sweden,ITA,Italy,2012,225,866,-641
SWE,Sweden,ITA,Italy,2013,187,1016,-829
SWE,Sweden,ITA,Italy,2014,168,1095,-927
SWE,Sweden,ITA,Italy,2015,163,1209,-1046
SWE,Sweden,ITA,Italy,2016,162,1307,-1145
SWE,Sweden,ITA,Italy,2017,193,1309,-1116
SWE,Sweden,JPN,Japan,2008,835,354,481
SWE,Sweden,JPN,Japan,2009,829,312,517
SWE,Sweden,JPN,Japan,2010,1026,320,706
SWE,Sweden,JPN,Japan,2011,816,288,528
SWE,Sweden,JPN,Japan,2012,982,325,657
SWE,Sweden,JPN,Japan,2013,960,244,716
SWE,Sweden,JPN,Japan,2014,1159,258,901
SWE,Sweden,JPN,Japan,2015,1061,222,839
SWE,Sweden,JPN,Japan,2016,982,287,695
SWE,Sweden,JPN,Japan,2017,988,272,716
SWE,Sweden,KOR,Korea,2008,161,205,-44
SWE,Sweden,KOR,Korea,2009,141,241,-100
SWE,Sweden,KOR,Korea,2010,166,235,-69
SWE,Sweden,KOR,Korea,2011,235,233,2
SWE,Sweden,KOR,Korea,2012,233,186,47
SWE,Sweden,KOR,Korea,2013,260,237,23
SWE,Sweden,KOR,Korea,2014,284,215,69
SWE,Sweden,KOR,Korea,2015,278,181,97
SWE,Sweden,KOR,Korea,2016,282,291,-9
SWE,Sweden,KOR,Korea,2017,281,288,-7
SWE,Sweden,LUX,Luxembourg,2008,186,6,180
SWE,Sweden,LUX,Luxembourg,2009,111,9,102
SWE,Sweden,LUX,Luxembourg,2010,131,4,127
SWE,Sweden,LUX,Luxembourg,2011,97,10,87
SWE,Sweden,LUX,Luxembourg,2012,126,9,117
SWE,Sweden,LUX,Luxembourg,2013,139,5,134
SWE,Sweden,LUX,Luxembourg,2014,164,4,160
SWE,Sweden,LUX,Luxembourg,2015,150,3,147
SWE,Sweden,LUX,Luxembourg,2016,123,6,117
SWE,Sweden,LUX,Luxembourg,2017,94,5,89
SWE,Sweden,MEX,Mexico,2008,18,208,-190
SWE,Sweden,MEX,Mexico,2009,30,186,-156
SWE,Sweden,MEX,Mexico,2010,41,146,-105
SWE,Sweden,MEX,Mexico,2011,28,157,-129
SWE,Sweden,MEX,Mexico,2012,23,163,-140
SWE,Sweden,MEX,Mexico,2013,92,137,-45
SWE,Sweden,MEX,Mexico,2014,48,181,-133
SWE,Sweden,MEX,Mexico,2015,55,145,-90
SWE,Sweden,MEX,Mexico,2016,41,163,-122
SWE,Sweden,MEX,Mexico,2017,19,241,-222
SWE,Sweden,NLD,Netherlands,2008,622,1110,-488
SWE,Sweden,NLD,Netherlands,2009,662,855,-193
SWE,Sweden,NLD,Netherlands,2010,695,775,-80
SWE,Sweden,NLD,Netherlands,2011,761,866,-105
SWE,Sweden,NLD,Netherlands,2012,778,797,-19
SWE,Sweden,NLD,Netherlands,2013,769,781,-12
SWE,Sweden,NLD,Netherlands,2014,853,855,-2
SWE,Sweden,NLD,Netherlands,2015,967,946,21
SWE,Sweden,NLD,Netherlands,2016,950,991,-41
SWE,Sweden,NLD,Netherlands,2017,1019,1030,-11
SWE,Sweden,NZL,New Zealand,2008,306,81,225
SWE,Sweden,NZL,New Zealand,2009,275,85,190
SWE,Sweden,NZL,New Zealand,2010,252,99,153
SWE,Sweden,NZL,New Zealand,2011,315,71,244
SWE,Sweden,NZL,New Zealand,2012,306,63,243
SWE,Sweden,NZL,New Zealand,2013,337,72,265
SWE,Sweden,NZL,New Zealand,2014,418,71,347
SWE,Sweden,NZL,New Zealand,2015,449,53,396
SWE,Sweden,NZL,New Zealand,2016,482,64,418
SWE,Sweden,NZL,New Zealand,2017,475,83,392
SWE,Sweden,NOR,Norway,2008,5692,2263,3429
SWE,Sweden,NOR,Norway,2009,6033,1948,4085
SWE,Sweden,NOR,Norway,2010,7595,2070,5525
SWE,Sweden,NOR,Norway,2011,8201,2030,6171
SWE,Sweden,NOR,Norway,2012,5728,2034,3694
SWE,Sweden,NOR,Norway,2013,5271,2016,3255
SWE,Sweden,NOR,Norway,2014,4626,2065,2561
SWE,Sweden,NOR,Norway,2015,3603,2005,1598
SWE,Sweden,NOR,Norway,2016,2454,2145,309
SWE,Sweden,NOR,Norway,2017,2185,2123,62
SWE,Sweden,POL,Poland,2008,199,6970,-6771
SWE,Sweden,POL,Poland,2009,201,5167,-4966
SWE,Sweden,POL,Poland,2010,257,4414,-4157
SWE,Sweden,POL,Poland,2011,298,4403,-4105
SWE,Sweden,POL,Poland,2012,298,4433,-4135
SWE,Sweden,POL,Poland,2013,312,4611,-4299
SWE,Sweden,POL,Poland,2014,313,5058,-4745
SWE,Sweden,POL,Poland,2015,257,5552,-5295
SWE,Sweden,POL,Poland,2016,252,5045,-4793
SWE,Sweden,POL,Poland,2017,225,4351,-4126
SWE,Sweden,SVK,Slovak Republic,2008,30,208,-178
SWE,Sweden,SVK,Slovak Republic,2009,35,224,-189
SWE,Sweden,SVK,Slovak Republic,2010,20,234,-214
SWE,Sweden,SVK,Slovak Republic,2011,10,155,-145
SWE,Sweden,SVK,Slovak Republic,2012,20,139,-119
SWE,Sweden,SVK,Slovak Republic,2013,22,131,-109
SWE,Sweden,SVK,Slovak Republic,2014,11,183,-172
SWE,Sweden,SVK,Slovak Republic,2015,14,172,-158
SWE,Sweden,SVK,Slovak Republic,2016,21,178,-157
SWE,Sweden,SVK,Slovak Republic,2017,12,182,-170
SWE,Sweden,ESP,Spain,2008,1556,611,945
SWE,Sweden,ESP,Spain,2009,1433,702,731
SWE,Sweden,ESP,Spain,2010,1665,674,991
SWE,Sweden,ESP,Spain,2011,1635,762,873
SWE,Sweden,ESP,Spain,2012,1715,1052,663
SWE,Sweden,ESP,Spain,2013,1593,1387,206
SWE,Sweden,ESP,Spain,2014,1700,1421,279
SWE,Sweden,ESP,Spain,2015,1673,1286,387
SWE,Sweden,ESP,Spain,2016,1876,1343,533
SWE,Sweden,ESP,Spain,2017,2285,1378,907
SWE,Sweden,CHE,Switzerland,2008,1095,163,932
SWE,Sweden,CHE,Switzerland,2009,973,142,831
SWE,Sweden,CHE,Switzerland,2010,964,119,845
SWE,Sweden,CHE,Switzerland,2011,921,182,739
SWE,Sweden,CHE,Switzerland,2012,802,128,674
SWE,Sweden,CHE,Switzerland,2013,987,114,873
SWE,Sweden,CHE,Switzerland,2014,802,120,682
SWE,Sweden,CHE,Switzerland,2015,857,174,683
SWE,Sweden,CHE,Switzerland,2016,791,184,607
SWE,Sweden,CHE,Switzerland,2017,813,171,642
SWE,Sweden,TUR,Turkey,2010,64,2232,-2168
SWE,Sweden,TUR,Turkey,2016,374,1115,-741
SWE,Sweden,TUR,Turkey,2017,391,1549,-1158
SWE,Sweden,GBR,United Kingdom,2011,2000,1804,196
SWE,Sweden,GBR,United Kingdom,2012,3000,1549,1451
SWE,Sweden,GBR,United Kingdom,2013,2000,1554,446
SWE,Sweden,GBR,United Kingdom,2014,4000,1831,2169
SWE,Sweden,GBR,United Kingdom,2015,2000,1666,334
SWE,Sweden,USA,United States,2008,1019,1129,-110
SWE,Sweden,USA,United States,2009,1138,1196,-58
SWE,Sweden,USA,United States,2010,1097,1329,-232
SWE,Sweden,USA,United States,2011,979,1227,-248
SWE,Sweden,USA,United States,2012,968,1426,-458
SWE,Sweden,USA,United States,2013,1106,1427,-321
SWE,Sweden,USA,United States,2014,954,1286,-332
SWE,Sweden,USA,United States,2015,1066,1145,-79
SWE,Sweden,USA,United States,2016,1144,1184,-40
SWE,Sweden,USA,United States,2017,950,1610,-660
SWE,Sweden,CHL,Chile,2008,46,372,-326
SWE,Sweden,CHL,Chile,2009,40,390,-350
SWE,Sweden,CHL,Chile,2010,36,379,-343
SWE,Sweden,CHL,Chile,2011,41,278,-237
SWE,Sweden,CHL,Chile,2012,72,311,-239
SWE,Sweden,CHL,Chile,2013,50,214,-164
SWE,Sweden,CHL,Chile,2014,42,187,-145
SWE,Sweden,CHL,Chile,2015,51,156,-105
SWE,Sweden,CHL,Chile,2016,32,167,-135
SWE,Sweden,EST,Estonia,2008,63,389,-326
SWE,Sweden,EST,Estonia,2009,71,558,-487
SWE,Sweden,EST,Estonia,2010,28,491,-463
SWE,Sweden,EST,Estonia,2011,4,494,-490
SWE,Sweden,EST,Estonia,2012,4,542,-538
SWE,Sweden,EST,Estonia,2013,4,547,-543
SWE,Sweden,EST,Estonia,2014,11,513,-502
SWE,Sweden,EST,Estonia,2015,139,535,-396
SWE,Sweden,EST,Estonia,2016,129,419,-290
SWE,Sweden,EST,Estonia,2017,199,414,-215
SWE,Sweden,ISR,Israel,2008,7,87,-80
SWE,Sweden,ISR,Israel,2009,24,77,-53
SWE,Sweden,ISR,Israel,2010,28,48,-20
SWE,Sweden,ISR,Israel,2011,22,49,-27
SWE,Sweden,ISR,Israel,2012,15,73,-58
SWE,Sweden,ISR,Israel,2013,29,65,-36
SWE,Sweden,ISR,Israel,2014,13,81,-68
SWE,Sweden,ISR,Israel,2015,33,73,-40
SWE,Sweden,ISR,Israel,2016,25,48,-23
SWE,Sweden,ISR,Israel,2017,28,51,-23
SWE,Sweden,SVN,Slovenia,2008,24,74,-50
SWE,Sweden,SVN,Slovenia,2009,30,60,-30
SWE,Sweden,SVN,Slovenia,2010,31,48,-17
SWE,Sweden,SVN,Slovenia,2011,28,68,-40
SWE,Sweden,SVN,Slovenia,2012,20,73,-53
SWE,Sweden,SVN,Slovenia,2013,18,122,-104
SWE,Sweden,SVN,Slovenia,2014,20,98,-78
SWE,Sweden,SVN,Slovenia,2015,25,125,-100
SWE,Sweden,SVN,Slovenia,2016,21,87,-66
SWE,Sweden,SVN,Slovenia,2017,17,102,-85
CHE,Switzerland,AUS,Australia,2008,283,0,283
CHE,Switzerland,AUS,Australia,2009,275,0,275
CHE,Switzerland,AUS,Australia,2010,287,513,-226
CHE,Switzerland,AUS,Australia,2011,229,465,-236
CHE,Switzerland,AUS,Australia,2012,271,440,-169
CHE,Switzerland,AUS,Australia,2013,204,455,-251
CHE,Switzerland,AUS,Australia,2014,194,419,-225
CHE,Switzerland,AUS,Australia,2015,212,458,-246
CHE,Switzerland,AUS,Australia,2016,185,464,-279
CHE,Switzerland,AUS,Australia,2017,183,427,-244
CHE,Switzerland,AUT,Austria,2008,644,3202,-2558
CHE,Switzerland,AUT,Austria,2009,505,2775,-2270
CHE,Switzerland,AUT,Austria,2010,651,2579,-1928
CHE,Switzerland,AUT,Austria,2011,563,2855,-2292
CHE,Switzerland,AUT,Austria,2012,645,3054,-2409
CHE,Switzerland,AUT,Austria,2013,655,2915,-2260
CHE,Switzerland,AUT,Austria,2014,643,2961,-2318
CHE,Switzerland,AUT,Austria,2015,632,3168,-2536
CHE,Switzerland,AUT,Austria,2016,671,2923,-2252
CHE,Switzerland,AUT,Austria,2017,724,2777,-2053
CHE,Switzerland,BEL,Belgium,2008,253,1228,-975
CHE,Switzerland,BEL,Belgium,2009,195,1033,-838
CHE,Switzerland,BEL,Belgium,2010,244,1076,-832
CHE,Switzerland,BEL,Belgium,2011,260,1170,-910
CHE,Switzerland,BEL,Belgium,2012,203,1163,-960
CHE,Switzerland,BEL,Belgium,2013,207,1277,-1070
CHE,Switzerland,BEL,Belgium,2014,187,1250,-1063
CHE,Switzerland,BEL,Belgium,2015,154,1288,-1134
CHE,Switzerland,BEL,Belgium,2016,183,1217,-1034
CHE,Switzerland,BEL,Belgium,2017,191,1289,-1098
CHE,Switzerland,CAN,Canada,2008,357,0,357
CHE,Switzerland,CAN,Canada,2009,328,0,328
CHE,Switzerland,CAN,Canada,2010,285,1080,-795
CHE,Switzerland,CAN,Canada,2011,266,1000,-734
CHE,Switzerland,CAN,Canada,2012,243,903,-660
CHE,Switzerland,CAN,Canada,2013,200,806,-606
CHE,Switzerland,CAN,Canada,2014,203,779,-576
CHE,Switzerland,CAN,Canada,2015,236,923,-687
CHE,Switzerland,CAN,Canada,2016,215,715,-500
CHE,Switzerland,CAN,Canada,2017,190,786,-596
CHE,Switzerland,CZE,Czech Republic,2008,49,698,-649
CHE,Switzerland,CZE,Czech Republic,2009,32,558,-526
CHE,Switzerland,CZE,Czech Republic,2010,35,529,-494
CHE,Switzerland,CZE,Czech Republic,2011,18,916,-898
CHE,Switzerland,CZE,Czech Republic,2012,25,779,-754
CHE,Switzerland,CZE,Czech Republic,2013,27,733,-706
CHE,Switzerland,CZE,Czech Republic,2014,34,1267,-1233
CHE,Switzerland,CZE,Czech Republic,2015,31,1152,-1121
CHE,Switzerland,CZE,Czech Republic,2016,33,1029,-996
CHE,Switzerland,CZE,Czech Republic,2017,43,1007,-964
CHE,Switzerland,DNK,Denmark,2008,93,562,-469
CHE,Switzerland,DNK,Denmark,2009,70,496,-426
CHE,Switzerland,DNK,Denmark,2010,103,572,-469
CHE,Switzerland,DNK,Denmark,2011,88,511,-423
CHE,Switzerland,DNK,Denmark,2012,99,493,-394
CHE,Switzerland,DNK,Denmark,2013,89,470,-381
CHE,Switzerland,DNK,Denmark,2014,140,446,-306
CHE,Switzerland,DNK,Denmark,2015,128,422,-294
CHE,Switzerland,DNK,Denmark,2016,152,403,-251
CHE,Switzerland,DNK,Denmark,2017,123,381,-258
CHE,Switzerland,FIN,Finland,2008,47,570,-523
CHE,Switzerland,FIN,Finland,2009,32,491,-459
CHE,Switzerland,FIN,Finland,2010,38,469,-431
CHE,Switzerland,FIN,Finland,2011,35,490,-455
CHE,Switzerland,FIN,Finland,2012,53,377,-324
CHE,Switzerland,FIN,Finland,2013,25,418,-393
CHE,Switzerland,FIN,Finland,2014,40,461,-421
CHE,Switzerland,FIN,Finland,2015,41,405,-364
CHE,Switzerland,FIN,Finland,2016,47,394,-347
CHE,Switzerland,FIN,Finland,2017,37,390,-353
CHE,Switzerland,FRA,France,2008,0,13687,-13687
CHE,Switzerland,FRA,France,2009,0,10897,-10897
CHE,Switzerland,FRA,France,2010,0,11548,-11548
CHE,Switzerland,FRA,France,2011,0,11463,-11463
CHE,Switzerland,FRA,France,2012,0,11382,-11382
CHE,Switzerland,FRA,France,2013,0,13463,-13463
CHE,Switzerland,FRA,France,2014,0,13839,-13839
CHE,Switzerland,FRA,France,2015,22,14767,-14745
CHE,Switzerland,FRA,France,2016,48,13790,-13742
CHE,Switzerland,FRA,France,2017,31,14070,-14039
CHE,Switzerland,DEU,Germany,2008,3626,46385,-42759
CHE,Switzerland,DEU,Germany,2009,3569,33941,-30372
CHE,Switzerland,DEU,Germany,2010,3614,30745,-27131
CHE,Switzerland,DEU,Germany,2011,3856,30506,-26650
CHE,Switzerland,DEU,Germany,2012,4096,27123,-23027
CHE,Switzerland,DEU,Germany,2013,4176,26640,-22464
CHE,Switzerland,DEU,Germany,2014,4245,23752,-19507
CHE,Switzerland,DEU,Germany,2015,4282,22137,-17855
CHE,Switzerland,DEU,Germany,2016,4287,20891,-16604
CHE,Switzerland,DEU,Germany,2017,4225,19694,-15469
CHE,Switzerland,HUN,Hungary,2008,109,1060,-951
CHE,Switzerland,HUN,Hungary,2009,125,1104,-979
CHE,Switzerland,HUN,Hungary,2010,90,1160,-1070
CHE,Switzerland,HUN,Hungary,2011,111,2089,-1978
CHE,Switzerland,HUN,Hungary,2012,98,2492,-2394
CHE,Switzerland,HUN,Hungary,2013,108,2513,-2405
CHE,Switzerland,HUN,Hungary,2014,106,4205,-4099
CHE,Switzerland,HUN,Hungary,2015,115,3920,-3805
CHE,Switzerland,HUN,Hungary,2016,135,3554,-3419
CHE,Switzerland,HUN,Hungary,2017,149,3320,-3171
CHE,Switzerland,ISL,Iceland,2008,28,26,2
CHE,Switzerland,ISL,Iceland,2009,18,67,-49
CHE,Switzerland,ISL,Iceland,2010,12,60,-48
CHE,Switzerland,ISL,Iceland,2011,20,135,-115
CHE,Switzerland,ISL,Iceland,2012,11,77,-66
CHE,Switzerland,ISL,Iceland,2013,11,76,-65
CHE,Switzerland,ISL,Iceland,2014,22,67,-45
CHE,Switzerland,ISL,Iceland,2015,29,63,-34
CHE,Switzerland,ISL,Iceland,2016,22,81,-59
CHE,Switzerland,ISL,Iceland,2017,39,42,-3
CHE,Switzerland,ITA,Italy,2008,567,9911,-9344
CHE,Switzerland,ITA,Italy,2009,487,8511,-8024
CHE,Switzerland,ITA,Italy,2010,443,10098,-9655
CHE,Switzerland,ITA,Italy,2011,375,10777,-10402
CHE,Switzerland,ITA,Italy,2012,350,13624,-13274
CHE,Switzerland,ITA,Italy,2013,393,17475,-17082
CHE,Switzerland,ITA,Italy,2014,319,17822,-17503
CHE,Switzerland,ITA,Italy,2015,283,18241,-17958
CHE,Switzerland,ITA,Italy,2016,361,18136,-17775
CHE,Switzerland,ITA,Italy,2017,436,15484,-15048
CHE,Switzerland,JPN,Japan,2008,665,0,665
CHE,Switzerland,JPN,Japan,2009,444,0,444
CHE,Switzerland,JPN,Japan,2010,474,767,-293
CHE,Switzerland,JPN,Japan,2011,384,826,-442
CHE,Switzerland,JPN,Japan,2012,377,785,-408
CHE,Switzerland,JPN,Japan,2013,511,794,-283
CHE,Switzerland,JPN,Japan,2014,644,776,-132
CHE,Switzerland,JPN,Japan,2015,485,798,-313
CHE,Switzerland,JPN,Japan,2016,494,742,-248
CHE,Switzerland,JPN,Japan,2017,571,710,-139
CHE,Switzerland,KOR,Korea,2008,62,0,62
CHE,Switzerland,KOR,Korea,2009,85,0,85
CHE,Switzerland,KOR,Korea,2010,112,407,-295
CHE,Switzerland,KOR,Korea,2011,96,438,-342
CHE,Switzerland,KOR,Korea,2012,100,414,-314
CHE,Switzerland,KOR,Korea,2013,97,445,-348
CHE,Switzerland,KOR,Korea,2014,114,429,-315
CHE,Switzerland,KOR,Korea,2015,104,522,-418
CHE,Switzerland,KOR,Korea,2016,122,421,-299
CHE,Switzerland,KOR,Korea,2017,120,430,-310
CHE,Switzerland,LUX,Luxembourg,2008,48,186,-138
CHE,Switzerland,LUX,Luxembourg,2009,41,147,-106
CHE,Switzerland,LUX,Luxembourg,2010,40,209,-169
CHE,Switzerland,LUX,Luxembourg,2011,68,188,-120
CHE,Switzerland,LUX,Luxembourg,2012,47,169,-122
CHE,Switzerland,LUX,Luxembourg,2013,58,182,-124
CHE,Switzerland,LUX,Luxembourg,2014,53,170,-117
CHE,Switzerland,LUX,Luxembourg,2015,47,179,-132
CHE,Switzerland,LUX,Luxembourg,2016,46,177,-131
CHE,Switzerland,LUX,Luxembourg,2017,65,150,-85
CHE,Switzerland,MEX,Mexico,2008,68,0,68
CHE,Switzerland,MEX,Mexico,2009,93,0,93
CHE,Switzerland,MEX,Mexico,2010,105,629,-524
CHE,Switzerland,MEX,Mexico,2011,67,599,-532
CHE,Switzerland,MEX,Mexico,2012,55,556,-501
CHE,Switzerland,MEX,Mexico,2013,256,510,-254
CHE,Switzerland,MEX,Mexico,2014,126,494,-368
CHE,Switzerland,MEX,Mexico,2015,108,494,-386
CHE,Switzerland,MEX,Mexico,2016,95,499,-404
CHE,Switzerland,MEX,Mexico,2017,86,533,-447
CHE,Switzerland,NLD,Netherlands,2008,288,1973,-1685
CHE,Switzerland,NLD,Netherlands,2009,311,1461,-1150
CHE,Switzerland,NLD,Netherlands,2010,364,1607,-1243
CHE,Switzerland,NLD,Netherlands,2011,376,1454,-1078
CHE,Switzerland,NLD,Netherlands,2012,363,1396,-1033
CHE,Switzerland,NLD,Netherlands,2013,375,1662,-1287
CHE,Switzerland,NLD,Netherlands,2014,430,1627,-1197
CHE,Switzerland,NLD,Netherlands,2015,448,1506,-1058
CHE,Switzerland,NLD,Netherlands,2016,539,1616,-1077
CHE,Switzerland,NLD,Netherlands,2017,633,1380,-747
CHE,Switzerland,NZL,New Zealand,2008,137,0,137
CHE,Switzerland,NZL,New Zealand,2009,126,0,126
CHE,Switzerland,NZL,New Zealand,2010,101,117,-16
CHE,Switzerland,NZL,New Zealand,2011,81,119,-38
CHE,Switzerland,NZL,New Zealand,2012,111,134,-23
CHE,Switzerland,NZL,New Zealand,2013,149,118,31
CHE,Switzerland,NZL,New Zealand,2014,140,95,45
CHE,Switzerland,NZL,New Zealand,2015,124,96,28
CHE,Switzerland,NZL,New Zealand,2016,164,85,79
CHE,Switzerland,NZL,New Zealand,2017,155,80,75
CHE,Switzerland,NOR,Norway,2008,111,238,-127
CHE,Switzerland,NOR,Norway,2009,101,215,-114
CHE,Switzerland,NOR,Norway,2010,106,211,-105
CHE,Switzerland,NOR,Norway,2011,136,256,-120
CHE,Switzerland,NOR,Norway,2012,128,157,-29
CHE,Switzerland,NOR,Norway,2013,96,186,-90
CHE,Switzerland,NOR,Norway,2014,90,157,-67
CHE,Switzerland,NOR,Norway,2015,105,202,-97
CHE,Switzerland,NOR,Norway,2016,116,185,-69
CHE,Switzerland,NOR,Norway,2017,115,186,-71
CHE,Switzerland,POL,Poland,2008,46,2437,-2391
CHE,Switzerland,POL,Poland,2009,44,2123,-2079
CHE,Switzerland,POL,Poland,2010,28,2047,-2019
CHE,Switzerland,POL,Poland,2011,40,3413,-3373
CHE,Switzerland,POL,Poland,2012,40,3340,-3300
CHE,Switzerland,POL,Poland,2013,53,2936,-2883
CHE,Switzerland,POL,Poland,2014,53,4782,-4729
CHE,Switzerland,POL,Poland,2015,36,4821,-4785
CHE,Switzerland,POL,Poland,2016,39,4069,-4030
CHE,Switzerland,POL,Poland,2017,56,4123,-4067
CHE,Switzerland,SVK,Slovak Republic,2008,38,1209,-1171
CHE,Switzerland,SVK,Slovak Republic,2009,28,1115,-1087
CHE,Switzerland,SVK,Slovak Republic,2010,27,981,-954
CHE,Switzerland,SVK,Slovak Republic,2011,15,1865,-1850
CHE,Switzerland,SVK,Slovak Republic,2012,14,1625,-1611
CHE,Switzerland,SVK,Slovak Republic,2013,5,1498,-1493
CHE,Switzerland,SVK,Slovak Republic,2014,10,2716,-2706
CHE,Switzerland,SVK,Slovak Republic,2015,9,2583,-2574
CHE,Switzerland,SVK,Slovak Republic,2016,14,2347,-2333
CHE,Switzerland,SVK,Slovak Republic,2017,5,2087,-2082
CHE,Switzerland,ESP,Spain,2008,906,2365,-1459
CHE,Switzerland,ESP,Spain,2009,871,2480,-1609
CHE,Switzerland,ESP,Spain,2010,890,3258,-2368
CHE,Switzerland,ESP,Spain,2011,876,4584,-3708
CHE,Switzerland,ESP,Spain,2012,937,6525,-5588
CHE,Switzerland,ESP,Spain,2013,869,8778,-7909
CHE,Switzerland,ESP,Spain,2014,910,7593,-6683
CHE,Switzerland,ESP,Spain,2015,1031,7042,-6011
CHE,Switzerland,ESP,Spain,2016,1119,5787,-4668
CHE,Switzerland,ESP,Spain,2017,1499,5243,-3744
CHE,Switzerland,SWE,Sweden,2008,163,1095,-932
CHE,Switzerland,SWE,Sweden,2009,142,973,-831
CHE,Switzerland,SWE,Sweden,2010,119,964,-845
CHE,Switzerland,SWE,Sweden,2011,182,921,-739
CHE,Switzerland,SWE,Sweden,2012,128,802,-674
CHE,Switzerland,SWE,Sweden,2013,114,987,-873
CHE,Switzerland,SWE,Sweden,2014,120,802,-682
CHE,Switzerland,SWE,Sweden,2015,174,857,-683
CHE,Switzerland,SWE,Sweden,2016,184,791,-607
CHE,Switzerland,SWE,Sweden,2017,171,813,-642
CHE,Switzerland,TUR,Turkey,2010,56,1988,-1932
CHE,Switzerland,TUR,Turkey,2016,152,1479,-1327
CHE,Switzerland,TUR,Turkey,2017,118,1571,-1453
CHE,Switzerland,GBR,United Kingdom,2011,1000,5406,-4406
CHE,Switzerland,GBR,United Kingdom,2012,1000,4445,-3445
CHE,Switzerland,GBR,United Kingdom,2013,1000,4602,-3602
CHE,Switzerland,GBR,United Kingdom,2014,1000,4210,-3210
CHE,Switzerland,GBR,United Kingdom,2015,3000,3924,-924
CHE,Switzerland,USA,United States,2008,720,0,720
CHE,Switzerland,USA,United States,2009,798,0,798
CHE,Switzerland,USA,United States,2010,675,3964,-3289
CHE,Switzerland,USA,United States,2011,615,4239,-3624
CHE,Switzerland,USA,United States,2012,635,3475,-2840
CHE,Switzerland,USA,United States,2013,697,3404,-2707
CHE,Switzerland,USA,United States,2014,656,3100,-2444
CHE,Switzerland,USA,United States,2015,640,2879,-2239
CHE,Switzerland,USA,United States,2016,743,2914,-2171
CHE,Switzerland,USA,United States,2017,565,2957,-2392
CHE,Switzerland,CHL,Chile,2008,60,0,60
CHE,Switzerland,CHL,Chile,2009,84,0,84
CHE,Switzerland,CHL,Chile,2010,44,230,-186
CHE,Switzerland,CHL,Chile,2011,65,172,-107
CHE,Switzerland,CHL,Chile,2012,65,175,-110
CHE,Switzerland,CHL,Chile,2013,80,191,-111
CHE,Switzerland,CHL,Chile,2014,74,168,-94
CHE,Switzerland,CHL,Chile,2015,70,177,-107
CHE,Switzerland,CHL,Chile,2016,44,167,-123
CHE,Switzerland,EST,Estonia,2008,3,84,-81
CHE,Switzerland,EST,Estonia,2009,2,79,-77
CHE,Switzerland,EST,Estonia,2010,2,89,-87
CHE,Switzerland,EST,Estonia,2011,0,141,-141
CHE,Switzerland,EST,Estonia,2012,0,134,-134
CHE,Switzerland,EST,Estonia,2013,0,108,-108
CHE,Switzerland,EST,Estonia,2014,0,170,-170
CHE,Switzerland,EST,Estonia,2015,14,118,-104
CHE,Switzerland,EST,Estonia,2016,17,134,-117
CHE,Switzerland,EST,Estonia,2017,16,89,-73
CHE,Switzerland,ISR,Israel,2008,60,0,60
CHE,Switzerland,ISR,Israel,2009,79,0,79
CHE,Switzerland,ISR,Israel,2010,110,194,-84
CHE,Switzerland,ISR,Israel,2011,59,211,-152
CHE,Switzerland,ISR,Israel,2012,81,213,-132
CHE,Switzerland,ISR,Israel,2013,75,206,-131
CHE,Switzerland,ISR,Israel,2014,78,168,-90
CHE,Switzerland,ISR,Israel,2015,75,181,-106
CHE,Switzerland,ISR,Israel,2016,113,172,-59
CHE,Switzerland,ISR,Israel,2017,84,216,-132
CHE,Switzerland,SVN,Slovenia,2008,14,186,-172
CHE,Switzerland,SVN,Slovenia,2009,14,167,-153
CHE,Switzerland,SVN,Slovenia,2010,11,144,-133
CHE,Switzerland,SVN,Slovenia,2011,13,382,-369
CHE,Switzerland,SVN,Slovenia,2012,15,470,-455
CHE,Switzerland,SVN,Slovenia,2013,15,564,-549
CHE,Switzerland,SVN,Slovenia,2014,13,1152,-1139
CHE,Switzerland,SVN,Slovenia,2015,10,1083,-1073
CHE,Switzerland,SVN,Slovenia,2016,9,917,-908
CHE,Switzerland,SVN,Slovenia,2017,17,836,-819
SYR,Syria,AUS,Australia,2008,228,100,128
SYR,Syria,AUS,Australia,2009,250,95,155
SYR,Syria,AUS,Australia,2010,179,81,98
SYR,Syria,AUS,Australia,2011,235,72,163
SYR,Syria,AUS,Australia,2012,261,53,208
SYR,Syria,AUS,Australia,2013,209,46,163
SYR,Syria,AUS,Australia,2014,967,63,904
SYR,Syria,AUS,Australia,2015,2568,100,2468
SYR,Syria,AUS,Australia,2016,2233,100,2133
SYR,Syria,AUS,Australia,2017,8657,0,8657
SYR,Syria,AUT,Austria,2008,186,73,113
SYR,Syria,AUT,Austria,2009,300,93,207
SYR,Syria,AUT,Austria,2010,231,82,149
SYR,Syria,AUT,Austria,2011,441,74,367
SYR,Syria,AUT,Austria,2012,903,113,790
SYR,Syria,AUT,Austria,2013,1734,119,1615
SYR,Syria,AUT,Austria,2014,7400,272,7128
SYR,Syria,AUT,Austria,2015,22610,707,21903
SYR,Syria,AUT,Austria,2016,9040,1201,7839
SYR,Syria,AUT,Austria,2017,6691,849,5842
SYR,Syria,BEL,Belgium,2008,160,0,160
SYR,Syria,BEL,Belgium,2009,204,0,204
SYR,Syria,BEL,Belgium,2010,230,37,193
SYR,Syria,BEL,Belgium,2011,186,0,186
SYR,Syria,BEL,Belgium,2012,902,33,869
SYR,Syria,BEL,Belgium,2013,1045,78,967
SYR,Syria,BEL,Belgium,2014,2780,104,2676
SYR,Syria,BEL,Belgium,2015,10362,153,10209
SYR,Syria,BEL,Belgium,2016,4422,134,4288
SYR,Syria,BEL,Belgium,2017,5401,236,5165
SYR,Syria,CAN,Canada,2008,919,0,919
SYR,Syria,CAN,Canada,2009,917,0,917
SYR,Syria,CAN,Canada,2010,1040,0,1040
SYR,Syria,CAN,Canada,2011,1005,0,1005
SYR,Syria,CAN,Canada,2012,649,0,649
SYR,Syria,CAN,Canada,2013,1008,0,1008
SYR,Syria,CAN,Canada,2014,2051,0,2051
SYR,Syria,CAN,Canada,2015,9854,0,9854
SYR,Syria,CAN,Canada,2016,34925,0,34925
SYR,Syria,CAN,Canada,2017,12045,0,12045
SYR,Syria,CZE,Czech Republic,2008,41,1,40
SYR,Syria,CZE,Czech Republic,2009,48,0,48
SYR,Syria,CZE,Czech Republic,2010,55,1,54
SYR,Syria,CZE,Czech Republic,2011,55,0,55
SYR,Syria,CZE,Czech Republic,2012,95,27,68
SYR,Syria,CZE,Czech Republic,2013,177,47,130
SYR,Syria,CZE,Czech Republic,2014,144,62,82
SYR,Syria,CZE,Czech Republic,2015,236,76,160
SYR,Syria,CZE,Czech Republic,2016,187,63,124
SYR,Syria,CZE,Czech Republic,2017,151,67,84
SYR,Syria,DNK,Denmark,2008,89,8,81
SYR,Syria,DNK,Denmark,2009,177,7,170
SYR,Syria,DNK,Denmark,2010,400,19,381
SYR,Syria,DNK,Denmark,2011,558,16,542
SYR,Syria,DNK,Denmark,2012,935,8,927
SYR,Syria,DNK,Denmark,2013,1601,11,1590
SYR,Syria,DNK,Denmark,2014,5351,30,5321
SYR,Syria,DNK,Denmark,2015,11403,96,11307
SYR,Syria,DNK,Denmark,2016,8827,264,8563
SYR,Syria,DNK,Denmark,2017,2336,711,1625
SYR,Syria,FIN,Finland,2008,26,4,22
SYR,Syria,FIN,Finland,2009,13,3,10
SYR,Syria,FIN,Finland,2010,21,2,19
SYR,Syria,FIN,Finland,2011,46,1,45
SYR,Syria,FIN,Finland,2012,150,2,148
SYR,Syria,FIN,Finland,2013,173,0,173
SYR,Syria,FIN,Finland,2014,570,2,568
SYR,Syria,FIN,Finland,2015,578,0,578
SYR,Syria,FIN,Finland,2016,1716,5,1711
SYR,Syria,FIN,Finland,2017,1958,3,1955
SYR,Syria,FRA,France,2008,392,0,392
SYR,Syria,FRA,France,2009,403,0,403
SYR,Syria,FRA,France,2010,355,0,355
SYR,Syria,FRA,France,2011,472,0,472
SYR,Syria,FRA,France,2012,764,0,764
SYR,Syria,FRA,France,2013,1239,0,1239
SYR,Syria,FRA,France,2014,1715,0,1715
SYR,Syria,FRA,France,2015,2362,0,2362
SYR,Syria,FRA,France,2016,3525,0,3525
SYR,Syria,FRA,France,2017,4168,0,4168
SYR,Syria,DEU,Germany,2008,1969,1180,789
SYR,Syria,DEU,Germany,2009,2338,1417,921
SYR,Syria,DEU,Germany,2010,2983,1214,1769
SYR,Syria,DEU,Germany,2011,4560,1060,3500
SYR,Syria,DEU,Germany,2012,8530,1244,7286
SYR,Syria,DEU,Germany,2013,19017,1960,17057
SYR,Syria,DEU,Germany,2014,69074,3153,65921
SYR,Syria,DEU,Germany,2015,309699,11216,298483
SYR,Syria,DEU,Germany,2016,179435,33612,145823
SYR,Syria,DEU,Germany,2017,76391,16456,59935
SYR,Syria,HUN,Hungary,2008,72,9,63
SYR,Syria,HUN,Hungary,2009,73,13,60
SYR,Syria,HUN,Hungary,2010,39,10,29
SYR,Syria,HUN,Hungary,2011,72,17,55
SYR,Syria,HUN,Hungary,2012,96,8,88
SYR,Syria,HUN,Hungary,2013,120,19,101
SYR,Syria,HUN,Hungary,2014,265,19,246
SYR,Syria,HUN,Hungary,2015,280,12,268
SYR,Syria,HUN,Hungary,2016,236,33,203
SYR,Syria,HUN,Hungary,2017,580,28,552
SYR,Syria,ISL,Iceland,2008,0,0,0
SYR,Syria,ISL,Iceland,2009,0,1,-1
SYR,Syria,ISL,Iceland,2010,0,3,-3
SYR,Syria,ISL,Iceland,2011,2,1,1
SYR,Syria,ISL,Iceland,2012,3,0,3
SYR,Syria,ISL,Iceland,2013,13,1,12
SYR,Syria,ISL,Iceland,2014,3,0,3
SYR,Syria,ISL,Iceland,2015,21,0,21
SYR,Syria,ISL,Iceland,2016,94,0,94
SYR,Syria,ISL,Iceland,2017,69,0,69
SYR,Syria,ITA,Italy,2008,300,11,289
SYR,Syria,ITA,Italy,2009,271,13,258
SYR,Syria,ITA,Italy,2010,350,27,323
SYR,Syria,ITA,Italy,2011,331,39,292
SYR,Syria,ITA,Italy,2012,452,21,431
SYR,Syria,ITA,Italy,2013,586,52,534
SYR,Syria,ITA,Italy,2014,570,56,514
SYR,Syria,ITA,Italy,2015,429,49,380
SYR,Syria,ITA,Italy,2016,772,0,772
SYR,Syria,ITA,Italy,2017,1300,63,1237
SYR,Syria,JPN,Japan,2008,121,118,3
SYR,Syria,JPN,Japan,2009,135,120,15
SYR,Syria,JPN,Japan,2010,168,134,34
SYR,Syria,JPN,Japan,2011,115,93,22
SYR,Syria,JPN,Japan,2012,98,57,41
SYR,Syria,JPN,Japan,2013,32,10,22
SYR,Syria,JPN,Japan,2014,38,12,26
SYR,Syria,JPN,Japan,2015,56,16,40
SYR,Syria,JPN,Japan,2016,53,19,34
SYR,Syria,JPN,Japan,2017,103,25,78
SYR,Syria,KOR,Korea,2008,24,62,-38
SYR,Syria,KOR,Korea,2009,30,30,0
SYR,Syria,KOR,Korea,2010,62,60,2
SYR,Syria,KOR,Korea,2011,188,109,79
SYR,Syria,KOR,Korea,2012,368,235,133
SYR,Syria,KOR,Korea,2013,323,154,169
SYR,Syria,KOR,Korea,2014,186,107,79
SYR,Syria,KOR,Korea,2015,462,122,340
SYR,Syria,KOR,Korea,2016,224,98,126
SYR,Syria,KOR,Korea,2017,188,135,53
SYR,Syria,LUX,Luxembourg,2008,0,0,0
SYR,Syria,LUX,Luxembourg,2009,3,6,-3
SYR,Syria,LUX,Luxembourg,2010,0,0,0
SYR,Syria,LUX,Luxembourg,2011,10,7,3
SYR,Syria,LUX,Luxembourg,2012,9,7,2
SYR,Syria,LUX,Luxembourg,2013,19,5,14
SYR,Syria,LUX,Luxembourg,2014,112,7,105
SYR,Syria,LUX,Luxembourg,2015,682,10,672
SYR,Syria,LUX,Luxembourg,2016,371,32,339
SYR,Syria,LUX,Luxembourg,2017,529,10,519
SYR,Syria,MEX,Mexico,2008,8,0,8
SYR,Syria,MEX,Mexico,2009,8,0,8
SYR,Syria,MEX,Mexico,2010,5,0,5
SYR,Syria,MEX,Mexico,2011,11,0,11
SYR,Syria,MEX,Mexico,2012,5,0,5
SYR,Syria,MEX,Mexico,2013,19,0,19
SYR,Syria,MEX,Mexico,2014,15,0,15
SYR,Syria,MEX,Mexico,2015,9,0,9
SYR,Syria,MEX,Mexico,2016,18,0,18
SYR,Syria,MEX,Mexico,2017,13,0,13
SYR,Syria,NLD,Netherlands,2008,65,4,61
SYR,Syria,NLD,Netherlands,2009,80,24,56
SYR,Syria,NLD,Netherlands,2010,101,17,84
SYR,Syria,NLD,Netherlands,2011,90,16,74
SYR,Syria,NLD,Netherlands,2012,134,21,113
SYR,Syria,NLD,Netherlands,2013,576,4,572
SYR,Syria,NLD,Netherlands,2014,6860,42,6818
SYR,Syria,NLD,Netherlands,2015,17273,198,17075
SYR,Syria,NLD,Netherlands,2016,25130,346,24784
SYR,Syria,NLD,Netherlands,2017,15319,644,14675
SYR,Syria,NZL,New Zealand,2008,12,1,11
SYR,Syria,NZL,New Zealand,2009,17,0,17
SYR,Syria,NZL,New Zealand,2010,10,3,7
SYR,Syria,NZL,New Zealand,2011,18,1,17
SYR,Syria,NZL,New Zealand,2012,21,0,21
SYR,Syria,NZL,New Zealand,2013,19,1,18
SYR,Syria,NZL,New Zealand,2014,56,1,55
SYR,Syria,NZL,New Zealand,2015,76,0,76
SYR,Syria,NZL,New Zealand,2016,438,1,437
SYR,Syria,NZL,New Zealand,2017,358,0,358
SYR,Syria,NOR,Norway,2008,85,4,81
SYR,Syria,NOR,Norway,2009,55,7,48
SYR,Syria,NOR,Norway,2010,70,11,59
SYR,Syria,NOR,Norway,2011,67,11,56
SYR,Syria,NOR,Norway,2012,368,8,360
SYR,Syria,NOR,Norway,2013,841,11,830
SYR,Syria,NOR,Norway,2014,2131,13,2118
SYR,Syria,NOR,Norway,2015,4010,24,3986
SYR,Syria,NOR,Norway,2016,11208,24,11184
SYR,Syria,NOR,Norway,2017,6962,88,6874
SYR,Syria,POL,Poland,2008,178,0,178
SYR,Syria,POL,Poland,2009,168,0,168
SYR,Syria,POL,Poland,2010,186,0,186
SYR,Syria,POL,Poland,2011,160,0,160
SYR,Syria,POL,Poland,2012,255,0,255
SYR,Syria,POL,Poland,2013,300,0,300
SYR,Syria,POL,Poland,2014,112,0,112
SYR,Syria,POL,Poland,2015,275,0,275
SYR,Syria,POL,Poland,2016,282,0,282
SYR,Syria,POL,Poland,2017,279,0,279
SYR,Syria,SVK,Slovak Republic,2008,4,8,-4
SYR,Syria,SVK,Slovak Republic,2009,2,8,-6
SYR,Syria,SVK,Slovak Republic,2010,4,9,-5
SYR,Syria,SVK,Slovak Republic,2011,7,1,6
SYR,Syria,SVK,Slovak Republic,2012,4,1,3
SYR,Syria,SVK,Slovak Republic,2013,7,0,7
SYR,Syria,SVK,Slovak Republic,2014,1,0,1
SYR,Syria,SVK,Slovak Republic,2015,7,0,7
SYR,Syria,SVK,Slovak Republic,2017,2,0,2
SYR,Syria,ESP,Spain,2008,261,147,114
SYR,Syria,ESP,Spain,2009,218,201,17
SYR,Syria,ESP,Spain,2010,236,171,65
SYR,Syria,ESP,Spain,2011,267,168,99
SYR,Syria,ESP,Spain,2012,447,136,311
SYR,Syria,ESP,Spain,2013,759,212,547
SYR,Syria,ESP,Spain,2014,773,216,557
SYR,Syria,ESP,Spain,2015,672,230,442
SYR,Syria,ESP,Spain,2016,1178,248,930
SYR,Syria,ESP,Spain,2017,1452,257,1195
SYR,Syria,SWE,Sweden,2008,531,23,508
SYR,Syria,SWE,Sweden,2009,747,8,739
SYR,Syria,SWE,Sweden,2010,1047,22,1025
SYR,Syria,SWE,Sweden,2011,1537,40,1497
SYR,Syria,SWE,Sweden,2012,4730,50,4680
SYR,Syria,SWE,Sweden,2013,11749,47,11702
SYR,Syria,SWE,Sweden,2014,21674,124,21550
SYR,Syria,SWE,Sweden,2015,28011,123,27888
SYR,Syria,SWE,Sweden,2016,48973,165,48808
SYR,Syria,SWE,Sweden,2017,20947,228,20719
SYR,Syria,CHE,Switzerland,2010,149,37,112
SYR,Syria,CHE,Switzerland,2011,233,26,207
SYR,Syria,CHE,Switzerland,2012,290,21,269
SYR,Syria,CHE,Switzerland,2013,280,24,256
SYR,Syria,CHE,Switzerland,2014,1114,25,1089
SYR,Syria,CHE,Switzerland,2015,1800,19,1781
SYR,Syria,CHE,Switzerland,2016,1791,19,1772
SYR,Syria,CHE,Switzerland,2017,1683,28,1655
SYR,Syria,TUR,Turkey,2010,881,0,881
SYR,Syria,TUR,Turkey,2016,25689,7224,18465
SYR,Syria,TUR,Turkey,2017,28189,9382,18807
SYR,Syria,GBR,United Kingdom,2014,1000,0,1000
SYR,Syria,GBR,United Kingdom,2015,1000,0,1000
SYR,Syria,USA,United States,2008,2641,0,2641
SYR,Syria,USA,United States,2009,2442,0,2442
SYR,Syria,USA,United States,2010,2555,0,2555
SYR,Syria,USA,United States,2011,2785,0,2785
SYR,Syria,USA,United States,2012,3014,0,3014
SYR,Syria,USA,United States,2013,3366,0,3366
SYR,Syria,USA,United States,2014,3540,0,3540
SYR,Syria,USA,United States,2015,3840,0,3840
SYR,Syria,USA,United States,2016,4800,0,4800
SYR,Syria,USA,United States,2017,5877,0,5877
SYR,Syria,CHL,Chile,2008,7,0,7
SYR,Syria,CHL,Chile,2009,9,0,9
SYR,Syria,CHL,Chile,2010,8,0,8
SYR,Syria,CHL,Chile,2011,6,0,6
SYR,Syria,CHL,Chile,2012,22,0,22
SYR,Syria,CHL,Chile,2013,27,0,27
SYR,Syria,CHL,Chile,2014,22,0,22
SYR,Syria,CHL,Chile,2015,30,0,30
SYR,Syria,CHL,Chile,2016,83,0,83
SYR,Syria,EST,Estonia,2008,0,0,0
SYR,Syria,EST,Estonia,2009,0,0,0
SYR,Syria,EST,Estonia,2010,0,0,0
SYR,Syria,EST,Estonia,2011,2,0,2
SYR,Syria,EST,Estonia,2012,1,0,1
SYR,Syria,EST,Estonia,2013,0,0,0
SYR,Syria,EST,Estonia,2014,0,0,0
SYR,Syria,EST,Estonia,2015,12,0,12
SYR,Syria,EST,Estonia,2016,62,0,62
SYR,Syria,EST,Estonia,2017,79,0,79
SYR,Syria,SVN,Slovenia,2008,3,0,3
SYR,Syria,SVN,Slovenia,2009,2,0,2
SYR,Syria,SVN,Slovenia,2010,1,0,1
SYR,Syria,SVN,Slovenia,2011,7,0,7
SYR,Syria,SVN,Slovenia,2012,2,0,2
SYR,Syria,SVN,Slovenia,2013,2,0,2
SYR,Syria,SVN,Slovenia,2014,2,0,2
SYR,Syria,SVN,Slovenia,2015,3,0,3
SYR,Syria,SVN,Slovenia,2016,11,1,10
SYR,Syria,SVN,Slovenia,2017,9,1,8
TWN,Chinese Taipei,AUS,Australia,2008,1031,884,147
TWN,Chinese Taipei,AUS,Australia,2009,804,726,78
TWN,Chinese Taipei,AUS,Australia,2010,823,778,45
TWN,Chinese Taipei,AUS,Australia,2011,782,735,47
TWN,Chinese Taipei,AUS,Australia,2012,783,584,199
TWN,Chinese Taipei,AUS,Australia,2013,974,591,383
TWN,Chinese Taipei,AUS,Australia,2014,948,529,419
TWN,Chinese Taipei,AUS,Australia,2015,972,500,472
TWN,Chinese Taipei,AUS,Australia,2016,1121,400,721
TWN,Chinese Taipei,AUS,Australia,2017,1235,0,1235
TWN,Chinese Taipei,AUT,Austria,2014,0,0,0
TWN,Chinese Taipei,AUT,Austria,2015,0,0,0
TWN,Chinese Taipei,AUT,Austria,2016,0,0,0
TWN,Chinese Taipei,AUT,Austria,2017,0,0,0
TWN,Chinese Taipei,BEL,Belgium,2008,101,0,101
TWN,Chinese Taipei,BEL,Belgium,2009,73,0,73
TWN,Chinese Taipei,BEL,Belgium,2010,94,85,9
TWN,Chinese Taipei,BEL,Belgium,2011,109,0,109
TWN,Chinese Taipei,BEL,Belgium,2012,110,82,28
TWN,Chinese Taipei,BEL,Belgium,2013,208,104,104
TWN,Chinese Taipei,BEL,Belgium,2014,131,80,51
TWN,Chinese Taipei,BEL,Belgium,2015,98,80,18
TWN,Chinese Taipei,BEL,Belgium,2016,139,95,44
TWN,Chinese Taipei,BEL,Belgium,2017,157,75,82
TWN,Chinese Taipei,CAN,Canada,2008,2993,0,2993
TWN,Chinese Taipei,CAN,Canada,2009,2472,0,2472
TWN,Chinese Taipei,CAN,Canada,2010,2629,0,2629
TWN,Chinese Taipei,CAN,Canada,2011,1703,0,1703
TWN,Chinese Taipei,CAN,Canada,2012,985,0,985
TWN,Chinese Taipei,CAN,Canada,2013,768,0,768
TWN,Chinese Taipei,CAN,Canada,2014,692,0,692
TWN,Chinese Taipei,CAN,Canada,2015,617,0,617
TWN,Chinese Taipei,CAN,Canada,2016,790,0,790
TWN,Chinese Taipei,CAN,Canada,2017,795,0,795
TWN,Chinese Taipei,DNK,Denmark,2010,23,24,-1
TWN,Chinese Taipei,DNK,Denmark,2011,27,15,12
TWN,Chinese Taipei,DNK,Denmark,2012,29,22,7
TWN,Chinese Taipei,DNK,Denmark,2013,28,34,-6
TWN,Chinese Taipei,DNK,Denmark,2014,33,43,-10
TWN,Chinese Taipei,DNK,Denmark,2015,36,42,-6
TWN,Chinese Taipei,DNK,Denmark,2016,37,63,-26
TWN,Chinese Taipei,DNK,Denmark,2017,59,55,4
TWN,Chinese Taipei,FIN,Finland,2008,0,0,0
TWN,Chinese Taipei,FIN,Finland,2009,0,0,0
TWN,Chinese Taipei,FIN,Finland,2010,0,0,0
TWN,Chinese Taipei,FIN,Finland,2011,0,0,0
TWN,Chinese Taipei,FIN,Finland,2012,0,0,0
TWN,Chinese Taipei,FIN,Finland,2013,0,0,0
TWN,Chinese Taipei,FIN,Finland,2014,0,0,0
TWN,Chinese Taipei,FIN,Finland,2015,0,0,0
TWN,Chinese Taipei,FIN,Finland,2016,0,0,0
TWN,Chinese Taipei,FIN,Finland,2017,0,0,0
TWN,Chinese Taipei,FRA,France,2008,99,0,99
TWN,Chinese Taipei,FRA,France,2009,126,0,126
TWN,Chinese Taipei,FRA,France,2010,134,0,134
TWN,Chinese Taipei,FRA,France,2011,165,0,165
TWN,Chinese Taipei,FRA,France,2012,168,0,168
TWN,Chinese Taipei,FRA,France,2013,180,0,180
TWN,Chinese Taipei,FRA,France,2014,216,0,216
TWN,Chinese Taipei,FRA,France,2015,174,0,174
TWN,Chinese Taipei,FRA,France,2016,187,0,187
TWN,Chinese Taipei,FRA,France,2017,149,0,149
TWN,Chinese Taipei,DEU,Germany,2016,1662,1374,288
TWN,Chinese Taipei,DEU,Germany,2017,1878,1242,636
TWN,Chinese Taipei,HUN,Hungary,2008,0,0,0
TWN,Chinese Taipei,HUN,Hungary,2009,0,0,0
TWN,Chinese Taipei,HUN,Hungary,2010,65,24,41
TWN,Chinese Taipei,HUN,Hungary,2011,47,5,42
TWN,Chinese Taipei,HUN,Hungary,2012,44,3,41
TWN,Chinese Taipei,HUN,Hungary,2013,31,8,23
TWN,Chinese Taipei,HUN,Hungary,2014,51,11,40
TWN,Chinese Taipei,HUN,Hungary,2015,109,11,98
TWN,Chinese Taipei,HUN,Hungary,2016,91,18,73
TWN,Chinese Taipei,HUN,Hungary,2017,85,0,85
TWN,Chinese Taipei,ISL,Iceland,2008,1,1,0
TWN,Chinese Taipei,ISL,Iceland,2009,4,1,3
TWN,Chinese Taipei,ISL,Iceland,2010,4,4,0
TWN,Chinese Taipei,ISL,Iceland,2011,0,3,-3
TWN,Chinese Taipei,ISL,Iceland,2012,0,0,0
TWN,Chinese Taipei,ISL,Iceland,2013,1,1,0
TWN,Chinese Taipei,ISL,Iceland,2014,0,0,0
TWN,Chinese Taipei,ISL,Iceland,2015,1,2,-1
TWN,Chinese Taipei,ISL,Iceland,2016,0,0,0
TWN,Chinese Taipei,ISL,Iceland,2017,0,0,0
TWN,Chinese Taipei,ITA,Italy,2008,39,32,7
TWN,Chinese Taipei,ITA,Italy,2009,41,37,4
TWN,Chinese Taipei,ITA,Italy,2010,40,5,35
TWN,Chinese Taipei,ITA,Italy,2011,64,14,50
TWN,Chinese Taipei,ITA,Italy,2012,79,14,65
TWN,Chinese Taipei,ITA,Italy,2013,123,21,102
TWN,Chinese Taipei,ITA,Italy,2014,60,11,49
TWN,Chinese Taipei,ITA,Italy,2015,85,8,77
TWN,Chinese Taipei,ITA,Italy,2016,60,0,60
TWN,Chinese Taipei,ITA,Italy,2017,73,18,55
TWN,Chinese Taipei,JPN,Japan,2008,5549,3669,1880
TWN,Chinese Taipei,JPN,Japan,2009,5425,4015,1410
TWN,Chinese Taipei,JPN,Japan,2010,6568,4661,1907
TWN,Chinese Taipei,JPN,Japan,2011,5555,5306,249
TWN,Chinese Taipei,JPN,Japan,2012,6602,5002,1600
TWN,Chinese Taipei,JPN,Japan,2013,6596,4881,1715
TWN,Chinese Taipei,JPN,Japan,2014,7704,5156,2548
TWN,Chinese Taipei,JPN,Japan,2015,10836,5680,5156
TWN,Chinese Taipei,JPN,Japan,2016,12242,7951,4291
TWN,Chinese Taipei,JPN,Japan,2017,13737,9319,4418
TWN,Chinese Taipei,KOR,Korea,2008,1357,1328,29
TWN,Chinese Taipei,KOR,Korea,2009,1459,1369,90
TWN,Chinese Taipei,KOR,Korea,2010,1440,1400,40
TWN,Chinese Taipei,KOR,Korea,2011,1629,1496,133
TWN,Chinese Taipei,KOR,Korea,2012,1633,1943,-310
TWN,Chinese Taipei,KOR,Korea,2013,1952,1614,338
TWN,Chinese Taipei,KOR,Korea,2014,1971,1969,2
TWN,Chinese Taipei,KOR,Korea,2015,1992,2517,-525
TWN,Chinese Taipei,KOR,Korea,2016,2339,2251,88
TWN,Chinese Taipei,KOR,Korea,2017,2486,2544,-58
TWN,Chinese Taipei,LUX,Luxembourg,2008,8,1,7
TWN,Chinese Taipei,LUX,Luxembourg,2009,10,7,3
TWN,Chinese Taipei,LUX,Luxembourg,2010,0,0,0
TWN,Chinese Taipei,LUX,Luxembourg,2011,2,0,2
TWN,Chinese Taipei,LUX,Luxembourg,2012,7,10,-3
TWN,Chinese Taipei,LUX,Luxembourg,2013,1,1,0
TWN,Chinese Taipei,LUX,Luxembourg,2014,0,0,0
TWN,Chinese Taipei,LUX,Luxembourg,2015,7,0,7
TWN,Chinese Taipei,LUX,Luxembourg,2016,6,3,3
TWN,Chinese Taipei,LUX,Luxembourg,2017,10,2,8
TWN,Chinese Taipei,MEX,Mexico,2008,29,0,29
TWN,Chinese Taipei,MEX,Mexico,2009,42,0,42
TWN,Chinese Taipei,MEX,Mexico,2010,55,0,55
TWN,Chinese Taipei,MEX,Mexico,2011,64,0,64
TWN,Chinese Taipei,MEX,Mexico,2012,57,0,57
TWN,Chinese Taipei,MEX,Mexico,2013,183,0,183
TWN,Chinese Taipei,MEX,Mexico,2014,83,0,83
TWN,Chinese Taipei,MEX,Mexico,2015,59,0,59
TWN,Chinese Taipei,MEX,Mexico,2016,43,0,43
TWN,Chinese Taipei,MEX,Mexico,2017,58,0,58
TWN,Chinese Taipei,NLD,Netherlands,2008,402,294,108
TWN,Chinese Taipei,NLD,Netherlands,2009,351,312,39
TWN,Chinese Taipei,NLD,Netherlands,2010,405,321,84
TWN,Chinese Taipei,NLD,Netherlands,2011,443,361,82
TWN,Chinese Taipei,NLD,Netherlands,2012,349,373,-24
TWN,Chinese Taipei,NLD,Netherlands,2013,409,354,55
TWN,Chinese Taipei,NLD,Netherlands,2014,462,292,170
TWN,Chinese Taipei,NLD,Netherlands,2015,509,332,177
TWN,Chinese Taipei,NLD,Netherlands,2016,644,363,281
TWN,Chinese Taipei,NLD,Netherlands,2017,723,498,225
TWN,Chinese Taipei,NZL,New Zealand,2008,565,226,339
TWN,Chinese Taipei,NZL,New Zealand,2009,522,193,329
TWN,Chinese Taipei,NZL,New Zealand,2010,588,211,377
TWN,Chinese Taipei,NZL,New Zealand,2011,590,232,358
TWN,Chinese Taipei,NZL,New Zealand,2012,560,225,335
TWN,Chinese Taipei,NZL,New Zealand,2013,630,185,445
TWN,Chinese Taipei,NZL,New Zealand,2014,604,204,400
TWN,Chinese Taipei,NZL,New Zealand,2015,684,200,484
TWN,Chinese Taipei,NZL,New Zealand,2016,683,225,458
TWN,Chinese Taipei,NZL,New Zealand,2017,691,222,469
TWN,Chinese Taipei,NOR,Norway,2008,29,7,22
TWN,Chinese Taipei,NOR,Norway,2009,21,17,4
TWN,Chinese Taipei,NOR,Norway,2010,12,12,0
TWN,Chinese Taipei,NOR,Norway,2011,0,0,0
TWN,Chinese Taipei,NOR,Norway,2012,0,0,0
TWN,Chinese Taipei,NOR,Norway,2013,0,0,0
TWN,Chinese Taipei,NOR,Norway,2014,0,0,0
TWN,Chinese Taipei,NOR,Norway,2015,0,0,0
TWN,Chinese Taipei,NOR,Norway,2016,0,0,0
TWN,Chinese Taipei,NOR,Norway,2017,0,0,0
TWN,Chinese Taipei,POL,Poland,2009,659,0,659
TWN,Chinese Taipei,POL,Poland,2010,555,0,555
TWN,Chinese Taipei,POL,Poland,2011,493,0,493
TWN,Chinese Taipei,POL,Poland,2012,380,0,380
TWN,Chinese Taipei,POL,Poland,2013,224,0,224
TWN,Chinese Taipei,POL,Poland,2014,95,0,95
TWN,Chinese Taipei,POL,Poland,2015,187,0,187
TWN,Chinese Taipei,POL,Poland,2016,308,0,308
TWN,Chinese Taipei,POL,Poland,2017,389,0,389
TWN,Chinese Taipei,SVK,Slovak Republic,2008,4,0,4
TWN,Chinese Taipei,SVK,Slovak Republic,2009,14,1,13
TWN,Chinese Taipei,SVK,Slovak Republic,2010,2,1,1
TWN,Chinese Taipei,SVK,Slovak Republic,2011,1,17,-16
TWN,Chinese Taipei,SVK,Slovak Republic,2016,1,0,1
TWN,Chinese Taipei,SVK,Slovak Republic,2017,1,0,1
TWN,Chinese Taipei,ESP,Spain,2008,69,47,22
TWN,Chinese Taipei,ESP,Spain,2009,76,81,-5
TWN,Chinese Taipei,ESP,Spain,2010,101,51,50
TWN,Chinese Taipei,ESP,Spain,2011,0,0,0
TWN,Chinese Taipei,ESP,Spain,2012,0,0,0
TWN,Chinese Taipei,ESP,Spain,2013,0,0,0
TWN,Chinese Taipei,SWE,Sweden,2008,128,11,117
TWN,Chinese Taipei,SWE,Sweden,2009,110,17,93
TWN,Chinese Taipei,SWE,Sweden,2010,103,25,78
TWN,Chinese Taipei,SWE,Sweden,2011,88,38,50
TWN,Chinese Taipei,SWE,Sweden,2012,91,64,27
TWN,Chinese Taipei,SWE,Sweden,2013,95,35,60
TWN,Chinese Taipei,SWE,Sweden,2014,131,46,85
TWN,Chinese Taipei,SWE,Sweden,2015,106,59,47
TWN,Chinese Taipei,SWE,Sweden,2016,122,32,90
TWN,Chinese Taipei,SWE,Sweden,2017,141,33,108
TWN,Chinese Taipei,CHE,Switzerland,2010,225,186,39
TWN,Chinese Taipei,CHE,Switzerland,2011,280,188,92
TWN,Chinese Taipei,CHE,Switzerland,2012,277,233,44
TWN,Chinese Taipei,CHE,Switzerland,2013,342,214,128
TWN,Chinese Taipei,CHE,Switzerland,2014,308,276,32
TWN,Chinese Taipei,CHE,Switzerland,2015,338,226,112
TWN,Chinese Taipei,CHE,Switzerland,2016,330,311,19
TWN,Chinese Taipei,CHE,Switzerland,2017,335,299,36
TWN,Chinese Taipei,GBR,United Kingdom,2008,1000,1000,0
TWN,Chinese Taipei,GBR,United Kingdom,2009,4000,0,4000
TWN,Chinese Taipei,GBR,United Kingdom,2013,4000,0,4000
TWN,Chinese Taipei,USA,United States,2008,9073,0,9073
TWN,Chinese Taipei,USA,United States,2009,8038,0,8038
TWN,Chinese Taipei,USA,United States,2010,6732,0,6732
TWN,Chinese Taipei,USA,United States,2011,6154,0,6154
TWN,Chinese Taipei,USA,United States,2012,5331,0,5331
TWN,Chinese Taipei,USA,United States,2013,5385,0,5385
TWN,Chinese Taipei,USA,United States,2014,4697,0,4697
TWN,Chinese Taipei,USA,United States,2015,4888,0,4888
TWN,Chinese Taipei,USA,United States,2016,5120,0,5120
TWN,Chinese Taipei,USA,United States,2017,4858,0,4858
TWN,Chinese Taipei,CHL,Chile,2008,31,0,31
TWN,Chinese Taipei,CHL,Chile,2009,25,0,25
TWN,Chinese Taipei,CHL,Chile,2010,29,0,29
TWN,Chinese Taipei,CHL,Chile,2011,30,0,30
TWN,Chinese Taipei,CHL,Chile,2012,37,0,37
TWN,Chinese Taipei,CHL,Chile,2013,30,0,30
TWN,Chinese Taipei,CHL,Chile,2014,36,0,36
TWN,Chinese Taipei,CHL,Chile,2015,19,0,19
TWN,Chinese Taipei,CHL,Chile,2016,26,0,26
TWN,Chinese Taipei,EST,Estonia,2008,0,0,0
TWN,Chinese Taipei,EST,Estonia,2009,1,0,1
TWN,Chinese Taipei,EST,Estonia,2010,0,0,0
TWN,Chinese Taipei,EST,Estonia,2011,0,0,0
TWN,Chinese Taipei,EST,Estonia,2012,1,0,1
TWN,Chinese Taipei,EST,Estonia,2013,3,0,3
TWN,Chinese Taipei,EST,Estonia,2014,0,0,0
TWN,Chinese Taipei,EST,Estonia,2015,1,0,1
TWN,Chinese Taipei,EST,Estonia,2016,1,0,1
TWN,Chinese Taipei,EST,Estonia,2017,0,0,0
TWN,Chinese Taipei,SVN,Slovenia,2012,1,0,1
TWN,Chinese Taipei,SVN,Slovenia,2013,2,0,2
TWN,Chinese Taipei,SVN,Slovenia,2014,4,0,4
TWN,Chinese Taipei,SVN,Slovenia,2015,5,0,5
TWN,Chinese Taipei,SVN,Slovenia,2016,4,0,4
TWN,Chinese Taipei,SVN,Slovenia,2017,5,0,5
TJK,Tajikistan,AUS,Australia,2008,0,0,0
TJK,Tajikistan,AUS,Australia,2009,6,0,6
TJK,Tajikistan,AUS,Australia,2010,11,0,11
TJK,Tajikistan,AUS,Australia,2011,7,0,7
TJK,Tajikistan,AUS,Australia,2012,4,0,4
TJK,Tajikistan,AUS,Australia,2013,4,0,4
TJK,Tajikistan,AUS,Australia,2014,8,0,8
TJK,Tajikistan,AUS,Australia,2015,0,0,0
TJK,Tajikistan,AUS,Australia,2017,0,0,0
TJK,Tajikistan,AUT,Austria,2008,16,3,13
TJK,Tajikistan,AUT,Austria,2009,27,8,19
TJK,Tajikistan,AUT,Austria,2010,41,16,25
TJK,Tajikistan,AUT,Austria,2011,48,16,32
TJK,Tajikistan,AUT,Austria,2012,75,16,59
TJK,Tajikistan,AUT,Austria,2013,47,23,24
TJK,Tajikistan,AUT,Austria,2014,41,10,31
TJK,Tajikistan,AUT,Austria,2015,106,12,94
TJK,Tajikistan,AUT,Austria,2016,120,37,83
TJK,Tajikistan,AUT,Austria,2017,61,72,-11
TJK,Tajikistan,BEL,Belgium,2008,5,0,5
TJK,Tajikistan,BEL,Belgium,2009,6,0,6
TJK,Tajikistan,BEL,Belgium,2010,6,0,6
TJK,Tajikistan,BEL,Belgium,2012,17,11,6
TJK,Tajikistan,BEL,Belgium,2013,4,14,-10
TJK,Tajikistan,BEL,Belgium,2014,13,7,6
TJK,Tajikistan,BEL,Belgium,2015,17,1,16
TJK,Tajikistan,BEL,Belgium,2016,7,4,3
TJK,Tajikistan,BEL,Belgium,2017,8,2,6
TJK,Tajikistan,CAN,Canada,2008,15,0,15
TJK,Tajikistan,CAN,Canada,2009,50,0,50
TJK,Tajikistan,CAN,Canada,2010,52,0,52
TJK,Tajikistan,CAN,Canada,2011,47,0,47
TJK,Tajikistan,CAN,Canada,2012,34,0,34
TJK,Tajikistan,CAN,Canada,2013,39,0,39
TJK,Tajikistan,CAN,Canada,2014,24,0,24
TJK,Tajikistan,CAN,Canada,2015,43,0,43
TJK,Tajikistan,CAN,Canada,2016,30,0,30
TJK,Tajikistan,CAN,Canada,2017,40,0,40
TJK,Tajikistan,CZE,Czech Republic,2008,59,5,54
TJK,Tajikistan,CZE,Czech Republic,2009,54,0,54
TJK,Tajikistan,CZE,Czech Republic,2010,10,0,10
TJK,Tajikistan,CZE,Czech Republic,2011,6,1,5
TJK,Tajikistan,CZE,Czech Republic,2012,13,8,5
TJK,Tajikistan,CZE,Czech Republic,2013,9,24,-15
TJK,Tajikistan,CZE,Czech Republic,2014,19,6,13
TJK,Tajikistan,CZE,Czech Republic,2015,18,5,13
TJK,Tajikistan,CZE,Czech Republic,2016,36,8,28
TJK,Tajikistan,CZE,Czech Republic,2017,29,14,15
TJK,Tajikistan,DNK,Denmark,2008,0,0,0
TJK,Tajikistan,DNK,Denmark,2009,1,1,0
TJK,Tajikistan,DNK,Denmark,2010,1,0,1
TJK,Tajikistan,DNK,Denmark,2011,1,1,0
TJK,Tajikistan,DNK,Denmark,2012,3,0,3
TJK,Tajikistan,DNK,Denmark,2013,1,0,1
TJK,Tajikistan,DNK,Denmark,2014,0,0,0
TJK,Tajikistan,DNK,Denmark,2015,1,1,0
TJK,Tajikistan,DNK,Denmark,2016,1,0,1
TJK,Tajikistan,DNK,Denmark,2017,1,0,1
TJK,Tajikistan,FIN,Finland,2008,11,1,10
TJK,Tajikistan,FIN,Finland,2009,3,0,3
TJK,Tajikistan,FIN,Finland,2010,4,0,4
TJK,Tajikistan,FIN,Finland,2011,0,0,0
TJK,Tajikistan,FIN,Finland,2012,2,1,1
TJK,Tajikistan,FIN,Finland,2013,1,0,1
TJK,Tajikistan,FIN,Finland,2014,2,0,2
TJK,Tajikistan,FIN,Finland,2015,7,0,7
TJK,Tajikistan,FIN,Finland,2016,1,0,1
TJK,Tajikistan,FIN,Finland,2017,0,0,0
TJK,Tajikistan,FRA,France,2008,10,0,10
TJK,Tajikistan,FRA,France,2009,12,0,12
TJK,Tajikistan,FRA,France,2010,7,0,7
TJK,Tajikistan,FRA,France,2011,14,0,14
TJK,Tajikistan,FRA,France,2012,8,0,8
TJK,Tajikistan,FRA,France,2013,14,0,14
TJK,Tajikistan,FRA,France,2014,14,0,14
TJK,Tajikistan,FRA,France,2015,19,0,19
TJK,Tajikistan,FRA,France,2016,18,0,18
TJK,Tajikistan,FRA,France,2017,18,0,18
TJK,Tajikistan,DEU,Germany,2008,153,127,26
TJK,Tajikistan,DEU,Germany,2009,199,163,36
TJK,Tajikistan,DEU,Germany,2010,235,119,116
TJK,Tajikistan,DEU,Germany,2011,285,162,123
TJK,Tajikistan,DEU,Germany,2012,207,156,51
TJK,Tajikistan,DEU,Germany,2013,365,145,220
TJK,Tajikistan,DEU,Germany,2014,649,197,452
TJK,Tajikistan,DEU,Germany,2015,1008,356,652
TJK,Tajikistan,DEU,Germany,2016,1497,478,1019
TJK,Tajikistan,DEU,Germany,2017,1651,808,843
TJK,Tajikistan,HUN,Hungary,2008,5,1,4
TJK,Tajikistan,HUN,Hungary,2009,3,0,3
TJK,Tajikistan,HUN,Hungary,2010,3,0,3
TJK,Tajikistan,HUN,Hungary,2011,3,0,3
TJK,Tajikistan,HUN,Hungary,2012,3,0,3
TJK,Tajikistan,HUN,Hungary,2013,3,1,2
TJK,Tajikistan,HUN,Hungary,2014,1,0,1
TJK,Tajikistan,HUN,Hungary,2015,9,0,9
TJK,Tajikistan,HUN,Hungary,2016,5,0,5
TJK,Tajikistan,HUN,Hungary,2017,8,0,8
TJK,Tajikistan,ISL,Iceland,2016,1,0,1
TJK,Tajikistan,ISL,Iceland,2017,0,0,0
TJK,Tajikistan,ITA,Italy,2008,3,0,3
TJK,Tajikistan,ITA,Italy,2009,8,0,8
TJK,Tajikistan,ITA,Italy,2010,5,0,5
TJK,Tajikistan,ITA,Italy,2011,6,0,6
TJK,Tajikistan,ITA,Italy,2012,0,0,0
TJK,Tajikistan,ITA,Italy,2013,16,3,13
TJK,Tajikistan,ITA,Italy,2014,4,0,4
TJK,Tajikistan,ITA,Italy,2015,2,0,2
TJK,Tajikistan,ITA,Italy,2016,10,0,10
TJK,Tajikistan,ITA,Italy,2017,13,0,13
TJK,Tajikistan,JPN,Japan,2008,149,125,24
TJK,Tajikistan,JPN,Japan,2009,124,111,13
TJK,Tajikistan,JPN,Japan,2010,128,118,10
TJK,Tajikistan,JPN,Japan,2011,136,108,28
TJK,Tajikistan,JPN,Japan,2012,120,118,2
TJK,Tajikistan,JPN,Japan,2013,118,107,11
TJK,Tajikistan,JPN,Japan,2014,126,101,25
TJK,Tajikistan,JPN,Japan,2015,151,141,10
TJK,Tajikistan,JPN,Japan,2016,214,180,34
TJK,Tajikistan,JPN,Japan,2017,142,118,24
TJK,Tajikistan,KOR,Korea,2008,39,30,9
TJK,Tajikistan,KOR,Korea,2009,30,30,0
TJK,Tajikistan,KOR,Korea,2010,71,40,31
TJK,Tajikistan,KOR,Korea,2011,110,67,43
TJK,Tajikistan,KOR,Korea,2012,170,107,63
TJK,Tajikistan,KOR,Korea,2013,99,91,8
TJK,Tajikistan,KOR,Korea,2014,173,124,49
TJK,Tajikistan,KOR,Korea,2015,119,119,0
TJK,Tajikistan,KOR,Korea,2016,161,125,36
TJK,Tajikistan,KOR,Korea,2017,219,174,45
TJK,Tajikistan,LUX,Luxembourg,2008,0,1,-1
TJK,Tajikistan,LUX,Luxembourg,2009,0,0,0
TJK,Tajikistan,LUX,Luxembourg,2010,0,0,0
TJK,Tajikistan,LUX,Luxembourg,2011,0,0,0
TJK,Tajikistan,LUX,Luxembourg,2012,0,0,0
TJK,Tajikistan,LUX,Luxembourg,2013,1,0,1
TJK,Tajikistan,LUX,Luxembourg,2014,1,0,1
TJK,Tajikistan,LUX,Luxembourg,2015,1,0,1
TJK,Tajikistan,LUX,Luxembourg,2016,2,0,2
TJK,Tajikistan,LUX,Luxembourg,2017,5,0,5
TJK,Tajikistan,MEX,Mexico,2012,3,0,3
TJK,Tajikistan,MEX,Mexico,2013,0,0,0
TJK,Tajikistan,MEX,Mexico,2014,2,0,2
TJK,Tajikistan,MEX,Mexico,2015,3,0,3
TJK,Tajikistan,MEX,Mexico,2016,8,0,8
TJK,Tajikistan,MEX,Mexico,2017,4,0,4
TJK,Tajikistan,NLD,Netherlands,2009,5,5,0
TJK,Tajikistan,NLD,Netherlands,2010,3,1,2
TJK,Tajikistan,NLD,Netherlands,2011,4,2,2
TJK,Tajikistan,NLD,Netherlands,2012,1,2,-1
TJK,Tajikistan,NLD,Netherlands,2013,9,0,9
TJK,Tajikistan,NLD,Netherlands,2014,14,1,13
TJK,Tajikistan,NLD,Netherlands,2015,8,3,5
TJK,Tajikistan,NLD,Netherlands,2016,16,4,12
TJK,Tajikistan,NLD,Netherlands,2017,12,13,-1
TJK,Tajikistan,NZL,New Zealand,2008,0,0,0
TJK,Tajikistan,NZL,New Zealand,2009,4,2,2
TJK,Tajikistan,NZL,New Zealand,2010,1,0,1
TJK,Tajikistan,NZL,New Zealand,2011,0,1,-1
TJK,Tajikistan,NZL,New Zealand,2012,6,0,6
TJK,Tajikistan,NZL,New Zealand,2013,1,0,1
TJK,Tajikistan,NZL,New Zealand,2016,5,0,5
TJK,Tajikistan,NZL,New Zealand,2017,4,0,4
TJK,Tajikistan,NOR,Norway,2008,7,0,7
TJK,Tajikistan,NOR,Norway,2009,4,1,3
TJK,Tajikistan,NOR,Norway,2010,1,0,1
TJK,Tajikistan,NOR,Norway,2011,4,4,0
TJK,Tajikistan,NOR,Norway,2012,7,3,4
TJK,Tajikistan,NOR,Norway,2013,7,0,7
TJK,Tajikistan,NOR,Norway,2014,3,9,-6
TJK,Tajikistan,NOR,Norway,2015,3,0,3
TJK,Tajikistan,NOR,Norway,2016,5,4,1
TJK,Tajikistan,NOR,Norway,2017,2,0,2
TJK,Tajikistan,POL,Poland,2008,13,0,13
TJK,Tajikistan,POL,Poland,2009,21,0,21
TJK,Tajikistan,POL,Poland,2010,12,0,12
TJK,Tajikistan,POL,Poland,2011,37,0,37
TJK,Tajikistan,POL,Poland,2012,42,0,42
TJK,Tajikistan,POL,Poland,2013,31,0,31
TJK,Tajikistan,POL,Poland,2014,33,0,33
TJK,Tajikistan,POL,Poland,2015,61,0,61
TJK,Tajikistan,POL,Poland,2016,123,0,123
TJK,Tajikistan,POL,Poland,2017,264,0,264
TJK,Tajikistan,SVK,Slovak Republic,2008,8,0,8
TJK,Tajikistan,SVK,Slovak Republic,2009,3,6,-3
TJK,Tajikistan,SVK,Slovak Republic,2010,1,1,0
TJK,Tajikistan,ESP,Spain,2008,2,3,-1
TJK,Tajikistan,ESP,Spain,2009,11,2,9
TJK,Tajikistan,ESP,Spain,2010,8,3,5
TJK,Tajikistan,ESP,Spain,2011,7,5,2
TJK,Tajikistan,ESP,Spain,2012,16,6,10
TJK,Tajikistan,ESP,Spain,2013,16,4,12
TJK,Tajikistan,ESP,Spain,2014,10,2,8
TJK,Tajikistan,ESP,Spain,2015,17,7,10
TJK,Tajikistan,ESP,Spain,2016,13,3,10
TJK,Tajikistan,ESP,Spain,2017,4,9,-5
TJK,Tajikistan,SWE,Sweden,2008,20,2,18
TJK,Tajikistan,SWE,Sweden,2009,19,2,17
TJK,Tajikistan,SWE,Sweden,2010,6,6,0
TJK,Tajikistan,SWE,Sweden,2011,11,3,8
TJK,Tajikistan,SWE,Sweden,2012,23,5,18
TJK,Tajikistan,SWE,Sweden,2013,43,2,41
TJK,Tajikistan,SWE,Sweden,2014,22,3,19
TJK,Tajikistan,SWE,Sweden,2015,9,8,1
TJK,Tajikistan,SWE,Sweden,2016,34,1,33
TJK,Tajikistan,SWE,Sweden,2017,26,1,25
TJK,Tajikistan,CHE,Switzerland,2010,11,1,10
TJK,Tajikistan,CHE,Switzerland,2011,10,8,2
TJK,Tajikistan,CHE,Switzerland,2012,15,5,10
TJK,Tajikistan,CHE,Switzerland,2013,5,5,0
TJK,Tajikistan,CHE,Switzerland,2014,7,3,4
TJK,Tajikistan,CHE,Switzerland,2015,5,3,2
TJK,Tajikistan,CHE,Switzerland,2016,3,6,-3
TJK,Tajikistan,CHE,Switzerland,2017,13,4,9
TJK,Tajikistan,TUR,Turkey,2010,83,0,83
TJK,Tajikistan,TUR,Turkey,2016,852,346,506
TJK,Tajikistan,TUR,Turkey,2017,1616,501,1115
TJK,Tajikistan,USA,United States,2008,231,0,231
TJK,Tajikistan,USA,United States,2009,265,0,265
TJK,Tajikistan,USA,United States,2010,299,0,299
TJK,Tajikistan,USA,United States,2011,382,0,382
TJK,Tajikistan,USA,United States,2012,411,0,411
TJK,Tajikistan,USA,United States,2013,550,0,550
TJK,Tajikistan,USA,United States,2014,516,0,516
TJK,Tajikistan,USA,United States,2015,595,0,595
TJK,Tajikistan,USA,United States,2016,593,0,593
TJK,Tajikistan,USA,United States,2017,652,0,652
TJK,Tajikistan,CHL,Chile,2008,0,0,0
TJK,Tajikistan,CHL,Chile,2009,0,0,0
TJK,Tajikistan,CHL,Chile,2010,0,0,0
TJK,Tajikistan,CHL,Chile,2011,0,0,0
TJK,Tajikistan,CHL,Chile,2012,0,0,0
TJK,Tajikistan,CHL,Chile,2013,0,0,0
TJK,Tajikistan,CHL,Chile,2014,0,0,0
TJK,Tajikistan,CHL,Chile,2015,0,0,0
TJK,Tajikistan,CHL,Chile,2016,0,0,0
TJK,Tajikistan,EST,Estonia,2008,0,0,0
TJK,Tajikistan,EST,Estonia,2009,0,0,0
TJK,Tajikistan,EST,Estonia,2010,0,0,0
TJK,Tajikistan,EST,Estonia,2011,0,0,0
TJK,Tajikistan,EST,Estonia,2012,0,0,0
TJK,Tajikistan,EST,Estonia,2013,1,0,1
TJK,Tajikistan,EST,Estonia,2014,0,0,0
TJK,Tajikistan,EST,Estonia,2015,1,0,1
TJK,Tajikistan,EST,Estonia,2016,1,0,1
TJK,Tajikistan,EST,Estonia,2017,4,0,4
TJK,Tajikistan,SVN,Slovenia,2008,1,0,1
TJK,Tajikistan,SVN,Slovenia,2010,3,0,3
TJK,Tajikistan,SVN,Slovenia,2013,2,0,2
TJK,Tajikistan,SVN,Slovenia,2014,1,0,1
TJK,Tajikistan,SVN,Slovenia,2015,1,0,1
TJK,Tajikistan,SVN,Slovenia,2017,2,1,1
TZA,Tanzania,AUS,Australia,2008,42,19,23
TZA,Tanzania,AUS,Australia,2009,58,14,44
TZA,Tanzania,AUS,Australia,2010,57,26,31
TZA,Tanzania,AUS,Australia,2011,63,19,44
TZA,Tanzania,AUS,Australia,2012,49,19,30
TZA,Tanzania,AUS,Australia,2013,57,26,31
TZA,Tanzania,AUS,Australia,2014,78,21,57
TZA,Tanzania,AUS,Australia,2015,69,0,69
TZA,Tanzania,AUS,Australia,2016,69,0,69
TZA,Tanzania,AUS,Australia,2017,83,0,83
TZA,Tanzania,AUT,Austria,2008,13,13,0
TZA,Tanzania,AUT,Austria,2009,12,8,4
TZA,Tanzania,AUT,Austria,2010,15,5,10
TZA,Tanzania,AUT,Austria,2011,18,10,8
TZA,Tanzania,AUT,Austria,2012,13,13,0
TZA,Tanzania,AUT,Austria,2013,19,11,8
TZA,Tanzania,AUT,Austria,2014,25,12,13
TZA,Tanzania,AUT,Austria,2015,20,7,13
TZA,Tanzania,AUT,Austria,2016,24,10,14
TZA,Tanzania,AUT,Austria,2017,19,15,4
TZA,Tanzania,BEL,Belgium,2008,42,0,42
TZA,Tanzania,BEL,Belgium,2009,73,0,73
TZA,Tanzania,BEL,Belgium,2010,69,47,22
TZA,Tanzania,BEL,Belgium,2012,59,73,-14
TZA,Tanzania,BEL,Belgium,2013,59,82,-23
TZA,Tanzania,BEL,Belgium,2014,57,70,-13
TZA,Tanzania,BEL,Belgium,2015,38,43,-5
TZA,Tanzania,BEL,Belgium,2016,52,31,21
TZA,Tanzania,BEL,Belgium,2017,66,24,42
TZA,Tanzania,CAN,Canada,2008,230,0,230
TZA,Tanzania,CAN,Canada,2009,136,0,136
TZA,Tanzania,CAN,Canada,2010,200,0,200
TZA,Tanzania,CAN,Canada,2011,215,0,215
TZA,Tanzania,CAN,Canada,2012,224,0,224
TZA,Tanzania,CAN,Canada,2013,182,0,182
TZA,Tanzania,CAN,Canada,2014,133,0,133
TZA,Tanzania,CAN,Canada,2015,157,0,157
TZA,Tanzania,CAN,Canada,2016,115,0,115
TZA,Tanzania,CAN,Canada,2017,195,0,195
TZA,Tanzania,CZE,Czech Republic,2008,2,0,2
TZA,Tanzania,CZE,Czech Republic,2012,2,1,1
TZA,Tanzania,CZE,Czech Republic,2013,1,1,0
TZA,Tanzania,CZE,Czech Republic,2014,1,3,-2
TZA,Tanzania,CZE,Czech Republic,2015,3,1,2
TZA,Tanzania,CZE,Czech Republic,2016,2,0,2
TZA,Tanzania,CZE,Czech Republic,2017,3,0,3
TZA,Tanzania,DNK,Denmark,2008,41,12,29
TZA,Tanzania,DNK,Denmark,2009,18,13,5
TZA,Tanzania,DNK,Denmark,2010,25,16,9
TZA,Tanzania,DNK,Denmark,2011,26,22,4
TZA,Tanzania,DNK,Denmark,2012,30,26,4
TZA,Tanzania,DNK,Denmark,2013,32,27,5
TZA,Tanzania,DNK,Denmark,2014,15,17,-2
TZA,Tanzania,DNK,Denmark,2015,0,29,-29
TZA,Tanzania,DNK,Denmark,2016,19,18,1
TZA,Tanzania,DNK,Denmark,2017,28,30,-2
TZA,Tanzania,FIN,Finland,2008,37,12,25
TZA,Tanzania,FIN,Finland,2009,25,5,20
TZA,Tanzania,FIN,Finland,2010,31,2,29
TZA,Tanzania,FIN,Finland,2011,26,5,21
TZA,Tanzania,FIN,Finland,2012,39,5,34
TZA,Tanzania,FIN,Finland,2013,22,5,17
TZA,Tanzania,FIN,Finland,2014,26,2,24
TZA,Tanzania,FIN,Finland,2015,16,7,9
TZA,Tanzania,FIN,Finland,2016,18,5,13
TZA,Tanzania,FIN,Finland,2017,12,7,5
TZA,Tanzania,FRA,France,2008,18,0,18
TZA,Tanzania,FRA,France,2009,21,0,21
TZA,Tanzania,FRA,France,2010,11,0,11
TZA,Tanzania,FRA,France,2011,18,0,18
TZA,Tanzania,FRA,France,2012,15,0,15
TZA,Tanzania,FRA,France,2013,14,0,14
TZA,Tanzania,FRA,France,2014,16,0,16
TZA,Tanzania,FRA,France,2015,26,0,26
TZA,Tanzania,FRA,France,2016,28,0,28
TZA,Tanzania,FRA,France,2017,20,0,20
TZA,Tanzania,DEU,Germany,2008,167,156,11
TZA,Tanzania,DEU,Germany,2009,178,178,0
TZA,Tanzania,DEU,Germany,2010,182,166,16
TZA,Tanzania,DEU,Germany,2011,200,140,60
TZA,Tanzania,DEU,Germany,2012,175,126,49
TZA,Tanzania,DEU,Germany,2013,248,138,110
TZA,Tanzania,DEU,Germany,2014,238,166,72
TZA,Tanzania,DEU,Germany,2015,300,169,131
TZA,Tanzania,DEU,Germany,2016,293,148,145
TZA,Tanzania,DEU,Germany,2017,336,195,141
TZA,Tanzania,HUN,Hungary,2008,8,0,8
TZA,Tanzania,HUN,Hungary,2009,1,0,1
TZA,Tanzania,HUN,Hungary,2010,1,0,1
TZA,Tanzania,HUN,Hungary,2011,5,0,5
TZA,Tanzania,HUN,Hungary,2012,8,0,8
TZA,Tanzania,HUN,Hungary,2013,2,2,0
TZA,Tanzania,HUN,Hungary,2014,5,1,4
TZA,Tanzania,HUN,Hungary,2015,1,0,1
TZA,Tanzania,HUN,Hungary,2016,2,0,2
TZA,Tanzania,HUN,Hungary,2017,5,0,5
TZA,Tanzania,ISL,Iceland,2008,3,4,-1
TZA,Tanzania,ISL,Iceland,2009,1,2,-1
TZA,Tanzania,ISL,Iceland,2010,3,1,2
TZA,Tanzania,ISL,Iceland,2011,2,1,1
TZA,Tanzania,ISL,Iceland,2012,5,0,5
TZA,Tanzania,ISL,Iceland,2013,6,4,2
TZA,Tanzania,ISL,Iceland,2014,4,6,-2
TZA,Tanzania,ISL,Iceland,2015,3,4,-1
TZA,Tanzania,ISL,Iceland,2016,5,7,-2
TZA,Tanzania,ISL,Iceland,2017,4,5,-1
TZA,Tanzania,ITA,Italy,2008,68,9,59
TZA,Tanzania,ITA,Italy,2009,113,14,99
TZA,Tanzania,ITA,Italy,2010,89,10,79
TZA,Tanzania,ITA,Italy,2011,62,11,51
TZA,Tanzania,ITA,Italy,2012,93,15,78
TZA,Tanzania,ITA,Italy,2013,80,13,67
TZA,Tanzania,ITA,Italy,2014,67,14,53
TZA,Tanzania,ITA,Italy,2015,87,19,68
TZA,Tanzania,ITA,Italy,2016,89,0,89
TZA,Tanzania,ITA,Italy,2017,95,14,81
TZA,Tanzania,JPN,Japan,2008,261,260,1
TZA,Tanzania,JPN,Japan,2009,246,222,24
TZA,Tanzania,JPN,Japan,2010,292,266,26
TZA,Tanzania,JPN,Japan,2011,196,198,-2
TZA,Tanzania,JPN,Japan,2012,259,254,5
TZA,Tanzania,JPN,Japan,2013,294,269,25
TZA,Tanzania,JPN,Japan,2014,321,278,43
TZA,Tanzania,JPN,Japan,2015,314,249,65
TZA,Tanzania,JPN,Japan,2016,256,226,30
TZA,Tanzania,JPN,Japan,2017,251,245,6
TZA,Tanzania,KOR,Korea,2008,42,22,20
TZA,Tanzania,KOR,Korea,2009,53,42,11
TZA,Tanzania,KOR,Korea,2010,57,42,15
TZA,Tanzania,KOR,Korea,2011,64,54,10
TZA,Tanzania,KOR,Korea,2012,73,54,19
TZA,Tanzania,KOR,Korea,2013,47,72,-25
TZA,Tanzania,KOR,Korea,2014,67,55,12
TZA,Tanzania,KOR,Korea,2015,67,54,13
TZA,Tanzania,KOR,Korea,2016,65,73,-8
TZA,Tanzania,KOR,Korea,2017,86,53,33
TZA,Tanzania,LUX,Luxembourg,2008,1,0,1
TZA,Tanzania,LUX,Luxembourg,2009,0,0,0
TZA,Tanzania,LUX,Luxembourg,2010,1,0,1
TZA,Tanzania,LUX,Luxembourg,2011,2,0,2
TZA,Tanzania,LUX,Luxembourg,2012,7,1,6
TZA,Tanzania,LUX,Luxembourg,2013,3,5,-2
TZA,Tanzania,LUX,Luxembourg,2014,1,0,1
TZA,Tanzania,LUX,Luxembourg,2015,7,1,6
TZA,Tanzania,LUX,Luxembourg,2016,3,0,3
TZA,Tanzania,LUX,Luxembourg,2017,3,2,1
TZA,Tanzania,MEX,Mexico,2008,3,0,3
TZA,Tanzania,MEX,Mexico,2009,3,0,3
TZA,Tanzania,MEX,Mexico,2010,1,0,1
TZA,Tanzania,MEX,Mexico,2011,3,0,3
TZA,Tanzania,MEX,Mexico,2012,1,0,1
TZA,Tanzania,MEX,Mexico,2013,3,0,3
TZA,Tanzania,MEX,Mexico,2014,2,0,2
TZA,Tanzania,MEX,Mexico,2015,4,0,4
TZA,Tanzania,NLD,Netherlands,2008,111,89,22
TZA,Tanzania,NLD,Netherlands,2009,133,80,53
TZA,Tanzania,NLD,Netherlands,2010,103,140,-37
TZA,Tanzania,NLD,Netherlands,2011,81,108,-27
TZA,Tanzania,NLD,Netherlands,2012,88,62,26
TZA,Tanzania,NLD,Netherlands,2013,86,157,-71
TZA,Tanzania,NLD,Netherlands,2014,71,64,7
TZA,Tanzania,NLD,Netherlands,2015,94,80,14
TZA,Tanzania,NLD,Netherlands,2016,73,103,-30
TZA,Tanzania,NLD,Netherlands,2017,97,77,20
TZA,Tanzania,NZL,New Zealand,2008,19,1,18
TZA,Tanzania,NZL,New Zealand,2009,18,7,11
TZA,Tanzania,NZL,New Zealand,2010,13,10,3
TZA,Tanzania,NZL,New Zealand,2011,12,6,6
TZA,Tanzania,NZL,New Zealand,2012,11,6,5
TZA,Tanzania,NZL,New Zealand,2013,8,4,4
TZA,Tanzania,NZL,New Zealand,2014,8,3,5
TZA,Tanzania,NZL,New Zealand,2015,11,7,4
TZA,Tanzania,NZL,New Zealand,2016,17,6,11
TZA,Tanzania,NZL,New Zealand,2017,6,6,0
TZA,Tanzania,NOR,Norway,2008,101,80,21
TZA,Tanzania,NOR,Norway,2009,98,73,25
TZA,Tanzania,NOR,Norway,2010,89,70,19
TZA,Tanzania,NOR,Norway,2011,81,83,-2
TZA,Tanzania,NOR,Norway,2012,82,64,18
TZA,Tanzania,NOR,Norway,2013,67,83,-16
TZA,Tanzania,NOR,Norway,2014,81,68,13
TZA,Tanzania,NOR,Norway,2015,74,64,10
TZA,Tanzania,NOR,Norway,2016,60,69,-9
TZA,Tanzania,NOR,Norway,2017,42,42,0
TZA,Tanzania,POL,Poland,2008,28,0,28
TZA,Tanzania,POL,Poland,2009,36,0,36
TZA,Tanzania,POL,Poland,2010,27,0,27
TZA,Tanzania,POL,Poland,2011,31,0,31
TZA,Tanzania,POL,Poland,2012,22,0,22
TZA,Tanzania,POL,Poland,2013,25,0,25
TZA,Tanzania,POL,Poland,2014,17,0,17
TZA,Tanzania,POL,Poland,2015,16,0,16
TZA,Tanzania,POL,Poland,2016,14,0,14
TZA,Tanzania,POL,Poland,2017,12,0,12
TZA,Tanzania,SVK,Slovak Republic,2008,0,0,0
TZA,Tanzania,SVK,Slovak Republic,2009,1,0,1
TZA,Tanzania,ESP,Spain,2008,28,16,12
TZA,Tanzania,ESP,Spain,2009,26,16,10
TZA,Tanzania,ESP,Spain,2010,33,11,22
TZA,Tanzania,ESP,Spain,2011,22,11,11
TZA,Tanzania,ESP,Spain,2012,34,9,25
TZA,Tanzania,ESP,Spain,2013,32,5,27
TZA,Tanzania,ESP,Spain,2014,24,5,19
TZA,Tanzania,ESP,Spain,2015,35,8,27
TZA,Tanzania,ESP,Spain,2016,25,6,19
TZA,Tanzania,ESP,Spain,2017,41,10,31
TZA,Tanzania,SWE,Sweden,2008,93,22,71
TZA,Tanzania,SWE,Sweden,2009,95,11,84
TZA,Tanzania,SWE,Sweden,2010,104,17,87
TZA,Tanzania,SWE,Sweden,2011,116,22,94
TZA,Tanzania,SWE,Sweden,2012,108,30,78
TZA,Tanzania,SWE,Sweden,2013,76,20,56
TZA,Tanzania,SWE,Sweden,2014,100,40,60
TZA,Tanzania,SWE,Sweden,2015,62,49,13
TZA,Tanzania,SWE,Sweden,2016,86,40,46
TZA,Tanzania,SWE,Sweden,2017,108,26,82
TZA,Tanzania,CHE,Switzerland,2010,55,29,26
TZA,Tanzania,CHE,Switzerland,2011,38,23,15
TZA,Tanzania,CHE,Switzerland,2012,34,16,18
TZA,Tanzania,CHE,Switzerland,2013,32,25,7
TZA,Tanzania,CHE,Switzerland,2014,37,25,12
TZA,Tanzania,CHE,Switzerland,2015,33,22,11
TZA,Tanzania,CHE,Switzerland,2016,31,13,18
TZA,Tanzania,CHE,Switzerland,2017,35,12,23
TZA,Tanzania,TUR,Turkey,2010,30,0,30
TZA,Tanzania,TUR,Turkey,2016,111,81,30
TZA,Tanzania,TUR,Turkey,2017,0,0,0
TZA,Tanzania,GBR,United Kingdom,2011,1000,0,1000
TZA,Tanzania,GBR,United Kingdom,2013,1000,0,1000
TZA,Tanzania,USA,United States,2008,838,0,838
TZA,Tanzania,USA,United States,2009,2773,0,2773
TZA,Tanzania,USA,United States,2010,1850,0,1850
TZA,Tanzania,USA,United States,2011,1427,0,1427
TZA,Tanzania,USA,United States,2012,1516,0,1516
TZA,Tanzania,USA,United States,2013,837,0,837
TZA,Tanzania,USA,United States,2014,774,0,774
TZA,Tanzania,USA,United States,2015,799,0,799
TZA,Tanzania,USA,United States,2016,788,0,788
TZA,Tanzania,USA,United States,2017,1415,0,1415
TZA,Tanzania,CHL,Chile,2008,0,0,0
TZA,Tanzania,CHL,Chile,2009,0,0,0
TZA,Tanzania,CHL,Chile,2010,0,0,0
TZA,Tanzania,CHL,Chile,2011,1,0,1
TZA,Tanzania,CHL,Chile,2012,0,0,0
TZA,Tanzania,CHL,Chile,2013,19,0,19
TZA,Tanzania,CHL,Chile,2014,0,0,0
TZA,Tanzania,CHL,Chile,2015,0,0,0
TZA,Tanzania,CHL,Chile,2016,0,0,0
TZA,Tanzania,EST,Estonia,2008,2,0,2
TZA,Tanzania,EST,Estonia,2009,0,0,0
TZA,Tanzania,EST,Estonia,2010,0,0,0
TZA,Tanzania,EST,Estonia,2011,2,0,2
TZA,Tanzania,EST,Estonia,2012,1,0,1
TZA,Tanzania,EST,Estonia,2013,0,0,0
TZA,Tanzania,EST,Estonia,2014,0,0,0
TZA,Tanzania,EST,Estonia,2015,1,0,1
TZA,Tanzania,EST,Estonia,2016,0,0,0
TZA,Tanzania,EST,Estonia,2017,0,0,0
TZA,Tanzania,SVN,Slovenia,2013,2,0,2
TZA,Tanzania,SVN,Slovenia,2014,1,0,1
TZA,Tanzania,SVN,Slovenia,2015,1,0,1
THA,Thailand,AUS,Australia,2008,2671,345,2326
THA,Thailand,AUS,Australia,2009,2738,300,2438
THA,Thailand,AUS,Australia,2010,2557,352,2205
THA,Thailand,AUS,Australia,2011,2475,417,2058
THA,Thailand,AUS,Australia,2012,2655,424,2231
THA,Thailand,AUS,Australia,2013,3141,511,2630
THA,Thailand,AUS,Australia,2014,2693,504,2189
THA,Thailand,AUS,Australia,2015,2523,500,2023
THA,Thailand,AUS,Australia,2016,2815,500,2315
THA,Thailand,AUS,Australia,2017,2680,0,2680
THA,Thailand,AUT,Austria,2008,351,161,190
THA,Thailand,AUT,Austria,2009,344,173,171
THA,Thailand,AUT,Austria,2010,347,186,161
THA,Thailand,AUT,Austria,2011,369,207,162
THA,Thailand,AUT,Austria,2012,345,189,156
THA,Thailand,AUT,Austria,2013,331,182,149
THA,Thailand,AUT,Austria,2014,364,206,158
THA,Thailand,AUT,Austria,2015,586,321,265
THA,Thailand,AUT,Austria,2016,360,326,34
THA,Thailand,AUT,Austria,2017,339,218,121
THA,Thailand,BEL,Belgium,2008,613,175,438
THA,Thailand,BEL,Belgium,2009,602,183,419
THA,Thailand,BEL,Belgium,2010,685,202,483
THA,Thailand,BEL,Belgium,2011,580,226,354
THA,Thailand,BEL,Belgium,2012,442,214,228
THA,Thailand,BEL,Belgium,2013,447,210,237
THA,Thailand,BEL,Belgium,2014,349,143,206
THA,Thailand,BEL,Belgium,2015,425,108,317
THA,Thailand,BEL,Belgium,2016,366,91,275
THA,Thailand,BEL,Belgium,2017,409,98,311
THA,Thailand,CAN,Canada,2008,519,0,519
THA,Thailand,CAN,Canada,2009,512,0,512
THA,Thailand,CAN,Canada,2010,499,0,499
THA,Thailand,CAN,Canada,2011,396,0,396
THA,Thailand,CAN,Canada,2012,296,0,296
THA,Thailand,CAN,Canada,2013,400,0,400
THA,Thailand,CAN,Canada,2014,608,0,608
THA,Thailand,CAN,Canada,2015,484,0,484
THA,Thailand,CAN,Canada,2016,460,0,460
THA,Thailand,CAN,Canada,2017,600,0,600
THA,Thailand,CZE,Czech Republic,2008,175,0,175
THA,Thailand,CZE,Czech Republic,2009,122,0,122
THA,Thailand,CZE,Czech Republic,2010,129,0,129
THA,Thailand,CZE,Czech Republic,2011,90,0,90
THA,Thailand,CZE,Czech Republic,2012,111,53,58
THA,Thailand,CZE,Czech Republic,2013,150,166,-16
THA,Thailand,CZE,Czech Republic,2014,269,90,179
THA,Thailand,CZE,Czech Republic,2015,130,120,10
THA,Thailand,CZE,Czech Republic,2016,233,93,140
THA,Thailand,CZE,Czech Republic,2017,199,115,84
THA,Thailand,DNK,Denmark,2008,692,116,576
THA,Thailand,DNK,Denmark,2009,660,159,501
THA,Thailand,DNK,Denmark,2010,806,183,623
THA,Thailand,DNK,Denmark,2011,454,209,245
THA,Thailand,DNK,Denmark,2012,457,213,244
THA,Thailand,DNK,Denmark,2013,617,170,447
THA,Thailand,DNK,Denmark,2014,490,206,284
THA,Thailand,DNK,Denmark,2015,484,168,316
THA,Thailand,DNK,Denmark,2016,438,186,252
THA,Thailand,DNK,Denmark,2017,533,220,313
THA,Thailand,FIN,Finland,2008,562,47,515
THA,Thailand,FIN,Finland,2009,628,28,600
THA,Thailand,FIN,Finland,2010,599,30,569
THA,Thailand,FIN,Finland,2011,625,46,579
THA,Thailand,FIN,Finland,2012,589,43,546
THA,Thailand,FIN,Finland,2013,602,39,563
THA,Thailand,FIN,Finland,2014,552,43,509
THA,Thailand,FIN,Finland,2015,576,49,527
THA,Thailand,FIN,Finland,2016,511,60,451
THA,Thailand,FIN,Finland,2017,390,72,318
THA,Thailand,FRA,France,2008,818,0,818
THA,Thailand,FRA,France,2009,951,0,951
THA,Thailand,FRA,France,2010,832,0,832
THA,Thailand,FRA,France,2011,807,0,807
THA,Thailand,FRA,France,2012,827,0,827
THA,Thailand,FRA,France,2013,839,0,839
THA,Thailand,FRA,France,2014,832,0,832
THA,Thailand,FRA,France,2015,847,0,847
THA,Thailand,FRA,France,2016,900,0,900
THA,Thailand,FRA,France,2017,851,0,851
THA,Thailand,DEU,Germany,2008,3153,2843,310
THA,Thailand,DEU,Germany,2009,3394,3000,394
THA,Thailand,DEU,Germany,2010,3342,2716,626
THA,Thailand,DEU,Germany,2011,3192,2167,1025
THA,Thailand,DEU,Germany,2012,3256,2114,1142
THA,Thailand,DEU,Germany,2013,3219,2241,978
THA,Thailand,DEU,Germany,2014,3075,2277,798
THA,Thailand,DEU,Germany,2015,3223,2181,1042
THA,Thailand,DEU,Germany,2016,3442,2184,1258
THA,Thailand,DEU,Germany,2017,3354,1867,1487
THA,Thailand,HUN,Hungary,2008,211,29,182
THA,Thailand,HUN,Hungary,2009,155,38,117
THA,Thailand,HUN,Hungary,2010,190,45,145
THA,Thailand,HUN,Hungary,2011,201,28,173
THA,Thailand,HUN,Hungary,2012,201,58,143
THA,Thailand,HUN,Hungary,2013,211,63,148
THA,Thailand,HUN,Hungary,2014,247,60,187
THA,Thailand,HUN,Hungary,2015,266,73,193
THA,Thailand,HUN,Hungary,2016,226,75,151
THA,Thailand,HUN,Hungary,2017,339,0,339
THA,Thailand,ISL,Iceland,2008,92,26,66
THA,Thailand,ISL,Iceland,2009,41,43,-2
THA,Thailand,ISL,Iceland,2010,49,19,30
THA,Thailand,ISL,Iceland,2011,38,15,23
THA,Thailand,ISL,Iceland,2012,35,14,21
THA,Thailand,ISL,Iceland,2013,54,19,35
THA,Thailand,ISL,Iceland,2014,38,9,29
THA,Thailand,ISL,Iceland,2015,47,10,37
THA,Thailand,ISL,Iceland,2016,58,17,41
THA,Thailand,ISL,Iceland,2017,59,10,49
THA,Thailand,ITA,Italy,2008,572,43,529
THA,Thailand,ITA,Italy,2009,612,53,559
THA,Thailand,ITA,Italy,2010,621,58,563
THA,Thailand,ITA,Italy,2011,604,37,567
THA,Thailand,ITA,Italy,2012,540,58,482
THA,Thailand,ITA,Italy,2013,464,77,387
THA,Thailand,ITA,Italy,2014,390,85,305
THA,Thailand,ITA,Italy,2015,393,78,315
THA,Thailand,ITA,Italy,2016,437,0,437
THA,Thailand,ITA,Italy,2017,417,57,360
THA,Thailand,JPN,Japan,2008,10484,8321,2163
THA,Thailand,JPN,Japan,2009,9904,8570,1334
THA,Thailand,JPN,Japan,2010,10868,10171,697
THA,Thailand,JPN,Japan,2011,13620,8748,4872
THA,Thailand,JPN,Japan,2012,15362,16721,-1359
THA,Thailand,JPN,Japan,2013,15431,13375,2056
THA,Thailand,JPN,Japan,2014,14309,11233,3076
THA,Thailand,JPN,Japan,2015,14509,11257,3252
THA,Thailand,JPN,Japan,2016,15448,12279,3169
THA,Thailand,JPN,Japan,2017,16372,13147,3225
THA,Thailand,KOR,Korea,2008,8621,10200,-1579
THA,Thailand,KOR,Korea,2009,5804,9631,-3827
THA,Thailand,KOR,Korea,2010,6884,7904,-1020
THA,Thailand,KOR,Korea,2011,10340,10217,123
THA,Thailand,KOR,Korea,2012,13771,14565,-794
THA,Thailand,KOR,Korea,2013,18335,9423,8912
THA,Thailand,KOR,Korea,2014,48326,12658,35668
THA,Thailand,KOR,Korea,2015,20122,20946,-824
THA,Thailand,KOR,Korea,2016,28457,22392,6065
THA,Thailand,KOR,Korea,2017,71506,22740,48766
THA,Thailand,LUX,Luxembourg,2008,16,5,11
THA,Thailand,LUX,Luxembourg,2009,34,4,30
THA,Thailand,LUX,Luxembourg,2010,34,10,24
THA,Thailand,LUX,Luxembourg,2011,25,10,15
THA,Thailand,LUX,Luxembourg,2012,31,7,24
THA,Thailand,LUX,Luxembourg,2013,30,9,21
THA,Thailand,LUX,Luxembourg,2014,25,7,18
THA,Thailand,LUX,Luxembourg,2015,37,15,22
THA,Thailand,LUX,Luxembourg,2016,33,17,16
THA,Thailand,LUX,Luxembourg,2017,37,16,21
THA,Thailand,MEX,Mexico,2008,9,0,9
THA,Thailand,MEX,Mexico,2009,17,0,17
THA,Thailand,MEX,Mexico,2010,7,0,7
THA,Thailand,MEX,Mexico,2011,5,0,5
THA,Thailand,MEX,Mexico,2012,5,0,5
THA,Thailand,MEX,Mexico,2013,25,0,25
THA,Thailand,MEX,Mexico,2014,18,0,18
THA,Thailand,MEX,Mexico,2015,11,0,11
THA,Thailand,MEX,Mexico,2016,11,0,11
THA,Thailand,MEX,Mexico,2017,7,0,7
THA,Thailand,NLD,Netherlands,2008,769,279,490
THA,Thailand,NLD,Netherlands,2009,755,271,484
THA,Thailand,NLD,Netherlands,2010,742,305,437
THA,Thailand,NLD,Netherlands,2011,733,286,447
THA,Thailand,NLD,Netherlands,2012,667,313,354
THA,Thailand,NLD,Netherlands,2013,584,347,237
THA,Thailand,NLD,Netherlands,2014,557,319,238
THA,Thailand,NLD,Netherlands,2015,586,341,245
THA,Thailand,NLD,Netherlands,2016,646,307,339
THA,Thailand,NLD,Netherlands,2017,659,279,380
THA,Thailand,NZL,New Zealand,2008,704,279,425
THA,Thailand,NZL,New Zealand,2009,681,276,405
THA,Thailand,NZL,New Zealand,2010,740,257,483
THA,Thailand,NZL,New Zealand,2011,702,273,429
THA,Thailand,NZL,New Zealand,2012,707,312,395
THA,Thailand,NZL,New Zealand,2013,678,255,423
THA,Thailand,NZL,New Zealand,2014,638,210,428
THA,Thailand,NZL,New Zealand,2015,763,191,572
THA,Thailand,NZL,New Zealand,2016,890,182,708
THA,Thailand,NZL,New Zealand,2017,703,326,377
THA,Thailand,NOR,Norway,2008,1317,140,1177
THA,Thailand,NOR,Norway,2009,1308,141,1167
THA,Thailand,NOR,Norway,2010,1171,206,965
THA,Thailand,NOR,Norway,2011,1249,246,1003
THA,Thailand,NOR,Norway,2012,1286,195,1091
THA,Thailand,NOR,Norway,2013,1092,221,871
THA,Thailand,NOR,Norway,2014,848,233,615
THA,Thailand,NOR,Norway,2015,1007,216,791
THA,Thailand,NOR,Norway,2016,1377,236,1141
THA,Thailand,NOR,Norway,2017,1073,195,878
THA,Thailand,POL,Poland,2008,920,0,920
THA,Thailand,POL,Poland,2009,242,0,242
THA,Thailand,POL,Poland,2010,207,0,207
THA,Thailand,POL,Poland,2011,154,0,154
THA,Thailand,POL,Poland,2012,164,0,164
THA,Thailand,POL,Poland,2013,183,0,183
THA,Thailand,POL,Poland,2014,94,0,94
THA,Thailand,POL,Poland,2015,222,0,222
THA,Thailand,POL,Poland,2016,208,0,208
THA,Thailand,POL,Poland,2017,264,0,264
THA,Thailand,PRT,Portugal,2008,105,0,105
THA,Thailand,PRT,Portugal,2009,226,0,226
THA,Thailand,PRT,Portugal,2010,298,0,298
THA,Thailand,PRT,Portugal,2011,246,0,246
THA,Thailand,PRT,Portugal,2012,116,0,116
THA,Thailand,PRT,Portugal,2013,137,0,137
THA,Thailand,PRT,Portugal,2014,264,0,264
THA,Thailand,PRT,Portugal,2015,396,0,396
THA,Thailand,PRT,Portugal,2016,297,0,297
THA,Thailand,PRT,Portugal,2017,350,0,350
THA,Thailand,SVK,Slovak Republic,2008,4,2,2
THA,Thailand,SVK,Slovak Republic,2009,2,15,-13
THA,Thailand,SVK,Slovak Republic,2010,2,14,-12
THA,Thailand,SVK,Slovak Republic,2011,2,14,-12
THA,Thailand,SVK,Slovak Republic,2012,5,0,5
THA,Thailand,SVK,Slovak Republic,2013,6,0,6
THA,Thailand,SVK,Slovak Republic,2014,7,1,6
THA,Thailand,SVK,Slovak Republic,2015,5,0,5
THA,Thailand,SVK,Slovak Republic,2016,5,0,5
THA,Thailand,SVK,Slovak Republic,2017,8,0,8
THA,Thailand,ESP,Spain,2008,237,240,-3
THA,Thailand,ESP,Spain,2009,154,69,85
THA,Thailand,ESP,Spain,2010,141,45,96
THA,Thailand,ESP,Spain,2011,162,70,92
THA,Thailand,ESP,Spain,2012,214,54,160
THA,Thailand,ESP,Spain,2013,171,74,97
THA,Thailand,ESP,Spain,2014,179,66,113
THA,Thailand,ESP,Spain,2015,156,50,106
THA,Thailand,ESP,Spain,2016,190,60,130
THA,Thailand,ESP,Spain,2017,212,87,125
THA,Thailand,SWE,Sweden,2008,3060,184,2876
THA,Thailand,SWE,Sweden,2009,2994,166,2828
THA,Thailand,SWE,Sweden,2010,2775,200,2575
THA,Thailand,SWE,Sweden,2011,2533,301,2232
THA,Thailand,SWE,Sweden,2012,2331,364,1967
THA,Thailand,SWE,Sweden,2013,1771,348,1423
THA,Thailand,SWE,Sweden,2014,1587,423,1164
THA,Thailand,SWE,Sweden,2015,1274,603,671
THA,Thailand,SWE,Sweden,2016,1359,279,1080
THA,Thailand,SWE,Sweden,2017,1534,195,1339
THA,Thailand,CHE,Switzerland,2010,877,437,440
THA,Thailand,CHE,Switzerland,2011,934,427,507
THA,Thailand,CHE,Switzerland,2012,857,387,470
THA,Thailand,CHE,Switzerland,2013,864,405,459
THA,Thailand,CHE,Switzerland,2014,748,412,336
THA,Thailand,CHE,Switzerland,2015,885,357,528
THA,Thailand,CHE,Switzerland,2016,839,394,445
THA,Thailand,CHE,Switzerland,2017,852,399,453
THA,Thailand,TUR,Turkey,2010,110,0,110
THA,Thailand,TUR,Turkey,2016,366,359,7
THA,Thailand,TUR,Turkey,2017,446,271,175
THA,Thailand,GBR,United Kingdom,2008,4000,1000,3000
THA,Thailand,GBR,United Kingdom,2009,4000,2000,2000
THA,Thailand,GBR,United Kingdom,2010,6000,2000,4000
THA,Thailand,GBR,United Kingdom,2011,3000,1000,2000
THA,Thailand,GBR,United Kingdom,2012,4000,3000,1000
THA,Thailand,GBR,United Kingdom,2013,4000,1000,3000
THA,Thailand,GBR,United Kingdom,2014,3000,1000,2000
THA,Thailand,GBR,United Kingdom,2015,6000,2000,4000
THA,Thailand,USA,United States,2008,6637,0,6637
THA,Thailand,USA,United States,2009,10444,0,10444
THA,Thailand,USA,United States,2010,9384,0,9384
THA,Thailand,USA,United States,2011,9962,0,9962
THA,Thailand,USA,United States,2012,9459,0,9459
THA,Thailand,USA,United States,2013,7583,0,7583
THA,Thailand,USA,United States,2014,6197,0,6197
THA,Thailand,USA,United States,2015,7502,0,7502
THA,Thailand,USA,United States,2016,7039,0,7039
THA,Thailand,USA,United States,2017,6311,0,6311
THA,Thailand,CHL,Chile,2008,13,0,13
THA,Thailand,CHL,Chile,2009,9,0,9
THA,Thailand,CHL,Chile,2010,10,0,10
THA,Thailand,CHL,Chile,2011,4,0,4
THA,Thailand,CHL,Chile,2012,9,0,9
THA,Thailand,CHL,Chile,2013,16,0,16
THA,Thailand,CHL,Chile,2014,10,0,10
THA,Thailand,CHL,Chile,2015,11,0,11
THA,Thailand,CHL,Chile,2016,23,0,23
THA,Thailand,EST,Estonia,2008,3,0,3
THA,Thailand,EST,Estonia,2009,4,0,4
THA,Thailand,EST,Estonia,2010,3,0,3
THA,Thailand,EST,Estonia,2011,5,0,5
THA,Thailand,EST,Estonia,2012,14,0,14
THA,Thailand,EST,Estonia,2013,5,0,5
THA,Thailand,EST,Estonia,2014,5,0,5
THA,Thailand,EST,Estonia,2015,5,0,5
THA,Thailand,EST,Estonia,2016,18,0,18
THA,Thailand,EST,Estonia,2017,22,0,22
THA,Thailand,SVN,Slovenia,2008,72,0,72
THA,Thailand,SVN,Slovenia,2009,31,0,31
THA,Thailand,SVN,Slovenia,2010,36,0,36
THA,Thailand,SVN,Slovenia,2011,51,12,39
THA,Thailand,SVN,Slovenia,2012,21,5,16
THA,Thailand,SVN,Slovenia,2013,17,0,17
THA,Thailand,SVN,Slovenia,2014,23,3,20
THA,Thailand,SVN,Slovenia,2015,40,4,36
THA,Thailand,SVN,Slovenia,2016,32,8,24
THA,Thailand,SVN,Slovenia,2017,47,2,45
TLS,Timor-Leste,AUS,Australia,2008,47,42,5
TLS,Timor-Leste,AUS,Australia,2009,36,50,-14
TLS,Timor-Leste,AUS,Australia,2010,33,62,-29
TLS,Timor-Leste,AUS,Australia,2011,28,42,-14
TLS,Timor-Leste,AUS,Australia,2012,21,30,-9
TLS,Timor-Leste,AUS,Australia,2013,16,40,-24
TLS,Timor-Leste,AUS,Australia,2014,35,29,6
TLS,Timor-Leste,AUS,Australia,2015,13,0,13
TLS,Timor-Leste,AUS,Australia,2016,23,0,23
TLS,Timor-Leste,AUS,Australia,2017,22,0,22
TLS,Timor-Leste,AUT,Austria,2008,0,0,0
TLS,Timor-Leste,AUT,Austria,2009,0,0,0
TLS,Timor-Leste,AUT,Austria,2010,0,0,0
TLS,Timor-Leste,AUT,Austria,2011,0,0,0
TLS,Timor-Leste,AUT,Austria,2012,0,0,0
TLS,Timor-Leste,AUT,Austria,2013,0,0,0
TLS,Timor-Leste,AUT,Austria,2014,0,0,0
TLS,Timor-Leste,AUT,Austria,2015,0,0,0
TLS,Timor-Leste,AUT,Austria,2016,0,0,0
TLS,Timor-Leste,AUT,Austria,2017,1,0,1
TLS,Timor-Leste,BEL,Belgium,2008,0,0,0
TLS,Timor-Leste,BEL,Belgium,2009,0,0,0
TLS,Timor-Leste,BEL,Belgium,2010,3,0,3
TLS,Timor-Leste,BEL,Belgium,2015,1,1,0
TLS,Timor-Leste,BEL,Belgium,2016,1,0,1
TLS,Timor-Leste,BEL,Belgium,2017,2,0,2
TLS,Timor-Leste,CAN,Canada,2008,0,0,0
TLS,Timor-Leste,CAN,Canada,2009,0,0,0
TLS,Timor-Leste,CAN,Canada,2010,0,0,0
TLS,Timor-Leste,CAN,Canada,2011,0,0,0
TLS,Timor-Leste,CAN,Canada,2012,0,0,0
TLS,Timor-Leste,CAN,Canada,2013,0,0,0
TLS,Timor-Leste,CAN,Canada,2014,1,0,1
TLS,Timor-Leste,CAN,Canada,2015,0,0,0
TLS,Timor-Leste,CAN,Canada,2016,0,0,0
TLS,Timor-Leste,CAN,Canada,2017,0,0,0
TLS,Timor-Leste,DNK,Denmark,2014,0,0,0
TLS,Timor-Leste,DNK,Denmark,2015,0,0,0
TLS,Timor-Leste,DNK,Denmark,2016,0,0,0
TLS,Timor-Leste,DNK,Denmark,2017,0,0,0
TLS,Timor-Leste,FIN,Finland,2008,0,0,0
TLS,Timor-Leste,FIN,Finland,2009,0,0,0
TLS,Timor-Leste,FIN,Finland,2010,0,0,0
TLS,Timor-Leste,FIN,Finland,2011,0,0,0
TLS,Timor-Leste,FIN,Finland,2012,0,0,0
TLS,Timor-Leste,FIN,Finland,2013,0,0,0
TLS,Timor-Leste,FIN,Finland,2014,0,0,0
TLS,Timor-Leste,FIN,Finland,2015,0,0,0
TLS,Timor-Leste,FIN,Finland,2016,0,0,0
TLS,Timor-Leste,FIN,Finland,2017,0,0,0
TLS,Timor-Leste,FRA,France,2008,0,0,0
TLS,Timor-Leste,FRA,France,2009,0,0,0
TLS,Timor-Leste,FRA,France,2010,0,0,0
TLS,Timor-Leste,FRA,France,2011,0,0,0
TLS,Timor-Leste,FRA,France,2012,0,0,0
TLS,Timor-Leste,FRA,France,2013,0,0,0
TLS,Timor-Leste,FRA,France,2014,0,0,0
TLS,Timor-Leste,FRA,France,2015,0,0,0
TLS,Timor-Leste,FRA,France,2016,2,0,2
TLS,Timor-Leste,FRA,France,2017,1,0,1
TLS,Timor-Leste,DEU,Germany,2008,2,3,-1
TLS,Timor-Leste,DEU,Germany,2009,4,3,1
TLS,Timor-Leste,DEU,Germany,2010,0,0,0
TLS,Timor-Leste,DEU,Germany,2011,1,0,1
TLS,Timor-Leste,DEU,Germany,2012,1,1,0
TLS,Timor-Leste,DEU,Germany,2013,0,0,0
TLS,Timor-Leste,DEU,Germany,2014,1,1,0
TLS,Timor-Leste,DEU,Germany,2015,1,0,1
TLS,Timor-Leste,DEU,Germany,2016,1,0,1
TLS,Timor-Leste,DEU,Germany,2017,2,1,1
TLS,Timor-Leste,HUN,Hungary,2008,0,0,0
TLS,Timor-Leste,HUN,Hungary,2009,0,0,0
TLS,Timor-Leste,HUN,Hungary,2010,0,0,0
TLS,Timor-Leste,HUN,Hungary,2011,0,0,0
TLS,Timor-Leste,HUN,Hungary,2012,0,0,0
TLS,Timor-Leste,HUN,Hungary,2013,0,0,0
TLS,Timor-Leste,HUN,Hungary,2014,0,0,0
TLS,Timor-Leste,HUN,Hungary,2015,0,0,0
TLS,Timor-Leste,HUN,Hungary,2016,0,0,0
TLS,Timor-Leste,HUN,Hungary,2017,0,0,0
TLS,Timor-Leste,ISL,Iceland,2008,0,0,0
TLS,Timor-Leste,ISL,Iceland,2009,0,0,0
TLS,Timor-Leste,ISL,Iceland,2010,0,0,0
TLS,Timor-Leste,ISL,Iceland,2011,0,0,0
TLS,Timor-Leste,ISL,Iceland,2012,0,0,0
TLS,Timor-Leste,ISL,Iceland,2013,0,0,0
TLS,Timor-Leste,ISL,Iceland,2014,1,0,1
TLS,Timor-Leste,ISL,Iceland,2015,0,1,-1
TLS,Timor-Leste,ISL,Iceland,2016,0,0,0
TLS,Timor-Leste,ISL,Iceland,2017,0,0,0
TLS,Timor-Leste,ITA,Italy,2008,2,0,2
TLS,Timor-Leste,ITA,Italy,2009,1,0,1
TLS,Timor-Leste,ITA,Italy,2010,5,0,5
TLS,Timor-Leste,ITA,Italy,2011,6,0,6
TLS,Timor-Leste,ITA,Italy,2012,10,1,9
TLS,Timor-Leste,ITA,Italy,2013,12,0,12
TLS,Timor-Leste,ITA,Italy,2014,105,0,105
TLS,Timor-Leste,ITA,Italy,2015,27,2,25
TLS,Timor-Leste,ITA,Italy,2016,11,0,11
TLS,Timor-Leste,ITA,Italy,2017,15,0,15
TLS,Timor-Leste,JPN,Japan,2008,84,85,-1
TLS,Timor-Leste,JPN,Japan,2009,126,123,3
TLS,Timor-Leste,JPN,Japan,2010,125,120,5
TLS,Timor-Leste,JPN,Japan,2011,109,110,-1
TLS,Timor-Leste,JPN,Japan,2012,160,147,13
TLS,Timor-Leste,JPN,Japan,2013,110,108,2
TLS,Timor-Leste,JPN,Japan,2014,159,151,8
TLS,Timor-Leste,JPN,Japan,2015,147,156,-9
TLS,Timor-Leste,JPN,Japan,2016,166,160,6
TLS,Timor-Leste,JPN,Japan,2017,166,158,8
TLS,Timor-Leste,KOR,Korea,2008,11,20,-9
TLS,Timor-Leste,KOR,Korea,2009,99,2,97
TLS,Timor-Leste,KOR,Korea,2010,348,11,337
TLS,Timor-Leste,KOR,Korea,2011,186,30,156
TLS,Timor-Leste,KOR,Korea,2012,498,86,412
TLS,Timor-Leste,KOR,Korea,2013,285,104,181
TLS,Timor-Leste,KOR,Korea,2014,265,158,107
TLS,Timor-Leste,KOR,Korea,2015,442,254,188
TLS,Timor-Leste,KOR,Korea,2016,546,242,304
TLS,Timor-Leste,KOR,Korea,2017,352,301,51
TLS,Timor-Leste,LUX,Luxembourg,2008,0,0,0
TLS,Timor-Leste,LUX,Luxembourg,2009,0,0,0
TLS,Timor-Leste,LUX,Luxembourg,2010,0,0,0
TLS,Timor-Leste,LUX,Luxembourg,2011,0,0,0
TLS,Timor-Leste,LUX,Luxembourg,2012,0,0,0
TLS,Timor-Leste,LUX,Luxembourg,2013,0,0,0
TLS,Timor-Leste,LUX,Luxembourg,2014,0,0,0
TLS,Timor-Leste,LUX,Luxembourg,2015,0,0,0
TLS,Timor-Leste,LUX,Luxembourg,2016,0,0,0
TLS,Timor-Leste,LUX,Luxembourg,2017,0,0,0
TLS,Timor-Leste,MEX,Mexico,2012,0,0,0
TLS,Timor-Leste,MEX,Mexico,2013,1,0,1
TLS,Timor-Leste,MEX,Mexico,2014,0,0,0
TLS,Timor-Leste,MEX,Mexico,2016,1,0,1
TLS,Timor-Leste,NZL,New Zealand,2008,5,2,3
TLS,Timor-Leste,NZL,New Zealand,2009,10,0,10
TLS,Timor-Leste,NZL,New Zealand,2010,23,3,20
TLS,Timor-Leste,NZL,New Zealand,2011,16,4,12
TLS,Timor-Leste,NZL,New Zealand,2012,30,29,1
TLS,Timor-Leste,NZL,New Zealand,2013,22,18,4
TLS,Timor-Leste,NZL,New Zealand,2014,25,5,20
TLS,Timor-Leste,NZL,New Zealand,2015,22,14,8
TLS,Timor-Leste,NZL,New Zealand,2016,16,2,14
TLS,Timor-Leste,NZL,New Zealand,2017,27,13,14
TLS,Timor-Leste,NOR,Norway,2008,3,0,3
TLS,Timor-Leste,NOR,Norway,2009,5,0,5
TLS,Timor-Leste,NOR,Norway,2010,1,0,1
TLS,Timor-Leste,NOR,Norway,2011,1,6,-5
TLS,Timor-Leste,NOR,Norway,2012,2,3,-1
TLS,Timor-Leste,NOR,Norway,2013,10,2,8
TLS,Timor-Leste,NOR,Norway,2014,0,3,-3
TLS,Timor-Leste,NOR,Norway,2015,1,7,-6
TLS,Timor-Leste,NOR,Norway,2016,1,0,1
TLS,Timor-Leste,NOR,Norway,2017,0,0,0
TLS,Timor-Leste,POL,Poland,2009,0,0,0
TLS,Timor-Leste,POL,Poland,2010,0,0,0
TLS,Timor-Leste,POL,Poland,2011,0,0,0
TLS,Timor-Leste,POL,Poland,2012,0,0,0
TLS,Timor-Leste,POL,Poland,2013,0,0,0
TLS,Timor-Leste,POL,Poland,2014,0,0,0
TLS,Timor-Leste,POL,Poland,2015,0,0,0
TLS,Timor-Leste,POL,Poland,2016,1,0,1
TLS,Timor-Leste,POL,Poland,2017,0,0,0
TLS,Timor-Leste,SVK,Slovak Republic,2008,0,0,0
TLS,Timor-Leste,ESP,Spain,2008,1,1,0
TLS,Timor-Leste,ESP,Spain,2009,0,0,0
TLS,Timor-Leste,ESP,Spain,2010,0,0,0
TLS,Timor-Leste,ESP,Spain,2011,1,0,1
TLS,Timor-Leste,ESP,Spain,2012,1,0,1
TLS,Timor-Leste,ESP,Spain,2013,0,0,0
TLS,Timor-Leste,ESP,Spain,2014,2,0,2
TLS,Timor-Leste,ESP,Spain,2015,1,0,1
TLS,Timor-Leste,ESP,Spain,2016,3,0,3
TLS,Timor-Leste,ESP,Spain,2017,1,0,1
TLS,Timor-Leste,SWE,Sweden,2008,0,0,0
TLS,Timor-Leste,SWE,Sweden,2009,0,0,0
TLS,Timor-Leste,SWE,Sweden,2010,0,0,0
TLS,Timor-Leste,SWE,Sweden,2011,0,0,0
TLS,Timor-Leste,SWE,Sweden,2012,0,0,0
TLS,Timor-Leste,SWE,Sweden,2013,0,0,0
TLS,Timor-Leste,SWE,Sweden,2014,1,0,1
TLS,Timor-Leste,SWE,Sweden,2015,0,0,0
TLS,Timor-Leste,SWE,Sweden,2016,0,0,0
TLS,Timor-Leste,SWE,Sweden,2017,2,0,2
TLS,Timor-Leste,CHE,Switzerland,2010,0,0,0
TLS,Timor-Leste,CHE,Switzerland,2011,0,0,0
TLS,Timor-Leste,CHE,Switzerland,2012,0,0,0
TLS,Timor-Leste,CHE,Switzerland,2013,0,0,0
TLS,Timor-Leste,USA,United States,2015,3,0,3
TLS,Timor-Leste,USA,United States,2017,1,0,1
TLS,Timor-Leste,CHL,Chile,2008,0,0,0
TLS,Timor-Leste,CHL,Chile,2009,0,0,0
TLS,Timor-Leste,CHL,Chile,2010,0,0,0
TLS,Timor-Leste,CHL,Chile,2011,0,0,0
TLS,Timor-Leste,CHL,Chile,2012,0,0,0
TLS,Timor-Leste,CHL,Chile,2013,0,0,0
TLS,Timor-Leste,CHL,Chile,2014,0,0,0
TLS,Timor-Leste,CHL,Chile,2015,0,0,0
TLS,Timor-Leste,CHL,Chile,2016,0,0,0
TLS,Timor-Leste,EST,Estonia,2008,0,0,0
TLS,Timor-Leste,EST,Estonia,2009,0,0,0
TLS,Timor-Leste,EST,Estonia,2010,0,0,0
TLS,Timor-Leste,EST,Estonia,2011,0,0,0
TLS,Timor-Leste,EST,Estonia,2012,0,0,0
TLS,Timor-Leste,EST,Estonia,2013,0,0,0
TLS,Timor-Leste,EST,Estonia,2014,0,0,0
TLS,Timor-Leste,EST,Estonia,2015,0,0,0
TLS,Timor-Leste,EST,Estonia,2016,0,0,0
TLS,Timor-Leste,EST,Estonia,2017,0,0,0
TGO,Togo,AUS,Australia,2008,141,0,141
TGO,Togo,AUS,Australia,2009,57,0,57
TGO,Togo,AUS,Australia,2010,66,0,66
TGO,Togo,AUS,Australia,2011,76,0,76
TGO,Togo,AUS,Australia,2012,15,0,15
TGO,Togo,AUS,Australia,2013,7,0,7
TGO,Togo,AUS,Australia,2014,17,0,17
TGO,Togo,AUS,Australia,2015,0,0,0
TGO,Togo,AUS,Australia,2017,3,0,3
TGO,Togo,AUT,Austria,2008,13,5,8
TGO,Togo,AUT,Austria,2009,1,5,-4
TGO,Togo,AUT,Austria,2010,7,5,2
TGO,Togo,AUT,Austria,2011,7,4,3
TGO,Togo,AUT,Austria,2012,9,4,5
TGO,Togo,AUT,Austria,2013,10,3,7
TGO,Togo,AUT,Austria,2014,8,6,2
TGO,Togo,AUT,Austria,2015,10,4,6
TGO,Togo,AUT,Austria,2016,16,12,4
TGO,Togo,AUT,Austria,2017,7,8,-1
TGO,Togo,BEL,Belgium,2008,182,0,182
TGO,Togo,BEL,Belgium,2009,225,0,225
TGO,Togo,BEL,Belgium,2010,213,34,179
TGO,Togo,BEL,Belgium,2011,225,0,225
TGO,Togo,BEL,Belgium,2012,349,95,254
TGO,Togo,BEL,Belgium,2013,348,169,179
TGO,Togo,BEL,Belgium,2014,230,222,8
TGO,Togo,BEL,Belgium,2015,317,139,178
TGO,Togo,BEL,Belgium,2016,275,91,184
TGO,Togo,BEL,Belgium,2017,242,71,171
TGO,Togo,CAN,Canada,2008,351,0,351
TGO,Togo,CAN,Canada,2009,400,0,400
TGO,Togo,CAN,Canada,2010,354,0,354
TGO,Togo,CAN,Canada,2011,261,0,261
TGO,Togo,CAN,Canada,2012,299,0,299
TGO,Togo,CAN,Canada,2013,315,0,315
TGO,Togo,CAN,Canada,2014,248,0,248
TGO,Togo,CAN,Canada,2015,258,0,258
TGO,Togo,CAN,Canada,2016,245,0,245
TGO,Togo,CAN,Canada,2017,205,0,205
TGO,Togo,CZE,Czech Republic,2008,2,0,2
TGO,Togo,CZE,Czech Republic,2010,1,0,1
TGO,Togo,CZE,Czech Republic,2014,1,0,1
TGO,Togo,CZE,Czech Republic,2015,2,0,2
TGO,Togo,CZE,Czech Republic,2016,2,0,2
TGO,Togo,DNK,Denmark,2008,5,3,2
TGO,Togo,DNK,Denmark,2009,5,0,5
TGO,Togo,DNK,Denmark,2010,6,4,2
TGO,Togo,DNK,Denmark,2012,2,1,1
TGO,Togo,DNK,Denmark,2013,5,1,4
TGO,Togo,DNK,Denmark,2014,6,1,5
TGO,Togo,DNK,Denmark,2015,2,2,0
TGO,Togo,DNK,Denmark,2016,2,1,1
TGO,Togo,DNK,Denmark,2017,3,2,1
TGO,Togo,FIN,Finland,2008,5,0,5
TGO,Togo,FIN,Finland,2009,4,0,4
TGO,Togo,FIN,Finland,2010,7,0,7
TGO,Togo,FIN,Finland,2011,3,0,3
TGO,Togo,FIN,Finland,2012,6,2,4
TGO,Togo,FIN,Finland,2013,3,0,3
TGO,Togo,FIN,Finland,2014,12,2,10
TGO,Togo,FIN,Finland,2015,5,1,4
TGO,Togo,FIN,Finland,2016,11,0,11
TGO,Togo,FIN,Finland,2017,7,0,7
TGO,Togo,FRA,France,2008,835,0,835
TGO,Togo,FRA,France,2009,741,0,741
TGO,Togo,FRA,France,2010,766,0,766
TGO,Togo,FRA,France,2011,641,0,641
TGO,Togo,FRA,France,2012,697,0,697
TGO,Togo,FRA,France,2013,695,0,695
TGO,Togo,FRA,France,2014,769,0,769
TGO,Togo,FRA,France,2015,631,0,631
TGO,Togo,FRA,France,2016,633,0,633
TGO,Togo,FRA,France,2017,517,0,517
TGO,Togo,DEU,Germany,2008,394,433,-39
TGO,Togo,DEU,Germany,2009,462,357,105
TGO,Togo,DEU,Germany,2010,426,272,154
TGO,Togo,DEU,Germany,2011,422,258,164
TGO,Togo,DEU,Germany,2012,448,244,204
TGO,Togo,DEU,Germany,2013,439,228,211
TGO,Togo,DEU,Germany,2014,620,252,368
TGO,Togo,DEU,Germany,2015,784,283,501
TGO,Togo,DEU,Germany,2016,825,289,536
TGO,Togo,DEU,Germany,2017,933,243,690
TGO,Togo,HUN,Hungary,2008,2,0,2
TGO,Togo,HUN,Hungary,2009,2,0,2
TGO,Togo,HUN,Hungary,2010,0,1,-1
TGO,Togo,HUN,Hungary,2011,0,0,0
TGO,Togo,HUN,Hungary,2012,2,0,2
TGO,Togo,HUN,Hungary,2013,1,0,1
TGO,Togo,HUN,Hungary,2014,1,0,1
TGO,Togo,HUN,Hungary,2015,1,0,1
TGO,Togo,HUN,Hungary,2016,1,1,0
TGO,Togo,HUN,Hungary,2017,8,0,8
TGO,Togo,ISL,Iceland,2008,0,0,0
TGO,Togo,ISL,Iceland,2009,0,0,0
TGO,Togo,ISL,Iceland,2010,0,0,0
TGO,Togo,ISL,Iceland,2011,1,0,1
TGO,Togo,ISL,Iceland,2012,0,0,0
TGO,Togo,ISL,Iceland,2013,3,2,1
TGO,Togo,ISL,Iceland,2014,1,3,-2
TGO,Togo,ISL,Iceland,2015,1,1,0
TGO,Togo,ISL,Iceland,2016,1,0,1
TGO,Togo,ISL,Iceland,2017,1,0,1
TGO,Togo,ITA,Italy,2008,631,4,627
TGO,Togo,ITA,Italy,2009,453,7,446
TGO,Togo,ITA,Italy,2010,407,17,390
TGO,Togo,ITA,Italy,2011,382,17,365
TGO,Togo,ITA,Italy,2012,514,17,497
TGO,Togo,ITA,Italy,2013,447,21,426
TGO,Togo,ITA,Italy,2014,356,25,331
TGO,Togo,ITA,Italy,2015,358,25,333
TGO,Togo,ITA,Italy,2016,419,0,419
TGO,Togo,ITA,Italy,2017,817,29,788
TGO,Togo,JPN,Japan,2008,39,39,0
TGO,Togo,JPN,Japan,2009,28,24,4
TGO,Togo,JPN,Japan,2010,26,25,1
TGO,Togo,JPN,Japan,2011,54,47,7
TGO,Togo,JPN,Japan,2012,66,62,4
TGO,Togo,JPN,Japan,2013,59,58,1
TGO,Togo,JPN,Japan,2014,22,21,1
TGO,Togo,JPN,Japan,2015,39,35,4
TGO,Togo,JPN,Japan,2016,37,33,4
TGO,Togo,JPN,Japan,2017,28,24,4
TGO,Togo,KOR,Korea,2008,5,5,0
TGO,Togo,KOR,Korea,2009,4,4,0
TGO,Togo,KOR,Korea,2010,2,3,-1
TGO,Togo,KOR,Korea,2011,9,2,7
TGO,Togo,KOR,Korea,2012,6,5,1
TGO,Togo,KOR,Korea,2013,6,12,-6
TGO,Togo,KOR,Korea,2014,13,5,8
TGO,Togo,KOR,Korea,2015,13,11,2
TGO,Togo,KOR,Korea,2016,9,10,-1
TGO,Togo,KOR,Korea,2017,16,11,5
TGO,Togo,LUX,Luxembourg,2008,18,1,17
TGO,Togo,LUX,Luxembourg,2009,20,4,16
TGO,Togo,LUX,Luxembourg,2010,15,6,9
TGO,Togo,LUX,Luxembourg,2011,17,5,12
TGO,Togo,LUX,Luxembourg,2012,12,10,2
TGO,Togo,LUX,Luxembourg,2013,18,2,16
TGO,Togo,LUX,Luxembourg,2014,14,5,9
TGO,Togo,LUX,Luxembourg,2015,21,3,18
TGO,Togo,LUX,Luxembourg,2016,18,3,15
TGO,Togo,LUX,Luxembourg,2017,20,3,17
TGO,Togo,MEX,Mexico,2008,3,0,3
TGO,Togo,MEX,Mexico,2009,4,0,4
TGO,Togo,MEX,Mexico,2010,2,0,2
TGO,Togo,MEX,Mexico,2011,2,0,2
TGO,Togo,MEX,Mexico,2012,1,0,1
TGO,Togo,MEX,Mexico,2013,4,0,4
TGO,Togo,MEX,Mexico,2014,2,0,2
TGO,Togo,MEX,Mexico,2015,3,0,3
TGO,Togo,MEX,Mexico,2016,4,0,4
TGO,Togo,MEX,Mexico,2017,11,0,11
TGO,Togo,NLD,Netherlands,2008,30,2,28
TGO,Togo,NLD,Netherlands,2009,32,10,22
TGO,Togo,NLD,Netherlands,2010,25,7,18
TGO,Togo,NLD,Netherlands,2011,23,3,20
TGO,Togo,NLD,Netherlands,2012,24,9,15
TGO,Togo,NLD,Netherlands,2013,12,7,5
TGO,Togo,NLD,Netherlands,2014,21,7,14
TGO,Togo,NLD,Netherlands,2015,8,4,4
TGO,Togo,NLD,Netherlands,2016,18,7,11
TGO,Togo,NLD,Netherlands,2017,17,-1,18
TGO,Togo,NZL,New Zealand,2012,0,0,0
TGO,Togo,NZL,New Zealand,2014,1,0,1
TGO,Togo,NOR,Norway,2008,7,3,4
TGO,Togo,NOR,Norway,2009,8,1,7
TGO,Togo,NOR,Norway,2010,5,0,5
TGO,Togo,NOR,Norway,2011,1,1,0
TGO,Togo,NOR,Norway,2012,2,1,1
TGO,Togo,NOR,Norway,2013,2,1,1
TGO,Togo,NOR,Norway,2014,3,0,3
TGO,Togo,NOR,Norway,2015,0,1,-1
TGO,Togo,NOR,Norway,2016,4,1,3
TGO,Togo,NOR,Norway,2017,3,0,3
TGO,Togo,POL,Poland,2009,9,0,9
TGO,Togo,POL,Poland,2010,7,0,7
TGO,Togo,POL,Poland,2011,10,0,10
TGO,Togo,POL,Poland,2012,5,0,5
TGO,Togo,POL,Poland,2013,10,0,10
TGO,Togo,POL,Poland,2014,5,0,5
TGO,Togo,POL,Poland,2015,9,0,9
TGO,Togo,POL,Poland,2016,3,0,3
TGO,Togo,POL,Poland,2017,5,0,5
TGO,Togo,SVK,Slovak Republic,2008,0,0,0
TGO,Togo,ESP,Spain,2008,80,30,50
TGO,Togo,ESP,Spain,2009,28,41,-13
TGO,Togo,ESP,Spain,2010,29,24,5
TGO,Togo,ESP,Spain,2011,42,37,5
TGO,Togo,ESP,Spain,2012,36,19,17
TGO,Togo,ESP,Spain,2013,44,31,13
TGO,Togo,ESP,Spain,2014,22,10,12
TGO,Togo,ESP,Spain,2015,30,12,18
TGO,Togo,ESP,Spain,2016,35,8,27
TGO,Togo,ESP,Spain,2017,42,18,24
TGO,Togo,SWE,Sweden,2008,7,4,3
TGO,Togo,SWE,Sweden,2009,9,0,9
TGO,Togo,SWE,Sweden,2010,8,0,8
TGO,Togo,SWE,Sweden,2011,18,0,18
TGO,Togo,SWE,Sweden,2012,19,2,17
TGO,Togo,SWE,Sweden,2013,13,4,9
TGO,Togo,SWE,Sweden,2014,10,2,8
TGO,Togo,SWE,Sweden,2015,10,0,10
TGO,Togo,SWE,Sweden,2016,9,1,8
TGO,Togo,SWE,Sweden,2017,7,1,6
TGO,Togo,CHE,Switzerland,2010,83,18,65
TGO,Togo,CHE,Switzerland,2011,98,14,84
TGO,Togo,CHE,Switzerland,2012,68,19,49
TGO,Togo,CHE,Switzerland,2013,82,18,64
TGO,Togo,CHE,Switzerland,2014,71,18,53
TGO,Togo,CHE,Switzerland,2015,58,6,52
TGO,Togo,CHE,Switzerland,2016,73,12,61
TGO,Togo,CHE,Switzerland,2017,79,11,68
TGO,Togo,TUR,Turkey,2010,3,0,3
TGO,Togo,USA,United States,2008,1661,0,1661
TGO,Togo,USA,United States,2009,1680,0,1680
TGO,Togo,USA,United States,2010,1563,0,1563
TGO,Togo,USA,United States,2011,1506,0,1506
TGO,Togo,USA,United States,2012,1756,0,1756
TGO,Togo,USA,United States,2013,1257,0,1257
TGO,Togo,USA,United States,2014,1612,0,1612
TGO,Togo,USA,United States,2015,1547,0,1547
TGO,Togo,USA,United States,2016,1938,0,1938
TGO,Togo,USA,United States,2017,1572,0,1572
TGO,Togo,CHL,Chile,2008,0,0,0
TGO,Togo,CHL,Chile,2009,0,0,0
TGO,Togo,CHL,Chile,2010,0,0,0
TGO,Togo,CHL,Chile,2011,0,0,0
TGO,Togo,CHL,Chile,2012,0,0,0
TGO,Togo,CHL,Chile,2013,1,0,1
TGO,Togo,CHL,Chile,2014,0,0,0
TGO,Togo,CHL,Chile,2015,1,0,1
TGO,Togo,CHL,Chile,2016,1,0,1
TGO,Togo,EST,Estonia,2008,0,0,0
TGO,Togo,EST,Estonia,2009,0,0,0
TGO,Togo,EST,Estonia,2010,0,0,0
TGO,Togo,EST,Estonia,2011,0,0,0
TGO,Togo,EST,Estonia,2012,0,0,0
TGO,Togo,EST,Estonia,2013,0,0,0
TGO,Togo,EST,Estonia,2014,0,0,0
TGO,Togo,EST,Estonia,2015,1,0,1
TGO,Togo,EST,Estonia,2016,0,0,0
TGO,Togo,EST,Estonia,2017,0,0,0
TGO,Togo,SVN,Slovenia,2010,1,0,1
TKL,Tokelau,AUS,Australia,2009,0,0,0
TKL,Tokelau,AUS,Australia,2010,0,0,0
TKL,Tokelau,AUS,Australia,2011,0,0,0
TKL,Tokelau,AUS,Australia,2012,0,0,0
TKL,Tokelau,AUS,Australia,2013,0,0,0
TKL,Tokelau,AUS,Australia,2014,0,0,0
TKL,Tokelau,AUS,Australia,2015,0,0,0
TKL,Tokelau,AUS,Australia,2016,0,0,0
TKL,Tokelau,AUS,Australia,2017,0,0,0
TKL,Tokelau,AUT,Austria,2014,0,0,0
TKL,Tokelau,AUT,Austria,2015,0,0,0
TKL,Tokelau,AUT,Austria,2016,0,0,0
TKL,Tokelau,AUT,Austria,2017,0,0,0
TKL,Tokelau,BEL,Belgium,2010,0,0,0
TKL,Tokelau,CAN,Canada,2008,0,0,0
TKL,Tokelau,CAN,Canada,2009,0,0,0
TKL,Tokelau,CAN,Canada,2010,0,0,0
TKL,Tokelau,CAN,Canada,2011,0,0,0
TKL,Tokelau,CAN,Canada,2012,0,0,0
TKL,Tokelau,CAN,Canada,2013,0,0,0
TKL,Tokelau,CAN,Canada,2014,0,0,0
TKL,Tokelau,CAN,Canada,2015,0,0,0
TKL,Tokelau,CAN,Canada,2016,0,0,0
TKL,Tokelau,CAN,Canada,2017,0,0,0
TKL,Tokelau,DNK,Denmark,2015,0,0,0
TKL,Tokelau,DNK,Denmark,2016,0,0,0
TKL,Tokelau,FIN,Finland,2008,0,0,0
TKL,Tokelau,FIN,Finland,2009,0,0,0
TKL,Tokelau,FIN,Finland,2010,0,0,0
TKL,Tokelau,FIN,Finland,2011,0,0,0
TKL,Tokelau,FIN,Finland,2012,0,0,0
TKL,Tokelau,FIN,Finland,2013,0,0,0
TKL,Tokelau,FIN,Finland,2014,0,0,0
TKL,Tokelau,FIN,Finland,2015,0,0,0
TKL,Tokelau,FIN,Finland,2016,0,0,0
TKL,Tokelau,FIN,Finland,2017,0,0,0
TKL,Tokelau,FRA,France,2008,0,0,0
TKL,Tokelau,FRA,France,2009,0,0,0
TKL,Tokelau,FRA,France,2010,0,0,0
TKL,Tokelau,FRA,France,2011,0,0,0
TKL,Tokelau,FRA,France,2012,0,0,0
TKL,Tokelau,FRA,France,2013,0,0,0
TKL,Tokelau,FRA,France,2014,0,0,0
TKL,Tokelau,FRA,France,2015,0,0,0
TKL,Tokelau,FRA,France,2016,0,0,0
TKL,Tokelau,FRA,France,2017,0,0,0
TKL,Tokelau,HUN,Hungary,2008,0,0,0
TKL,Tokelau,HUN,Hungary,2009,0,0,0
TKL,Tokelau,HUN,Hungary,2010,0,0,0
TKL,Tokelau,HUN,Hungary,2011,0,0,0
TKL,Tokelau,HUN,Hungary,2012,0,0,0
TKL,Tokelau,HUN,Hungary,2013,0,0,0
TKL,Tokelau,HUN,Hungary,2014,0,0,0
TKL,Tokelau,HUN,Hungary,2015,0,0,0
TKL,Tokelau,HUN,Hungary,2016,0,0,0
TKL,Tokelau,HUN,Hungary,2017,0,0,0
TKL,Tokelau,ISL,Iceland,2016,0,0,0
TKL,Tokelau,ISL,Iceland,2017,0,0,0
TKL,Tokelau,ITA,Italy,2015,0,0,0
TKL,Tokelau,JPN,Japan,2008,0,0,0
TKL,Tokelau,JPN,Japan,2009,0,0,0
TKL,Tokelau,JPN,Japan,2010,0,0,0
TKL,Tokelau,JPN,Japan,2011,0,0,0
TKL,Tokelau,JPN,Japan,2012,0,0,0
TKL,Tokelau,JPN,Japan,2013,0,0,0
TKL,Tokelau,JPN,Japan,2014,0,0,0
TKL,Tokelau,JPN,Japan,2015,0,0,0
TKL,Tokelau,JPN,Japan,2016,0,0,0
TKL,Tokelau,JPN,Japan,2017,0,0,0
TKL,Tokelau,KOR,Korea,2008,0,0,0
TKL,Tokelau,KOR,Korea,2009,1,0,1
TKL,Tokelau,KOR,Korea,2010,0,0,0
TKL,Tokelau,KOR,Korea,2011,0,0,0
TKL,Tokelau,KOR,Korea,2012,0,0,0
TKL,Tokelau,KOR,Korea,2013,0,0,0
TKL,Tokelau,KOR,Korea,2014,0,0,0
TKL,Tokelau,KOR,Korea,2015,0,0,0
TKL,Tokelau,KOR,Korea,2016,0,0,0
TKL,Tokelau,KOR,Korea,2017,0,0,0
TKL,Tokelau,LUX,Luxembourg,2008,0,0,0
TKL,Tokelau,LUX,Luxembourg,2009,0,0,0
TKL,Tokelau,LUX,Luxembourg,2010,0,0,0
TKL,Tokelau,LUX,Luxembourg,2011,0,0,0
TKL,Tokelau,LUX,Luxembourg,2012,0,0,0
TKL,Tokelau,LUX,Luxembourg,2013,0,0,0
TKL,Tokelau,LUX,Luxembourg,2014,0,0,0
TKL,Tokelau,LUX,Luxembourg,2015,0,0,0
TKL,Tokelau,LUX,Luxembourg,2016,0,0,0
TKL,Tokelau,LUX,Luxembourg,2017,0,0,0
TKL,Tokelau,MEX,Mexico,2012,0,0,0
TKL,Tokelau,MEX,Mexico,2013,0,0,0
TKL,Tokelau,MEX,Mexico,2014,0,0,0
TKL,Tokelau,NOR,Norway,2008,0,0,0
TKL,Tokelau,NOR,Norway,2009,0,0,0
TKL,Tokelau,NOR,Norway,2010,0,0,0
TKL,Tokelau,NOR,Norway,2011,0,0,0
TKL,Tokelau,NOR,Norway,2012,0,0,0
TKL,Tokelau,NOR,Norway,2013,0,0,0
TKL,Tokelau,NOR,Norway,2014,0,0,0
TKL,Tokelau,NOR,Norway,2015,0,0,0
TKL,Tokelau,NOR,Norway,2016,0,0,0
TKL,Tokelau,NOR,Norway,2017,0,0,0
TKL,Tokelau,POL,Poland,2009,0,0,0
TKL,Tokelau,POL,Poland,2010,0,0,0
TKL,Tokelau,POL,Poland,2011,0,0,0
TKL,Tokelau,POL,Poland,2012,0,0,0
TKL,Tokelau,POL,Poland,2013,0,0,0
TKL,Tokelau,POL,Poland,2014,0,0,0
TKL,Tokelau,POL,Poland,2015,0,0,0
TKL,Tokelau,POL,Poland,2016,0,0,0
TKL,Tokelau,POL,Poland,2017,0,0,0
TKL,Tokelau,ESP,Spain,2008,0,0,0
TKL,Tokelau,ESP,Spain,2009,0,0,0
TKL,Tokelau,ESP,Spain,2010,0,0,0
TKL,Tokelau,ESP,Spain,2011,0,0,0
TKL,Tokelau,ESP,Spain,2012,0,0,0
TKL,Tokelau,ESP,Spain,2013,0,0,0
TKL,Tokelau,SWE,Sweden,2008,0,0,0
TKL,Tokelau,SWE,Sweden,2009,0,0,0
TKL,Tokelau,SWE,Sweden,2010,0,0,0
TKL,Tokelau,SWE,Sweden,2011,0,0,0
TKL,Tokelau,SWE,Sweden,2012,0,0,0
TKL,Tokelau,SWE,Sweden,2013,0,0,0
TKL,Tokelau,SWE,Sweden,2014,0,0,0
TKL,Tokelau,SWE,Sweden,2015,0,0,0
TKL,Tokelau,CHL,Chile,2008,0,0,0
TKL,Tokelau,CHL,Chile,2009,0,0,0
TKL,Tokelau,CHL,Chile,2010,0,0,0
TKL,Tokelau,CHL,Chile,2011,0,0,0
TKL,Tokelau,CHL,Chile,2012,0,0,0
TKL,Tokelau,CHL,Chile,2013,0,0,0
TKL,Tokelau,CHL,Chile,2014,0,0,0
TKL,Tokelau,CHL,Chile,2015,0,0,0
TKL,Tokelau,CHL,Chile,2016,0,0,0
TKL,Tokelau,EST,Estonia,2017,0,0,0
TON,Tonga,AUS,Australia,2008,233,38,195
TON,Tonga,AUS,Australia,2009,209,40,169
TON,Tonga,AUS,Australia,2010,211,37,174
TON,Tonga,AUS,Australia,2011,201,39,162
TON,Tonga,AUS,Australia,2012,228,30,198
TON,Tonga,AUS,Australia,2013,204,25,179
TON,Tonga,AUS,Australia,2014,204,34,170
TON,Tonga,AUS,Australia,2015,142,0,142
TON,Tonga,AUS,Australia,2016,132,0,132
TON,Tonga,AUS,Australia,2017,165,0,165
TON,Tonga,AUT,Austria,2008,2,0,2
TON,Tonga,AUT,Austria,2009,0,0,0
TON,Tonga,AUT,Austria,2010,0,0,0
TON,Tonga,AUT,Austria,2011,0,0,0
TON,Tonga,AUT,Austria,2012,0,1,-1
TON,Tonga,AUT,Austria,2013,0,0,0
TON,Tonga,AUT,Austria,2014,0,0,0
TON,Tonga,AUT,Austria,2015,0,0,0
TON,Tonga,AUT,Austria,2016,1,0,1
TON,Tonga,AUT,Austria,2017,1,0,1
TON,Tonga,BEL,Belgium,2010,0,0,0
TON,Tonga,BEL,Belgium,2012,2,0,2
TON,Tonga,CAN,Canada,2008,0,0,0
TON,Tonga,CAN,Canada,2009,5,0,5
TON,Tonga,CAN,Canada,2010,5,0,5
TON,Tonga,CAN,Canada,2011,2,0,2
TON,Tonga,CAN,Canada,2012,3,0,3
TON,Tonga,CAN,Canada,2013,5,0,5
TON,Tonga,CAN,Canada,2014,2,0,2
TON,Tonga,CAN,Canada,2015,10,0,10
TON,Tonga,CAN,Canada,2016,0,0,0
TON,Tonga,CAN,Canada,2017,0,0,0
TON,Tonga,CZE,Czech Republic,2014,1,1,0
TON,Tonga,DNK,Denmark,2008,1,0,1
TON,Tonga,DNK,Denmark,2009,0,0,0
TON,Tonga,DNK,Denmark,2012,0,0,0
TON,Tonga,DNK,Denmark,2013,0,0,0
TON,Tonga,DNK,Denmark,2014,0,0,0
TON,Tonga,DNK,Denmark,2015,0,0,0
TON,Tonga,DNK,Denmark,2016,0,0,0
TON,Tonga,DNK,Denmark,2017,0,0,0
TON,Tonga,FIN,Finland,2008,0,0,0
TON,Tonga,FIN,Finland,2009,0,0,0
TON,Tonga,FIN,Finland,2010,0,0,0
TON,Tonga,FIN,Finland,2011,0,0,0
TON,Tonga,FIN,Finland,2012,0,0,0
TON,Tonga,FIN,Finland,2013,2,0,2
TON,Tonga,FIN,Finland,2014,0,0,0
TON,Tonga,FIN,Finland,2015,0,0,0
TON,Tonga,FIN,Finland,2016,0,0,0
TON,Tonga,FIN,Finland,2017,0,0,0
TON,Tonga,FRA,France,2008,9,0,9
TON,Tonga,FRA,France,2009,15,0,15
TON,Tonga,FRA,France,2010,8,0,8
TON,Tonga,FRA,France,2011,12,0,12
TON,Tonga,FRA,France,2012,6,0,6
TON,Tonga,FRA,France,2013,14,0,14
TON,Tonga,FRA,France,2014,8,0,8
TON,Tonga,FRA,France,2015,16,0,16
TON,Tonga,FRA,France,2016,7,0,7
TON,Tonga,FRA,France,2017,12,0,12
TON,Tonga,DEU,Germany,2008,3,5,-2
TON,Tonga,DEU,Germany,2009,5,6,-1
TON,Tonga,DEU,Germany,2010,4,6,-2
TON,Tonga,DEU,Germany,2011,6,2,4
TON,Tonga,DEU,Germany,2012,6,3,3
TON,Tonga,DEU,Germany,2013,4,2,2
TON,Tonga,DEU,Germany,2014,9,4,5
TON,Tonga,DEU,Germany,2015,3,2,1
TON,Tonga,DEU,Germany,2016,3,3,0
TON,Tonga,DEU,Germany,2017,4,2,2
TON,Tonga,HUN,Hungary,2008,0,0,0
TON,Tonga,HUN,Hungary,2009,0,0,0
TON,Tonga,HUN,Hungary,2010,0,0,0
TON,Tonga,HUN,Hungary,2011,0,0,0
TON,Tonga,HUN,Hungary,2012,0,0,0
TON,Tonga,HUN,Hungary,2013,0,0,0
TON,Tonga,HUN,Hungary,2014,0,0,0
TON,Tonga,HUN,Hungary,2015,0,0,0
TON,Tonga,HUN,Hungary,2016,0,0,0
TON,Tonga,HUN,Hungary,2017,0,0,0
TON,Tonga,ISL,Iceland,2008,1,0,1
TON,Tonga,ISL,Iceland,2009,0,1,-1
TON,Tonga,ISL,Iceland,2010,0,0,0
TON,Tonga,ISL,Iceland,2011,0,0,0
TON,Tonga,ISL,Iceland,2012,0,0,0
TON,Tonga,ISL,Iceland,2013,0,0,0
TON,Tonga,ISL,Iceland,2014,0,0,0
TON,Tonga,ISL,Iceland,2015,0,0,0
TON,Tonga,ISL,Iceland,2016,0,0,0
TON,Tonga,ISL,Iceland,2017,0,0,0
TON,Tonga,ITA,Italy,2008,2,0,2
TON,Tonga,ITA,Italy,2009,2,0,2
TON,Tonga,ITA,Italy,2010,1,0,1
TON,Tonga,ITA,Italy,2011,0,0,0
TON,Tonga,ITA,Italy,2012,2,0,2
TON,Tonga,ITA,Italy,2013,0,0,0
TON,Tonga,ITA,Italy,2014,1,0,1
TON,Tonga,ITA,Italy,2015,0,0,0
TON,Tonga,ITA,Italy,2016,6,0,6
TON,Tonga,ITA,Italy,2017,4,0,4
TON,Tonga,JPN,Japan,2008,79,74,5
TON,Tonga,JPN,Japan,2009,52,58,-6
TON,Tonga,JPN,Japan,2010,72,73,-1
TON,Tonga,JPN,Japan,2011,61,53,8
TON,Tonga,JPN,Japan,2012,62,48,14
TON,Tonga,JPN,Japan,2013,71,59,12
TON,Tonga,JPN,Japan,2014,66,63,3
TON,Tonga,JPN,Japan,2015,68,56,12
TON,Tonga,JPN,Japan,2016,77,65,12
TON,Tonga,JPN,Japan,2017,91,73,18
TON,Tonga,KOR,Korea,2008,1,0,1
TON,Tonga,KOR,Korea,2009,0,1,-1
TON,Tonga,KOR,Korea,2010,2,0,2
TON,Tonga,KOR,Korea,2011,0,1,-1
TON,Tonga,KOR,Korea,2012,2,1,1
TON,Tonga,KOR,Korea,2013,0,0,0
TON,Tonga,KOR,Korea,2014,1,1,0
TON,Tonga,KOR,Korea,2015,2,2,0
TON,Tonga,KOR,Korea,2016,2,1,1
TON,Tonga,KOR,Korea,2017,1,4,-3
TON,Tonga,LUX,Luxembourg,2008,0,0,0
TON,Tonga,LUX,Luxembourg,2009,0,0,0
TON,Tonga,LUX,Luxembourg,2010,0,0,0
TON,Tonga,LUX,Luxembourg,2011,0,0,0
TON,Tonga,LUX,Luxembourg,2012,0,0,0
TON,Tonga,LUX,Luxembourg,2013,0,0,0
TON,Tonga,LUX,Luxembourg,2014,0,0,0
TON,Tonga,LUX,Luxembourg,2015,0,0,0
TON,Tonga,LUX,Luxembourg,2016,0,0,0
TON,Tonga,LUX,Luxembourg,2017,0,0,0
TON,Tonga,MEX,Mexico,2009,1,0,1
TON,Tonga,MEX,Mexico,2012,0,0,0
TON,Tonga,MEX,Mexico,2013,0,0,0
TON,Tonga,MEX,Mexico,2014,0,0,0
TON,Tonga,NZL,New Zealand,2008,723,237,486
TON,Tonga,NZL,New Zealand,2009,536,267,269
TON,Tonga,NZL,New Zealand,2010,591,295,296
TON,Tonga,NZL,New Zealand,2011,594,292,302
TON,Tonga,NZL,New Zealand,2012,513,288,225
TON,Tonga,NZL,New Zealand,2013,623,245,378
TON,Tonga,NZL,New Zealand,2014,664,192,472
TON,Tonga,NZL,New Zealand,2015,788,211,577
TON,Tonga,NZL,New Zealand,2016,679,217,462
TON,Tonga,NZL,New Zealand,2017,709,231,478
TON,Tonga,NOR,Norway,2008,0,0,0
TON,Tonga,NOR,Norway,2009,0,0,0
TON,Tonga,NOR,Norway,2010,0,0,0
TON,Tonga,NOR,Norway,2011,0,0,0
TON,Tonga,NOR,Norway,2012,0,0,0
TON,Tonga,NOR,Norway,2013,0,0,0
TON,Tonga,NOR,Norway,2014,0,0,0
TON,Tonga,NOR,Norway,2015,0,0,0
TON,Tonga,NOR,Norway,2016,0,0,0
TON,Tonga,NOR,Norway,2017,0,0,0
TON,Tonga,POL,Poland,2009,0,0,0
TON,Tonga,POL,Poland,2010,0,0,0
TON,Tonga,POL,Poland,2011,0,0,0
TON,Tonga,POL,Poland,2012,0,0,0
TON,Tonga,POL,Poland,2013,0,0,0
TON,Tonga,POL,Poland,2014,0,0,0
TON,Tonga,POL,Poland,2015,0,0,0
TON,Tonga,POL,Poland,2016,0,0,0
TON,Tonga,POL,Poland,2017,0,0,0
TON,Tonga,SVK,Slovak Republic,2008,0,0,0
TON,Tonga,ESP,Spain,2008,1,0,1
TON,Tonga,ESP,Spain,2009,0,0,0
TON,Tonga,ESP,Spain,2010,0,1,-1
TON,Tonga,ESP,Spain,2011,0,0,0
TON,Tonga,ESP,Spain,2012,1,1,0
TON,Tonga,ESP,Spain,2013,0,0,0
TON,Tonga,ESP,Spain,2014,1,0,1
TON,Tonga,ESP,Spain,2015,2,0,2
TON,Tonga,ESP,Spain,2016,2,0,2
TON,Tonga,SWE,Sweden,2008,0,0,0
TON,Tonga,SWE,Sweden,2009,1,0,1
TON,Tonga,SWE,Sweden,2010,0,0,0
TON,Tonga,SWE,Sweden,2011,0,0,0
TON,Tonga,SWE,Sweden,2012,0,0,0
TON,Tonga,SWE,Sweden,2013,0,0,0
TON,Tonga,SWE,Sweden,2014,0,0,0
TON,Tonga,SWE,Sweden,2015,0,0,0
TON,Tonga,SWE,Sweden,2016,1,1,0
TON,Tonga,SWE,Sweden,2017,0,0,0
TON,Tonga,CHE,Switzerland,2010,1,0,1
TON,Tonga,CHE,Switzerland,2011,2,0,2
TON,Tonga,CHE,Switzerland,2012,0,1,-1
TON,Tonga,CHE,Switzerland,2013,0,0,0
TON,Tonga,CHE,Switzerland,2017,1,0,1
TON,Tonga,USA,United States,2008,365,0,365
TON,Tonga,USA,United States,2009,379,0,379
TON,Tonga,USA,United States,2010,343,0,343
TON,Tonga,USA,United States,2011,408,0,408
TON,Tonga,USA,United States,2012,276,0,276
TON,Tonga,USA,United States,2013,348,0,348
TON,Tonga,USA,United States,2014,320,0,320
TON,Tonga,USA,United States,2015,327,0,327
TON,Tonga,USA,United States,2016,283,0,283
TON,Tonga,USA,United States,2017,262,0,262
TON,Tonga,CHL,Chile,2008,1,0,1
TON,Tonga,CHL,Chile,2009,0,0,0
TON,Tonga,CHL,Chile,2010,0,0,0
TON,Tonga,CHL,Chile,2011,0,0,0
TON,Tonga,CHL,Chile,2012,0,0,0
TON,Tonga,CHL,Chile,2013,1,0,1
TON,Tonga,CHL,Chile,2014,0,0,0
TON,Tonga,CHL,Chile,2015,0,0,0
TON,Tonga,CHL,Chile,2016,0,0,0
TON,Tonga,EST,Estonia,2008,0,0,0
TON,Tonga,EST,Estonia,2009,0,0,0
TON,Tonga,EST,Estonia,2010,0,0,0
TON,Tonga,EST,Estonia,2011,0,0,0
TON,Tonga,EST,Estonia,2012,0,0,0
TON,Tonga,EST,Estonia,2013,0,0,0
TON,Tonga,EST,Estonia,2014,0,0,0
TON,Tonga,EST,Estonia,2015,0,0,0
TON,Tonga,EST,Estonia,2016,0,0,0
TON,Tonga,EST,Estonia,2017,0,0,0
TTO,Trinidad and Tobago,AUS,Australia,2008,16,12,4
TTO,Trinidad and Tobago,AUS,Australia,2009,20,16,4
TTO,Trinidad and Tobago,AUS,Australia,2010,26,9,17
TTO,Trinidad and Tobago,AUS,Australia,2011,18,0,18
TTO,Trinidad and Tobago,AUS,Australia,2012,34,14,20
TTO,Trinidad and Tobago,AUS,Australia,2013,34,13,21
TTO,Trinidad and Tobago,AUS,Australia,2014,29,14,15
TTO,Trinidad and Tobago,AUS,Australia,2015,34,0,34
TTO,Trinidad and Tobago,AUS,Australia,2016,30,0,30
TTO,Trinidad and Tobago,AUS,Australia,2017,35,0,35
TTO,Trinidad and Tobago,AUT,Austria,2008,3,5,-2
TTO,Trinidad and Tobago,AUT,Austria,2009,3,5,-2
TTO,Trinidad and Tobago,AUT,Austria,2010,2,2,0
TTO,Trinidad and Tobago,AUT,Austria,2011,2,2,0
TTO,Trinidad and Tobago,AUT,Austria,2012,1,1,0
TTO,Trinidad and Tobago,AUT,Austria,2013,1,4,-3
TTO,Trinidad and Tobago,AUT,Austria,2014,2,2,0
TTO,Trinidad and Tobago,AUT,Austria,2015,6,2,4
TTO,Trinidad and Tobago,AUT,Austria,2016,4,3,1
TTO,Trinidad and Tobago,AUT,Austria,2017,5,4,1
TTO,Trinidad and Tobago,BEL,Belgium,2008,6,0,6
TTO,Trinidad and Tobago,BEL,Belgium,2009,8,0,8
TTO,Trinidad and Tobago,BEL,Belgium,2010,4,2,2
TTO,Trinidad and Tobago,BEL,Belgium,2012,9,4,5
TTO,Trinidad and Tobago,BEL,Belgium,2013,3,9,-6
TTO,Trinidad and Tobago,BEL,Belgium,2014,4,3,1
TTO,Trinidad and Tobago,BEL,Belgium,2015,9,3,6
TTO,Trinidad and Tobago,BEL,Belgium,2016,8,1,7
TTO,Trinidad and Tobago,BEL,Belgium,2017,10,5,5
TTO,Trinidad and Tobago,CAN,Canada,2008,1002,0,1002
TTO,Trinidad and Tobago,CAN,Canada,2009,1134,0,1134
TTO,Trinidad and Tobago,CAN,Canada,2010,914,0,914
TTO,Trinidad and Tobago,CAN,Canada,2011,588,0,588
TTO,Trinidad and Tobago,CAN,Canada,2012,579,0,579
TTO,Trinidad and Tobago,CAN,Canada,2013,427,0,427
TTO,Trinidad and Tobago,CAN,Canada,2014,430,0,430
TTO,Trinidad and Tobago,CAN,Canada,2015,348,0,348
TTO,Trinidad and Tobago,CAN,Canada,2016,325,0,325
TTO,Trinidad and Tobago,CAN,Canada,2017,375,0,375
TTO,Trinidad and Tobago,CZE,Czech Republic,2008,1,0,1
TTO,Trinidad and Tobago,CZE,Czech Republic,2009,1,0,1
TTO,Trinidad and Tobago,CZE,Czech Republic,2011,1,0,1
TTO,Trinidad and Tobago,DNK,Denmark,2008,2,4,-2
TTO,Trinidad and Tobago,DNK,Denmark,2009,7,4,3
TTO,Trinidad and Tobago,DNK,Denmark,2010,12,1,11
TTO,Trinidad and Tobago,DNK,Denmark,2011,2,6,-4
TTO,Trinidad and Tobago,DNK,Denmark,2012,6,4,2
TTO,Trinidad and Tobago,DNK,Denmark,2013,6,6,0
TTO,Trinidad and Tobago,DNK,Denmark,2014,9,5,4
TTO,Trinidad and Tobago,DNK,Denmark,2015,3,3,0
TTO,Trinidad and Tobago,DNK,Denmark,2016,5,3,2
TTO,Trinidad and Tobago,DNK,Denmark,2017,4,4,0
TTO,Trinidad and Tobago,FIN,Finland,2008,0,1,-1
TTO,Trinidad and Tobago,FIN,Finland,2009,1,0,1
TTO,Trinidad and Tobago,FIN,Finland,2010,0,0,0
TTO,Trinidad and Tobago,FIN,Finland,2011,1,1,0
TTO,Trinidad and Tobago,FIN,Finland,2012,2,0,2
TTO,Trinidad and Tobago,FIN,Finland,2013,4,0,4
TTO,Trinidad and Tobago,FIN,Finland,2014,1,0,1
TTO,Trinidad and Tobago,FIN,Finland,2015,0,0,0
TTO,Trinidad and Tobago,FIN,Finland,2016,5,0,5
TTO,Trinidad and Tobago,FIN,Finland,2017,3,0,3
TTO,Trinidad and Tobago,FRA,France,2008,11,0,11
TTO,Trinidad and Tobago,FRA,France,2009,15,0,15
TTO,Trinidad and Tobago,FRA,France,2010,18,0,18
TTO,Trinidad and Tobago,FRA,France,2011,16,0,16
TTO,Trinidad and Tobago,FRA,France,2012,16,0,16
TTO,Trinidad and Tobago,FRA,France,2013,15,0,15
TTO,Trinidad and Tobago,FRA,France,2014,27,0,27
TTO,Trinidad and Tobago,FRA,France,2015,26,0,26
TTO,Trinidad and Tobago,FRA,France,2016,21,0,21
TTO,Trinidad and Tobago,FRA,France,2017,27,0,27
TTO,Trinidad and Tobago,DEU,Germany,2008,27,84,-57
TTO,Trinidad and Tobago,DEU,Germany,2009,36,37,-1
TTO,Trinidad and Tobago,DEU,Germany,2010,54,56,-2
TTO,Trinidad and Tobago,DEU,Germany,2011,33,23,10
TTO,Trinidad and Tobago,DEU,Germany,2012,44,22,22
TTO,Trinidad and Tobago,DEU,Germany,2013,30,28,2
TTO,Trinidad and Tobago,DEU,Germany,2014,35,27,8
TTO,Trinidad and Tobago,DEU,Germany,2015,33,20,13
TTO,Trinidad and Tobago,DEU,Germany,2016,41,19,22
TTO,Trinidad and Tobago,DEU,Germany,2017,32,13,19
TTO,Trinidad and Tobago,HUN,Hungary,2008,5,0,5
TTO,Trinidad and Tobago,HUN,Hungary,2009,1,0,1
TTO,Trinidad and Tobago,HUN,Hungary,2010,2,0,2
TTO,Trinidad and Tobago,HUN,Hungary,2011,1,0,1
TTO,Trinidad and Tobago,HUN,Hungary,2012,0,0,0
TTO,Trinidad and Tobago,HUN,Hungary,2013,4,0,4
TTO,Trinidad and Tobago,HUN,Hungary,2014,0,0,0
TTO,Trinidad and Tobago,HUN,Hungary,2015,1,0,1
TTO,Trinidad and Tobago,HUN,Hungary,2016,0,0,0
TTO,Trinidad and Tobago,HUN,Hungary,2017,1,0,1
TTO,Trinidad and Tobago,ISL,Iceland,2008,1,0,1
TTO,Trinidad and Tobago,ISL,Iceland,2009,0,0,0
TTO,Trinidad and Tobago,ISL,Iceland,2010,1,0,1
TTO,Trinidad and Tobago,ISL,Iceland,2011,0,0,0
TTO,Trinidad and Tobago,ISL,Iceland,2012,0,1,-1
TTO,Trinidad and Tobago,ISL,Iceland,2013,0,0,0
TTO,Trinidad and Tobago,ISL,Iceland,2014,2,2,0
TTO,Trinidad and Tobago,ISL,Iceland,2015,3,0,3
TTO,Trinidad and Tobago,ISL,Iceland,2016,2,2,0
TTO,Trinidad and Tobago,ISL,Iceland,2017,1,2,-1
TTO,Trinidad and Tobago,ITA,Italy,2008,7,0,7
TTO,Trinidad and Tobago,ITA,Italy,2009,1,0,1
TTO,Trinidad and Tobago,ITA,Italy,2010,7,0,7
TTO,Trinidad and Tobago,ITA,Italy,2011,6,0,6
TTO,Trinidad and Tobago,ITA,Italy,2012,4,0,4
TTO,Trinidad and Tobago,ITA,Italy,2013,6,1,5
TTO,Trinidad and Tobago,ITA,Italy,2014,2,0,2
TTO,Trinidad and Tobago,ITA,Italy,2015,1,1,0
TTO,Trinidad and Tobago,ITA,Italy,2016,1,0,1
TTO,Trinidad and Tobago,ITA,Italy,2017,1,1,0
TTO,Trinidad and Tobago,JPN,Japan,2008,75,67,8
TTO,Trinidad and Tobago,JPN,Japan,2009,46,43,3
TTO,Trinidad and Tobago,JPN,Japan,2010,61,55,6
TTO,Trinidad and Tobago,JPN,Japan,2011,30,22,8
TTO,Trinidad and Tobago,JPN,Japan,2012,40,44,-4
TTO,Trinidad and Tobago,JPN,Japan,2013,39,39,0
TTO,Trinidad and Tobago,JPN,Japan,2014,49,47,2
TTO,Trinidad and Tobago,JPN,Japan,2015,40,26,14
TTO,Trinidad and Tobago,JPN,Japan,2016,36,11,25
TTO,Trinidad and Tobago,JPN,Japan,2017,36,13,23
TTO,Trinidad and Tobago,KOR,Korea,2008,7,6,1
TTO,Trinidad and Tobago,KOR,Korea,2009,4,3,1
TTO,Trinidad and Tobago,KOR,Korea,2010,4,5,-1
TTO,Trinidad and Tobago,KOR,Korea,2011,2,2,0
TTO,Trinidad and Tobago,KOR,Korea,2012,1,2,-1
TTO,Trinidad and Tobago,KOR,Korea,2013,7,2,5
TTO,Trinidad and Tobago,KOR,Korea,2014,3,0,3
TTO,Trinidad and Tobago,KOR,Korea,2015,7,9,-2
TTO,Trinidad and Tobago,KOR,Korea,2016,3,4,-1
TTO,Trinidad and Tobago,KOR,Korea,2017,5,2,3
TTO,Trinidad and Tobago,LUX,Luxembourg,2008,1,0,1
TTO,Trinidad and Tobago,LUX,Luxembourg,2009,0,0,0
TTO,Trinidad and Tobago,LUX,Luxembourg,2010,0,0,0
TTO,Trinidad and Tobago,LUX,Luxembourg,2011,1,0,1
TTO,Trinidad and Tobago,LUX,Luxembourg,2012,1,0,1
TTO,Trinidad and Tobago,LUX,Luxembourg,2013,2,0,2
TTO,Trinidad and Tobago,LUX,Luxembourg,2014,0,1,-1
TTO,Trinidad and Tobago,LUX,Luxembourg,2015,0,1,-1
TTO,Trinidad and Tobago,LUX,Luxembourg,2016,2,1,1
TTO,Trinidad and Tobago,LUX,Luxembourg,2017,0,1,-1
TTO,Trinidad and Tobago,MEX,Mexico,2008,3,0,3
TTO,Trinidad and Tobago,MEX,Mexico,2009,5,0,5
TTO,Trinidad and Tobago,MEX,Mexico,2010,1,0,1
TTO,Trinidad and Tobago,MEX,Mexico,2012,0,0,0
TTO,Trinidad and Tobago,MEX,Mexico,2013,5,0,5
TTO,Trinidad and Tobago,MEX,Mexico,2014,3,0,3
TTO,Trinidad and Tobago,MEX,Mexico,2015,5,0,5
TTO,Trinidad and Tobago,MEX,Mexico,2016,3,0,3
TTO,Trinidad and Tobago,MEX,Mexico,2017,5,0,5
TTO,Trinidad and Tobago,NLD,Netherlands,2008,15,12,3
TTO,Trinidad and Tobago,NLD,Netherlands,2010,15,11,4
TTO,Trinidad and Tobago,NLD,Netherlands,2011,24,18,6
TTO,Trinidad and Tobago,NLD,Netherlands,2012,15,11,4
TTO,Trinidad and Tobago,NLD,Netherlands,2013,9,10,-1
TTO,Trinidad and Tobago,NLD,Netherlands,2014,24,5,19
TTO,Trinidad and Tobago,NLD,Netherlands,2015,16,12,4
TTO,Trinidad and Tobago,NLD,Netherlands,2016,29,10,19
TTO,Trinidad and Tobago,NLD,Netherlands,2017,46,8,38
TTO,Trinidad and Tobago,NZL,New Zealand,2008,3,4,-1
TTO,Trinidad and Tobago,NZL,New Zealand,2009,2,4,-2
TTO,Trinidad and Tobago,NZL,New Zealand,2010,6,2,4
TTO,Trinidad and Tobago,NZL,New Zealand,2011,7,1,6
TTO,Trinidad and Tobago,NZL,New Zealand,2012,7,4,3
TTO,Trinidad and Tobago,NZL,New Zealand,2013,13,2,11
TTO,Trinidad and Tobago,NZL,New Zealand,2014,4,2,2
TTO,Trinidad and Tobago,NZL,New Zealand,2015,10,4,6
TTO,Trinidad and Tobago,NZL,New Zealand,2016,2,6,-4
TTO,Trinidad and Tobago,NZL,New Zealand,2017,14,0,14
TTO,Trinidad and Tobago,NOR,Norway,2008,12,3,9
TTO,Trinidad and Tobago,NOR,Norway,2009,3,3,0
TTO,Trinidad and Tobago,NOR,Norway,2010,9,5,4
TTO,Trinidad and Tobago,NOR,Norway,2011,5,3,2
TTO,Trinidad and Tobago,NOR,Norway,2012,11,5,6
TTO,Trinidad and Tobago,NOR,Norway,2013,13,8,5
TTO,Trinidad and Tobago,NOR,Norway,2014,8,2,6
TTO,Trinidad and Tobago,NOR,Norway,2015,2,3,-1
TTO,Trinidad and Tobago,NOR,Norway,2016,8,11,-3
TTO,Trinidad and Tobago,NOR,Norway,2017,8,2,6
TTO,Trinidad and Tobago,POL,Poland,2009,4,0,4
TTO,Trinidad and Tobago,POL,Poland,2010,1,0,1
TTO,Trinidad and Tobago,POL,Poland,2011,3,0,3
TTO,Trinidad and Tobago,POL,Poland,2012,4,0,4
TTO,Trinidad and Tobago,POL,Poland,2013,2,0,2
TTO,Trinidad and Tobago,POL,Poland,2014,0,0,0
TTO,Trinidad and Tobago,POL,Poland,2015,6,0,6
TTO,Trinidad and Tobago,POL,Poland,2016,6,0,6
TTO,Trinidad and Tobago,POL,Poland,2017,3,0,3
TTO,Trinidad and Tobago,SVK,Slovak Republic,2008,1,0,1
TTO,Trinidad and Tobago,SVK,Slovak Republic,2009,2,0,2
TTO,Trinidad and Tobago,SVK,Slovak Republic,2011,1,0,1
TTO,Trinidad and Tobago,SVK,Slovak Republic,2015,1,0,1
TTO,Trinidad and Tobago,ESP,Spain,2008,13,3,10
TTO,Trinidad and Tobago,ESP,Spain,2009,7,6,1
TTO,Trinidad and Tobago,ESP,Spain,2010,10,4,6
TTO,Trinidad and Tobago,ESP,Spain,2011,13,5,8
TTO,Trinidad and Tobago,ESP,Spain,2012,9,4,5
TTO,Trinidad and Tobago,ESP,Spain,2013,18,7,11
TTO,Trinidad and Tobago,ESP,Spain,2014,12,4,8
TTO,Trinidad and Tobago,ESP,Spain,2015,13,4,9
TTO,Trinidad and Tobago,ESP,Spain,2016,18,8,10
TTO,Trinidad and Tobago,ESP,Spain,2017,28,12,16
TTO,Trinidad and Tobago,SWE,Sweden,2008,8,3,5
TTO,Trinidad and Tobago,SWE,Sweden,2009,5,1,4
TTO,Trinidad and Tobago,SWE,Sweden,2010,19,2,17
TTO,Trinidad and Tobago,SWE,Sweden,2011,9,2,7
TTO,Trinidad and Tobago,SWE,Sweden,2012,8,9,-1
TTO,Trinidad and Tobago,SWE,Sweden,2013,5,5,0
TTO,Trinidad and Tobago,SWE,Sweden,2014,3,3,0
TTO,Trinidad and Tobago,SWE,Sweden,2015,2,7,-5
TTO,Trinidad and Tobago,SWE,Sweden,2016,4,5,-1
TTO,Trinidad and Tobago,SWE,Sweden,2017,13,3,10
TTO,Trinidad and Tobago,CHE,Switzerland,2010,7,8,-1
TTO,Trinidad and Tobago,CHE,Switzerland,2011,7,6,1
TTO,Trinidad and Tobago,CHE,Switzerland,2012,16,1,15
TTO,Trinidad and Tobago,CHE,Switzerland,2013,14,7,7
TTO,Trinidad and Tobago,CHE,Switzerland,2014,10,6,4
TTO,Trinidad and Tobago,CHE,Switzerland,2015,6,0,6
TTO,Trinidad and Tobago,CHE,Switzerland,2016,13,8,5
TTO,Trinidad and Tobago,CHE,Switzerland,2017,3,7,-4
TTO,Trinidad and Tobago,GBR,United Kingdom,2013,1000,1000,0
TTO,Trinidad and Tobago,USA,United States,2008,5937,0,5937
TTO,Trinidad and Tobago,USA,United States,2009,6256,0,6256
TTO,Trinidad and Tobago,USA,United States,2010,5435,0,5435
TTO,Trinidad and Tobago,USA,United States,2011,5023,0,5023
TTO,Trinidad and Tobago,USA,United States,2012,5214,0,5214
TTO,Trinidad and Tobago,USA,United States,2013,4724,0,4724
TTO,Trinidad and Tobago,USA,United States,2014,3988,0,3988
TTO,Trinidad and Tobago,USA,United States,2015,3212,0,3212
TTO,Trinidad and Tobago,USA,United States,2016,3469,0,3469
TTO,Trinidad and Tobago,USA,United States,2017,3100,0,3100
TTO,Trinidad and Tobago,CHL,Chile,2008,7,0,7
TTO,Trinidad and Tobago,CHL,Chile,2009,3,0,3
TTO,Trinidad and Tobago,CHL,Chile,2010,3,0,3
TTO,Trinidad and Tobago,CHL,Chile,2011,1,0,1
TTO,Trinidad and Tobago,CHL,Chile,2012,3,0,3
TTO,Trinidad and Tobago,CHL,Chile,2013,3,0,3
TTO,Trinidad and Tobago,CHL,Chile,2014,3,0,3
TTO,Trinidad and Tobago,CHL,Chile,2015,4,0,4
TTO,Trinidad and Tobago,CHL,Chile,2016,2,0,2
TTO,Trinidad and Tobago,EST,Estonia,2008,0,0,0
TTO,Trinidad and Tobago,EST,Estonia,2009,0,0,0
TTO,Trinidad and Tobago,EST,Estonia,2010,0,0,0
TTO,Trinidad and Tobago,EST,Estonia,2011,0,0,0
TTO,Trinidad and Tobago,EST,Estonia,2012,0,0,0
TTO,Trinidad and Tobago,EST,Estonia,2013,0,0,0
TTO,Trinidad and Tobago,EST,Estonia,2014,0,0,0
TTO,Trinidad and Tobago,EST,Estonia,2015,0,0,0
TTO,Trinidad and Tobago,EST,Estonia,2016,0,0,0
TTO,Trinidad and Tobago,EST,Estonia,2017,0,0,0
TTO,Trinidad and Tobago,SVN,Slovenia,2008,1,0,1
TTO,Trinidad and Tobago,SVN,Slovenia,2009,31,0,31
TTO,Trinidad and Tobago,SVN,Slovenia,2010,1,0,1
TTO,Trinidad and Tobago,SVN,Slovenia,2015,2,0,2
TUN,Tunisia,AUS,Australia,2008,7,6,1
TUN,Tunisia,AUS,Australia,2009,7,0,7
TUN,Tunisia,AUS,Australia,2010,7,11,-4
TUN,Tunisia,AUS,Australia,2011,13,9,4
TUN,Tunisia,AUS,Australia,2012,15,10,5
TUN,Tunisia,AUS,Australia,2013,26,6,20
TUN,Tunisia,AUS,Australia,2014,28,8,20
TUN,Tunisia,AUS,Australia,2015,22,0,22
TUN,Tunisia,AUS,Australia,2016,28,0,28
TUN,Tunisia,AUS,Australia,2017,26,0,26
TUN,Tunisia,AUT,Austria,2008,189,104,85
TUN,Tunisia,AUT,Austria,2009,156,103,53
TUN,Tunisia,AUT,Austria,2010,190,97,93
TUN,Tunisia,AUT,Austria,2011,247,120,127
TUN,Tunisia,AUT,Austria,2012,235,132,103
TUN,Tunisia,AUT,Austria,2013,190,117,73
TUN,Tunisia,AUT,Austria,2014,273,118,155
TUN,Tunisia,AUT,Austria,2015,295,104,191
TUN,Tunisia,AUT,Austria,2016,305,155,150
TUN,Tunisia,AUT,Austria,2017,276,209,67
TUN,Tunisia,BEL,Belgium,2008,669,100,569
TUN,Tunisia,BEL,Belgium,2009,607,135,472
TUN,Tunisia,BEL,Belgium,2010,717,137,580
TUN,Tunisia,BEL,Belgium,2011,812,155,657
TUN,Tunisia,BEL,Belgium,2012,794,177,617
TUN,Tunisia,BEL,Belgium,2013,709,269,440
TUN,Tunisia,BEL,Belgium,2014,662,282,380
TUN,Tunisia,BEL,Belgium,2015,650,225,425
TUN,Tunisia,BEL,Belgium,2016,627,156,471
TUN,Tunisia,BEL,Belgium,2017,653,129,524
TUN,Tunisia,CAN,Canada,2008,950,0,950
TUN,Tunisia,CAN,Canada,2009,1195,0,1195
TUN,Tunisia,CAN,Canada,2010,1299,0,1299
TUN,Tunisia,CAN,Canada,2011,1441,0,1441
TUN,Tunisia,CAN,Canada,2012,1495,0,1495
TUN,Tunisia,CAN,Canada,2013,1624,0,1624
TUN,Tunisia,CAN,Canada,2014,1472,0,1472
TUN,Tunisia,CAN,Canada,2015,1283,0,1283
TUN,Tunisia,CAN,Canada,2016,1310,0,1310
TUN,Tunisia,CAN,Canada,2017,1435,0,1435
TUN,Tunisia,CZE,Czech Republic,2008,80,3,77
TUN,Tunisia,CZE,Czech Republic,2009,105,2,103
TUN,Tunisia,CZE,Czech Republic,2010,47,1,46
TUN,Tunisia,CZE,Czech Republic,2011,47,3,44
TUN,Tunisia,CZE,Czech Republic,2012,58,6,52
TUN,Tunisia,CZE,Czech Republic,2013,46,28,18
TUN,Tunisia,CZE,Czech Republic,2014,81,21,60
TUN,Tunisia,CZE,Czech Republic,2015,70,45,25
TUN,Tunisia,CZE,Czech Republic,2016,113,16,97
TUN,Tunisia,CZE,Czech Republic,2017,124,18,106
TUN,Tunisia,DNK,Denmark,2008,18,11,7
TUN,Tunisia,DNK,Denmark,2009,28,6,22
TUN,Tunisia,DNK,Denmark,2010,26,7,19
TUN,Tunisia,DNK,Denmark,2011,20,12,8
TUN,Tunisia,DNK,Denmark,2012,19,6,13
TUN,Tunisia,DNK,Denmark,2013,34,12,22
TUN,Tunisia,DNK,Denmark,2014,23,14,9
TUN,Tunisia,DNK,Denmark,2015,41,9,32
TUN,Tunisia,DNK,Denmark,2016,42,15,27
TUN,Tunisia,DNK,Denmark,2017,26,15,11
TUN,Tunisia,FIN,Finland,2008,37,1,36
TUN,Tunisia,FIN,Finland,2009,42,2,40
TUN,Tunisia,FIN,Finland,2010,33,2,31
TUN,Tunisia,FIN,Finland,2011,25,9,16
TUN,Tunisia,FIN,Finland,2012,40,10,30
TUN,Tunisia,FIN,Finland,2013,25,5,20
TUN,Tunisia,FIN,Finland,2014,36,7,29
TUN,Tunisia,FIN,Finland,2015,52,7,45
TUN,Tunisia,FIN,Finland,2016,44,7,37
TUN,Tunisia,FIN,Finland,2017,34,7,27
TUN,Tunisia,FRA,France,2008,8802,0,8802
TUN,Tunisia,FRA,France,2009,10341,0,10341
TUN,Tunisia,FRA,France,2010,10692,0,10692
TUN,Tunisia,FRA,France,2011,10296,0,10296
TUN,Tunisia,FRA,France,2012,11276,0,11276
TUN,Tunisia,FRA,France,2013,11572,0,11572
TUN,Tunisia,FRA,France,2014,11904,0,11904
TUN,Tunisia,FRA,France,2015,10508,0,10508
TUN,Tunisia,FRA,France,2016,11283,0,11283
TUN,Tunisia,FRA,France,2017,11669,0,11669
TUN,Tunisia,DEU,Germany,2008,1868,1600,268
TUN,Tunisia,DEU,Germany,2009,1837,1600,237
TUN,Tunisia,DEU,Germany,2010,1955,1387,568
TUN,Tunisia,DEU,Germany,2011,2748,1431,1317
TUN,Tunisia,DEU,Germany,2012,3046,1580,1466
TUN,Tunisia,DEU,Germany,2013,3859,1683,2176
TUN,Tunisia,DEU,Germany,2014,4950,2022,2928
TUN,Tunisia,DEU,Germany,2015,5299,2188,3111
TUN,Tunisia,DEU,Germany,2016,5541,3186,2355
TUN,Tunisia,DEU,Germany,2017,5105,2596,2509
TUN,Tunisia,HUN,Hungary,2008,26,2,24
TUN,Tunisia,HUN,Hungary,2009,29,5,24
TUN,Tunisia,HUN,Hungary,2010,19,2,17
TUN,Tunisia,HUN,Hungary,2011,14,1,13
TUN,Tunisia,HUN,Hungary,2012,20,2,18
TUN,Tunisia,HUN,Hungary,2013,20,0,20
TUN,Tunisia,HUN,Hungary,2014,75,3,72
TUN,Tunisia,HUN,Hungary,2015,100,2,98
TUN,Tunisia,HUN,Hungary,2016,83,8,75
TUN,Tunisia,HUN,Hungary,2017,125,0,125
TUN,Tunisia,ISL,Iceland,2008,2,0,2
TUN,Tunisia,ISL,Iceland,2009,0,0,0
TUN,Tunisia,ISL,Iceland,2010,2,0,2
TUN,Tunisia,ISL,Iceland,2011,2,0,2
TUN,Tunisia,ISL,Iceland,2012,3,2,1
TUN,Tunisia,ISL,Iceland,2013,1,0,1
TUN,Tunisia,ISL,Iceland,2014,3,0,3
TUN,Tunisia,ISL,Iceland,2015,4,1,3
TUN,Tunisia,ISL,Iceland,2016,3,1,2
TUN,Tunisia,ISL,Iceland,2017,5,1,4
TUN,Tunisia,ITA,Italy,2008,6947,401,6546
TUN,Tunisia,ITA,Italy,2009,5692,484,5208
TUN,Tunisia,ITA,Italy,2010,6007,532,5475
TUN,Tunisia,ITA,Italy,2011,5888,571,5317
TUN,Tunisia,ITA,Italy,2012,5447,676,4771
TUN,Tunisia,ITA,Italy,2013,4313,655,3658
TUN,Tunisia,ITA,Italy,2014,3740,705,3035
TUN,Tunisia,ITA,Italy,2015,3861,611,3250
TUN,Tunisia,ITA,Italy,2016,3671,0,3671
TUN,Tunisia,ITA,Italy,2017,3565,471,3094
TUN,Tunisia,JPN,Japan,2008,102,75,27
TUN,Tunisia,JPN,Japan,2009,74,59,15
TUN,Tunisia,JPN,Japan,2010,82,70,12
TUN,Tunisia,JPN,Japan,2011,123,117,6
TUN,Tunisia,JPN,Japan,2012,89,97,-8
TUN,Tunisia,JPN,Japan,2013,95,72,23
TUN,Tunisia,JPN,Japan,2014,90,84,6
TUN,Tunisia,JPN,Japan,2015,102,90,12
TUN,Tunisia,JPN,Japan,2016,90,75,15
TUN,Tunisia,JPN,Japan,2017,128,97,31
TUN,Tunisia,KOR,Korea,2008,29,26,3
TUN,Tunisia,KOR,Korea,2009,28,24,4
TUN,Tunisia,KOR,Korea,2010,36,24,12
TUN,Tunisia,KOR,Korea,2011,41,30,11
TUN,Tunisia,KOR,Korea,2012,37,27,10
TUN,Tunisia,KOR,Korea,2013,53,30,23
TUN,Tunisia,KOR,Korea,2014,68,48,20
TUN,Tunisia,KOR,Korea,2015,56,47,9
TUN,Tunisia,KOR,Korea,2016,62,50,12
TUN,Tunisia,KOR,Korea,2017,66,51,15
TUN,Tunisia,LUX,Luxembourg,2008,36,4,32
TUN,Tunisia,LUX,Luxembourg,2009,36,13,23
TUN,Tunisia,LUX,Luxembourg,2010,36,15,21
TUN,Tunisia,LUX,Luxembourg,2011,61,7,54
TUN,Tunisia,LUX,Luxembourg,2012,62,21,41
TUN,Tunisia,LUX,Luxembourg,2013,79,23,56
TUN,Tunisia,LUX,Luxembourg,2014,85,41,44
TUN,Tunisia,LUX,Luxembourg,2015,94,43,51
TUN,Tunisia,LUX,Luxembourg,2016,83,30,53
TUN,Tunisia,LUX,Luxembourg,2017,145,21,124
TUN,Tunisia,MEX,Mexico,2008,1,0,1
TUN,Tunisia,MEX,Mexico,2009,2,0,2
TUN,Tunisia,MEX,Mexico,2010,7,0,7
TUN,Tunisia,MEX,Mexico,2011,3,0,3
TUN,Tunisia,MEX,Mexico,2012,3,0,3
TUN,Tunisia,MEX,Mexico,2013,8,0,8
TUN,Tunisia,MEX,Mexico,2014,7,0,7
TUN,Tunisia,MEX,Mexico,2015,6,0,6
TUN,Tunisia,MEX,Mexico,2016,6,0,6
TUN,Tunisia,MEX,Mexico,2017,7,0,7
TUN,Tunisia,NLD,Netherlands,2008,100,45,55
TUN,Tunisia,NLD,Netherlands,2009,108,44,64
TUN,Tunisia,NLD,Netherlands,2010,97,53,44
TUN,Tunisia,NLD,Netherlands,2011,122,35,87
TUN,Tunisia,NLD,Netherlands,2012,144,35,109
TUN,Tunisia,NLD,Netherlands,2013,146,76,70
TUN,Tunisia,NLD,Netherlands,2014,129,59,70
TUN,Tunisia,NLD,Netherlands,2015,128,41,87
TUN,Tunisia,NLD,Netherlands,2016,162,50,112
TUN,Tunisia,NLD,Netherlands,2017,209,42,167
TUN,Tunisia,NZL,New Zealand,2008,1,1,0
TUN,Tunisia,NZL,New Zealand,2009,2,0,2
TUN,Tunisia,NZL,New Zealand,2010,3,1,2
TUN,Tunisia,NZL,New Zealand,2011,2,1,1
TUN,Tunisia,NZL,New Zealand,2012,1,0,1
TUN,Tunisia,NZL,New Zealand,2013,3,0,3
TUN,Tunisia,NZL,New Zealand,2014,6,2,4
TUN,Tunisia,NZL,New Zealand,2015,2,0,2
TUN,Tunisia,NZL,New Zealand,2016,3,4,-1
TUN,Tunisia,NZL,New Zealand,2017,2,1,1
TUN,Tunisia,NOR,Norway,2008,35,11,24
TUN,Tunisia,NOR,Norway,2009,46,4,42
TUN,Tunisia,NOR,Norway,2010,24,17,7
TUN,Tunisia,NOR,Norway,2011,53,17,36
TUN,Tunisia,NOR,Norway,2012,47,12,35
TUN,Tunisia,NOR,Norway,2013,28,18,10
TUN,Tunisia,NOR,Norway,2014,36,12,24
TUN,Tunisia,NOR,Norway,2015,38,16,22
TUN,Tunisia,NOR,Norway,2016,35,18,17
TUN,Tunisia,NOR,Norway,2017,48,11,37
TUN,Tunisia,POL,Poland,2008,297,0,297
TUN,Tunisia,POL,Poland,2009,350,0,350
TUN,Tunisia,POL,Poland,2010,498,0,498
TUN,Tunisia,POL,Poland,2011,450,0,450
TUN,Tunisia,POL,Poland,2012,453,0,453
TUN,Tunisia,POL,Poland,2013,402,0,402
TUN,Tunisia,POL,Poland,2014,235,0,235
TUN,Tunisia,POL,Poland,2015,403,0,403
TUN,Tunisia,POL,Poland,2016,342,0,342
TUN,Tunisia,POL,Poland,2017,284,0,284
TUN,Tunisia,SVK,Slovak Republic,2008,10,3,7
TUN,Tunisia,SVK,Slovak Republic,2009,6,1,5
TUN,Tunisia,SVK,Slovak Republic,2010,14,2,12
TUN,Tunisia,SVK,Slovak Republic,2011,5,1,4
TUN,Tunisia,SVK,Slovak Republic,2012,6,0,6
TUN,Tunisia,SVK,Slovak Republic,2013,10,0,10
TUN,Tunisia,SVK,Slovak Republic,2014,6,1,5
TUN,Tunisia,SVK,Slovak Republic,2015,8,1,7
TUN,Tunisia,SVK,Slovak Republic,2016,4,0,4
TUN,Tunisia,SVK,Slovak Republic,2017,4,0,4
TUN,Tunisia,ESP,Spain,2008,232,102,130
TUN,Tunisia,ESP,Spain,2009,194,133,61
TUN,Tunisia,ESP,Spain,2010,160,173,-13
TUN,Tunisia,ESP,Spain,2011,208,173,35
TUN,Tunisia,ESP,Spain,2012,183,147,36
TUN,Tunisia,ESP,Spain,2013,205,159,46
TUN,Tunisia,ESP,Spain,2014,214,97,117
TUN,Tunisia,ESP,Spain,2015,213,81,132
TUN,Tunisia,ESP,Spain,2016,247,127,120
TUN,Tunisia,ESP,Spain,2017,256,163,93
TUN,Tunisia,SWE,Sweden,2008,183,28,155
TUN,Tunisia,SWE,Sweden,2009,209,14,195
TUN,Tunisia,SWE,Sweden,2010,250,34,216
TUN,Tunisia,SWE,Sweden,2011,228,34,194
TUN,Tunisia,SWE,Sweden,2012,288,28,260
TUN,Tunisia,SWE,Sweden,2013,208,28,180
TUN,Tunisia,SWE,Sweden,2014,193,40,153
TUN,Tunisia,SWE,Sweden,2015,221,58,163
TUN,Tunisia,SWE,Sweden,2016,201,27,174
TUN,Tunisia,SWE,Sweden,2017,250,39,211
TUN,Tunisia,CHE,Switzerland,2010,569,139,430
TUN,Tunisia,CHE,Switzerland,2011,523,134,389
TUN,Tunisia,CHE,Switzerland,2012,503,151,352
TUN,Tunisia,CHE,Switzerland,2013,509,136,373
TUN,Tunisia,CHE,Switzerland,2014,458,142,316
TUN,Tunisia,CHE,Switzerland,2015,521,142,379
TUN,Tunisia,CHE,Switzerland,2016,584,138,446
TUN,Tunisia,CHE,Switzerland,2017,475,137,338
TUN,Tunisia,TUR,Turkey,2010,46,0,46
TUN,Tunisia,TUR,Turkey,2016,608,234,374
TUN,Tunisia,TUR,Turkey,2017,810,275,535
TUN,Tunisia,GBR,United Kingdom,2013,2000,0,2000
TUN,Tunisia,USA,United States,2008,410,0,410
TUN,Tunisia,USA,United States,2009,416,0,416
TUN,Tunisia,USA,United States,2010,418,0,418
TUN,Tunisia,USA,United States,2011,440,0,440
TUN,Tunisia,USA,United States,2012,422,0,422
TUN,Tunisia,USA,United States,2013,445,0,445
TUN,Tunisia,USA,United States,2014,429,0,429
TUN,Tunisia,USA,United States,2015,518,0,518
TUN,Tunisia,USA,United States,2016,518,0,518
TUN,Tunisia,USA,United States,2017,535,0,535
TUN,Tunisia,CHL,Chile,2008,2,0,2
TUN,Tunisia,CHL,Chile,2009,2,0,2
TUN,Tunisia,CHL,Chile,2010,1,0,1
TUN,Tunisia,CHL,Chile,2011,1,0,1
TUN,Tunisia,CHL,Chile,2012,2,0,2
TUN,Tunisia,CHL,Chile,2013,3,0,3
TUN,Tunisia,CHL,Chile,2014,1,0,1
TUN,Tunisia,CHL,Chile,2015,6,0,6
TUN,Tunisia,CHL,Chile,2016,7,0,7
TUN,Tunisia,EST,Estonia,2008,1,0,1
TUN,Tunisia,EST,Estonia,2009,0,0,0
TUN,Tunisia,EST,Estonia,2010,0,0,0
TUN,Tunisia,EST,Estonia,2011,1,0,1
TUN,Tunisia,EST,Estonia,2012,1,0,1
TUN,Tunisia,EST,Estonia,2013,1,0,1
TUN,Tunisia,EST,Estonia,2014,1,0,1
TUN,Tunisia,EST,Estonia,2015,1,0,1
TUN,Tunisia,EST,Estonia,2016,7,0,7
TUN,Tunisia,EST,Estonia,2017,2,0,2
TUN,Tunisia,ISR,Israel,2008,8,0,8
TUN,Tunisia,ISR,Israel,2009,14,0,14
TUN,Tunisia,ISR,Israel,2010,16,0,16
TUN,Tunisia,ISR,Israel,2011,46,0,46
TUN,Tunisia,ISR,Israel,2012,40,0,40
TUN,Tunisia,ISR,Israel,2013,6,0,6
TUN,Tunisia,ISR,Israel,2014,12,0,12
TUN,Tunisia,ISR,Israel,2015,12,0,12
TUN,Tunisia,ISR,Israel,2016,14,0,14
TUN,Tunisia,ISR,Israel,2017,43,0,43
TUN,Tunisia,SVN,Slovenia,2008,5,0,5
TUN,Tunisia,SVN,Slovenia,2009,9,0,9
TUN,Tunisia,SVN,Slovenia,2010,12,0,12
TUN,Tunisia,SVN,Slovenia,2011,13,0,13
TUN,Tunisia,SVN,Slovenia,2013,4,1,3
TUN,Tunisia,SVN,Slovenia,2015,11,1,10
TUN,Tunisia,SVN,Slovenia,2016,2,0,2
TUN,Tunisia,SVN,Slovenia,2017,12,2,10
TUR,Turkey,AUS,Australia,2008,546,0,546
TUR,Turkey,AUS,Australia,2009,591,0,591
TUR,Turkey,AUS,Australia,2010,449,100,349
TUR,Turkey,AUS,Australia,2011,705,0,705
TUR,Turkey,AUS,Australia,2012,612,0,612
TUR,Turkey,AUS,Australia,2013,564,0,564
TUR,Turkey,AUS,Australia,2014,604,0,604
TUR,Turkey,AUS,Australia,2015,542,0,542
TUR,Turkey,AUS,Australia,2016,575,220,355
TUR,Turkey,AUS,Australia,2017,624,180,444
TUR,Turkey,AUT,Austria,2008,4983,0,4983
TUR,Turkey,AUT,Austria,2009,4735,0,4735
TUR,Turkey,AUT,Austria,2010,4258,139,4119
TUR,Turkey,AUT,Austria,2011,3812,0,3812
TUR,Turkey,AUT,Austria,2012,4088,0,4088
TUR,Turkey,AUT,Austria,2013,4476,0,4476
TUR,Turkey,AUT,Austria,2014,3684,0,3684
TUR,Turkey,AUT,Austria,2015,3653,0,3653
TUR,Turkey,AUT,Austria,2016,3707,1532,2175
TUR,Turkey,AUT,Austria,2017,3347,1472,1875
TUR,Turkey,BEL,Belgium,2008,3172,0,3172
TUR,Turkey,BEL,Belgium,2009,3118,0,3118
TUR,Turkey,BEL,Belgium,2010,3232,252,2980
TUR,Turkey,BEL,Belgium,2011,2897,0,2897
TUR,Turkey,BEL,Belgium,2012,2391,0,2391
TUR,Turkey,BEL,Belgium,2013,1973,0,1973
TUR,Turkey,BEL,Belgium,2014,1617,0,1617
TUR,Turkey,BEL,Belgium,2015,1724,0,1724
TUR,Turkey,BEL,Belgium,2016,1742,239,1503
TUR,Turkey,BEL,Belgium,2017,1925,247,1678
TUR,Turkey,CAN,Canada,2008,1122,0,1122
TUR,Turkey,CAN,Canada,2009,1238,0,1238
TUR,Turkey,CAN,Canada,2010,1492,136,1356
TUR,Turkey,CAN,Canada,2011,1255,0,1255
TUR,Turkey,CAN,Canada,2012,1068,0,1068
TUR,Turkey,CAN,Canada,2013,729,0,729
TUR,Turkey,CAN,Canada,2014,717,0,717
TUR,Turkey,CAN,Canada,2015,874,0,874
TUR,Turkey,CAN,Canada,2016,920,366,554
TUR,Turkey,CAN,Canada,2017,1110,454,656
TUR,Turkey,CZE,Czech Republic,2008,394,0,394
TUR,Turkey,CZE,Czech Republic,2009,398,0,398
TUR,Turkey,CZE,Czech Republic,2010,489,50,439
TUR,Turkey,CZE,Czech Republic,2011,430,0,430
TUR,Turkey,CZE,Czech Republic,2012,366,0,366
TUR,Turkey,CZE,Czech Republic,2013,435,0,435
TUR,Turkey,CZE,Czech Republic,2014,390,0,390
TUR,Turkey,CZE,Czech Republic,2015,381,0,381
TUR,Turkey,CZE,Czech Republic,2016,451,161,290
TUR,Turkey,CZE,Czech Republic,2017,600,109,491
TUR,Turkey,DNK,Denmark,2008,571,0,571
TUR,Turkey,DNK,Denmark,2009,649,0,649
TUR,Turkey,DNK,Denmark,2010,561,207,354
TUR,Turkey,DNK,Denmark,2011,400,0,400
TUR,Turkey,DNK,Denmark,2012,326,0,326
TUR,Turkey,DNK,Denmark,2013,523,0,523
TUR,Turkey,DNK,Denmark,2014,436,0,436
TUR,Turkey,DNK,Denmark,2015,417,0,417
TUR,Turkey,DNK,Denmark,2016,438,321,117
TUR,Turkey,DNK,Denmark,2017,611,343,268
TUR,Turkey,FIN,Finland,2008,439,0,439
TUR,Turkey,FIN,Finland,2009,430,0,430
TUR,Turkey,FIN,Finland,2010,277,28,249
TUR,Turkey,FIN,Finland,2011,312,0,312
TUR,Turkey,FIN,Finland,2012,409,0,409
TUR,Turkey,FIN,Finland,2013,382,0,382
TUR,Turkey,FIN,Finland,2014,346,0,346
TUR,Turkey,FIN,Finland,2015,297,0,297
TUR,Turkey,FIN,Finland,2016,311,138,173
TUR,Turkey,FIN,Finland,2017,325,186,139
TUR,Turkey,FRA,France,2008,7153,0,7153
TUR,Turkey,FRA,France,2009,6717,0,6717
TUR,Turkey,FRA,France,2010,5695,420,5275
TUR,Turkey,FRA,France,2011,5464,0,5464
TUR,Turkey,FRA,France,2012,5753,0,5753
TUR,Turkey,FRA,France,2013,5922,0,5922
TUR,Turkey,FRA,France,2014,5290,0,5290
TUR,Turkey,FRA,France,2015,4948,0,4948
TUR,Turkey,FRA,France,2016,4981,866,4115
TUR,Turkey,FRA,France,2017,4929,789,4140
TUR,Turkey,DEU,Germany,2008,26653,0,26653
TUR,Turkey,DEU,Germany,2009,27212,0,27212
TUR,Turkey,DEU,Germany,2010,27564,1642,25922
TUR,Turkey,DEU,Germany,2011,28610,0,28610
TUR,Turkey,DEU,Germany,2012,26150,0,26150
TUR,Turkey,DEU,Germany,2013,23230,0,23230
TUR,Turkey,DEU,Germany,2014,22058,0,22058
TUR,Turkey,DEU,Germany,2015,23698,0,23698
TUR,Turkey,DEU,Germany,2016,28639,8606,20033
TUR,Turkey,DEU,Germany,2017,33655,8440,25215
TUR,Turkey,HUN,Hungary,2008,720,0,720
TUR,Turkey,HUN,Hungary,2009,520,0,520
TUR,Turkey,HUN,Hungary,2010,520,54,466
TUR,Turkey,HUN,Hungary,2011,576,0,576
TUR,Turkey,HUN,Hungary,2012,569,0,569
TUR,Turkey,HUN,Hungary,2013,499,0,499
TUR,Turkey,HUN,Hungary,2014,567,0,567
TUR,Turkey,HUN,Hungary,2015,565,0,565
TUR,Turkey,HUN,Hungary,2016,698,146,552
TUR,Turkey,HUN,Hungary,2017,953,0,953
TUR,Turkey,ISL,Iceland,2008,7,0,7
TUR,Turkey,ISL,Iceland,2009,2,0,2
TUR,Turkey,ISL,Iceland,2010,7,3,4
TUR,Turkey,ISL,Iceland,2011,3,0,3
TUR,Turkey,ISL,Iceland,2012,4,0,4
TUR,Turkey,ISL,Iceland,2013,7,0,7
TUR,Turkey,ISL,Iceland,2014,7,0,7
TUR,Turkey,ISL,Iceland,2015,7,0,7
TUR,Turkey,ISL,Iceland,2016,6,0,6
TUR,Turkey,ISL,Iceland,2017,10,0,10
TUR,Turkey,ITA,Italy,2008,1441,0,1441
TUR,Turkey,ITA,Italy,2009,1394,0,1394
TUR,Turkey,ITA,Italy,2010,1483,274,1209
TUR,Turkey,ITA,Italy,2011,1397,0,1397
TUR,Turkey,ITA,Italy,2012,1202,0,1202
TUR,Turkey,ITA,Italy,2013,1169,0,1169
TUR,Turkey,ITA,Italy,2014,927,0,927
TUR,Turkey,ITA,Italy,2015,875,0,875
TUR,Turkey,ITA,Italy,2016,840,693,147
TUR,Turkey,ITA,Italy,2017,997,462,535
TUR,Turkey,JPN,Japan,2008,663,0,663
TUR,Turkey,JPN,Japan,2009,489,0,489
TUR,Turkey,JPN,Japan,2010,855,172,683
TUR,Turkey,JPN,Japan,2011,599,0,599
TUR,Turkey,JPN,Japan,2012,833,0,833
TUR,Turkey,JPN,Japan,2013,908,0,908
TUR,Turkey,JPN,Japan,2014,1150,0,1150
TUR,Turkey,JPN,Japan,2015,1236,0,1236
TUR,Turkey,JPN,Japan,2016,895,340,555
TUR,Turkey,JPN,Japan,2017,955,344,611
TUR,Turkey,KOR,Korea,2008,386,0,386
TUR,Turkey,KOR,Korea,2009,318,0,318
TUR,Turkey,KOR,Korea,2010,407,260,147
TUR,Turkey,KOR,Korea,2011,367,0,367
TUR,Turkey,KOR,Korea,2012,321,0,321
TUR,Turkey,KOR,Korea,2013,308,0,308
TUR,Turkey,KOR,Korea,2014,324,0,324
TUR,Turkey,KOR,Korea,2015,338,0,338
TUR,Turkey,KOR,Korea,2016,424,670,-246
TUR,Turkey,KOR,Korea,2017,587,756,-169
TUR,Turkey,LUX,Luxembourg,2008,37,0,37
TUR,Turkey,LUX,Luxembourg,2009,74,0,74
TUR,Turkey,LUX,Luxembourg,2010,71,1,70
TUR,Turkey,LUX,Luxembourg,2011,77,0,77
TUR,Turkey,LUX,Luxembourg,2012,90,0,90
TUR,Turkey,LUX,Luxembourg,2013,63,0,63
TUR,Turkey,LUX,Luxembourg,2014,66,0,66
TUR,Turkey,LUX,Luxembourg,2015,96,0,96
TUR,Turkey,LUX,Luxembourg,2016,114,0,114
TUR,Turkey,LUX,Luxembourg,2017,231,0,231
TUR,Turkey,MEX,Mexico,2008,17,0,17
TUR,Turkey,MEX,Mexico,2009,31,0,31
TUR,Turkey,MEX,Mexico,2010,34,21,13
TUR,Turkey,MEX,Mexico,2011,20,0,20
TUR,Turkey,MEX,Mexico,2012,17,0,17
TUR,Turkey,MEX,Mexico,2013,54,0,54
TUR,Turkey,MEX,Mexico,2014,38,0,38
TUR,Turkey,MEX,Mexico,2015,30,0,30
TUR,Turkey,MEX,Mexico,2016,51,106,-55
TUR,Turkey,MEX,Mexico,2017,25,101,-76
TUR,Turkey,NLD,Netherlands,2008,3299,0,3299
TUR,Turkey,NLD,Netherlands,2009,3468,0,3468
TUR,Turkey,NLD,Netherlands,2010,3712,277,3435
TUR,Turkey,NLD,Netherlands,2011,3387,0,3387
TUR,Turkey,NLD,Netherlands,2012,3190,0,3190
TUR,Turkey,NLD,Netherlands,2013,3035,0,3035
TUR,Turkey,NLD,Netherlands,2014,2840,0,2840
TUR,Turkey,NLD,Netherlands,2015,2843,0,2843
TUR,Turkey,NLD,Netherlands,2016,3247,861,2386
TUR,Turkey,NLD,Netherlands,2017,4444,727,3717
TUR,Turkey,NZL,New Zealand,2008,45,0,45
TUR,Turkey,NZL,New Zealand,2009,53,0,53
TUR,Turkey,NZL,New Zealand,2010,44,24,20
TUR,Turkey,NZL,New Zealand,2011,55,0,55
TUR,Turkey,NZL,New Zealand,2012,42,0,42
TUR,Turkey,NZL,New Zealand,2013,44,0,44
TUR,Turkey,NZL,New Zealand,2014,76,0,76
TUR,Turkey,NZL,New Zealand,2015,78,0,78
TUR,Turkey,NZL,New Zealand,2016,67,0,67
TUR,Turkey,NZL,New Zealand,2017,77,0,77
TUR,Turkey,NOR,Norway,2008,308,0,308
TUR,Turkey,NOR,Norway,2009,414,0,414
TUR,Turkey,NOR,Norway,2010,293,142,151
TUR,Turkey,NOR,Norway,2011,281,0,281
TUR,Turkey,NOR,Norway,2012,306,0,306
TUR,Turkey,NOR,Norway,2013,290,0,290
TUR,Turkey,NOR,Norway,2014,290,0,290
TUR,Turkey,NOR,Norway,2015,247,0,247
TUR,Turkey,NOR,Norway,2016,331,209,122
TUR,Turkey,NOR,Norway,2017,377,309,68
TUR,Turkey,POL,Poland,2008,918,0,918
TUR,Turkey,POL,Poland,2009,1002,0,1002
TUR,Turkey,POL,Poland,2010,1122,109,1013
TUR,Turkey,POL,Poland,2011,1239,0,1239
TUR,Turkey,POL,Poland,2012,1340,0,1340
TUR,Turkey,POL,Poland,2013,1420,0,1420
TUR,Turkey,POL,Poland,2014,922,0,922
TUR,Turkey,POL,Poland,2015,1669,0,1669
TUR,Turkey,POL,Poland,2016,1703,289,1414
TUR,Turkey,POL,Poland,2017,1995,251,1744
TUR,Turkey,SVK,Slovak Republic,2008,10,0,10
TUR,Turkey,SVK,Slovak Republic,2009,8,0,8
TUR,Turkey,SVK,Slovak Republic,2010,16,57,-41
TUR,Turkey,SVK,Slovak Republic,2011,13,0,13
TUR,Turkey,SVK,Slovak Republic,2012,10,0,10
TUR,Turkey,SVK,Slovak Republic,2013,12,0,12
TUR,Turkey,SVK,Slovak Republic,2014,5,0,5
TUR,Turkey,SVK,Slovak Republic,2015,13,0,13
TUR,Turkey,SVK,Slovak Republic,2016,8,0,8
TUR,Turkey,SVK,Slovak Republic,2017,9,0,9
TUR,Turkey,ESP,Spain,2008,514,0,514
TUR,Turkey,ESP,Spain,2009,461,0,461
TUR,Turkey,ESP,Spain,2010,427,199,228
TUR,Turkey,ESP,Spain,2011,640,0,640
TUR,Turkey,ESP,Spain,2012,590,0,590
TUR,Turkey,ESP,Spain,2013,546,0,546
TUR,Turkey,ESP,Spain,2014,527,0,527
TUR,Turkey,ESP,Spain,2015,641,0,641
TUR,Turkey,ESP,Spain,2016,706,391,315
TUR,Turkey,ESP,Spain,2017,1078,304,774
TUR,Turkey,SWE,Sweden,2008,1458,0,1458
TUR,Turkey,SWE,Sweden,2009,1970,0,1970
TUR,Turkey,SWE,Sweden,2010,2232,64,2168
TUR,Turkey,SWE,Sweden,2011,1965,0,1965
TUR,Turkey,SWE,Sweden,2012,1793,0,1793
TUR,Turkey,SWE,Sweden,2013,1326,0,1326
TUR,Turkey,SWE,Sweden,2014,1216,0,1216
TUR,Turkey,SWE,Sweden,2015,1228,0,1228
TUR,Turkey,SWE,Sweden,2016,1115,374,741
TUR,Turkey,SWE,Sweden,2017,1549,391,1158
TUR,Turkey,CHE,Switzerland,2008,2146,0,2146
TUR,Turkey,CHE,Switzerland,2009,2198,0,2198
TUR,Turkey,CHE,Switzerland,2010,1988,56,1932
TUR,Turkey,CHE,Switzerland,2011,1787,0,1787
TUR,Turkey,CHE,Switzerland,2012,1637,0,1637
TUR,Turkey,CHE,Switzerland,2013,1659,0,1659
TUR,Turkey,CHE,Switzerland,2014,1665,0,1665
TUR,Turkey,CHE,Switzerland,2015,1548,0,1548
TUR,Turkey,CHE,Switzerland,2016,1479,152,1327
TUR,Turkey,CHE,Switzerland,2017,1571,118,1453
TUR,Turkey,GBR,United Kingdom,2011,1000,0,1000
TUR,Turkey,GBR,United Kingdom,2012,1000,0,1000
TUR,Turkey,GBR,United Kingdom,2013,5000,0,5000
TUR,Turkey,GBR,United Kingdom,2014,4000,0,4000
TUR,Turkey,GBR,United Kingdom,2015,2000,0,2000
TUR,Turkey,GBR,United Kingdom,2016,7000,1764,5236
TUR,Turkey,GBR,United Kingdom,2017,6000,1819,4181
TUR,Turkey,USA,United States,2008,4210,0,4210
TUR,Turkey,USA,United States,2009,4958,0,4958
TUR,Turkey,USA,United States,2010,4483,1541,2942
TUR,Turkey,USA,United States,2011,4403,0,4403
TUR,Turkey,USA,United States,2012,4162,0,4162
TUR,Turkey,USA,United States,2013,4144,0,4144
TUR,Turkey,USA,United States,2014,3834,0,3834
TUR,Turkey,USA,United States,2015,4201,0,4201
TUR,Turkey,USA,United States,2016,4469,1663,2806
TUR,Turkey,USA,United States,2017,4844,1969,2875
TUR,Turkey,CHL,Chile,2008,39,0,39
TUR,Turkey,CHL,Chile,2009,30,0,30
TUR,Turkey,CHL,Chile,2010,36,8,28
TUR,Turkey,CHL,Chile,2011,38,0,38
TUR,Turkey,CHL,Chile,2012,66,0,66
TUR,Turkey,CHL,Chile,2013,33,0,33
TUR,Turkey,CHL,Chile,2014,41,0,41
TUR,Turkey,CHL,Chile,2015,78,0,78
TUR,Turkey,CHL,Chile,2016,64,0,64
TUR,Turkey,EST,Estonia,2008,11,0,11
TUR,Turkey,EST,Estonia,2009,21,0,21
TUR,Turkey,EST,Estonia,2010,17,21,-4
TUR,Turkey,EST,Estonia,2011,18,0,18
TUR,Turkey,EST,Estonia,2012,22,0,22
TUR,Turkey,EST,Estonia,2013,38,0,38
TUR,Turkey,EST,Estonia,2014,22,0,22
TUR,Turkey,EST,Estonia,2015,66,0,66
TUR,Turkey,EST,Estonia,2016,61,0,61
TUR,Turkey,EST,Estonia,2017,97,0,97
TUR,Turkey,ISR,Israel,2008,98,0,98
TUR,Turkey,ISR,Israel,2009,145,0,145
TUR,Turkey,ISR,Israel,2010,131,18,113
TUR,Turkey,ISR,Israel,2011,104,0,104
TUR,Turkey,ISR,Israel,2012,62,0,62
TUR,Turkey,ISR,Israel,2013,64,0,64
TUR,Turkey,ISR,Israel,2014,57,0,57
TUR,Turkey,ISR,Israel,2015,90,0,90
TUR,Turkey,ISR,Israel,2016,239,0,239
TUR,Turkey,ISR,Israel,2017,369,153,216
TUR,Turkey,SVN,Slovenia,2008,105,0,105
TUR,Turkey,SVN,Slovenia,2009,95,0,95
TUR,Turkey,SVN,Slovenia,2010,118,9,109
TUR,Turkey,SVN,Slovenia,2011,169,0,169
TUR,Turkey,SVN,Slovenia,2012,83,0,83
TUR,Turkey,SVN,Slovenia,2013,92,0,92
TUR,Turkey,SVN,Slovenia,2014,54,0,54
TUR,Turkey,SVN,Slovenia,2015,49,0,49
TUR,Turkey,SVN,Slovenia,2016,39,0,39
TUR,Turkey,SVN,Slovenia,2017,71,0,71
TKM,Turkmenistan,AUS,Australia,2008,1,0,1
TKM,Turkmenistan,AUS,Australia,2009,1,0,1
TKM,Turkmenistan,AUS,Australia,2010,6,0,6
TKM,Turkmenistan,AUS,Australia,2011,3,0,3
TKM,Turkmenistan,AUS,Australia,2012,2,0,2
TKM,Turkmenistan,AUS,Australia,2013,2,0,2
TKM,Turkmenistan,AUS,Australia,2014,0,0,0
TKM,Turkmenistan,AUS,Australia,2015,0,0,0
TKM,Turkmenistan,AUS,Australia,2017,3,0,3
TKM,Turkmenistan,AUT,Austria,2008,9,9,0
TKM,Turkmenistan,AUT,Austria,2009,31,5,26
TKM,Turkmenistan,AUT,Austria,2010,31,11,20
TKM,Turkmenistan,AUT,Austria,2011,40,15,25
TKM,Turkmenistan,AUT,Austria,2012,31,18,13
TKM,Turkmenistan,AUT,Austria,2013,14,25,-11
TKM,Turkmenistan,AUT,Austria,2014,22,9,13
TKM,Turkmenistan,AUT,Austria,2015,24,20,4
TKM,Turkmenistan,AUT,Austria,2016,14,11,3
TKM,Turkmenistan,AUT,Austria,2017,23,14,9
TKM,Turkmenistan,BEL,Belgium,2008,0,0,0
TKM,Turkmenistan,BEL,Belgium,2009,0,0,0
TKM,Turkmenistan,BEL,Belgium,2010,8,0,8
TKM,Turkmenistan,BEL,Belgium,2013,7,6,1
TKM,Turkmenistan,BEL,Belgium,2015,4,1,3
TKM,Turkmenistan,BEL,Belgium,2016,1,1,0
TKM,Turkmenistan,BEL,Belgium,2017,6,0,6
TKM,Turkmenistan,CAN,Canada,2008,13,0,13
TKM,Turkmenistan,CAN,Canada,2009,20,0,20
TKM,Turkmenistan,CAN,Canada,2010,30,0,30
TKM,Turkmenistan,CAN,Canada,2011,20,0,20
TKM,Turkmenistan,CAN,Canada,2012,19,0,19
TKM,Turkmenistan,CAN,Canada,2013,14,0,14
TKM,Turkmenistan,CAN,Canada,2014,5,0,5
TKM,Turkmenistan,CAN,Canada,2015,8,0,8
TKM,Turkmenistan,CAN,Canada,2016,15,0,15
TKM,Turkmenistan,CAN,Canada,2017,25,0,25
TKM,Turkmenistan,CZE,Czech Republic,2008,12,0,12
TKM,Turkmenistan,CZE,Czech Republic,2009,8,0,8
TKM,Turkmenistan,CZE,Czech Republic,2010,1,0,1
TKM,Turkmenistan,CZE,Czech Republic,2011,5,0,5
TKM,Turkmenistan,CZE,Czech Republic,2012,5,3,2
TKM,Turkmenistan,CZE,Czech Republic,2013,4,7,-3
TKM,Turkmenistan,CZE,Czech Republic,2014,6,3,3
TKM,Turkmenistan,CZE,Czech Republic,2015,3,1,2
TKM,Turkmenistan,CZE,Czech Republic,2016,8,3,5
TKM,Turkmenistan,CZE,Czech Republic,2017,9,2,7
TKM,Turkmenistan,DNK,Denmark,2008,2,1,1
TKM,Turkmenistan,DNK,Denmark,2009,2,0,2
TKM,Turkmenistan,DNK,Denmark,2010,1,0,1
TKM,Turkmenistan,DNK,Denmark,2012,0,1,-1
TKM,Turkmenistan,DNK,Denmark,2013,0,1,-1
TKM,Turkmenistan,DNK,Denmark,2014,4,0,4
TKM,Turkmenistan,DNK,Denmark,2015,0,0,0
TKM,Turkmenistan,DNK,Denmark,2016,1,1,0
TKM,Turkmenistan,DNK,Denmark,2017,1,1,0
TKM,Turkmenistan,FIN,Finland,2008,3,0,3
TKM,Turkmenistan,FIN,Finland,2009,3,0,3
TKM,Turkmenistan,FIN,Finland,2010,1,0,1
TKM,Turkmenistan,FIN,Finland,2011,0,0,0
TKM,Turkmenistan,FIN,Finland,2012,1,0,1
TKM,Turkmenistan,FIN,Finland,2013,0,0,0
TKM,Turkmenistan,FIN,Finland,2014,0,0,0
TKM,Turkmenistan,FIN,Finland,2015,1,0,1
TKM,Turkmenistan,FIN,Finland,2016,6,0,6
TKM,Turkmenistan,FIN,Finland,2017,3,0,3
TKM,Turkmenistan,FRA,France,2008,10,0,10
TKM,Turkmenistan,FRA,France,2009,15,0,15
TKM,Turkmenistan,FRA,France,2010,14,0,14
TKM,Turkmenistan,FRA,France,2011,15,0,15
TKM,Turkmenistan,FRA,France,2012,8,0,8
TKM,Turkmenistan,FRA,France,2013,29,0,29
TKM,Turkmenistan,FRA,France,2014,14,0,14
TKM,Turkmenistan,FRA,France,2015,19,0,19
TKM,Turkmenistan,FRA,France,2016,14,0,14
TKM,Turkmenistan,FRA,France,2017,15,0,15
TKM,Turkmenistan,DEU,Germany,2008,147,91,56
TKM,Turkmenistan,DEU,Germany,2009,144,105,39
TKM,Turkmenistan,DEU,Germany,2010,120,99,21
TKM,Turkmenistan,DEU,Germany,2011,164,111,53
TKM,Turkmenistan,DEU,Germany,2012,149,105,44
TKM,Turkmenistan,DEU,Germany,2013,244,106,138
TKM,Turkmenistan,DEU,Germany,2014,454,128,326
TKM,Turkmenistan,DEU,Germany,2015,458,178,280
TKM,Turkmenistan,DEU,Germany,2016,448,215,233
TKM,Turkmenistan,DEU,Germany,2017,280,158,122
TKM,Turkmenistan,HUN,Hungary,2008,1,0,1
TKM,Turkmenistan,HUN,Hungary,2009,2,0,2
TKM,Turkmenistan,HUN,Hungary,2010,3,0,3
TKM,Turkmenistan,HUN,Hungary,2011,5,1,4
TKM,Turkmenistan,HUN,Hungary,2012,2,0,2
TKM,Turkmenistan,HUN,Hungary,2013,5,0,5
TKM,Turkmenistan,HUN,Hungary,2014,16,2,14
TKM,Turkmenistan,HUN,Hungary,2015,13,3,10
TKM,Turkmenistan,HUN,Hungary,2016,7,4,3
TKM,Turkmenistan,HUN,Hungary,2017,6,0,6
TKM,Turkmenistan,ISL,Iceland,2016,0,0,0
TKM,Turkmenistan,ISL,Iceland,2017,0,0,0
TKM,Turkmenistan,ITA,Italy,2008,48,0,48
TKM,Turkmenistan,ITA,Italy,2009,22,0,22
TKM,Turkmenistan,ITA,Italy,2010,11,1,10
TKM,Turkmenistan,ITA,Italy,2011,5,4,1
TKM,Turkmenistan,ITA,Italy,2012,6,0,6
TKM,Turkmenistan,ITA,Italy,2013,10,3,7
TKM,Turkmenistan,ITA,Italy,2014,9,0,9
TKM,Turkmenistan,ITA,Italy,2015,14,1,13
TKM,Turkmenistan,ITA,Italy,2016,9,0,9
TKM,Turkmenistan,ITA,Italy,2017,8,0,8
TKM,Turkmenistan,JPN,Japan,2008,40,38,2
TKM,Turkmenistan,JPN,Japan,2009,118,111,7
TKM,Turkmenistan,JPN,Japan,2010,74,70,4
TKM,Turkmenistan,JPN,Japan,2011,39,32,7
TKM,Turkmenistan,JPN,Japan,2012,52,42,10
TKM,Turkmenistan,JPN,Japan,2013,104,105,-1
TKM,Turkmenistan,JPN,Japan,2014,50,43,7
TKM,Turkmenistan,JPN,Japan,2015,154,152,2
TKM,Turkmenistan,JPN,Japan,2016,37,39,-2
TKM,Turkmenistan,JPN,Japan,2017,62,57,5
TKM,Turkmenistan,KOR,Korea,2008,2,3,-1
TKM,Turkmenistan,KOR,Korea,2009,9,2,7
TKM,Turkmenistan,KOR,Korea,2010,11,7,4
TKM,Turkmenistan,KOR,Korea,2011,8,3,5
TKM,Turkmenistan,KOR,Korea,2012,22,12,10
TKM,Turkmenistan,KOR,Korea,2013,12,9,3
TKM,Turkmenistan,KOR,Korea,2014,7,5,2
TKM,Turkmenistan,KOR,Korea,2015,13,13,0
TKM,Turkmenistan,KOR,Korea,2016,35,18,17
TKM,Turkmenistan,KOR,Korea,2017,41,12,29
TKM,Turkmenistan,LUX,Luxembourg,2008,0,0,0
TKM,Turkmenistan,LUX,Luxembourg,2009,0,0,0
TKM,Turkmenistan,LUX,Luxembourg,2010,0,0,0
TKM,Turkmenistan,LUX,Luxembourg,2011,0,0,0
TKM,Turkmenistan,LUX,Luxembourg,2012,0,0,0
TKM,Turkmenistan,LUX,Luxembourg,2013,0,0,0
TKM,Turkmenistan,LUX,Luxembourg,2014,0,0,0
TKM,Turkmenistan,LUX,Luxembourg,2015,1,0,1
TKM,Turkmenistan,LUX,Luxembourg,2016,0,0,0
TKM,Turkmenistan,LUX,Luxembourg,2017,6,0,6
TKM,Turkmenistan,MEX,Mexico,2008,1,0,1
TKM,Turkmenistan,MEX,Mexico,2009,1,0,1
TKM,Turkmenistan,MEX,Mexico,2012,0,0,0
TKM,Turkmenistan,MEX,Mexico,2013,1,0,1
TKM,Turkmenistan,MEX,Mexico,2014,0,0,0
TKM,Turkmenistan,MEX,Mexico,2016,0,0,0
TKM,Turkmenistan,NLD,Netherlands,2009,8,2,6
TKM,Turkmenistan,NLD,Netherlands,2010,2,0,2
TKM,Turkmenistan,NLD,Netherlands,2011,6,2,4
TKM,Turkmenistan,NLD,Netherlands,2012,4,1,3
TKM,Turkmenistan,NLD,Netherlands,2013,3,1,2
TKM,Turkmenistan,NLD,Netherlands,2014,4,1,3
TKM,Turkmenistan,NLD,Netherlands,2015,5,0,5
TKM,Turkmenistan,NLD,Netherlands,2016,7,3,4
TKM,Turkmenistan,NLD,Netherlands,2017,6,4,2
TKM,Turkmenistan,NZL,New Zealand,2014,1,0,1
TKM,Turkmenistan,NZL,New Zealand,2016,1,0,1
TKM,Turkmenistan,NOR,Norway,2008,7,0,7
TKM,Turkmenistan,NOR,Norway,2009,3,3,0
TKM,Turkmenistan,NOR,Norway,2010,7,1,6
TKM,Turkmenistan,NOR,Norway,2011,3,3,0
TKM,Turkmenistan,NOR,Norway,2012,2,2,0
TKM,Turkmenistan,NOR,Norway,2013,2,2,0
TKM,Turkmenistan,NOR,Norway,2014,2,0,2
TKM,Turkmenistan,NOR,Norway,2015,4,2,2
TKM,Turkmenistan,NOR,Norway,2016,0,3,-3
TKM,Turkmenistan,NOR,Norway,2017,6,1,5
TKM,Turkmenistan,POL,Poland,2008,25,0,25
TKM,Turkmenistan,POL,Poland,2009,40,0,40
TKM,Turkmenistan,POL,Poland,2010,33,0,33
TKM,Turkmenistan,POL,Poland,2011,32,0,32
TKM,Turkmenistan,POL,Poland,2012,42,0,42
TKM,Turkmenistan,POL,Poland,2013,51,0,51
TKM,Turkmenistan,POL,Poland,2014,19,0,19
TKM,Turkmenistan,POL,Poland,2015,25,0,25
TKM,Turkmenistan,POL,Poland,2016,39,0,39
TKM,Turkmenistan,POL,Poland,2017,51,0,51
TKM,Turkmenistan,SVK,Slovak Republic,2008,0,0,0
TKM,Turkmenistan,SVK,Slovak Republic,2009,1,0,1
TKM,Turkmenistan,SVK,Slovak Republic,2015,1,0,1
TKM,Turkmenistan,ESP,Spain,2008,2,2,0
TKM,Turkmenistan,ESP,Spain,2009,4,0,4
TKM,Turkmenistan,ESP,Spain,2010,6,0,6
TKM,Turkmenistan,ESP,Spain,2011,8,1,7
TKM,Turkmenistan,ESP,Spain,2012,4,1,3
TKM,Turkmenistan,ESP,Spain,2013,9,1,8
TKM,Turkmenistan,ESP,Spain,2014,6,4,2
TKM,Turkmenistan,ESP,Spain,2015,9,3,6
TKM,Turkmenistan,ESP,Spain,2016,11,2,9
TKM,Turkmenistan,ESP,Spain,2017,10,5,5
TKM,Turkmenistan,SWE,Sweden,2008,8,1,7
TKM,Turkmenistan,SWE,Sweden,2009,7,0,7
TKM,Turkmenistan,SWE,Sweden,2010,0,0,0
TKM,Turkmenistan,SWE,Sweden,2011,5,3,2
TKM,Turkmenistan,SWE,Sweden,2012,1,0,1
TKM,Turkmenistan,SWE,Sweden,2013,2,0,2
TKM,Turkmenistan,SWE,Sweden,2014,5,0,5
TKM,Turkmenistan,SWE,Sweden,2015,3,2,1
TKM,Turkmenistan,SWE,Sweden,2016,2,0,2
TKM,Turkmenistan,SWE,Sweden,2017,1,0,1
TKM,Turkmenistan,CHE,Switzerland,2010,7,1,6
TKM,Turkmenistan,CHE,Switzerland,2011,4,1,3
TKM,Turkmenistan,CHE,Switzerland,2012,10,1,9
TKM,Turkmenistan,CHE,Switzerland,2013,3,0,3
TKM,Turkmenistan,CHE,Switzerland,2014,10,2,8
TKM,Turkmenistan,CHE,Switzerland,2015,4,0,4
TKM,Turkmenistan,CHE,Switzerland,2016,12,1,11
TKM,Turkmenistan,CHE,Switzerland,2017,6,2,4
TKM,Turkmenistan,TUR,Turkey,2010,1186,0,1186
TKM,Turkmenistan,TUR,Turkey,2016,8394,3555,4839
TKM,Turkmenistan,TUR,Turkey,2017,20317,4001,16316
TKM,Turkmenistan,USA,United States,2008,274,0,274
TKM,Turkmenistan,USA,United States,2009,290,0,290
TKM,Turkmenistan,USA,United States,2010,224,0,224
TKM,Turkmenistan,USA,United States,2011,260,0,260
TKM,Turkmenistan,USA,United States,2012,223,0,223
TKM,Turkmenistan,USA,United States,2013,210,0,210
TKM,Turkmenistan,USA,United States,2014,254,0,254
TKM,Turkmenistan,USA,United States,2015,226,0,226
TKM,Turkmenistan,USA,United States,2016,235,0,235
TKM,Turkmenistan,USA,United States,2017,251,0,251
TKM,Turkmenistan,CHL,Chile,2008,0,0,0
TKM,Turkmenistan,CHL,Chile,2009,0,0,0
TKM,Turkmenistan,CHL,Chile,2010,0,0,0
TKM,Turkmenistan,CHL,Chile,2011,0,0,0
TKM,Turkmenistan,CHL,Chile,2012,0,0,0
TKM,Turkmenistan,CHL,Chile,2013,0,0,0
TKM,Turkmenistan,CHL,Chile,2014,0,0,0
TKM,Turkmenistan,CHL,Chile,2015,0,0,0
TKM,Turkmenistan,CHL,Chile,2016,0,0,0
TKM,Turkmenistan,EST,Estonia,2008,0,0,0
TKM,Turkmenistan,EST,Estonia,2009,0,0,0
TKM,Turkmenistan,EST,Estonia,2010,0,0,0
TKM,Turkmenistan,EST,Estonia,2011,0,0,0
TKM,Turkmenistan,EST,Estonia,2012,1,0,1
TKM,Turkmenistan,EST,Estonia,2013,1,0,1
TKM,Turkmenistan,EST,Estonia,2014,0,0,0
TKM,Turkmenistan,EST,Estonia,2015,0,0,0
TKM,Turkmenistan,EST,Estonia,2016,2,0,2
TKM,Turkmenistan,EST,Estonia,2017,0,0,0
TUV,Tuvalu,AUS,Australia,2008,0,0,0
TUV,Tuvalu,AUS,Australia,2009,0,0,0
TUV,Tuvalu,AUS,Australia,2010,17,0,17
TUV,Tuvalu,AUS,Australia,2011,0,0,0
TUV,Tuvalu,AUS,Australia,2012,6,0,6
TUV,Tuvalu,AUS,Australia,2013,0,0,0
TUV,Tuvalu,AUS,Australia,2014,7,0,7
TUV,Tuvalu,AUS,Australia,2015,0,0,0
TUV,Tuvalu,AUS,Australia,2017,3,0,3
TUV,Tuvalu,AUT,Austria,2008,0,0,0
TUV,Tuvalu,AUT,Austria,2009,0,0,0
TUV,Tuvalu,AUT,Austria,2010,0,0,0
TUV,Tuvalu,AUT,Austria,2011,0,0,0
TUV,Tuvalu,AUT,Austria,2012,0,0,0
TUV,Tuvalu,AUT,Austria,2013,1,0,1
TUV,Tuvalu,AUT,Austria,2014,0,0,0
TUV,Tuvalu,AUT,Austria,2015,0,0,0
TUV,Tuvalu,AUT,Austria,2016,0,0,0
TUV,Tuvalu,AUT,Austria,2017,0,0,0
TUV,Tuvalu,BEL,Belgium,2009,0,0,0
TUV,Tuvalu,BEL,Belgium,2010,0,0,0
TUV,Tuvalu,BEL,Belgium,2017,1,0,1
TUV,Tuvalu,CAN,Canada,2008,0,0,0
TUV,Tuvalu,CAN,Canada,2009,0,0,0
TUV,Tuvalu,CAN,Canada,2010,0,0,0
TUV,Tuvalu,CAN,Canada,2011,1,0,1
TUV,Tuvalu,CAN,Canada,2012,0,0,0
TUV,Tuvalu,CAN,Canada,2013,0,0,0
TUV,Tuvalu,CAN,Canada,2014,0,0,0
TUV,Tuvalu,CAN,Canada,2015,0,0,0
TUV,Tuvalu,CAN,Canada,2016,0,0,0
TUV,Tuvalu,CAN,Canada,2017,0,0,0
TUV,Tuvalu,DNK,Denmark,2014,0,0,0
TUV,Tuvalu,DNK,Denmark,2015,1,0,1
TUV,Tuvalu,DNK,Denmark,2016,0,0,0
TUV,Tuvalu,DNK,Denmark,2017,0,0,0
TUV,Tuvalu,FIN,Finland,2008,0,0,0
TUV,Tuvalu,FIN,Finland,2009,0,0,0
TUV,Tuvalu,FIN,Finland,2010,0,0,0
TUV,Tuvalu,FIN,Finland,2011,0,0,0
TUV,Tuvalu,FIN,Finland,2012,0,0,0
TUV,Tuvalu,FIN,Finland,2013,0,0,0
TUV,Tuvalu,FIN,Finland,2014,0,0,0
TUV,Tuvalu,FIN,Finland,2015,0,0,0
TUV,Tuvalu,FIN,Finland,2016,0,0,0
TUV,Tuvalu,FIN,Finland,2017,0,0,0
TUV,Tuvalu,FRA,France,2008,0,0,0
TUV,Tuvalu,FRA,France,2009,0,0,0
TUV,Tuvalu,FRA,France,2010,0,0,0
TUV,Tuvalu,FRA,France,2011,0,0,0
TUV,Tuvalu,FRA,France,2012,0,0,0
TUV,Tuvalu,FRA,France,2013,0,0,0
TUV,Tuvalu,FRA,France,2014,1,0,1
TUV,Tuvalu,FRA,France,2015,0,0,0
TUV,Tuvalu,FRA,France,2016,0,0,0
TUV,Tuvalu,FRA,France,2017,0,0,0
TUV,Tuvalu,DEU,Germany,2008,147,102,45
TUV,Tuvalu,DEU,Germany,2009,81,146,-65
TUV,Tuvalu,DEU,Germany,2010,33,50,-17
TUV,Tuvalu,DEU,Germany,2011,38,33,5
TUV,Tuvalu,DEU,Germany,2012,27,60,-33
TUV,Tuvalu,DEU,Germany,2013,4,15,-11
TUV,Tuvalu,DEU,Germany,2014,2,2,0
TUV,Tuvalu,DEU,Germany,2015,2,1,1
TUV,Tuvalu,DEU,Germany,2016,2,2,0
TUV,Tuvalu,DEU,Germany,2017,3,1,2
TUV,Tuvalu,HUN,Hungary,2008,0,0,0
TUV,Tuvalu,HUN,Hungary,2009,0,0,0
TUV,Tuvalu,HUN,Hungary,2010,0,0,0
TUV,Tuvalu,HUN,Hungary,2011,0,0,0
TUV,Tuvalu,HUN,Hungary,2012,0,0,0
TUV,Tuvalu,HUN,Hungary,2013,0,0,0
TUV,Tuvalu,HUN,Hungary,2014,0,0,0
TUV,Tuvalu,HUN,Hungary,2015,0,0,0
TUV,Tuvalu,HUN,Hungary,2016,0,0,0
TUV,Tuvalu,HUN,Hungary,2017,0,0,0
TUV,Tuvalu,ISL,Iceland,2016,0,0,0
TUV,Tuvalu,ISL,Iceland,2017,0,0,0
TUV,Tuvalu,ITA,Italy,2008,1,0,1
TUV,Tuvalu,ITA,Italy,2009,0,0,0
TUV,Tuvalu,ITA,Italy,2010,0,0,0
TUV,Tuvalu,ITA,Italy,2011,0,0,0
TUV,Tuvalu,ITA,Italy,2012,0,0,0
TUV,Tuvalu,ITA,Italy,2013,0,0,0
TUV,Tuvalu,ITA,Italy,2015,0,0,0
TUV,Tuvalu,JPN,Japan,2008,30,28,2
TUV,Tuvalu,JPN,Japan,2009,20,20,0
TUV,Tuvalu,JPN,Japan,2010,23,22,1
TUV,Tuvalu,JPN,Japan,2011,17,10,7
TUV,Tuvalu,JPN,Japan,2012,23,24,-1
TUV,Tuvalu,JPN,Japan,2013,16,16,0
TUV,Tuvalu,JPN,Japan,2014,28,28,0
TUV,Tuvalu,JPN,Japan,2015,39,39,0
TUV,Tuvalu,JPN,Japan,2016,24,24,0
TUV,Tuvalu,JPN,Japan,2017,31,30,1
TUV,Tuvalu,KOR,Korea,2008,0,1,-1
TUV,Tuvalu,KOR,Korea,2009,0,0,0
TUV,Tuvalu,KOR,Korea,2010,0,0,0
TUV,Tuvalu,KOR,Korea,2011,3,1,2
TUV,Tuvalu,KOR,Korea,2012,2,2,0
TUV,Tuvalu,KOR,Korea,2013,0,1,-1
TUV,Tuvalu,KOR,Korea,2014,0,0,0
TUV,Tuvalu,KOR,Korea,2015,0,0,0
TUV,Tuvalu,KOR,Korea,2016,0,0,0
TUV,Tuvalu,KOR,Korea,2017,0,0,0
TUV,Tuvalu,LUX,Luxembourg,2008,0,0,0
TUV,Tuvalu,LUX,Luxembourg,2009,0,0,0
TUV,Tuvalu,LUX,Luxembourg,2010,0,0,0
TUV,Tuvalu,LUX,Luxembourg,2011,0,0,0
TUV,Tuvalu,LUX,Luxembourg,2012,0,0,0
TUV,Tuvalu,LUX,Luxembourg,2013,0,0,0
TUV,Tuvalu,LUX,Luxembourg,2014,0,0,0
TUV,Tuvalu,LUX,Luxembourg,2015,0,0,0
TUV,Tuvalu,LUX,Luxembourg,2016,0,0,0
TUV,Tuvalu,LUX,Luxembourg,2017,0,0,0
TUV,Tuvalu,MEX,Mexico,2012,0,0,0
TUV,Tuvalu,MEX,Mexico,2013,0,0,0
TUV,Tuvalu,MEX,Mexico,2014,0,0,0
TUV,Tuvalu,NZL,New Zealand,2008,25,20,5
TUV,Tuvalu,NZL,New Zealand,2009,42,18,24
TUV,Tuvalu,NZL,New Zealand,2010,40,31,9
TUV,Tuvalu,NZL,New Zealand,2011,28,24,4
TUV,Tuvalu,NZL,New Zealand,2012,41,25,16
TUV,Tuvalu,NZL,New Zealand,2013,74,22,52
TUV,Tuvalu,NZL,New Zealand,2014,64,16,48
TUV,Tuvalu,NZL,New Zealand,2015,98,12,86
TUV,Tuvalu,NZL,New Zealand,2016,56,25,31
TUV,Tuvalu,NZL,New Zealand,2017,100,12,88
TUV,Tuvalu,NOR,Norway,2008,0,0,0
TUV,Tuvalu,NOR,Norway,2009,0,0,0
TUV,Tuvalu,NOR,Norway,2010,0,0,0
TUV,Tuvalu,NOR,Norway,2011,0,0,0
TUV,Tuvalu,NOR,Norway,2012,0,0,0
TUV,Tuvalu,NOR,Norway,2013,0,0,0
TUV,Tuvalu,NOR,Norway,2014,0,0,0
TUV,Tuvalu,NOR,Norway,2015,0,0,0
TUV,Tuvalu,NOR,Norway,2016,0,0,0
TUV,Tuvalu,NOR,Norway,2017,0,0,0
TUV,Tuvalu,POL,Poland,2009,0,0,0
TUV,Tuvalu,POL,Poland,2010,0,0,0
TUV,Tuvalu,POL,Poland,2011,0,0,0
TUV,Tuvalu,POL,Poland,2012,0,0,0
TUV,Tuvalu,POL,Poland,2013,0,0,0
TUV,Tuvalu,POL,Poland,2014,0,0,0
TUV,Tuvalu,POL,Poland,2015,0,0,0
TUV,Tuvalu,POL,Poland,2016,0,0,0
TUV,Tuvalu,POL,Poland,2017,0,0,0
TUV,Tuvalu,SVK,Slovak Republic,2008,0,0,0
TUV,Tuvalu,ESP,Spain,2008,0,0,0
TUV,Tuvalu,ESP,Spain,2009,1,0,1
TUV,Tuvalu,ESP,Spain,2010,0,0,0
TUV,Tuvalu,ESP,Spain,2011,0,4,-4
TUV,Tuvalu,ESP,Spain,2012,0,0,0
TUV,Tuvalu,ESP,Spain,2013,0,0,0
TUV,Tuvalu,ESP,Spain,2014,4,0,4
TUV,Tuvalu,ESP,Spain,2015,0,0,0
TUV,Tuvalu,ESP,Spain,2016,0,0,0
TUV,Tuvalu,ESP,Spain,2017,1,0,1
TUV,Tuvalu,SWE,Sweden,2008,0,0,0
TUV,Tuvalu,SWE,Sweden,2009,0,0,0
TUV,Tuvalu,SWE,Sweden,2010,0,0,0
TUV,Tuvalu,SWE,Sweden,2011,0,0,0
TUV,Tuvalu,SWE,Sweden,2012,0,0,0
TUV,Tuvalu,SWE,Sweden,2013,0,0,0
TUV,Tuvalu,SWE,Sweden,2014,0,0,0
TUV,Tuvalu,SWE,Sweden,2015,0,0,0
TUV,Tuvalu,CHE,Switzerland,2010,0,0,0
TUV,Tuvalu,CHE,Switzerland,2011,0,0,0
TUV,Tuvalu,CHE,Switzerland,2012,0,0,0
TUV,Tuvalu,CHE,Switzerland,2013,0,0,0
TUV,Tuvalu,USA,United States,2017,3,0,3
TUV,Tuvalu,CHL,Chile,2008,0,0,0
TUV,Tuvalu,CHL,Chile,2009,0,0,0
TUV,Tuvalu,CHL,Chile,2010,0,0,0
TUV,Tuvalu,CHL,Chile,2011,0,0,0
TUV,Tuvalu,CHL,Chile,2012,0,0,0
TUV,Tuvalu,CHL,Chile,2013,0,0,0
TUV,Tuvalu,CHL,Chile,2014,0,0,0
TUV,Tuvalu,CHL,Chile,2015,0,0,0
TUV,Tuvalu,CHL,Chile,2016,0,0,0
TUV,Tuvalu,EST,Estonia,2008,0,0,0
TUV,Tuvalu,EST,Estonia,2009,0,0,0
TUV,Tuvalu,EST,Estonia,2010,0,0,0
TUV,Tuvalu,EST,Estonia,2011,0,0,0
TUV,Tuvalu,EST,Estonia,2012,0,0,0
TUV,Tuvalu,EST,Estonia,2013,0,0,0
TUV,Tuvalu,EST,Estonia,2014,0,0,0
TUV,Tuvalu,EST,Estonia,2015,0,0,0
TUV,Tuvalu,EST,Estonia,2016,0,0,0
TUV,Tuvalu,EST,Estonia,2017,0,0,0
UGA,Uganda,AUS,Australia,2008,64,19,45
UGA,Uganda,AUS,Australia,2009,47,17,30
UGA,Uganda,AUS,Australia,2010,63,21,42
UGA,Uganda,AUS,Australia,2011,87,13,74
UGA,Uganda,AUS,Australia,2012,51,19,32
UGA,Uganda,AUS,Australia,2013,68,18,50
UGA,Uganda,AUS,Australia,2014,94,24,70
UGA,Uganda,AUS,Australia,2015,71,0,71
UGA,Uganda,AUS,Australia,2016,76,0,76
UGA,Uganda,AUS,Australia,2017,65,0,65
UGA,Uganda,AUT,Austria,2008,34,27,7
UGA,Uganda,AUT,Austria,2009,27,27,0
UGA,Uganda,AUT,Austria,2010,28,26,2
UGA,Uganda,AUT,Austria,2011,39,17,22
UGA,Uganda,AUT,Austria,2012,46,20,26
UGA,Uganda,AUT,Austria,2013,27,22,5
UGA,Uganda,AUT,Austria,2014,44,31,13
UGA,Uganda,AUT,Austria,2015,71,24,47
UGA,Uganda,AUT,Austria,2016,56,38,18
UGA,Uganda,AUT,Austria,2017,45,35,10
UGA,Uganda,BEL,Belgium,2008,56,0,56
UGA,Uganda,BEL,Belgium,2009,63,0,63
UGA,Uganda,BEL,Belgium,2010,56,29,27
UGA,Uganda,BEL,Belgium,2012,73,65,8
UGA,Uganda,BEL,Belgium,2013,72,70,2
UGA,Uganda,BEL,Belgium,2014,65,45,20
UGA,Uganda,BEL,Belgium,2015,70,34,36
UGA,Uganda,BEL,Belgium,2016,72,37,35
UGA,Uganda,BEL,Belgium,2017,61,27,34
UGA,Uganda,CAN,Canada,2008,204,0,204
UGA,Uganda,CAN,Canada,2009,185,0,185
UGA,Uganda,CAN,Canada,2010,216,0,216
UGA,Uganda,CAN,Canada,2011,213,0,213
UGA,Uganda,CAN,Canada,2012,222,0,222
UGA,Uganda,CAN,Canada,2013,204,0,204
UGA,Uganda,CAN,Canada,2014,170,0,170
UGA,Uganda,CAN,Canada,2015,182,0,182
UGA,Uganda,CAN,Canada,2016,180,0,180
UGA,Uganda,CAN,Canada,2017,215,0,215
UGA,Uganda,CZE,Czech Republic,2008,4,0,4
UGA,Uganda,CZE,Czech Republic,2009,2,0,2
UGA,Uganda,CZE,Czech Republic,2010,2,0,2
UGA,Uganda,CZE,Czech Republic,2011,1,0,1
UGA,Uganda,CZE,Czech Republic,2012,1,0,1
UGA,Uganda,CZE,Czech Republic,2013,2,1,1
UGA,Uganda,CZE,Czech Republic,2014,9,0,9
UGA,Uganda,CZE,Czech Republic,2015,5,0,5
UGA,Uganda,CZE,Czech Republic,2016,2,0,2
UGA,Uganda,DNK,Denmark,2008,46,16,30
UGA,Uganda,DNK,Denmark,2009,64,20,44
UGA,Uganda,DNK,Denmark,2010,65,34,31
UGA,Uganda,DNK,Denmark,2011,38,26,12
UGA,Uganda,DNK,Denmark,2012,49,33,16
UGA,Uganda,DNK,Denmark,2013,57,20,37
UGA,Uganda,DNK,Denmark,2014,85,27,58
UGA,Uganda,DNK,Denmark,2015,69,20,49
UGA,Uganda,DNK,Denmark,2016,60,21,39
UGA,Uganda,DNK,Denmark,2017,55,29,26
UGA,Uganda,FIN,Finland,2008,23,0,23
UGA,Uganda,FIN,Finland,2009,9,1,8
UGA,Uganda,FIN,Finland,2010,13,2,11
UGA,Uganda,FIN,Finland,2011,9,0,9
UGA,Uganda,FIN,Finland,2012,11,3,8
UGA,Uganda,FIN,Finland,2013,21,1,20
UGA,Uganda,FIN,Finland,2014,20,0,20
UGA,Uganda,FIN,Finland,2015,14,1,13
UGA,Uganda,FIN,Finland,2016,23,0,23
UGA,Uganda,FIN,Finland,2017,16,1,15
UGA,Uganda,FRA,France,2008,24,0,24
UGA,Uganda,FRA,France,2009,13,0,13
UGA,Uganda,FRA,France,2010,17,0,17
UGA,Uganda,FRA,France,2011,26,0,26
UGA,Uganda,FRA,France,2012,26,0,26
UGA,Uganda,FRA,France,2013,26,0,26
UGA,Uganda,FRA,France,2014,22,0,22
UGA,Uganda,FRA,France,2015,38,0,38
UGA,Uganda,FRA,France,2016,46,0,46
UGA,Uganda,FRA,France,2017,39,0,39
UGA,Uganda,DEU,Germany,2008,165,146,19
UGA,Uganda,DEU,Germany,2009,183,134,49
UGA,Uganda,DEU,Germany,2010,217,144,73
UGA,Uganda,DEU,Germany,2011,226,110,116
UGA,Uganda,DEU,Germany,2012,233,123,110
UGA,Uganda,DEU,Germany,2013,225,137,88
UGA,Uganda,DEU,Germany,2014,225,117,108
UGA,Uganda,DEU,Germany,2015,320,122,198
UGA,Uganda,DEU,Germany,2016,374,126,248
UGA,Uganda,DEU,Germany,2017,368,151,217
UGA,Uganda,HUN,Hungary,2008,6,0,6
UGA,Uganda,HUN,Hungary,2009,5,0,5
UGA,Uganda,HUN,Hungary,2010,1,1,0
UGA,Uganda,HUN,Hungary,2011,7,0,7
UGA,Uganda,HUN,Hungary,2012,2,0,2
UGA,Uganda,HUN,Hungary,2013,7,0,7
UGA,Uganda,HUN,Hungary,2014,8,1,7
UGA,Uganda,HUN,Hungary,2015,7,0,7
UGA,Uganda,HUN,Hungary,2016,9,0,9
UGA,Uganda,HUN,Hungary,2017,21,0,21
UGA,Uganda,ISL,Iceland,2008,7,6,1
UGA,Uganda,ISL,Iceland,2009,9,12,-3
UGA,Uganda,ISL,Iceland,2010,8,1,7
UGA,Uganda,ISL,Iceland,2011,12,4,8
UGA,Uganda,ISL,Iceland,2012,9,2,7
UGA,Uganda,ISL,Iceland,2013,7,15,-8
UGA,Uganda,ISL,Iceland,2014,11,11,0
UGA,Uganda,ISL,Iceland,2015,11,7,4
UGA,Uganda,ISL,Iceland,2016,14,14,0
UGA,Uganda,ISL,Iceland,2017,12,7,5
UGA,Uganda,ITA,Italy,2008,44,7,37
UGA,Uganda,ITA,Italy,2009,37,7,30
UGA,Uganda,ITA,Italy,2010,42,3,39
UGA,Uganda,ITA,Italy,2011,29,3,26
UGA,Uganda,ITA,Italy,2012,44,1,43
UGA,Uganda,ITA,Italy,2013,34,7,27
UGA,Uganda,ITA,Italy,2014,43,5,38
UGA,Uganda,ITA,Italy,2015,49,6,43
UGA,Uganda,ITA,Italy,2016,45,0,45
UGA,Uganda,ITA,Italy,2017,52,8,44
UGA,Uganda,JPN,Japan,2008,159,146,13
UGA,Uganda,JPN,Japan,2009,123,110,13
UGA,Uganda,JPN,Japan,2010,167,142,25
UGA,Uganda,JPN,Japan,2011,153,138,15
UGA,Uganda,JPN,Japan,2012,210,183,27
UGA,Uganda,JPN,Japan,2013,247,223,24
UGA,Uganda,JPN,Japan,2014,180,138,42
UGA,Uganda,JPN,Japan,2015,223,189,34
UGA,Uganda,JPN,Japan,2016,153,134,19
UGA,Uganda,JPN,Japan,2017,207,169,38
UGA,Uganda,KOR,Korea,2008,45,28,17
UGA,Uganda,KOR,Korea,2009,28,33,-5
UGA,Uganda,KOR,Korea,2010,36,46,-10
UGA,Uganda,KOR,Korea,2011,113,39,74
UGA,Uganda,KOR,Korea,2012,88,52,36
UGA,Uganda,KOR,Korea,2013,74,56,18
UGA,Uganda,KOR,Korea,2014,121,60,61
UGA,Uganda,KOR,Korea,2015,189,86,103
UGA,Uganda,KOR,Korea,2016,215,98,117
UGA,Uganda,KOR,Korea,2017,138,109,29
UGA,Uganda,LUX,Luxembourg,2008,2,1,1
UGA,Uganda,LUX,Luxembourg,2009,0,0,0
UGA,Uganda,LUX,Luxembourg,2010,1,1,0
UGA,Uganda,LUX,Luxembourg,2011,2,1,1
UGA,Uganda,LUX,Luxembourg,2012,0,0,0
UGA,Uganda,LUX,Luxembourg,2013,1,0,1
UGA,Uganda,LUX,Luxembourg,2014,5,0,5
UGA,Uganda,LUX,Luxembourg,2015,3,2,1
UGA,Uganda,LUX,Luxembourg,2016,3,2,1
UGA,Uganda,LUX,Luxembourg,2017,2,0,2
UGA,Uganda,MEX,Mexico,2008,1,0,1
UGA,Uganda,MEX,Mexico,2010,2,0,2
UGA,Uganda,MEX,Mexico,2011,1,0,1
UGA,Uganda,MEX,Mexico,2012,0,0,0
UGA,Uganda,MEX,Mexico,2013,2,0,2
UGA,Uganda,MEX,Mexico,2014,3,0,3
UGA,Uganda,MEX,Mexico,2015,2,0,2
UGA,Uganda,MEX,Mexico,2016,2,0,2
UGA,Uganda,NLD,Netherlands,2008,124,71,53
UGA,Uganda,NLD,Netherlands,2009,110,62,48
UGA,Uganda,NLD,Netherlands,2010,98,115,-17
UGA,Uganda,NLD,Netherlands,2011,73,84,-11
UGA,Uganda,NLD,Netherlands,2012,93,48,45
UGA,Uganda,NLD,Netherlands,2013,154,107,47
UGA,Uganda,NLD,Netherlands,2014,203,49,154
UGA,Uganda,NLD,Netherlands,2015,205,73,132
UGA,Uganda,NLD,Netherlands,2016,185,75,110
UGA,Uganda,NLD,Netherlands,2017,169,57,112
UGA,Uganda,NZL,New Zealand,2008,9,0,9
UGA,Uganda,NZL,New Zealand,2009,4,3,1
UGA,Uganda,NZL,New Zealand,2010,3,1,2
UGA,Uganda,NZL,New Zealand,2011,2,1,1
UGA,Uganda,NZL,New Zealand,2012,9,1,8
UGA,Uganda,NZL,New Zealand,2013,3,0,3
UGA,Uganda,NZL,New Zealand,2014,3,2,1
UGA,Uganda,NZL,New Zealand,2015,3,2,1
UGA,Uganda,NZL,New Zealand,2016,1,3,-2
UGA,Uganda,NZL,New Zealand,2017,7,2,5
UGA,Uganda,NOR,Norway,2008,85,44,41
UGA,Uganda,NOR,Norway,2009,76,74,2
UGA,Uganda,NOR,Norway,2010,82,60,22
UGA,Uganda,NOR,Norway,2011,71,62,9
UGA,Uganda,NOR,Norway,2012,118,55,63
UGA,Uganda,NOR,Norway,2013,108,52,56
UGA,Uganda,NOR,Norway,2014,107,49,58
UGA,Uganda,NOR,Norway,2015,106,47,59
UGA,Uganda,NOR,Norway,2016,57,59,-2
UGA,Uganda,NOR,Norway,2017,49,33,16
UGA,Uganda,POL,Poland,2009,7,0,7
UGA,Uganda,POL,Poland,2010,9,0,9
UGA,Uganda,POL,Poland,2011,8,0,8
UGA,Uganda,POL,Poland,2012,11,0,11
UGA,Uganda,POL,Poland,2013,22,0,22
UGA,Uganda,POL,Poland,2014,3,0,3
UGA,Uganda,POL,Poland,2015,12,0,12
UGA,Uganda,POL,Poland,2016,9,0,9
UGA,Uganda,POL,Poland,2017,9,0,9
UGA,Uganda,SVK,Slovak Republic,2008,0,0,0
UGA,Uganda,SVK,Slovak Republic,2009,1,0,1
UGA,Uganda,SVK,Slovak Republic,2016,2,0,2
UGA,Uganda,ESP,Spain,2008,25,4,21
UGA,Uganda,ESP,Spain,2009,17,9,8
UGA,Uganda,ESP,Spain,2010,15,19,-4
UGA,Uganda,ESP,Spain,2011,21,14,7
UGA,Uganda,ESP,Spain,2012,17,4,13
UGA,Uganda,ESP,Spain,2013,16,13,3
UGA,Uganda,ESP,Spain,2014,13,7,6
UGA,Uganda,ESP,Spain,2015,22,4,18
UGA,Uganda,ESP,Spain,2016,16,10,6
UGA,Uganda,ESP,Spain,2017,24,13,11
UGA,Uganda,SWE,Sweden,2008,147,10,137
UGA,Uganda,SWE,Sweden,2009,132,14,118
UGA,Uganda,SWE,Sweden,2010,191,21,170
UGA,Uganda,SWE,Sweden,2011,179,26,153
UGA,Uganda,SWE,Sweden,2012,224,26,198
UGA,Uganda,SWE,Sweden,2013,320,28,292
UGA,Uganda,SWE,Sweden,2014,333,30,303
UGA,Uganda,SWE,Sweden,2015,239,34,205
UGA,Uganda,SWE,Sweden,2016,201,20,181
UGA,Uganda,SWE,Sweden,2017,177,43,134
UGA,Uganda,CHE,Switzerland,2010,32,13,19
UGA,Uganda,CHE,Switzerland,2011,38,15,23
UGA,Uganda,CHE,Switzerland,2012,17,9,8
UGA,Uganda,CHE,Switzerland,2013,26,15,11
UGA,Uganda,CHE,Switzerland,2014,26,7,19
UGA,Uganda,CHE,Switzerland,2015,26,12,14
UGA,Uganda,CHE,Switzerland,2016,23,8,15
UGA,Uganda,CHE,Switzerland,2017,27,6,21
UGA,Uganda,TUR,Turkey,2010,8,0,8
UGA,Uganda,TUR,Turkey,2016,167,69,98
UGA,Uganda,TUR,Turkey,2017,361,86,275
UGA,Uganda,GBR,United Kingdom,2011,1000,0,1000
UGA,Uganda,GBR,United Kingdom,2015,1000,1000,0
UGA,Uganda,USA,United States,2008,1174,0,1174
UGA,Uganda,USA,United States,2009,1364,0,1364
UGA,Uganda,USA,United States,2010,1085,0,1085
UGA,Uganda,USA,United States,2011,1239,0,1239
UGA,Uganda,USA,United States,2012,1340,0,1340
UGA,Uganda,USA,United States,2013,1350,0,1350
UGA,Uganda,USA,United States,2014,1409,0,1409
UGA,Uganda,USA,United States,2015,1664,0,1664
UGA,Uganda,USA,United States,2016,1649,0,1649
UGA,Uganda,USA,United States,2017,1898,0,1898
UGA,Uganda,CHL,Chile,2008,0,0,0
UGA,Uganda,CHL,Chile,2009,0,0,0
UGA,Uganda,CHL,Chile,2010,0,0,0
UGA,Uganda,CHL,Chile,2011,1,0,1
UGA,Uganda,CHL,Chile,2012,0,0,0
UGA,Uganda,CHL,Chile,2013,0,0,0
UGA,Uganda,CHL,Chile,2014,0,0,0
UGA,Uganda,CHL,Chile,2015,1,0,1
UGA,Uganda,CHL,Chile,2016,0,0,0
UGA,Uganda,EST,Estonia,2008,0,0,0
UGA,Uganda,EST,Estonia,2009,0,0,0
UGA,Uganda,EST,Estonia,2010,4,0,4
UGA,Uganda,EST,Estonia,2011,0,0,0
UGA,Uganda,EST,Estonia,2012,0,0,0
UGA,Uganda,EST,Estonia,2013,1,0,1
UGA,Uganda,EST,Estonia,2014,0,0,0
UGA,Uganda,EST,Estonia,2015,1,0,1
UGA,Uganda,EST,Estonia,2016,2,0,2
UGA,Uganda,EST,Estonia,2017,3,0,3
UGA,Uganda,SVN,Slovenia,2010,1,0,1
UGA,Uganda,SVN,Slovenia,2015,1,0,1
UKR,Ukraine,AUS,Australia,2008,291,74,217
UKR,Ukraine,AUS,Australia,2009,341,65,276
UKR,Ukraine,AUS,Australia,2010,327,50,277
UKR,Ukraine,AUS,Australia,2011,374,77,297
UKR,Ukraine,AUS,Australia,2012,363,70,293
UKR,Ukraine,AUS,Australia,2013,417,66,351
UKR,Ukraine,AUS,Australia,2014,353,67,286
UKR,Ukraine,AUS,Australia,2015,392,100,292
UKR,Ukraine,AUS,Australia,2016,412,100,312
UKR,Ukraine,AUS,Australia,2017,428,0,428
UKR,Ukraine,AUT,Austria,2008,874,586,288
UKR,Ukraine,AUT,Austria,2009,853,548,305
UKR,Ukraine,AUT,Austria,2010,910,555,355
UKR,Ukraine,AUT,Austria,2011,963,507,456
UKR,Ukraine,AUT,Austria,2012,1125,513,612
UKR,Ukraine,AUT,Austria,2013,1288,538,750
UKR,Ukraine,AUT,Austria,2014,1833,631,1202
UKR,Ukraine,AUT,Austria,2015,1992,690,1302
UKR,Ukraine,AUT,Austria,2016,1621,938,683
UKR,Ukraine,AUT,Austria,2017,1627,982,645
UKR,Ukraine,BEL,Belgium,2008,387,100,287
UKR,Ukraine,BEL,Belgium,2009,421,105,316
UKR,Ukraine,BEL,Belgium,2010,583,151,432
UKR,Ukraine,BEL,Belgium,2011,611,152,459
UKR,Ukraine,BEL,Belgium,2012,610,236,374
UKR,Ukraine,BEL,Belgium,2013,511,281,230
UKR,Ukraine,BEL,Belgium,2014,880,249,631
UKR,Ukraine,BEL,Belgium,2015,800,276,524
UKR,Ukraine,BEL,Belgium,2016,546,205,341
UKR,Ukraine,BEL,Belgium,2017,689,164,525
UKR,Ukraine,CAN,Canada,2008,1935,0,1935
UKR,Ukraine,CAN,Canada,2009,2363,0,2363
UKR,Ukraine,CAN,Canada,2010,3157,0,3157
UKR,Ukraine,CAN,Canada,2011,2516,0,2516
UKR,Ukraine,CAN,Canada,2012,2263,0,2263
UKR,Ukraine,CAN,Canada,2013,2484,0,2484
UKR,Ukraine,CAN,Canada,2014,2539,0,2539
UKR,Ukraine,CAN,Canada,2015,2376,0,2376
UKR,Ukraine,CAN,Canada,2016,3365,0,3365
UKR,Ukraine,CAN,Canada,2017,3305,0,3305
UKR,Ukraine,CZE,Czech Republic,2008,18731,156,18575
UKR,Ukraine,CZE,Czech Republic,2009,8084,33,8051
UKR,Ukraine,CZE,Czech Republic,2010,3476,44,3432
UKR,Ukraine,CZE,Czech Republic,2011,1980,91,1889
UKR,Ukraine,CZE,Czech Republic,2012,5919,7733,-1814
UKR,Ukraine,CZE,Czech Republic,2013,3744,10965,-7221
UKR,Ukraine,CZE,Czech Republic,2014,8445,4488,3957
UKR,Ukraine,CZE,Czech Republic,2015,5454,3208,2246
UKR,Ukraine,CZE,Czech Republic,2016,5778,2443,3335
UKR,Ukraine,CZE,Czech Republic,2017,10340,2650,7690
UKR,Ukraine,DNK,Denmark,2008,1778,1028,750
UKR,Ukraine,DNK,Denmark,2009,1421,1387,34
UKR,Ukraine,DNK,Denmark,2010,1242,1359,-117
UKR,Ukraine,DNK,Denmark,2011,1179,990,189
UKR,Ukraine,DNK,Denmark,2012,1152,919,233
UKR,Ukraine,DNK,Denmark,2013,1280,744,536
UKR,Ukraine,DNK,Denmark,2014,1474,615,859
UKR,Ukraine,DNK,Denmark,2015,1086,630,456
UKR,Ukraine,DNK,Denmark,2016,1250,834,416
UKR,Ukraine,DNK,Denmark,2017,1580,753,827
UKR,Ukraine,FIN,Finland,2008,249,24,225
UKR,Ukraine,FIN,Finland,2009,236,21,215
UKR,Ukraine,FIN,Finland,2010,203,20,183
UKR,Ukraine,FIN,Finland,2011,271,16,255
UKR,Ukraine,FIN,Finland,2012,333,26,307
UKR,Ukraine,FIN,Finland,2013,368,33,335
UKR,Ukraine,FIN,Finland,2014,445,44,401
UKR,Ukraine,FIN,Finland,2015,502,33,469
UKR,Ukraine,FIN,Finland,2016,517,54,463
UKR,Ukraine,FIN,Finland,2017,545,55,490
UKR,Ukraine,FRA,France,2008,822,0,822
UKR,Ukraine,FRA,France,2009,803,0,803
UKR,Ukraine,FRA,France,2010,737,0,737
UKR,Ukraine,FRA,France,2011,797,0,797
UKR,Ukraine,FRA,France,2012,918,0,918
UKR,Ukraine,FRA,France,2013,1078,0,1078
UKR,Ukraine,FRA,France,2014,1241,0,1241
UKR,Ukraine,FRA,France,2015,1348,0,1348
UKR,Ukraine,FRA,France,2016,1556,0,1556
UKR,Ukraine,FRA,France,2017,1477,0,1477
UKR,Ukraine,DEU,Germany,2008,6869,6337,532
UKR,Ukraine,DEU,Germany,2009,6947,5679,1268
UKR,Ukraine,DEU,Germany,2010,6870,4847,2023
UKR,Ukraine,DEU,Germany,2011,7585,4094,3491
UKR,Ukraine,DEU,Germany,2012,8198,4074,4124
UKR,Ukraine,DEU,Germany,2013,8342,4336,4006
UKR,Ukraine,DEU,Germany,2014,13477,4594,8883
UKR,Ukraine,DEU,Germany,2015,15778,5376,10402
UKR,Ukraine,DEU,Germany,2016,13303,6834,6469
UKR,Ukraine,DEU,Germany,2017,13107,7466,5641
UKR,Ukraine,GRC,Greece,2008,695,0,695
UKR,Ukraine,GRC,Greece,2009,830,0,830
UKR,Ukraine,GRC,Greece,2010,947,0,947
UKR,Ukraine,GRC,Greece,2011,863,0,863
UKR,Ukraine,HUN,Hungary,2008,4071,346,3725
UKR,Ukraine,HUN,Hungary,2009,1887,564,1323
UKR,Ukraine,HUN,Hungary,2010,1619,432,1187
UKR,Ukraine,HUN,Hungary,2011,1280,455,825
UKR,Ukraine,HUN,Hungary,2012,859,474,385
UKR,Ukraine,HUN,Hungary,2013,558,327,231
UKR,Ukraine,HUN,Hungary,2014,717,477,240
UKR,Ukraine,HUN,Hungary,2015,1143,469,674
UKR,Ukraine,HUN,Hungary,2016,1202,439,763
UKR,Ukraine,HUN,Hungary,2017,6325,1312,5013
UKR,Ukraine,ISL,Iceland,2008,37,21,16
UKR,Ukraine,ISL,Iceland,2009,16,21,-5
UKR,Ukraine,ISL,Iceland,2010,16,9,7
UKR,Ukraine,ISL,Iceland,2011,24,12,12
UKR,Ukraine,ISL,Iceland,2012,35,6,29
UKR,Ukraine,ISL,Iceland,2013,24,12,12
UKR,Ukraine,ISL,Iceland,2014,20,8,12
UKR,Ukraine,ISL,Iceland,2015,33,5,28
UKR,Ukraine,ISL,Iceland,2016,39,8,31
UKR,Ukraine,ISL,Iceland,2017,35,11,24
UKR,Ukraine,ITA,Italy,2008,24039,875,23164
UKR,Ukraine,ITA,Italy,2009,22594,1044,21550
UKR,Ukraine,ITA,Italy,2010,30416,1211,29205
UKR,Ukraine,ITA,Italy,2011,17889,1212,16677
UKR,Ukraine,ITA,Italy,2012,11510,1440,10070
UKR,Ukraine,ITA,Italy,2013,12814,1698,11116
UKR,Ukraine,ITA,Italy,2014,9665,1763,7902
UKR,Ukraine,ITA,Italy,2015,9337,1656,7681
UKR,Ukraine,ITA,Italy,2016,8740,0,8740
UKR,Ukraine,ITA,Italy,2017,7864,1556,6308
UKR,Ukraine,JPN,Japan,2008,841,810,31
UKR,Ukraine,JPN,Japan,2009,917,878,39
UKR,Ukraine,JPN,Japan,2010,722,745,-23
UKR,Ukraine,JPN,Japan,2011,580,565,15
UKR,Ukraine,JPN,Japan,2012,986,783,203
UKR,Ukraine,JPN,Japan,2013,802,727,75
UKR,Ukraine,JPN,Japan,2014,945,973,-28
UKR,Ukraine,JPN,Japan,2015,822,720,102
UKR,Ukraine,JPN,Japan,2016,1103,819,284
UKR,Ukraine,JPN,Japan,2017,1139,887,252
UKR,Ukraine,KOR,Korea,2008,444,408,36
UKR,Ukraine,KOR,Korea,2009,291,388,-97
UKR,Ukraine,KOR,Korea,2010,389,312,77
UKR,Ukraine,KOR,Korea,2011,335,390,-55
UKR,Ukraine,KOR,Korea,2012,580,484,96
UKR,Ukraine,KOR,Korea,2013,522,442,80
UKR,Ukraine,KOR,Korea,2014,674,447,227
UKR,Ukraine,KOR,Korea,2015,968,498,470
UKR,Ukraine,KOR,Korea,2016,1240,653,587
UKR,Ukraine,KOR,Korea,2017,1298,819,479
UKR,Ukraine,LUX,Luxembourg,2008,45,13,32
UKR,Ukraine,LUX,Luxembourg,2009,46,16,30
UKR,Ukraine,LUX,Luxembourg,2010,42,10,32
UKR,Ukraine,LUX,Luxembourg,2011,62,9,53
UKR,Ukraine,LUX,Luxembourg,2012,49,14,35
UKR,Ukraine,LUX,Luxembourg,2013,57,10,47
UKR,Ukraine,LUX,Luxembourg,2014,120,20,100
UKR,Ukraine,LUX,Luxembourg,2015,143,25,118
UKR,Ukraine,LUX,Luxembourg,2016,142,49,93
UKR,Ukraine,LUX,Luxembourg,2017,180,52,128
UKR,Ukraine,MEX,Mexico,2008,38,0,38
UKR,Ukraine,MEX,Mexico,2009,55,0,55
UKR,Ukraine,MEX,Mexico,2010,40,0,40
UKR,Ukraine,MEX,Mexico,2011,35,0,35
UKR,Ukraine,MEX,Mexico,2012,34,0,34
UKR,Ukraine,MEX,Mexico,2013,121,0,121
UKR,Ukraine,MEX,Mexico,2014,101,0,101
UKR,Ukraine,MEX,Mexico,2015,102,0,102
UKR,Ukraine,MEX,Mexico,2016,92,0,92
UKR,Ukraine,MEX,Mexico,2017,80,0,80
UKR,Ukraine,NLD,Netherlands,2008,451,161,290
UKR,Ukraine,NLD,Netherlands,2009,450,175,275
UKR,Ukraine,NLD,Netherlands,2010,456,158,298
UKR,Ukraine,NLD,Netherlands,2011,585,168,417
UKR,Ukraine,NLD,Netherlands,2012,620,231,389
UKR,Ukraine,NLD,Netherlands,2013,712,224,488
UKR,Ukraine,NLD,Netherlands,2014,870,211,659
UKR,Ukraine,NLD,Netherlands,2015,1119,257,862
UKR,Ukraine,NLD,Netherlands,2016,1086,309,777
UKR,Ukraine,NLD,Netherlands,2017,1163,456,707
UKR,Ukraine,NZL,New Zealand,2008,35,15,20
UKR,Ukraine,NZL,New Zealand,2009,38,7,31
UKR,Ukraine,NZL,New Zealand,2010,43,14,29
UKR,Ukraine,NZL,New Zealand,2011,52,7,45
UKR,Ukraine,NZL,New Zealand,2012,85,15,70
UKR,Ukraine,NZL,New Zealand,2013,90,11,79
UKR,Ukraine,NZL,New Zealand,2014,120,14,106
UKR,Ukraine,NZL,New Zealand,2015,114,13,101
UKR,Ukraine,NZL,New Zealand,2016,110,20,90
UKR,Ukraine,NZL,New Zealand,2017,71,22,49
UKR,Ukraine,NOR,Norway,2008,343,85,258
UKR,Ukraine,NOR,Norway,2009,360,82,278
UKR,Ukraine,NOR,Norway,2010,360,99,261
UKR,Ukraine,NOR,Norway,2011,492,145,347
UKR,Ukraine,NOR,Norway,2012,488,121,367
UKR,Ukraine,NOR,Norway,2013,462,164,298
UKR,Ukraine,NOR,Norway,2014,446,120,326
UKR,Ukraine,NOR,Norway,2015,525,139,386
UKR,Ukraine,NOR,Norway,2016,488,156,332
UKR,Ukraine,NOR,Norway,2017,473,139,334
UKR,Ukraine,POL,Poland,2008,10311,0,10311
UKR,Ukraine,POL,Poland,2009,10125,0,10125
UKR,Ukraine,POL,Poland,2010,10250,0,10250
UKR,Ukraine,POL,Poland,2011,10133,0,10133
UKR,Ukraine,POL,Poland,2012,11829,0,11829
UKR,Ukraine,POL,Poland,2013,11897,0,11897
UKR,Ukraine,POL,Poland,2014,7790,0,7790
UKR,Ukraine,POL,Poland,2015,45237,0,45237
UKR,Ukraine,POL,Poland,2016,63843,0,63843
UKR,Ukraine,POL,Poland,2017,78968,0,78968
UKR,Ukraine,PRT,Portugal,2008,3624,0,3624
UKR,Ukraine,PRT,Portugal,2009,2362,0,2362
UKR,Ukraine,PRT,Portugal,2010,2057,0,2057
UKR,Ukraine,PRT,Portugal,2011,1761,0,1761
UKR,Ukraine,PRT,Portugal,2012,1460,0,1460
UKR,Ukraine,PRT,Portugal,2013,1075,0,1075
UKR,Ukraine,PRT,Portugal,2014,953,0,953
UKR,Ukraine,PRT,Portugal,2015,1098,0,1098
UKR,Ukraine,PRT,Portugal,2016,1240,0,1240
UKR,Ukraine,PRT,Portugal,2017,1247,0,1247
UKR,Ukraine,SVK,Slovak Republic,2008,98,6,92
UKR,Ukraine,SVK,Slovak Republic,2009,99,1,98
UKR,Ukraine,SVK,Slovak Republic,2010,107,1,106
UKR,Ukraine,SVK,Slovak Republic,2011,105,1,104
UKR,Ukraine,SVK,Slovak Republic,2012,92,1,91
UKR,Ukraine,SVK,Slovak Republic,2013,77,3,74
UKR,Ukraine,SVK,Slovak Republic,2014,94,2,92
UKR,Ukraine,SVK,Slovak Republic,2015,192,0,192
UKR,Ukraine,SVK,Slovak Republic,2016,154,0,154
UKR,Ukraine,SVK,Slovak Republic,2017,202,0,202
UKR,Ukraine,ESP,Spain,2008,6863,4257,2606
UKR,Ukraine,ESP,Spain,2009,4751,4548,203
UKR,Ukraine,ESP,Spain,2010,4925,4256,669
UKR,Ukraine,ESP,Spain,2011,5093,4165,928
UKR,Ukraine,ESP,Spain,2012,3678,4511,-833
UKR,Ukraine,ESP,Spain,2013,3348,5449,-2101
UKR,Ukraine,ESP,Spain,2014,5680,2890,2790
UKR,Ukraine,ESP,Spain,2015,8849,2156,6693
UKR,Ukraine,ESP,Spain,2016,6876,2588,4288
UKR,Ukraine,ESP,Spain,2017,7768,3540,4228
UKR,Ukraine,SWE,Sweden,2008,376,34,342
UKR,Ukraine,SWE,Sweden,2009,466,30,436
UKR,Ukraine,SWE,Sweden,2010,550,60,490
UKR,Ukraine,SWE,Sweden,2011,601,85,516
UKR,Ukraine,SWE,Sweden,2012,622,77,545
UKR,Ukraine,SWE,Sweden,2013,549,79,470
UKR,Ukraine,SWE,Sweden,2014,605,121,484
UKR,Ukraine,SWE,Sweden,2015,653,185,468
UKR,Ukraine,SWE,Sweden,2016,712,88,624
UKR,Ukraine,SWE,Sweden,2017,965,107,858
UKR,Ukraine,CHE,Switzerland,2010,738,252,486
UKR,Ukraine,CHE,Switzerland,2011,811,224,587
UKR,Ukraine,CHE,Switzerland,2012,771,278,493
UKR,Ukraine,CHE,Switzerland,2013,860,277,583
UKR,Ukraine,CHE,Switzerland,2014,840,269,571
UKR,Ukraine,CHE,Switzerland,2015,866,289,577
UKR,Ukraine,CHE,Switzerland,2016,743,288,455
UKR,Ukraine,CHE,Switzerland,2017,667,339,328
UKR,Ukraine,TUR,Turkey,2010,949,0,949
UKR,Ukraine,TUR,Turkey,2016,6531,3364,3167
UKR,Ukraine,TUR,Turkey,2017,6303,3987,2316
UKR,Ukraine,GBR,United Kingdom,2011,1000,0,1000
UKR,Ukraine,GBR,United Kingdom,2013,1000,0,1000
UKR,Ukraine,USA,United States,2008,10813,0,10813
UKR,Ukraine,USA,United States,2009,11223,0,11223
UKR,Ukraine,USA,United States,2010,8477,0,8477
UKR,Ukraine,USA,United States,2011,8292,0,8292
UKR,Ukraine,USA,United States,2012,7642,0,7642
UKR,Ukraine,USA,United States,2013,8193,0,8193
UKR,Ukraine,USA,United States,2014,7752,0,7752
UKR,Ukraine,USA,United States,2015,7987,0,7987
UKR,Ukraine,USA,United States,2016,10422,0,10422
UKR,Ukraine,USA,United States,2017,10135,0,10135
UKR,Ukraine,CHL,Chile,2008,18,0,18
UKR,Ukraine,CHL,Chile,2009,16,0,16
UKR,Ukraine,CHL,Chile,2010,24,0,24
UKR,Ukraine,CHL,Chile,2011,29,0,29
UKR,Ukraine,CHL,Chile,2012,32,0,32
UKR,Ukraine,CHL,Chile,2013,26,0,26
UKR,Ukraine,CHL,Chile,2014,36,0,36
UKR,Ukraine,CHL,Chile,2015,44,0,44
UKR,Ukraine,CHL,Chile,2016,55,0,55
UKR,Ukraine,EST,Estonia,2008,183,0,183
UKR,Ukraine,EST,Estonia,2009,221,0,221
UKR,Ukraine,EST,Estonia,2010,88,0,88
UKR,Ukraine,EST,Estonia,2011,264,0,264
UKR,Ukraine,EST,Estonia,2012,188,0,188
UKR,Ukraine,EST,Estonia,2013,324,0,324
UKR,Ukraine,EST,Estonia,2014,395,0,395
UKR,Ukraine,EST,Estonia,2015,1200,0,1200
UKR,Ukraine,EST,Estonia,2016,1091,243,848
UKR,Ukraine,EST,Estonia,2017,1037,293,744
UKR,Ukraine,SVN,Slovenia,2008,516,152,364
UKR,Ukraine,SVN,Slovenia,2009,31,218,-187
UKR,Ukraine,SVN,Slovenia,2010,334,163,171
UKR,Ukraine,SVN,Slovenia,2011,392,66,326
UKR,Ukraine,SVN,Slovenia,2012,197,44,153
UKR,Ukraine,SVN,Slovenia,2013,185,18,167
UKR,Ukraine,SVN,Slovenia,2014,272,15,257
UKR,Ukraine,SVN,Slovenia,2015,394,26,368
UKR,Ukraine,SVN,Slovenia,2016,281,49,232
UKR,Ukraine,SVN,Slovenia,2017,324,58,266
ARE,United Arab Emirates,AUS,Australia,2008,4,80,-76
ARE,United Arab Emirates,AUS,Australia,2009,5,58,-53
ARE,United Arab Emirates,AUS,Australia,2010,7,60,-53
ARE,United Arab Emirates,AUS,Australia,2011,2,72,-70
ARE,United Arab Emirates,AUS,Australia,2012,12,55,-43
ARE,United Arab Emirates,AUS,Australia,2013,3,90,-87
ARE,United Arab Emirates,AUS,Australia,2014,11,122,-111
ARE,United Arab Emirates,AUS,Australia,2015,20,100,-80
ARE,United Arab Emirates,AUS,Australia,2016,14,100,-86
ARE,United Arab Emirates,AUS,Australia,2017,25,0,25
ARE,United Arab Emirates,AUT,Austria,2008,3,1,2
ARE,United Arab Emirates,AUT,Austria,2009,7,4,3
ARE,United Arab Emirates,AUT,Austria,2010,30,5,25
ARE,United Arab Emirates,AUT,Austria,2011,5,2,3
ARE,United Arab Emirates,AUT,Austria,2012,5,21,-16
ARE,United Arab Emirates,AUT,Austria,2013,5,4,1
ARE,United Arab Emirates,AUT,Austria,2014,6,4,2
ARE,United Arab Emirates,AUT,Austria,2015,16,5,11
ARE,United Arab Emirates,AUT,Austria,2016,7,9,-2
ARE,United Arab Emirates,AUT,Austria,2017,5,7,-2
ARE,United Arab Emirates,BEL,Belgium,2010,2,0,2
ARE,United Arab Emirates,BEL,Belgium,2012,3,2,1
ARE,United Arab Emirates,BEL,Belgium,2013,5,0,5
ARE,United Arab Emirates,BEL,Belgium,2014,2,1,1
ARE,United Arab Emirates,BEL,Belgium,2015,2,7,-5
ARE,United Arab Emirates,BEL,Belgium,2016,1,3,-2
ARE,United Arab Emirates,BEL,Belgium,2017,12,0,12
ARE,United Arab Emirates,CAN,Canada,2008,33,0,33
ARE,United Arab Emirates,CAN,Canada,2009,37,0,37
ARE,United Arab Emirates,CAN,Canada,2010,86,0,86
ARE,United Arab Emirates,CAN,Canada,2011,60,0,60
ARE,United Arab Emirates,CAN,Canada,2012,54,0,54
ARE,United Arab Emirates,CAN,Canada,2013,46,0,46
ARE,United Arab Emirates,CAN,Canada,2014,40,0,40
ARE,United Arab Emirates,CAN,Canada,2015,33,0,33
ARE,United Arab Emirates,CAN,Canada,2016,25,0,25
ARE,United Arab Emirates,CAN,Canada,2017,10,0,10
ARE,United Arab Emirates,CZE,Czech Republic,2012,1,0,1
ARE,United Arab Emirates,DNK,Denmark,2008,0,0,0
ARE,United Arab Emirates,DNK,Denmark,2009,1,1,0
ARE,United Arab Emirates,DNK,Denmark,2010,3,1,2
ARE,United Arab Emirates,DNK,Denmark,2012,1,0,1
ARE,United Arab Emirates,DNK,Denmark,2013,0,0,0
ARE,United Arab Emirates,DNK,Denmark,2014,1,0,1
ARE,United Arab Emirates,DNK,Denmark,2015,1,2,-1
ARE,United Arab Emirates,DNK,Denmark,2016,0,0,0
ARE,United Arab Emirates,DNK,Denmark,2017,2,1,1
ARE,United Arab Emirates,FIN,Finland,2008,0,0,0
ARE,United Arab Emirates,FIN,Finland,2009,0,0,0
ARE,United Arab Emirates,FIN,Finland,2010,0,0,0
ARE,United Arab Emirates,FIN,Finland,2011,1,0,1
ARE,United Arab Emirates,FIN,Finland,2012,0,0,0
ARE,United Arab Emirates,FIN,Finland,2013,1,0,1
ARE,United Arab Emirates,FIN,Finland,2014,0,0,0
ARE,United Arab Emirates,FIN,Finland,2015,0,0,0
ARE,United Arab Emirates,FIN,Finland,2016,2,0,2
ARE,United Arab Emirates,FIN,Finland,2017,0,0,0
ARE,United Arab Emirates,FRA,France,2008,6,0,6
ARE,United Arab Emirates,FRA,France,2009,7,0,7
ARE,United Arab Emirates,FRA,France,2010,7,0,7
ARE,United Arab Emirates,FRA,France,2011,9,0,9
ARE,United Arab Emirates,FRA,France,2012,3,0,3
ARE,United Arab Emirates,FRA,France,2013,6,0,6
ARE,United Arab Emirates,FRA,France,2014,8,0,8
ARE,United Arab Emirates,FRA,France,2015,4,0,4
ARE,United Arab Emirates,FRA,France,2016,2,0,2
ARE,United Arab Emirates,FRA,France,2017,1,0,1
ARE,United Arab Emirates,DEU,Germany,2008,476,663,-187
ARE,United Arab Emirates,DEU,Germany,2009,758,500,258
ARE,United Arab Emirates,DEU,Germany,2010,688,617,71
ARE,United Arab Emirates,DEU,Germany,2011,563,512,51
ARE,United Arab Emirates,DEU,Germany,2012,831,586,245
ARE,United Arab Emirates,DEU,Germany,2013,1315,1070,245
ARE,United Arab Emirates,DEU,Germany,2014,1707,1176,531
ARE,United Arab Emirates,DEU,Germany,2015,2086,1183,903
ARE,United Arab Emirates,DEU,Germany,2016,1953,1452,501
ARE,United Arab Emirates,DEU,Germany,2017,1647,2012,-365
ARE,United Arab Emirates,HUN,Hungary,2008,0,1,-1
ARE,United Arab Emirates,HUN,Hungary,2009,0,0,0
ARE,United Arab Emirates,HUN,Hungary,2010,1,0,1
ARE,United Arab Emirates,HUN,Hungary,2011,0,1,-1
ARE,United Arab Emirates,HUN,Hungary,2012,1,0,1
ARE,United Arab Emirates,HUN,Hungary,2013,2,0,2
ARE,United Arab Emirates,HUN,Hungary,2014,1,1,0
ARE,United Arab Emirates,HUN,Hungary,2015,1,0,1
ARE,United Arab Emirates,HUN,Hungary,2016,2,1,1
ARE,United Arab Emirates,HUN,Hungary,2017,3,0,3
ARE,United Arab Emirates,ISL,Iceland,2008,0,1,-1
ARE,United Arab Emirates,ISL,Iceland,2009,0,0,0
ARE,United Arab Emirates,ISL,Iceland,2010,0,0,0
ARE,United Arab Emirates,ISL,Iceland,2011,0,1,-1
ARE,United Arab Emirates,ISL,Iceland,2012,0,0,0
ARE,United Arab Emirates,ISL,Iceland,2016,0,0,0
ARE,United Arab Emirates,ISL,Iceland,2017,0,0,0
ARE,United Arab Emirates,ITA,Italy,2008,7,0,7
ARE,United Arab Emirates,ITA,Italy,2009,3,0,3
ARE,United Arab Emirates,ITA,Italy,2010,8,0,8
ARE,United Arab Emirates,ITA,Italy,2011,1,0,1
ARE,United Arab Emirates,ITA,Italy,2012,6,0,6
ARE,United Arab Emirates,ITA,Italy,2013,6,0,6
ARE,United Arab Emirates,ITA,Italy,2014,6,1,5
ARE,United Arab Emirates,ITA,Italy,2015,3,3,0
ARE,United Arab Emirates,ITA,Italy,2016,2,0,2
ARE,United Arab Emirates,ITA,Italy,2017,6,2,4
ARE,United Arab Emirates,JPN,Japan,2008,55,44,11
ARE,United Arab Emirates,JPN,Japan,2009,72,46,26
ARE,United Arab Emirates,JPN,Japan,2010,28,25,3
ARE,United Arab Emirates,JPN,Japan,2011,47,41,6
ARE,United Arab Emirates,JPN,Japan,2012,51,50,1
ARE,United Arab Emirates,JPN,Japan,2013,107,97,10
ARE,United Arab Emirates,JPN,Japan,2014,117,102,15
ARE,United Arab Emirates,JPN,Japan,2015,107,90,17
ARE,United Arab Emirates,JPN,Japan,2016,92,96,-4
ARE,United Arab Emirates,JPN,Japan,2017,102,89,13
ARE,United Arab Emirates,KOR,Korea,2008,18,11,7
ARE,United Arab Emirates,KOR,Korea,2009,12,5,7
ARE,United Arab Emirates,KOR,Korea,2010,8,20,-12
ARE,United Arab Emirates,KOR,Korea,2011,14,28,-14
ARE,United Arab Emirates,KOR,Korea,2012,59,24,35
ARE,United Arab Emirates,KOR,Korea,2013,251,137,114
ARE,United Arab Emirates,KOR,Korea,2014,507,428,79
ARE,United Arab Emirates,KOR,Korea,2015,560,588,-28
ARE,United Arab Emirates,KOR,Korea,2016,445,559,-114
ARE,United Arab Emirates,KOR,Korea,2017,542,463,79
ARE,United Arab Emirates,LUX,Luxembourg,2008,0,0,0
ARE,United Arab Emirates,LUX,Luxembourg,2009,0,0,0
ARE,United Arab Emirates,LUX,Luxembourg,2010,0,0,0
ARE,United Arab Emirates,LUX,Luxembourg,2011,0,0,0
ARE,United Arab Emirates,LUX,Luxembourg,2012,0,0,0
ARE,United Arab Emirates,LUX,Luxembourg,2013,0,0,0
ARE,United Arab Emirates,LUX,Luxembourg,2014,0,0,0
ARE,United Arab Emirates,LUX,Luxembourg,2015,0,0,0
ARE,United Arab Emirates,LUX,Luxembourg,2016,1,0,1
ARE,United Arab Emirates,LUX,Luxembourg,2017,0,0,0
ARE,United Arab Emirates,MEX,Mexico,2008,6,0,6
ARE,United Arab Emirates,MEX,Mexico,2009,9,0,9
ARE,United Arab Emirates,MEX,Mexico,2012,0,0,0
ARE,United Arab Emirates,MEX,Mexico,2013,0,0,0
ARE,United Arab Emirates,MEX,Mexico,2014,0,0,0
ARE,United Arab Emirates,NLD,Netherlands,2008,6,6,0
ARE,United Arab Emirates,NLD,Netherlands,2009,6,6,0
ARE,United Arab Emirates,NLD,Netherlands,2010,1,3,-2
ARE,United Arab Emirates,NLD,Netherlands,2011,1,0,1
ARE,United Arab Emirates,NLD,Netherlands,2012,7,5,2
ARE,United Arab Emirates,NLD,Netherlands,2013,9,4,5
ARE,United Arab Emirates,NLD,Netherlands,2014,6,2,4
ARE,United Arab Emirates,NLD,Netherlands,2015,5,14,-9
ARE,United Arab Emirates,NLD,Netherlands,2016,2,3,-1
ARE,United Arab Emirates,NLD,Netherlands,2017,4,1,3
ARE,United Arab Emirates,NZL,New Zealand,2008,12,0,12
ARE,United Arab Emirates,NZL,New Zealand,2009,9,0,9
ARE,United Arab Emirates,NZL,New Zealand,2010,16,2,14
ARE,United Arab Emirates,NZL,New Zealand,2011,14,9,5
ARE,United Arab Emirates,NZL,New Zealand,2012,8,10,-2
ARE,United Arab Emirates,NZL,New Zealand,2013,4,20,-16
ARE,United Arab Emirates,NZL,New Zealand,2014,6,4,2
ARE,United Arab Emirates,NZL,New Zealand,2015,2,3,-1
ARE,United Arab Emirates,NZL,New Zealand,2016,8,6,2
ARE,United Arab Emirates,NZL,New Zealand,2017,9,1,8
ARE,United Arab Emirates,NOR,Norway,2008,3,0,3
ARE,United Arab Emirates,NOR,Norway,2009,3,0,3
ARE,United Arab Emirates,NOR,Norway,2010,2,0,2
ARE,United Arab Emirates,NOR,Norway,2011,3,0,3
ARE,United Arab Emirates,NOR,Norway,2012,0,2,-2
ARE,United Arab Emirates,NOR,Norway,2013,3,0,3
ARE,United Arab Emirates,NOR,Norway,2014,1,0,1
ARE,United Arab Emirates,NOR,Norway,2015,0,0,0
ARE,United Arab Emirates,NOR,Norway,2016,0,1,-1
ARE,United Arab Emirates,NOR,Norway,2017,1,0,1
ARE,United Arab Emirates,POL,Poland,2009,0,0,0
ARE,United Arab Emirates,POL,Poland,2010,0,0,0
ARE,United Arab Emirates,POL,Poland,2011,0,0,0
ARE,United Arab Emirates,POL,Poland,2012,0,0,0
ARE,United Arab Emirates,POL,Poland,2013,0,0,0
ARE,United Arab Emirates,POL,Poland,2014,0,0,0
ARE,United Arab Emirates,POL,Poland,2015,0,0,0
ARE,United Arab Emirates,POL,Poland,2016,0,0,0
ARE,United Arab Emirates,POL,Poland,2017,0,0,0
ARE,United Arab Emirates,SVK,Slovak Republic,2008,0,2,-2
ARE,United Arab Emirates,SVK,Slovak Republic,2013,1,0,1
ARE,United Arab Emirates,ESP,Spain,2008,4,1,3
ARE,United Arab Emirates,ESP,Spain,2009,6,0,6
ARE,United Arab Emirates,ESP,Spain,2010,2,5,-3
ARE,United Arab Emirates,ESP,Spain,2011,13,4,9
ARE,United Arab Emirates,ESP,Spain,2012,8,2,6
ARE,United Arab Emirates,ESP,Spain,2013,12,7,5
ARE,United Arab Emirates,ESP,Spain,2014,15,3,12
ARE,United Arab Emirates,ESP,Spain,2015,10,1,9
ARE,United Arab Emirates,ESP,Spain,2016,26,5,21
ARE,United Arab Emirates,ESP,Spain,2017,30,11,19
ARE,United Arab Emirates,SWE,Sweden,2008,5,1,4
ARE,United Arab Emirates,SWE,Sweden,2009,6,2,4
ARE,United Arab Emirates,SWE,Sweden,2010,4,10,-6
ARE,United Arab Emirates,SWE,Sweden,2011,0,3,-3
ARE,United Arab Emirates,SWE,Sweden,2012,2,14,-12
ARE,United Arab Emirates,SWE,Sweden,2013,3,4,-1
ARE,United Arab Emirates,SWE,Sweden,2014,5,0,5
ARE,United Arab Emirates,SWE,Sweden,2015,3,9,-6
ARE,United Arab Emirates,SWE,Sweden,2016,1,1,0
ARE,United Arab Emirates,SWE,Sweden,2017,2,3,-1
ARE,United Arab Emirates,CHE,Switzerland,2010,11,8,3
ARE,United Arab Emirates,CHE,Switzerland,2011,4,10,-6
ARE,United Arab Emirates,CHE,Switzerland,2012,6,7,-1
ARE,United Arab Emirates,CHE,Switzerland,2013,14,9,5
ARE,United Arab Emirates,CHE,Switzerland,2014,5,8,-3
ARE,United Arab Emirates,CHE,Switzerland,2015,8,5,3
ARE,United Arab Emirates,CHE,Switzerland,2016,9,10,-1
ARE,United Arab Emirates,CHE,Switzerland,2017,9,6,3
ARE,United Arab Emirates,TUR,Turkey,2010,2,0,2
ARE,United Arab Emirates,GBR,United Kingdom,2012,1000,0,1000
ARE,United Arab Emirates,GBR,United Kingdom,2014,2000,0,2000
ARE,United Arab Emirates,GBR,United Kingdom,2015,1000,0,1000
ARE,United Arab Emirates,USA,United States,2008,693,0,693
ARE,United Arab Emirates,USA,United States,2009,697,0,697
ARE,United Arab Emirates,USA,United States,2010,779,0,779
ARE,United Arab Emirates,USA,United States,2011,707,0,707
ARE,United Arab Emirates,USA,United States,2012,854,0,854
ARE,United Arab Emirates,USA,United States,2013,910,0,910
ARE,United Arab Emirates,USA,United States,2014,1039,0,1039
ARE,United Arab Emirates,USA,United States,2015,1193,0,1193
ARE,United Arab Emirates,USA,United States,2016,1370,0,1370
ARE,United Arab Emirates,USA,United States,2017,1314,0,1314
ARE,United Arab Emirates,CHL,Chile,2008,0,0,0
ARE,United Arab Emirates,CHL,Chile,2009,0,0,0
ARE,United Arab Emirates,CHL,Chile,2010,0,0,0
ARE,United Arab Emirates,CHL,Chile,2011,0,0,0
ARE,United Arab Emirates,CHL,Chile,2012,0,0,0
ARE,United Arab Emirates,CHL,Chile,2013,0,0,0
ARE,United Arab Emirates,CHL,Chile,2014,0,0,0
ARE,United Arab Emirates,CHL,Chile,2015,0,0,0
ARE,United Arab Emirates,CHL,Chile,2016,0,0,0
ARE,United Arab Emirates,EST,Estonia,2008,0,0,0
ARE,United Arab Emirates,EST,Estonia,2009,0,0,0
ARE,United Arab Emirates,EST,Estonia,2010,0,0,0
ARE,United Arab Emirates,EST,Estonia,2011,0,0,0
ARE,United Arab Emirates,EST,Estonia,2012,0,0,0
ARE,United Arab Emirates,EST,Estonia,2013,0,0,0
ARE,United Arab Emirates,EST,Estonia,2014,0,0,0
ARE,United Arab Emirates,EST,Estonia,2015,0,0,0
ARE,United Arab Emirates,EST,Estonia,2016,0,0,0
ARE,United Arab Emirates,EST,Estonia,2017,0,0,0
GBR,United Kingdom,AUS,Australia,2008,31718,14000,17718
GBR,United Kingdom,AUS,Australia,2009,33287,12000,21287
GBR,United Kingdom,AUS,Australia,2010,26701,18000,8701
GBR,United Kingdom,AUS,Australia,2011,21476,13000,8476
GBR,United Kingdom,AUS,Australia,2012,27010,16000,11010
GBR,United Kingdom,AUS,Australia,2013,23149,11000,12149
GBR,United Kingdom,AUS,Australia,2014,23798,15000,8798
GBR,United Kingdom,AUS,Australia,2015,22187,16000,6187
GBR,United Kingdom,AUS,Australia,2016,18963,13000,5963
GBR,United Kingdom,AUS,Australia,2017,17646,18000,-354
GBR,United Kingdom,AUT,Austria,2008,1259,0,1259
GBR,United Kingdom,AUT,Austria,2009,1136,0,1136
GBR,United Kingdom,AUT,Austria,2010,1227,0,1227
GBR,United Kingdom,AUT,Austria,2011,1295,0,1295
GBR,United Kingdom,AUT,Austria,2012,1225,1000,225
GBR,United Kingdom,AUT,Austria,2013,1398,1000,398
GBR,United Kingdom,AUT,Austria,2014,1373,1000,373
GBR,United Kingdom,AUT,Austria,2015,1401,1000,401
GBR,United Kingdom,AUT,Austria,2016,1452,0,1452
GBR,United Kingdom,AUT,Austria,2017,1510,0,1510
GBR,United Kingdom,BEL,Belgium,2008,2363,0,2363
GBR,United Kingdom,BEL,Belgium,2009,1894,0,1894
GBR,United Kingdom,BEL,Belgium,2010,2205,0,2205
GBR,United Kingdom,BEL,Belgium,2011,2061,1000,1061
GBR,United Kingdom,BEL,Belgium,2012,1999,3000,-1001
GBR,United Kingdom,BEL,Belgium,2013,1993,1000,993
GBR,United Kingdom,BEL,Belgium,2014,1638,3000,-1362
GBR,United Kingdom,BEL,Belgium,2015,1739,2000,-261
GBR,United Kingdom,BEL,Belgium,2016,1572,0,1572
GBR,United Kingdom,BEL,Belgium,2017,1600,0,1600
GBR,United Kingdom,CAN,Canada,2008,8975,7000,1975
GBR,United Kingdom,CAN,Canada,2009,8872,0,8872
GBR,United Kingdom,CAN,Canada,2010,8715,6000,2715
GBR,United Kingdom,CAN,Canada,2011,6128,9000,-2872
GBR,United Kingdom,CAN,Canada,2012,6171,7000,-829
GBR,United Kingdom,CAN,Canada,2013,5814,6000,-186
GBR,United Kingdom,CAN,Canada,2014,5759,11000,-5241
GBR,United Kingdom,CAN,Canada,2015,5450,6000,-550
GBR,United Kingdom,CAN,Canada,2016,5810,6000,-190
GBR,United Kingdom,CAN,Canada,2017,5295,6000,-705
GBR,United Kingdom,CZE,Czech Republic,2008,716,0,716
GBR,United Kingdom,CZE,Czech Republic,2009,387,0,387
GBR,United Kingdom,CZE,Czech Republic,2010,316,0,316
GBR,United Kingdom,CZE,Czech Republic,2011,276,4000,-3724
GBR,United Kingdom,CZE,Czech Republic,2012,262,2000,-1738
GBR,United Kingdom,CZE,Czech Republic,2013,355,2000,-1645
GBR,United Kingdom,CZE,Czech Republic,2014,366,3000,-2634
GBR,United Kingdom,CZE,Czech Republic,2015,323,4000,-3677
GBR,United Kingdom,CZE,Czech Republic,2016,356,0,356
GBR,United Kingdom,CZE,Czech Republic,2017,445,0,445
GBR,United Kingdom,DNK,Denmark,2008,983,0,983
GBR,United Kingdom,DNK,Denmark,2009,860,0,860
GBR,United Kingdom,DNK,Denmark,2010,975,0,975
GBR,United Kingdom,DNK,Denmark,2011,1064,0,1064
GBR,United Kingdom,DNK,Denmark,2012,1035,1000,35
GBR,United Kingdom,DNK,Denmark,2013,1139,2000,-861
GBR,United Kingdom,DNK,Denmark,2014,1229,1000,229
GBR,United Kingdom,DNK,Denmark,2015,1404,5000,-3596
GBR,United Kingdom,DNK,Denmark,2016,1607,0,1607
GBR,United Kingdom,DNK,Denmark,2017,1746,0,1746
GBR,United Kingdom,FIN,Finland,2008,327,0,327
GBR,United Kingdom,FIN,Finland,2009,282,0,282
GBR,United Kingdom,FIN,Finland,2010,260,0,260
GBR,United Kingdom,FIN,Finland,2011,344,1000,-656
GBR,United Kingdom,FIN,Finland,2012,385,2000,-1615
GBR,United Kingdom,FIN,Finland,2013,354,1000,-646
GBR,United Kingdom,FIN,Finland,2014,421,2000,-1579
GBR,United Kingdom,FIN,Finland,2015,343,2000,-1657
GBR,United Kingdom,FIN,Finland,2016,378,0,378
GBR,United Kingdom,FIN,Finland,2017,324,0,324
GBR,United Kingdom,FRA,France,2008,0,0,0
GBR,United Kingdom,FRA,France,2009,0,14000,-14000
GBR,United Kingdom,FRA,France,2010,0,11000,-11000
GBR,United Kingdom,FRA,France,2011,0,17000,-17000
GBR,United Kingdom,FRA,France,2012,0,14000,-14000
GBR,United Kingdom,FRA,France,2013,10448,15000,-4552
GBR,United Kingdom,FRA,France,2014,9341,24000,-14659
GBR,United Kingdom,FRA,France,2015,9760,15000,-5240
GBR,United Kingdom,FRA,France,2016,11567,25000,-13433
GBR,United Kingdom,FRA,France,2017,10001,14000,-3999
GBR,United Kingdom,DEU,Germany,2008,8592,18000,-9408
GBR,United Kingdom,DEU,Germany,2009,8635,11000,-2365
GBR,United Kingdom,DEU,Germany,2010,9173,7000,2173
GBR,United Kingdom,DEU,Germany,2011,9767,13000,-3233
GBR,United Kingdom,DEU,Germany,2012,10466,8000,2466
GBR,United Kingdom,DEU,Germany,2013,10836,10000,836
GBR,United Kingdom,DEU,Germany,2014,10796,13000,-2204
GBR,United Kingdom,DEU,Germany,2015,10726,10000,726
GBR,United Kingdom,DEU,Germany,2016,11489,9000,2489
GBR,United Kingdom,DEU,Germany,2017,11456,12000,-544
GBR,United Kingdom,HUN,Hungary,2008,421,0,421
GBR,United Kingdom,HUN,Hungary,2009,335,0,335
GBR,United Kingdom,HUN,Hungary,2010,332,0,332
GBR,United Kingdom,HUN,Hungary,2011,395,4000,-3605
GBR,United Kingdom,HUN,Hungary,2012,324,5000,-4676
GBR,United Kingdom,HUN,Hungary,2013,378,7000,-6622
GBR,United Kingdom,HUN,Hungary,2014,384,8000,-7616
GBR,United Kingdom,HUN,Hungary,2015,414,9000,-8586
GBR,United Kingdom,HUN,Hungary,2016,435,3000,-2565
GBR,United Kingdom,HUN,Hungary,2017,509,8000,-7491
GBR,United Kingdom,ISL,Iceland,2008,117,0,117
GBR,United Kingdom,ISL,Iceland,2009,107,0,107
GBR,United Kingdom,ISL,Iceland,2010,107,0,107
GBR,United Kingdom,ISL,Iceland,2011,123,0,123
GBR,United Kingdom,ISL,Iceland,2012,84,0,84
GBR,United Kingdom,ISL,Iceland,2013,113,0,113
GBR,United Kingdom,ISL,Iceland,2014,128,0,128
GBR,United Kingdom,ISL,Iceland,2015,161,0,161
GBR,United Kingdom,ISL,Iceland,2016,205,0,205
GBR,United Kingdom,ISL,Iceland,2017,224,0,224
GBR,United Kingdom,IRL,Ireland,2008,6800,0,6800
GBR,United Kingdom,IRL,Ireland,2009,3900,11000,-7100
GBR,United Kingdom,IRL,Ireland,2010,2500,14000,-11500
GBR,United Kingdom,IRL,Ireland,2011,4100,10000,-5900
GBR,United Kingdom,IRL,Ireland,2012,3900,4000,-100
GBR,United Kingdom,IRL,Ireland,2013,4100,10000,-5900
GBR,United Kingdom,IRL,Ireland,2014,4200,6000,-1800
GBR,United Kingdom,IRL,Ireland,2015,5000,5000,0
GBR,United Kingdom,IRL,Ireland,2016,5900,11000,-5100
GBR,United Kingdom,IRL,Ireland,2017,6100,10000,-3900
GBR,United Kingdom,ITA,Italy,2008,2244,14000,-11756
GBR,United Kingdom,ITA,Italy,2009,1939,8000,-6061
GBR,United Kingdom,ITA,Italy,2010,1568,9000,-7432
GBR,United Kingdom,ITA,Italy,2011,1591,10000,-8409
GBR,United Kingdom,ITA,Italy,2012,1548,10000,-8452
GBR,United Kingdom,ITA,Italy,2013,1235,17000,-15765
GBR,United Kingdom,ITA,Italy,2014,1328,17000,-15672
GBR,United Kingdom,ITA,Italy,2015,1482,26000,-24518
GBR,United Kingdom,ITA,Italy,2016,1712,26000,-24288
GBR,United Kingdom,ITA,Italy,2017,1964,19000,-17036
GBR,United Kingdom,JPN,Japan,2008,5952,0,5952
GBR,United Kingdom,JPN,Japan,2009,5278,6000,-722
GBR,United Kingdom,JPN,Japan,2010,5800,4000,1800
GBR,United Kingdom,JPN,Japan,2011,5160,3000,2160
GBR,United Kingdom,JPN,Japan,2012,5504,5000,504
GBR,United Kingdom,JPN,Japan,2013,6138,5000,1138
GBR,United Kingdom,JPN,Japan,2014,5875,4000,1875
GBR,United Kingdom,JPN,Japan,2015,6673,7000,-327
GBR,United Kingdom,JPN,Japan,2016,6582,5000,1582
GBR,United Kingdom,JPN,Japan,2017,6741,0,6741
GBR,United Kingdom,KOR,Korea,2008,1550,0,1550
GBR,United Kingdom,KOR,Korea,2009,1782,5000,-3218
GBR,United Kingdom,KOR,Korea,2010,1727,4000,-2273
GBR,United Kingdom,KOR,Korea,2011,2086,3000,-914
GBR,United Kingdom,KOR,Korea,2012,1818,1000,818
GBR,United Kingdom,KOR,Korea,2013,1877,3000,-1123
GBR,United Kingdom,KOR,Korea,2014,1567,6000,-4433
GBR,United Kingdom,KOR,Korea,2015,1305,2000,-695
GBR,United Kingdom,KOR,Korea,2016,1540,0,1540
GBR,United Kingdom,KOR,Korea,2017,1336,0,1336
GBR,United Kingdom,LUX,Luxembourg,2008,491,0,491
GBR,United Kingdom,LUX,Luxembourg,2009,446,0,446
GBR,United Kingdom,LUX,Luxembourg,2010,415,0,415
GBR,United Kingdom,LUX,Luxembourg,2011,427,0,427
GBR,United Kingdom,LUX,Luxembourg,2012,439,0,439
GBR,United Kingdom,LUX,Luxembourg,2013,467,1000,-533
GBR,United Kingdom,LUX,Luxembourg,2014,502,1000,-498
GBR,United Kingdom,LUX,Luxembourg,2015,452,0,452
GBR,United Kingdom,LUX,Luxembourg,2016,457,0,457
GBR,United Kingdom,LUX,Luxembourg,2017,554,0,554
GBR,United Kingdom,MEX,Mexico,2008,170,0,170
GBR,United Kingdom,MEX,Mexico,2009,255,0,255
GBR,United Kingdom,MEX,Mexico,2010,248,0,248
GBR,United Kingdom,MEX,Mexico,2011,228,0,228
GBR,United Kingdom,MEX,Mexico,2012,200,1000,-800
GBR,United Kingdom,MEX,Mexico,2013,748,1000,-252
GBR,United Kingdom,MEX,Mexico,2014,454,2000,-1546
GBR,United Kingdom,MEX,Mexico,2015,331,4000,-3669
GBR,United Kingdom,MEX,Mexico,2016,317,0,317
GBR,United Kingdom,MEX,Mexico,2017,253,0,253
GBR,United Kingdom,NLD,Netherlands,2008,4731,0,4731
GBR,United Kingdom,NLD,Netherlands,2009,4422,0,4422
GBR,United Kingdom,NLD,Netherlands,2010,4366,0,4366
GBR,United Kingdom,NLD,Netherlands,2011,4434,1000,3434
GBR,United Kingdom,NLD,Netherlands,2012,4704,3000,1704
GBR,United Kingdom,NLD,Netherlands,2013,5122,4000,1122
GBR,United Kingdom,NLD,Netherlands,2014,5265,5000,265
GBR,United Kingdom,NLD,Netherlands,2015,5766,8000,-2234
GBR,United Kingdom,NLD,Netherlands,2016,6521,6000,521
GBR,United Kingdom,NLD,Netherlands,2017,7164,7000,164
GBR,United Kingdom,NZL,New Zealand,2008,11617,8000,3617
GBR,United Kingdom,NZL,New Zealand,2009,10082,5000,5082
GBR,United Kingdom,NZL,New Zealand,2010,8877,4000,4877
GBR,United Kingdom,NZL,New Zealand,2011,9536,5000,4536
GBR,United Kingdom,NZL,New Zealand,2012,9334,5000,4334
GBR,United Kingdom,NZL,New Zealand,2013,9763,3000,6763
GBR,United Kingdom,NZL,New Zealand,2014,10188,6000,4188
GBR,United Kingdom,NZL,New Zealand,2015,10264,6000,4264
GBR,United Kingdom,NZL,New Zealand,2016,10843,6000,4843
GBR,United Kingdom,NZL,New Zealand,2017,11363,12000,-637
GBR,United Kingdom,NOR,Norway,2008,1249,0,1249
GBR,United Kingdom,NOR,Norway,2009,1256,0,1256
GBR,United Kingdom,NOR,Norway,2010,1462,0,1462
GBR,United Kingdom,NOR,Norway,2011,1519,3000,-1481
GBR,United Kingdom,NOR,Norway,2012,1408,3000,-1592
GBR,United Kingdom,NOR,Norway,2013,1331,3000,-1669
GBR,United Kingdom,NOR,Norway,2014,1254,2000,-746
GBR,United Kingdom,NOR,Norway,2015,984,4000,-3016
GBR,United Kingdom,NOR,Norway,2016,906,0,906
GBR,United Kingdom,NOR,Norway,2017,902,0,902
GBR,United Kingdom,POL,Poland,2008,1515,55000,-53485
GBR,United Kingdom,POL,Poland,2009,526,32000,-31474
GBR,United Kingdom,POL,Poland,2010,522,34000,-33478
GBR,United Kingdom,POL,Poland,2011,536,33000,-32464
GBR,United Kingdom,POL,Poland,2012,511,30000,-29489
GBR,United Kingdom,POL,Poland,2013,525,28000,-27475
GBR,United Kingdom,POL,Poland,2014,523,32000,-31477
GBR,United Kingdom,POL,Poland,2015,553,40000,-39447
GBR,United Kingdom,POL,Poland,2016,596,29000,-28404
GBR,United Kingdom,POL,Poland,2017,664,25000,-24336
GBR,United Kingdom,PRT,Portugal,2008,2670,0,2670
GBR,United Kingdom,PRT,Portugal,2009,2154,0,2154
GBR,United Kingdom,PRT,Portugal,2010,1763,4000,-2237
GBR,United Kingdom,PRT,Portugal,2011,1692,5000,-3308
GBR,United Kingdom,PRT,Portugal,2012,1246,7000,-5754
GBR,United Kingdom,PRT,Portugal,2013,1402,12000,-10598
GBR,United Kingdom,PRT,Portugal,2014,1486,15000,-13514
GBR,United Kingdom,PRT,Portugal,2015,1866,10000,-8134
GBR,United Kingdom,PRT,Portugal,2016,3066,12000,-8934
GBR,United Kingdom,PRT,Portugal,2017,3832,15000,-11168
GBR,United Kingdom,SVK,Slovak Republic,2008,242,0,242
GBR,United Kingdom,SVK,Slovak Republic,2009,212,0,212
GBR,United Kingdom,SVK,Slovak Republic,2010,126,0,126
GBR,United Kingdom,SVK,Slovak Republic,2011,153,0,153
GBR,United Kingdom,SVK,Slovak Republic,2012,60,0,60
GBR,United Kingdom,SVK,Slovak Republic,2013,48,6000,-5952
GBR,United Kingdom,SVK,Slovak Republic,2014,62,0,62
GBR,United Kingdom,SVK,Slovak Republic,2015,103,0,103
GBR,United Kingdom,SVK,Slovak Republic,2016,130,0,130
GBR,United Kingdom,SVK,Slovak Republic,2017,109,0,109
GBR,United Kingdom,ESP,Spain,2008,23758,0,23758
GBR,United Kingdom,ESP,Spain,2009,17938,11000,6938
GBR,United Kingdom,ESP,Spain,2010,16173,5000,11173
GBR,United Kingdom,ESP,Spain,2011,15731,8000,7731
GBR,United Kingdom,ESP,Spain,2012,16375,17000,-625
GBR,United Kingdom,ESP,Spain,2013,14145,21000,-6855
GBR,United Kingdom,ESP,Spain,2014,14230,21000,-6770
GBR,United Kingdom,ESP,Spain,2015,14991,20000,-5009
GBR,United Kingdom,ESP,Spain,2016,18549,18000,549
GBR,United Kingdom,ESP,Spain,2017,21186,18000,3186
GBR,United Kingdom,SWE,Sweden,2008,1719,0,1719
GBR,United Kingdom,SWE,Sweden,2009,1638,0,1638
GBR,United Kingdom,SWE,Sweden,2010,1435,0,1435
GBR,United Kingdom,SWE,Sweden,2011,1804,2000,-196
GBR,United Kingdom,SWE,Sweden,2012,1549,3000,-1451
GBR,United Kingdom,SWE,Sweden,2013,1554,2000,-446
GBR,United Kingdom,SWE,Sweden,2014,1831,4000,-2169
GBR,United Kingdom,SWE,Sweden,2015,1666,2000,-334
GBR,United Kingdom,SWE,Sweden,2016,1934,0,1934
GBR,United Kingdom,SWE,Sweden,2017,2048,0,2048
GBR,United Kingdom,CHE,Switzerland,2008,5633,0,5633
GBR,United Kingdom,CHE,Switzerland,2009,4761,0,4761
GBR,United Kingdom,CHE,Switzerland,2010,5465,0,5465
GBR,United Kingdom,CHE,Switzerland,2011,5406,1000,4406
GBR,United Kingdom,CHE,Switzerland,2012,4445,1000,3445
GBR,United Kingdom,CHE,Switzerland,2013,4602,1000,3602
GBR,United Kingdom,CHE,Switzerland,2014,4210,1000,3210
GBR,United Kingdom,CHE,Switzerland,2015,3924,3000,924
GBR,United Kingdom,CHE,Switzerland,2016,3575,0,3575
GBR,United Kingdom,CHE,Switzerland,2017,3760,0,3760
GBR,United Kingdom,TUR,Turkey,2010,1146,0,1146
GBR,United Kingdom,TUR,Turkey,2016,1764,7000,-5236
GBR,United Kingdom,TUR,Turkey,2017,1819,6000,-4181
GBR,United Kingdom,USA,United States,2008,14348,17000,-2652
GBR,United Kingdom,USA,United States,2009,15748,17000,-1252
GBR,United Kingdom,USA,United States,2010,12792,16000,-3208
GBR,United Kingdom,USA,United States,2011,11572,16000,-4428
GBR,United Kingdom,USA,United States,2012,12014,17000,-4986
GBR,United Kingdom,USA,United States,2013,12984,12000,984
GBR,United Kingdom,USA,United States,2014,12225,20000,-7775
GBR,United Kingdom,USA,United States,2015,12592,18000,-5408
GBR,United Kingdom,USA,United States,2016,12673,17000,-4327
GBR,United Kingdom,USA,United States,2017,10948,19000,-8052
GBR,United Kingdom,CHL,Chile,2008,0,0,0
GBR,United Kingdom,CHL,Chile,2009,0,0,0
GBR,United Kingdom,CHL,Chile,2010,0,0,0
GBR,United Kingdom,CHL,Chile,2011,0,1000,-1000
GBR,United Kingdom,CHL,Chile,2012,0,1000,-1000
GBR,United Kingdom,CHL,Chile,2013,0,0,0
GBR,United Kingdom,CHL,Chile,2014,0,2000,-2000
GBR,United Kingdom,CHL,Chile,2015,0,0,0
GBR,United Kingdom,CHL,Chile,2016,64,0,64
GBR,United Kingdom,EST,Estonia,2008,46,0,46
GBR,United Kingdom,EST,Estonia,2009,56,0,56
GBR,United Kingdom,EST,Estonia,2010,17,0,17
GBR,United Kingdom,EST,Estonia,2011,0,2000,-2000
GBR,United Kingdom,EST,Estonia,2012,2,1000,-998
GBR,United Kingdom,EST,Estonia,2013,9,1000,-991
GBR,United Kingdom,EST,Estonia,2014,4,0,4
GBR,United Kingdom,EST,Estonia,2015,116,0,116
GBR,United Kingdom,EST,Estonia,2016,111,0,111
GBR,United Kingdom,EST,Estonia,2017,168,0,168
GBR,United Kingdom,ISR,Israel,2008,505,0,505
GBR,United Kingdom,ISR,Israel,2009,708,0,708
GBR,United Kingdom,ISR,Israel,2010,632,0,632
GBR,United Kingdom,ISR,Israel,2011,485,0,485
GBR,United Kingdom,ISR,Israel,2012,569,1000,-431
GBR,United Kingdom,ISR,Israel,2013,403,0,403
GBR,United Kingdom,ISR,Israel,2014,486,0,486
GBR,United Kingdom,ISR,Israel,2015,623,1000,-377
GBR,United Kingdom,ISR,Israel,2016,632,0,632
GBR,United Kingdom,ISR,Israel,2017,468,0,468
GBR,United Kingdom,SVN,Slovenia,2008,129,0,129
GBR,United Kingdom,SVN,Slovenia,2009,107,0,107
GBR,United Kingdom,SVN,Slovenia,2010,3,0,3
GBR,United Kingdom,SVN,Slovenia,2011,120,0,120
GBR,United Kingdom,SVN,Slovenia,2012,115,1000,-885
GBR,United Kingdom,SVN,Slovenia,2013,84,1000,-916
GBR,United Kingdom,SVN,Slovenia,2014,80,0,80
GBR,United Kingdom,SVN,Slovenia,2015,83,0,83
GBR,United Kingdom,SVN,Slovenia,2016,105,0,105
GBR,United Kingdom,SVN,Slovenia,2017,123,0,123
USA,United States,AUS,Australia,2008,2964,2464,500
USA,United States,AUS,Australia,2009,3071,2622,449
USA,United States,AUS,Australia,2010,3176,2512,664
USA,United States,AUS,Australia,2011,2986,2343,643
USA,United States,AUS,Australia,2012,3258,2414,844
USA,United States,AUS,Australia,2013,3844,2759,1085
USA,United States,AUS,Australia,2014,3818,2809,1009
USA,United States,AUS,Australia,2015,3515,3034,481
USA,United States,AUS,Australia,2016,3489,3239,250
USA,United States,AUS,Australia,2017,3601,2906,695
USA,United States,AUT,Austria,2008,1664,443,1221
USA,United States,AUT,Austria,2009,1565,512,1053
USA,United States,AUT,Austria,2010,1632,442,1190
USA,United States,AUT,Austria,2011,1805,424,1381
USA,United States,AUT,Austria,2012,1796,407,1389
USA,United States,AUT,Austria,2013,1801,415,1386
USA,United States,AUT,Austria,2014,1861,438,1423
USA,United States,AUT,Austria,2015,1977,474,1503
USA,United States,AUT,Austria,2016,1880,432,1448
USA,United States,AUT,Austria,2017,1938,387,1551
USA,United States,BEL,Belgium,2008,2631,642,1989
USA,United States,BEL,Belgium,2009,2650,686,1964
USA,United States,BEL,Belgium,2010,2714,592,2122
USA,United States,BEL,Belgium,2011,2559,567,1992
USA,United States,BEL,Belgium,2012,2544,574,1970
USA,United States,BEL,Belgium,2013,2587,675,1912
USA,United States,BEL,Belgium,2014,2001,632,1369
USA,United States,BEL,Belgium,2015,2179,662,1517
USA,United States,BEL,Belgium,2016,2113,691,1422
USA,United States,BEL,Belgium,2017,2078,625,1453
USA,United States,CAN,Canada,2008,10186,15109,-4923
USA,United States,CAN,Canada,2009,8994,16140,-7146
USA,United States,CAN,Canada,2010,8139,13328,-5189
USA,United States,CAN,Canada,2011,7671,12800,-5129
USA,United States,CAN,Canada,2012,7870,12932,-5062
USA,United States,CAN,Canada,2013,8485,13181,-4696
USA,United States,CAN,Canada,2014,8491,11586,-3095
USA,United States,CAN,Canada,2015,7521,12673,-5152
USA,United States,CAN,Canada,2016,8410,12793,-4383
USA,United States,CAN,Canada,2017,9100,11484,-2384
USA,United States,CZE,Czech Republic,2008,2217,227,1990
USA,United States,CZE,Czech Republic,2009,2464,146,2318
USA,United States,CZE,Czech Republic,2010,1680,190,1490
USA,United States,CZE,Czech Republic,2011,1321,303,1018
USA,United States,CZE,Czech Republic,2012,1081,677,404
USA,United States,CZE,Czech Republic,2013,812,676,136
USA,United States,CZE,Czech Republic,2014,916,606,310
USA,United States,CZE,Czech Republic,2015,832,637,195
USA,United States,CZE,Czech Republic,2016,1063,650,413
USA,United States,CZE,Czech Republic,2017,1073,582,491
USA,United States,DNK,Denmark,2008,913,498,415
USA,United States,DNK,Denmark,2009,746,603,143
USA,United States,DNK,Denmark,2010,864,518,346
USA,United States,DNK,Denmark,2011,872,459,413
USA,United States,DNK,Denmark,2012,897,459,438
USA,United States,DNK,Denmark,2013,917,506,411
USA,United States,DNK,Denmark,2014,1021,514,507
USA,United States,DNK,Denmark,2015,1120,609,511
USA,United States,DNK,Denmark,2016,1135,521,614
USA,United States,DNK,Denmark,2017,1209,461,748
USA,United States,FIN,Finland,2008,301,302,-1
USA,United States,FIN,Finland,2009,278,423,-145
USA,United States,FIN,Finland,2010,290,397,-107
USA,United States,FIN,Finland,2011,316,363,-47
USA,United States,FIN,Finland,2012,287,348,-61
USA,United States,FIN,Finland,2013,311,331,-20
USA,United States,FIN,Finland,2014,371,350,21
USA,United States,FIN,Finland,2015,352,407,-55
USA,United States,FIN,Finland,2016,381,489,-108
USA,United States,FIN,Finland,2017,375,439,-64
USA,United States,FRA,France,2008,2806,4935,-2129
USA,United States,FRA,France,2009,3464,4569,-1105
USA,United States,FRA,France,2010,2954,3919,-965
USA,United States,FRA,France,2011,3092,3653,-561
USA,United States,FRA,France,2012,3082,3862,-780
USA,United States,FRA,France,2013,3105,4425,-1320
USA,United States,FRA,France,2014,3142,4284,-1142
USA,United States,FRA,France,2015,4350,4693,-343
USA,United States,FRA,France,2016,4541,5159,-618
USA,United States,FRA,France,2017,4320,4782,-462
USA,United States,DEU,Germany,2008,17542,7091,10451
USA,United States,DEU,Germany,2009,17706,7583,10123
USA,United States,DEU,Germany,2010,18262,6888,11374
USA,United States,DEU,Germany,2011,20149,6125,14024
USA,United States,DEU,Germany,2012,19563,5812,13751
USA,United States,DEU,Germany,2013,20531,6032,14499
USA,United States,DEU,Germany,2014,20468,5584,14884
USA,United States,DEU,Germany,2015,21115,5436,15679
USA,United States,DEU,Germany,2016,20736,5306,15430
USA,United States,DEU,Germany,2017,21121,4662,16459
USA,United States,HUN,Hungary,2008,1209,1127,82
USA,United States,HUN,Hungary,2009,1271,1314,-43
USA,United States,HUN,Hungary,2010,1125,1022,103
USA,United States,HUN,Hungary,2011,998,1044,-46
USA,United States,HUN,Hungary,2012,1045,1054,-9
USA,United States,HUN,Hungary,2013,1039,1052,-13
USA,United States,HUN,Hungary,2014,1051,996,55
USA,United States,HUN,Hungary,2015,1188,1095,93
USA,United States,HUN,Hungary,2016,1132,1048,84
USA,United States,HUN,Hungary,2017,1405,972,433
USA,United States,ISL,Iceland,2008,142,122,20
USA,United States,ISL,Iceland,2009,131,131,0
USA,United States,ISL,Iceland,2010,130,105,25
USA,United States,ISL,Iceland,2011,113,90,23
USA,United States,ISL,Iceland,2012,191,103,88
USA,United States,ISL,Iceland,2013,193,139,54
USA,United States,ISL,Iceland,2014,169,86,83
USA,United States,ISL,Iceland,2015,205,104,101
USA,United States,ISL,Iceland,2016,262,97,165
USA,United States,ISL,Iceland,2017,311,86,225
USA,United States,ITA,Italy,2008,1447,2514,-1067
USA,United States,ITA,Italy,2009,1456,2892,-1436
USA,United States,ITA,Italy,2010,1477,2579,-1102
USA,United States,ITA,Italy,2011,1573,2443,-870
USA,United States,ITA,Italy,2012,1620,2673,-1053
USA,United States,ITA,Italy,2013,1546,2960,-1414
USA,United States,ITA,Italy,2014,1391,3298,-1907
USA,United States,ITA,Italy,2015,1395,3544,-2149
USA,United States,ITA,Italy,2016,1365,4078,-2713
USA,United States,ITA,Italy,2017,1583,3655,-2072
USA,United States,JPN,Japan,2008,24021,6821,17200
USA,United States,JPN,Japan,2009,23549,7690,15859
USA,United States,JPN,Japan,2010,22669,6264,16405
USA,United States,JPN,Japan,2011,19303,6161,13142
USA,United States,JPN,Japan,2012,20985,6061,14924
USA,United States,JPN,Japan,2013,21058,5925,15133
USA,United States,JPN,Japan,2014,22042,5545,16497
USA,United States,JPN,Japan,2015,21523,5395,16128
USA,United States,JPN,Japan,2016,22182,5207,16975
USA,United States,JPN,Japan,2017,21994,4635,17359
USA,United States,KOR,Korea,2008,23402,26666,-3264
USA,United States,KOR,Korea,2009,27127,25859,1268
USA,United States,KOR,Korea,2010,28328,22227,6101
USA,United States,KOR,Korea,2011,28061,22824,5237
USA,United States,KOR,Korea,2012,28866,20846,8020
USA,United States,KOR,Korea,2013,26622,23166,3456
USA,United States,KOR,Korea,2014,24500,20423,4077
USA,United States,KOR,Korea,2015,22741,17138,5603
USA,United States,KOR,Korea,2016,21771,21801,-30
USA,United States,KOR,Korea,2017,19848,19194,654
USA,United States,LUX,Luxembourg,2008,332,28,304
USA,United States,LUX,Luxembourg,2009,274,30,244
USA,United States,LUX,Luxembourg,2010,335,22,313
USA,United States,LUX,Luxembourg,2011,337,24,313
USA,United States,LUX,Luxembourg,2012,431,19,412
USA,United States,LUX,Luxembourg,2013,488,40,448
USA,United States,LUX,Luxembourg,2014,682,26,656
USA,United States,LUX,Luxembourg,2015,549,27,522
USA,United States,LUX,Luxembourg,2016,407,34,373
USA,United States,LUX,Luxembourg,2017,505,33,472
USA,United States,MEX,Mexico,2008,2155,189989,-187834
USA,United States,MEX,Mexico,2009,2882,164920,-162038
USA,United States,MEX,Mexico,2010,4026,139120,-135094
USA,United States,MEX,Mexico,2011,4261,143446,-139185
USA,United States,MEX,Mexico,2012,3952,146406,-142454
USA,United States,MEX,Mexico,2013,14420,135028,-120608
USA,United States,MEX,Mexico,2014,9373,134052,-124679
USA,United States,MEX,Mexico,2015,7096,158619,-151523
USA,United States,MEX,Mexico,2016,6754,174534,-167780
USA,United States,MEX,Mexico,2017,5374,170581,-165207
USA,United States,NLD,Netherlands,2008,3437,1240,2197
USA,United States,NLD,Netherlands,2009,3091,1499,1592
USA,United States,NLD,Netherlands,2010,3325,1321,2004
USA,United States,NLD,Netherlands,2011,3749,1085,2664
USA,United States,NLD,Netherlands,2012,3715,1091,2624
USA,United States,NLD,Netherlands,2013,3596,1142,2454
USA,United States,NLD,Netherlands,2014,3821,1195,2626
USA,United States,NLD,Netherlands,2015,4653,1309,3344
USA,United States,NLD,Netherlands,2016,4705,1319,3386
USA,United States,NLD,Netherlands,2017,5573,1056,4517
USA,United States,NZL,New Zealand,2008,2294,893,1401
USA,United States,NZL,New Zealand,2009,2320,947,1373
USA,United States,NZL,New Zealand,2010,2267,919,1348
USA,United States,NZL,New Zealand,2011,2506,803,1703
USA,United States,NZL,New Zealand,2012,2533,814,1719
USA,United States,NZL,New Zealand,2013,2810,921,1889
USA,United States,NZL,New Zealand,2014,2856,796,2060
USA,United States,NZL,New Zealand,2015,3192,855,2337
USA,United States,NZL,New Zealand,2016,3268,846,2422
USA,United States,NZL,New Zealand,2017,3922,798,3124
USA,United States,NOR,Norway,2008,914,350,564
USA,United States,NOR,Norway,2009,881,407,474
USA,United States,NOR,Norway,2010,874,334,540
USA,United States,NOR,Norway,2011,967,339,628
USA,United States,NOR,Norway,2012,1137,276,861
USA,United States,NOR,Norway,2013,994,335,659
USA,United States,NOR,Norway,2014,874,271,603
USA,United States,NOR,Norway,2015,930,310,620
USA,United States,NOR,Norway,2016,895,362,533
USA,United States,NOR,Norway,2017,867,290,577
USA,United States,POL,Poland,2008,1017,8354,-7337
USA,United States,POL,Poland,2009,984,8754,-7770
USA,United States,POL,Poland,2010,984,7643,-6659
USA,United States,POL,Poland,2011,993,6863,-5870
USA,United States,POL,Poland,2012,1052,6300,-5248
USA,United States,POL,Poland,2013,1126,6430,-5304
USA,United States,POL,Poland,2014,0,5689,-5689
USA,United States,POL,Poland,2015,0,5275,-5275
USA,United States,POL,Poland,2016,0,5603,-5603
USA,United States,POL,Poland,2017,0,4845,-4845
USA,United States,PRT,Portugal,2008,353,772,-419
USA,United States,PRT,Portugal,2009,329,946,-617
USA,United States,PRT,Portugal,2010,255,755,-500
USA,United States,PRT,Portugal,2011,346,821,-475
USA,United States,PRT,Portugal,2012,327,811,-484
USA,United States,PRT,Portugal,2013,314,918,-604
USA,United States,PRT,Portugal,2014,312,892,-580
USA,United States,PRT,Portugal,2015,329,857,-528
USA,United States,PRT,Portugal,2016,501,1006,-505
USA,United States,PRT,Portugal,2017,614,939,-325
USA,United States,SVK,Slovak Republic,2008,27,653,-626
USA,United States,SVK,Slovak Republic,2009,28,706,-678
USA,United States,SVK,Slovak Republic,2010,30,538,-508
USA,United States,SVK,Slovak Republic,2011,20,594,-574
USA,United States,SVK,Slovak Republic,2012,11,528,-517
USA,United States,SVK,Slovak Republic,2013,14,507,-493
USA,United States,SVK,Slovak Republic,2014,23,460,-437
USA,United States,SVK,Slovak Republic,2015,15,424,-409
USA,United States,SVK,Slovak Republic,2016,13,483,-470
USA,United States,SVK,Slovak Republic,2017,17,388,-371
USA,United States,ESP,Spain,2008,3690,1621,2069
USA,United States,ESP,Spain,2009,3492,1769,1723
USA,United States,ESP,Spain,2010,3695,1684,2011
USA,United States,ESP,Spain,2011,5019,1890,3129
USA,United States,ESP,Spain,2012,4946,1842,3104
USA,United States,ESP,Spain,2013,5527,2480,3047
USA,United States,ESP,Spain,2014,5290,2928,2362
USA,United States,ESP,Spain,2015,5626,3303,2323
USA,United States,ESP,Spain,2016,5918,3519,2399
USA,United States,ESP,Spain,2017,7548,3045,4503
USA,United States,SWE,Sweden,2008,1129,1019,110
USA,United States,SWE,Sweden,2009,1196,1138,58
USA,United States,SWE,Sweden,2010,1329,1097,232
USA,United States,SWE,Sweden,2011,1227,979,248
USA,United States,SWE,Sweden,2012,1426,968,458
USA,United States,SWE,Sweden,2013,1427,1106,321
USA,United States,SWE,Sweden,2014,1286,954,332
USA,United States,SWE,Sweden,2015,1145,1066,79
USA,United States,SWE,Sweden,2016,1184,1144,40
USA,United States,SWE,Sweden,2017,1610,950,660
USA,United States,CHE,Switzerland,2010,3964,675,3289
USA,United States,CHE,Switzerland,2011,4239,615,3624
USA,United States,CHE,Switzerland,2012,3475,635,2840
USA,United States,CHE,Switzerland,2013,3404,697,2707
USA,United States,CHE,Switzerland,2014,3100,656,2444
USA,United States,CHE,Switzerland,2015,2879,640,2239
USA,United States,CHE,Switzerland,2016,2914,743,2171
USA,United States,CHE,Switzerland,2017,2957,565,2392
USA,United States,TUR,Turkey,2010,1541,4483,-2942
USA,United States,TUR,Turkey,2016,1663,4469,-2806
USA,United States,TUR,Turkey,2017,1969,4844,-2875
USA,United States,GBR,United Kingdom,2008,17000,14348,2652
USA,United States,GBR,United Kingdom,2009,17000,15748,1252
USA,United States,GBR,United Kingdom,2010,16000,12792,3208
USA,United States,GBR,United Kingdom,2011,16000,11572,4428
USA,United States,GBR,United Kingdom,2012,17000,12014,4986
USA,United States,GBR,United Kingdom,2013,12000,12984,-984
USA,United States,GBR,United Kingdom,2014,20000,12225,7775
USA,United States,GBR,United Kingdom,2015,18000,12592,5408
USA,United States,GBR,United Kingdom,2016,17000,12673,4327
USA,United States,GBR,United Kingdom,2017,19000,10948,8052
USA,United States,CHL,Chile,2008,1585,2017,-432
USA,United States,CHL,Chile,2009,1660,2250,-590
USA,United States,CHL,Chile,2010,2224,1950,274
USA,United States,CHL,Chile,2011,2126,1853,273
USA,United States,CHL,Chile,2012,2313,1673,640
USA,United States,CHL,Chile,2013,2342,1736,606
USA,United States,CHL,Chile,2014,2060,1581,479
USA,United States,CHL,Chile,2015,1743,1596,147
USA,United States,CHL,Chile,2016,1420,1698,-278
USA,United States,EST,Estonia,2008,31,287,-256
USA,United States,EST,Estonia,2009,70,282,-212
USA,United States,EST,Estonia,2010,10,260,-250
USA,United States,EST,Estonia,2011,46,191,-145
USA,United States,EST,Estonia,2012,53,227,-174
USA,United States,EST,Estonia,2013,75,211,-136
USA,United States,EST,Estonia,2014,63,220,-157
USA,United States,EST,Estonia,2015,98,189,-91
USA,United States,EST,Estonia,2016,111,211,-100
USA,United States,EST,Estonia,2017,118,176,-58
USA,United States,ISR,Israel,2008,2023,5851,-3828
USA,United States,ISR,Israel,2009,2475,5612,-3137
USA,United States,ISR,Israel,2010,2530,4515,-1985
USA,United States,ISR,Israel,2011,2363,3826,-1463
USA,United States,ISR,Israel,2012,2290,4153,-1863
USA,United States,ISR,Israel,2013,2186,3996,-1810
USA,United States,ISR,Israel,2014,2439,3805,-1366
USA,United States,ISR,Israel,2015,2451,3965,-1514
USA,United States,ISR,Israel,2016,2682,4142,-1460
USA,United States,ISR,Israel,2017,2567,3802,-1235
USA,United States,SVN,Slovenia,2008,111,79,32
USA,United States,SVN,Slovenia,2009,149,108,41
USA,United States,SVN,Slovenia,2010,170,74,96
USA,United States,SVN,Slovenia,2011,89,69,20
USA,United States,SVN,Slovenia,2012,148,86,62
USA,United States,SVN,Slovenia,2013,32,62,-30
USA,United States,SVN,Slovenia,2014,61,78,-17
USA,United States,SVN,Slovenia,2015,187,107,80
USA,United States,SVN,Slovenia,2016,91,119,-28
USA,United States,SVN,Slovenia,2017,108,108,0
URY,Uruguay,AUS,Australia,2008,42,79,-37
URY,Uruguay,AUS,Australia,2009,32,84,-52
URY,Uruguay,AUS,Australia,2010,29,55,-26
URY,Uruguay,AUS,Australia,2011,23,68,-45
URY,Uruguay,AUS,Australia,2012,38,64,-26
URY,Uruguay,AUS,Australia,2013,15,66,-51
URY,Uruguay,AUS,Australia,2014,24,54,-30
URY,Uruguay,AUS,Australia,2015,15,100,-85
URY,Uruguay,AUS,Australia,2016,16,0,16
URY,Uruguay,AUS,Australia,2017,21,0,21
URY,Uruguay,AUT,Austria,2008,16,6,10
URY,Uruguay,AUT,Austria,2009,8,9,-1
URY,Uruguay,AUT,Austria,2010,8,11,-3
URY,Uruguay,AUT,Austria,2011,6,6,0
URY,Uruguay,AUT,Austria,2012,9,9,0
URY,Uruguay,AUT,Austria,2013,9,5,4
URY,Uruguay,AUT,Austria,2014,12,6,6
URY,Uruguay,AUT,Austria,2015,15,6,9
URY,Uruguay,AUT,Austria,2016,13,9,4
URY,Uruguay,AUT,Austria,2017,15,10,5
URY,Uruguay,BEL,Belgium,2008,16,0,16
URY,Uruguay,BEL,Belgium,2009,7,0,7
URY,Uruguay,BEL,Belgium,2010,21,7,14
URY,Uruguay,BEL,Belgium,2012,13,3,10
URY,Uruguay,BEL,Belgium,2013,11,13,-2
URY,Uruguay,BEL,Belgium,2014,15,6,9
URY,Uruguay,BEL,Belgium,2015,8,3,5
URY,Uruguay,BEL,Belgium,2016,11,11,0
URY,Uruguay,BEL,Belgium,2017,21,12,9
URY,Uruguay,CAN,Canada,2008,159,0,159
URY,Uruguay,CAN,Canada,2009,99,0,99
URY,Uruguay,CAN,Canada,2010,93,0,93
URY,Uruguay,CAN,Canada,2011,81,0,81
URY,Uruguay,CAN,Canada,2012,47,0,47
URY,Uruguay,CAN,Canada,2013,58,0,58
URY,Uruguay,CAN,Canada,2014,43,0,43
URY,Uruguay,CAN,Canada,2015,50,0,50
URY,Uruguay,CAN,Canada,2016,55,0,55
URY,Uruguay,CAN,Canada,2017,25,0,25
URY,Uruguay,CZE,Czech Republic,2008,2,0,2
URY,Uruguay,CZE,Czech Republic,2009,1,0,1
URY,Uruguay,CZE,Czech Republic,2010,3,0,3
URY,Uruguay,CZE,Czech Republic,2011,2,0,2
URY,Uruguay,CZE,Czech Republic,2012,3,0,3
URY,Uruguay,CZE,Czech Republic,2013,4,1,3
URY,Uruguay,CZE,Czech Republic,2014,2,2,0
URY,Uruguay,CZE,Czech Republic,2015,5,2,3
URY,Uruguay,CZE,Czech Republic,2016,5,3,2
URY,Uruguay,DNK,Denmark,2008,2,4,-2
URY,Uruguay,DNK,Denmark,2009,3,5,-2
URY,Uruguay,DNK,Denmark,2010,3,4,-1
URY,Uruguay,DNK,Denmark,2011,4,4,0
URY,Uruguay,DNK,Denmark,2012,11,1,10
URY,Uruguay,DNK,Denmark,2013,2,4,-2
URY,Uruguay,DNK,Denmark,2014,4,2,2
URY,Uruguay,DNK,Denmark,2015,11,11,0
URY,Uruguay,DNK,Denmark,2016,5,4,1
URY,Uruguay,DNK,Denmark,2017,7,9,-2
URY,Uruguay,FIN,Finland,2008,7,1,6
URY,Uruguay,FIN,Finland,2009,6,0,6
URY,Uruguay,FIN,Finland,2010,4,0,4
URY,Uruguay,FIN,Finland,2011,7,1,6
URY,Uruguay,FIN,Finland,2012,1,1,0
URY,Uruguay,FIN,Finland,2013,8,0,8
URY,Uruguay,FIN,Finland,2014,6,6,0
URY,Uruguay,FIN,Finland,2015,15,2,13
URY,Uruguay,FIN,Finland,2016,1,1,0
URY,Uruguay,FIN,Finland,2017,8,4,4
URY,Uruguay,FRA,France,2008,39,0,39
URY,Uruguay,FRA,France,2009,39,0,39
URY,Uruguay,FRA,France,2010,35,0,35
URY,Uruguay,FRA,France,2011,34,0,34
URY,Uruguay,FRA,France,2012,50,0,50
URY,Uruguay,FRA,France,2013,30,0,30
URY,Uruguay,FRA,France,2014,38,0,38
URY,Uruguay,FRA,France,2015,38,0,38
URY,Uruguay,FRA,France,2016,43,0,43
URY,Uruguay,FRA,France,2017,32,0,32
URY,Uruguay,DEU,Germany,2008,85,70,15
URY,Uruguay,DEU,Germany,2009,79,82,-3
URY,Uruguay,DEU,Germany,2010,67,78,-11
URY,Uruguay,DEU,Germany,2011,68,53,15
URY,Uruguay,DEU,Germany,2012,102,54,48
URY,Uruguay,DEU,Germany,2013,108,67,41
URY,Uruguay,DEU,Germany,2014,102,75,27
URY,Uruguay,DEU,Germany,2015,119,65,54
URY,Uruguay,DEU,Germany,2016,107,57,50
URY,Uruguay,DEU,Germany,2017,126,67,59
URY,Uruguay,HUN,Hungary,2008,6,0,6
URY,Uruguay,HUN,Hungary,2009,1,0,1
URY,Uruguay,HUN,Hungary,2010,0,0,0
URY,Uruguay,HUN,Hungary,2011,1,0,1
URY,Uruguay,HUN,Hungary,2012,2,0,2
URY,Uruguay,HUN,Hungary,2013,0,0,0
URY,Uruguay,HUN,Hungary,2014,4,0,4
URY,Uruguay,HUN,Hungary,2015,3,1,2
URY,Uruguay,HUN,Hungary,2016,2,0,2
URY,Uruguay,HUN,Hungary,2017,3,0,3
URY,Uruguay,ISL,Iceland,2008,0,1,-1
URY,Uruguay,ISL,Iceland,2009,0,0,0
URY,Uruguay,ISL,Iceland,2010,0,0,0
URY,Uruguay,ISL,Iceland,2011,1,2,-1
URY,Uruguay,ISL,Iceland,2012,0,0,0
URY,Uruguay,ISL,Iceland,2013,1,0,1
URY,Uruguay,ISL,Iceland,2014,0,0,0
URY,Uruguay,ISL,Iceland,2015,0,0,0
URY,Uruguay,ISL,Iceland,2016,1,0,1
URY,Uruguay,ISL,Iceland,2017,1,0,1
URY,Uruguay,ITA,Italy,2008,241,27,214
URY,Uruguay,ITA,Italy,2009,187,30,157
URY,Uruguay,ITA,Italy,2010,140,22,118
URY,Uruguay,ITA,Italy,2011,137,15,122
URY,Uruguay,ITA,Italy,2012,103,15,88
URY,Uruguay,ITA,Italy,2013,99,20,79
URY,Uruguay,ITA,Italy,2014,71,9,62
URY,Uruguay,ITA,Italy,2015,62,15,47
URY,Uruguay,ITA,Italy,2016,66,0,66
URY,Uruguay,ITA,Italy,2017,86,12,74
URY,Uruguay,JPN,Japan,2008,73,61,12
URY,Uruguay,JPN,Japan,2009,60,63,-3
URY,Uruguay,JPN,Japan,2010,61,58,3
URY,Uruguay,JPN,Japan,2011,55,58,-3
URY,Uruguay,JPN,Japan,2012,41,36,5
URY,Uruguay,JPN,Japan,2013,41,36,5
URY,Uruguay,JPN,Japan,2014,35,30,5
URY,Uruguay,JPN,Japan,2015,45,49,-4
URY,Uruguay,JPN,Japan,2016,35,30,5
URY,Uruguay,JPN,Japan,2017,32,24,8
URY,Uruguay,KOR,Korea,2008,6,6,0
URY,Uruguay,KOR,Korea,2009,14,4,10
URY,Uruguay,KOR,Korea,2010,7,11,-4
URY,Uruguay,KOR,Korea,2011,7,7,0
URY,Uruguay,KOR,Korea,2012,12,12,0
URY,Uruguay,KOR,Korea,2013,8,10,-2
URY,Uruguay,KOR,Korea,2014,7,3,4
URY,Uruguay,KOR,Korea,2015,5,6,-1
URY,Uruguay,KOR,Korea,2016,8,7,1
URY,Uruguay,KOR,Korea,2017,11,9,2
URY,Uruguay,LUX,Luxembourg,2008,1,2,-1
URY,Uruguay,LUX,Luxembourg,2009,8,1,7
URY,Uruguay,LUX,Luxembourg,2010,2,1,1
URY,Uruguay,LUX,Luxembourg,2011,2,1,1
URY,Uruguay,LUX,Luxembourg,2012,0,0,0
URY,Uruguay,LUX,Luxembourg,2013,1,3,-2
URY,Uruguay,LUX,Luxembourg,2014,4,3,1
URY,Uruguay,LUX,Luxembourg,2015,0,0,0
URY,Uruguay,LUX,Luxembourg,2016,2,5,-3
URY,Uruguay,LUX,Luxembourg,2017,0,1,-1
URY,Uruguay,MEX,Mexico,2008,135,0,135
URY,Uruguay,MEX,Mexico,2009,231,0,231
URY,Uruguay,MEX,Mexico,2010,232,0,232
URY,Uruguay,MEX,Mexico,2011,160,0,160
URY,Uruguay,MEX,Mexico,2012,122,0,122
URY,Uruguay,MEX,Mexico,2013,480,0,480
URY,Uruguay,MEX,Mexico,2014,292,0,292
URY,Uruguay,MEX,Mexico,2015,194,0,194
URY,Uruguay,MEX,Mexico,2016,184,0,184
URY,Uruguay,MEX,Mexico,2017,129,0,129
URY,Uruguay,NLD,Netherlands,2008,21,8,13
URY,Uruguay,NLD,Netherlands,2009,12,19,-7
URY,Uruguay,NLD,Netherlands,2010,13,16,-3
URY,Uruguay,NLD,Netherlands,2011,14,6,8
URY,Uruguay,NLD,Netherlands,2012,21,11,10
URY,Uruguay,NLD,Netherlands,2013,24,18,6
URY,Uruguay,NLD,Netherlands,2014,25,23,2
URY,Uruguay,NLD,Netherlands,2015,17,16,1
URY,Uruguay,NLD,Netherlands,2016,30,9,21
URY,Uruguay,NLD,Netherlands,2017,24,15,9
URY,Uruguay,NZL,New Zealand,2008,101,15,86
URY,Uruguay,NZL,New Zealand,2009,91,40,51
URY,Uruguay,NZL,New Zealand,2010,100,42,58
URY,Uruguay,NZL,New Zealand,2011,141,44,97
URY,Uruguay,NZL,New Zealand,2012,115,44,71
URY,Uruguay,NZL,New Zealand,2013,131,25,106
URY,Uruguay,NZL,New Zealand,2014,151,37,114
URY,Uruguay,NZL,New Zealand,2015,159,52,107
URY,Uruguay,NZL,New Zealand,2016,160,50,110
URY,Uruguay,NZL,New Zealand,2017,170,89,81
URY,Uruguay,NOR,Norway,2008,9,3,6
URY,Uruguay,NOR,Norway,2009,6,1,5
URY,Uruguay,NOR,Norway,2010,6,3,3
URY,Uruguay,NOR,Norway,2011,9,2,7
URY,Uruguay,NOR,Norway,2012,2,6,-4
URY,Uruguay,NOR,Norway,2013,5,1,4
URY,Uruguay,NOR,Norway,2014,6,1,5
URY,Uruguay,NOR,Norway,2015,3,2,1
URY,Uruguay,NOR,Norway,2016,1,2,-1
URY,Uruguay,NOR,Norway,2017,7,3,4
URY,Uruguay,POL,Poland,2009,4,0,4
URY,Uruguay,POL,Poland,2010,4,0,4
URY,Uruguay,POL,Poland,2011,5,0,5
URY,Uruguay,POL,Poland,2012,5,0,5
URY,Uruguay,POL,Poland,2013,3,0,3
URY,Uruguay,POL,Poland,2014,0,0,0
URY,Uruguay,POL,Poland,2015,5,0,5
URY,Uruguay,POL,Poland,2016,9,0,9
URY,Uruguay,POL,Poland,2017,6,0,6
URY,Uruguay,SVK,Slovak Republic,2008,2,1,1
URY,Uruguay,SVK,Slovak Republic,2009,4,0,4
URY,Uruguay,SVK,Slovak Republic,2010,1,2,-1
URY,Uruguay,SVK,Slovak Republic,2015,1,0,1
URY,Uruguay,ESP,Spain,2008,4332,2749,1583
URY,Uruguay,ESP,Spain,2009,1669,3751,-2082
URY,Uruguay,ESP,Spain,2010,1466,3412,-1946
URY,Uruguay,ESP,Spain,2011,1324,3022,-1698
URY,Uruguay,ESP,Spain,2012,991,2653,-1662
URY,Uruguay,ESP,Spain,2013,918,2824,-1906
URY,Uruguay,ESP,Spain,2014,1027,1525,-498
URY,Uruguay,ESP,Spain,2015,1245,923,322
URY,Uruguay,ESP,Spain,2016,1851,737,1114
URY,Uruguay,ESP,Spain,2017,2437,1209,1228
URY,Uruguay,SWE,Sweden,2008,32,12,20
URY,Uruguay,SWE,Sweden,2009,25,4,21
URY,Uruguay,SWE,Sweden,2010,17,13,4
URY,Uruguay,SWE,Sweden,2011,13,4,9
URY,Uruguay,SWE,Sweden,2012,15,7,8
URY,Uruguay,SWE,Sweden,2013,12,14,-2
URY,Uruguay,SWE,Sweden,2014,12,4,8
URY,Uruguay,SWE,Sweden,2015,15,12,3
URY,Uruguay,SWE,Sweden,2016,16,11,5
URY,Uruguay,SWE,Sweden,2017,17,6,11
URY,Uruguay,CHE,Switzerland,2010,52,25,27
URY,Uruguay,CHE,Switzerland,2011,34,18,16
URY,Uruguay,CHE,Switzerland,2012,35,29,6
URY,Uruguay,CHE,Switzerland,2013,13,18,-5
URY,Uruguay,CHE,Switzerland,2014,39,13,26
URY,Uruguay,CHE,Switzerland,2015,22,23,-1
URY,Uruguay,CHE,Switzerland,2016,19,22,-3
URY,Uruguay,CHE,Switzerland,2017,17,12,5
URY,Uruguay,GBR,United Kingdom,2012,1000,0,1000
URY,Uruguay,USA,United States,2008,1451,0,1451
URY,Uruguay,USA,United States,2009,1775,0,1775
URY,Uruguay,USA,United States,2010,1331,0,1331
URY,Uruguay,USA,United States,2011,1553,0,1553
URY,Uruguay,USA,United States,2012,1374,0,1374
URY,Uruguay,USA,United States,2013,1352,0,1352
URY,Uruguay,USA,United States,2014,1128,0,1128
URY,Uruguay,USA,United States,2015,1078,0,1078
URY,Uruguay,USA,United States,2016,972,0,972
URY,Uruguay,USA,United States,2017,1001,0,1001
URY,Uruguay,CHL,Chile,2008,594,0,594
URY,Uruguay,CHL,Chile,2009,398,0,398
URY,Uruguay,CHL,Chile,2010,482,0,482
URY,Uruguay,CHL,Chile,2011,462,0,462
URY,Uruguay,CHL,Chile,2012,447,0,447
URY,Uruguay,CHL,Chile,2013,442,0,442
URY,Uruguay,CHL,Chile,2014,415,0,415
URY,Uruguay,CHL,Chile,2015,515,0,515
URY,Uruguay,CHL,Chile,2016,434,0,434
URY,Uruguay,EST,Estonia,2008,0,0,0
URY,Uruguay,EST,Estonia,2009,0,0,0
URY,Uruguay,EST,Estonia,2010,0,0,0
URY,Uruguay,EST,Estonia,2011,0,0,0
URY,Uruguay,EST,Estonia,2012,0,0,0
URY,Uruguay,EST,Estonia,2013,0,0,0
URY,Uruguay,EST,Estonia,2014,0,0,0
URY,Uruguay,EST,Estonia,2015,1,0,1
URY,Uruguay,EST,Estonia,2016,1,0,1
URY,Uruguay,EST,Estonia,2017,0,0,0
URY,Uruguay,ISR,Israel,2008,79,0,79
URY,Uruguay,ISR,Israel,2009,87,0,87
URY,Uruguay,ISR,Israel,2010,90,0,90
URY,Uruguay,ISR,Israel,2011,48,0,48
URY,Uruguay,ISR,Israel,2012,67,0,67
URY,Uruguay,ISR,Israel,2013,62,0,62
URY,Uruguay,ISR,Israel,2014,52,0,52
URY,Uruguay,ISR,Israel,2015,65,0,65
URY,Uruguay,ISR,Israel,2016,58,0,58
URY,Uruguay,ISR,Israel,2017,69,0,69
URY,Uruguay,SVN,Slovenia,2008,1,0,1
URY,Uruguay,SVN,Slovenia,2009,1,0,1
URY,Uruguay,SVN,Slovenia,2015,3,0,3
URY,Uruguay,SVN,Slovenia,2016,1,0,1
UZB,Uzbekistan,AUS,Australia,2008,92,13,79
UZB,Uzbekistan,AUS,Australia,2009,78,5,73
UZB,Uzbekistan,AUS,Australia,2010,76,0,76
UZB,Uzbekistan,AUS,Australia,2011,73,6,67
UZB,Uzbekistan,AUS,Australia,2012,98,0,98
UZB,Uzbekistan,AUS,Australia,2013,96,9,87
UZB,Uzbekistan,AUS,Australia,2014,80,17,63
UZB,Uzbekistan,AUS,Australia,2015,72,0,72
UZB,Uzbekistan,AUS,Australia,2016,72,0,72
UZB,Uzbekistan,AUS,Australia,2017,61,0,61
UZB,Uzbekistan,AUT,Austria,2008,45,19,26
UZB,Uzbekistan,AUT,Austria,2009,69,27,42
UZB,Uzbekistan,AUT,Austria,2010,38,28,10
UZB,Uzbekistan,AUT,Austria,2011,55,23,32
UZB,Uzbekistan,AUT,Austria,2012,60,39,21
UZB,Uzbekistan,AUT,Austria,2013,62,37,25
UZB,Uzbekistan,AUT,Austria,2014,78,27,51
UZB,Uzbekistan,AUT,Austria,2015,67,26,41
UZB,Uzbekistan,AUT,Austria,2016,69,29,40
UZB,Uzbekistan,AUT,Austria,2017,70,53,17
UZB,Uzbekistan,BEL,Belgium,2008,66,0,66
UZB,Uzbekistan,BEL,Belgium,2009,62,0,62
UZB,Uzbekistan,BEL,Belgium,2010,56,14,42
UZB,Uzbekistan,BEL,Belgium,2012,43,36,7
UZB,Uzbekistan,BEL,Belgium,2013,27,30,-3
UZB,Uzbekistan,BEL,Belgium,2014,25,23,2
UZB,Uzbekistan,BEL,Belgium,2015,24,19,5
UZB,Uzbekistan,BEL,Belgium,2016,19,20,-1
UZB,Uzbekistan,BEL,Belgium,2017,26,29,-3
UZB,Uzbekistan,CAN,Canada,2008,215,0,215
UZB,Uzbekistan,CAN,Canada,2009,288,0,288
UZB,Uzbekistan,CAN,Canada,2010,289,0,289
UZB,Uzbekistan,CAN,Canada,2011,162,0,162
UZB,Uzbekistan,CAN,Canada,2012,234,0,234
UZB,Uzbekistan,CAN,Canada,2013,167,0,167
UZB,Uzbekistan,CAN,Canada,2014,164,0,164
UZB,Uzbekistan,CAN,Canada,2015,189,0,189
UZB,Uzbekistan,CAN,Canada,2016,215,0,215
UZB,Uzbekistan,CAN,Canada,2017,180,0,180
UZB,Uzbekistan,CZE,Czech Republic,2008,1459,2,1457
UZB,Uzbekistan,CZE,Czech Republic,2009,456,1,455
UZB,Uzbekistan,CZE,Czech Republic,2010,139,1,138
UZB,Uzbekistan,CZE,Czech Republic,2011,95,3,92
UZB,Uzbekistan,CZE,Czech Republic,2012,201,188,13
UZB,Uzbekistan,CZE,Czech Republic,2013,147,327,-180
UZB,Uzbekistan,CZE,Czech Republic,2014,325,135,190
UZB,Uzbekistan,CZE,Czech Republic,2015,168,136,32
UZB,Uzbekistan,CZE,Czech Republic,2016,259,74,185
UZB,Uzbekistan,CZE,Czech Republic,2017,376,100,276
UZB,Uzbekistan,DNK,Denmark,2008,22,18,4
UZB,Uzbekistan,DNK,Denmark,2009,12,11,1
UZB,Uzbekistan,DNK,Denmark,2010,16,14,2
UZB,Uzbekistan,DNK,Denmark,2011,22,4,18
UZB,Uzbekistan,DNK,Denmark,2012,14,13,1
UZB,Uzbekistan,DNK,Denmark,2013,33,1,32
UZB,Uzbekistan,DNK,Denmark,2014,14,12,2
UZB,Uzbekistan,DNK,Denmark,2015,16,6,10
UZB,Uzbekistan,DNK,Denmark,2016,20,26,-6
UZB,Uzbekistan,DNK,Denmark,2017,10,10,0
UZB,Uzbekistan,FIN,Finland,2008,18,3,15
UZB,Uzbekistan,FIN,Finland,2009,24,6,18
UZB,Uzbekistan,FIN,Finland,2010,14,5,9
UZB,Uzbekistan,FIN,Finland,2011,10,1,9
UZB,Uzbekistan,FIN,Finland,2012,14,7,7
UZB,Uzbekistan,FIN,Finland,2013,68,2,66
UZB,Uzbekistan,FIN,Finland,2014,35,1,34
UZB,Uzbekistan,FIN,Finland,2015,29,2,27
UZB,Uzbekistan,FIN,Finland,2016,96,3,93
UZB,Uzbekistan,FIN,Finland,2017,213,3,210
UZB,Uzbekistan,FRA,France,2008,85,0,85
UZB,Uzbekistan,FRA,France,2009,64,0,64
UZB,Uzbekistan,FRA,France,2010,64,0,64
UZB,Uzbekistan,FRA,France,2011,63,0,63
UZB,Uzbekistan,FRA,France,2012,51,0,51
UZB,Uzbekistan,FRA,France,2013,57,0,57
UZB,Uzbekistan,FRA,France,2014,66,0,66
UZB,Uzbekistan,FRA,France,2015,50,0,50
UZB,Uzbekistan,FRA,France,2016,44,0,44
UZB,Uzbekistan,FRA,France,2017,47,0,47
UZB,Uzbekistan,DEU,Germany,2008,745,491,254
UZB,Uzbekistan,DEU,Germany,2009,721,577,144
UZB,Uzbekistan,DEU,Germany,2010,742,467,275
UZB,Uzbekistan,DEU,Germany,2011,755,464,291
UZB,Uzbekistan,DEU,Germany,2012,618,470,148
UZB,Uzbekistan,DEU,Germany,2013,516,430,86
UZB,Uzbekistan,DEU,Germany,2014,513,380,133
UZB,Uzbekistan,DEU,Germany,2015,636,345,291
UZB,Uzbekistan,DEU,Germany,2016,678,337,341
UZB,Uzbekistan,DEU,Germany,2017,705,338,367
UZB,Uzbekistan,HUN,Hungary,2008,24,2,22
UZB,Uzbekistan,HUN,Hungary,2009,11,2,9
UZB,Uzbekistan,HUN,Hungary,2010,15,2,13
UZB,Uzbekistan,HUN,Hungary,2011,8,4,4
UZB,Uzbekistan,HUN,Hungary,2012,16,0,16
UZB,Uzbekistan,HUN,Hungary,2013,18,1,17
UZB,Uzbekistan,HUN,Hungary,2014,23,0,23
UZB,Uzbekistan,HUN,Hungary,2015,27,3,24
UZB,Uzbekistan,HUN,Hungary,2016,22,4,18
UZB,Uzbekistan,HUN,Hungary,2017,17,0,17
UZB,Uzbekistan,ISL,Iceland,2008,1,0,1
UZB,Uzbekistan,ISL,Iceland,2009,1,1,0
UZB,Uzbekistan,ISL,Iceland,2010,0,0,0
UZB,Uzbekistan,ISL,Iceland,2011,1,0,1
UZB,Uzbekistan,ISL,Iceland,2012,3,0,3
UZB,Uzbekistan,ISL,Iceland,2013,0,0,0
UZB,Uzbekistan,ISL,Iceland,2014,1,1,0
UZB,Uzbekistan,ISL,Iceland,2015,3,1,2
UZB,Uzbekistan,ISL,Iceland,2016,0,2,-2
UZB,Uzbekistan,ISL,Iceland,2017,2,1,1
UZB,Uzbekistan,ITA,Italy,2008,106,11,95
UZB,Uzbekistan,ITA,Italy,2009,110,15,95
UZB,Uzbekistan,ITA,Italy,2010,126,13,113
UZB,Uzbekistan,ITA,Italy,2011,67,5,62
UZB,Uzbekistan,ITA,Italy,2012,62,15,47
UZB,Uzbekistan,ITA,Italy,2013,70,16,54
UZB,Uzbekistan,ITA,Italy,2014,63,11,52
UZB,Uzbekistan,ITA,Italy,2015,35,18,17
UZB,Uzbekistan,ITA,Italy,2016,41,0,41
UZB,Uzbekistan,ITA,Italy,2017,36,7,29
UZB,Uzbekistan,JPN,Japan,2008,373,306,67
UZB,Uzbekistan,JPN,Japan,2009,339,260,79
UZB,Uzbekistan,JPN,Japan,2010,425,297,128
UZB,Uzbekistan,JPN,Japan,2011,432,366,66
UZB,Uzbekistan,JPN,Japan,2012,433,279,154
UZB,Uzbekistan,JPN,Japan,2013,456,282,174
UZB,Uzbekistan,JPN,Japan,2014,509,264,245
UZB,Uzbekistan,JPN,Japan,2015,514,277,237
UZB,Uzbekistan,JPN,Japan,2016,734,303,431
UZB,Uzbekistan,JPN,Japan,2017,1400,302,1098
UZB,Uzbekistan,KOR,Korea,2008,9441,5471,3970
UZB,Uzbekistan,KOR,Korea,2009,4684,5162,-478
UZB,Uzbekistan,KOR,Korea,2010,8567,4387,4180
UZB,Uzbekistan,KOR,Korea,2011,8180,5404,2776
UZB,Uzbekistan,KOR,Korea,2012,11354,7756,3598
UZB,Uzbekistan,KOR,Korea,2013,12333,9161,3172
UZB,Uzbekistan,KOR,Korea,2014,12920,9876,3044
UZB,Uzbekistan,KOR,Korea,2015,14246,11140,3106
UZB,Uzbekistan,KOR,Korea,2016,16151,9845,6306
UZB,Uzbekistan,KOR,Korea,2017,18486,12096,6390
UZB,Uzbekistan,LUX,Luxembourg,2008,7,0,7
UZB,Uzbekistan,LUX,Luxembourg,2009,2,0,2
UZB,Uzbekistan,LUX,Luxembourg,2010,1,0,1
UZB,Uzbekistan,LUX,Luxembourg,2011,1,0,1
UZB,Uzbekistan,LUX,Luxembourg,2012,2,0,2
UZB,Uzbekistan,LUX,Luxembourg,2013,1,0,1
UZB,Uzbekistan,LUX,Luxembourg,2014,1,0,1
UZB,Uzbekistan,LUX,Luxembourg,2015,3,0,3
UZB,Uzbekistan,LUX,Luxembourg,2016,2,1,1
UZB,Uzbekistan,LUX,Luxembourg,2017,5,0,5
UZB,Uzbekistan,MEX,Mexico,2008,4,0,4
UZB,Uzbekistan,MEX,Mexico,2009,4,0,4
UZB,Uzbekistan,MEX,Mexico,2010,2,0,2
UZB,Uzbekistan,MEX,Mexico,2011,5,0,5
UZB,Uzbekistan,MEX,Mexico,2012,0,0,0
UZB,Uzbekistan,MEX,Mexico,2013,4,0,4
UZB,Uzbekistan,MEX,Mexico,2014,2,0,2
UZB,Uzbekistan,MEX,Mexico,2015,6,0,6
UZB,Uzbekistan,MEX,Mexico,2016,2,0,2
UZB,Uzbekistan,MEX,Mexico,2017,4,0,4
UZB,Uzbekistan,NLD,Netherlands,2009,32,11,21
UZB,Uzbekistan,NLD,Netherlands,2010,28,16,12
UZB,Uzbekistan,NLD,Netherlands,2011,41,11,30
UZB,Uzbekistan,NLD,Netherlands,2012,39,17,22
UZB,Uzbekistan,NLD,Netherlands,2013,28,26,2
UZB,Uzbekistan,NLD,Netherlands,2014,58,20,38
UZB,Uzbekistan,NLD,Netherlands,2015,32,15,17
UZB,Uzbekistan,NLD,Netherlands,2016,42,21,21
UZB,Uzbekistan,NLD,Netherlands,2017,44,27,17
UZB,Uzbekistan,NZL,New Zealand,2008,7,1,6
UZB,Uzbekistan,NZL,New Zealand,2009,17,5,12
UZB,Uzbekistan,NZL,New Zealand,2010,3,6,-3
UZB,Uzbekistan,NZL,New Zealand,2011,8,5,3
UZB,Uzbekistan,NZL,New Zealand,2012,8,1,7
UZB,Uzbekistan,NZL,New Zealand,2013,17,2,15
UZB,Uzbekistan,NZL,New Zealand,2014,18,2,16
UZB,Uzbekistan,NZL,New Zealand,2015,20,6,14
UZB,Uzbekistan,NZL,New Zealand,2016,19,5,14
UZB,Uzbekistan,NZL,New Zealand,2017,17,6,11
UZB,Uzbekistan,NOR,Norway,2008,57,0,57
UZB,Uzbekistan,NOR,Norway,2009,21,6,15
UZB,Uzbekistan,NOR,Norway,2010,28,5,23
UZB,Uzbekistan,NOR,Norway,2011,45,4,41
UZB,Uzbekistan,NOR,Norway,2012,38,19,19
UZB,Uzbekistan,NOR,Norway,2013,38,9,29
UZB,Uzbekistan,NOR,Norway,2014,41,8,33
UZB,Uzbekistan,NOR,Norway,2015,48,9,39
UZB,Uzbekistan,NOR,Norway,2016,78,6,72
UZB,Uzbekistan,NOR,Norway,2017,48,5,43
UZB,Uzbekistan,POL,Poland,2008,163,0,163
UZB,Uzbekistan,POL,Poland,2009,151,0,151
UZB,Uzbekistan,POL,Poland,2010,161,0,161
UZB,Uzbekistan,POL,Poland,2011,183,0,183
UZB,Uzbekistan,POL,Poland,2012,183,0,183
UZB,Uzbekistan,POL,Poland,2013,215,0,215
UZB,Uzbekistan,POL,Poland,2014,158,0,158
UZB,Uzbekistan,POL,Poland,2015,511,0,511
UZB,Uzbekistan,POL,Poland,2016,877,0,877
UZB,Uzbekistan,POL,Poland,2017,781,0,781
UZB,Uzbekistan,SVK,Slovak Republic,2008,2,3,-1
UZB,Uzbekistan,SVK,Slovak Republic,2009,1,2,-1
UZB,Uzbekistan,SVK,Slovak Republic,2010,1,3,-2
UZB,Uzbekistan,SVK,Slovak Republic,2011,4,0,4
UZB,Uzbekistan,SVK,Slovak Republic,2012,1,0,1
UZB,Uzbekistan,SVK,Slovak Republic,2015,4,0,4
UZB,Uzbekistan,SVK,Slovak Republic,2017,1,0,1
UZB,Uzbekistan,ESP,Spain,2008,71,42,29
UZB,Uzbekistan,ESP,Spain,2009,52,49,3
UZB,Uzbekistan,ESP,Spain,2010,60,46,14
UZB,Uzbekistan,ESP,Spain,2011,96,46,50
UZB,Uzbekistan,ESP,Spain,2012,74,17,57
UZB,Uzbekistan,ESP,Spain,2013,77,69,8
UZB,Uzbekistan,ESP,Spain,2014,70,34,36
UZB,Uzbekistan,ESP,Spain,2015,64,28,36
UZB,Uzbekistan,ESP,Spain,2016,82,27,55
UZB,Uzbekistan,ESP,Spain,2017,65,39,26
UZB,Uzbekistan,SWE,Sweden,2008,222,18,204
UZB,Uzbekistan,SWE,Sweden,2009,231,18,213
UZB,Uzbekistan,SWE,Sweden,2010,307,11,296
UZB,Uzbekistan,SWE,Sweden,2011,400,28,372
UZB,Uzbekistan,SWE,Sweden,2012,343,28,315
UZB,Uzbekistan,SWE,Sweden,2013,235,42,193
UZB,Uzbekistan,SWE,Sweden,2014,222,50,172
UZB,Uzbekistan,SWE,Sweden,2015,214,67,147
UZB,Uzbekistan,SWE,Sweden,2016,218,43,175
UZB,Uzbekistan,SWE,Sweden,2017,211,32,179
UZB,Uzbekistan,CHE,Switzerland,2010,66,14,52
UZB,Uzbekistan,CHE,Switzerland,2011,59,33,26
UZB,Uzbekistan,CHE,Switzerland,2012,62,9,53
UZB,Uzbekistan,CHE,Switzerland,2013,73,27,46
UZB,Uzbekistan,CHE,Switzerland,2015,61,26,35
UZB,Uzbekistan,CHE,Switzerland,2016,49,20,29
UZB,Uzbekistan,CHE,Switzerland,2017,20,20,0
UZB,Uzbekistan,TUR,Turkey,2010,575,0,575
UZB,Uzbekistan,TUR,Turkey,2016,8975,3236,5739
UZB,Uzbekistan,TUR,Turkey,2017,17871,5528,12343
UZB,Uzbekistan,USA,United States,2008,6375,0,6375
UZB,Uzbekistan,USA,United States,2009,5467,0,5467
UZB,Uzbekistan,USA,United States,2010,4770,0,4770
UZB,Uzbekistan,USA,United States,2011,5056,0,5056
UZB,Uzbekistan,USA,United States,2012,4726,0,4726
UZB,Uzbekistan,USA,United States,2013,4382,0,4382
UZB,Uzbekistan,USA,United States,2014,5194,0,5194
UZB,Uzbekistan,USA,United States,2015,3977,0,3977
UZB,Uzbekistan,USA,United States,2016,4359,0,4359
UZB,Uzbekistan,USA,United States,2017,4095,0,4095
UZB,Uzbekistan,CHL,Chile,2008,2,0,2
UZB,Uzbekistan,CHL,Chile,2009,0,0,0
UZB,Uzbekistan,CHL,Chile,2010,0,0,0
UZB,Uzbekistan,CHL,Chile,2011,1,0,1
UZB,Uzbekistan,CHL,Chile,2012,2,0,2
UZB,Uzbekistan,CHL,Chile,2013,0,0,0
UZB,Uzbekistan,CHL,Chile,2014,0,0,0
UZB,Uzbekistan,CHL,Chile,2015,0,0,0
UZB,Uzbekistan,CHL,Chile,2016,4,0,4
UZB,Uzbekistan,EST,Estonia,2008,1,0,1
UZB,Uzbekistan,EST,Estonia,2009,5,0,5
UZB,Uzbekistan,EST,Estonia,2010,0,0,0
UZB,Uzbekistan,EST,Estonia,2011,5,0,5
UZB,Uzbekistan,EST,Estonia,2012,3,0,3
UZB,Uzbekistan,EST,Estonia,2013,6,0,6
UZB,Uzbekistan,EST,Estonia,2014,8,0,8
UZB,Uzbekistan,EST,Estonia,2015,6,0,6
UZB,Uzbekistan,EST,Estonia,2016,7,0,7
UZB,Uzbekistan,EST,Estonia,2017,6,0,6
UZB,Uzbekistan,SVN,Slovenia,2008,5,0,5
UZB,Uzbekistan,SVN,Slovenia,2009,7,0,7
UZB,Uzbekistan,SVN,Slovenia,2010,4,0,4
UZB,Uzbekistan,SVN,Slovenia,2011,5,3,2
UZB,Uzbekistan,SVN,Slovenia,2013,3,0,3
UZB,Uzbekistan,SVN,Slovenia,2014,4,0,4
UZB,Uzbekistan,SVN,Slovenia,2015,7,0,7
UZB,Uzbekistan,SVN,Slovenia,2016,5,0,5
UZB,Uzbekistan,SVN,Slovenia,2017,4,0,4
VUT,Vanuatu,AUS,Australia,2008,25,10,15
VUT,Vanuatu,AUS,Australia,2009,14,11,3
VUT,Vanuatu,AUS,Australia,2010,34,7,27
VUT,Vanuatu,AUS,Australia,2011,24,8,16
VUT,Vanuatu,AUS,Australia,2012,27,9,18
VUT,Vanuatu,AUS,Australia,2013,35,7,28
VUT,Vanuatu,AUS,Australia,2014,14,7,7
VUT,Vanuatu,AUS,Australia,2015,25,0,25
VUT,Vanuatu,AUS,Australia,2016,20,0,20
VUT,Vanuatu,AUS,Australia,2017,15,0,15
VUT,Vanuatu,AUT,Austria,2008,5,0,5
VUT,Vanuatu,AUT,Austria,2009,0,1,-1
VUT,Vanuatu,AUT,Austria,2010,0,0,0
VUT,Vanuatu,AUT,Austria,2011,1,0,1
VUT,Vanuatu,AUT,Austria,2012,0,1,-1
VUT,Vanuatu,AUT,Austria,2013,0,0,0
VUT,Vanuatu,AUT,Austria,2014,0,0,0
VUT,Vanuatu,AUT,Austria,2015,0,0,0
VUT,Vanuatu,AUT,Austria,2016,0,0,0
VUT,Vanuatu,AUT,Austria,2017,0,0,0
VUT,Vanuatu,BEL,Belgium,2008,0,0,0
VUT,Vanuatu,BEL,Belgium,2009,0,0,0
VUT,Vanuatu,BEL,Belgium,2010,0,0,0
VUT,Vanuatu,BEL,Belgium,2013,2,0,2
VUT,Vanuatu,BEL,Belgium,2014,1,1,0
VUT,Vanuatu,CAN,Canada,2008,0,0,0
VUT,Vanuatu,CAN,Canada,2009,1,0,1
VUT,Vanuatu,CAN,Canada,2010,0,0,0
VUT,Vanuatu,CAN,Canada,2011,0,0,0
VUT,Vanuatu,CAN,Canada,2012,0,0,0
VUT,Vanuatu,CAN,Canada,2013,0,0,0
VUT,Vanuatu,CAN,Canada,2014,2,0,2
VUT,Vanuatu,CAN,Canada,2015,0,0,0
VUT,Vanuatu,CAN,Canada,2016,0,0,0
VUT,Vanuatu,CAN,Canada,2017,0,0,0
VUT,Vanuatu,CZE,Czech Republic,2009,1,0,1
VUT,Vanuatu,CZE,Czech Republic,2013,1,0,1
VUT,Vanuatu,DNK,Denmark,2014,0,0,0
VUT,Vanuatu,DNK,Denmark,2015,0,0,0
VUT,Vanuatu,DNK,Denmark,2016,0,2,-2
VUT,Vanuatu,DNK,Denmark,2017,0,1,-1
VUT,Vanuatu,FIN,Finland,2008,1,0,1
VUT,Vanuatu,FIN,Finland,2009,0,0,0
VUT,Vanuatu,FIN,Finland,2010,0,0,0
VUT,Vanuatu,FIN,Finland,2011,0,0,0
VUT,Vanuatu,FIN,Finland,2012,0,0,0
VUT,Vanuatu,FIN,Finland,2013,0,0,0
VUT,Vanuatu,FIN,Finland,2014,0,0,0
VUT,Vanuatu,FIN,Finland,2015,0,0,0
VUT,Vanuatu,FIN,Finland,2016,0,0,0
VUT,Vanuatu,FIN,Finland,2017,0,0,0
VUT,Vanuatu,FRA,France,2008,1,0,1
VUT,Vanuatu,FRA,France,2009,6,0,6
VUT,Vanuatu,FRA,France,2010,3,0,3
VUT,Vanuatu,FRA,France,2011,3,0,3
VUT,Vanuatu,FRA,France,2012,3,0,3
VUT,Vanuatu,FRA,France,2013,4,0,4
VUT,Vanuatu,FRA,France,2014,2,0,2
VUT,Vanuatu,FRA,France,2015,3,0,3
VUT,Vanuatu,FRA,France,2016,6,0,6
VUT,Vanuatu,FRA,France,2017,2,0,2
VUT,Vanuatu,DEU,Germany,2008,1,3,-2
VUT,Vanuatu,DEU,Germany,2009,2,2,0
VUT,Vanuatu,DEU,Germany,2010,1,1,0
VUT,Vanuatu,DEU,Germany,2011,3,2,1
VUT,Vanuatu,DEU,Germany,2012,0,1,-1
VUT,Vanuatu,DEU,Germany,2013,4,2,2
VUT,Vanuatu,DEU,Germany,2014,6,3,3
VUT,Vanuatu,DEU,Germany,2015,3,3,0
VUT,Vanuatu,DEU,Germany,2016,2,2,0
VUT,Vanuatu,DEU,Germany,2017,3,4,-1
VUT,Vanuatu,HUN,Hungary,2008,0,0,0
VUT,Vanuatu,HUN,Hungary,2009,0,0,0
VUT,Vanuatu,HUN,Hungary,2010,1,0,1
VUT,Vanuatu,HUN,Hungary,2011,0,0,0
VUT,Vanuatu,HUN,Hungary,2012,0,0,0
VUT,Vanuatu,HUN,Hungary,2013,0,0,0
VUT,Vanuatu,HUN,Hungary,2014,0,0,0
VUT,Vanuatu,HUN,Hungary,2015,0,0,0
VUT,Vanuatu,HUN,Hungary,2016,0,0,0
VUT,Vanuatu,HUN,Hungary,2017,0,0,0
VUT,Vanuatu,ISL,Iceland,2016,0,0,0
VUT,Vanuatu,ISL,Iceland,2017,0,0,0
VUT,Vanuatu,ITA,Italy,2008,0,0,0
VUT,Vanuatu,ITA,Italy,2009,0,0,0
VUT,Vanuatu,ITA,Italy,2010,0,0,0
VUT,Vanuatu,ITA,Italy,2011,0,0,0
VUT,Vanuatu,ITA,Italy,2012,0,0,0
VUT,Vanuatu,ITA,Italy,2013,0,0,0
VUT,Vanuatu,ITA,Italy,2015,0,0,0
VUT,Vanuatu,ITA,Italy,2016,2,0,2
VUT,Vanuatu,JPN,Japan,2008,46,47,-1
VUT,Vanuatu,JPN,Japan,2009,54,52,2
VUT,Vanuatu,JPN,Japan,2010,55,54,1
VUT,Vanuatu,JPN,Japan,2011,27,30,-3
VUT,Vanuatu,JPN,Japan,2012,49,47,2
VUT,Vanuatu,JPN,Japan,2013,37,38,-1
VUT,Vanuatu,JPN,Japan,2014,39,40,-1
VUT,Vanuatu,JPN,Japan,2015,60,59,1
VUT,Vanuatu,JPN,Japan,2016,48,45,3
VUT,Vanuatu,JPN,Japan,2017,64,61,3
VUT,Vanuatu,KOR,Korea,2008,0,1,-1
VUT,Vanuatu,KOR,Korea,2009,0,0,0
VUT,Vanuatu,KOR,Korea,2010,1,1,0
VUT,Vanuatu,KOR,Korea,2011,0,0,0
VUT,Vanuatu,KOR,Korea,2012,2,2,0
VUT,Vanuatu,KOR,Korea,2013,0,0,0
VUT,Vanuatu,KOR,Korea,2014,1,0,1
VUT,Vanuatu,KOR,Korea,2015,2,1,1
VUT,Vanuatu,KOR,Korea,2016,0,0,0
VUT,Vanuatu,KOR,Korea,2017,0,3,-3
VUT,Vanuatu,LUX,Luxembourg,2008,0,0,0
VUT,Vanuatu,LUX,Luxembourg,2009,0,0,0
VUT,Vanuatu,LUX,Luxembourg,2010,0,0,0
VUT,Vanuatu,LUX,Luxembourg,2011,0,0,0
VUT,Vanuatu,LUX,Luxembourg,2012,0,0,0
VUT,Vanuatu,LUX,Luxembourg,2013,1,0,1
VUT,Vanuatu,LUX,Luxembourg,2014,0,1,-1
VUT,Vanuatu,LUX,Luxembourg,2015,0,0,0
VUT,Vanuatu,LUX,Luxembourg,2016,0,0,0
VUT,Vanuatu,LUX,Luxembourg,2017,0,0,0
VUT,Vanuatu,MEX,Mexico,2008,1,0,1
VUT,Vanuatu,MEX,Mexico,2009,1,0,1
VUT,Vanuatu,MEX,Mexico,2010,2,0,2
VUT,Vanuatu,MEX,Mexico,2012,0,0,0
VUT,Vanuatu,MEX,Mexico,2013,0,0,0
VUT,Vanuatu,MEX,Mexico,2014,0,0,0
VUT,Vanuatu,NLD,Netherlands,2011,1,0,1
VUT,Vanuatu,NZL,New Zealand,2008,31,17,14
VUT,Vanuatu,NZL,New Zealand,2009,34,25,9
VUT,Vanuatu,NZL,New Zealand,2010,46,11,35
VUT,Vanuatu,NZL,New Zealand,2011,51,28,23
VUT,Vanuatu,NZL,New Zealand,2012,49,18,31
VUT,Vanuatu,NZL,New Zealand,2013,50,16,34
VUT,Vanuatu,NZL,New Zealand,2014,48,14,34
VUT,Vanuatu,NZL,New Zealand,2015,38,14,24
VUT,Vanuatu,NZL,New Zealand,2016,68,15,53
VUT,Vanuatu,NZL,New Zealand,2017,54,15,39
VUT,Vanuatu,NOR,Norway,2008,0,0,0
VUT,Vanuatu,NOR,Norway,2009,0,1,-1
VUT,Vanuatu,NOR,Norway,2010,0,0,0
VUT,Vanuatu,NOR,Norway,2011,0,0,0
VUT,Vanuatu,NOR,Norway,2012,0,0,0
VUT,Vanuatu,NOR,Norway,2013,0,0,0
VUT,Vanuatu,NOR,Norway,2014,0,0,0
VUT,Vanuatu,NOR,Norway,2015,0,0,0
VUT,Vanuatu,NOR,Norway,2016,0,0,0
VUT,Vanuatu,NOR,Norway,2017,0,0,0
VUT,Vanuatu,POL,Poland,2009,0,0,0
VUT,Vanuatu,POL,Poland,2010,0,0,0
VUT,Vanuatu,POL,Poland,2011,0,0,0
VUT,Vanuatu,POL,Poland,2012,0,0,0
VUT,Vanuatu,POL,Poland,2013,0,0,0
VUT,Vanuatu,POL,Poland,2014,0,0,0
VUT,Vanuatu,POL,Poland,2015,0,0,0
VUT,Vanuatu,POL,Poland,2016,0,0,0
VUT,Vanuatu,POL,Poland,2017,1,0,1
VUT,Vanuatu,SVK,Slovak Republic,2008,0,0,0
VUT,Vanuatu,SVK,Slovak Republic,2010,1,0,1
VUT,Vanuatu,SVK,Slovak Republic,2011,1,0,1
VUT,Vanuatu,ESP,Spain,2008,0,0,0
VUT,Vanuatu,ESP,Spain,2009,1,0,1
VUT,Vanuatu,ESP,Spain,2010,0,0,0
VUT,Vanuatu,ESP,Spain,2011,1,0,1
VUT,Vanuatu,ESP,Spain,2012,0,0,0
VUT,Vanuatu,ESP,Spain,2013,0,0,0
VUT,Vanuatu,ESP,Spain,2014,0,0,0
VUT,Vanuatu,ESP,Spain,2015,0,0,0
VUT,Vanuatu,ESP,Spain,2016,3,0,3
VUT,Vanuatu,ESP,Spain,2017,2,0,2
VUT,Vanuatu,SWE,Sweden,2008,0,0,0
VUT,Vanuatu,SWE,Sweden,2009,1,0,1
VUT,Vanuatu,SWE,Sweden,2010,0,0,0
VUT,Vanuatu,SWE,Sweden,2011,0,0,0
VUT,Vanuatu,SWE,Sweden,2012,0,0,0
VUT,Vanuatu,SWE,Sweden,2013,0,0,0
VUT,Vanuatu,SWE,Sweden,2014,0,0,0
VUT,Vanuatu,SWE,Sweden,2015,0,0,0
VUT,Vanuatu,SWE,Sweden,2016,1,0,1
VUT,Vanuatu,SWE,Sweden,2017,0,0,0
VUT,Vanuatu,CHE,Switzerland,2010,0,0,0
VUT,Vanuatu,CHE,Switzerland,2011,0,0,0
VUT,Vanuatu,CHE,Switzerland,2012,0,1,-1
VUT,Vanuatu,CHE,Switzerland,2013,0,0,0
VUT,Vanuatu,USA,United States,2008,5,0,5
VUT,Vanuatu,USA,United States,2009,6,0,6
VUT,Vanuatu,USA,United States,2010,5,0,5
VUT,Vanuatu,USA,United States,2011,4,0,4
VUT,Vanuatu,USA,United States,2012,3,0,3
VUT,Vanuatu,USA,United States,2013,7,0,7
VUT,Vanuatu,USA,United States,2014,3,0,3
VUT,Vanuatu,USA,United States,2015,4,0,4
VUT,Vanuatu,USA,United States,2016,3,0,3
VUT,Vanuatu,USA,United States,2017,6,0,6
VUT,Vanuatu,CHL,Chile,2008,0,0,0
VUT,Vanuatu,CHL,Chile,2009,0,0,0
VUT,Vanuatu,CHL,Chile,2010,0,0,0
VUT,Vanuatu,CHL,Chile,2011,0,0,0
VUT,Vanuatu,CHL,Chile,2012,0,0,0
VUT,Vanuatu,CHL,Chile,2013,0,0,0
VUT,Vanuatu,CHL,Chile,2014,0,0,0
VUT,Vanuatu,CHL,Chile,2015,0,0,0
VUT,Vanuatu,CHL,Chile,2016,0,0,0
VUT,Vanuatu,EST,Estonia,2008,0,0,0
VUT,Vanuatu,EST,Estonia,2009,0,0,0
VUT,Vanuatu,EST,Estonia,2010,0,0,0
VUT,Vanuatu,EST,Estonia,2011,0,0,0
VUT,Vanuatu,EST,Estonia,2012,0,0,0
VUT,Vanuatu,EST,Estonia,2013,0,0,0
VUT,Vanuatu,EST,Estonia,2014,0,0,0
VUT,Vanuatu,EST,Estonia,2015,0,0,0
VUT,Vanuatu,EST,Estonia,2016,0,0,0
VUT,Vanuatu,EST,Estonia,2017,0,0,0
VEN,Venezuela,AUS,Australia,2008,277,10,267
VEN,Venezuela,AUS,Australia,2009,286,20,266
VEN,Venezuela,AUS,Australia,2010,381,15,366
VEN,Venezuela,AUS,Australia,2011,270,14,256
VEN,Venezuela,AUS,Australia,2012,313,30,283
VEN,Venezuela,AUS,Australia,2013,286,25,261
VEN,Venezuela,AUS,Australia,2014,220,42,178
VEN,Venezuela,AUS,Australia,2015,260,0,260
VEN,Venezuela,AUS,Australia,2016,251,0,251
VEN,Venezuela,AUS,Australia,2017,267,0,267
VEN,Venezuela,AUT,Austria,2008,53,32,21
VEN,Venezuela,AUT,Austria,2009,64,37,27
VEN,Venezuela,AUT,Austria,2010,46,41,5
VEN,Venezuela,AUT,Austria,2011,56,32,24
VEN,Venezuela,AUT,Austria,2012,64,34,30
VEN,Venezuela,AUT,Austria,2013,52,34,18
VEN,Venezuela,AUT,Austria,2014,53,40,13
VEN,Venezuela,AUT,Austria,2015,91,26,65
VEN,Venezuela,AUT,Austria,2016,95,39,56
VEN,Venezuela,AUT,Austria,2017,137,41,96
VEN,Venezuela,BEL,Belgium,2008,102,0,102
VEN,Venezuela,BEL,Belgium,2009,80,0,80
VEN,Venezuela,BEL,Belgium,2010,127,54,73
VEN,Venezuela,BEL,Belgium,2011,114,0,114
VEN,Venezuela,BEL,Belgium,2012,106,57,49
VEN,Venezuela,BEL,Belgium,2013,90,84,6
VEN,Venezuela,BEL,Belgium,2014,92,52,40
VEN,Venezuela,BEL,Belgium,2015,109,38,71
VEN,Venezuela,BEL,Belgium,2016,136,24,112
VEN,Venezuela,BEL,Belgium,2017,275,40,235
VEN,Venezuela,CAN,Canada,2008,1239,0,1239
VEN,Venezuela,CAN,Canada,2009,1352,0,1352
VEN,Venezuela,CAN,Canada,2010,998,0,998
VEN,Venezuela,CAN,Canada,2011,1451,0,1451
VEN,Venezuela,CAN,Canada,2012,1366,0,1366
VEN,Venezuela,CAN,Canada,2013,1022,0,1022
VEN,Venezuela,CAN,Canada,2014,1483,0,1483
VEN,Venezuela,CAN,Canada,2015,929,0,929
VEN,Venezuela,CAN,Canada,2016,1020,0,1020
VEN,Venezuela,CAN,Canada,2017,1020,0,1020
VEN,Venezuela,CZE,Czech Republic,2008,22,0,22
VEN,Venezuela,CZE,Czech Republic,2009,16,1,15
VEN,Venezuela,CZE,Czech Republic,2010,11,0,11
VEN,Venezuela,CZE,Czech Republic,2011,15,0,15
VEN,Venezuela,CZE,Czech Republic,2012,14,6,8
VEN,Venezuela,CZE,Czech Republic,2013,18,13,5
VEN,Venezuela,CZE,Czech Republic,2014,19,12,7
VEN,Venezuela,CZE,Czech Republic,2015,18,8,10
VEN,Venezuela,CZE,Czech Republic,2016,28,9,19
VEN,Venezuela,CZE,Czech Republic,2017,48,6,42
VEN,Venezuela,DNK,Denmark,2008,27,17,10
VEN,Venezuela,DNK,Denmark,2009,39,19,20
VEN,Venezuela,DNK,Denmark,2010,34,19,15
VEN,Venezuela,DNK,Denmark,2011,16,24,-8
VEN,Venezuela,DNK,Denmark,2012,27,18,9
VEN,Venezuela,DNK,Denmark,2013,36,22,14
VEN,Venezuela,DNK,Denmark,2014,29,20,9
VEN,Venezuela,DNK,Denmark,2015,29,14,15
VEN,Venezuela,DNK,Denmark,2016,29,13,16
VEN,Venezuela,DNK,Denmark,2017,44,14,30
VEN,Venezuela,FIN,Finland,2008,9,0,9
VEN,Venezuela,FIN,Finland,2009,7,0,7
VEN,Venezuela,FIN,Finland,2010,18,0,18
VEN,Venezuela,FIN,Finland,2011,17,0,17
VEN,Venezuela,FIN,Finland,2012,19,0,19
VEN,Venezuela,FIN,Finland,2013,13,2,11
VEN,Venezuela,FIN,Finland,2014,22,4,18
VEN,Venezuela,FIN,Finland,2015,18,2,16
VEN,Venezuela,FIN,Finland,2016,14,0,14
VEN,Venezuela,FIN,Finland,2017,11,2,9
VEN,Venezuela,FRA,France,2008,228,0,228
VEN,Venezuela,FRA,France,2009,247,0,247
VEN,Venezuela,FRA,France,2010,209,0,209
VEN,Venezuela,FRA,France,2011,251,0,251
VEN,Venezuela,FRA,France,2012,248,0,248
VEN,Venezuela,FRA,France,2013,271,0,271
VEN,Venezuela,FRA,France,2014,337,0,337
VEN,Venezuela,FRA,France,2015,282,0,282
VEN,Venezuela,FRA,France,2016,296,0,296
VEN,Venezuela,FRA,France,2017,339,0,339
VEN,Venezuela,DEU,Germany,2008,515,448,67
VEN,Venezuela,DEU,Germany,2009,551,436,115
VEN,Venezuela,DEU,Germany,2010,527,412,115
VEN,Venezuela,DEU,Germany,2011,560,306,254
VEN,Venezuela,DEU,Germany,2012,679,374,305
VEN,Venezuela,DEU,Germany,2013,702,376,326
VEN,Venezuela,DEU,Germany,2014,792,434,358
VEN,Venezuela,DEU,Germany,2015,880,386,494
VEN,Venezuela,DEU,Germany,2016,975,373,602
VEN,Venezuela,DEU,Germany,2017,1264,373,891
VEN,Venezuela,HUN,Hungary,2008,24,0,24
VEN,Venezuela,HUN,Hungary,2009,25,1,24
VEN,Venezuela,HUN,Hungary,2010,14,6,8
VEN,Venezuela,HUN,Hungary,2011,12,3,9
VEN,Venezuela,HUN,Hungary,2012,20,2,18
VEN,Venezuela,HUN,Hungary,2013,22,5,17
VEN,Venezuela,HUN,Hungary,2014,15,2,13
VEN,Venezuela,HUN,Hungary,2015,18,2,16
VEN,Venezuela,HUN,Hungary,2016,40,8,32
VEN,Venezuela,HUN,Hungary,2017,47,0,47
VEN,Venezuela,ISL,Iceland,2008,4,9,-5
VEN,Venezuela,ISL,Iceland,2009,1,1,0
VEN,Venezuela,ISL,Iceland,2010,2,1,1
VEN,Venezuela,ISL,Iceland,2011,3,1,2
VEN,Venezuela,ISL,Iceland,2012,0,0,0
VEN,Venezuela,ISL,Iceland,2013,1,1,0
VEN,Venezuela,ISL,Iceland,2014,1,3,-2
VEN,Venezuela,ISL,Iceland,2015,1,1,0
VEN,Venezuela,ISL,Iceland,2016,6,0,6
VEN,Venezuela,ISL,Iceland,2017,13,1,12
VEN,Venezuela,ITA,Italy,2008,848,75,773
VEN,Venezuela,ITA,Italy,2009,704,90,614
VEN,Venezuela,ITA,Italy,2010,802,70,732
VEN,Venezuela,ITA,Italy,2011,738,77,661
VEN,Venezuela,ITA,Italy,2012,584,56,528
VEN,Venezuela,ITA,Italy,2013,528,69,459
VEN,Venezuela,ITA,Italy,2014,523,50,473
VEN,Venezuela,ITA,Italy,2015,672,77,595
VEN,Venezuela,ITA,Italy,2016,967,0,967
VEN,Venezuela,ITA,Italy,2017,1568,66,1502
VEN,Venezuela,JPN,Japan,2008,412,383,29
VEN,Venezuela,JPN,Japan,2009,266,257,9
VEN,Venezuela,JPN,Japan,2010,173,168,5
VEN,Venezuela,JPN,Japan,2011,127,111,16
VEN,Venezuela,JPN,Japan,2012,173,161,12
VEN,Venezuela,JPN,Japan,2013,395,363,32
VEN,Venezuela,JPN,Japan,2014,120,102,18
VEN,Venezuela,JPN,Japan,2015,318,276,42
VEN,Venezuela,JPN,Japan,2016,128,95,33
VEN,Venezuela,JPN,Japan,2017,137,88,49
VEN,Venezuela,KOR,Korea,2008,48,38,10
VEN,Venezuela,KOR,Korea,2009,36,41,-5
VEN,Venezuela,KOR,Korea,2010,23,32,-9
VEN,Venezuela,KOR,Korea,2011,39,28,11
VEN,Venezuela,KOR,Korea,2012,48,41,7
VEN,Venezuela,KOR,Korea,2013,45,39,6
VEN,Venezuela,KOR,Korea,2014,36,44,-8
VEN,Venezuela,KOR,Korea,2015,35,31,4
VEN,Venezuela,KOR,Korea,2016,44,35,9
VEN,Venezuela,KOR,Korea,2017,53,44,9
VEN,Venezuela,LUX,Luxembourg,2008,2,4,-2
VEN,Venezuela,LUX,Luxembourg,2009,5,2,3
VEN,Venezuela,LUX,Luxembourg,2010,5,1,4
VEN,Venezuela,LUX,Luxembourg,2011,12,2,10
VEN,Venezuela,LUX,Luxembourg,2012,7,0,7
VEN,Venezuela,LUX,Luxembourg,2013,11,2,9
VEN,Venezuela,LUX,Luxembourg,2014,10,4,6
VEN,Venezuela,LUX,Luxembourg,2015,22,2,20
VEN,Venezuela,LUX,Luxembourg,2016,14,4,10
VEN,Venezuela,LUX,Luxembourg,2017,20,6,14
VEN,Venezuela,MEX,Mexico,2008,743,0,743
VEN,Venezuela,MEX,Mexico,2009,1310,0,1310
VEN,Venezuela,MEX,Mexico,2010,1664,0,1664
VEN,Venezuela,MEX,Mexico,2011,1290,0,1290
VEN,Venezuela,MEX,Mexico,2012,1173,0,1173
VEN,Venezuela,MEX,Mexico,2013,2808,0,2808
VEN,Venezuela,MEX,Mexico,2014,2624,0,2624
VEN,Venezuela,MEX,Mexico,2015,2235,0,2235
VEN,Venezuela,MEX,Mexico,2016,2537,0,2537
VEN,Venezuela,MEX,Mexico,2017,3383,0,3383
VEN,Venezuela,NLD,Netherlands,2008,149,71,78
VEN,Venezuela,NLD,Netherlands,2009,140,49,91
VEN,Venezuela,NLD,Netherlands,2010,130,74,56
VEN,Venezuela,NLD,Netherlands,2011,139,70,69
VEN,Venezuela,NLD,Netherlands,2012,139,65,74
VEN,Venezuela,NLD,Netherlands,2013,120,78,42
VEN,Venezuela,NLD,Netherlands,2014,141,55,86
VEN,Venezuela,NLD,Netherlands,2015,137,70,67
VEN,Venezuela,NLD,Netherlands,2016,129,71,58
VEN,Venezuela,NLD,Netherlands,2017,201,54,147
VEN,Venezuela,NZL,New Zealand,2008,12,3,9
VEN,Venezuela,NZL,New Zealand,2009,13,1,12
VEN,Venezuela,NZL,New Zealand,2010,8,7,1
VEN,Venezuela,NZL,New Zealand,2011,15,7,8
VEN,Venezuela,NZL,New Zealand,2012,15,6,9
VEN,Venezuela,NZL,New Zealand,2013,7,7,0
VEN,Venezuela,NZL,New Zealand,2014,11,2,9
VEN,Venezuela,NZL,New Zealand,2015,11,3,8
VEN,Venezuela,NZL,New Zealand,2016,24,0,24
VEN,Venezuela,NZL,New Zealand,2017,16,10,6
VEN,Venezuela,NOR,Norway,2008,141,20,121
VEN,Venezuela,NOR,Norway,2009,84,27,57
VEN,Venezuela,NOR,Norway,2010,67,29,38
VEN,Venezuela,NOR,Norway,2011,127,38,89
VEN,Venezuela,NOR,Norway,2012,114,19,95
VEN,Venezuela,NOR,Norway,2013,90,40,50
VEN,Venezuela,NOR,Norway,2014,70,37,33
VEN,Venezuela,NOR,Norway,2015,39,30,9
VEN,Venezuela,NOR,Norway,2016,30,49,-19
VEN,Venezuela,NOR,Norway,2017,53,25,28
VEN,Venezuela,POL,Poland,2008,21,0,21
VEN,Venezuela,POL,Poland,2009,23,0,23
VEN,Venezuela,POL,Poland,2010,36,0,36
VEN,Venezuela,POL,Poland,2011,30,0,30
VEN,Venezuela,POL,Poland,2012,44,0,44
VEN,Venezuela,POL,Poland,2013,39,0,39
VEN,Venezuela,POL,Poland,2014,14,0,14
VEN,Venezuela,POL,Poland,2015,45,0,45
VEN,Venezuela,POL,Poland,2016,43,0,43
VEN,Venezuela,POL,Poland,2017,66,0,66
VEN,Venezuela,PRT,Portugal,2008,159,0,159
VEN,Venezuela,PRT,Portugal,2009,116,0,116
VEN,Venezuela,PRT,Portugal,2010,126,0,126
VEN,Venezuela,PRT,Portugal,2011,141,0,141
VEN,Venezuela,PRT,Portugal,2012,101,0,101
VEN,Venezuela,PRT,Portugal,2013,96,0,96
VEN,Venezuela,PRT,Portugal,2014,144,0,144
VEN,Venezuela,PRT,Portugal,2015,241,0,241
VEN,Venezuela,PRT,Portugal,2016,453,0,453
VEN,Venezuela,PRT,Portugal,2017,924,0,924
VEN,Venezuela,SVK,Slovak Republic,2008,3,4,-1
VEN,Venezuela,SVK,Slovak Republic,2009,1,1,0
VEN,Venezuela,SVK,Slovak Republic,2010,1,0,1
VEN,Venezuela,SVK,Slovak Republic,2011,1,0,1
VEN,Venezuela,SVK,Slovak Republic,2016,1,0,1
VEN,Venezuela,ESP,Spain,2008,8693,3433,5260
VEN,Venezuela,ESP,Spain,2009,5736,4339,1397
VEN,Venezuela,ESP,Spain,2010,6460,4129,2331
VEN,Venezuela,ESP,Spain,2011,6767,4180,2587
VEN,Venezuela,ESP,Spain,2012,4609,4548,61
VEN,Venezuela,ESP,Spain,2013,4691,6133,-1442
VEN,Venezuela,ESP,Spain,2014,7199,3099,4100
VEN,Venezuela,ESP,Spain,2015,10529,2482,8047
VEN,Venezuela,ESP,Spain,2016,18507,2293,16214
VEN,Venezuela,ESP,Spain,2017,31468,3073,28395
VEN,Venezuela,SWE,Sweden,2008,62,15,47
VEN,Venezuela,SWE,Sweden,2009,45,7,38
VEN,Venezuela,SWE,Sweden,2010,52,7,45
VEN,Venezuela,SWE,Sweden,2011,62,17,45
VEN,Venezuela,SWE,Sweden,2012,77,17,60
VEN,Venezuela,SWE,Sweden,2013,47,11,36
VEN,Venezuela,SWE,Sweden,2014,45,13,32
VEN,Venezuela,SWE,Sweden,2015,45,9,36
VEN,Venezuela,SWE,Sweden,2016,47,8,39
VEN,Venezuela,SWE,Sweden,2017,67,8,59
VEN,Venezuela,CHE,Switzerland,2010,144,72,72
VEN,Venezuela,CHE,Switzerland,2011,135,74,61
VEN,Venezuela,CHE,Switzerland,2012,141,81,60
VEN,Venezuela,CHE,Switzerland,2013,134,63,71
VEN,Venezuela,CHE,Switzerland,2014,139,40,99
VEN,Venezuela,CHE,Switzerland,2015,130,56,74
VEN,Venezuela,CHE,Switzerland,2016,138,51,87
VEN,Venezuela,CHE,Switzerland,2017,124,54,70
VEN,Venezuela,TUR,Turkey,2010,8,0,8
VEN,Venezuela,GBR,United Kingdom,2013,1000,0,1000
VEN,Venezuela,USA,United States,2008,10514,0,10514
VEN,Venezuela,USA,United States,2009,11154,0,11154
VEN,Venezuela,USA,United States,2010,9409,0,9409
VEN,Venezuela,USA,United States,2011,9183,0,9183
VEN,Venezuela,USA,United States,2012,9387,0,9387
VEN,Venezuela,USA,United States,2013,9572,0,9572
VEN,Venezuela,USA,United States,2014,8427,0,8427
VEN,Venezuela,USA,United States,2015,9144,0,9144
VEN,Venezuela,USA,United States,2016,10772,0,10772
VEN,Venezuela,USA,United States,2017,11809,0,11809
VEN,Venezuela,CHL,Chile,2008,504,0,504
VEN,Venezuela,CHL,Chile,2009,507,0,507
VEN,Venezuela,CHL,Chile,2010,547,0,547
VEN,Venezuela,CHL,Chile,2011,782,0,782
VEN,Venezuela,CHL,Chile,2012,824,0,824
VEN,Venezuela,CHL,Chile,2013,1019,0,1019
VEN,Venezuela,CHL,Chile,2014,2309,0,2309
VEN,Venezuela,CHL,Chile,2015,7351,0,7351
VEN,Venezuela,CHL,Chile,2016,21889,0,21889
VEN,Venezuela,EST,Estonia,2008,2,0,2
VEN,Venezuela,EST,Estonia,2009,1,0,1
VEN,Venezuela,EST,Estonia,2010,0,0,0
VEN,Venezuela,EST,Estonia,2011,0,0,0
VEN,Venezuela,EST,Estonia,2012,2,0,2
VEN,Venezuela,EST,Estonia,2013,0,0,0
VEN,Venezuela,EST,Estonia,2014,1,0,1
VEN,Venezuela,EST,Estonia,2015,3,0,3
VEN,Venezuela,EST,Estonia,2016,1,0,1
VEN,Venezuela,EST,Estonia,2017,10,0,10
VEN,Venezuela,ISR,Israel,2008,46,0,46
VEN,Venezuela,ISR,Israel,2009,31,0,31
VEN,Venezuela,ISR,Israel,2010,101,0,101
VEN,Venezuela,ISR,Israel,2011,77,0,77
VEN,Venezuela,ISR,Israel,2012,33,0,33
VEN,Venezuela,ISR,Israel,2013,47,0,47
VEN,Venezuela,ISR,Israel,2014,59,0,59
VEN,Venezuela,ISR,Israel,2015,84,0,84
VEN,Venezuela,ISR,Israel,2016,70,0,70
VEN,Venezuela,ISR,Israel,2017,130,0,130
VEN,Venezuela,SVN,Slovenia,2008,2,0,2
VEN,Venezuela,SVN,Slovenia,2010,5,0,5
VEN,Venezuela,SVN,Slovenia,2011,7,1,6
VEN,Venezuela,SVN,Slovenia,2013,1,0,1
VEN,Venezuela,SVN,Slovenia,2015,8,0,8
VEN,Venezuela,SVN,Slovenia,2016,1,0,1
VEN,Venezuela,SVN,Slovenia,2017,6,0,6
VNM,Viet Nam,AUS,Australia,2008,3043,819,2224
VNM,Viet Nam,AUS,Australia,2009,3273,691,2582
VNM,Viet Nam,AUS,Australia,2010,3844,702,3142
VNM,Viet Nam,AUS,Australia,2011,4802,780,4022
VNM,Viet Nam,AUS,Australia,2012,4804,669,4135
VNM,Viet Nam,AUS,Australia,2013,5716,621,5095
VNM,Viet Nam,AUS,Australia,2014,5237,565,4672
VNM,Viet Nam,AUS,Australia,2015,5074,600,4474
VNM,Viet Nam,AUS,Australia,2016,5377,600,4777
VNM,Viet Nam,AUS,Australia,2017,5526,0,5526
VNM,Viet Nam,AUT,Austria,2008,84,49,35
VNM,Viet Nam,AUT,Austria,2009,70,76,-6
VNM,Viet Nam,AUT,Austria,2010,77,56,21
VNM,Viet Nam,AUT,Austria,2011,86,62,24
VNM,Viet Nam,AUT,Austria,2012,108,72,36
VNM,Viet Nam,AUT,Austria,2013,98,63,35
VNM,Viet Nam,AUT,Austria,2014,118,41,77
VNM,Viet Nam,AUT,Austria,2015,161,80,81
VNM,Viet Nam,AUT,Austria,2016,162,73,89
VNM,Viet Nam,AUT,Austria,2017,211,83,128
VNM,Viet Nam,BEL,Belgium,2008,245,171,74
VNM,Viet Nam,BEL,Belgium,2009,310,167,143
VNM,Viet Nam,BEL,Belgium,2010,295,158,137
VNM,Viet Nam,BEL,Belgium,2011,352,187,165
VNM,Viet Nam,BEL,Belgium,2012,276,234,42
VNM,Viet Nam,BEL,Belgium,2013,326,181,145
VNM,Viet Nam,BEL,Belgium,2014,230,187,43
VNM,Viet Nam,BEL,Belgium,2015,255,139,116
VNM,Viet Nam,BEL,Belgium,2016,278,124,154
VNM,Viet Nam,BEL,Belgium,2017,276,142,134
VNM,Viet Nam,CAN,Canada,2008,1784,0,1784
VNM,Viet Nam,CAN,Canada,2009,2171,0,2171
VNM,Viet Nam,CAN,Canada,2010,1942,0,1942
VNM,Viet Nam,CAN,Canada,2011,1723,0,1723
VNM,Viet Nam,CAN,Canada,2012,1729,0,1729
VNM,Viet Nam,CAN,Canada,2013,2112,0,2112
VNM,Viet Nam,CAN,Canada,2014,2494,0,2494
VNM,Viet Nam,CAN,Canada,2015,2591,0,2591
VNM,Viet Nam,CAN,Canada,2016,2445,0,2445
VNM,Viet Nam,CAN,Canada,2017,2505,0,2505
VNM,Viet Nam,CZE,Czech Republic,2008,13368,69,13299
VNM,Viet Nam,CZE,Czech Republic,2009,2306,37,2269
VNM,Viet Nam,CZE,Czech Republic,2010,1422,36,1386
VNM,Viet Nam,CZE,Czech Republic,2011,708,53,655
VNM,Viet Nam,CZE,Czech Republic,2012,1571,1663,-92
VNM,Viet Nam,CZE,Czech Republic,2013,1186,2371,-1185
VNM,Viet Nam,CZE,Czech Republic,2014,1745,1899,-154
VNM,Viet Nam,CZE,Czech Republic,2015,1305,1534,-229
VNM,Viet Nam,CZE,Czech Republic,2016,1752,1211,541
VNM,Viet Nam,CZE,Czech Republic,2017,2196,880,1316
VNM,Viet Nam,DNK,Denmark,2008,143,75,68
VNM,Viet Nam,DNK,Denmark,2009,165,58,107
VNM,Viet Nam,DNK,Denmark,2010,178,76,102
VNM,Viet Nam,DNK,Denmark,2011,126,107,19
VNM,Viet Nam,DNK,Denmark,2012,144,72,72
VNM,Viet Nam,DNK,Denmark,2013,158,102,56
VNM,Viet Nam,DNK,Denmark,2014,191,54,137
VNM,Viet Nam,DNK,Denmark,2015,164,63,101
VNM,Viet Nam,DNK,Denmark,2016,137,80,57
VNM,Viet Nam,DNK,Denmark,2017,207,114,93
VNM,Viet Nam,FIN,Finland,2008,317,18,299
VNM,Viet Nam,FIN,Finland,2009,300,20,280
VNM,Viet Nam,FIN,Finland,2010,272,23,249
VNM,Viet Nam,FIN,Finland,2011,360,23,337
VNM,Viet Nam,FIN,Finland,2012,379,17,362
VNM,Viet Nam,FIN,Finland,2013,402,33,369
VNM,Viet Nam,FIN,Finland,2014,506,44,462
VNM,Viet Nam,FIN,Finland,2015,679,30,649
VNM,Viet Nam,FIN,Finland,2016,942,54,888
VNM,Viet Nam,FIN,Finland,2017,616,41,575
VNM,Viet Nam,FRA,France,2008,1249,0,1249
VNM,Viet Nam,FRA,France,2009,1352,0,1352
VNM,Viet Nam,FRA,France,2010,1153,0,1153
VNM,Viet Nam,FRA,France,2011,1148,0,1148
VNM,Viet Nam,FRA,France,2012,1328,0,1328
VNM,Viet Nam,FRA,France,2013,1359,0,1359
VNM,Viet Nam,FRA,France,2014,1466,0,1466
VNM,Viet Nam,FRA,France,2015,1012,0,1012
VNM,Viet Nam,FRA,France,2016,1003,0,1003
VNM,Viet Nam,FRA,France,2017,1023,0,1023
VNM,Viet Nam,DEU,Germany,2008,4045,4313,-268
VNM,Viet Nam,DEU,Germany,2009,4469,3720,749
VNM,Viet Nam,DEU,Germany,2010,4310,3267,1043
VNM,Viet Nam,DEU,Germany,2011,4206,2990,1216
VNM,Viet Nam,DEU,Germany,2012,3887,2411,1476
VNM,Viet Nam,DEU,Germany,2013,4126,2535,1591
VNM,Viet Nam,DEU,Germany,2014,5053,2347,2706
VNM,Viet Nam,DEU,Germany,2015,6117,2393,3724
VNM,Viet Nam,DEU,Germany,2016,6998,2811,4187
VNM,Viet Nam,DEU,Germany,2017,7045,2601,4444
VNM,Viet Nam,HUN,Hungary,2008,300,34,266
VNM,Viet Nam,HUN,Hungary,2009,227,20,207
VNM,Viet Nam,HUN,Hungary,2010,212,47,165
VNM,Viet Nam,HUN,Hungary,2011,225,22,203
VNM,Viet Nam,HUN,Hungary,2012,269,14,255
VNM,Viet Nam,HUN,Hungary,2013,294,91,203
VNM,Viet Nam,HUN,Hungary,2014,276,51,225
VNM,Viet Nam,HUN,Hungary,2015,347,34,313
VNM,Viet Nam,HUN,Hungary,2016,280,56,224
VNM,Viet Nam,HUN,Hungary,2017,731,76,655
VNM,Viet Nam,ISL,Iceland,2008,42,7,35
VNM,Viet Nam,ISL,Iceland,2009,22,5,17
VNM,Viet Nam,ISL,Iceland,2010,37,1,36
VNM,Viet Nam,ISL,Iceland,2011,36,8,28
VNM,Viet Nam,ISL,Iceland,2012,20,1,19
VNM,Viet Nam,ISL,Iceland,2013,32,4,28
VNM,Viet Nam,ISL,Iceland,2014,42,7,35
VNM,Viet Nam,ISL,Iceland,2015,43,6,37
VNM,Viet Nam,ISL,Iceland,2016,66,6,60
VNM,Viet Nam,ISL,Iceland,2017,66,6,60
VNM,Viet Nam,ITA,Italy,2008,326,7,319
VNM,Viet Nam,ITA,Italy,2009,301,7,294
VNM,Viet Nam,ITA,Italy,2010,306,7,299
VNM,Viet Nam,ITA,Italy,2011,230,10,220
VNM,Viet Nam,ITA,Italy,2012,141,9,132
VNM,Viet Nam,ITA,Italy,2013,159,12,147
VNM,Viet Nam,ITA,Italy,2014,199,14,185
VNM,Viet Nam,ITA,Italy,2015,220,14,206
VNM,Viet Nam,ITA,Italy,2016,247,0,247
VNM,Viet Nam,ITA,Italy,2017,203,12,191
VNM,Viet Nam,JPN,Japan,2008,12528,7160,5368
VNM,Viet Nam,JPN,Japan,2009,10930,9895,1035
VNM,Viet Nam,JPN,Japan,2010,11932,10025,1907
VNM,Viet Nam,JPN,Japan,2011,13913,9971,3942
VNM,Viet Nam,JPN,Japan,2012,19481,9796,9685
VNM,Viet Nam,JPN,Japan,2013,31740,10427,21313
VNM,Viet Nam,JPN,Japan,2014,42993,12461,30532
VNM,Viet Nam,JPN,Japan,2015,65850,14365,51485
VNM,Viet Nam,JPN,Japan,2016,77540,18376,59164
VNM,Viet Nam,JPN,Japan,2017,98615,28069,70546
VNM,Viet Nam,KOR,Korea,2008,23960,7998,15962
VNM,Viet Nam,KOR,Korea,2009,16427,9821,6606
VNM,Viet Nam,KOR,Korea,2010,22934,9488,13446
VNM,Viet Nam,KOR,Korea,2011,27873,14155,13718
VNM,Viet Nam,KOR,Korea,2012,24743,18573,6170
VNM,Viet Nam,KOR,Korea,2013,22248,20484,1764
VNM,Viet Nam,KOR,Korea,2014,28012,17740,10272
VNM,Viet Nam,KOR,Korea,2015,30244,24533,5711
VNM,Viet Nam,KOR,Korea,2016,40099,27711,12388
VNM,Viet Nam,KOR,Korea,2017,47964,27447,20517
VNM,Viet Nam,LUX,Luxembourg,2008,22,11,11
VNM,Viet Nam,LUX,Luxembourg,2009,15,4,11
VNM,Viet Nam,LUX,Luxembourg,2010,17,13,4
VNM,Viet Nam,LUX,Luxembourg,2011,21,11,10
VNM,Viet Nam,LUX,Luxembourg,2012,20,12,8
VNM,Viet Nam,LUX,Luxembourg,2013,28,14,14
VNM,Viet Nam,LUX,Luxembourg,2014,22,21,1
VNM,Viet Nam,LUX,Luxembourg,2015,34,19,15
VNM,Viet Nam,LUX,Luxembourg,2016,33,15,18
VNM,Viet Nam,LUX,Luxembourg,2017,29,18,11
VNM,Viet Nam,MEX,Mexico,2008,8,0,8
VNM,Viet Nam,MEX,Mexico,2009,8,0,8
VNM,Viet Nam,MEX,Mexico,2010,4,0,4
VNM,Viet Nam,MEX,Mexico,2011,5,0,5
VNM,Viet Nam,MEX,Mexico,2012,1,0,1
VNM,Viet Nam,MEX,Mexico,2013,20,0,20
VNM,Viet Nam,MEX,Mexico,2014,7,0,7
VNM,Viet Nam,MEX,Mexico,2015,5,0,5
VNM,Viet Nam,MEX,Mexico,2016,9,0,9
VNM,Viet Nam,MEX,Mexico,2017,12,0,12
VNM,Viet Nam,NLD,Netherlands,2008,331,237,94
VNM,Viet Nam,NLD,Netherlands,2009,352,188,164
VNM,Viet Nam,NLD,Netherlands,2010,361,267,94
VNM,Viet Nam,NLD,Netherlands,2011,442,225,217
VNM,Viet Nam,NLD,Netherlands,2012,359,221,138
VNM,Viet Nam,NLD,Netherlands,2013,368,269,99
VNM,Viet Nam,NLD,Netherlands,2014,392,220,172
VNM,Viet Nam,NLD,Netherlands,2015,473,209,264
VNM,Viet Nam,NLD,Netherlands,2016,683,254,429
VNM,Viet Nam,NLD,Netherlands,2017,870,336,534
VNM,Viet Nam,NZL,New Zealand,2008,453,121,332
VNM,Viet Nam,NZL,New Zealand,2009,505,109,396
VNM,Viet Nam,NZL,New Zealand,2010,607,142,465
VNM,Viet Nam,NZL,New Zealand,2011,519,183,336
VNM,Viet Nam,NZL,New Zealand,2012,548,196,352
VNM,Viet Nam,NZL,New Zealand,2013,543,192,351
VNM,Viet Nam,NZL,New Zealand,2014,607,226,381
VNM,Viet Nam,NZL,New Zealand,2015,729,196,533
VNM,Viet Nam,NZL,New Zealand,2016,889,164,725
VNM,Viet Nam,NZL,New Zealand,2017,1106,202,904
VNM,Viet Nam,NOR,Norway,2008,319,90,229
VNM,Viet Nam,NOR,Norway,2009,203,99,104
VNM,Viet Nam,NOR,Norway,2010,277,115,162
VNM,Viet Nam,NOR,Norway,2011,322,126,196
VNM,Viet Nam,NOR,Norway,2012,357,134,223
VNM,Viet Nam,NOR,Norway,2013,342,156,186
VNM,Viet Nam,NOR,Norway,2014,284,125,159
VNM,Viet Nam,NOR,Norway,2015,241,121,120
VNM,Viet Nam,NOR,Norway,2016,352,148,204
VNM,Viet Nam,NOR,Norway,2017,356,87,269
VNM,Viet Nam,POL,Poland,2008,2788,0,2788
VNM,Viet Nam,POL,Poland,2009,2981,0,2981
VNM,Viet Nam,POL,Poland,2010,2402,0,2402
VNM,Viet Nam,POL,Poland,2011,2113,0,2113
VNM,Viet Nam,POL,Poland,2012,4031,0,4031
VNM,Viet Nam,POL,Poland,2013,2788,0,2788
VNM,Viet Nam,POL,Poland,2014,1968,0,1968
VNM,Viet Nam,POL,Poland,2015,3297,0,3297
VNM,Viet Nam,POL,Poland,2016,3226,0,3226
VNM,Viet Nam,POL,Poland,2017,3980,0,3980
VNM,Viet Nam,SVK,Slovak Republic,2008,32,3,29
VNM,Viet Nam,SVK,Slovak Republic,2009,28,343,-315
VNM,Viet Nam,SVK,Slovak Republic,2010,39,181,-142
VNM,Viet Nam,SVK,Slovak Republic,2011,63,66,-3
VNM,Viet Nam,SVK,Slovak Republic,2012,55,0,55
VNM,Viet Nam,SVK,Slovak Republic,2013,86,1,85
VNM,Viet Nam,SVK,Slovak Republic,2014,35,1,34
VNM,Viet Nam,SVK,Slovak Republic,2015,25,0,25
VNM,Viet Nam,SVK,Slovak Republic,2016,18,0,18
VNM,Viet Nam,SVK,Slovak Republic,2017,21,0,21
VNM,Viet Nam,ESP,Spain,2008,76,28,48
VNM,Viet Nam,ESP,Spain,2009,88,37,51
VNM,Viet Nam,ESP,Spain,2010,163,33,130
VNM,Viet Nam,ESP,Spain,2011,136,57,79
VNM,Viet Nam,ESP,Spain,2012,132,35,97
VNM,Viet Nam,ESP,Spain,2013,128,74,54
VNM,Viet Nam,ESP,Spain,2014,184,33,151
VNM,Viet Nam,ESP,Spain,2015,213,42,171
VNM,Viet Nam,ESP,Spain,2016,308,48,260
VNM,Viet Nam,ESP,Spain,2017,441,78,363
VNM,Viet Nam,SWE,Sweden,2008,442,44,398
VNM,Viet Nam,SWE,Sweden,2009,539,29,510
VNM,Viet Nam,SWE,Sweden,2010,659,41,618
VNM,Viet Nam,SWE,Sweden,2011,725,85,640
VNM,Viet Nam,SWE,Sweden,2012,649,112,537
VNM,Viet Nam,SWE,Sweden,2013,536,83,453
VNM,Viet Nam,SWE,Sweden,2014,678,113,565
VNM,Viet Nam,SWE,Sweden,2015,694,218,476
VNM,Viet Nam,SWE,Sweden,2016,752,77,675
VNM,Viet Nam,SWE,Sweden,2017,1075,86,989
VNM,Viet Nam,CHE,Switzerland,2010,395,230,165
VNM,Viet Nam,CHE,Switzerland,2011,337,234,103
VNM,Viet Nam,CHE,Switzerland,2012,321,234,87
VNM,Viet Nam,CHE,Switzerland,2013,360,222,138
VNM,Viet Nam,CHE,Switzerland,2014,400,215,185
VNM,Viet Nam,CHE,Switzerland,2015,399,207,192
VNM,Viet Nam,CHE,Switzerland,2016,462,220,242
VNM,Viet Nam,CHE,Switzerland,2017,398,246,152
VNM,Viet Nam,TUR,Turkey,2010,7,0,7
VNM,Viet Nam,TUR,Turkey,2016,280,161,119
VNM,Viet Nam,TUR,Turkey,2017,238,386,-148
VNM,Viet Nam,GBR,United Kingdom,2010,3000,0,3000
VNM,Viet Nam,GBR,United Kingdom,2014,3000,1000,2000
VNM,Viet Nam,GBR,United Kingdom,2015,1000,0,1000
VNM,Viet Nam,USA,United States,2008,31497,0,31497
VNM,Viet Nam,USA,United States,2009,29234,0,29234
VNM,Viet Nam,USA,United States,2010,30632,0,30632
VNM,Viet Nam,USA,United States,2011,34157,0,34157
VNM,Viet Nam,USA,United States,2012,28304,0,28304
VNM,Viet Nam,USA,United States,2013,27101,0,27101
VNM,Viet Nam,USA,United States,2014,30283,0,30283
VNM,Viet Nam,USA,United States,2015,30832,0,30832
VNM,Viet Nam,USA,United States,2016,41451,0,41451
VNM,Viet Nam,USA,United States,2017,38231,0,38231
VNM,Viet Nam,CHL,Chile,2008,0,0,0
VNM,Viet Nam,CHL,Chile,2009,0,0,0
VNM,Viet Nam,CHL,Chile,2010,0,0,0
VNM,Viet Nam,CHL,Chile,2011,0,0,0
VNM,Viet Nam,CHL,Chile,2012,2,0,2
VNM,Viet Nam,CHL,Chile,2013,3,0,3
VNM,Viet Nam,CHL,Chile,2014,10,0,10
VNM,Viet Nam,CHL,Chile,2015,2,0,2
VNM,Viet Nam,CHL,Chile,2016,0,0,0
VNM,Viet Nam,EST,Estonia,2008,2,0,2
VNM,Viet Nam,EST,Estonia,2009,0,0,0
VNM,Viet Nam,EST,Estonia,2010,3,0,3
VNM,Viet Nam,EST,Estonia,2011,0,0,0
VNM,Viet Nam,EST,Estonia,2012,6,0,6
VNM,Viet Nam,EST,Estonia,2013,1,0,1
VNM,Viet Nam,EST,Estonia,2014,1,0,1
VNM,Viet Nam,EST,Estonia,2015,5,0,5
VNM,Viet Nam,EST,Estonia,2016,7,0,7
VNM,Viet Nam,EST,Estonia,2017,10,0,10
VNM,Viet Nam,SVN,Slovenia,2008,1,0,1
VNM,Viet Nam,SVN,Slovenia,2010,1,0,1
VNM,Viet Nam,SVN,Slovenia,2011,2,0,2
VNM,Viet Nam,SVN,Slovenia,2013,3,0,3
VNM,Viet Nam,SVN,Slovenia,2014,2,0,2
VNM,Viet Nam,SVN,Slovenia,2015,4,1,3
VNM,Viet Nam,SVN,Slovenia,2016,1,0,1
VNM,Viet Nam,SVN,Slovenia,2017,4,1,3
YEM,Yemen,AUS,Australia,2008,17,5,12
YEM,Yemen,AUS,Australia,2009,11,0,11
YEM,Yemen,AUS,Australia,2010,4,8,-4
YEM,Yemen,AUS,Australia,2011,10,0,10
YEM,Yemen,AUS,Australia,2012,15,0,15
YEM,Yemen,AUS,Australia,2013,10,5,5
YEM,Yemen,AUS,Australia,2014,8,0,8
YEM,Yemen,AUS,Australia,2015,36,0,36
YEM,Yemen,AUS,Australia,2016,50,0,50
YEM,Yemen,AUS,Australia,2017,40,0,40
YEM,Yemen,AUT,Austria,2008,10,3,7
YEM,Yemen,AUT,Austria,2009,15,5,10
YEM,Yemen,AUT,Austria,2010,24,8,16
YEM,Yemen,AUT,Austria,2011,15,6,9
YEM,Yemen,AUT,Austria,2012,7,11,-4
YEM,Yemen,AUT,Austria,2013,15,6,9
YEM,Yemen,AUT,Austria,2014,23,12,11
YEM,Yemen,AUT,Austria,2015,122,16,106
YEM,Yemen,AUT,Austria,2016,69,14,55
YEM,Yemen,AUT,Austria,2017,45,27,18
YEM,Yemen,BEL,Belgium,2008,2,0,2
YEM,Yemen,BEL,Belgium,2009,1,0,1
YEM,Yemen,BEL,Belgium,2010,14,2,12
YEM,Yemen,BEL,Belgium,2012,14,1,13
YEM,Yemen,BEL,Belgium,2013,20,3,17
YEM,Yemen,BEL,Belgium,2014,18,13,5
YEM,Yemen,BEL,Belgium,2015,44,3,41
YEM,Yemen,BEL,Belgium,2016,29,5,24
YEM,Yemen,BEL,Belgium,2017,16,2,14
YEM,Yemen,CAN,Canada,2008,129,0,129
YEM,Yemen,CAN,Canada,2009,128,0,128
YEM,Yemen,CAN,Canada,2010,211,0,211
YEM,Yemen,CAN,Canada,2011,159,0,159
YEM,Yemen,CAN,Canada,2012,174,0,174
YEM,Yemen,CAN,Canada,2013,217,0,217
YEM,Yemen,CAN,Canada,2014,149,0,149
YEM,Yemen,CAN,Canada,2015,206,0,206
YEM,Yemen,CAN,Canada,2016,160,0,160
YEM,Yemen,CAN,Canada,2017,250,0,250
YEM,Yemen,CZE,Czech Republic,2008,17,0,17
YEM,Yemen,CZE,Czech Republic,2009,10,0,10
YEM,Yemen,CZE,Czech Republic,2010,4,0,4
YEM,Yemen,CZE,Czech Republic,2011,7,0,7
YEM,Yemen,CZE,Czech Republic,2012,11,7,4
YEM,Yemen,CZE,Czech Republic,2013,18,18,0
YEM,Yemen,CZE,Czech Republic,2014,18,20,-2
YEM,Yemen,CZE,Czech Republic,2015,19,14,5
YEM,Yemen,CZE,Czech Republic,2016,22,10,12
YEM,Yemen,CZE,Czech Republic,2017,16,5,11
YEM,Yemen,DNK,Denmark,2008,1,2,-1
YEM,Yemen,DNK,Denmark,2009,5,0,5
YEM,Yemen,DNK,Denmark,2010,4,0,4
YEM,Yemen,DNK,Denmark,2011,4,0,4
YEM,Yemen,DNK,Denmark,2012,1,1,0
YEM,Yemen,DNK,Denmark,2013,4,1,3
YEM,Yemen,DNK,Denmark,2014,1,0,1
YEM,Yemen,DNK,Denmark,2015,5,1,4
YEM,Yemen,DNK,Denmark,2016,3,2,1
YEM,Yemen,DNK,Denmark,2017,3,5,-2
YEM,Yemen,FIN,Finland,2008,1,0,1
YEM,Yemen,FIN,Finland,2009,0,0,0
YEM,Yemen,FIN,Finland,2010,4,0,4
YEM,Yemen,FIN,Finland,2011,5,0,5
YEM,Yemen,FIN,Finland,2012,11,0,11
YEM,Yemen,FIN,Finland,2013,3,1,2
YEM,Yemen,FIN,Finland,2014,10,0,10
YEM,Yemen,FIN,Finland,2015,6,1,5
YEM,Yemen,FIN,Finland,2016,58,0,58
YEM,Yemen,FIN,Finland,2017,67,1,66
YEM,Yemen,FRA,France,2008,14,0,14
YEM,Yemen,FRA,France,2009,28,0,28
YEM,Yemen,FRA,France,2010,19,0,19
YEM,Yemen,FRA,France,2011,37,0,37
YEM,Yemen,FRA,France,2012,32,0,32
YEM,Yemen,FRA,France,2013,50,0,50
YEM,Yemen,FRA,France,2014,40,0,40
YEM,Yemen,FRA,France,2015,52,0,52
YEM,Yemen,FRA,France,2016,83,0,83
YEM,Yemen,FRA,France,2017,103,0,103
YEM,Yemen,DEU,Germany,2008,466,303,163
YEM,Yemen,DEU,Germany,2009,488,345,143
YEM,Yemen,DEU,Germany,2010,465,352,113
YEM,Yemen,DEU,Germany,2011,352,242,110
YEM,Yemen,DEU,Germany,2012,370,265,105
YEM,Yemen,DEU,Germany,2013,514,270,244
YEM,Yemen,DEU,Germany,2014,645,265,380
YEM,Yemen,DEU,Germany,2015,1010,242,768
YEM,Yemen,DEU,Germany,2016,981,347,634
YEM,Yemen,DEU,Germany,2017,1158,224,934
YEM,Yemen,HUN,Hungary,2008,8,0,8
YEM,Yemen,HUN,Hungary,2009,19,2,17
YEM,Yemen,HUN,Hungary,2010,15,3,12
YEM,Yemen,HUN,Hungary,2011,9,1,8
YEM,Yemen,HUN,Hungary,2012,26,3,23
YEM,Yemen,HUN,Hungary,2013,15,5,10
YEM,Yemen,HUN,Hungary,2014,35,2,33
YEM,Yemen,HUN,Hungary,2015,63,10,53
YEM,Yemen,HUN,Hungary,2016,42,12,30
YEM,Yemen,HUN,Hungary,2017,56,0,56
YEM,Yemen,ISL,Iceland,2008,3,2,1
YEM,Yemen,ISL,Iceland,2009,1,1,0
YEM,Yemen,ISL,Iceland,2010,1,1,0
YEM,Yemen,ISL,Iceland,2011,0,0,0
YEM,Yemen,ISL,Iceland,2012,0,0,0
YEM,Yemen,ISL,Iceland,2013,0,0,0
YEM,Yemen,ISL,Iceland,2014,0,0,0
YEM,Yemen,ISL,Iceland,2015,0,0,0
YEM,Yemen,ISL,Iceland,2016,1,0,1
YEM,Yemen,ISL,Iceland,2017,0,0,0
YEM,Yemen,ITA,Italy,2008,26,2,24
YEM,Yemen,ITA,Italy,2009,26,2,24
YEM,Yemen,ITA,Italy,2010,18,2,16
YEM,Yemen,ITA,Italy,2011,16,0,16
YEM,Yemen,ITA,Italy,2012,8,5,3
YEM,Yemen,ITA,Italy,2013,21,0,21
YEM,Yemen,ITA,Italy,2014,28,0,28
YEM,Yemen,ITA,Italy,2015,23,0,23
YEM,Yemen,ITA,Italy,2016,39,0,39
YEM,Yemen,ITA,Italy,2017,48,0,48
YEM,Yemen,JPN,Japan,2008,67,60,7
YEM,Yemen,JPN,Japan,2009,76,65,11
YEM,Yemen,JPN,Japan,2010,96,93,3
YEM,Yemen,JPN,Japan,2011,20,15,5
YEM,Yemen,JPN,Japan,2012,52,49,3
YEM,Yemen,JPN,Japan,2013,97,85,12
YEM,Yemen,JPN,Japan,2014,92,76,16
YEM,Yemen,JPN,Japan,2015,26,13,13
YEM,Yemen,JPN,Japan,2016,12,7,5
YEM,Yemen,JPN,Japan,2017,29,21,8
YEM,Yemen,KOR,Korea,2008,10,8,2
YEM,Yemen,KOR,Korea,2009,16,13,3
YEM,Yemen,KOR,Korea,2010,21,10,11
YEM,Yemen,KOR,Korea,2011,28,14,14
YEM,Yemen,KOR,Korea,2012,52,45,7
YEM,Yemen,KOR,Korea,2013,86,37,49
YEM,Yemen,KOR,Korea,2014,168,51,117
YEM,Yemen,KOR,Korea,2015,96,61,35
YEM,Yemen,KOR,Korea,2016,160,67,93
YEM,Yemen,KOR,Korea,2017,187,97,90
YEM,Yemen,LUX,Luxembourg,2008,0,0,0
YEM,Yemen,LUX,Luxembourg,2009,0,0,0
YEM,Yemen,LUX,Luxembourg,2010,0,0,0
YEM,Yemen,LUX,Luxembourg,2011,0,0,0
YEM,Yemen,LUX,Luxembourg,2012,0,0,0
YEM,Yemen,LUX,Luxembourg,2013,0,0,0
YEM,Yemen,LUX,Luxembourg,2014,0,0,0
YEM,Yemen,LUX,Luxembourg,2015,1,0,1
YEM,Yemen,LUX,Luxembourg,2016,1,1,0
YEM,Yemen,LUX,Luxembourg,2017,2,0,2
YEM,Yemen,MEX,Mexico,2011,1,0,1
YEM,Yemen,MEX,Mexico,2012,0,0,0
YEM,Yemen,MEX,Mexico,2013,0,0,0
YEM,Yemen,MEX,Mexico,2014,0,0,0
YEM,Yemen,MEX,Mexico,2015,1,0,1
YEM,Yemen,MEX,Mexico,2017,2,0,2
YEM,Yemen,NLD,Netherlands,2008,16,13,3
YEM,Yemen,NLD,Netherlands,2009,17,9,8
YEM,Yemen,NLD,Netherlands,2010,18,7,11
YEM,Yemen,NLD,Netherlands,2011,21,2,19
YEM,Yemen,NLD,Netherlands,2012,23,9,14
YEM,Yemen,NLD,Netherlands,2013,21,13,8
YEM,Yemen,NLD,Netherlands,2014,53,6,47
YEM,Yemen,NLD,Netherlands,2015,58,11,47
YEM,Yemen,NLD,Netherlands,2016,74,7,67
YEM,Yemen,NLD,Netherlands,2017,191,8,183
YEM,Yemen,NZL,New Zealand,2008,11,1,10
YEM,Yemen,NZL,New Zealand,2009,1,1,0
YEM,Yemen,NZL,New Zealand,2010,1,0,1
YEM,Yemen,NZL,New Zealand,2011,2,0,2
YEM,Yemen,NZL,New Zealand,2012,6,2,4
YEM,Yemen,NZL,New Zealand,2013,7,0,7
YEM,Yemen,NZL,New Zealand,2014,6,0,6
YEM,Yemen,NZL,New Zealand,2015,12,1,11
YEM,Yemen,NZL,New Zealand,2016,24,1,23
YEM,Yemen,NZL,New Zealand,2017,6,0,6
YEM,Yemen,NOR,Norway,2008,19,0,19
YEM,Yemen,NOR,Norway,2009,40,1,39
YEM,Yemen,NOR,Norway,2010,46,0,46
YEM,Yemen,NOR,Norway,2011,41,3,38
YEM,Yemen,NOR,Norway,2012,19,1,18
YEM,Yemen,NOR,Norway,2013,16,6,10
YEM,Yemen,NOR,Norway,2014,11,1,10
YEM,Yemen,NOR,Norway,2015,55,2,53
YEM,Yemen,NOR,Norway,2016,78,2,76
YEM,Yemen,NOR,Norway,2017,79,7,72
YEM,Yemen,POL,Poland,2008,36,0,36
YEM,Yemen,POL,Poland,2009,35,0,35
YEM,Yemen,POL,Poland,2010,37,0,37
YEM,Yemen,POL,Poland,2011,36,0,36
YEM,Yemen,POL,Poland,2012,40,0,40
YEM,Yemen,POL,Poland,2013,36,0,36
YEM,Yemen,POL,Poland,2014,18,0,18
YEM,Yemen,POL,Poland,2015,56,0,56
YEM,Yemen,POL,Poland,2016,71,0,71
YEM,Yemen,POL,Poland,2017,87,0,87
YEM,Yemen,SVK,Slovak Republic,2008,0,2,-2
YEM,Yemen,SVK,Slovak Republic,2009,3,2,1
YEM,Yemen,SVK,Slovak Republic,2010,2,2,0
YEM,Yemen,SVK,Slovak Republic,2011,1,0,1
YEM,Yemen,SVK,Slovak Republic,2012,1,0,1
YEM,Yemen,SVK,Slovak Republic,2015,1,0,1
YEM,Yemen,SVK,Slovak Republic,2016,1,0,1
YEM,Yemen,ESP,Spain,2008,9,4,5
YEM,Yemen,ESP,Spain,2009,12,7,5
YEM,Yemen,ESP,Spain,2010,7,8,-1
YEM,Yemen,ESP,Spain,2011,13,12,1
YEM,Yemen,ESP,Spain,2012,14,2,12
YEM,Yemen,ESP,Spain,2013,27,13,14
YEM,Yemen,ESP,Spain,2014,25,2,23
YEM,Yemen,ESP,Spain,2015,36,2,34
YEM,Yemen,ESP,Spain,2016,33,11,22
YEM,Yemen,ESP,Spain,2017,56,15,41
YEM,Yemen,SWE,Sweden,2008,25,0,25
YEM,Yemen,SWE,Sweden,2009,106,1,105
YEM,Yemen,SWE,Sweden,2010,92,0,92
YEM,Yemen,SWE,Sweden,2011,213,6,207
YEM,Yemen,SWE,Sweden,2012,194,4,190
YEM,Yemen,SWE,Sweden,2013,208,18,190
YEM,Yemen,SWE,Sweden,2014,121,4,117
YEM,Yemen,SWE,Sweden,2015,184,13,171
YEM,Yemen,SWE,Sweden,2016,414,8,406
YEM,Yemen,SWE,Sweden,2017,348,7,341
YEM,Yemen,CHE,Switzerland,2010,34,0,34
YEM,Yemen,CHE,Switzerland,2011,34,4,30
YEM,Yemen,CHE,Switzerland,2012,41,3,38
YEM,Yemen,CHE,Switzerland,2013,30,15,15
YEM,Yemen,CHE,Switzerland,2014,55,3,52
YEM,Yemen,CHE,Switzerland,2015,53,4,49
YEM,Yemen,CHE,Switzerland,2016,14,5,9
YEM,Yemen,CHE,Switzerland,2017,27,5,22
YEM,Yemen,TUR,Turkey,2010,46,0,46
YEM,Yemen,TUR,Turkey,2016,1839,438,1401
YEM,Yemen,TUR,Turkey,2017,3726,528,3198
YEM,Yemen,USA,United States,2008,1872,0,1872
YEM,Yemen,USA,United States,2009,3134,0,3134
YEM,Yemen,USA,United States,2010,3591,0,3591
YEM,Yemen,USA,United States,2011,3361,0,3361
YEM,Yemen,USA,United States,2012,2620,0,2620
YEM,Yemen,USA,United States,2013,3532,0,3532
YEM,Yemen,USA,United States,2014,3492,0,3492
YEM,Yemen,USA,United States,2015,3194,0,3194
YEM,Yemen,USA,United States,2016,13040,0,13040
YEM,Yemen,USA,United States,2017,6029,0,6029
YEM,Yemen,CHL,Chile,2008,0,0,0
YEM,Yemen,CHL,Chile,2009,1,0,1
YEM,Yemen,CHL,Chile,2010,0,0,0
YEM,Yemen,CHL,Chile,2011,0,0,0
YEM,Yemen,CHL,Chile,2012,0,0,0
YEM,Yemen,CHL,Chile,2013,0,0,0
YEM,Yemen,CHL,Chile,2014,1,0,1
YEM,Yemen,CHL,Chile,2015,1,0,1
YEM,Yemen,CHL,Chile,2016,0,0,0
YEM,Yemen,EST,Estonia,2008,0,0,0
YEM,Yemen,EST,Estonia,2009,0,0,0
YEM,Yemen,EST,Estonia,2010,0,0,0
YEM,Yemen,EST,Estonia,2011,0,0,0
YEM,Yemen,EST,Estonia,2012,0,0,0
YEM,Yemen,EST,Estonia,2013,0,0,0
YEM,Yemen,EST,Estonia,2014,0,0,0
YEM,Yemen,EST,Estonia,2015,2,0,2
YEM,Yemen,EST,Estonia,2016,2,0,2
YEM,Yemen,EST,Estonia,2017,6,0,6
YEM,Yemen,ISR,Israel,2008,0,0,0
YEM,Yemen,ISR,Israel,2009,42,0,42
YEM,Yemen,ISR,Israel,2010,13,0,13
YEM,Yemen,ISR,Israel,2011,17,0,17
YEM,Yemen,ISR,Israel,2012,25,0,25
YEM,Yemen,ISR,Israel,2013,52,0,52
YEM,Yemen,ISR,Israel,2014,7,0,7
YEM,Yemen,ISR,Israel,2015,3,0,3
YEM,Yemen,ISR,Israel,2016,16,0,16
YEM,Yemen,SVN,Slovenia,2009,1,0,1
YEM,Yemen,SVN,Slovenia,2015,2,0,2
YEM,Yemen,SVN,Slovenia,2016,1,0,1
YEM,Yemen,SVN,Slovenia,2017,2,0,2
ZMB,Zambia,AUS,Australia,2008,104,29,75
ZMB,Zambia,AUS,Australia,2009,86,39,47
ZMB,Zambia,AUS,Australia,2010,131,40,91
ZMB,Zambia,AUS,Australia,2011,184,40,144
ZMB,Zambia,AUS,Australia,2012,181,36,145
ZMB,Zambia,AUS,Australia,2013,210,45,165
ZMB,Zambia,AUS,Australia,2014,163,47,116
ZMB,Zambia,AUS,Australia,2015,177,100,77
ZMB,Zambia,AUS,Australia,2016,102,0,102
ZMB,Zambia,AUS,Australia,2017,124,0,124
ZMB,Zambia,AUT,Austria,2008,11,2,9
ZMB,Zambia,AUT,Austria,2009,9,5,4
ZMB,Zambia,AUT,Austria,2010,7,2,5
ZMB,Zambia,AUT,Austria,2011,4,4,0
ZMB,Zambia,AUT,Austria,2012,7,6,1
ZMB,Zambia,AUT,Austria,2013,5,4,1
ZMB,Zambia,AUT,Austria,2014,4,1,3
ZMB,Zambia,AUT,Austria,2015,4,1,3
ZMB,Zambia,AUT,Austria,2016,4,3,1
ZMB,Zambia,AUT,Austria,2017,13,1,12
ZMB,Zambia,BEL,Belgium,2008,25,0,25
ZMB,Zambia,BEL,Belgium,2009,24,0,24
ZMB,Zambia,BEL,Belgium,2010,11,10,1
ZMB,Zambia,BEL,Belgium,2012,21,18,3
ZMB,Zambia,BEL,Belgium,2013,7,23,-16
ZMB,Zambia,BEL,Belgium,2014,13,7,6
ZMB,Zambia,BEL,Belgium,2015,16,7,9
ZMB,Zambia,BEL,Belgium,2016,11,4,7
ZMB,Zambia,BEL,Belgium,2017,18,5,13
ZMB,Zambia,CAN,Canada,2008,64,0,64
ZMB,Zambia,CAN,Canada,2009,60,0,60
ZMB,Zambia,CAN,Canada,2010,102,0,102
ZMB,Zambia,CAN,Canada,2011,69,0,69
ZMB,Zambia,CAN,Canada,2012,46,0,46
ZMB,Zambia,CAN,Canada,2013,59,0,59
ZMB,Zambia,CAN,Canada,2014,46,0,46
ZMB,Zambia,CAN,Canada,2015,56,0,56
ZMB,Zambia,CAN,Canada,2016,55,0,55
ZMB,Zambia,CAN,Canada,2017,85,0,85
ZMB,Zambia,CZE,Czech Republic,2008,3,0,3
ZMB,Zambia,CZE,Czech Republic,2009,4,0,4
ZMB,Zambia,CZE,Czech Republic,2010,6,0,6
ZMB,Zambia,CZE,Czech Republic,2011,2,0,2
ZMB,Zambia,CZE,Czech Republic,2012,5,2,3
ZMB,Zambia,CZE,Czech Republic,2013,6,10,-4
ZMB,Zambia,CZE,Czech Republic,2014,9,3,6
ZMB,Zambia,CZE,Czech Republic,2015,7,4,3
ZMB,Zambia,CZE,Czech Republic,2016,7,5,2
ZMB,Zambia,CZE,Czech Republic,2017,5,2,3
ZMB,Zambia,DNK,Denmark,2008,25,9,16
ZMB,Zambia,DNK,Denmark,2009,25,2,23
ZMB,Zambia,DNK,Denmark,2010,19,12,7
ZMB,Zambia,DNK,Denmark,2011,22,10,12
ZMB,Zambia,DNK,Denmark,2012,21,10,11
ZMB,Zambia,DNK,Denmark,2013,25,10,15
ZMB,Zambia,DNK,Denmark,2014,15,14,1
ZMB,Zambia,DNK,Denmark,2015,17,8,9
ZMB,Zambia,DNK,Denmark,2016,16,5,11
ZMB,Zambia,DNK,Denmark,2017,15,12,3
ZMB,Zambia,FIN,Finland,2008,19,5,14
ZMB,Zambia,FIN,Finland,2009,10,0,10
ZMB,Zambia,FIN,Finland,2010,10,0,10
ZMB,Zambia,FIN,Finland,2011,13,8,5
ZMB,Zambia,FIN,Finland,2012,7,0,7
ZMB,Zambia,FIN,Finland,2013,13,4,9
ZMB,Zambia,FIN,Finland,2014,5,2,3
ZMB,Zambia,FIN,Finland,2015,10,4,6
ZMB,Zambia,FIN,Finland,2016,12,6,6
ZMB,Zambia,FIN,Finland,2017,10,2,8
ZMB,Zambia,FRA,France,2008,5,0,5
ZMB,Zambia,FRA,France,2009,13,0,13
ZMB,Zambia,FRA,France,2010,4,0,4
ZMB,Zambia,FRA,France,2011,5,0,5
ZMB,Zambia,FRA,France,2012,2,0,2
ZMB,Zambia,FRA,France,2013,6,0,6
ZMB,Zambia,FRA,France,2014,5,0,5
ZMB,Zambia,FRA,France,2015,4,0,4
ZMB,Zambia,FRA,France,2016,5,0,5
ZMB,Zambia,FRA,France,2017,8,0,8
ZMB,Zambia,DEU,Germany,2008,54,60,-6
ZMB,Zambia,DEU,Germany,2009,37,75,-38
ZMB,Zambia,DEU,Germany,2010,37,38,-1
ZMB,Zambia,DEU,Germany,2011,55,41,14
ZMB,Zambia,DEU,Germany,2012,51,27,24
ZMB,Zambia,DEU,Germany,2013,71,40,31
ZMB,Zambia,DEU,Germany,2014,72,35,37
ZMB,Zambia,DEU,Germany,2015,65,47,18
ZMB,Zambia,DEU,Germany,2016,81,40,41
ZMB,Zambia,DEU,Germany,2017,89,34,55
ZMB,Zambia,HUN,Hungary,2008,1,0,1
ZMB,Zambia,HUN,Hungary,2009,1,1,0
ZMB,Zambia,HUN,Hungary,2010,5,0,5
ZMB,Zambia,HUN,Hungary,2011,5,0,5
ZMB,Zambia,HUN,Hungary,2012,1,0,1
ZMB,Zambia,HUN,Hungary,2013,5,1,4
ZMB,Zambia,HUN,Hungary,2014,3,0,3
ZMB,Zambia,HUN,Hungary,2015,2,0,2
ZMB,Zambia,HUN,Hungary,2016,1,0,1
ZMB,Zambia,HUN,Hungary,2017,7,0,7
ZMB,Zambia,ISL,Iceland,2008,0,0,0
ZMB,Zambia,ISL,Iceland,2009,1,1,0
ZMB,Zambia,ISL,Iceland,2010,0,0,0
ZMB,Zambia,ISL,Iceland,2011,1,0,1
ZMB,Zambia,ISL,Iceland,2012,1,0,1
ZMB,Zambia,ISL,Iceland,2013,0,1,-1
ZMB,Zambia,ISL,Iceland,2014,0,0,0
ZMB,Zambia,ISL,Iceland,2015,0,0,0
ZMB,Zambia,ISL,Iceland,2016,0,0,0
ZMB,Zambia,ISL,Iceland,2017,0,0,0
ZMB,Zambia,ITA,Italy,2008,25,2,23
ZMB,Zambia,ITA,Italy,2009,18,2,16
ZMB,Zambia,ITA,Italy,2010,17,0,17
ZMB,Zambia,ITA,Italy,2011,23,4,19
ZMB,Zambia,ITA,Italy,2012,12,0,12
ZMB,Zambia,ITA,Italy,2013,15,7,8
ZMB,Zambia,ITA,Italy,2014,21,1,20
ZMB,Zambia,ITA,Italy,2015,12,3,9
ZMB,Zambia,ITA,Italy,2016,19,0,19
ZMB,Zambia,ITA,Italy,2017,11,1,10
ZMB,Zambia,JPN,Japan,2008,79,74,5
ZMB,Zambia,JPN,Japan,2009,123,115,8
ZMB,Zambia,JPN,Japan,2010,162,129,33
ZMB,Zambia,JPN,Japan,2011,158,156,2
ZMB,Zambia,JPN,Japan,2012,254,230,24
ZMB,Zambia,JPN,Japan,2013,235,231,4
ZMB,Zambia,JPN,Japan,2014,194,180,14
ZMB,Zambia,JPN,Japan,2015,193,179,14
ZMB,Zambia,JPN,Japan,2016,200,169,31
ZMB,Zambia,JPN,Japan,2017,242,199,43
ZMB,Zambia,KOR,Korea,2008,7,2,5
ZMB,Zambia,KOR,Korea,2009,7,7,0
ZMB,Zambia,KOR,Korea,2010,6,5,1
ZMB,Zambia,KOR,Korea,2011,15,10,5
ZMB,Zambia,KOR,Korea,2012,11,18,-7
ZMB,Zambia,KOR,Korea,2013,10,14,-4
ZMB,Zambia,KOR,Korea,2014,18,4,14
ZMB,Zambia,KOR,Korea,2015,16,7,9
ZMB,Zambia,KOR,Korea,2016,11,13,-2
ZMB,Zambia,KOR,Korea,2017,19,13,6
ZMB,Zambia,LUX,Luxembourg,2008,0,0,0
ZMB,Zambia,LUX,Luxembourg,2009,0,0,0
ZMB,Zambia,LUX,Luxembourg,2010,1,0,1
ZMB,Zambia,LUX,Luxembourg,2011,0,0,0
ZMB,Zambia,LUX,Luxembourg,2012,0,0,0
ZMB,Zambia,LUX,Luxembourg,2013,0,0,0
ZMB,Zambia,LUX,Luxembourg,2014,0,0,0
ZMB,Zambia,LUX,Luxembourg,2015,0,0,0
ZMB,Zambia,LUX,Luxembourg,2016,0,0,0
ZMB,Zambia,LUX,Luxembourg,2017,2,0,2
ZMB,Zambia,MEX,Mexico,2012,0,0,0
ZMB,Zambia,MEX,Mexico,2013,1,0,1
ZMB,Zambia,MEX,Mexico,2014,1,0,1
ZMB,Zambia,MEX,Mexico,2016,2,0,2
ZMB,Zambia,NLD,Netherlands,2008,40,30,10
ZMB,Zambia,NLD,Netherlands,2009,45,22,23
ZMB,Zambia,NLD,Netherlands,2010,53,29,24
ZMB,Zambia,NLD,Netherlands,2011,49,43,6
ZMB,Zambia,NLD,Netherlands,2012,50,32,18
ZMB,Zambia,NLD,Netherlands,2013,36,48,-12
ZMB,Zambia,NLD,Netherlands,2014,37,34,3
ZMB,Zambia,NLD,Netherlands,2015,36,39,-3
ZMB,Zambia,NLD,Netherlands,2016,40,47,-7
ZMB,Zambia,NLD,Netherlands,2017,30,35,-5
ZMB,Zambia,NZL,New Zealand,2008,41,18,23
ZMB,Zambia,NZL,New Zealand,2009,29,3,26
ZMB,Zambia,NZL,New Zealand,2010,28,30,-2
ZMB,Zambia,NZL,New Zealand,2011,7,25,-18
ZMB,Zambia,NZL,New Zealand,2012,36,17,19
ZMB,Zambia,NZL,New Zealand,2013,4,9,-5
ZMB,Zambia,NZL,New Zealand,2014,14,5,9
ZMB,Zambia,NZL,New Zealand,2015,7,2,5
ZMB,Zambia,NZL,New Zealand,2016,19,2,17
ZMB,Zambia,NZL,New Zealand,2017,9,5,4
ZMB,Zambia,NOR,Norway,2008,37,17,20
ZMB,Zambia,NOR,Norway,2009,44,27,17
ZMB,Zambia,NOR,Norway,2010,47,27,20
ZMB,Zambia,NOR,Norway,2011,45,32,13
ZMB,Zambia,NOR,Norway,2012,45,28,17
ZMB,Zambia,NOR,Norway,2013,51,39,12
ZMB,Zambia,NOR,Norway,2014,38,39,-1
ZMB,Zambia,NOR,Norway,2015,42,38,4
ZMB,Zambia,NOR,Norway,2016,22,45,-23
ZMB,Zambia,NOR,Norway,2017,27,14,13
ZMB,Zambia,POL,Poland,2009,12,0,12
ZMB,Zambia,POL,Poland,2010,15,0,15
ZMB,Zambia,POL,Poland,2011,12,0,12
ZMB,Zambia,POL,Poland,2012,9,0,9
ZMB,Zambia,POL,Poland,2013,6,0,6
ZMB,Zambia,POL,Poland,2014,3,0,3
ZMB,Zambia,POL,Poland,2015,2,0,2
ZMB,Zambia,POL,Poland,2016,13,0,13
ZMB,Zambia,POL,Poland,2017,8,0,8
ZMB,Zambia,SVK,Slovak Republic,2008,1,0,1
ZMB,Zambia,SVK,Slovak Republic,2009,4,0,4
ZMB,Zambia,SVK,Slovak Republic,2010,1,0,1
ZMB,Zambia,ESP,Spain,2008,7,4,3
ZMB,Zambia,ESP,Spain,2009,9,0,9
ZMB,Zambia,ESP,Spain,2010,3,1,2
ZMB,Zambia,ESP,Spain,2011,3,1,2
ZMB,Zambia,ESP,Spain,2012,1,0,1
ZMB,Zambia,ESP,Spain,2013,7,2,5
ZMB,Zambia,ESP,Spain,2014,5,0,5
ZMB,Zambia,ESP,Spain,2015,4,1,3
ZMB,Zambia,ESP,Spain,2016,8,3,5
ZMB,Zambia,ESP,Spain,2017,13,3,10
ZMB,Zambia,SWE,Sweden,2008,28,11,17
ZMB,Zambia,SWE,Sweden,2009,21,4,17
ZMB,Zambia,SWE,Sweden,2010,12,7,5
ZMB,Zambia,SWE,Sweden,2011,22,5,17
ZMB,Zambia,SWE,Sweden,2012,29,6,23
ZMB,Zambia,SWE,Sweden,2013,24,5,19
ZMB,Zambia,SWE,Sweden,2014,46,8,38
ZMB,Zambia,SWE,Sweden,2015,21,15,6
ZMB,Zambia,SWE,Sweden,2016,32,7,25
ZMB,Zambia,SWE,Sweden,2017,47,25,22
ZMB,Zambia,CHE,Switzerland,2010,9,4,5
ZMB,Zambia,CHE,Switzerland,2011,8,1,7
ZMB,Zambia,CHE,Switzerland,2012,7,5,2
ZMB,Zambia,CHE,Switzerland,2013,14,6,8
ZMB,Zambia,CHE,Switzerland,2014,15,6,9
ZMB,Zambia,CHE,Switzerland,2015,5,5,0
ZMB,Zambia,CHE,Switzerland,2016,12,2,10
ZMB,Zambia,CHE,Switzerland,2017,16,9,7
ZMB,Zambia,USA,United States,2008,613,0,613
ZMB,Zambia,USA,United States,2009,704,0,704
ZMB,Zambia,USA,United States,2010,628,0,628
ZMB,Zambia,USA,United States,2011,652,0,652
ZMB,Zambia,USA,United States,2012,643,0,643
ZMB,Zambia,USA,United States,2013,505,0,505
ZMB,Zambia,USA,United States,2014,441,0,441
ZMB,Zambia,USA,United States,2015,460,0,460
ZMB,Zambia,USA,United States,2016,487,0,487
ZMB,Zambia,USA,United States,2017,537,0,537
ZMB,Zambia,CHL,Chile,2008,0,0,0
ZMB,Zambia,CHL,Chile,2009,0,0,0
ZMB,Zambia,CHL,Chile,2010,0,0,0
ZMB,Zambia,CHL,Chile,2011,1,0,1
ZMB,Zambia,CHL,Chile,2012,0,0,0
ZMB,Zambia,CHL,Chile,2013,0,0,0
ZMB,Zambia,CHL,Chile,2014,1,0,1
ZMB,Zambia,CHL,Chile,2015,0,0,0
ZMB,Zambia,CHL,Chile,2016,0,0,0
ZMB,Zambia,EST,Estonia,2008,0,0,0
ZMB,Zambia,EST,Estonia,2009,0,0,0
ZMB,Zambia,EST,Estonia,2010,0,0,0
ZMB,Zambia,EST,Estonia,2011,0,0,0
ZMB,Zambia,EST,Estonia,2012,0,0,0
ZMB,Zambia,EST,Estonia,2013,1,0,1
ZMB,Zambia,EST,Estonia,2014,0,0,0
ZMB,Zambia,EST,Estonia,2015,0,0,0
ZMB,Zambia,EST,Estonia,2016,0,0,0
ZMB,Zambia,EST,Estonia,2017,0,0,0
ZMB,Zambia,SVN,Slovenia,2015,1,0,1
ZMB,Zambia,SVN,Slovenia,2017,1,0,1
ZWE,Zimbabwe,AUS,Australia,2008,1429,170,1259
ZWE,Zimbabwe,AUS,Australia,2009,1628,157,1471
ZWE,Zimbabwe,AUS,Australia,2010,1763,185,1578
ZWE,Zimbabwe,AUS,Australia,2011,1418,206,1212
ZWE,Zimbabwe,AUS,Australia,2012,1060,151,909
ZWE,Zimbabwe,AUS,Australia,2013,1059,214,845
ZWE,Zimbabwe,AUS,Australia,2014,831,158,673
ZWE,Zimbabwe,AUS,Australia,2015,806,300,506
ZWE,Zimbabwe,AUS,Australia,2016,767,200,567
ZWE,Zimbabwe,AUS,Australia,2017,850,0,850
ZWE,Zimbabwe,AUT,Austria,2008,22,11,11
ZWE,Zimbabwe,AUT,Austria,2009,29,13,16
ZWE,Zimbabwe,AUT,Austria,2010,43,19,24
ZWE,Zimbabwe,AUT,Austria,2011,28,20,8
ZWE,Zimbabwe,AUT,Austria,2012,25,14,11
ZWE,Zimbabwe,AUT,Austria,2013,21,21,0
ZWE,Zimbabwe,AUT,Austria,2014,22,15,7
ZWE,Zimbabwe,AUT,Austria,2015,14,19,-5
ZWE,Zimbabwe,AUT,Austria,2016,22,11,11
ZWE,Zimbabwe,AUT,Austria,2017,25,14,11
ZWE,Zimbabwe,BEL,Belgium,2008,26,0,26
ZWE,Zimbabwe,BEL,Belgium,2009,40,0,40
ZWE,Zimbabwe,BEL,Belgium,2010,40,0,40
ZWE,Zimbabwe,BEL,Belgium,2012,26,29,-3
ZWE,Zimbabwe,BEL,Belgium,2013,29,14,15
ZWE,Zimbabwe,BEL,Belgium,2014,18,21,-3
ZWE,Zimbabwe,BEL,Belgium,2015,22,10,12
ZWE,Zimbabwe,BEL,Belgium,2016,22,10,12
ZWE,Zimbabwe,BEL,Belgium,2017,25,15,10
ZWE,Zimbabwe,CAN,Canada,2008,611,0,611
ZWE,Zimbabwe,CAN,Canada,2009,508,0,508
ZWE,Zimbabwe,CAN,Canada,2010,494,0,494
ZWE,Zimbabwe,CAN,Canada,2011,434,0,434
ZWE,Zimbabwe,CAN,Canada,2012,437,0,437
ZWE,Zimbabwe,CAN,Canada,2013,408,0,408
ZWE,Zimbabwe,CAN,Canada,2014,332,0,332
ZWE,Zimbabwe,CAN,Canada,2015,238,0,238
ZWE,Zimbabwe,CAN,Canada,2016,285,0,285
ZWE,Zimbabwe,CAN,Canada,2017,420,0,420
ZWE,Zimbabwe,CZE,Czech Republic,2008,5,0,5
ZWE,Zimbabwe,CZE,Czech Republic,2009,5,0,5
ZWE,Zimbabwe,CZE,Czech Republic,2010,2,0,2
ZWE,Zimbabwe,CZE,Czech Republic,2011,2,0,2
ZWE,Zimbabwe,CZE,Czech Republic,2012,5,0,5
ZWE,Zimbabwe,CZE,Czech Republic,2013,6,2,4
ZWE,Zimbabwe,CZE,Czech Republic,2014,8,4,4
ZWE,Zimbabwe,CZE,Czech Republic,2015,6,3,3
ZWE,Zimbabwe,CZE,Czech Republic,2016,6,1,5
ZWE,Zimbabwe,CZE,Czech Republic,2017,11,1,10
ZWE,Zimbabwe,DNK,Denmark,2008,10,5,5
ZWE,Zimbabwe,DNK,Denmark,2009,17,5,12
ZWE,Zimbabwe,DNK,Denmark,2010,12,5,7
ZWE,Zimbabwe,DNK,Denmark,2011,15,2,13
ZWE,Zimbabwe,DNK,Denmark,2012,5,8,-3
ZWE,Zimbabwe,DNK,Denmark,2013,9,10,-1
ZWE,Zimbabwe,DNK,Denmark,2014,9,7,2
ZWE,Zimbabwe,DNK,Denmark,2015,5,7,-2
ZWE,Zimbabwe,DNK,Denmark,2016,8,9,-1
ZWE,Zimbabwe,DNK,Denmark,2017,19,6,13
ZWE,Zimbabwe,FIN,Finland,2008,4,0,4
ZWE,Zimbabwe,FIN,Finland,2009,4,0,4
ZWE,Zimbabwe,FIN,Finland,2010,5,0,5
ZWE,Zimbabwe,FIN,Finland,2011,2,0,2
ZWE,Zimbabwe,FIN,Finland,2012,3,1,2
ZWE,Zimbabwe,FIN,Finland,2013,10,0,10
ZWE,Zimbabwe,FIN,Finland,2014,7,0,7
ZWE,Zimbabwe,FIN,Finland,2015,5,1,4
ZWE,Zimbabwe,FIN,Finland,2016,10,1,9
ZWE,Zimbabwe,FIN,Finland,2017,4,5,-1
ZWE,Zimbabwe,FRA,France,2008,19,0,19
ZWE,Zimbabwe,FRA,France,2009,18,0,18
ZWE,Zimbabwe,FRA,France,2010,20,0,20
ZWE,Zimbabwe,FRA,France,2011,11,0,11
ZWE,Zimbabwe,FRA,France,2012,16,0,16
ZWE,Zimbabwe,FRA,France,2013,13,0,13
ZWE,Zimbabwe,FRA,France,2014,16,0,16
ZWE,Zimbabwe,FRA,France,2015,17,0,17
ZWE,Zimbabwe,FRA,France,2016,23,0,23
ZWE,Zimbabwe,FRA,France,2017,16,0,16
ZWE,Zimbabwe,DEU,Germany,2008,166,92,74
ZWE,Zimbabwe,DEU,Germany,2009,277,148,129
ZWE,Zimbabwe,DEU,Germany,2010,181,132,49
ZWE,Zimbabwe,DEU,Germany,2011,177,91,86
ZWE,Zimbabwe,DEU,Germany,2012,170,129,41
ZWE,Zimbabwe,DEU,Germany,2013,163,106,57
ZWE,Zimbabwe,DEU,Germany,2014,166,112,54
ZWE,Zimbabwe,DEU,Germany,2015,204,110,94
ZWE,Zimbabwe,DEU,Germany,2016,443,85,358
ZWE,Zimbabwe,DEU,Germany,2017,580,109,471
ZWE,Zimbabwe,HUN,Hungary,2008,1,0,1
ZWE,Zimbabwe,HUN,Hungary,2009,6,0,6
ZWE,Zimbabwe,HUN,Hungary,2010,1,1,0
ZWE,Zimbabwe,HUN,Hungary,2011,4,1,3
ZWE,Zimbabwe,HUN,Hungary,2012,1,0,1
ZWE,Zimbabwe,HUN,Hungary,2013,1,1,0
ZWE,Zimbabwe,HUN,Hungary,2014,2,1,1
ZWE,Zimbabwe,HUN,Hungary,2015,6,0,6
ZWE,Zimbabwe,HUN,Hungary,2016,16,1,15
ZWE,Zimbabwe,HUN,Hungary,2017,25,0,25
ZWE,Zimbabwe,ISL,Iceland,2008,0,1,-1
ZWE,Zimbabwe,ISL,Iceland,2009,0,0,0
ZWE,Zimbabwe,ISL,Iceland,2010,0,0,0
ZWE,Zimbabwe,ISL,Iceland,2011,0,0,0
ZWE,Zimbabwe,ISL,Iceland,2012,0,0,0
ZWE,Zimbabwe,ISL,Iceland,2013,0,0,0
ZWE,Zimbabwe,ISL,Iceland,2014,1,0,1
ZWE,Zimbabwe,ISL,Iceland,2015,1,0,1
ZWE,Zimbabwe,ISL,Iceland,2016,0,0,0
ZWE,Zimbabwe,ISL,Iceland,2017,0,0,0
ZWE,Zimbabwe,ITA,Italy,2008,30,3,27
ZWE,Zimbabwe,ITA,Italy,2009,17,3,14
ZWE,Zimbabwe,ITA,Italy,2010,32,0,32
ZWE,Zimbabwe,ITA,Italy,2011,11,1,10
ZWE,Zimbabwe,ITA,Italy,2012,17,0,17
ZWE,Zimbabwe,ITA,Italy,2013,11,1,10
ZWE,Zimbabwe,ITA,Italy,2014,14,0,14
ZWE,Zimbabwe,ITA,Italy,2015,11,1,10
ZWE,Zimbabwe,ITA,Italy,2016,14,0,14
ZWE,Zimbabwe,ITA,Italy,2017,20,0,20
ZWE,Zimbabwe,JPN,Japan,2008,70,59,11
ZWE,Zimbabwe,JPN,Japan,2009,74,71,3
ZWE,Zimbabwe,JPN,Japan,2010,113,112,1
ZWE,Zimbabwe,JPN,Japan,2011,89,82,7
ZWE,Zimbabwe,JPN,Japan,2012,163,159,4
ZWE,Zimbabwe,JPN,Japan,2013,205,193,12
ZWE,Zimbabwe,JPN,Japan,2014,98,94,4
ZWE,Zimbabwe,JPN,Japan,2015,196,176,20
ZWE,Zimbabwe,JPN,Japan,2016,194,179,15
ZWE,Zimbabwe,JPN,Japan,2017,139,104,35
ZWE,Zimbabwe,KOR,Korea,2008,18,13,5
ZWE,Zimbabwe,KOR,Korea,2009,9,9,0
ZWE,Zimbabwe,KOR,Korea,2010,15,9,6
ZWE,Zimbabwe,KOR,Korea,2011,14,13,1
ZWE,Zimbabwe,KOR,Korea,2012,18,15,3
ZWE,Zimbabwe,KOR,Korea,2013,20,12,8
ZWE,Zimbabwe,KOR,Korea,2014,20,25,-5
ZWE,Zimbabwe,KOR,Korea,2015,40,17,23
ZWE,Zimbabwe,KOR,Korea,2016,30,28,2
ZWE,Zimbabwe,KOR,Korea,2017,37,30,7
ZWE,Zimbabwe,LUX,Luxembourg,2008,2,0,2
ZWE,Zimbabwe,LUX,Luxembourg,2009,0,2,-2
ZWE,Zimbabwe,LUX,Luxembourg,2010,4,0,4
ZWE,Zimbabwe,LUX,Luxembourg,2011,1,0,1
ZWE,Zimbabwe,LUX,Luxembourg,2012,0,1,-1
ZWE,Zimbabwe,LUX,Luxembourg,2013,1,0,1
ZWE,Zimbabwe,LUX,Luxembourg,2014,5,1,4
ZWE,Zimbabwe,LUX,Luxembourg,2015,4,0,4
ZWE,Zimbabwe,LUX,Luxembourg,2016,2,0,2
ZWE,Zimbabwe,LUX,Luxembourg,2017,1,2,-1
ZWE,Zimbabwe,MEX,Mexico,2011,2,0,2
ZWE,Zimbabwe,MEX,Mexico,2012,0,0,0
ZWE,Zimbabwe,MEX,Mexico,2013,6,0,6
ZWE,Zimbabwe,MEX,Mexico,2014,5,0,5
ZWE,Zimbabwe,MEX,Mexico,2016,1,0,1
ZWE,Zimbabwe,MEX,Mexico,2017,1,0,1
ZWE,Zimbabwe,NLD,Netherlands,2008,111,41,70
ZWE,Zimbabwe,NLD,Netherlands,2009,115,40,75
ZWE,Zimbabwe,NLD,Netherlands,2010,100,80,20
ZWE,Zimbabwe,NLD,Netherlands,2011,77,76,1
ZWE,Zimbabwe,NLD,Netherlands,2012,70,67,3
ZWE,Zimbabwe,NLD,Netherlands,2013,65,95,-30
ZWE,Zimbabwe,NLD,Netherlands,2014,60,77,-17
ZWE,Zimbabwe,NLD,Netherlands,2015,67,60,7
ZWE,Zimbabwe,NLD,Netherlands,2016,76,60,16
ZWE,Zimbabwe,NLD,Netherlands,2017,102,45,57
ZWE,Zimbabwe,NZL,New Zealand,2008,377,39,338
ZWE,Zimbabwe,NZL,New Zealand,2009,245,34,211
ZWE,Zimbabwe,NZL,New Zealand,2010,124,40,84
ZWE,Zimbabwe,NZL,New Zealand,2011,101,77,24
ZWE,Zimbabwe,NZL,New Zealand,2012,91,39,52
ZWE,Zimbabwe,NZL,New Zealand,2013,55,28,27
ZWE,Zimbabwe,NZL,New Zealand,2014,84,28,56
ZWE,Zimbabwe,NZL,New Zealand,2015,62,7,55
ZWE,Zimbabwe,NZL,New Zealand,2016,100,8,92
ZWE,Zimbabwe,NZL,New Zealand,2017,132,11,121
ZWE,Zimbabwe,NOR,Norway,2008,13,12,1
ZWE,Zimbabwe,NOR,Norway,2009,11,7,4
ZWE,Zimbabwe,NOR,Norway,2010,22,7,15
ZWE,Zimbabwe,NOR,Norway,2011,20,13,7
ZWE,Zimbabwe,NOR,Norway,2012,20,13,7
ZWE,Zimbabwe,NOR,Norway,2013,19,13,6
ZWE,Zimbabwe,NOR,Norway,2014,13,7,6
ZWE,Zimbabwe,NOR,Norway,2015,14,13,1
ZWE,Zimbabwe,NOR,Norway,2016,18,13,5
ZWE,Zimbabwe,NOR,Norway,2017,28,9,19
ZWE,Zimbabwe,POL,Poland,2008,27,0,27
ZWE,Zimbabwe,POL,Poland,2009,32,0,32
ZWE,Zimbabwe,POL,Poland,2010,36,0,36
ZWE,Zimbabwe,POL,Poland,2011,27,0,27
ZWE,Zimbabwe,POL,Poland,2012,30,0,30
ZWE,Zimbabwe,POL,Poland,2013,25,0,25
ZWE,Zimbabwe,POL,Poland,2014,11,0,11
ZWE,Zimbabwe,POL,Poland,2015,19,0,19
ZWE,Zimbabwe,POL,Poland,2016,35,0,35
ZWE,Zimbabwe,POL,Poland,2017,40,0,40
ZWE,Zimbabwe,SVK,Slovak Republic,2008,1,0,1
ZWE,Zimbabwe,SVK,Slovak Republic,2010,2,0,2
ZWE,Zimbabwe,SVK,Slovak Republic,2015,1,0,1
ZWE,Zimbabwe,ESP,Spain,2008,17,6,11
ZWE,Zimbabwe,ESP,Spain,2009,15,5,10
ZWE,Zimbabwe,ESP,Spain,2010,15,7,8
ZWE,Zimbabwe,ESP,Spain,2011,11,6,5
ZWE,Zimbabwe,ESP,Spain,2012,9,3,6
ZWE,Zimbabwe,ESP,Spain,2013,10,2,8
ZWE,Zimbabwe,ESP,Spain,2014,16,8,8
ZWE,Zimbabwe,ESP,Spain,2015,12,3,9
ZWE,Zimbabwe,ESP,Spain,2016,21,5,16
ZWE,Zimbabwe,ESP,Spain,2017,24,6,18
ZWE,Zimbabwe,SWE,Sweden,2008,28,1,27
ZWE,Zimbabwe,SWE,Sweden,2009,20,7,13
ZWE,Zimbabwe,SWE,Sweden,2010,23,6,17
ZWE,Zimbabwe,SWE,Sweden,2011,30,3,27
ZWE,Zimbabwe,SWE,Sweden,2012,26,7,19
ZWE,Zimbabwe,SWE,Sweden,2013,15,3,12
ZWE,Zimbabwe,SWE,Sweden,2014,39,7,32
ZWE,Zimbabwe,SWE,Sweden,2015,25,10,15
ZWE,Zimbabwe,SWE,Sweden,2016,53,5,48
ZWE,Zimbabwe,SWE,Sweden,2017,34,13,21
ZWE,Zimbabwe,CHE,Switzerland,2010,53,29,24
ZWE,Zimbabwe,CHE,Switzerland,2011,48,31,17
ZWE,Zimbabwe,CHE,Switzerland,2012,27,47,-20
ZWE,Zimbabwe,CHE,Switzerland,2013,41,44,-3
ZWE,Zimbabwe,CHE,Switzerland,2014,28,26,2
ZWE,Zimbabwe,CHE,Switzerland,2015,35,33,2
ZWE,Zimbabwe,CHE,Switzerland,2016,34,41,-7
ZWE,Zimbabwe,CHE,Switzerland,2017,25,17,8
ZWE,Zimbabwe,TUR,Turkey,2010,2,0,2
ZWE,Zimbabwe,GBR,United Kingdom,2011,1000,1000,0
ZWE,Zimbabwe,GBR,United Kingdom,2012,2000,0,2000
ZWE,Zimbabwe,GBR,United Kingdom,2015,1000,0,1000
ZWE,Zimbabwe,USA,United States,2008,953,0,953
ZWE,Zimbabwe,USA,United States,2009,983,0,983
ZWE,Zimbabwe,USA,United States,2010,1274,0,1274
ZWE,Zimbabwe,USA,United States,2011,1016,0,1016
ZWE,Zimbabwe,USA,United States,2012,914,0,914
ZWE,Zimbabwe,USA,United States,2013,924,0,924
ZWE,Zimbabwe,USA,United States,2014,797,0,797
ZWE,Zimbabwe,USA,United States,2015,779,0,779
ZWE,Zimbabwe,USA,United States,2016,815,0,815
ZWE,Zimbabwe,USA,United States,2017,810,0,810
ZWE,Zimbabwe,CHL,Chile,2008,2,0,2
ZWE,Zimbabwe,CHL,Chile,2009,0,0,0
ZWE,Zimbabwe,CHL,Chile,2010,0,0,0
ZWE,Zimbabwe,CHL,Chile,2011,0,0,0
ZWE,Zimbabwe,CHL,Chile,2012,0,0,0
ZWE,Zimbabwe,CHL,Chile,2013,0,0,0
ZWE,Zimbabwe,CHL,Chile,2014,1,0,1
ZWE,Zimbabwe,CHL,Chile,2015,1,0,1
ZWE,Zimbabwe,CHL,Chile,2016,0,0,0
ZWE,Zimbabwe,EST,Estonia,2008,0,0,0
ZWE,Zimbabwe,EST,Estonia,2009,0,0,0
ZWE,Zimbabwe,EST,Estonia,2010,0,0,0
ZWE,Zimbabwe,EST,Estonia,2011,0,0,0
ZWE,Zimbabwe,EST,Estonia,2012,0,0,0
ZWE,Zimbabwe,EST,Estonia,2013,0,0,0
ZWE,Zimbabwe,EST,Estonia,2014,0,0,0
ZWE,Zimbabwe,EST,Estonia,2015,0,0,0
ZWE,Zimbabwe,EST,Estonia,2016,4,0,4
ZWE,Zimbabwe,EST,Estonia,2017,1,0,1
ZWE,Zimbabwe,SVN,Slovenia,2010,1,0,1
ZWE,Zimbabwe,SVN,Slovenia,2012,1,0,1
TKM,Turkmenistan,SVN,Slovenia,2015,2,0,2
TKM,Turkmenistan,SVN,Slovenia,2016,2,0,2
DZA,Algeria,LVA,Latvia,2014,0,0,0
DZA,Algeria,LVA,Latvia,2015,0,0,0
DZA,Algeria,LVA,Latvia,2017,7,0,7
MEX,Mexico,LVA,Latvia,2008,1,5,-4
MEX,Mexico,LVA,Latvia,2009,8,11,-3
MEX,Mexico,LVA,Latvia,2010,8,2,6
MEX,Mexico,LVA,Latvia,2014,2,6,-4
MEX,Mexico,LVA,Latvia,2015,2,9,-7
MEX,Mexico,LVA,Latvia,2017,1,8,-7
PRT,Portugal,LVA,Latvia,2008,9,0,9
PRT,Portugal,LVA,Latvia,2009,10,0,10
PRT,Portugal,LVA,Latvia,2010,11,0,11
PRT,Portugal,LVA,Latvia,2014,19,0,19
PRT,Portugal,LVA,Latvia,2015,19,0,19
PRT,Portugal,LVA,Latvia,2017,7,0,7
CAF,Central African Republic,LVA,Latvia,2014,0,0,0
CAF,Central African Republic,LVA,Latvia,2015,0,0,0
CAF,Central African Republic,LVA,Latvia,2017,0,0,0
LTU,Lithuania,LVA,Latvia,2008,285,0,285
LTU,Lithuania,LVA,Latvia,2009,212,0,212
LTU,Lithuania,LVA,Latvia,2010,137,0,137
LTU,Lithuania,LVA,Latvia,2013,163,0,163
LTU,Lithuania,LVA,Latvia,2014,184,0,184
LTU,Lithuania,LVA,Latvia,2015,184,0,184
LTU,Lithuania,LVA,Latvia,2017,173,0,173
MDA,Moldova,LVA,Latvia,2008,45,0,45
MDA,Moldova,LVA,Latvia,2009,9,0,9
MDA,Moldova,LVA,Latvia,2010,9,0,9
MDA,Moldova,LVA,Latvia,2014,12,0,12
MDA,Moldova,LVA,Latvia,2015,12,0,12
MDA,Moldova,LVA,Latvia,2017,22,0,22
BGR,Bulgaria,LVA,Latvia,2008,248,0,248
BGR,Bulgaria,LVA,Latvia,2009,16,0,16
BGR,Bulgaria,LVA,Latvia,2010,22,0,22
BGR,Bulgaria,LVA,Latvia,2014,26,0,26
BGR,Bulgaria,LVA,Latvia,2015,26,0,26
BGR,Bulgaria,LVA,Latvia,2017,10,0,10
KGZ,Kyrgyzstan,LVA,Latvia,2008,4,0,4
KGZ,Kyrgyzstan,LVA,Latvia,2009,3,0,3
KGZ,Kyrgyzstan,LVA,Latvia,2010,6,0,6
KGZ,Kyrgyzstan,LVA,Latvia,2014,1,0,1
KGZ,Kyrgyzstan,LVA,Latvia,2015,1,0,1
KGZ,Kyrgyzstan,LVA,Latvia,2017,7,0,7
TLS,Timor-Leste,LVA,Latvia,2014,0,0,0
TLS,Timor-Leste,LVA,Latvia,2015,0,0,0
TLS,Timor-Leste,LVA,Latvia,2017,0,0,0
MNE,Montenegro,LVA,Latvia,2014,0,0,0
MNE,Montenegro,LVA,Latvia,2015,0,0,0
MNE,Montenegro,LVA,Latvia,2017,1,0,1
LBN,Lebanon,LVA,Latvia,2009,1,0,1
LBN,Lebanon,LVA,Latvia,2010,3,0,3
LBN,Lebanon,LVA,Latvia,2014,1,0,1
LBN,Lebanon,LVA,Latvia,2015,1,0,1
LBN,Lebanon,LVA,Latvia,2017,5,0,5
AUT,Austria,LVA,Latvia,2008,17,110,-93
AUT,Austria,LVA,Latvia,2009,16,181,-165
AUT,Austria,LVA,Latvia,2010,15,195,-180
AUT,Austria,LVA,Latvia,2014,7,274,-267
AUT,Austria,LVA,Latvia,2015,7,296,-289
AUT,Austria,LVA,Latvia,2017,9,268,-259
BRB,Barbados,LVA,Latvia,2014,0,0,0
BRB,Barbados,LVA,Latvia,2015,0,0,0
BRB,Barbados,LVA,Latvia,2017,0,0,0
PNG,Papua New Guinea,LVA,Latvia,2014,0,0,0
PNG,Papua New Guinea,LVA,Latvia,2015,0,0,0
PNG,Papua New Guinea,LVA,Latvia,2017,0,0,0
COD,Democratic Republic of the Congo,LVA,Latvia,2014,0,0,0
COD,Democratic Republic of the Congo,LVA,Latvia,2015,0,0,0
COD,Democratic Republic of the Congo,LVA,Latvia,2017,3,0,3
COG,Congo,LVA,Latvia,2014,0,0,0
COG,Congo,LVA,Latvia,2015,0,0,0
COG,Congo,LVA,Latvia,2017,0,0,0
BOL,Bolivia,LVA,Latvia,2014,0,0,0
BOL,Bolivia,LVA,Latvia,2015,0,0,0
BOL,Bolivia,LVA,Latvia,2017,0,0,0
MOZ,Mozambique,LVA,Latvia,2014,0,0,0
MOZ,Mozambique,LVA,Latvia,2015,0,0,0
MOZ,Mozambique,LVA,Latvia,2017,0,0,0
SVK,Slovak Republic,LVA,Latvia,2014,5,7,-2
SVK,Slovak Republic,LVA,Latvia,2015,5,17,-12
SVK,Slovak Republic,LVA,Latvia,2017,7,9,-2
EGY,Egypt,LVA,Latvia,2014,7,0,7
EGY,Egypt,LVA,Latvia,2015,7,0,7
EGY,Egypt,LVA,Latvia,2017,20,0,20
URY,Uruguay,LVA,Latvia,2014,1,0,1
URY,Uruguay,LVA,Latvia,2015,1,0,1
URY,Uruguay,LVA,Latvia,2017,0,0,0
SVN,Slovenia,LVA,Latvia,2014,0,25,-25
SVN,Slovenia,LVA,Latvia,2015,0,35,-35
SVN,Slovenia,LVA,Latvia,2017,6,19,-13
NGA,Nigeria,LVA,Latvia,2014,5,0,5
NGA,Nigeria,LVA,Latvia,2015,5,0,5
NGA,Nigeria,LVA,Latvia,2017,7,0,7
BRN,Brunei Darussalam,LVA,Latvia,2014,0,0,0
BRN,Brunei Darussalam,LVA,Latvia,2015,0,0,0
BRN,Brunei Darussalam,LVA,Latvia,2017,0,0,0
THA,Thailand,LVA,Latvia,2014,2,0,2
THA,Thailand,LVA,Latvia,2015,2,0,2
THA,Thailand,LVA,Latvia,2017,5,0,5
MDV,Maldives,LVA,Latvia,2014,0,0,0
MDV,Maldives,LVA,Latvia,2015,0,0,0
MDV,Maldives,LVA,Latvia,2017,0,0,0
LUX,Luxembourg,LVA,Latvia,2009,2,50,-48
LUX,Luxembourg,LVA,Latvia,2010,0,64,-64
LUX,Luxembourg,LVA,Latvia,2014,0,84,-84
LUX,Luxembourg,LVA,Latvia,2015,0,68,-68
LUX,Luxembourg,LVA,Latvia,2017,1,60,-59
BFA,Burkina Faso,LVA,Latvia,2014,0,0,0
BFA,Burkina Faso,LVA,Latvia,2015,0,0,0
BFA,Burkina Faso,LVA,Latvia,2017,0,0,0
PRY,Paraguay,LVA,Latvia,2014,0,0,0
PRY,Paraguay,LVA,Latvia,2015,0,0,0
PRY,Paraguay,LVA,Latvia,2017,0,0,0
FSM,Micronesia,LVA,Latvia,2014,0,0,0
FSM,Micronesia,LVA,Latvia,2015,0,0,0
FSM,Micronesia,LVA,Latvia,2017,0,0,0
NLD,Netherlands,LVA,Latvia,2008,14,245,-231
NLD,Netherlands,LVA,Latvia,2009,20,577,-557
NLD,Netherlands,LVA,Latvia,2010,13,1016,-1003
NLD,Netherlands,LVA,Latvia,2014,19,1074,-1055
NLD,Netherlands,LVA,Latvia,2015,19,960,-941
NLD,Netherlands,LVA,Latvia,2017,10,1189,-1179
BIH,Bosnia and Herzegovina,LVA,Latvia,2014,1,0,1
BIH,Bosnia and Herzegovina,LVA,Latvia,2015,1,0,1
BIH,Bosnia and Herzegovina,LVA,Latvia,2017,2,0,2
MAR,Morocco,LVA,Latvia,2014,0,0,0
MAR,Morocco,LVA,Latvia,2015,0,0,0
MAR,Morocco,LVA,Latvia,2017,4,0,4
PRI,Puerto Rico,LVA,Latvia,2014,0,0,0
PRI,Puerto Rico,LVA,Latvia,2017,0,0,0
NIU,Niue,LVA,Latvia,2014,0,0,0
NIU,Niue,LVA,Latvia,2017,0,0,0
BTN,Bhutan,LVA,Latvia,2014,0,0,0
BTN,Bhutan,LVA,Latvia,2015,0,0,0
BTN,Bhutan,LVA,Latvia,2017,0,0,0
MAC,Macau,LVA,Latvia,2014,0,0,0
MAC,Macau,LVA,Latvia,2017,0,0,0
COK,Cook Islands,LVA,Latvia,2014,0,0,0
COK,Cook Islands,LVA,Latvia,2017,0,0,0
PLW,Palau,LVA,Latvia,2014,0,0,0
PLW,Palau,LVA,Latvia,2015,0,0,0
PLW,Palau,LVA,Latvia,2017,0,0,0
MLI,Mali,LVA,Latvia,2014,0,0,0
MLI,Mali,LVA,Latvia,2015,0,0,0
MLI,Mali,LVA,Latvia,2017,0,0,0
TCD,Chad,LVA,Latvia,2014,0,0,0
TCD,Chad,LVA,Latvia,2015,0,0,0
TCD,Chad,LVA,Latvia,2017,0,0,0
RWA,Rwanda,LVA,Latvia,2014,0,0,0
RWA,Rwanda,LVA,Latvia,2015,0,0,0
RWA,Rwanda,LVA,Latvia,2017,0,0,0
COM,Comoros,LVA,Latvia,2014,0,0,0
COM,Comoros,LVA,Latvia,2015,0,0,0
COM,Comoros,LVA,Latvia,2017,0,0,0
MYS,Malaysia,LVA,Latvia,2014,1,0,1
MYS,Malaysia,LVA,Latvia,2015,1,0,1
MYS,Malaysia,LVA,Latvia,2017,1,0,1
AUS,Australia,LVA,Latvia,2008,1,47,-46
AUS,Australia,LVA,Latvia,2009,4,48,-44
AUS,Australia,LVA,Latvia,2010,4,74,-70
AUS,Australia,LVA,Latvia,2014,2,48,-46
AUS,Australia,LVA,Latvia,2015,2,38,-36
AUS,Australia,LVA,Latvia,2017,4,34,-30
SLB,Solomon Islands,LVA,Latvia,2014,0,0,0
SLB,Solomon Islands,LVA,Latvia,2015,0,0,0
SLB,Solomon Islands,LVA,Latvia,2017,0,0,0
CPV,Cape Verde,LVA,Latvia,2014,0,0,0
CPV,Cape Verde,LVA,Latvia,2015,0,0,0
CPV,Cape Verde,LVA,Latvia,2017,0,0,0
VEN,Venezuela,LVA,Latvia,2014,0,0,0
VEN,Venezuela,LVA,Latvia,2015,0,0,0
VEN,Venezuela,LVA,Latvia,2017,2,0,2
ISL,Iceland,LVA,Latvia,2008,8,254,-246
ISL,Iceland,LVA,Latvia,2009,9,160,-151
ISL,Iceland,LVA,Latvia,2010,6,106,-100
ISL,Iceland,LVA,Latvia,2014,1,102,-101
ISL,Iceland,LVA,Latvia,2015,1,127,-126
ISL,Iceland,LVA,Latvia,2017,0,601,-601
SYR,Syria,LVA,Latvia,2008,1,0,1
SYR,Syria,LVA,Latvia,2009,2,0,2
SYR,Syria,LVA,Latvia,2010,0,0,0
SYR,Syria,LVA,Latvia,2014,2,0,2
SYR,Syria,LVA,Latvia,2015,2,0,2
SYR,Syria,LVA,Latvia,2017,4,0,4
BHS,Bahamas,LVA,Latvia,2014,0,0,0
BHS,Bahamas,LVA,Latvia,2015,0,0,0
BHS,Bahamas,LVA,Latvia,2017,0,0,0
GUY,Guyana,LVA,Latvia,2014,0,0,0
GUY,Guyana,LVA,Latvia,2015,0,0,0
GUY,Guyana,LVA,Latvia,2017,0,0,0
MDG,Madagascar,LVA,Latvia,2014,0,0,0
MDG,Madagascar,LVA,Latvia,2015,0,0,0
MDG,Madagascar,LVA,Latvia,2017,0,0,0
VUT,Vanuatu,LVA,Latvia,2014,0,0,0
VUT,Vanuatu,LVA,Latvia,2015,0,0,0
VUT,Vanuatu,LVA,Latvia,2017,0,0,0
JOR,Jordan,LVA,Latvia,2014,1,0,1
JOR,Jordan,LVA,Latvia,2015,1,0,1
JOR,Jordan,LVA,Latvia,2017,0,0,0
YEM,Yemen,LVA,Latvia,2014,0,0,0
YEM,Yemen,LVA,Latvia,2015,0,0,0
YEM,Yemen,LVA,Latvia,2017,0,0,0
IRQ,Iraq,LVA,Latvia,2014,0,0,0
IRQ,Iraq,LVA,Latvia,2015,0,0,0
IRQ,Iraq,LVA,Latvia,2017,1,0,1
BMU,Bermuda,LVA,Latvia,2014,0,0,0
BMU,Bermuda,LVA,Latvia,2015,0,0,0
BMU,Bermuda,LVA,Latvia,2017,0,0,0
JAM,Jamaica,LVA,Latvia,2014,0,0,0
JAM,Jamaica,LVA,Latvia,2015,0,0,0
JAM,Jamaica,LVA,Latvia,2017,0,0,0
UGA,Uganda,LVA,Latvia,2014,0,0,0
UGA,Uganda,LVA,Latvia,2015,0,0,0
UGA,Uganda,LVA,Latvia,2017,0,0,0
AZE,Azerbaijan,LVA,Latvia,2008,2,0,2
AZE,Azerbaijan,LVA,Latvia,2009,11,0,11
AZE,Azerbaijan,LVA,Latvia,2010,3,0,3
AZE,Azerbaijan,LVA,Latvia,2014,24,0,24
AZE,Azerbaijan,LVA,Latvia,2015,24,0,24
AZE,Azerbaijan,LVA,Latvia,2017,99,0,99
MKD,North Macedonia,LVA,Latvia,2014,2,0,2
MKD,North Macedonia,LVA,Latvia,2015,2,0,2
MKD,North Macedonia,LVA,Latvia,2017,2,0,2
ARG,Argentina,LVA,Latvia,2014,0,0,0
ARG,Argentina,LVA,Latvia,2015,0,0,0
ARG,Argentina,LVA,Latvia,2017,3,0,3
KOR,Korea,LVA,Latvia,2008,28,6,22
KOR,Korea,LVA,Latvia,2009,10,15,-5
KOR,Korea,LVA,Latvia,2010,10,15,-5
KOR,Korea,LVA,Latvia,2014,12,16,-4
KOR,Korea,LVA,Latvia,2015,12,37,-25
KOR,Korea,LVA,Latvia,2017,6,17,-11
TTO,Trinidad and Tobago,LVA,Latvia,2014,0,0,0
TTO,Trinidad and Tobago,LVA,Latvia,2015,0,0,0
TTO,Trinidad and Tobago,LVA,Latvia,2017,0,0,0
BLZ,Belize,LVA,Latvia,2014,0,0,0
BLZ,Belize,LVA,Latvia,2015,0,0,0
BLZ,Belize,LVA,Latvia,2017,0,0,0
VNM,Viet Nam,LVA,Latvia,2008,2,0,2
VNM,Viet Nam,LVA,Latvia,2009,7,0,7
VNM,Viet Nam,LVA,Latvia,2010,0,0,0
VNM,Viet Nam,LVA,Latvia,2014,3,0,3
VNM,Viet Nam,LVA,Latvia,2015,3,0,3
VNM,Viet Nam,LVA,Latvia,2017,8,0,8
BHR,Bahrain,LVA,Latvia,2014,0,0,0
BHR,Bahrain,LVA,Latvia,2015,0,0,0
BHR,Bahrain,LVA,Latvia,2017,0,0,0
KWT,Kuwait,LVA,Latvia,2014,1,0,1
KWT,Kuwait,LVA,Latvia,2015,1,0,1
KWT,Kuwait,LVA,Latvia,2017,0,0,0
UKR,Ukraine,LVA,Latvia,2008,107,0,107
UKR,Ukraine,LVA,Latvia,2009,78,0,78
UKR,Ukraine,LVA,Latvia,2010,91,0,91
UKR,Ukraine,LVA,Latvia,2013,383,0,383
UKR,Ukraine,LVA,Latvia,2014,547,0,547
UKR,Ukraine,LVA,Latvia,2015,547,0,547
UKR,Ukraine,LVA,Latvia,2017,873,0,873
NAM,Namibia,LVA,Latvia,2014,0,0,0
NAM,Namibia,LVA,Latvia,2015,0,0,0
NAM,Namibia,LVA,Latvia,2017,0,0,0
ATG,Antigua and Barbuda,LVA,Latvia,2014,0,0,0
ATG,Antigua and Barbuda,LVA,Latvia,2015,0,0,0
ATG,Antigua and Barbuda,LVA,Latvia,2017,0,0,0
PAK,Pakistan,LVA,Latvia,2008,1,0,1
PAK,Pakistan,LVA,Latvia,2009,1,0,1
PAK,Pakistan,LVA,Latvia,2010,2,0,2
PAK,Pakistan,LVA,Latvia,2014,2,0,2
PAK,Pakistan,LVA,Latvia,2015,2,0,2
PAK,Pakistan,LVA,Latvia,2017,77,0,77
PRK,Democratic People's Republic of Korea,LVA,Latvia,2014,0,0,0
PRK,Democratic People's Republic of Korea,LVA,Latvia,2015,0,0,0
PRK,Democratic People's Republic of Korea,LVA,Latvia,2017,0,0,0
IND,India,LVA,Latvia,2008,4,0,4
IND,India,LVA,Latvia,2009,7,0,7
IND,India,LVA,Latvia,2010,5,0,5
IND,India,LVA,Latvia,2014,50,0,50
IND,India,LVA,Latvia,2015,50,0,50
IND,India,LVA,Latvia,2017,634,0,634
LCA,Saint Lucia,LVA,Latvia,2014,0,0,0
LCA,Saint Lucia,LVA,Latvia,2015,0,0,0
LCA,Saint Lucia,LVA,Latvia,2017,0,0,0
TUV,Tuvalu,LVA,Latvia,2014,0,0,0
TUV,Tuvalu,LVA,Latvia,2015,0,0,0
TUV,Tuvalu,LVA,Latvia,2017,0,0,0
MNG,Mongolia,LVA,Latvia,2014,1,0,1
MNG,Mongolia,LVA,Latvia,2015,1,0,1
MNG,Mongolia,LVA,Latvia,2017,3,0,3
TON,Tonga,LVA,Latvia,2014,0,0,0
TON,Tonga,LVA,Latvia,2015,0,0,0
TON,Tonga,LVA,Latvia,2017,0,0,0
BEN,Benin,LVA,Latvia,2014,0,0,0
BEN,Benin,LVA,Latvia,2015,0,0,0
BEN,Benin,LVA,Latvia,2017,1,0,1
KAZ,Kazakhstan,LVA,Latvia,2008,5,0,5
KAZ,Kazakhstan,LVA,Latvia,2009,11,0,11
KAZ,Kazakhstan,LVA,Latvia,2010,23,0,23
KAZ,Kazakhstan,LVA,Latvia,2014,36,0,36
KAZ,Kazakhstan,LVA,Latvia,2015,36,0,36
KAZ,Kazakhstan,LVA,Latvia,2017,90,0,90
SOM,Somalia,LVA,Latvia,2014,0,0,0
SOM,Somalia,LVA,Latvia,2015,0,0,0
SOM,Somalia,LVA,Latvia,2017,0,0,0
GRC,Greece,LVA,Latvia,2008,4,0,4
GRC,Greece,LVA,Latvia,2009,5,0,5
GRC,Greece,LVA,Latvia,2010,1,0,1
GRC,Greece,LVA,Latvia,2014,5,0,5
GRC,Greece,LVA,Latvia,2015,5,0,5
GRC,Greece,LVA,Latvia,2017,6,0,6
JPN,Japan,LVA,Latvia,2014,3,51,-48
JPN,Japan,LVA,Latvia,2015,3,157,-154
JPN,Japan,LVA,Latvia,2017,5,120,-115
TGO,Togo,LVA,Latvia,2014,0,0,0
TGO,Togo,LVA,Latvia,2015,0,0,0
TGO,Togo,LVA,Latvia,2017,0,0,0
DEU,Germany,LVA,Latvia,2008,209,2066,-1857
DEU,Germany,LVA,Latvia,2009,161,4896,-4735
DEU,Germany,LVA,Latvia,2010,176,7485,-7309
DEU,Germany,LVA,Latvia,2013,234,8403,-8169
DEU,Germany,LVA,Latvia,2014,235,7457,-7222
DEU,Germany,LVA,Latvia,2015,235,6608,-6373
DEU,Germany,LVA,Latvia,2017,99,7283,-7184
PAN,Panama,LVA,Latvia,2014,0,0,0
PAN,Panama,LVA,Latvia,2015,0,0,0
PAN,Panama,LVA,Latvia,2017,1,0,1
SLE,Sierra Leone,LVA,Latvia,2014,0,0,0
SLE,Sierra Leone,LVA,Latvia,2015,0,0,0
SLE,Sierra Leone,LVA,Latvia,2017,0,0,0
GIN,Guinea,LVA,Latvia,2014,0,0,0
GIN,Guinea,LVA,Latvia,2015,0,0,0
GIN,Guinea,LVA,Latvia,2017,0,0,0
FRA,France,LVA,Latvia,2008,76,0,76
FRA,France,LVA,Latvia,2009,51,0,51
FRA,France,LVA,Latvia,2010,63,0,63
FRA,France,LVA,Latvia,2014,18,262,-244
FRA,France,LVA,Latvia,2015,18,70,-52
FRA,France,LVA,Latvia,2017,36,106,-70
ARM,Armenia,LVA,Latvia,2008,8,0,8
ARM,Armenia,LVA,Latvia,2009,5,0,5
ARM,Armenia,LVA,Latvia,2010,3,0,3
ARM,Armenia,LVA,Latvia,2014,14,0,14
ARM,Armenia,LVA,Latvia,2015,14,0,14
ARM,Armenia,LVA,Latvia,2017,39,0,39
MWI,Malawi,LVA,Latvia,2014,0,0,0
MWI,Malawi,LVA,Latvia,2015,0,0,0
MWI,Malawi,LVA,Latvia,2017,0,0,0
SRB,Serbia,LVA,Latvia,2008,4,0,4
SRB,Serbia,LVA,Latvia,2010,1,0,1
SRB,Serbia,LVA,Latvia,2014,2,0,2
SRB,Serbia,LVA,Latvia,2015,2,0,2
SRB,Serbia,LVA,Latvia,2017,2,0,2
ESP,Spain,LVA,Latvia,2008,49,354,-305
ESP,Spain,LVA,Latvia,2009,36,623,-587
ESP,Spain,LVA,Latvia,2010,41,493,-452
ESP,Spain,LVA,Latvia,2014,19,383,-364
ESP,Spain,LVA,Latvia,2015,19,399,-380
ESP,Spain,LVA,Latvia,2017,41,570,-529
AGO,Angola,LVA,Latvia,2014,0,0,0
AGO,Angola,LVA,Latvia,2015,0,0,0
AGO,Angola,LVA,Latvia,2017,0,0,0
NPL,Nepal,LVA,Latvia,2014,5,0,5
NPL,Nepal,LVA,Latvia,2015,5,0,5
NPL,Nepal,LVA,Latvia,2017,12,0,12
TWN,Chinese Taipei,LVA,Latvia,2014,0,0,0
TWN,Chinese Taipei,LVA,Latvia,2015,0,0,0
TWN,Chinese Taipei,LVA,Latvia,2017,6,0,6
HTI,Haiti,LVA,Latvia,2014,0,0,0
HTI,Haiti,LVA,Latvia,2015,0,0,0
HTI,Haiti,LVA,Latvia,2017,0,0,0
TKL,Tokelau,LVA,Latvia,2014,0,0,0
TKL,Tokelau,LVA,Latvia,2017,0,0,0
MHL,Marshall Islands,LVA,Latvia,2014,0,0,0
MHL,Marshall Islands,LVA,Latvia,2015,0,0,0
MHL,Marshall Islands,LVA,Latvia,2017,0,0,0
SWZ,Swaziland,LVA,Latvia,2014,0,0,0
SWZ,Swaziland,LVA,Latvia,2015,0,0,0
SWZ,Swaziland,LVA,Latvia,2017,0,0,0
ETH,Ethiopia,LVA,Latvia,2014,0,0,0
ETH,Ethiopia,LVA,Latvia,2015,0,0,0
ETH,Ethiopia,LVA,Latvia,2017,0,0,0
CHE,Switzerland,LVA,Latvia,2008,6,174,-168
CHE,Switzerland,LVA,Latvia,2009,7,217,-210
CHE,Switzerland,LVA,Latvia,2010,6,224,-218
CHE,Switzerland,LVA,Latvia,2014,3,301,-298
CHE,Switzerland,LVA,Latvia,2015,3,267,-264
CHE,Switzerland,LVA,Latvia,2017,6,277,-271
KNA,Saint Kitts and Nevis,LVA,Latvia,2014,0,0,0
KNA,Saint Kitts and Nevis,LVA,Latvia,2015,0,0,0
KNA,Saint Kitts and Nevis,LVA,Latvia,2017,0,0,0
BRA,Brazil,LVA,Latvia,2008,12,0,12
BRA,Brazil,LVA,Latvia,2010,4,0,4
BRA,Brazil,LVA,Latvia,2014,5,0,5
BRA,Brazil,LVA,Latvia,2015,5,0,5
BRA,Brazil,LVA,Latvia,2017,7,0,7
GHA,Ghana,LVA,Latvia,2014,4,0,4
GHA,Ghana,LVA,Latvia,2015,4,0,4
GHA,Ghana,LVA,Latvia,2017,4,0,4
MLT,Malta,LVA,Latvia,2008,3,0,3
MLT,Malta,LVA,Latvia,2009,1,0,1
MLT,Malta,LVA,Latvia,2010,1,0,1
MLT,Malta,LVA,Latvia,2014,1,0,1
MLT,Malta,LVA,Latvia,2015,1,0,1
MLT,Malta,LVA,Latvia,2017,2,0,2
GNB,Guinea-Bissau,LVA,Latvia,2014,0,0,0
GNB,Guinea-Bissau,LVA,Latvia,2015,0,0,0
GNB,Guinea-Bissau,LVA,Latvia,2017,0,0,0
GTM,Guatemala,LVA,Latvia,2014,0,0,0
GTM,Guatemala,LVA,Latvia,2015,0,0,0
GTM,Guatemala,LVA,Latvia,2017,1,0,1
SWE,Sweden,LVA,Latvia,2008,69,404,-335
SWE,Sweden,LVA,Latvia,2009,89,928,-839
SWE,Sweden,LVA,Latvia,2010,63,767,-704
SWE,Sweden,LVA,Latvia,2014,104,688,-584
SWE,Sweden,LVA,Latvia,2015,104,735,-631
SWE,Sweden,LVA,Latvia,2017,41,776,-735
PSE,West Bank and Gaza Strip,LVA,Latvia,2014,0,0,0
PSE,West Bank and Gaza Strip,LVA,Latvia,2015,0,0,0
PSE,West Bank and Gaza Strip,LVA,Latvia,2017,1,0,1
LKA,Sri Lanka,LVA,Latvia,2008,1,0,1
LKA,Sri Lanka,LVA,Latvia,2010,0,0,0
LKA,Sri Lanka,LVA,Latvia,2014,7,0,7
LKA,Sri Lanka,LVA,Latvia,2015,7,0,7
LKA,Sri Lanka,LVA,Latvia,2017,54,0,54
CIV,Côte d'Ivoire,LVA,Latvia,2014,0,0,0
CIV,Côte d'Ivoire,LVA,Latvia,2015,0,0,0
CIV,Côte d'Ivoire,LVA,Latvia,2017,0,0,0
HKG,"Hong Kong, China",LVA,Latvia,2014,0,0,0
HKG,"Hong Kong, China",LVA,Latvia,2017,0,0,0
KEN,Kenya,LVA,Latvia,2014,0,0,0
KEN,Kenya,LVA,Latvia,2015,0,0,0
KEN,Kenya,LVA,Latvia,2017,1,0,1
AND,Andorra,LVA,Latvia,2014,0,0,0
AND,Andorra,LVA,Latvia,2015,0,0,0
AND,Andorra,LVA,Latvia,2017,0,0,0
DJI,Djibouti,LVA,Latvia,2014,0,0,0
DJI,Djibouti,LVA,Latvia,2015,0,0,0
DJI,Djibouti,LVA,Latvia,2017,0,0,0
ECU,Ecuador,LVA,Latvia,2014,0,0,0
ECU,Ecuador,LVA,Latvia,2015,0,0,0
ECU,Ecuador,LVA,Latvia,2017,1,0,1
SCG,Serbia and Montenegro,LVA,Latvia,2014,0,0,0
SCG,Serbia and Montenegro,LVA,Latvia,2017,0,0,0
IRN,Iran,LVA,Latvia,2014,1,0,1
IRN,Iran,LVA,Latvia,2015,1,0,1
IRN,Iran,LVA,Latvia,2017,2,0,2
ERI,Eritrea,LVA,Latvia,2014,0,0,0
ERI,Eritrea,LVA,Latvia,2015,0,0,0
ERI,Eritrea,LVA,Latvia,2017,0,0,0
NZL,New Zealand,LVA,Latvia,2014,1,43,-42
NZL,New Zealand,LVA,Latvia,2015,1,81,-80
NZL,New Zealand,LVA,Latvia,2017,8,68,-60
BGD,Bangladesh,LVA,Latvia,2014,0,0,0
BGD,Bangladesh,LVA,Latvia,2015,0,0,0
BGD,Bangladesh,LVA,Latvia,2017,4,0,4
VCT,Saint Vincent and the Grenadines,LVA,Latvia,2014,0,0,0
VCT,Saint Vincent and the Grenadines,LVA,Latvia,2015,0,0,0
VCT,Saint Vincent and the Grenadines,LVA,Latvia,2017,0,0,0
QAT,Qatar,LVA,Latvia,2014,0,0,0
QAT,Qatar,LVA,Latvia,2015,0,0,0
QAT,Qatar,LVA,Latvia,2017,0,0,0
HUN,Hungary,LVA,Latvia,2008,14,7,7
HUN,Hungary,LVA,Latvia,2009,3,17,-14
HUN,Hungary,LVA,Latvia,2010,2,12,-10
HUN,Hungary,LVA,Latvia,2014,3,15,-12
HUN,Hungary,LVA,Latvia,2015,3,20,-17
HUN,Hungary,LVA,Latvia,2017,5,19,-14
USA,United States,LVA,Latvia,2008,47,455,-408
USA,United States,LVA,Latvia,2009,27,444,-417
USA,United States,LVA,Latvia,2010,35,435,-400
USA,United States,LVA,Latvia,2014,33,384,-351
USA,United States,LVA,Latvia,2015,33,480,-447
USA,United States,LVA,Latvia,2017,47,359,-312
CRI,Costa Rica,LVA,Latvia,2014,0,0,0
CRI,Costa Rica,LVA,Latvia,2015,0,0,0
CRI,Costa Rica,LVA,Latvia,2017,0,0,0
BEL,Belgium,LVA,Latvia,2008,3,163,-160
BEL,Belgium,LVA,Latvia,2009,11,253,-242
BEL,Belgium,LVA,Latvia,2010,12,325,-313
BEL,Belgium,LVA,Latvia,2014,2,185,-183
BEL,Belgium,LVA,Latvia,2015,2,155,-153
BEL,Belgium,LVA,Latvia,2017,9,240,-231
DMA,Dominica,LVA,Latvia,2014,0,0,0
DMA,Dominica,LVA,Latvia,2015,0,0,0
DMA,Dominica,LVA,Latvia,2017,0,0,0
MCO,Monaco,LVA,Latvia,2014,0,0,0
MCO,Monaco,LVA,Latvia,2015,0,0,0
MCO,Monaco,LVA,Latvia,2017,0,0,0
IDN,Indonesia,LVA,Latvia,2014,2,0,2
IDN,Indonesia,LVA,Latvia,2015,2,0,2
IDN,Indonesia,LVA,Latvia,2017,1,0,1
DNK,Denmark,LVA,Latvia,2008,19,442,-423
DNK,Denmark,LVA,Latvia,2009,44,729,-685
DNK,Denmark,LVA,Latvia,2010,20,860,-840
DNK,Denmark,LVA,Latvia,2014,13,588,-575
DNK,Denmark,LVA,Latvia,2015,13,539,-526
DNK,Denmark,LVA,Latvia,2017,18,560,-542
SYC,Seychelles,LVA,Latvia,2014,0,0,0
SYC,Seychelles,LVA,Latvia,2015,0,0,0
SYC,Seychelles,LVA,Latvia,2017,0,0,0
HRV,Croatia,LVA,Latvia,2014,1,0,1
HRV,Croatia,LVA,Latvia,2015,1,0,1
HRV,Croatia,LVA,Latvia,2017,3,0,3
NER,Niger,LVA,Latvia,2014,0,0,0
NER,Niger,LVA,Latvia,2015,0,0,0
NER,Niger,LVA,Latvia,2017,0,0,0
CYP,Cyprus,LVA,Latvia,2014,2,0,2
CYP,Cyprus,LVA,Latvia,2015,2,0,2
CYP,Cyprus,LVA,Latvia,2017,1,0,1
GNQ,Equatorial Guinea,LVA,Latvia,2014,0,0,0
GNQ,Equatorial Guinea,LVA,Latvia,2015,0,0,0
GNQ,Equatorial Guinea,LVA,Latvia,2017,0,0,0
SEN,Senegal,LVA,Latvia,2014,0,0,0
SEN,Senegal,LVA,Latvia,2015,0,0,0
SEN,Senegal,LVA,Latvia,2017,1,0,1
LBY,Libya,LVA,Latvia,2014,0,0,0
LBY,Libya,LVA,Latvia,2015,0,0,0
LBY,Libya,LVA,Latvia,2017,2,0,2
ZWE,Zimbabwe,LVA,Latvia,2014,0,0,0
ZWE,Zimbabwe,LVA,Latvia,2015,0,0,0
ZWE,Zimbabwe,LVA,Latvia,2017,0,0,0
KIR,Kiribati,LVA,Latvia,2014,0,0,0
KIR,Kiribati,LVA,Latvia,2015,0,0,0
KIR,Kiribati,LVA,Latvia,2017,0,0,0
SGP,Singapore,LVA,Latvia,2014,2,0,2
SGP,Singapore,LVA,Latvia,2015,2,0,2
SGP,Singapore,LVA,Latvia,2017,2,0,2
ARE,United Arab Emirates,LVA,Latvia,2014,0,0,0
ARE,United Arab Emirates,LVA,Latvia,2015,0,0,0
ARE,United Arab Emirates,LVA,Latvia,2017,0,0,0
NRU,Nauru,LVA,Latvia,2014,0,0,0
NRU,Nauru,LVA,Latvia,2015,0,0,0
NRU,Nauru,LVA,Latvia,2017,0,0,0
ZAF,South Africa,LVA,Latvia,2014,3,0,3
ZAF,South Africa,LVA,Latvia,2015,3,0,3
ZAF,South Africa,LVA,Latvia,2017,2,0,2
TUR,Turkey,LVA,Latvia,2008,4,0,4
TUR,Turkey,LVA,Latvia,2009,8,0,8
TUR,Turkey,LVA,Latvia,2010,7,39,-32
TUR,Turkey,LVA,Latvia,2014,11,0,11
TUR,Turkey,LVA,Latvia,2015,11,0,11
TUR,Turkey,LVA,Latvia,2017,47,0,47
RUS,Russia,LVA,Latvia,2008,403,0,403
RUS,Russia,LVA,Latvia,2009,709,0,709
RUS,Russia,LVA,Latvia,2010,868,0,868
RUS,Russia,LVA,Latvia,2013,2469,0,2469
RUS,Russia,LVA,Latvia,2014,1309,0,1309
RUS,Russia,LVA,Latvia,2015,1309,0,1309
RUS,Russia,LVA,Latvia,2017,874,0,874
HND,Honduras,LVA,Latvia,2014,0,0,0
HND,Honduras,LVA,Latvia,2015,0,0,0
HND,Honduras,LVA,Latvia,2017,1,0,1
BWA,Botswana,LVA,Latvia,2014,0,0,0
BWA,Botswana,LVA,Latvia,2015,0,0,0
BWA,Botswana,LVA,Latvia,2017,0,0,0
GMB,Gambia,LVA,Latvia,2014,0,0,0
GMB,Gambia,LVA,Latvia,2015,0,0,0
GMB,Gambia,LVA,Latvia,2017,1,0,1
NOR,Norway,LVA,Latvia,2008,36,614,-578
NOR,Norway,LVA,Latvia,2009,38,1129,-1091
NOR,Norway,LVA,Latvia,2010,34,2292,-2258
NOR,Norway,LVA,Latvia,2014,37,1123,-1086
NOR,Norway,LVA,Latvia,2015,37,844,-807
NOR,Norway,LVA,Latvia,2017,11,689,-678
EST,Estonia,LVA,Latvia,2008,79,78,1
EST,Estonia,LVA,Latvia,2009,71,101,-30
EST,Estonia,LVA,Latvia,2010,48,54,-6
EST,Estonia,LVA,Latvia,2014,31,52,-21
EST,Estonia,LVA,Latvia,2015,31,326,-295
EST,Estonia,LVA,Latvia,2017,38,863,-825
LAO,Laos,LVA,Latvia,2014,0,0,0
LAO,Laos,LVA,Latvia,2015,0,0,0
LAO,Laos,LVA,Latvia,2017,0,0,0
MRT,Mauritania,LVA,Latvia,2014,1,0,1
MRT,Mauritania,LVA,Latvia,2015,1,0,1
MRT,Mauritania,LVA,Latvia,2017,0,0,0
AFG,Afghanistan,LVA,Latvia,2014,1,0,1
AFG,Afghanistan,LVA,Latvia,2015,1,0,1
AFG,Afghanistan,LVA,Latvia,2017,0,0,0
LIE,Liechtenstein,LVA,Latvia,2014,0,0,0
LIE,Liechtenstein,LVA,Latvia,2015,0,0,0
LIE,Liechtenstein,LVA,Latvia,2017,0,0,0
ALB,Albania,LVA,Latvia,2014,2,0,2
ALB,Albania,LVA,Latvia,2015,2,0,2
ALB,Albania,LVA,Latvia,2017,2,0,2
LBR,Liberia,LVA,Latvia,2014,0,0,0
LBR,Liberia,LVA,Latvia,2015,0,0,0
LBR,Liberia,LVA,Latvia,2017,0,0,0
TZA,Tanzania,LVA,Latvia,2014,0,0,0
TZA,Tanzania,LVA,Latvia,2015,0,0,0
TZA,Tanzania,LVA,Latvia,2017,0,0,0
CMR,Cameroon,LVA,Latvia,2014,0,0,0
CMR,Cameroon,LVA,Latvia,2015,0,0,0
CMR,Cameroon,LVA,Latvia,2017,2,0,2
ZMB,Zambia,LVA,Latvia,2014,0,0,0
ZMB,Zambia,LVA,Latvia,2015,0,0,0
ZMB,Zambia,LVA,Latvia,2017,0,0,0
SUR,Suriname,LVA,Latvia,2014,0,0,0
SUR,Suriname,LVA,Latvia,2015,0,0,0
SUR,Suriname,LVA,Latvia,2017,0,0,0
TUN,Tunisia,LVA,Latvia,2014,1,0,1
TUN,Tunisia,LVA,Latvia,2015,1,0,1
TUN,Tunisia,LVA,Latvia,2017,0,0,0
FJI,Fiji,LVA,Latvia,2014,0,0,0
FJI,Fiji,LVA,Latvia,2015,0,0,0
FJI,Fiji,LVA,Latvia,2017,0,0,0
CHL,Chile,LVA,Latvia,2014,1,6,-5
CHL,Chile,LVA,Latvia,2015,1,14,-13
CHL,Chile,LVA,Latvia,2017,1,0,1
GAB,Gabon,LVA,Latvia,2014,1,0,1
GAB,Gabon,LVA,Latvia,2015,1,0,1
GAB,Gabon,LVA,Latvia,2017,0,0,0
MUS,Mauritius,LVA,Latvia,2014,0,0,0
MUS,Mauritius,LVA,Latvia,2015,0,0,0
MUS,Mauritius,LVA,Latvia,2017,2,0,2
GRD,Grenada,LVA,Latvia,2014,0,0,0
GRD,Grenada,LVA,Latvia,2015,0,0,0
GRD,Grenada,LVA,Latvia,2017,0,0,0
ROU,Romania,LVA,Latvia,2008,190,0,190
ROU,Romania,LVA,Latvia,2009,74,0,74
ROU,Romania,LVA,Latvia,2010,8,0,8
ROU,Romania,LVA,Latvia,2014,14,0,14
ROU,Romania,LVA,Latvia,2015,14,0,14
ROU,Romania,LVA,Latvia,2017,32,0,32
GBR,United Kingdom,LVA,Latvia,2008,67,0,67
GBR,United Kingdom,LVA,Latvia,2009,52,0,52
GBR,United Kingdom,LVA,Latvia,2010,60,8000,-7940
GBR,United Kingdom,LVA,Latvia,2014,75,6000,-5925
GBR,United Kingdom,LVA,Latvia,2015,75,2000,-1925
GBR,United Kingdom,LVA,Latvia,2017,56,0,56
TJK,Tajikistan,LVA,Latvia,2014,7,0,7
TJK,Tajikistan,LVA,Latvia,2015,7,0,7
TJK,Tajikistan,LVA,Latvia,2017,18,0,18
ISR,Israel,LVA,Latvia,2008,22,0,22
ISR,Israel,LVA,Latvia,2009,11,0,11
ISR,Israel,LVA,Latvia,2010,10,0,10
ISR,Israel,LVA,Latvia,2013,60,0,60
ISR,Israel,LVA,Latvia,2014,20,0,20
ISR,Israel,LVA,Latvia,2015,20,0,20
ISR,Israel,LVA,Latvia,2017,21,0,21
TKM,Turkmenistan,LVA,Latvia,2009,4,0,4
TKM,Turkmenistan,LVA,Latvia,2010,2,0,2
TKM,Turkmenistan,LVA,Latvia,2014,1,0,1
TKM,Turkmenistan,LVA,Latvia,2015,1,0,1
TKM,Turkmenistan,LVA,Latvia,2017,8,0,8
SAU,Saudi Arabia,LVA,Latvia,2014,0,0,0
SAU,Saudi Arabia,LVA,Latvia,2015,0,0,0
SAU,Saudi Arabia,LVA,Latvia,2017,0,0,0
OMN,Oman,LVA,Latvia,2014,0,0,0
OMN,Oman,LVA,Latvia,2015,0,0,0
OMN,Oman,LVA,Latvia,2017,0,0,0
UZB,Uzbekistan,LVA,Latvia,2008,12,0,12
UZB,Uzbekistan,LVA,Latvia,2009,6,0,6
UZB,Uzbekistan,LVA,Latvia,2010,26,0,26
UZB,Uzbekistan,LVA,Latvia,2014,124,0,124
UZB,Uzbekistan,LVA,Latvia,2015,124,0,124
UZB,Uzbekistan,LVA,Latvia,2017,347,0,347
COL,Colombia,LVA,Latvia,2014,0,0,0
COL,Colombia,LVA,Latvia,2015,0,0,0
COL,Colombia,LVA,Latvia,2017,3,0,3
SLV,El Salvador,LVA,Latvia,2014,0,0,0
SLV,El Salvador,LVA,Latvia,2015,0,0,0
SLV,El Salvador,LVA,Latvia,2017,0,0,0
GEO,Georgia,LVA,Latvia,2008,7,0,7
GEO,Georgia,LVA,Latvia,2009,18,0,18
GEO,Georgia,LVA,Latvia,2010,11,0,11
GEO,Georgia,LVA,Latvia,2014,23,0,23
GEO,Georgia,LVA,Latvia,2015,23,0,23
GEO,Georgia,LVA,Latvia,2017,22,0,22
MMR,Myanmar,LVA,Latvia,2014,0,0,0
MMR,Myanmar,LVA,Latvia,2015,0,0,0
MMR,Myanmar,LVA,Latvia,2017,0,0,0
CHN,China,LVA,Latvia,2008,2,0,2
CHN,China,LVA,Latvia,2009,3,0,3
CHN,China,LVA,Latvia,2010,1,0,1
CHN,China,LVA,Latvia,2014,57,0,57
CHN,China,LVA,Latvia,2015,57,0,57
CHN,China,LVA,Latvia,2017,51,0,51
SMR,San Marino,LVA,Latvia,2014,0,0,0
SMR,San Marino,LVA,Latvia,2015,0,0,0
SMR,San Marino,LVA,Latvia,2017,0,0,0
DOM,Dominican Republic,LVA,Latvia,2014,0,0,0
DOM,Dominican Republic,LVA,Latvia,2015,0,0,0
DOM,Dominican Republic,LVA,Latvia,2017,0,0,0
SDN,Sudan,LVA,Latvia,2014,0,0,0
SDN,Sudan,LVA,Latvia,2015,0,0,0
SDN,Sudan,LVA,Latvia,2017,0,0,0
LSO,Lesotho,LVA,Latvia,2014,0,0,0
LSO,Lesotho,LVA,Latvia,2015,0,0,0
LSO,Lesotho,LVA,Latvia,2017,0,0,0
STP,Sao Tome and Principe,LVA,Latvia,2014,0,0,0
STP,Sao Tome and Principe,LVA,Latvia,2017,0,0,0
ITA,Italy,LVA,Latvia,2008,48,266,-218
ITA,Italy,LVA,Latvia,2009,52,293,-241
ITA,Italy,LVA,Latvia,2010,40,330,-290
ITA,Italy,LVA,Latvia,2014,44,169,-125
ITA,Italy,LVA,Latvia,2015,44,192,-148
ITA,Italy,LVA,Latvia,2017,40,144,-104
IRL,Ireland,LVA,Latvia,2008,9,0,9
IRL,Ireland,LVA,Latvia,2009,7,0,7
IRL,Ireland,LVA,Latvia,2010,9,0,9
IRL,Ireland,LVA,Latvia,2014,21,0,21
IRL,Ireland,LVA,Latvia,2015,21,0,21
IRL,Ireland,LVA,Latvia,2017,7,0,7
CZE,Czech Republic,LVA,Latvia,2008,27,18,9
CZE,Czech Republic,LVA,Latvia,2009,23,27,-4
CZE,Czech Republic,LVA,Latvia,2010,9,47,-38
CZE,Czech Republic,LVA,Latvia,2014,3,58,-55
CZE,Czech Republic,LVA,Latvia,2015,3,57,-54
CZE,Czech Republic,LVA,Latvia,2017,10,47,-37
POL,Poland,LVA,Latvia,2008,85,55,30
POL,Poland,LVA,Latvia,2009,70,68,2
POL,Poland,LVA,Latvia,2010,43,73,-30
POL,Poland,LVA,Latvia,2013,163,68,95
POL,Poland,LVA,Latvia,2014,27,68,-41
POL,Poland,LVA,Latvia,2015,27,71,-44
POL,Poland,LVA,Latvia,2017,61,112,-51
BLR,Belarus,LVA,Latvia,2008,86,0,86
BLR,Belarus,LVA,Latvia,2009,57,0,57
BLR,Belarus,LVA,Latvia,2010,38,0,38
BLR,Belarus,LVA,Latvia,2013,312,0,312
BLR,Belarus,LVA,Latvia,2014,299,0,299
BLR,Belarus,LVA,Latvia,2015,299,0,299
BLR,Belarus,LVA,Latvia,2017,254,0,254
CAN,Canada,LVA,Latvia,2008,9,67,-58
CAN,Canada,LVA,Latvia,2009,7,85,-78
CAN,Canada,LVA,Latvia,2010,8,70,-62
CAN,Canada,LVA,Latvia,2014,6,163,-157
CAN,Canada,LVA,Latvia,2015,6,130,-124
CAN,Canada,LVA,Latvia,2017,18,105,-87
PER,Peru,LVA,Latvia,2014,1,0,1
PER,Peru,LVA,Latvia,2015,1,0,1
PER,Peru,LVA,Latvia,2017,1,0,1
CUB,Cuba,LVA,Latvia,2014,2,0,2
CUB,Cuba,LVA,Latvia,2015,2,0,2
CUB,Cuba,LVA,Latvia,2017,1,0,1
BDI,Burundi,LVA,Latvia,2014,0,0,0
BDI,Burundi,LVA,Latvia,2015,0,0,0
BDI,Burundi,LVA,Latvia,2017,0,0,0
KHM,Cambodia,LVA,Latvia,2014,0,0,0
KHM,Cambodia,LVA,Latvia,2015,0,0,0
KHM,Cambodia,LVA,Latvia,2017,0,0,0
NIC,Nicaragua,LVA,Latvia,2014,0,0,0
NIC,Nicaragua,LVA,Latvia,2015,0,0,0
NIC,Nicaragua,LVA,Latvia,2017,0,0,0
GUM,Guam,LVA,Latvia,2014,0,0,0
GUM,Guam,LVA,Latvia,2017,0,0,0
PHL,Philippines,LVA,Latvia,2014,53,0,53
PHL,Philippines,LVA,Latvia,2015,53,0,53
PHL,Philippines,LVA,Latvia,2017,2,0,2
WSM,Samoa,LVA,Latvia,2014,0,0,0
WSM,Samoa,LVA,Latvia,2015,0,0,0
WSM,Samoa,LVA,Latvia,2017,0,0,0
FIN,Finland,LVA,Latvia,2008,53,91,-38
FIN,Finland,LVA,Latvia,2009,34,129,-95
FIN,Finland,LVA,Latvia,2010,39,186,-147
FIN,Finland,LVA,Latvia,2014,48,244,-196
FIN,Finland,LVA,Latvia,2015,48,203,-155
FIN,Finland,LVA,Latvia,2017,20,267,-247
AUS,Australia,AFG,Afghanistan,2008,77,2033,-1956
AUS,Australia,AFG,Afghanistan,2009,96,1696,-1600
AUS,Australia,AFG,Afghanistan,2010,105,1618,-1513
AUS,Australia,AFG,Afghanistan,2011,164,2030,-1866
AUS,Australia,AFG,Afghanistan,2012,116,1623,-1507
AUS,Australia,AFG,Afghanistan,2013,114,2178,-2064
AUS,Australia,AFG,Afghanistan,2014,115,5686,-5571
AUS,Australia,AFG,Afghanistan,2015,100,3323,-3223
AUS,Australia,AFG,Afghanistan,2016,100,3197,-3097
AUS,Australia,AFG,Afghanistan,2017,0,3566,-3566
AUT,Austria,AFG,Afghanistan,2008,111,958,-847
AUT,Austria,AFG,Afghanistan,2009,297,1422,-1125
AUT,Austria,AFG,Afghanistan,2010,317,1281,-964
AUT,Austria,AFG,Afghanistan,2011,252,2908,-2656
AUT,Austria,AFG,Afghanistan,2012,794,3756,-2962
AUT,Austria,AFG,Afghanistan,2013,611,2305,-1694
AUT,Austria,AFG,Afghanistan,2014,462,3171,-2709
AUT,Austria,AFG,Afghanistan,2015,896,19505,-18609
AUT,Austria,AFG,Afghanistan,2016,2668,11660,-8992
AUT,Austria,AFG,Afghanistan,2017,1954,2103,-149
BEL,Belgium,AFG,Afghanistan,2008,0,138,-138
BEL,Belgium,AFG,Afghanistan,2009,0,150,-150
BEL,Belgium,AFG,Afghanistan,2010,19,208,-189
BEL,Belgium,AFG,Afghanistan,2011,0,285,-285
BEL,Belgium,AFG,Afghanistan,2012,379,2804,-2425
BEL,Belgium,AFG,Afghanistan,2013,765,1255,-490
BEL,Belgium,AFG,Afghanistan,2014,481,1134,-653
BEL,Belgium,AFG,Afghanistan,2015,317,7453,-7136
BEL,Belgium,AFG,Afghanistan,2016,205,2481,-2276
BEL,Belgium,AFG,Afghanistan,2017,431,1537,-1106
CAN,Canada,AFG,Afghanistan,2008,0,2110,-2110
CAN,Canada,AFG,Afghanistan,2009,0,1745,-1745
CAN,Canada,AFG,Afghanistan,2010,0,1758,-1758
CAN,Canada,AFG,Afghanistan,2011,0,2203,-2203
CAN,Canada,AFG,Afghanistan,2012,0,2635,-2635
CAN,Canada,AFG,Afghanistan,2013,0,2003,-2003
CAN,Canada,AFG,Afghanistan,2014,0,1489,-1489
CAN,Canada,AFG,Afghanistan,2015,0,2587,-2587
CAN,Canada,AFG,Afghanistan,2016,0,2635,-2635
CAN,Canada,AFG,Afghanistan,2017,0,3440,-3440
CZE,Czech Republic,AFG,Afghanistan,2008,6,21,-15
CZE,Czech Republic,AFG,Afghanistan,2009,0,13,-13
CZE,Czech Republic,AFG,Afghanistan,2010,0,27,-27
CZE,Czech Republic,AFG,Afghanistan,2011,1,25,-24
CZE,Czech Republic,AFG,Afghanistan,2012,1,25,-24
CZE,Czech Republic,AFG,Afghanistan,2013,17,24,-7
CZE,Czech Republic,AFG,Afghanistan,2014,9,32,-23
CZE,Czech Republic,AFG,Afghanistan,2015,9,55,-46
CZE,Czech Republic,AFG,Afghanistan,2016,49,84,-35
CZE,Czech Republic,AFG,Afghanistan,2017,92,86,6
DNK,Denmark,AFG,Afghanistan,2008,25,154,-129
DNK,Denmark,AFG,Afghanistan,2009,13,325,-312
DNK,Denmark,AFG,Afghanistan,2010,30,669,-639
DNK,Denmark,AFG,Afghanistan,2011,27,710,-683
DNK,Denmark,AFG,Afghanistan,2012,31,540,-509
DNK,Denmark,AFG,Afghanistan,2013,24,645,-621
DNK,Denmark,AFG,Afghanistan,2014,21,526,-505
DNK,Denmark,AFG,Afghanistan,2015,33,267,-234
DNK,Denmark,AFG,Afghanistan,2016,36,361,-325
DNK,Denmark,AFG,Afghanistan,2017,32,589,-557
FIN,Finland,AFG,Afghanistan,2008,8,219,-211
FIN,Finland,AFG,Afghanistan,2009,8,226,-218
FIN,Finland,AFG,Afghanistan,2010,4,321,-317
FIN,Finland,AFG,Afghanistan,2011,3,373,-370
FIN,Finland,AFG,Afghanistan,2012,4,593,-589
FIN,Finland,AFG,Afghanistan,2013,5,627,-622
FIN,Finland,AFG,Afghanistan,2014,7,515,-508
FIN,Finland,AFG,Afghanistan,2015,7,394,-387
FIN,Finland,AFG,Afghanistan,2016,9,1864,-1855
FIN,Finland,AFG,Afghanistan,2017,11,879,-868
FRA,France,AFG,Afghanistan,2008,0,172,-172
FRA,France,AFG,Afghanistan,2009,0,215,-215
FRA,France,AFG,Afghanistan,2010,0,355,-355
FRA,France,AFG,Afghanistan,2011,0,448,-448
FRA,France,AFG,Afghanistan,2012,0,646,-646
FRA,France,AFG,Afghanistan,2013,0,895,-895
FRA,France,AFG,Afghanistan,2014,0,781,-781
FRA,France,AFG,Afghanistan,2015,0,630,-630
FRA,France,AFG,Afghanistan,2016,0,1706,-1706
FRA,France,AFG,Afghanistan,2017,0,4904,-4904
DEU,Germany,AFG,Afghanistan,2008,1510,1855,-345
DEU,Germany,AFG,Afghanistan,2009,1597,4622,-3025
DEU,Germany,AFG,Afghanistan,2010,1449,7377,-5928
DEU,Germany,AFG,Afghanistan,2011,1453,9321,-7868
DEU,Germany,AFG,Afghanistan,2012,1932,8581,-6649
DEU,Germany,AFG,Afghanistan,2013,1860,9088,-7228
DEU,Germany,AFG,Afghanistan,2014,2057,12922,-10865
DEU,Germany,AFG,Afghanistan,2015,5309,84881,-79572
DEU,Germany,AFG,Afghanistan,2016,19701,75763,-56062
DEU,Germany,AFG,Afghanistan,2017,8849,12489,-3640
HUN,Hungary,AFG,Afghanistan,2008,1,11,-10
HUN,Hungary,AFG,Afghanistan,2009,1,26,-25
HUN,Hungary,AFG,Afghanistan,2010,0,21,-21
HUN,Hungary,AFG,Afghanistan,2011,1,14,-13
HUN,Hungary,AFG,Afghanistan,2012,0,25,-25
HUN,Hungary,AFG,Afghanistan,2013,3,54,-51
HUN,Hungary,AFG,Afghanistan,2014,5,108,-103
HUN,Hungary,AFG,Afghanistan,2015,13,112,-99
HUN,Hungary,AFG,Afghanistan,2016,6,101,-95
HUN,Hungary,AFG,Afghanistan,2017,0,476,-476
ISL,Iceland,AFG,Afghanistan,2008,0,0,0
ISL,Iceland,AFG,Afghanistan,2009,0,0,0
ISL,Iceland,AFG,Afghanistan,2010,0,3,-3
ISL,Iceland,AFG,Afghanistan,2011,0,1,-1
ISL,Iceland,AFG,Afghanistan,2012,1,3,-2
ISL,Iceland,AFG,Afghanistan,2013,0,0,0
ISL,Iceland,AFG,Afghanistan,2014,1,6,-5
ISL,Iceland,AFG,Afghanistan,2015,0,7,-7
ISL,Iceland,AFG,Afghanistan,2016,2,10,-8
ISL,Iceland,AFG,Afghanistan,2017,2,36,-34
ITA,Italy,AFG,Afghanistan,2008,8,1175,-1167
ITA,Italy,AFG,Afghanistan,2009,11,1017,-1006
ITA,Italy,AFG,Afghanistan,2010,13,694,-681
ITA,Italy,AFG,Afghanistan,2011,14,847,-833
ITA,Italy,AFG,Afghanistan,2012,8,1109,-1101
ITA,Italy,AFG,Afghanistan,2013,19,1147,-1128
ITA,Italy,AFG,Afghanistan,2014,43,1527,-1484
ITA,Italy,AFG,Afghanistan,2015,79,2370,-2291
ITA,Italy,AFG,Afghanistan,2016,0,3191,-3191
ITA,Italy,AFG,Afghanistan,2017,125,2120,-1995
JPN,Japan,AFG,Afghanistan,2008,225,364,-139
JPN,Japan,AFG,Afghanistan,2009,287,430,-143
JPN,Japan,AFG,Afghanistan,2010,403,560,-157
JPN,Japan,AFG,Afghanistan,2011,301,553,-252
JPN,Japan,AFG,Afghanistan,2012,543,894,-351
JPN,Japan,AFG,Afghanistan,2013,337,690,-353
JPN,Japan,AFG,Afghanistan,2014,431,773,-342
JPN,Japan,AFG,Afghanistan,2015,564,1118,-554
JPN,Japan,AFG,Afghanistan,2016,407,747,-340
JPN,Japan,AFG,Afghanistan,2017,523,743,-220
KOR,Korea,AFG,Afghanistan,2008,44,84,-40
KOR,Korea,AFG,Afghanistan,2009,67,88,-21
KOR,Korea,AFG,Afghanistan,2010,75,88,-13
KOR,Korea,AFG,Afghanistan,2011,88,158,-70
KOR,Korea,AFG,Afghanistan,2012,95,107,-12
KOR,Korea,AFG,Afghanistan,2013,104,111,-7
KOR,Korea,AFG,Afghanistan,2014,102,92,10
KOR,Korea,AFG,Afghanistan,2015,73,59,14
KOR,Korea,AFG,Afghanistan,2016,68,68,0
KOR,Korea,AFG,Afghanistan,2017,61,81,-20
LUX,Luxembourg,AFG,Afghanistan,2008,2,2,0
LUX,Luxembourg,AFG,Afghanistan,2009,0,18,-18
LUX,Luxembourg,AFG,Afghanistan,2010,6,15,-9
LUX,Luxembourg,AFG,Afghanistan,2011,1,16,-15
LUX,Luxembourg,AFG,Afghanistan,2012,2,11,-9
LUX,Luxembourg,AFG,Afghanistan,2013,4,14,-10
LUX,Luxembourg,AFG,Afghanistan,2014,7,4,3
LUX,Luxembourg,AFG,Afghanistan,2015,4,199,-195
LUX,Luxembourg,AFG,Afghanistan,2016,19,71,-52
LUX,Luxembourg,AFG,Afghanistan,2017,1,20,-19
MEX,Mexico,AFG,Afghanistan,2008,0,1,-1
MEX,Mexico,AFG,Afghanistan,2009,0,1,-1
MEX,Mexico,AFG,Afghanistan,2012,0,4,-4
MEX,Mexico,AFG,Afghanistan,2013,0,1,-1
MEX,Mexico,AFG,Afghanistan,2014,0,0,0
MEX,Mexico,AFG,Afghanistan,2017,0,1,-1
NLD,Netherlands,AFG,Afghanistan,2008,46,236,-190
NLD,Netherlands,AFG,Afghanistan,2009,46,289,-243
NLD,Netherlands,AFG,Afghanistan,2010,29,338,-309
NLD,Netherlands,AFG,Afghanistan,2011,56,275,-219
NLD,Netherlands,AFG,Afghanistan,2012,65,231,-166
NLD,Netherlands,AFG,Afghanistan,2013,56,397,-341
NLD,Netherlands,AFG,Afghanistan,2014,59,554,-495
NLD,Netherlands,AFG,Afghanistan,2015,64,667,-603
NLD,Netherlands,AFG,Afghanistan,2016,76,1879,-1803
NLD,Netherlands,AFG,Afghanistan,2017,224,785,-561
NZL,New Zealand,AFG,Afghanistan,2008,2,75,-73
NZL,New Zealand,AFG,Afghanistan,2009,2,158,-156
NZL,New Zealand,AFG,Afghanistan,2010,3,91,-88
NZL,New Zealand,AFG,Afghanistan,2011,2,72,-70
NZL,New Zealand,AFG,Afghanistan,2012,2,96,-94
NZL,New Zealand,AFG,Afghanistan,2013,1,218,-217
NZL,New Zealand,AFG,Afghanistan,2014,7,356,-349
NZL,New Zealand,AFG,Afghanistan,2015,7,269,-262
NZL,New Zealand,AFG,Afghanistan,2016,3,225,-222
NZL,New Zealand,AFG,Afghanistan,2017,3,206,-203
NOR,Norway,AFG,Afghanistan,2008,22,785,-763
NOR,Norway,AFG,Afghanistan,2009,36,1386,-1350
NOR,Norway,AFG,Afghanistan,2010,42,1417,-1375
NOR,Norway,AFG,Afghanistan,2011,49,1095,-1046
NOR,Norway,AFG,Afghanistan,2012,58,1219,-1161
NOR,Norway,AFG,Afghanistan,2013,72,990,-918
NOR,Norway,AFG,Afghanistan,2014,105,833,-728
NOR,Norway,AFG,Afghanistan,2015,84,1381,-1297
NOR,Norway,AFG,Afghanistan,2016,67,2166,-2099
NOR,Norway,AFG,Afghanistan,2017,110,1114,-1004
POL,Poland,AFG,Afghanistan,2008,0,25,-25
POL,Poland,AFG,Afghanistan,2009,0,34,-34
POL,Poland,AFG,Afghanistan,2010,0,31,-31
POL,Poland,AFG,Afghanistan,2011,0,44,-44
POL,Poland,AFG,Afghanistan,2012,0,51,-51
POL,Poland,AFG,Afghanistan,2013,0,60,-60
POL,Poland,AFG,Afghanistan,2014,0,32,-32
POL,Poland,AFG,Afghanistan,2015,0,84,-84
POL,Poland,AFG,Afghanistan,2016,0,76,-76
POL,Poland,AFG,Afghanistan,2017,0,81,-81
SVK,Slovak Republic,AFG,Afghanistan,2008,8,2,6
SVK,Slovak Republic,AFG,Afghanistan,2009,7,1,6
SVK,Slovak Republic,AFG,Afghanistan,2010,6,1,5
SVK,Slovak Republic,AFG,Afghanistan,2011,13,3,10
SVK,Slovak Republic,AFG,Afghanistan,2012,0,1,-1
SVK,Slovak Republic,AFG,Afghanistan,2013,0,1,-1
SVK,Slovak Republic,AFG,Afghanistan,2014,0,2,-2
SVK,Slovak Republic,AFG,Afghanistan,2015,0,16,-16
SVK,Slovak Republic,AFG,Afghanistan,2016,0,4,-4
ESP,Spain,AFG,Afghanistan,2008,18,54,-36
ESP,Spain,AFG,Afghanistan,2009,23,66,-43
ESP,Spain,AFG,Afghanistan,2010,35,44,-9
ESP,Spain,AFG,Afghanistan,2011,50,49,1
ESP,Spain,AFG,Afghanistan,2012,39,40,-1
ESP,Spain,AFG,Afghanistan,2013,32,68,-36
ESP,Spain,AFG,Afghanistan,2014,45,113,-68
ESP,Spain,AFG,Afghanistan,2015,24,48,-24
ESP,Spain,AFG,Afghanistan,2016,23,83,-60
ESP,Spain,AFG,Afghanistan,2017,28,121,-93
SWE,Sweden,AFG,Afghanistan,2008,60,1033,-973
SWE,Sweden,AFG,Afghanistan,2009,34,1558,-1524
SWE,Sweden,AFG,Afghanistan,2010,64,1920,-1856
SWE,Sweden,AFG,Afghanistan,2011,58,3415,-3357
SWE,Sweden,AFG,Afghanistan,2012,69,4673,-4604
SWE,Sweden,AFG,Afghanistan,2013,63,4165,-4102
SWE,Sweden,AFG,Afghanistan,2014,67,3844,-3777
SWE,Sweden,AFG,Afghanistan,2015,80,3375,-3295
SWE,Sweden,AFG,Afghanistan,2016,58,4081,-4023
SWE,Sweden,AFG,Afghanistan,2017,63,11309,-11246
CHE,Switzerland,AFG,Afghanistan,2010,9,245,-236
CHE,Switzerland,AFG,Afghanistan,2011,12,175,-163
CHE,Switzerland,AFG,Afghanistan,2012,13,267,-254
CHE,Switzerland,AFG,Afghanistan,2013,9,295,-286
CHE,Switzerland,AFG,Afghanistan,2014,7,509,-502
CHE,Switzerland,AFG,Afghanistan,2015,13,513,-500
CHE,Switzerland,AFG,Afghanistan,2016,14,510,-496
CHE,Switzerland,AFG,Afghanistan,2017,10,854,-844
TUR,Turkey,AFG,Afghanistan,2010,0,2188,-2188
TUR,Turkey,AFG,Afghanistan,2016,6883,27850,-20967
TUR,Turkey,AFG,Afghanistan,2017,6413,37747,-31334
GBR,United Kingdom,AFG,Afghanistan,2011,0,1000,-1000
GBR,United Kingdom,AFG,Afghanistan,2012,0,1000,-1000
GBR,United Kingdom,AFG,Afghanistan,2013,0,2000,-2000
GBR,United Kingdom,AFG,Afghanistan,2015,0,1000,-1000
USA,United States,AFG,Afghanistan,2008,0,2813,-2813
USA,United States,AFG,Afghanistan,2009,0,3165,-3165
USA,United States,AFG,Afghanistan,2010,0,2017,-2017
USA,United States,AFG,Afghanistan,2011,0,1648,-1648
USA,United States,AFG,Afghanistan,2012,0,1617,-1617
USA,United States,AFG,Afghanistan,2013,0,2196,-2196
USA,United States,AFG,Afghanistan,2014,0,10527,-10527
USA,United States,AFG,Afghanistan,2015,0,8328,-8328
USA,United States,AFG,Afghanistan,2016,0,12513,-12513
USA,United States,AFG,Afghanistan,2017,0,19538,-19538
CHL,Chile,AFG,Afghanistan,2008,0,0,0
CHL,Chile,AFG,Afghanistan,2009,0,1,-1
CHL,Chile,AFG,Afghanistan,2010,0,0,0
CHL,Chile,AFG,Afghanistan,2011,0,1,-1
CHL,Chile,AFG,Afghanistan,2012,0,3,-3
CHL,Chile,AFG,Afghanistan,2013,0,9,-9
CHL,Chile,AFG,Afghanistan,2014,0,0,0
CHL,Chile,AFG,Afghanistan,2015,0,5,-5
CHL,Chile,AFG,Afghanistan,2016,0,4,-4
EST,Estonia,AFG,Afghanistan,2008,0,1,-1
EST,Estonia,AFG,Afghanistan,2009,0,0,0
EST,Estonia,AFG,Afghanistan,2010,0,0,0
EST,Estonia,AFG,Afghanistan,2011,0,1,-1
EST,Estonia,AFG,Afghanistan,2012,0,0,0
EST,Estonia,AFG,Afghanistan,2013,0,1,-1
EST,Estonia,AFG,Afghanistan,2014,0,0,0
EST,Estonia,AFG,Afghanistan,2015,0,5,-5
EST,Estonia,AFG,Afghanistan,2016,0,16,-16
EST,Estonia,AFG,Afghanistan,2017,0,19,-19
SVN,Slovenia,AFG,Afghanistan,2014,0,2,-2
SVN,Slovenia,AFG,Afghanistan,2015,0,2,-2
AUS,Australia,ALB,Albania,2008,13,115,-102
AUS,Australia,ALB,Albania,2009,9,161,-152
AUS,Australia,ALB,Albania,2010,25,144,-119
AUS,Australia,ALB,Albania,2011,11,110,-99
AUS,Australia,ALB,Albania,2012,21,144,-123
AUS,Australia,ALB,Albania,2013,6,117,-111
AUS,Australia,ALB,Albania,2014,11,111,-100
AUS,Australia,ALB,Albania,2015,0,89,-89
AUS,Australia,ALB,Albania,2016,0,80,-80
AUS,Australia,ALB,Albania,2017,0,101,-101
AUT,Austria,ALB,Albania,2008,102,172,-70
AUT,Austria,ALB,Albania,2009,117,185,-68
AUT,Austria,ALB,Albania,2010,100,136,-36
AUT,Austria,ALB,Albania,2011,125,192,-67
AUT,Austria,ALB,Albania,2012,113,250,-137
AUT,Austria,ALB,Albania,2013,153,330,-177
AUT,Austria,ALB,Albania,2014,193,383,-190
AUT,Austria,ALB,Albania,2015,218,482,-264
AUT,Austria,ALB,Albania,2016,277,435,-158
AUT,Austria,ALB,Albania,2017,284,507,-223
BEL,Belgium,ALB,Albania,2008,0,297,-297
BEL,Belgium,ALB,Albania,2009,0,351,-351
BEL,Belgium,ALB,Albania,2010,78,376,-298
BEL,Belgium,ALB,Albania,2011,0,395,-395
BEL,Belgium,ALB,Albania,2012,468,881,-413
BEL,Belgium,ALB,Albania,2013,672,830,-158
BEL,Belgium,ALB,Albania,2014,499,727,-228
BEL,Belgium,ALB,Albania,2015,565,878,-313
BEL,Belgium,ALB,Albania,2016,236,912,-676
BEL,Belgium,ALB,Albania,2017,219,976,-757
CAN,Canada,ALB,Albania,2008,0,560,-560
CAN,Canada,ALB,Albania,2009,0,715,-715
CAN,Canada,ALB,Albania,2010,0,560,-560
CAN,Canada,ALB,Albania,2011,0,539,-539
CAN,Canada,ALB,Albania,2012,0,619,-619
CAN,Canada,ALB,Albania,2013,0,603,-603
CAN,Canada,ALB,Albania,2014,0,519,-519
CAN,Canada,ALB,Albania,2015,0,574,-574
CAN,Canada,ALB,Albania,2016,0,515,-515
CAN,Canada,ALB,Albania,2017,0,645,-645
CZE,Czech Republic,ALB,Albania,2008,2,42,-40
CZE,Czech Republic,ALB,Albania,2009,0,38,-38
CZE,Czech Republic,ALB,Albania,2010,1,30,-29
CZE,Czech Republic,ALB,Albania,2011,0,21,-21
CZE,Czech Republic,ALB,Albania,2012,23,50,-27
CZE,Czech Republic,ALB,Albania,2013,53,30,23
CZE,Czech Republic,ALB,Albania,2014,29,34,-5
CZE,Czech Republic,ALB,Albania,2015,17,51,-34
CZE,Czech Republic,ALB,Albania,2016,17,54,-37
CZE,Czech Republic,ALB,Albania,2017,21,72,-51
DNK,Denmark,ALB,Albania,2008,13,23,-10
DNK,Denmark,ALB,Albania,2009,12,20,-8
DNK,Denmark,ALB,Albania,2010,11,26,-15
DNK,Denmark,ALB,Albania,2011,6,17,-11
DNK,Denmark,ALB,Albania,2012,10,12,-2
DNK,Denmark,ALB,Albania,2013,13,23,-10
DNK,Denmark,ALB,Albania,2014,11,29,-18
DNK,Denmark,ALB,Albania,2015,11,25,-14
DNK,Denmark,ALB,Albania,2016,17,39,-22
DNK,Denmark,ALB,Albania,2017,22,50,-28
FIN,Finland,ALB,Albania,2008,1,31,-30
FIN,Finland,ALB,Albania,2009,1,14,-13
FIN,Finland,ALB,Albania,2010,1,9,-8
FIN,Finland,ALB,Albania,2011,0,21,-21
FIN,Finland,ALB,Albania,2012,2,38,-36
FIN,Finland,ALB,Albania,2013,3,59,-56
FIN,Finland,ALB,Albania,2014,4,54,-50
FIN,Finland,ALB,Albania,2015,6,74,-68
FIN,Finland,ALB,Albania,2016,2,76,-74
FIN,Finland,ALB,Albania,2017,7,90,-83
FRA,France,ALB,Albania,2008,0,358,-358
FRA,France,ALB,Albania,2009,0,318,-318
FRA,France,ALB,Albania,2010,0,303,-303
FRA,France,ALB,Albania,2011,0,404,-404
FRA,France,ALB,Albania,2012,0,397,-397
FRA,France,ALB,Albania,2013,0,502,-502
FRA,France,ALB,Albania,2014,0,768,-768
FRA,France,ALB,Albania,2015,0,1128,-1128
FRA,France,ALB,Albania,2016,0,1433,-1433
FRA,France,ALB,Albania,2017,0,1654,-1654
DEU,Germany,ALB,Albania,2008,829,1046,-217
DEU,Germany,ALB,Albania,2009,812,961,-149
DEU,Germany,ALB,Albania,2010,669,913,-244
DEU,Germany,ALB,Albania,2011,833,1417,-584
DEU,Germany,ALB,Albania,2012,951,2234,-1283
DEU,Germany,ALB,Albania,2013,1447,4131,-2684
DEU,Germany,ALB,Albania,2014,3519,15165,-11646
DEU,Germany,ALB,Albania,2015,22533,69362,-46829
DEU,Germany,ALB,Albania,2016,39124,12982,26142
DEU,Germany,ALB,Albania,2017,15904,14905,999
GRC,Greece,ALB,Albania,2008,0,32107,-32107
GRC,Greece,ALB,Albania,2009,0,34610,-34610
GRC,Greece,ALB,Albania,2010,0,23688,-23688
GRC,Greece,ALB,Albania,2011,0,14327,-14327
HUN,Hungary,ALB,Albania,2008,4,28,-24
HUN,Hungary,ALB,Albania,2009,3,19,-16
HUN,Hungary,ALB,Albania,2010,3,15,-12
HUN,Hungary,ALB,Albania,2011,2,18,-16
HUN,Hungary,ALB,Albania,2012,4,30,-26
HUN,Hungary,ALB,Albania,2013,7,64,-57
HUN,Hungary,ALB,Albania,2014,16,62,-46
HUN,Hungary,ALB,Albania,2015,24,77,-53
HUN,Hungary,ALB,Albania,2016,34,70,-36
HUN,Hungary,ALB,Albania,2017,0,114,-114
ISL,Iceland,ALB,Albania,2008,1,1,0
ISL,Iceland,ALB,Albania,2009,1,3,-2
ISL,Iceland,ALB,Albania,2010,0,1,-1
ISL,Iceland,ALB,Albania,2011,0,1,-1
ISL,Iceland,ALB,Albania,2012,2,0,2
ISL,Iceland,ALB,Albania,2013,0,4,-4
ISL,Iceland,ALB,Albania,2014,3,5,-2
ISL,Iceland,ALB,Albania,2015,0,8,-8
ISL,Iceland,ALB,Albania,2016,1,29,-28
ISL,Iceland,ALB,Albania,2017,2,42,-40
ITA,Italy,ALB,Albania,2008,925,35715,-34790
ITA,Italy,ALB,Albania,2009,1110,27493,-26383
ITA,Italy,ALB,Albania,2010,1495,22591,-21096
ITA,Italy,ALB,Albania,2011,1525,16613,-15088
ITA,Italy,ALB,Albania,2012,1794,14118,-12324
ITA,Italy,ALB,Albania,2013,2296,12165,-9869
ITA,Italy,ALB,Albania,2014,2114,11398,-9284
ITA,Italy,ALB,Albania,2015,1959,11545,-9586
ITA,Italy,ALB,Albania,2016,0,12966,-12966
ITA,Italy,ALB,Albania,2017,1564,15385,-13821
JPN,Japan,ALB,Albania,2008,57,61,-4
JPN,Japan,ALB,Albania,2009,52,54,-2
JPN,Japan,ALB,Albania,2010,45,46,-1
JPN,Japan,ALB,Albania,2011,36,35,1
JPN,Japan,ALB,Albania,2012,56,56,0
JPN,Japan,ALB,Albania,2013,51,52,-1
JPN,Japan,ALB,Albania,2014,34,34,0
JPN,Japan,ALB,Albania,2015,61,70,-9
JPN,Japan,ALB,Albania,2016,44,48,-4
JPN,Japan,ALB,Albania,2017,44,57,-13
KOR,Korea,ALB,Albania,2008,11,12,-1
KOR,Korea,ALB,Albania,2009,10,7,3
KOR,Korea,ALB,Albania,2010,9,11,-2
KOR,Korea,ALB,Albania,2011,11,17,-6
KOR,Korea,ALB,Albania,2012,17,20,-3
KOR,Korea,ALB,Albania,2013,16,18,-2
KOR,Korea,ALB,Albania,2014,8,6,2
KOR,Korea,ALB,Albania,2015,8,4,4
KOR,Korea,ALB,Albania,2016,6,9,-3
KOR,Korea,ALB,Albania,2017,14,16,-2
LUX,Luxembourg,ALB,Albania,2008,20,35,-15
LUX,Luxembourg,ALB,Albania,2009,10,40,-30
LUX,Luxembourg,ALB,Albania,2010,12,98,-86
LUX,Luxembourg,ALB,Albania,2011,5,40,-35
LUX,Luxembourg,ALB,Albania,2012,15,123,-108
LUX,Luxembourg,ALB,Albania,2013,40,74,-34
LUX,Luxembourg,ALB,Albania,2014,68,107,-39
LUX,Luxembourg,ALB,Albania,2015,90,146,-56
LUX,Luxembourg,ALB,Albania,2016,81,163,-82
LUX,Luxembourg,ALB,Albania,2017,130,114,16
MEX,Mexico,ALB,Albania,2008,0,3,-3
MEX,Mexico,ALB,Albania,2009,0,9,-9
MEX,Mexico,ALB,Albania,2010,0,4,-4
MEX,Mexico,ALB,Albania,2011,0,5,-5
MEX,Mexico,ALB,Albania,2012,0,6,-6
MEX,Mexico,ALB,Albania,2013,0,13,-13
MEX,Mexico,ALB,Albania,2014,0,4,-4
MEX,Mexico,ALB,Albania,2015,0,2,-2
MEX,Mexico,ALB,Albania,2016,0,12,-12
MEX,Mexico,ALB,Albania,2017,0,8,-8
NLD,Netherlands,ALB,Albania,2008,23,97,-74
NLD,Netherlands,ALB,Albania,2009,45,145,-100
NLD,Netherlands,ALB,Albania,2010,69,94,-25
NLD,Netherlands,ALB,Albania,2011,68,100,-32
NLD,Netherlands,ALB,Albania,2012,66,120,-54
NLD,Netherlands,ALB,Albania,2013,68,128,-60
NLD,Netherlands,ALB,Albania,2014,56,179,-123
NLD,Netherlands,ALB,Albania,2015,84,232,-148
NLD,Netherlands,ALB,Albania,2016,92,271,-179
NLD,Netherlands,ALB,Albania,2017,181,297,-116
NZL,New Zealand,ALB,Albania,2008,0,5,-5
NZL,New Zealand,ALB,Albania,2009,0,3,-3
NZL,New Zealand,ALB,Albania,2010,0,5,-5
NZL,New Zealand,ALB,Albania,2012,0,2,-2
NZL,New Zealand,ALB,Albania,2013,0,3,-3
NZL,New Zealand,ALB,Albania,2014,1,7,-6
NZL,New Zealand,ALB,Albania,2015,0,5,-5
NZL,New Zealand,ALB,Albania,2016,1,8,-7
NZL,New Zealand,ALB,Albania,2017,1,4,-3
NOR,Norway,ALB,Albania,2008,11,53,-42
NOR,Norway,ALB,Albania,2009,9,34,-25
NOR,Norway,ALB,Albania,2010,13,34,-21
NOR,Norway,ALB,Albania,2011,15,50,-35
NOR,Norway,ALB,Albania,2012,15,62,-47
NOR,Norway,ALB,Albania,2013,14,69,-55
NOR,Norway,ALB,Albania,2014,25,105,-80
NOR,Norway,ALB,Albania,2015,21,143,-122
NOR,Norway,ALB,Albania,2016,31,143,-112
NOR,Norway,ALB,Albania,2017,31,170,-139
POL,Poland,ALB,Albania,2008,0,175,-175
POL,Poland,ALB,Albania,2009,0,179,-179
POL,Poland,ALB,Albania,2010,0,145,-145
POL,Poland,ALB,Albania,2011,0,106,-106
POL,Poland,ALB,Albania,2012,0,83,-83
POL,Poland,ALB,Albania,2013,0,92,-92
POL,Poland,ALB,Albania,2014,0,58,-58
POL,Poland,ALB,Albania,2015,0,98,-98
POL,Poland,ALB,Albania,2016,0,101,-101
POL,Poland,ALB,Albania,2017,0,98,-98
SVK,Slovak Republic,ALB,Albania,2008,2,6,-4
SVK,Slovak Republic,ALB,Albania,2009,1,10,-9
SVK,Slovak Republic,ALB,Albania,2010,1,4,-3
SVK,Slovak Republic,ALB,Albania,2011,2,4,-2
SVK,Slovak Republic,ALB,Albania,2013,1,3,-2
SVK,Slovak Republic,ALB,Albania,2014,0,1,-1
SVK,Slovak Republic,ALB,Albania,2016,0,12,-12
SVK,Slovak Republic,ALB,Albania,2017,1,8,-7
ESP,Spain,ALB,Albania,2008,102,246,-144
ESP,Spain,ALB,Albania,2009,171,189,-18
ESP,Spain,ALB,Albania,2010,161,149,12
ESP,Spain,ALB,Albania,2011,162,256,-94
ESP,Spain,ALB,Albania,2012,162,237,-75
ESP,Spain,ALB,Albania,2013,224,244,-20
ESP,Spain,ALB,Albania,2014,119,234,-115
ESP,Spain,ALB,Albania,2015,110,279,-169
ESP,Spain,ALB,Albania,2016,106,361,-255
ESP,Spain,ALB,Albania,2017,171,506,-335
SWE,Sweden,ALB,Albania,2008,9,98,-89
SWE,Sweden,ALB,Albania,2009,5,122,-117
SWE,Sweden,ALB,Albania,2010,12,164,-152
SWE,Sweden,ALB,Albania,2011,14,137,-123
SWE,Sweden,ALB,Albania,2012,18,226,-208
SWE,Sweden,ALB,Albania,2013,17,192,-175
SWE,Sweden,ALB,Albania,2014,27,273,-246
SWE,Sweden,ALB,Albania,2015,38,466,-428
SWE,Sweden,ALB,Albania,2016,14,658,-644
SWE,Sweden,ALB,Albania,2017,11,978,-967
CHE,Switzerland,ALB,Albania,2010,45,113,-68
CHE,Switzerland,ALB,Albania,2011,35,102,-67
CHE,Switzerland,ALB,Albania,2012,38,115,-77
CHE,Switzerland,ALB,Albania,2013,33,134,-101
CHE,Switzerland,ALB,Albania,2014,46,158,-112
CHE,Switzerland,ALB,Albania,2015,29,201,-172
CHE,Switzerland,ALB,Albania,2016,50,242,-192
CHE,Switzerland,ALB,Albania,2017,42,263,-221
TUR,Turkey,ALB,Albania,2010,0,132,-132
TUR,Turkey,ALB,Albania,2016,281,749,-468
TUR,Turkey,ALB,Albania,2017,446,1119,-673
USA,United States,ALB,Albania,2008,0,5754,-5754
USA,United States,ALB,Albania,2009,0,5137,-5137
USA,United States,ALB,Albania,2010,0,4711,-4711
USA,United States,ALB,Albania,2011,0,3612,-3612
USA,United States,ALB,Albania,2012,0,3364,-3364
USA,United States,ALB,Albania,2013,0,3186,-3186
USA,United States,ALB,Albania,2014,0,3828,-3828
USA,United States,ALB,Albania,2015,0,4653,-4653
USA,United States,ALB,Albania,2016,0,5773,-5773
USA,United States,ALB,Albania,2017,0,5722,-5722
CHL,Chile,ALB,Albania,2008,0,1,-1
CHL,Chile,ALB,Albania,2009,0,2,-2
CHL,Chile,ALB,Albania,2010,0,3,-3
CHL,Chile,ALB,Albania,2011,0,2,-2
CHL,Chile,ALB,Albania,2012,0,0,0
CHL,Chile,ALB,Albania,2013,0,1,-1
CHL,Chile,ALB,Albania,2014,0,2,-2
CHL,Chile,ALB,Albania,2015,0,6,-6
CHL,Chile,ALB,Albania,2016,0,9,-9
EST,Estonia,ALB,Albania,2008,0,2,-2
EST,Estonia,ALB,Albania,2009,0,3,-3
EST,Estonia,ALB,Albania,2010,0,0,0
EST,Estonia,ALB,Albania,2011,0,1,-1
EST,Estonia,ALB,Albania,2012,0,3,-3
EST,Estonia,ALB,Albania,2013,0,2,-2
EST,Estonia,ALB,Albania,2014,0,1,-1
EST,Estonia,ALB,Albania,2015,0,6,-6
EST,Estonia,ALB,Albania,2016,0,14,-14
EST,Estonia,ALB,Albania,2017,0,4,-4
SVN,Slovenia,ALB,Albania,2008,3,53,-50
SVN,Slovenia,ALB,Albania,2009,10,109,-99
SVN,Slovenia,ALB,Albania,2010,11,29,-18
SVN,Slovenia,ALB,Albania,2011,4,11,-7
SVN,Slovenia,ALB,Albania,2012,1,13,-12
SVN,Slovenia,ALB,Albania,2013,0,14,-14
SVN,Slovenia,ALB,Albania,2014,0,9,-9
SVN,Slovenia,ALB,Albania,2015,0,18,-18
SVN,Slovenia,ALB,Albania,2016,3,18,-15
SVN,Slovenia,ALB,Albania,2017,5,22,-17
AUS,Australia,DZA,Algeria,2008,22,25,-3
AUS,Australia,DZA,Algeria,2009,27,21,6
AUS,Australia,DZA,Algeria,2010,25,27,-2
AUS,Australia,DZA,Algeria,2011,29,25,4
AUS,Australia,DZA,Algeria,2012,27,22,5
AUS,Australia,DZA,Algeria,2013,26,19,7
AUS,Australia,DZA,Algeria,2014,26,17,9
AUS,Australia,DZA,Algeria,2015,0,19,-19
AUS,Australia,DZA,Algeria,2016,0,32,-32
AUS,Australia,DZA,Algeria,2017,0,28,-28
AUT,Austria,DZA,Algeria,2008,142,196,-54
AUT,Austria,DZA,Algeria,2009,180,252,-72
AUT,Austria,DZA,Algeria,2010,207,239,-32
AUT,Austria,DZA,Algeria,2011,186,251,-65
AUT,Austria,DZA,Algeria,2012,238,249,-11
AUT,Austria,DZA,Algeria,2013,213,365,-152
AUT,Austria,DZA,Algeria,2014,241,336,-95
AUT,Austria,DZA,Algeria,2015,276,498,-222
AUT,Austria,DZA,Algeria,2016,441,661,-220
AUT,Austria,DZA,Algeria,2017,566,392,174
BEL,Belgium,DZA,Algeria,2008,110,915,-805
BEL,Belgium,DZA,Algeria,2009,129,1074,-945
BEL,Belgium,DZA,Algeria,2010,194,1097,-903
BEL,Belgium,DZA,Algeria,2011,173,1095,-922
BEL,Belgium,DZA,Algeria,2012,340,919,-579
BEL,Belgium,DZA,Algeria,2013,503,730,-227
BEL,Belgium,DZA,Algeria,2014,415,680,-265
BEL,Belgium,DZA,Algeria,2015,335,716,-381
BEL,Belgium,DZA,Algeria,2016,237,649,-412
BEL,Belgium,DZA,Algeria,2017,172,639,-467
CAN,Canada,DZA,Algeria,2008,0,4005,-4005
CAN,Canada,DZA,Algeria,2009,0,5390,-5390
CAN,Canada,DZA,Algeria,2010,0,4751,-4751
CAN,Canada,DZA,Algeria,2011,0,4325,-4325
CAN,Canada,DZA,Algeria,2012,0,3762,-3762
CAN,Canada,DZA,Algeria,2013,0,4325,-4325
CAN,Canada,DZA,Algeria,2014,0,3653,-3653
CAN,Canada,DZA,Algeria,2015,0,2835,-2835
CAN,Canada,DZA,Algeria,2016,0,2820,-2820
CAN,Canada,DZA,Algeria,2017,0,2635,-2635
CZE,Czech Republic,DZA,Algeria,2008,2,31,-29
CZE,Czech Republic,DZA,Algeria,2009,2,23,-21
CZE,Czech Republic,DZA,Algeria,2010,1,42,-41
CZE,Czech Republic,DZA,Algeria,2011,3,18,-15
CZE,Czech Republic,DZA,Algeria,2012,12,38,-26
CZE,Czech Republic,DZA,Algeria,2013,30,34,-4
CZE,Czech Republic,DZA,Algeria,2014,16,46,-30
CZE,Czech Republic,DZA,Algeria,2015,22,42,-20
CZE,Czech Republic,DZA,Algeria,2016,16,52,-36
CZE,Czech Republic,DZA,Algeria,2017,13,42,-29
DNK,Denmark,DZA,Algeria,2008,2,17,-15
DNK,Denmark,DZA,Algeria,2009,5,11,-6
DNK,Denmark,DZA,Algeria,2010,7,20,-13
DNK,Denmark,DZA,Algeria,2011,6,16,-10
DNK,Denmark,DZA,Algeria,2012,10,11,-1
DNK,Denmark,DZA,Algeria,2013,5,19,-14
DNK,Denmark,DZA,Algeria,2014,6,17,-11
DNK,Denmark,DZA,Algeria,2015,8,13,-5
DNK,Denmark,DZA,Algeria,2016,5,29,-24
DNK,Denmark,DZA,Algeria,2017,6,29,-23
FIN,Finland,DZA,Algeria,2008,7,32,-25
FIN,Finland,DZA,Algeria,2009,3,43,-40
FIN,Finland,DZA,Algeria,2010,0,36,-36
FIN,Finland,DZA,Algeria,2011,4,34,-30
FIN,Finland,DZA,Algeria,2012,3,46,-43
FIN,Finland,DZA,Algeria,2013,3,42,-39
FIN,Finland,DZA,Algeria,2014,14,44,-30
FIN,Finland,DZA,Algeria,2015,5,61,-56
FIN,Finland,DZA,Algeria,2016,8,47,-39
FIN,Finland,DZA,Algeria,2017,6,41,-35
FRA,France,DZA,Algeria,2008,0,24364,-24364
FRA,France,DZA,Algeria,2009,0,23100,-23100
FRA,France,DZA,Algeria,2010,0,21394,-21394
FRA,France,DZA,Algeria,2011,0,21234,-21234
FRA,France,DZA,Algeria,2012,0,23689,-23689
FRA,France,DZA,Algeria,2013,0,23631,-23631
FRA,France,DZA,Algeria,2014,0,24108,-24108
FRA,France,DZA,Algeria,2015,0,22427,-22427
FRA,France,DZA,Algeria,2016,0,21824,-21824
FRA,France,DZA,Algeria,2017,0,21823,-21823
DEU,Germany,DZA,Algeria,2008,1352,1381,-29
DEU,Germany,DZA,Algeria,2009,1305,1543,-238
DEU,Germany,DZA,Algeria,2010,1180,1539,-359
DEU,Germany,DZA,Algeria,2011,1143,1582,-439
DEU,Germany,DZA,Algeria,2012,1079,1566,-487
DEU,Germany,DZA,Algeria,2013,1202,2348,-1146
DEU,Germany,DZA,Algeria,2014,1866,3879,-2013
DEU,Germany,DZA,Algeria,2015,3540,9596,-6056
DEU,Germany,DZA,Algeria,2016,7731,4845,2886
DEU,Germany,DZA,Algeria,2017,4295,3706,589
HUN,Hungary,DZA,Algeria,2008,1,21,-20
HUN,Hungary,DZA,Algeria,2009,1,32,-31
HUN,Hungary,DZA,Algeria,2010,6,38,-32
HUN,Hungary,DZA,Algeria,2011,8,23,-15
HUN,Hungary,DZA,Algeria,2012,3,23,-20
HUN,Hungary,DZA,Algeria,2013,6,33,-27
HUN,Hungary,DZA,Algeria,2014,1,82,-81
HUN,Hungary,DZA,Algeria,2015,4,67,-63
HUN,Hungary,DZA,Algeria,2016,7,99,-92
HUN,Hungary,DZA,Algeria,2017,0,82,-82
ISL,Iceland,DZA,Algeria,2008,1,1,0
ISL,Iceland,DZA,Algeria,2009,2,2,0
ISL,Iceland,DZA,Algeria,2010,0,3,-3
ISL,Iceland,DZA,Algeria,2011,2,3,-1
ISL,Iceland,DZA,Algeria,2012,0,4,-4
ISL,Iceland,DZA,Algeria,2013,1,3,-2
ISL,Iceland,DZA,Algeria,2014,1,9,-8
ISL,Iceland,DZA,Algeria,2015,1,10,-9
ISL,Iceland,DZA,Algeria,2016,3,10,-7
ISL,Iceland,DZA,Algeria,2017,1,3,-2
ITA,Italy,DZA,Algeria,2008,127,1376,-1249
ITA,Italy,DZA,Algeria,2009,149,1132,-983
ITA,Italy,DZA,Algeria,2010,152,1199,-1047
ITA,Italy,DZA,Algeria,2011,165,1089,-924
ITA,Italy,DZA,Algeria,2012,140,944,-804
ITA,Italy,DZA,Algeria,2013,159,935,-776
ITA,Italy,DZA,Algeria,2014,136,927,-791
ITA,Italy,DZA,Algeria,2015,181,866,-685
ITA,Italy,DZA,Algeria,2016,0,676,-676
ITA,Italy,DZA,Algeria,2017,108,702,-594
JPN,Japan,DZA,Algeria,2008,164,171,-7
JPN,Japan,DZA,Algeria,2009,47,58,-11
JPN,Japan,DZA,Algeria,2010,51,75,-24
JPN,Japan,DZA,Algeria,2011,39,45,-6
JPN,Japan,DZA,Algeria,2012,74,97,-23
JPN,Japan,DZA,Algeria,2013,57,75,-18
JPN,Japan,DZA,Algeria,2014,58,82,-24
JPN,Japan,DZA,Algeria,2015,87,104,-17
JPN,Japan,DZA,Algeria,2016,34,77,-43
JPN,Japan,DZA,Algeria,2017,45,78,-33
KOR,Korea,DZA,Algeria,2008,24,32,-8
KOR,Korea,DZA,Algeria,2009,22,26,-4
KOR,Korea,DZA,Algeria,2010,24,44,-20
KOR,Korea,DZA,Algeria,2011,37,37,0
KOR,Korea,DZA,Algeria,2012,57,36,21
KOR,Korea,DZA,Algeria,2013,22,30,-8
KOR,Korea,DZA,Algeria,2014,42,93,-51
KOR,Korea,DZA,Algeria,2015,54,27,27
KOR,Korea,DZA,Algeria,2016,49,61,-12
KOR,Korea,DZA,Algeria,2017,53,111,-58
LUX,Luxembourg,DZA,Algeria,2008,17,35,-18
LUX,Luxembourg,DZA,Algeria,2009,12,36,-24
LUX,Luxembourg,DZA,Algeria,2010,9,71,-62
LUX,Luxembourg,DZA,Algeria,2011,13,55,-42
LUX,Luxembourg,DZA,Algeria,2012,22,32,-10
LUX,Luxembourg,DZA,Algeria,2013,28,64,-36
LUX,Luxembourg,DZA,Algeria,2014,33,64,-31
LUX,Luxembourg,DZA,Algeria,2015,35,47,-12
LUX,Luxembourg,DZA,Algeria,2016,20,52,-32
LUX,Luxembourg,DZA,Algeria,2017,25,54,-29
MEX,Mexico,DZA,Algeria,2008,0,8,-8
MEX,Mexico,DZA,Algeria,2009,0,8,-8
MEX,Mexico,DZA,Algeria,2010,0,11,-11
MEX,Mexico,DZA,Algeria,2011,0,15,-15
MEX,Mexico,DZA,Algeria,2012,0,12,-12
MEX,Mexico,DZA,Algeria,2013,0,27,-27
MEX,Mexico,DZA,Algeria,2014,0,22,-22
MEX,Mexico,DZA,Algeria,2015,0,8,-8
MEX,Mexico,DZA,Algeria,2016,0,12,-12
MEX,Mexico,DZA,Algeria,2017,0,12,-12
NLD,Netherlands,DZA,Algeria,2008,28,68,-40
NLD,Netherlands,DZA,Algeria,2009,41,58,-17
NLD,Netherlands,DZA,Algeria,2010,23,52,-29
NLD,Netherlands,DZA,Algeria,2011,36,65,-29
NLD,Netherlands,DZA,Algeria,2012,33,53,-20
NLD,Netherlands,DZA,Algeria,2013,28,53,-25
NLD,Netherlands,DZA,Algeria,2014,36,69,-33
NLD,Netherlands,DZA,Algeria,2015,31,60,-29
NLD,Netherlands,DZA,Algeria,2016,30,70,-40
NLD,Netherlands,DZA,Algeria,2017,36,77,-41
NZL,New Zealand,DZA,Algeria,2008,0,2,-2
NZL,New Zealand,DZA,Algeria,2009,2,7,-5
NZL,New Zealand,DZA,Algeria,2010,3,7,-4
NZL,New Zealand,DZA,Algeria,2011,1,2,-1
NZL,New Zealand,DZA,Algeria,2012,1,1,0
NZL,New Zealand,DZA,Algeria,2013,0,4,-4
NZL,New Zealand,DZA,Algeria,2014,0,6,-6
NZL,New Zealand,DZA,Algeria,2015,1,4,-3
NZL,New Zealand,DZA,Algeria,2016,0,7,-7
NZL,New Zealand,DZA,Algeria,2017,1,6,-5
NOR,Norway,DZA,Algeria,2008,17,46,-29
NOR,Norway,DZA,Algeria,2009,10,45,-35
NOR,Norway,DZA,Algeria,2010,24,37,-13
NOR,Norway,DZA,Algeria,2011,22,48,-26
NOR,Norway,DZA,Algeria,2012,14,59,-45
NOR,Norway,DZA,Algeria,2013,30,40,-10
NOR,Norway,DZA,Algeria,2014,21,40,-19
NOR,Norway,DZA,Algeria,2015,12,34,-22
NOR,Norway,DZA,Algeria,2016,25,34,-9
NOR,Norway,DZA,Algeria,2017,14,32,-18
POL,Poland,DZA,Algeria,2008,0,116,-116
POL,Poland,DZA,Algeria,2009,0,131,-131
POL,Poland,DZA,Algeria,2010,0,149,-149
POL,Poland,DZA,Algeria,2011,0,170,-170
POL,Poland,DZA,Algeria,2012,0,178,-178
POL,Poland,DZA,Algeria,2013,0,213,-213
POL,Poland,DZA,Algeria,2014,0,131,-131
POL,Poland,DZA,Algeria,2015,0,214,-214
POL,Poland,DZA,Algeria,2016,0,244,-244
POL,Poland,DZA,Algeria,2017,0,286,-286
SVK,Slovak Republic,DZA,Algeria,2008,1,2,-1
SVK,Slovak Republic,DZA,Algeria,2009,10,4,6
SVK,Slovak Republic,DZA,Algeria,2010,11,4,7
SVK,Slovak Republic,DZA,Algeria,2011,0,2,-2
SVK,Slovak Republic,DZA,Algeria,2012,0,4,-4
SVK,Slovak Republic,DZA,Algeria,2013,0,3,-3
SVK,Slovak Republic,DZA,Algeria,2014,0,1,-1
SVK,Slovak Republic,DZA,Algeria,2015,0,3,-3
SVK,Slovak Republic,DZA,Algeria,2016,0,2,-2
SVK,Slovak Republic,DZA,Algeria,2017,0,3,-3
ESP,Spain,DZA,Algeria,2008,3245,5524,-2279
ESP,Spain,DZA,Algeria,2009,4253,4314,-61
ESP,Spain,DZA,Algeria,2010,4874,3761,1113
ESP,Spain,DZA,Algeria,2011,5717,4257,1460
ESP,Spain,DZA,Algeria,2012,5873,4522,1351
ESP,Spain,DZA,Algeria,2013,6670,4762,1908
ESP,Spain,DZA,Algeria,2014,4854,4534,320
ESP,Spain,DZA,Algeria,2015,4035,4154,-119
ESP,Spain,DZA,Algeria,2016,4088,4434,-346
ESP,Spain,DZA,Algeria,2017,4501,4782,-281
SWE,Sweden,DZA,Algeria,2008,9,127,-118
SWE,Sweden,DZA,Algeria,2009,6,145,-139
SWE,Sweden,DZA,Algeria,2010,17,122,-105
SWE,Sweden,DZA,Algeria,2011,16,100,-84
SWE,Sweden,DZA,Algeria,2012,18,136,-118
SWE,Sweden,DZA,Algeria,2013,14,98,-84
SWE,Sweden,DZA,Algeria,2014,17,122,-105
SWE,Sweden,DZA,Algeria,2015,18,103,-85
SWE,Sweden,DZA,Algeria,2016,24,127,-103
SWE,Sweden,DZA,Algeria,2017,21,128,-107
CHE,Switzerland,DZA,Algeria,2010,80,296,-216
CHE,Switzerland,DZA,Algeria,2011,84,266,-182
CHE,Switzerland,DZA,Algeria,2012,52,266,-214
CHE,Switzerland,DZA,Algeria,2013,64,259,-195
CHE,Switzerland,DZA,Algeria,2014,79,259,-180
CHE,Switzerland,DZA,Algeria,2015,50,241,-191
CHE,Switzerland,DZA,Algeria,2016,61,264,-203
CHE,Switzerland,DZA,Algeria,2017,51,232,-181
TUR,Turkey,DZA,Algeria,2010,0,43,-43
TUR,Turkey,DZA,Algeria,2016,236,839,-603
TUR,Turkey,DZA,Algeria,2017,381,1478,-1097
GBR,United Kingdom,DZA,Algeria,2013,0,1000,-1000
GBR,United Kingdom,DZA,Algeria,2015,0,1000,-1000
USA,United States,DZA,Algeria,2008,0,1037,-1037
USA,United States,DZA,Algeria,2009,0,1485,-1485
USA,United States,DZA,Algeria,2010,0,1305,-1305
USA,United States,DZA,Algeria,2011,0,1364,-1364
USA,United States,DZA,Algeria,2012,0,1369,-1369
USA,United States,DZA,Algeria,2013,0,1241,-1241
USA,United States,DZA,Algeria,2014,0,1669,-1669
USA,United States,DZA,Algeria,2015,0,1775,-1775
USA,United States,DZA,Algeria,2016,0,2180,-2180
USA,United States,DZA,Algeria,2017,0,2139,-2139
CHL,Chile,DZA,Algeria,2008,0,0,0
CHL,Chile,DZA,Algeria,2009,0,1,-1
CHL,Chile,DZA,Algeria,2010,0,3,-3
CHL,Chile,DZA,Algeria,2011,0,2,-2
CHL,Chile,DZA,Algeria,2012,0,2,-2
CHL,Chile,DZA,Algeria,2013,0,8,-8
CHL,Chile,DZA,Algeria,2014,0,1,-1
CHL,Chile,DZA,Algeria,2015,0,5,-5
CHL,Chile,DZA,Algeria,2016,0,9,-9
EST,Estonia,DZA,Algeria,2008,0,0,0
EST,Estonia,DZA,Algeria,2009,0,0,0
EST,Estonia,DZA,Algeria,2010,0,0,0
EST,Estonia,DZA,Algeria,2011,0,2,-2
EST,Estonia,DZA,Algeria,2012,0,1,-1
EST,Estonia,DZA,Algeria,2013,0,1,-1
EST,Estonia,DZA,Algeria,2014,0,1,-1
EST,Estonia,DZA,Algeria,2015,0,3,-3
EST,Estonia,DZA,Algeria,2016,0,5,-5
EST,Estonia,DZA,Algeria,2017,0,2,-2
SVN,Slovenia,DZA,Algeria,2008,0,5,-5
SVN,Slovenia,DZA,Algeria,2009,0,6,-6
SVN,Slovenia,DZA,Algeria,2010,0,2,-2
SVN,Slovenia,DZA,Algeria,2013,0,3,-3
SVN,Slovenia,DZA,Algeria,2014,0,2,-2
SVN,Slovenia,DZA,Algeria,2015,0,4,-4
SVN,Slovenia,DZA,Algeria,2016,0,4,-4
SVN,Slovenia,DZA,Algeria,2017,0,2,-2
AUS,Australia,AND,Andorra,2008,0,0,0
AUS,Australia,AND,Andorra,2009,0,0,0
AUS,Australia,AND,Andorra,2010,0,0,0
AUS,Australia,AND,Andorra,2011,0,1,-1
AUS,Australia,AND,Andorra,2012,0,0,0
AUS,Australia,AND,Andorra,2013,0,0,0
AUS,Australia,AND,Andorra,2014,0,0,0
AUS,Australia,AND,Andorra,2015,0,0,0
AUS,Australia,AND,Andorra,2016,0,0,0
AUS,Australia,AND,Andorra,2017,0,3,-3
AUT,Austria,AND,Andorra,2008,0,2,-2
AUT,Austria,AND,Andorra,2009,2,0,2
AUT,Austria,AND,Andorra,2010,0,0,0
AUT,Austria,AND,Andorra,2011,1,0,1
AUT,Austria,AND,Andorra,2012,0,0,0
AUT,Austria,AND,Andorra,2013,0,1,-1
AUT,Austria,AND,Andorra,2014,0,0,0
AUT,Austria,AND,Andorra,2015,1,0,1
AUT,Austria,AND,Andorra,2016,0,1,-1
AUT,Austria,AND,Andorra,2017,0,1,-1
BEL,Belgium,AND,Andorra,2008,0,1,-1
BEL,Belgium,AND,Andorra,2009,0,3,-3
BEL,Belgium,AND,Andorra,2010,1,2,-1
BEL,Belgium,AND,Andorra,2011,0,1,-1
BEL,Belgium,AND,Andorra,2012,0,5,-5
BEL,Belgium,AND,Andorra,2013,1,2,-1
BEL,Belgium,AND,Andorra,2014,4,1,3
BEL,Belgium,AND,Andorra,2016,0,3,-3
BEL,Belgium,AND,Andorra,2017,0,1,-1
CAN,Canada,AND,Andorra,2008,0,0,0
CAN,Canada,AND,Andorra,2009,0,0,0
CAN,Canada,AND,Andorra,2010,0,0,0
CAN,Canada,AND,Andorra,2011,0,0,0
CAN,Canada,AND,Andorra,2012,0,1,-1
CAN,Canada,AND,Andorra,2013,0,1,-1
CAN,Canada,AND,Andorra,2014,0,0,0
CAN,Canada,AND,Andorra,2015,0,0,0
CAN,Canada,AND,Andorra,2016,0,0,0
CAN,Canada,AND,Andorra,2017,0,0,0
DNK,Denmark,AND,Andorra,2013,0,0,0
DNK,Denmark,AND,Andorra,2014,0,0,0
DNK,Denmark,AND,Andorra,2015,0,0,0
DNK,Denmark,AND,Andorra,2016,0,1,-1
DNK,Denmark,AND,Andorra,2017,0,0,0
FIN,Finland,AND,Andorra,2008,0,0,0
FIN,Finland,AND,Andorra,2009,0,0,0
FIN,Finland,AND,Andorra,2010,0,0,0
FIN,Finland,AND,Andorra,2011,0,0,0
FIN,Finland,AND,Andorra,2012,0,0,0
FIN,Finland,AND,Andorra,2013,0,0,0
FIN,Finland,AND,Andorra,2014,0,0,0
FIN,Finland,AND,Andorra,2015,0,0,0
FIN,Finland,AND,Andorra,2016,0,0,0
FIN,Finland,AND,Andorra,2017,0,0,0
FRA,France,AND,Andorra,2008,0,17,-17
FRA,France,AND,Andorra,2009,0,34,-34
FRA,France,AND,Andorra,2010,0,28,-28
FRA,France,AND,Andorra,2011,0,21,-21
FRA,France,AND,Andorra,2012,0,19,-19
FRA,France,AND,Andorra,2013,0,13,-13
FRA,France,AND,Andorra,2014,0,15,-15
FRA,France,AND,Andorra,2015,0,12,-12
FRA,France,AND,Andorra,2016,0,7,-7
FRA,France,AND,Andorra,2017,0,11,-11
DEU,Germany,AND,Andorra,2008,1,2,-1
DEU,Germany,AND,Andorra,2009,3,4,-1
DEU,Germany,AND,Andorra,2010,3,0,3
DEU,Germany,AND,Andorra,2011,1,4,-3
DEU,Germany,AND,Andorra,2012,2,9,-7
DEU,Germany,AND,Andorra,2013,6,16,-10
DEU,Germany,AND,Andorra,2014,7,6,1
DEU,Germany,AND,Andorra,2015,2,10,-8
DEU,Germany,AND,Andorra,2016,5,7,-2
DEU,Germany,AND,Andorra,2017,3,4,-1
HUN,Hungary,AND,Andorra,2008,0,0,0
HUN,Hungary,AND,Andorra,2009,0,0,0
HUN,Hungary,AND,Andorra,2010,0,0,0
HUN,Hungary,AND,Andorra,2011,0,0,0
HUN,Hungary,AND,Andorra,2012,0,0,0
HUN,Hungary,AND,Andorra,2013,0,0,0
HUN,Hungary,AND,Andorra,2014,0,0,0
HUN,Hungary,AND,Andorra,2015,0,0,0
HUN,Hungary,AND,Andorra,2016,0,0,0
HUN,Hungary,AND,Andorra,2017,0,0,0
ISL,Iceland,AND,Andorra,2008,0,0,0
ISL,Iceland,AND,Andorra,2009,0,0,0
ISL,Iceland,AND,Andorra,2010,0,0,0
ISL,Iceland,AND,Andorra,2011,0,0,0
ISL,Iceland,AND,Andorra,2012,0,1,-1
ISL,Iceland,AND,Andorra,2013,0,0,0
ISL,Iceland,AND,Andorra,2014,0,0,0
ISL,Iceland,AND,Andorra,2015,0,0,0
ISL,Iceland,AND,Andorra,2016,0,0,0
ISL,Iceland,AND,Andorra,2017,0,1,-1
ITA,Italy,AND,Andorra,2008,2,13,-11
ITA,Italy,AND,Andorra,2009,3,13,-10
ITA,Italy,AND,Andorra,2010,0,7,-7
ITA,Italy,AND,Andorra,2011,0,3,-3
ITA,Italy,AND,Andorra,2012,2,4,-2
ITA,Italy,AND,Andorra,2013,4,1,3
ITA,Italy,AND,Andorra,2015,0,2,-2
ITA,Italy,AND,Andorra,2016,0,2,-2
ITA,Italy,AND,Andorra,2017,0,3,-3
JPN,Japan,AND,Andorra,2008,2,1,1
JPN,Japan,AND,Andorra,2009,1,1,0
JPN,Japan,AND,Andorra,2010,1,1,0
JPN,Japan,AND,Andorra,2011,1,1,0
JPN,Japan,AND,Andorra,2012,1,1,0
JPN,Japan,AND,Andorra,2013,0,0,0
JPN,Japan,AND,Andorra,2014,5,5,0
JPN,Japan,AND,Andorra,2015,0,0,0
JPN,Japan,AND,Andorra,2016,2,5,-3
JPN,Japan,AND,Andorra,2017,4,5,-1
KOR,Korea,AND,Andorra,2008,0,1,-1
KOR,Korea,AND,Andorra,2009,0,0,0
KOR,Korea,AND,Andorra,2010,0,0,0
KOR,Korea,AND,Andorra,2011,0,1,-1
KOR,Korea,AND,Andorra,2012,0,0,0
KOR,Korea,AND,Andorra,2013,0,0,0
KOR,Korea,AND,Andorra,2014,0,0,0
KOR,Korea,AND,Andorra,2015,1,1,0
KOR,Korea,AND,Andorra,2016,0,0,0
KOR,Korea,AND,Andorra,2017,0,0,0
LUX,Luxembourg,AND,Andorra,2008,0,1,-1
LUX,Luxembourg,AND,Andorra,2009,0,0,0
LUX,Luxembourg,AND,Andorra,2010,0,0,0
LUX,Luxembourg,AND,Andorra,2011,0,1,-1
LUX,Luxembourg,AND,Andorra,2012,0,1,-1
LUX,Luxembourg,AND,Andorra,2013,2,0,2
LUX,Luxembourg,AND,Andorra,2014,0,3,-3
LUX,Luxembourg,AND,Andorra,2015,0,1,-1
LUX,Luxembourg,AND,Andorra,2016,0,0,0
LUX,Luxembourg,AND,Andorra,2017,1,2,-1
MEX,Mexico,AND,Andorra,2008,0,1,-1
MEX,Mexico,AND,Andorra,2009,0,2,-2
MEX,Mexico,AND,Andorra,2010,0,1,-1
MEX,Mexico,AND,Andorra,2011,0,6,-6
MEX,Mexico,AND,Andorra,2012,0,0,0
MEX,Mexico,AND,Andorra,2013,0,1,-1
MEX,Mexico,AND,Andorra,2014,0,2,-2
MEX,Mexico,AND,Andorra,2015,0,4,-4
MEX,Mexico,AND,Andorra,2016,0,1,-1
MEX,Mexico,AND,Andorra,2017,0,3,-3
NLD,Netherlands,AND,Andorra,2011,0,1,-1
NLD,Netherlands,AND,Andorra,2015,1,0,1
NLD,Netherlands,AND,Andorra,2016,0,2,-2
NLD,Netherlands,AND,Andorra,2017,2,5,-3
NOR,Norway,AND,Andorra,2008,0,0,0
NOR,Norway,AND,Andorra,2009,0,0,0
NOR,Norway,AND,Andorra,2010,1,1,0
NOR,Norway,AND,Andorra,2011,0,1,-1
NOR,Norway,AND,Andorra,2012,0,1,-1
NOR,Norway,AND,Andorra,2013,0,0,0
NOR,Norway,AND,Andorra,2014,0,0,0
NOR,Norway,AND,Andorra,2015,0,0,0
NOR,Norway,AND,Andorra,2016,0,0,0
NOR,Norway,AND,Andorra,2017,0,0,0
POL,Poland,AND,Andorra,2009,0,0,0
POL,Poland,AND,Andorra,2010,0,0,0
POL,Poland,AND,Andorra,2011,0,0,0
POL,Poland,AND,Andorra,2012,0,0,0
POL,Poland,AND,Andorra,2013,0,0,0
POL,Poland,AND,Andorra,2014,0,0,0
POL,Poland,AND,Andorra,2015,0,0,0
POL,Poland,AND,Andorra,2016,0,0,0
POL,Poland,AND,Andorra,2017,0,0,0
SVK,Slovak Republic,AND,Andorra,2008,0,0,0
SVK,Slovak Republic,AND,Andorra,2010,0,0,0
ESP,Spain,AND,Andorra,2008,82,175,-93
ESP,Spain,AND,Andorra,2009,101,146,-45
ESP,Spain,AND,Andorra,2010,92,131,-39
ESP,Spain,AND,Andorra,2011,106,153,-47
ESP,Spain,AND,Andorra,2012,63,147,-84
ESP,Spain,AND,Andorra,2013,123,129,-6
ESP,Spain,AND,Andorra,2014,94,124,-30
ESP,Spain,AND,Andorra,2015,65,141,-76
ESP,Spain,AND,Andorra,2016,52,153,-101
ESP,Spain,AND,Andorra,2017,104,138,-34
SWE,Sweden,AND,Andorra,2008,0,0,0
SWE,Sweden,AND,Andorra,2009,0,0,0
SWE,Sweden,AND,Andorra,2010,0,1,-1
SWE,Sweden,AND,Andorra,2011,0,0,0
SWE,Sweden,AND,Andorra,2012,0,0,0
SWE,Sweden,AND,Andorra,2013,0,0,0
SWE,Sweden,AND,Andorra,2014,0,0,0
SWE,Sweden,AND,Andorra,2015,0,0,0
SWE,Sweden,AND,Andorra,2016,0,0,0
SWE,Sweden,AND,Andorra,2017,0,0,0
CHE,Switzerland,AND,Andorra,2010,0,2,-2
CHE,Switzerland,AND,Andorra,2011,0,5,-5
CHE,Switzerland,AND,Andorra,2012,2,7,-5
CHE,Switzerland,AND,Andorra,2013,1,6,-5
CHE,Switzerland,AND,Andorra,2014,2,3,-1
CHE,Switzerland,AND,Andorra,2015,2,5,-3
CHE,Switzerland,AND,Andorra,2016,1,5,-4
CHE,Switzerland,AND,Andorra,2017,1,3,-2
USA,United States,AND,Andorra,2009,0,3,-3
USA,United States,AND,Andorra,2010,0,3,-3
USA,United States,AND,Andorra,2011,0,3,-3
USA,United States,AND,Andorra,2013,0,3,-3
USA,United States,AND,Andorra,2015,0,5,-5
USA,United States,AND,Andorra,2016,0,5,-5
USA,United States,AND,Andorra,2017,0,2,-2
CHL,Chile,AND,Andorra,2008,0,0,0
CHL,Chile,AND,Andorra,2009,0,0,0
CHL,Chile,AND,Andorra,2010,0,0,0
CHL,Chile,AND,Andorra,2011,0,2,-2
CHL,Chile,AND,Andorra,2012,0,0,0
CHL,Chile,AND,Andorra,2013,0,1,-1
CHL,Chile,AND,Andorra,2014,0,1,-1
CHL,Chile,AND,Andorra,2015,0,1,-1
CHL,Chile,AND,Andorra,2016,0,1,-1
EST,Estonia,AND,Andorra,2008,0,0,0
EST,Estonia,AND,Andorra,2009,0,0,0
EST,Estonia,AND,Andorra,2010,0,0,0
EST,Estonia,AND,Andorra,2011,0,0,0
EST,Estonia,AND,Andorra,2012,0,0,0
EST,Estonia,AND,Andorra,2013,0,0,0
EST,Estonia,AND,Andorra,2014,0,0,0
EST,Estonia,AND,Andorra,2015,0,0,0
EST,Estonia,AND,Andorra,2016,0,0,0
EST,Estonia,AND,Andorra,2017,0,0,0
AUS,Australia,AGO,Angola,2008,0,6,-6
AUS,Australia,AGO,Angola,2009,0,5,-5
AUS,Australia,AGO,Angola,2010,6,4,2
AUS,Australia,AGO,Angola,2011,0,3,-3
AUS,Australia,AGO,Angola,2012,0,1,-1
AUS,Australia,AGO,Angola,2013,0,2,-2
AUS,Australia,AGO,Angola,2014,0,0,0
AUS,Australia,AGO,Angola,2015,0,5,-5
AUS,Australia,AGO,Angola,2017,0,5,-5
AUT,Austria,AGO,Angola,2008,11,15,-4
AUT,Austria,AGO,Angola,2009,8,7,1
AUT,Austria,AGO,Angola,2010,14,18,-4
AUT,Austria,AGO,Angola,2011,6,11,-5
AUT,Austria,AGO,Angola,2012,7,8,-1
AUT,Austria,AGO,Angola,2013,8,8,0
AUT,Austria,AGO,Angola,2014,7,7,0
AUT,Austria,AGO,Angola,2015,7,1,6
AUT,Austria,AGO,Angola,2016,6,14,-8
AUT,Austria,AGO,Angola,2017,10,16,-6
BEL,Belgium,AGO,Angola,2008,0,96,-96
BEL,Belgium,AGO,Angola,2009,0,89,-89
BEL,Belgium,AGO,Angola,2010,13,136,-123
BEL,Belgium,AGO,Angola,2011,0,114,-114
BEL,Belgium,AGO,Angola,2012,108,265,-157
BEL,Belgium,AGO,Angola,2013,159,192,-33
BEL,Belgium,AGO,Angola,2014,159,150,9
BEL,Belgium,AGO,Angola,2015,158,155,3
BEL,Belgium,AGO,Angola,2016,88,149,-61
BEL,Belgium,AGO,Angola,2017,64,193,-129
CAN,Canada,AGO,Angola,2008,0,76,-76
CAN,Canada,AGO,Angola,2009,0,62,-62
CAN,Canada,AGO,Angola,2010,0,61,-61
CAN,Canada,AGO,Angola,2011,0,39,-39
CAN,Canada,AGO,Angola,2012,0,70,-70
CAN,Canada,AGO,Angola,2013,0,45,-45
CAN,Canada,AGO,Angola,2014,0,21,-21
CAN,Canada,AGO,Angola,2015,0,30,-30
CAN,Canada,AGO,Angola,2016,0,35,-35
CAN,Canada,AGO,Angola,2017,0,45,-45
CZE,Czech Republic,AGO,Angola,2008,0,12,-12
CZE,Czech Republic,AGO,Angola,2009,2,5,-3
CZE,Czech Republic,AGO,Angola,2010,0,2,-2
CZE,Czech Republic,AGO,Angola,2011,0,9,-9
CZE,Czech Republic,AGO,Angola,2012,13,7,6
CZE,Czech Republic,AGO,Angola,2013,14,4,10
CZE,Czech Republic,AGO,Angola,2014,6,7,-1
CZE,Czech Republic,AGO,Angola,2015,7,5,2
CZE,Czech Republic,AGO,Angola,2016,4,1,3
CZE,Czech Republic,AGO,Angola,2017,8,3,5
DNK,Denmark,AGO,Angola,2008,0,2,-2
DNK,Denmark,AGO,Angola,2009,0,0,0
DNK,Denmark,AGO,Angola,2010,0,4,-4
DNK,Denmark,AGO,Angola,2011,1,1,0
DNK,Denmark,AGO,Angola,2012,0,1,-1
DNK,Denmark,AGO,Angola,2013,2,5,-3
DNK,Denmark,AGO,Angola,2014,2,3,-1
DNK,Denmark,AGO,Angola,2015,1,6,-5
DNK,Denmark,AGO,Angola,2016,4,7,-3
DNK,Denmark,AGO,Angola,2017,11,2,9
FIN,Finland,AGO,Angola,2008,0,39,-39
FIN,Finland,AGO,Angola,2009,1,19,-18
FIN,Finland,AGO,Angola,2010,0,22,-22
FIN,Finland,AGO,Angola,2011,3,35,-32
FIN,Finland,AGO,Angola,2012,3,28,-25
FIN,Finland,AGO,Angola,2013,0,33,-33
FIN,Finland,AGO,Angola,2014,1,7,-6
FIN,Finland,AGO,Angola,2015,4,10,-6
FIN,Finland,AGO,Angola,2016,3,5,-2
FIN,Finland,AGO,Angola,2017,2,9,-7
FRA,France,AGO,Angola,2008,0,819,-819
FRA,France,AGO,Angola,2009,0,719,-719
FRA,France,AGO,Angola,2010,0,621,-621
FRA,France,AGO,Angola,2011,0,659,-659
FRA,France,AGO,Angola,2012,0,702,-702
FRA,France,AGO,Angola,2013,0,801,-801
FRA,France,AGO,Angola,2014,0,719,-719
FRA,France,AGO,Angola,2015,0,672,-672
FRA,France,AGO,Angola,2016,0,730,-730
FRA,France,AGO,Angola,2017,0,707,-707
DEU,Germany,AGO,Angola,2008,441,348,93
DEU,Germany,AGO,Angola,2009,506,341,165
DEU,Germany,AGO,Angola,2010,385,391,-6
DEU,Germany,AGO,Angola,2011,324,349,-25
DEU,Germany,AGO,Angola,2012,299,408,-109
DEU,Germany,AGO,Angola,2013,342,353,-11
DEU,Germany,AGO,Angola,2014,432,342,90
DEU,Germany,AGO,Angola,2015,287,298,-11
DEU,Germany,AGO,Angola,2016,303,337,-34
DEU,Germany,AGO,Angola,2017,264,451,-187
HUN,Hungary,AGO,Angola,2008,0,0,0
HUN,Hungary,AGO,Angola,2009,0,3,-3
HUN,Hungary,AGO,Angola,2010,0,13,-13
HUN,Hungary,AGO,Angola,2011,1,11,-10
HUN,Hungary,AGO,Angola,2012,0,13,-13
HUN,Hungary,AGO,Angola,2013,0,9,-9
HUN,Hungary,AGO,Angola,2014,0,6,-6
HUN,Hungary,AGO,Angola,2015,0,4,-4
HUN,Hungary,AGO,Angola,2016,10,22,-12
HUN,Hungary,AGO,Angola,2017,0,33,-33
ISL,Iceland,AGO,Angola,2008,0,0,0
ISL,Iceland,AGO,Angola,2009,1,2,-1
ISL,Iceland,AGO,Angola,2010,1,0,1
ISL,Iceland,AGO,Angola,2011,0,0,0
ISL,Iceland,AGO,Angola,2012,0,0,0
ISL,Iceland,AGO,Angola,2013,0,0,0
ISL,Iceland,AGO,Angola,2014,0,0,0
ISL,Iceland,AGO,Angola,2015,0,0,0
ISL,Iceland,AGO,Angola,2016,0,1,-1
ISL,Iceland,AGO,Angola,2017,1,1,0
ITA,Italy,AGO,Angola,2008,7,85,-78
ITA,Italy,AGO,Angola,2009,9,83,-74
ITA,Italy,AGO,Angola,2010,35,78,-43
ITA,Italy,AGO,Angola,2011,7,69,-62
ITA,Italy,AGO,Angola,2012,11,91,-80
ITA,Italy,AGO,Angola,2013,22,64,-42
ITA,Italy,AGO,Angola,2014,12,80,-68
ITA,Italy,AGO,Angola,2015,8,69,-61
ITA,Italy,AGO,Angola,2016,0,64,-64
ITA,Italy,AGO,Angola,2017,12,79,-67
JPN,Japan,AGO,Angola,2008,148,157,-9
JPN,Japan,AGO,Angola,2009,50,56,-6
JPN,Japan,AGO,Angola,2010,61,62,-1
JPN,Japan,AGO,Angola,2011,90,97,-7
JPN,Japan,AGO,Angola,2012,126,140,-14
JPN,Japan,AGO,Angola,2013,122,133,-11
JPN,Japan,AGO,Angola,2014,73,79,-6
JPN,Japan,AGO,Angola,2015,53,61,-8
JPN,Japan,AGO,Angola,2016,83,99,-16
JPN,Japan,AGO,Angola,2017,60,67,-7
KOR,Korea,AGO,Angola,2008,13,9,4
KOR,Korea,AGO,Angola,2009,2,11,-9
KOR,Korea,AGO,Angola,2010,4,11,-7
KOR,Korea,AGO,Angola,2011,22,30,-8
KOR,Korea,AGO,Angola,2012,38,46,-8
KOR,Korea,AGO,Angola,2013,31,18,13
KOR,Korea,AGO,Angola,2014,13,20,-7
KOR,Korea,AGO,Angola,2015,28,14,14
KOR,Korea,AGO,Angola,2016,6,12,-6
KOR,Korea,AGO,Angola,2017,17,34,-17
LUX,Luxembourg,AGO,Angola,2008,8,8,0
LUX,Luxembourg,AGO,Angola,2009,1,6,-5
LUX,Luxembourg,AGO,Angola,2010,0,4,-4
LUX,Luxembourg,AGO,Angola,2011,1,5,-4
LUX,Luxembourg,AGO,Angola,2012,3,7,-4
LUX,Luxembourg,AGO,Angola,2013,5,3,2
LUX,Luxembourg,AGO,Angola,2014,4,7,-3
LUX,Luxembourg,AGO,Angola,2015,2,7,-5
LUX,Luxembourg,AGO,Angola,2016,1,4,-3
LUX,Luxembourg,AGO,Angola,2017,2,5,-3
MEX,Mexico,AGO,Angola,2008,0,1,-1
MEX,Mexico,AGO,Angola,2009,0,3,-3
MEX,Mexico,AGO,Angola,2010,0,2,-2
MEX,Mexico,AGO,Angola,2012,0,1,-1
MEX,Mexico,AGO,Angola,2013,0,3,-3
MEX,Mexico,AGO,Angola,2014,0,1,-1
MEX,Mexico,AGO,Angola,2015,0,1,-1
MEX,Mexico,AGO,Angola,2016,0,2,-2
NLD,Netherlands,AGO,Angola,2008,13,25,-12
NLD,Netherlands,AGO,Angola,2009,36,20,16
NLD,Netherlands,AGO,Angola,2010,16,37,-21
NLD,Netherlands,AGO,Angola,2011,16,20,-4
NLD,Netherlands,AGO,Angola,2012,32,18,14
NLD,Netherlands,AGO,Angola,2013,27,29,-2
NLD,Netherlands,AGO,Angola,2014,31,27,4
NLD,Netherlands,AGO,Angola,2015,19,18,1
NLD,Netherlands,AGO,Angola,2016,29,26,3
NLD,Netherlands,AGO,Angola,2017,-1,14,-15
NZL,New Zealand,AGO,Angola,2010,0,0,0
NZL,New Zealand,AGO,Angola,2017,0,1,-1
NOR,Norway,AGO,Angola,2008,3,42,-39
NOR,Norway,AGO,Angola,2009,14,31,-17
NOR,Norway,AGO,Angola,2010,17,27,-10
NOR,Norway,AGO,Angola,2011,23,38,-15
NOR,Norway,AGO,Angola,2012,10,27,-17
NOR,Norway,AGO,Angola,2013,25,20,5
NOR,Norway,AGO,Angola,2014,12,17,-5
NOR,Norway,AGO,Angola,2015,10,38,-28
NOR,Norway,AGO,Angola,2016,27,19,8
NOR,Norway,AGO,Angola,2017,26,7,19
POL,Poland,AGO,Angola,2009,0,75,-75
POL,Poland,AGO,Angola,2010,0,73,-73
POL,Poland,AGO,Angola,2011,0,92,-92
POL,Poland,AGO,Angola,2012,0,94,-94
POL,Poland,AGO,Angola,2013,0,118,-118
POL,Poland,AGO,Angola,2014,0,59,-59
POL,Poland,AGO,Angola,2015,0,90,-90
POL,Poland,AGO,Angola,2016,0,86,-86
POL,Poland,AGO,Angola,2017,0,47,-47
PRT,Portugal,AGO,Angola,2008,0,2021,-2021
PRT,Portugal,AGO,Angola,2009,0,1543,-1543
PRT,Portugal,AGO,Angola,2010,0,1317,-1317
PRT,Portugal,AGO,Angola,2011,0,1369,-1369
PRT,Portugal,AGO,Angola,2012,0,1293,-1293
PRT,Portugal,AGO,Angola,2013,0,1477,-1477
PRT,Portugal,AGO,Angola,2014,0,1469,-1469
PRT,Portugal,AGO,Angola,2015,0,1277,-1277
PRT,Portugal,AGO,Angola,2016,0,1479,-1479
PRT,Portugal,AGO,Angola,2017,0,1831,-1831
SVK,Slovak Republic,AGO,Angola,2008,1,4,-3
SVK,Slovak Republic,AGO,Angola,2009,1,7,-6
SVK,Slovak Republic,AGO,Angola,2010,0,1,-1
ESP,Spain,AGO,Angola,2008,179,185,-6
ESP,Spain,AGO,Angola,2009,221,151,70
ESP,Spain,AGO,Angola,2010,193,114,79
ESP,Spain,AGO,Angola,2011,212,128,84
ESP,Spain,AGO,Angola,2012,115,181,-66
ESP,Spain,AGO,Angola,2013,194,112,82
ESP,Spain,AGO,Angola,2014,94,137,-43
ESP,Spain,AGO,Angola,2015,90,129,-39
ESP,Spain,AGO,Angola,2016,95,128,-33
ESP,Spain,AGO,Angola,2017,142,121,21
SWE,Sweden,AGO,Angola,2008,3,17,-14
SWE,Sweden,AGO,Angola,2009,0,27,-27
SWE,Sweden,AGO,Angola,2010,0,10,-10
SWE,Sweden,AGO,Angola,2011,8,15,-7
SWE,Sweden,AGO,Angola,2012,1,17,-16
SWE,Sweden,AGO,Angola,2013,6,8,-2
SWE,Sweden,AGO,Angola,2014,0,11,-11
SWE,Sweden,AGO,Angola,2015,3,7,-4
SWE,Sweden,AGO,Angola,2016,4,11,-7
SWE,Sweden,AGO,Angola,2017,1,7,-6
CHE,Switzerland,AGO,Angola,2010,12,314,-302
CHE,Switzerland,AGO,Angola,2011,8,263,-255
CHE,Switzerland,AGO,Angola,2012,11,207,-196
CHE,Switzerland,AGO,Angola,2013,15,183,-168
CHE,Switzerland,AGO,Angola,2014,14,143,-129
CHE,Switzerland,AGO,Angola,2015,13,107,-94
CHE,Switzerland,AGO,Angola,2016,16,95,-79
CHE,Switzerland,AGO,Angola,2017,13,109,-96
GBR,United Kingdom,AGO,Angola,2015,1000,1000,0
USA,United States,AGO,Angola,2008,0,221,-221
USA,United States,AGO,Angola,2009,0,173,-173
USA,United States,AGO,Angola,2010,0,148,-148
USA,United States,AGO,Angola,2011,0,148,-148
USA,United States,AGO,Angola,2012,0,187,-187
USA,United States,AGO,Angola,2013,0,143,-143
USA,United States,AGO,Angola,2014,0,148,-148
USA,United States,AGO,Angola,2015,0,154,-154
USA,United States,AGO,Angola,2016,0,198,-198
USA,United States,AGO,Angola,2017,0,209,-209
CHL,Chile,AGO,Angola,2008,0,2,-2
CHL,Chile,AGO,Angola,2009,0,0,0
CHL,Chile,AGO,Angola,2010,0,4,-4
CHL,Chile,AGO,Angola,2011,0,2,-2
CHL,Chile,AGO,Angola,2012,0,2,-2
CHL,Chile,AGO,Angola,2013,0,0,0
CHL,Chile,AGO,Angola,2014,0,1,-1
CHL,Chile,AGO,Angola,2015,0,12,-12
CHL,Chile,AGO,Angola,2016,0,12,-12
EST,Estonia,AGO,Angola,2008,0,0,0
EST,Estonia,AGO,Angola,2009,0,0,0
EST,Estonia,AGO,Angola,2010,0,0,0
EST,Estonia,AGO,Angola,2011,0,0,0
EST,Estonia,AGO,Angola,2012,0,0,0
EST,Estonia,AGO,Angola,2013,0,0,0
EST,Estonia,AGO,Angola,2014,0,0,0
EST,Estonia,AGO,Angola,2015,0,0,0
EST,Estonia,AGO,Angola,2016,0,0,0
EST,Estonia,AGO,Angola,2017,0,0,0
SVN,Slovenia,AGO,Angola,2017,0,1,-1
AUS,Australia,ATG,Antigua and Barbuda,2008,0,0,0
AUS,Australia,ATG,Antigua and Barbuda,2009,0,0,0
AUS,Australia,ATG,Antigua and Barbuda,2010,0,0,0
AUS,Australia,ATG,Antigua and Barbuda,2011,0,0,0
AUS,Australia,ATG,Antigua and Barbuda,2012,0,1,-1
AUS,Australia,ATG,Antigua and Barbuda,2013,0,2,-2
AUS,Australia,ATG,Antigua and Barbuda,2014,0,0,0
AUS,Australia,ATG,Antigua and Barbuda,2015,0,0,0
AUS,Australia,ATG,Antigua and Barbuda,2016,0,0,0
AUS,Australia,ATG,Antigua and Barbuda,2017,0,3,-3
AUT,Austria,ATG,Antigua and Barbuda,2008,1,1,0
AUT,Austria,ATG,Antigua and Barbuda,2009,1,0,1
AUT,Austria,ATG,Antigua and Barbuda,2010,0,0,0
AUT,Austria,ATG,Antigua and Barbuda,2011,1,1,0
AUT,Austria,ATG,Antigua and Barbuda,2012,0,0,0
AUT,Austria,ATG,Antigua and Barbuda,2013,0,0,0
AUT,Austria,ATG,Antigua and Barbuda,2014,1,1,0
AUT,Austria,ATG,Antigua and Barbuda,2015,0,2,-2
AUT,Austria,ATG,Antigua and Barbuda,2016,1,0,1
AUT,Austria,ATG,Antigua and Barbuda,2017,0,1,-1
BEL,Belgium,ATG,Antigua and Barbuda,2010,0,0,0
CAN,Canada,ATG,Antigua and Barbuda,2008,0,32,-32
CAN,Canada,ATG,Antigua and Barbuda,2009,0,38,-38
CAN,Canada,ATG,Antigua and Barbuda,2010,0,27,-27
CAN,Canada,ATG,Antigua and Barbuda,2011,0,37,-37
CAN,Canada,ATG,Antigua and Barbuda,2012,0,50,-50
CAN,Canada,ATG,Antigua and Barbuda,2013,0,25,-25
CAN,Canada,ATG,Antigua and Barbuda,2014,0,50,-50
CAN,Canada,ATG,Antigua and Barbuda,2015,0,51,-51
CAN,Canada,ATG,Antigua and Barbuda,2016,0,45,-45
CAN,Canada,ATG,Antigua and Barbuda,2017,0,85,-85
CZE,Czech Republic,ATG,Antigua and Barbuda,2013,0,1,-1
DNK,Denmark,ATG,Antigua and Barbuda,2013,0,0,0
DNK,Denmark,ATG,Antigua and Barbuda,2014,1,0,1
DNK,Denmark,ATG,Antigua and Barbuda,2015,0,2,-2
DNK,Denmark,ATG,Antigua and Barbuda,2016,0,0,0
DNK,Denmark,ATG,Antigua and Barbuda,2017,1,0,1
FIN,Finland,ATG,Antigua and Barbuda,2008,0,0,0
FIN,Finland,ATG,Antigua and Barbuda,2009,0,0,0
FIN,Finland,ATG,Antigua and Barbuda,2010,0,0,0
FIN,Finland,ATG,Antigua and Barbuda,2011,0,0,0
FIN,Finland,ATG,Antigua and Barbuda,2012,0,0,0
FIN,Finland,ATG,Antigua and Barbuda,2013,0,0,0
FIN,Finland,ATG,Antigua and Barbuda,2014,0,0,0
FIN,Finland,ATG,Antigua and Barbuda,2015,0,0,0
FIN,Finland,ATG,Antigua and Barbuda,2016,0,0,0
FIN,Finland,ATG,Antigua and Barbuda,2017,0,0,0
FRA,France,ATG,Antigua and Barbuda,2008,0,1,-1
FRA,France,ATG,Antigua and Barbuda,2009,0,1,-1
FRA,France,ATG,Antigua and Barbuda,2010,0,2,-2
FRA,France,ATG,Antigua and Barbuda,2011,0,2,-2
FRA,France,ATG,Antigua and Barbuda,2012,0,2,-2
FRA,France,ATG,Antigua and Barbuda,2013,0,3,-3
FRA,France,ATG,Antigua and Barbuda,2014,0,0,0
FRA,France,ATG,Antigua and Barbuda,2015,0,2,-2
FRA,France,ATG,Antigua and Barbuda,2016,0,5,-5
FRA,France,ATG,Antigua and Barbuda,2017,0,3,-3
DEU,Germany,ATG,Antigua and Barbuda,2008,3,3,0
DEU,Germany,ATG,Antigua and Barbuda,2009,0,2,-2
DEU,Germany,ATG,Antigua and Barbuda,2010,1,1,0
DEU,Germany,ATG,Antigua and Barbuda,2011,1,4,-3
DEU,Germany,ATG,Antigua and Barbuda,2012,1,1,0
DEU,Germany,ATG,Antigua and Barbuda,2013,1,2,-1
DEU,Germany,ATG,Antigua and Barbuda,2014,0,1,-1
DEU,Germany,ATG,Antigua and Barbuda,2015,1,3,-2
DEU,Germany,ATG,Antigua and Barbuda,2016,4,5,-1
DEU,Germany,ATG,Antigua and Barbuda,2017,2,9,-7
HUN,Hungary,ATG,Antigua and Barbuda,2008,0,0,0
HUN,Hungary,ATG,Antigua and Barbuda,2009,0,0,0
HUN,Hungary,ATG,Antigua and Barbuda,2010,0,0,0
HUN,Hungary,ATG,Antigua and Barbuda,2011,0,0,0
HUN,Hungary,ATG,Antigua and Barbuda,2012,0,1,-1
HUN,Hungary,ATG,Antigua and Barbuda,2013,0,0,0
HUN,Hungary,ATG,Antigua and Barbuda,2014,0,0,0
HUN,Hungary,ATG,Antigua and Barbuda,2015,0,0,0
HUN,Hungary,ATG,Antigua and Barbuda,2016,0,0,0
HUN,Hungary,ATG,Antigua and Barbuda,2017,0,0,0
ISL,Iceland,ATG,Antigua and Barbuda,2008,0,0,0
ISL,Iceland,ATG,Antigua and Barbuda,2009,0,0,0
ISL,Iceland,ATG,Antigua and Barbuda,2010,0,0,0
ISL,Iceland,ATG,Antigua and Barbuda,2011,0,0,0
ISL,Iceland,ATG,Antigua and Barbuda,2012,0,1,-1
ISL,Iceland,ATG,Antigua and Barbuda,2013,0,0,0
ISL,Iceland,ATG,Antigua and Barbuda,2014,0,0,0
ISL,Iceland,ATG,Antigua and Barbuda,2015,0,1,-1
ISL,Iceland,ATG,Antigua and Barbuda,2016,2,0,2
ISL,Iceland,ATG,Antigua and Barbuda,2017,0,0,0
ITA,Italy,ATG,Antigua and Barbuda,2008,0,3,-3
ITA,Italy,ATG,Antigua and Barbuda,2009,0,5,-5
ITA,Italy,ATG,Antigua and Barbuda,2010,0,2,-2
ITA,Italy,ATG,Antigua and Barbuda,2011,0,1,-1
ITA,Italy,ATG,Antigua and Barbuda,2012,0,4,-4
ITA,Italy,ATG,Antigua and Barbuda,2013,0,2,-2
ITA,Italy,ATG,Antigua and Barbuda,2015,0,0,0
ITA,Italy,ATG,Antigua and Barbuda,2016,0,2,-2
JPN,Japan,ATG,Antigua and Barbuda,2008,16,21,-5
JPN,Japan,ATG,Antigua and Barbuda,2009,11,11,0
JPN,Japan,ATG,Antigua and Barbuda,2010,18,13,5
JPN,Japan,ATG,Antigua and Barbuda,2011,7,7,0
JPN,Japan,ATG,Antigua and Barbuda,2012,6,7,-1
JPN,Japan,ATG,Antigua and Barbuda,2013,12,14,-2
JPN,Japan,ATG,Antigua and Barbuda,2014,18,19,-1
JPN,Japan,ATG,Antigua and Barbuda,2015,25,25,0
JPN,Japan,ATG,Antigua and Barbuda,2016,7,9,-2
JPN,Japan,ATG,Antigua and Barbuda,2017,14,13,1
KOR,Korea,ATG,Antigua and Barbuda,2008,2,1,1
KOR,Korea,ATG,Antigua and Barbuda,2009,1,2,-1
KOR,Korea,ATG,Antigua and Barbuda,2010,0,0,0
KOR,Korea,ATG,Antigua and Barbuda,2011,1,0,1
KOR,Korea,ATG,Antigua and Barbuda,2012,3,3,0
KOR,Korea,ATG,Antigua and Barbuda,2013,1,0,1
KOR,Korea,ATG,Antigua and Barbuda,2014,1,1,0
KOR,Korea,ATG,Antigua and Barbuda,2015,1,0,1
KOR,Korea,ATG,Antigua and Barbuda,2016,1,1,0
KOR,Korea,ATG,Antigua and Barbuda,2017,0,0,0
LUX,Luxembourg,ATG,Antigua and Barbuda,2008,0,0,0
LUX,Luxembourg,ATG,Antigua and Barbuda,2009,0,0,0
LUX,Luxembourg,ATG,Antigua and Barbuda,2010,0,0,0
LUX,Luxembourg,ATG,Antigua and Barbuda,2011,0,0,0
LUX,Luxembourg,ATG,Antigua and Barbuda,2012,0,0,0
LUX,Luxembourg,ATG,Antigua and Barbuda,2013,0,0,0
LUX,Luxembourg,ATG,Antigua and Barbuda,2014,0,0,0
LUX,Luxembourg,ATG,Antigua and Barbuda,2015,0,0,0
LUX,Luxembourg,ATG,Antigua and Barbuda,2016,0,0,0
LUX,Luxembourg,ATG,Antigua and Barbuda,2017,0,1,-1
MEX,Mexico,ATG,Antigua and Barbuda,2012,0,0,0
MEX,Mexico,ATG,Antigua and Barbuda,2013,0,0,0
MEX,Mexico,ATG,Antigua and Barbuda,2014,0,0,0
MEX,Mexico,ATG,Antigua and Barbuda,2015,0,1,-1
NLD,Netherlands,ATG,Antigua and Barbuda,2014,0,1,-1
NLD,Netherlands,ATG,Antigua and Barbuda,2015,0,1,-1
NLD,Netherlands,ATG,Antigua and Barbuda,2016,1,1,0
NZL,New Zealand,ATG,Antigua and Barbuda,2008,0,0,0
NZL,New Zealand,ATG,Antigua and Barbuda,2013,0,1,-1
NOR,Norway,ATG,Antigua and Barbuda,2008,0,0,0
NOR,Norway,ATG,Antigua and Barbuda,2009,0,0,0
NOR,Norway,ATG,Antigua and Barbuda,2010,0,0,0
NOR,Norway,ATG,Antigua and Barbuda,2011,0,0,0
NOR,Norway,ATG,Antigua and Barbuda,2012,0,0,0
NOR,Norway,ATG,Antigua and Barbuda,2013,0,0,0
NOR,Norway,ATG,Antigua and Barbuda,2014,0,0,0
NOR,Norway,ATG,Antigua and Barbuda,2015,0,0,0
NOR,Norway,ATG,Antigua and Barbuda,2016,0,0,0
NOR,Norway,ATG,Antigua and Barbuda,2017,0,0,0
POL,Poland,ATG,Antigua and Barbuda,2009,0,0,0
POL,Poland,ATG,Antigua and Barbuda,2010,0,0,0
POL,Poland,ATG,Antigua and Barbuda,2011,0,0,0
POL,Poland,ATG,Antigua and Barbuda,2012,0,0,0
POL,Poland,ATG,Antigua and Barbuda,2013,0,0,0
POL,Poland,ATG,Antigua and Barbuda,2014,0,0,0
POL,Poland,ATG,Antigua and Barbuda,2015,0,0,0
POL,Poland,ATG,Antigua and Barbuda,2016,0,0,0
POL,Poland,ATG,Antigua and Barbuda,2017,0,0,0
SVK,Slovak Republic,ATG,Antigua and Barbuda,2008,0,0,0
SVK,Slovak Republic,ATG,Antigua and Barbuda,2010,0,0,0
ESP,Spain,ATG,Antigua and Barbuda,2008,1,1,0
ESP,Spain,ATG,Antigua and Barbuda,2009,1,0,1
ESP,Spain,ATG,Antigua and Barbuda,2010,1,1,0
ESP,Spain,ATG,Antigua and Barbuda,2011,0,5,-5
ESP,Spain,ATG,Antigua and Barbuda,2012,1,5,-4
ESP,Spain,ATG,Antigua and Barbuda,2013,1,1,0
ESP,Spain,ATG,Antigua and Barbuda,2014,1,2,-1
ESP,Spain,ATG,Antigua and Barbuda,2015,0,3,-3
ESP,Spain,ATG,Antigua and Barbuda,2016,0,5,-5
ESP,Spain,ATG,Antigua and Barbuda,2017,0,4,-4
SWE,Sweden,ATG,Antigua and Barbuda,2008,0,1,-1
SWE,Sweden,ATG,Antigua and Barbuda,2009,0,0,0
SWE,Sweden,ATG,Antigua and Barbuda,2010,0,0,0
SWE,Sweden,ATG,Antigua and Barbuda,2011,0,0,0
SWE,Sweden,ATG,Antigua and Barbuda,2012,1,0,1
SWE,Sweden,ATG,Antigua and Barbuda,2013,0,1,-1
SWE,Sweden,ATG,Antigua and Barbuda,2014,0,0,0
SWE,Sweden,ATG,Antigua and Barbuda,2015,0,0,0
SWE,Sweden,ATG,Antigua and Barbuda,2016,0,0,0
SWE,Sweden,ATG,Antigua and Barbuda,2017,1,2,-1
CHE,Switzerland,ATG,Antigua and Barbuda,2010,1,5,-4
CHE,Switzerland,ATG,Antigua and Barbuda,2011,4,0,4
CHE,Switzerland,ATG,Antigua and Barbuda,2012,1,2,-1
CHE,Switzerland,ATG,Antigua and Barbuda,2013,3,1,2
CHE,Switzerland,ATG,Antigua and Barbuda,2014,1,1,0
CHE,Switzerland,ATG,Antigua and Barbuda,2015,0,1,-1
CHE,Switzerland,ATG,Antigua and Barbuda,2016,1,1,0
CHE,Switzerland,ATG,Antigua and Barbuda,2017,1,1,0
USA,United States,ATG,Antigua and Barbuda,2008,0,444,-444
USA,United States,ATG,Antigua and Barbuda,2009,0,437,-437
USA,United States,ATG,Antigua and Barbuda,2010,0,359,-359
USA,United States,ATG,Antigua and Barbuda,2011,0,368,-368
USA,United States,ATG,Antigua and Barbuda,2012,0,337,-337
USA,United States,ATG,Antigua and Barbuda,2013,0,344,-344
USA,United States,ATG,Antigua and Barbuda,2014,0,369,-369
USA,United States,ATG,Antigua and Barbuda,2015,0,290,-290
USA,United States,ATG,Antigua and Barbuda,2016,0,324,-324
USA,United States,ATG,Antigua and Barbuda,2017,0,322,-322
CHL,Chile,ATG,Antigua and Barbuda,2008,0,2,-2
CHL,Chile,ATG,Antigua and Barbuda,2009,0,0,0
CHL,Chile,ATG,Antigua and Barbuda,2010,0,0,0
CHL,Chile,ATG,Antigua and Barbuda,2011,0,0,0
CHL,Chile,ATG,Antigua and Barbuda,2012,0,0,0
CHL,Chile,ATG,Antigua and Barbuda,2013,0,0,0
CHL,Chile,ATG,Antigua and Barbuda,2014,0,0,0
CHL,Chile,ATG,Antigua and Barbuda,2015,0,0,0
CHL,Chile,ATG,Antigua and Barbuda,2016,0,0,0
EST,Estonia,ATG,Antigua and Barbuda,2008,0,0,0
EST,Estonia,ATG,Antigua and Barbuda,2009,0,0,0
EST,Estonia,ATG,Antigua and Barbuda,2010,0,0,0
EST,Estonia,ATG,Antigua and Barbuda,2011,0,0,0
EST,Estonia,ATG,Antigua and Barbuda,2012,0,0,0
EST,Estonia,ATG,Antigua and Barbuda,2013,0,0,0
EST,Estonia,ATG,Antigua and Barbuda,2014,0,0,0
EST,Estonia,ATG,Antigua and Barbuda,2015,0,4,-4
EST,Estonia,ATG,Antigua and Barbuda,2016,0,0,0
EST,Estonia,ATG,Antigua and Barbuda,2017,0,0,0
AUS,Australia,ARG,Argentina,2008,112,175,-63
AUS,Australia,ARG,Argentina,2009,124,161,-37
AUS,Australia,ARG,Argentina,2010,100,204,-104
AUS,Australia,ARG,Argentina,2011,106,128,-22
AUS,Australia,ARG,Argentina,2012,113,173,-60
AUS,Australia,ARG,Argentina,2013,93,186,-93
AUS,Australia,ARG,Argentina,2014,85,231,-146
AUS,Australia,ARG,Argentina,2015,100,190,-90
AUS,Australia,ARG,Argentina,2016,100,249,-149
AUS,Australia,ARG,Argentina,2017,0,239,-239
AUT,Austria,ARG,Argentina,2008,54,78,-24
AUT,Austria,ARG,Argentina,2009,67,73,-6
AUT,Austria,ARG,Argentina,2010,58,99,-41
AUT,Austria,ARG,Argentina,2011,55,101,-46
AUT,Austria,ARG,Argentina,2012,78,92,-14
AUT,Austria,ARG,Argentina,2013,59,82,-23
AUT,Austria,ARG,Argentina,2014,52,94,-42
AUT,Austria,ARG,Argentina,2015,53,93,-40
AUT,Austria,ARG,Argentina,2016,69,93,-24
AUT,Austria,ARG,Argentina,2017,87,95,-8
BEL,Belgium,ARG,Argentina,2008,0,114,-114
BEL,Belgium,ARG,Argentina,2009,0,109,-109
BEL,Belgium,ARG,Argentina,2010,82,113,-31
BEL,Belgium,ARG,Argentina,2011,0,127,-127
BEL,Belgium,ARG,Argentina,2012,77,107,-30
BEL,Belgium,ARG,Argentina,2013,78,113,-35
BEL,Belgium,ARG,Argentina,2014,48,78,-30
BEL,Belgium,ARG,Argentina,2015,41,99,-58
BEL,Belgium,ARG,Argentina,2016,39,96,-57
BEL,Belgium,ARG,Argentina,2017,42,119,-77
CAN,Canada,ARG,Argentina,2008,0,540,-540
CAN,Canada,ARG,Argentina,2009,0,467,-467
CAN,Canada,ARG,Argentina,2010,0,459,-459
CAN,Canada,ARG,Argentina,2011,0,278,-278
CAN,Canada,ARG,Argentina,2012,0,263,-263
CAN,Canada,ARG,Argentina,2013,0,282,-282
CAN,Canada,ARG,Argentina,2014,0,214,-214
CAN,Canada,ARG,Argentina,2015,0,237,-237
CAN,Canada,ARG,Argentina,2016,0,260,-260
CAN,Canada,ARG,Argentina,2017,0,235,-235
CZE,Czech Republic,ARG,Argentina,2008,0,12,-12
CZE,Czech Republic,ARG,Argentina,2009,0,14,-14
CZE,Czech Republic,ARG,Argentina,2010,0,28,-28
CZE,Czech Republic,ARG,Argentina,2011,0,21,-21
CZE,Czech Republic,ARG,Argentina,2012,7,22,-15
CZE,Czech Republic,ARG,Argentina,2013,10,21,-11
CZE,Czech Republic,ARG,Argentina,2014,12,23,-11
CZE,Czech Republic,ARG,Argentina,2015,21,25,-4
CZE,Czech Republic,ARG,Argentina,2016,20,23,-3
CZE,Czech Republic,ARG,Argentina,2017,14,43,-29
DNK,Denmark,ARG,Argentina,2008,26,28,-2
DNK,Denmark,ARG,Argentina,2009,27,26,1
DNK,Denmark,ARG,Argentina,2010,33,22,11
DNK,Denmark,ARG,Argentina,2011,27,39,-12
DNK,Denmark,ARG,Argentina,2012,27,34,-7
DNK,Denmark,ARG,Argentina,2013,43,58,-15
DNK,Denmark,ARG,Argentina,2014,61,94,-33
DNK,Denmark,ARG,Argentina,2015,135,138,-3
DNK,Denmark,ARG,Argentina,2016,291,201,90
DNK,Denmark,ARG,Argentina,2017,425,175,250
FIN,Finland,ARG,Argentina,2008,5,17,-12
FIN,Finland,ARG,Argentina,2009,10,16,-6
FIN,Finland,ARG,Argentina,2010,3,14,-11
FIN,Finland,ARG,Argentina,2011,4,18,-14
FIN,Finland,ARG,Argentina,2012,8,20,-12
FIN,Finland,ARG,Argentina,2013,14,20,-6
FIN,Finland,ARG,Argentina,2014,11,18,-7
FIN,Finland,ARG,Argentina,2015,2,26,-24
FIN,Finland,ARG,Argentina,2016,6,15,-9
FIN,Finland,ARG,Argentina,2017,8,18,-10
FRA,France,ARG,Argentina,2008,0,328,-328
FRA,France,ARG,Argentina,2009,0,423,-423
FRA,France,ARG,Argentina,2010,0,343,-343
FRA,France,ARG,Argentina,2011,0,310,-310
FRA,France,ARG,Argentina,2012,0,373,-373
FRA,France,ARG,Argentina,2013,0,352,-352
FRA,France,ARG,Argentina,2014,0,384,-384
FRA,France,ARG,Argentina,2015,0,487,-487
FRA,France,ARG,Argentina,2016,0,498,-498
FRA,France,ARG,Argentina,2017,0,533,-533
DEU,Germany,ARG,Argentina,2008,884,911,-27
DEU,Germany,ARG,Argentina,2009,835,896,-61
DEU,Germany,ARG,Argentina,2010,752,921,-169
DEU,Germany,ARG,Argentina,2011,707,988,-281
DEU,Germany,ARG,Argentina,2012,758,1022,-264
DEU,Germany,ARG,Argentina,2013,740,1083,-343
DEU,Germany,ARG,Argentina,2014,780,1081,-301
DEU,Germany,ARG,Argentina,2015,792,1073,-281
DEU,Germany,ARG,Argentina,2016,750,1160,-410
DEU,Germany,ARG,Argentina,2017,836,1688,-852
HUN,Hungary,ARG,Argentina,2008,0,16,-16
HUN,Hungary,ARG,Argentina,2009,2,20,-18
HUN,Hungary,ARG,Argentina,2010,2,15,-13
HUN,Hungary,ARG,Argentina,2011,7,25,-18
HUN,Hungary,ARG,Argentina,2012,8,32,-24
HUN,Hungary,ARG,Argentina,2013,5,41,-36
HUN,Hungary,ARG,Argentina,2014,8,36,-28
HUN,Hungary,ARG,Argentina,2015,10,21,-11
HUN,Hungary,ARG,Argentina,2016,3,35,-32
HUN,Hungary,ARG,Argentina,2017,0,34,-34
ISL,Iceland,ARG,Argentina,2008,3,2,1
ISL,Iceland,ARG,Argentina,2009,2,2,0
ISL,Iceland,ARG,Argentina,2010,2,5,-3
ISL,Iceland,ARG,Argentina,2011,0,2,-2
ISL,Iceland,ARG,Argentina,2012,3,4,-1
ISL,Iceland,ARG,Argentina,2013,1,1,0
ISL,Iceland,ARG,Argentina,2014,2,3,-1
ISL,Iceland,ARG,Argentina,2015,2,6,-4
ISL,Iceland,ARG,Argentina,2016,2,8,-6
ISL,Iceland,ARG,Argentina,2017,3,5,-2
ITA,Italy,ARG,Argentina,2008,261,1937,-1676
ITA,Italy,ARG,Argentina,2009,330,1434,-1104
ITA,Italy,ARG,Argentina,2010,179,1195,-1016
ITA,Italy,ARG,Argentina,2011,184,942,-758
ITA,Italy,ARG,Argentina,2012,171,742,-571
ITA,Italy,ARG,Argentina,2013,157,731,-574
ITA,Italy,ARG,Argentina,2014,129,706,-577
ITA,Italy,ARG,Argentina,2015,137,854,-717
ITA,Italy,ARG,Argentina,2016,0,987,-987
ITA,Italy,ARG,Argentina,2017,114,1424,-1310
JPN,Japan,ARG,Argentina,2008,463,505,-42
JPN,Japan,ARG,Argentina,2009,508,377,131
JPN,Japan,ARG,Argentina,2010,362,370,-8
JPN,Japan,ARG,Argentina,2011,354,319,35
JPN,Japan,ARG,Argentina,2012,280,317,-37
JPN,Japan,ARG,Argentina,2013,283,334,-51
JPN,Japan,ARG,Argentina,2014,332,409,-77
JPN,Japan,ARG,Argentina,2015,374,421,-47
JPN,Japan,ARG,Argentina,2016,331,407,-76
JPN,Japan,ARG,Argentina,2017,367,444,-77
KOR,Korea,ARG,Argentina,2008,68,86,-18
KOR,Korea,ARG,Argentina,2009,55,76,-21
KOR,Korea,ARG,Argentina,2010,82,106,-24
KOR,Korea,ARG,Argentina,2011,80,112,-32
KOR,Korea,ARG,Argentina,2012,51,90,-39
KOR,Korea,ARG,Argentina,2013,52,65,-13
KOR,Korea,ARG,Argentina,2014,62,76,-14
KOR,Korea,ARG,Argentina,2015,51,50,1
KOR,Korea,ARG,Argentina,2016,44,66,-22
KOR,Korea,ARG,Argentina,2017,54,70,-16
LUX,Luxembourg,ARG,Argentina,2008,1,8,-7
LUX,Luxembourg,ARG,Argentina,2009,2,8,-6
LUX,Luxembourg,ARG,Argentina,2010,3,7,-4
LUX,Luxembourg,ARG,Argentina,2011,3,23,-20
LUX,Luxembourg,ARG,Argentina,2012,6,15,-9
LUX,Luxembourg,ARG,Argentina,2013,8,16,-8
LUX,Luxembourg,ARG,Argentina,2014,7,13,-6
LUX,Luxembourg,ARG,Argentina,2015,3,13,-10
LUX,Luxembourg,ARG,Argentina,2016,11,14,-3
LUX,Luxembourg,ARG,Argentina,2017,16,15,1
MEX,Mexico,ARG,Argentina,2008,0,921,-921
MEX,Mexico,ARG,Argentina,2009,0,1378,-1378
MEX,Mexico,ARG,Argentina,2010,0,1443,-1443
MEX,Mexico,ARG,Argentina,2011,0,990,-990
MEX,Mexico,ARG,Argentina,2012,0,859,-859
MEX,Mexico,ARG,Argentina,2013,0,3232,-3232
MEX,Mexico,ARG,Argentina,2014,0,2142,-2142
MEX,Mexico,ARG,Argentina,2015,0,1428,-1428
MEX,Mexico,ARG,Argentina,2016,0,1408,-1408
MEX,Mexico,ARG,Argentina,2017,0,1003,-1003
NLD,Netherlands,ARG,Argentina,2008,103,162,-59
NLD,Netherlands,ARG,Argentina,2009,67,129,-62
NLD,Netherlands,ARG,Argentina,2010,100,130,-30
NLD,Netherlands,ARG,Argentina,2011,108,135,-27
NLD,Netherlands,ARG,Argentina,2012,100,142,-42
NLD,Netherlands,ARG,Argentina,2013,119,192,-73
NLD,Netherlands,ARG,Argentina,2014,108,186,-78
NLD,Netherlands,ARG,Argentina,2015,123,172,-49
NLD,Netherlands,ARG,Argentina,2016,111,202,-91
NLD,Netherlands,ARG,Argentina,2017,133,238,-105
NZL,New Zealand,ARG,Argentina,2008,80,508,-428
NZL,New Zealand,ARG,Argentina,2009,129,519,-390
NZL,New Zealand,ARG,Argentina,2010,165,423,-258
NZL,New Zealand,ARG,Argentina,2011,149,493,-344
NZL,New Zealand,ARG,Argentina,2012,169,538,-369
NZL,New Zealand,ARG,Argentina,2013,199,624,-425
NZL,New Zealand,ARG,Argentina,2014,231,660,-429
NZL,New Zealand,ARG,Argentina,2015,263,730,-467
NZL,New Zealand,ARG,Argentina,2016,291,686,-395
NZL,New Zealand,ARG,Argentina,2017,440,645,-205
NOR,Norway,ARG,Argentina,2008,11,38,-27
NOR,Norway,ARG,Argentina,2009,15,36,-21
NOR,Norway,ARG,Argentina,2010,28,38,-10
NOR,Norway,ARG,Argentina,2011,23,52,-29
NOR,Norway,ARG,Argentina,2012,22,46,-24
NOR,Norway,ARG,Argentina,2013,17,47,-30
NOR,Norway,ARG,Argentina,2014,18,37,-19
NOR,Norway,ARG,Argentina,2015,27,48,-21
NOR,Norway,ARG,Argentina,2016,39,33,6
NOR,Norway,ARG,Argentina,2017,13,56,-43
POL,Poland,ARG,Argentina,2009,0,28,-28
POL,Poland,ARG,Argentina,2010,0,31,-31
POL,Poland,ARG,Argentina,2011,0,34,-34
POL,Poland,ARG,Argentina,2012,0,50,-50
POL,Poland,ARG,Argentina,2013,0,49,-49
POL,Poland,ARG,Argentina,2014,0,26,-26
POL,Poland,ARG,Argentina,2015,0,67,-67
POL,Poland,ARG,Argentina,2016,0,74,-74
POL,Poland,ARG,Argentina,2017,0,66,-66
SVK,Slovak Republic,ARG,Argentina,2008,0,2,-2
SVK,Slovak Republic,ARG,Argentina,2009,2,3,-1
SVK,Slovak Republic,ARG,Argentina,2010,1,2,-1
SVK,Slovak Republic,ARG,Argentina,2011,1,2,-1
SVK,Slovak Republic,ARG,Argentina,2016,0,1,-1
SVK,Slovak Republic,ARG,Argentina,2017,0,2,-2
ESP,Spain,ARG,Argentina,2008,9363,13363,-4000
ESP,Spain,ARG,Argentina,2009,11034,6676,4358
ESP,Spain,ARG,Argentina,2010,9886,5416,4470
ESP,Spain,ARG,Argentina,2011,9043,4922,4121
ESP,Spain,ARG,Argentina,2012,8094,3602,4492
ESP,Spain,ARG,Argentina,2013,9417,3758,5659
ESP,Spain,ARG,Argentina,2014,4743,4173,570
ESP,Spain,ARG,Argentina,2015,3724,4986,-1262
ESP,Spain,ARG,Argentina,2016,2786,6352,-3566
ESP,Spain,ARG,Argentina,2017,4123,8782,-4659
SWE,Sweden,ARG,Argentina,2008,22,84,-62
SWE,Sweden,ARG,Argentina,2009,22,75,-53
SWE,Sweden,ARG,Argentina,2010,20,67,-47
SWE,Sweden,ARG,Argentina,2011,28,74,-46
SWE,Sweden,ARG,Argentina,2012,29,63,-34
SWE,Sweden,ARG,Argentina,2013,21,72,-51
SWE,Sweden,ARG,Argentina,2014,21,62,-41
SWE,Sweden,ARG,Argentina,2015,30,46,-16
SWE,Sweden,ARG,Argentina,2016,24,62,-38
SWE,Sweden,ARG,Argentina,2017,10,62,-52
CHE,Switzerland,ARG,Argentina,2010,130,239,-109
CHE,Switzerland,ARG,Argentina,2011,107,262,-155
CHE,Switzerland,ARG,Argentina,2012,147,222,-75
CHE,Switzerland,ARG,Argentina,2013,143,215,-72
CHE,Switzerland,ARG,Argentina,2014,132,205,-73
CHE,Switzerland,ARG,Argentina,2015,116,234,-118
CHE,Switzerland,ARG,Argentina,2016,126,172,-46
CHE,Switzerland,ARG,Argentina,2017,114,186,-72
TUR,Turkey,ARG,Argentina,2010,0,11,-11
GBR,United Kingdom,ARG,Argentina,2012,0,1000,-1000
USA,United States,ARG,Argentina,2008,0,5353,-5353
USA,United States,ARG,Argentina,2009,0,5780,-5780
USA,United States,ARG,Argentina,2010,0,4399,-4399
USA,United States,ARG,Argentina,2011,0,4473,-4473
USA,United States,ARG,Argentina,2012,0,4359,-4359
USA,United States,ARG,Argentina,2013,0,4372,-4372
USA,United States,ARG,Argentina,2014,0,3874,-3874
USA,United States,ARG,Argentina,2015,0,3730,-3730
USA,United States,ARG,Argentina,2016,0,4091,-4091
USA,United States,ARG,Argentina,2017,0,3482,-3482
CHL,Chile,ARG,Argentina,2008,0,2710,-2710
CHL,Chile,ARG,Argentina,2009,0,2822,-2822
CHL,Chile,ARG,Argentina,2010,0,2789,-2789
CHL,Chile,ARG,Argentina,2011,0,2814,-2814
CHL,Chile,ARG,Argentina,2012,0,3267,-3267
CHL,Chile,ARG,Argentina,2013,0,4315,-4315
CHL,Chile,ARG,Argentina,2014,0,4506,-4506
CHL,Chile,ARG,Argentina,2015,0,4913,-4913
CHL,Chile,ARG,Argentina,2016,0,4074,-4074
EST,Estonia,ARG,Argentina,2008,0,0,0
EST,Estonia,ARG,Argentina,2009,0,2,-2
EST,Estonia,ARG,Argentina,2010,0,0,0
EST,Estonia,ARG,Argentina,2011,0,0,0
EST,Estonia,ARG,Argentina,2012,0,1,-1
EST,Estonia,ARG,Argentina,2013,0,1,-1
EST,Estonia,ARG,Argentina,2014,0,4,-4
EST,Estonia,ARG,Argentina,2015,0,4,-4
EST,Estonia,ARG,Argentina,2016,0,4,-4
EST,Estonia,ARG,Argentina,2017,0,5,-5
ISR,Israel,ARG,Argentina,2008,0,188,-188
ISR,Israel,ARG,Argentina,2009,0,284,-284
ISR,Israel,ARG,Argentina,2010,0,337,-337
ISR,Israel,ARG,Argentina,2011,0,220,-220
ISR,Israel,ARG,Argentina,2012,0,222,-222
ISR,Israel,ARG,Argentina,2013,0,255,-255
ISR,Israel,ARG,Argentina,2014,0,271,-271
ISR,Israel,ARG,Argentina,2015,0,262,-262
ISR,Israel,ARG,Argentina,2016,0,255,-255
ISR,Israel,ARG,Argentina,2017,0,246,-246
SVN,Slovenia,ARG,Argentina,2008,0,5,-5
SVN,Slovenia,ARG,Argentina,2009,0,10,-10
SVN,Slovenia,ARG,Argentina,2010,0,7,-7
SVN,Slovenia,ARG,Argentina,2011,0,4,-4
SVN,Slovenia,ARG,Argentina,2013,2,4,-2
SVN,Slovenia,ARG,Argentina,2014,0,1,-1
SVN,Slovenia,ARG,Argentina,2015,1,2,-1
SVN,Slovenia,ARG,Argentina,2016,1,1,0
SVN,Slovenia,ARG,Argentina,2017,0,10,-10
AUS,Australia,ARM,Armenia,2008,5,30,-25
AUS,Australia,ARM,Armenia,2009,13,52,-39
AUS,Australia,ARM,Armenia,2010,5,24,-19
AUS,Australia,ARM,Armenia,2011,11,26,-15
AUS,Australia,ARM,Armenia,2012,0,35,-35
AUS,Australia,ARM,Armenia,2013,10,27,-17
AUS,Australia,ARM,Armenia,2014,8,37,-29
AUS,Australia,ARM,Armenia,2015,0,30,-30
AUS,Australia,ARM,Armenia,2016,0,18,-18
AUS,Australia,ARM,Armenia,2017,0,33,-33
AUT,Austria,ARM,Armenia,2008,179,275,-96
AUT,Austria,ARM,Armenia,2009,181,241,-60
AUT,Austria,ARM,Armenia,2010,263,194,69
AUT,Austria,ARM,Armenia,2011,212,172,40
AUT,Austria,ARM,Armenia,2012,148,318,-170
AUT,Austria,ARM,Armenia,2013,130,284,-154
AUT,Austria,ARM,Armenia,2014,72,344,-272
AUT,Austria,ARM,Armenia,2015,120,309,-189
AUT,Austria,ARM,Armenia,2016,126,303,-177
AUT,Austria,ARM,Armenia,2017,285,246,39
BEL,Belgium,ARM,Armenia,2008,0,177,-177
BEL,Belgium,ARM,Armenia,2009,0,228,-228
BEL,Belgium,ARM,Armenia,2010,26,283,-257
BEL,Belgium,ARM,Armenia,2011,0,269,-269
BEL,Belgium,ARM,Armenia,2012,558,453,105
BEL,Belgium,ARM,Armenia,2013,628,391,237
BEL,Belgium,ARM,Armenia,2014,764,309,455
BEL,Belgium,ARM,Armenia,2015,497,342,155
BEL,Belgium,ARM,Armenia,2016,211,332,-121
BEL,Belgium,ARM,Armenia,2017,172,365,-193
CAN,Canada,ARM,Armenia,2008,0,205,-205
CAN,Canada,ARM,Armenia,2009,0,267,-267
CAN,Canada,ARM,Armenia,2010,0,252,-252
CAN,Canada,ARM,Armenia,2011,0,236,-236
CAN,Canada,ARM,Armenia,2012,0,258,-258
CAN,Canada,ARM,Armenia,2013,0,208,-208
CAN,Canada,ARM,Armenia,2014,0,205,-205
CAN,Canada,ARM,Armenia,2015,0,302,-302
CAN,Canada,ARM,Armenia,2016,0,350,-350
CAN,Canada,ARM,Armenia,2017,0,255,-255
CZE,Czech Republic,ARM,Armenia,2008,4,380,-376
CZE,Czech Republic,ARM,Armenia,2009,0,220,-220
CZE,Czech Republic,ARM,Armenia,2010,2,183,-181
CZE,Czech Republic,ARM,Armenia,2011,1,76,-75
CZE,Czech Republic,ARM,Armenia,2012,98,96,2
CZE,Czech Republic,ARM,Armenia,2013,127,69,58
CZE,Czech Republic,ARM,Armenia,2014,121,116,5
CZE,Czech Republic,ARM,Armenia,2015,88,101,-13
CZE,Czech Republic,ARM,Armenia,2016,84,108,-24
CZE,Czech Republic,ARM,Armenia,2017,67,141,-74
DNK,Denmark,ARM,Armenia,2008,0,21,-21
DNK,Denmark,ARM,Armenia,2009,1,18,-17
DNK,Denmark,ARM,Armenia,2010,6,18,-12
DNK,Denmark,ARM,Armenia,2011,5,31,-26
DNK,Denmark,ARM,Armenia,2012,2,19,-17
DNK,Denmark,ARM,Armenia,2013,4,40,-36
DNK,Denmark,ARM,Armenia,2014,6,31,-25
DNK,Denmark,ARM,Armenia,2015,2,23,-21
DNK,Denmark,ARM,Armenia,2016,11,23,-12
DNK,Denmark,ARM,Armenia,2017,7,22,-15
FIN,Finland,ARM,Armenia,2008,1,7,-6
FIN,Finland,ARM,Armenia,2009,0,19,-19
FIN,Finland,ARM,Armenia,2010,3,6,-3
FIN,Finland,ARM,Armenia,2011,0,9,-9
FIN,Finland,ARM,Armenia,2012,2,4,-2
FIN,Finland,ARM,Armenia,2013,1,10,-9
FIN,Finland,ARM,Armenia,2014,3,6,-3
FIN,Finland,ARM,Armenia,2015,0,10,-10
FIN,Finland,ARM,Armenia,2016,0,13,-13
FIN,Finland,ARM,Armenia,2017,1,6,-5
FRA,France,ARM,Armenia,2008,0,1129,-1129
FRA,France,ARM,Armenia,2009,0,1357,-1357
FRA,France,ARM,Armenia,2010,0,1280,-1280
FRA,France,ARM,Armenia,2011,0,1354,-1354
FRA,France,ARM,Armenia,2012,0,1469,-1469
FRA,France,ARM,Armenia,2013,0,1735,-1735
FRA,France,ARM,Armenia,2014,0,1666,-1666
FRA,France,ARM,Armenia,2015,0,1581,-1581
FRA,France,ARM,Armenia,2016,0,1706,-1706
FRA,France,ARM,Armenia,2017,0,1742,-1742
DEU,Germany,ARM,Armenia,2008,858,610,248
DEU,Germany,ARM,Armenia,2009,649,802,-153
DEU,Germany,ARM,Armenia,2010,611,920,-309
DEU,Germany,ARM,Armenia,2011,554,1060,-506
DEU,Germany,ARM,Armenia,2012,523,1496,-973
DEU,Germany,ARM,Armenia,2013,557,2066,-1509
DEU,Germany,ARM,Armenia,2014,767,3174,-2407
DEU,Germany,ARM,Armenia,2015,978,4259,-3281
DEU,Germany,ARM,Armenia,2016,1248,4940,-3692
DEU,Germany,ARM,Armenia,2017,2081,3947,-1866
HUN,Hungary,ARM,Armenia,2008,1,9,-8
HUN,Hungary,ARM,Armenia,2009,2,22,-20
HUN,Hungary,ARM,Armenia,2010,3,17,-14
HUN,Hungary,ARM,Armenia,2011,5,21,-16
HUN,Hungary,ARM,Armenia,2012,4,15,-11
HUN,Hungary,ARM,Armenia,2013,0,12,-12
HUN,Hungary,ARM,Armenia,2014,5,21,-16
HUN,Hungary,ARM,Armenia,2015,3,19,-16
HUN,Hungary,ARM,Armenia,2016,6,34,-28
HUN,Hungary,ARM,Armenia,2017,0,49,-49
ISL,Iceland,ARM,Armenia,2008,0,1,-1
ISL,Iceland,ARM,Armenia,2009,2,0,2
ISL,Iceland,ARM,Armenia,2010,0,0,0
ISL,Iceland,ARM,Armenia,2011,0,0,0
ISL,Iceland,ARM,Armenia,2012,0,0,0
ISL,Iceland,ARM,Armenia,2013,0,1,-1
ISL,Iceland,ARM,Armenia,2014,0,2,-2
ISL,Iceland,ARM,Armenia,2015,0,0,0
ISL,Iceland,ARM,Armenia,2016,0,0,0
ISL,Iceland,ARM,Armenia,2017,1,1,0
ITA,Italy,ARM,Armenia,2008,1,135,-134
ITA,Italy,ARM,Armenia,2009,1,109,-108
ITA,Italy,ARM,Armenia,2010,8,131,-123
ITA,Italy,ARM,Armenia,2011,7,139,-132
ITA,Italy,ARM,Armenia,2012,11,119,-108
ITA,Italy,ARM,Armenia,2013,5,137,-132
ITA,Italy,ARM,Armenia,2014,13,126,-113
ITA,Italy,ARM,Armenia,2015,7,127,-120
ITA,Italy,ARM,Armenia,2016,0,120,-120
ITA,Italy,ARM,Armenia,2017,13,163,-150
JPN,Japan,ARM,Armenia,2008,137,140,-3
JPN,Japan,ARM,Armenia,2009,72,71,1
JPN,Japan,ARM,Armenia,2010,56,65,-9
JPN,Japan,ARM,Armenia,2011,68,71,-3
JPN,Japan,ARM,Armenia,2012,139,146,-7
JPN,Japan,ARM,Armenia,2013,60,69,-9
JPN,Japan,ARM,Armenia,2014,37,38,-1
JPN,Japan,ARM,Armenia,2015,64,75,-11
JPN,Japan,ARM,Armenia,2016,69,71,-2
JPN,Japan,ARM,Armenia,2017,76,81,-5
KOR,Korea,ARM,Armenia,2008,14,12,2
KOR,Korea,ARM,Armenia,2009,13,16,-3
KOR,Korea,ARM,Armenia,2010,17,18,-1
KOR,Korea,ARM,Armenia,2011,19,32,-13
KOR,Korea,ARM,Armenia,2012,34,28,6
KOR,Korea,ARM,Armenia,2013,23,22,1
KOR,Korea,ARM,Armenia,2014,26,25,1
KOR,Korea,ARM,Armenia,2015,24,19,5
KOR,Korea,ARM,Armenia,2016,20,20,0
KOR,Korea,ARM,Armenia,2017,30,18,12
LUX,Luxembourg,ARM,Armenia,2008,1,6,-5
LUX,Luxembourg,ARM,Armenia,2009,1,2,-1
LUX,Luxembourg,ARM,Armenia,2010,0,5,-5
LUX,Luxembourg,ARM,Armenia,2011,3,6,-3
LUX,Luxembourg,ARM,Armenia,2012,0,9,-9
LUX,Luxembourg,ARM,Armenia,2013,1,9,-8
LUX,Luxembourg,ARM,Armenia,2014,0,10,-10
LUX,Luxembourg,ARM,Armenia,2015,2,12,-10
LUX,Luxembourg,ARM,Armenia,2016,5,14,-9
LUX,Luxembourg,ARM,Armenia,2017,5,21,-16
MEX,Mexico,ARM,Armenia,2008,0,13,-13
MEX,Mexico,ARM,Armenia,2009,0,18,-18
MEX,Mexico,ARM,Armenia,2010,0,11,-11
MEX,Mexico,ARM,Armenia,2011,0,5,-5
MEX,Mexico,ARM,Armenia,2012,0,9,-9
MEX,Mexico,ARM,Armenia,2013,0,39,-39
MEX,Mexico,ARM,Armenia,2014,0,16,-16
MEX,Mexico,ARM,Armenia,2015,0,9,-9
MEX,Mexico,ARM,Armenia,2016,0,12,-12
MEX,Mexico,ARM,Armenia,2017,0,8,-8
NLD,Netherlands,ARM,Armenia,2008,12,69,-57
NLD,Netherlands,ARM,Armenia,2009,16,72,-56
NLD,Netherlands,ARM,Armenia,2010,18,105,-87
NLD,Netherlands,ARM,Armenia,2011,34,111,-77
NLD,Netherlands,ARM,Armenia,2012,30,122,-92
NLD,Netherlands,ARM,Armenia,2013,34,117,-83
NLD,Netherlands,ARM,Armenia,2014,28,171,-143
NLD,Netherlands,ARM,Armenia,2015,47,134,-87
NLD,Netherlands,ARM,Armenia,2016,48,137,-89
NLD,Netherlands,ARM,Armenia,2017,52,114,-62
NZL,New Zealand,ARM,Armenia,2008,0,6,-6
NZL,New Zealand,ARM,Armenia,2010,0,1,-1
NZL,New Zealand,ARM,Armenia,2012,0,4,-4
NZL,New Zealand,ARM,Armenia,2013,0,2,-2
NZL,New Zealand,ARM,Armenia,2014,0,6,-6
NZL,New Zealand,ARM,Armenia,2015,1,8,-7
NZL,New Zealand,ARM,Armenia,2016,0,6,-6
NZL,New Zealand,ARM,Armenia,2017,0,5,-5
NOR,Norway,ARM,Armenia,2008,4,16,-12
NOR,Norway,ARM,Armenia,2009,0,0,0
NOR,Norway,ARM,Armenia,2010,0,0,0
NOR,Norway,ARM,Armenia,2011,0,0,0
NOR,Norway,ARM,Armenia,2012,0,0,0
NOR,Norway,ARM,Armenia,2013,0,0,0
NOR,Norway,ARM,Armenia,2014,0,0,0
NOR,Norway,ARM,Armenia,2015,0,0,0
NOR,Norway,ARM,Armenia,2016,0,0,0
NOR,Norway,ARM,Armenia,2017,5,11,-6
POL,Poland,ARM,Armenia,2008,0,1604,-1604
POL,Poland,ARM,Armenia,2009,0,1559,-1559
POL,Poland,ARM,Armenia,2010,0,1397,-1397
POL,Poland,ARM,Armenia,2011,0,1181,-1181
POL,Poland,ARM,Armenia,2012,0,1624,-1624
POL,Poland,ARM,Armenia,2013,0,1090,-1090
POL,Poland,ARM,Armenia,2014,0,889,-889
POL,Poland,ARM,Armenia,2015,0,1206,-1206
POL,Poland,ARM,Armenia,2016,0,970,-970
POL,Poland,ARM,Armenia,2017,0,761,-761
SVK,Slovak Republic,ARM,Armenia,2008,9,1,8
SVK,Slovak Republic,ARM,Armenia,2009,14,6,8
SVK,Slovak Republic,ARM,Armenia,2010,6,2,4
SVK,Slovak Republic,ARM,Armenia,2011,2,1,1
SVK,Slovak Republic,ARM,Armenia,2012,0,1,-1
SVK,Slovak Republic,ARM,Armenia,2013,0,1,-1
SVK,Slovak Republic,ARM,Armenia,2014,0,1,-1
SVK,Slovak Republic,ARM,Armenia,2015,0,2,-2
SVK,Slovak Republic,ARM,Armenia,2016,0,1,-1
ESP,Spain,ARM,Armenia,2008,804,1073,-269
ESP,Spain,ARM,Armenia,2009,878,624,254
ESP,Spain,ARM,Armenia,2010,749,547,202
ESP,Spain,ARM,Armenia,2011,769,710,59
ESP,Spain,ARM,Armenia,2012,613,578,35
ESP,Spain,ARM,Armenia,2013,758,565,193
ESP,Spain,ARM,Armenia,2014,351,669,-318
ESP,Spain,ARM,Armenia,2015,359,661,-302
ESP,Spain,ARM,Armenia,2016,286,829,-543
ESP,Spain,ARM,Armenia,2017,370,898,-528
SWE,Sweden,ARM,Armenia,2008,8,97,-89
SWE,Sweden,ARM,Armenia,2009,6,177,-171
SWE,Sweden,ARM,Armenia,2010,7,174,-167
SWE,Sweden,ARM,Armenia,2011,10,217,-207
SWE,Sweden,ARM,Armenia,2012,20,246,-226
SWE,Sweden,ARM,Armenia,2013,17,190,-173
SWE,Sweden,ARM,Armenia,2014,25,206,-181
SWE,Sweden,ARM,Armenia,2015,21,249,-228
SWE,Sweden,ARM,Armenia,2016,13,175,-162
SWE,Sweden,ARM,Armenia,2017,20,216,-196
CHE,Switzerland,ARM,Armenia,2010,15,56,-41
CHE,Switzerland,ARM,Armenia,2011,13,81,-68
CHE,Switzerland,ARM,Armenia,2012,27,74,-47
CHE,Switzerland,ARM,Armenia,2013,20,58,-38
CHE,Switzerland,ARM,Armenia,2014,17,57,-40
CHE,Switzerland,ARM,Armenia,2015,15,51,-36
CHE,Switzerland,ARM,Armenia,2016,27,67,-40
CHE,Switzerland,ARM,Armenia,2017,14,51,-37
TUR,Turkey,ARM,Armenia,2010,0,50,-50
TUR,Turkey,ARM,Armenia,2016,243,466,-223
TUR,Turkey,ARM,Armenia,2017,255,684,-429
GBR,United Kingdom,ARM,Armenia,2012,0,1000,-1000
USA,United States,ARM,Armenia,2008,0,3586,-3586
USA,United States,ARM,Armenia,2009,0,3442,-3442
USA,United States,ARM,Armenia,2010,0,2979,-2979
USA,United States,ARM,Armenia,2011,0,2983,-2983
USA,United States,ARM,Armenia,2012,0,2681,-2681
USA,United States,ARM,Armenia,2013,0,2722,-2722
USA,United States,ARM,Armenia,2014,0,2913,-2913
USA,United States,ARM,Armenia,2015,0,2962,-2962
USA,United States,ARM,Armenia,2016,0,3543,-3543
USA,United States,ARM,Armenia,2017,0,3437,-3437
CHL,Chile,ARM,Armenia,2008,0,1,-1
CHL,Chile,ARM,Armenia,2009,0,2,-2
CHL,Chile,ARM,Armenia,2010,0,0,0
CHL,Chile,ARM,Armenia,2011,0,2,-2
CHL,Chile,ARM,Armenia,2012,0,1,-1
CHL,Chile,ARM,Armenia,2013,0,0,0
CHL,Chile,ARM,Armenia,2014,0,2,-2
CHL,Chile,ARM,Armenia,2015,0,1,-1
CHL,Chile,ARM,Armenia,2016,0,2,-2
EST,Estonia,ARM,Armenia,2008,0,13,-13
EST,Estonia,ARM,Armenia,2009,0,9,-9
EST,Estonia,ARM,Armenia,2010,0,6,-6
EST,Estonia,ARM,Armenia,2011,0,8,-8
EST,Estonia,ARM,Armenia,2012,0,5,-5
EST,Estonia,ARM,Armenia,2013,0,12,-12
EST,Estonia,ARM,Armenia,2014,0,3,-3
EST,Estonia,ARM,Armenia,2015,0,18,-18
EST,Estonia,ARM,Armenia,2016,0,18,-18
EST,Estonia,ARM,Armenia,2017,0,15,-15
SVN,Slovenia,ARM,Armenia,2008,0,2,-2
SVN,Slovenia,ARM,Armenia,2009,0,2,-2
SVN,Slovenia,ARM,Armenia,2010,0,1,-1
SVN,Slovenia,ARM,Armenia,2011,4,4,0
SVN,Slovenia,ARM,Armenia,2012,0,4,-4
SVN,Slovenia,ARM,Armenia,2013,1,2,-1
SVN,Slovenia,ARM,Armenia,2014,0,3,-3
SVN,Slovenia,ARM,Armenia,2015,0,3,-3
SVN,Slovenia,ARM,Armenia,2016,0,4,-4
SVN,Slovenia,ARM,Armenia,2017,0,1,-1
LUX,Luxembourg,AUS,Australia,2016,0,23,-23
AUS,Australia,AZE,Azerbaijan,2008,0,16,-16
AUS,Australia,AZE,Azerbaijan,2009,0,19,-19
AUS,Australia,AZE,Azerbaijan,2010,0,13,-13
AUS,Australia,AZE,Azerbaijan,2011,5,21,-16
AUS,Australia,AZE,Azerbaijan,2012,0,25,-25
AUS,Australia,AZE,Azerbaijan,2013,0,35,-35
AUS,Australia,AZE,Azerbaijan,2014,8,19,-11
AUS,Australia,AZE,Azerbaijan,2015,0,19,-19
AUS,Australia,AZE,Azerbaijan,2016,0,11,-11
AUS,Australia,AZE,Azerbaijan,2017,0,21,-21
AUT,Austria,AZE,Azerbaijan,2008,37,125,-88
AUT,Austria,AZE,Azerbaijan,2009,78,142,-64
AUT,Austria,AZE,Azerbaijan,2010,76,89,-13
AUT,Austria,AZE,Azerbaijan,2011,69,108,-39
AUT,Austria,AZE,Azerbaijan,2012,79,174,-95
AUT,Austria,AZE,Azerbaijan,2013,88,160,-72
AUT,Austria,AZE,Azerbaijan,2014,78,156,-78
AUT,Austria,AZE,Azerbaijan,2015,77,131,-54
AUT,Austria,AZE,Azerbaijan,2016,90,139,-49
AUT,Austria,AZE,Azerbaijan,2017,91,152,-61
BEL,Belgium,AZE,Azerbaijan,2008,0,23,-23
BEL,Belgium,AZE,Azerbaijan,2009,0,28,-28
BEL,Belgium,AZE,Azerbaijan,2010,11,48,-37
BEL,Belgium,AZE,Azerbaijan,2011,0,33,-33
BEL,Belgium,AZE,Azerbaijan,2012,51,139,-88
BEL,Belgium,AZE,Azerbaijan,2013,133,87,46
BEL,Belgium,AZE,Azerbaijan,2014,108,43,65
BEL,Belgium,AZE,Azerbaijan,2015,73,57,16
BEL,Belgium,AZE,Azerbaijan,2016,31,73,-42
BEL,Belgium,AZE,Azerbaijan,2017,34,63,-29
CAN,Canada,AZE,Azerbaijan,2008,0,125,-125
CAN,Canada,AZE,Azerbaijan,2009,0,165,-165
CAN,Canada,AZE,Azerbaijan,2010,0,209,-209
CAN,Canada,AZE,Azerbaijan,2011,0,137,-137
CAN,Canada,AZE,Azerbaijan,2012,0,160,-160
CAN,Canada,AZE,Azerbaijan,2013,0,57,-57
CAN,Canada,AZE,Azerbaijan,2014,0,63,-63
CAN,Canada,AZE,Azerbaijan,2015,0,112,-112
CAN,Canada,AZE,Azerbaijan,2016,0,115,-115
CAN,Canada,AZE,Azerbaijan,2017,0,120,-120
CZE,Czech Republic,AZE,Azerbaijan,2008,1,107,-106
CZE,Czech Republic,AZE,Azerbaijan,2009,0,168,-168
CZE,Czech Republic,AZE,Azerbaijan,2010,0,192,-192
CZE,Czech Republic,AZE,Azerbaijan,2011,0,115,-115
CZE,Czech Republic,AZE,Azerbaijan,2012,63,155,-92
CZE,Czech Republic,AZE,Azerbaijan,2013,116,120,-4
CZE,Czech Republic,AZE,Azerbaijan,2014,71,145,-74
CZE,Czech Republic,AZE,Azerbaijan,2015,83,111,-28
CZE,Czech Republic,AZE,Azerbaijan,2016,73,117,-44
CZE,Czech Republic,AZE,Azerbaijan,2017,72,173,-101
DNK,Denmark,AZE,Azerbaijan,2008,1,19,-18
DNK,Denmark,AZE,Azerbaijan,2009,2,16,-14
DNK,Denmark,AZE,Azerbaijan,2010,4,18,-14
DNK,Denmark,AZE,Azerbaijan,2011,5,13,-8
DNK,Denmark,AZE,Azerbaijan,2012,3,10,-7
DNK,Denmark,AZE,Azerbaijan,2013,1,20,-19
DNK,Denmark,AZE,Azerbaijan,2014,4,11,-7
DNK,Denmark,AZE,Azerbaijan,2015,5,11,-6
DNK,Denmark,AZE,Azerbaijan,2016,14,13,1
DNK,Denmark,AZE,Azerbaijan,2017,3,24,-21
FIN,Finland,AZE,Azerbaijan,2008,2,12,-10
FIN,Finland,AZE,Azerbaijan,2009,0,8,-8
FIN,Finland,AZE,Azerbaijan,2010,1,6,-5
FIN,Finland,AZE,Azerbaijan,2011,0,20,-20
FIN,Finland,AZE,Azerbaijan,2012,2,17,-15
FIN,Finland,AZE,Azerbaijan,2013,6,8,-2
FIN,Finland,AZE,Azerbaijan,2014,2,10,-8
FIN,Finland,AZE,Azerbaijan,2015,0,16,-16
FIN,Finland,AZE,Azerbaijan,2016,2,40,-38
FIN,Finland,AZE,Azerbaijan,2017,3,17,-14
FRA,France,AZE,Azerbaijan,2008,0,423,-423
FRA,France,AZE,Azerbaijan,2009,0,389,-389
FRA,France,AZE,Azerbaijan,2010,0,318,-318
FRA,France,AZE,Azerbaijan,2011,0,362,-362
FRA,France,AZE,Azerbaijan,2012,0,337,-337
FRA,France,AZE,Azerbaijan,2013,0,301,-301
FRA,France,AZE,Azerbaijan,2014,0,307,-307
FRA,France,AZE,Azerbaijan,2015,0,272,-272
FRA,France,AZE,Azerbaijan,2016,0,276,-276
FRA,France,AZE,Azerbaijan,2017,0,251,-251
DEU,Germany,AZE,Azerbaijan,2008,950,831,119
DEU,Germany,AZE,Azerbaijan,2009,844,1193,-349
DEU,Germany,AZE,Azerbaijan,2010,803,1081,-278
DEU,Germany,AZE,Azerbaijan,2011,607,1350,-743
DEU,Germany,AZE,Azerbaijan,2012,686,1360,-674
DEU,Germany,AZE,Azerbaijan,2013,679,1705,-1026
DEU,Germany,AZE,Azerbaijan,2014,844,2196,-1352
DEU,Germany,AZE,Azerbaijan,2015,912,3154,-2242
DEU,Germany,AZE,Azerbaijan,2016,1194,3985,-2791
DEU,Germany,AZE,Azerbaijan,2017,1760,3765,-2005
HUN,Hungary,AZE,Azerbaijan,2008,1,32,-31
HUN,Hungary,AZE,Azerbaijan,2009,0,24,-24
HUN,Hungary,AZE,Azerbaijan,2010,4,32,-28
HUN,Hungary,AZE,Azerbaijan,2011,4,31,-27
HUN,Hungary,AZE,Azerbaijan,2012,15,35,-20
HUN,Hungary,AZE,Azerbaijan,2013,1,45,-44
HUN,Hungary,AZE,Azerbaijan,2014,0,83,-83
HUN,Hungary,AZE,Azerbaijan,2015,8,75,-67
HUN,Hungary,AZE,Azerbaijan,2016,15,200,-185
HUN,Hungary,AZE,Azerbaijan,2017,0,218,-218
ISL,Iceland,AZE,Azerbaijan,2008,0,0,0
ISL,Iceland,AZE,Azerbaijan,2009,0,0,0
ISL,Iceland,AZE,Azerbaijan,2010,0,0,0
ISL,Iceland,AZE,Azerbaijan,2011,0,0,0
ISL,Iceland,AZE,Azerbaijan,2012,0,0,0
ISL,Iceland,AZE,Azerbaijan,2013,0,1,-1
ISL,Iceland,AZE,Azerbaijan,2014,0,1,-1
ISL,Iceland,AZE,Azerbaijan,2015,0,0,0
ISL,Iceland,AZE,Azerbaijan,2016,1,4,-3
ISL,Iceland,AZE,Azerbaijan,2017,0,0,0
ITA,Italy,AZE,Azerbaijan,2008,0,34,-34
ITA,Italy,AZE,Azerbaijan,2009,0,38,-38
ITA,Italy,AZE,Azerbaijan,2010,3,42,-39
ITA,Italy,AZE,Azerbaijan,2011,1,41,-40
ITA,Italy,AZE,Azerbaijan,2012,2,35,-33
ITA,Italy,AZE,Azerbaijan,2013,4,40,-36
ITA,Italy,AZE,Azerbaijan,2014,5,17,-12
ITA,Italy,AZE,Azerbaijan,2015,1,38,-37
ITA,Italy,AZE,Azerbaijan,2016,0,44,-44
ITA,Italy,AZE,Azerbaijan,2017,4,53,-49
JPN,Japan,AZE,Azerbaijan,2008,80,79,1
JPN,Japan,AZE,Azerbaijan,2009,74,83,-9
JPN,Japan,AZE,Azerbaijan,2010,75,91,-16
JPN,Japan,AZE,Azerbaijan,2011,61,64,-3
JPN,Japan,AZE,Azerbaijan,2012,83,86,-3
JPN,Japan,AZE,Azerbaijan,2013,68,78,-10
JPN,Japan,AZE,Azerbaijan,2014,86,94,-8
JPN,Japan,AZE,Azerbaijan,2015,83,86,-3
JPN,Japan,AZE,Azerbaijan,2016,115,136,-21
JPN,Japan,AZE,Azerbaijan,2017,88,108,-20
KOR,Korea,AZE,Azerbaijan,2008,12,46,-34
KOR,Korea,AZE,Azerbaijan,2009,11,40,-29
KOR,Korea,AZE,Azerbaijan,2010,28,45,-17
KOR,Korea,AZE,Azerbaijan,2011,38,42,-4
KOR,Korea,AZE,Azerbaijan,2012,46,41,5
KOR,Korea,AZE,Azerbaijan,2013,44,46,-2
KOR,Korea,AZE,Azerbaijan,2014,37,39,-2
KOR,Korea,AZE,Azerbaijan,2015,55,41,14
KOR,Korea,AZE,Azerbaijan,2016,51,56,-5
KOR,Korea,AZE,Azerbaijan,2017,46,83,-37
LUX,Luxembourg,AZE,Azerbaijan,2008,0,2,-2
LUX,Luxembourg,AZE,Azerbaijan,2009,0,14,-14
LUX,Luxembourg,AZE,Azerbaijan,2010,5,6,-1
LUX,Luxembourg,AZE,Azerbaijan,2011,0,18,-18
LUX,Luxembourg,AZE,Azerbaijan,2012,1,17,-16
LUX,Luxembourg,AZE,Azerbaijan,2013,5,13,-8
LUX,Luxembourg,AZE,Azerbaijan,2014,6,7,-1
LUX,Luxembourg,AZE,Azerbaijan,2015,4,13,-9
LUX,Luxembourg,AZE,Azerbaijan,2016,1,25,-24
LUX,Luxembourg,AZE,Azerbaijan,2017,3,45,-42
MEX,Mexico,AZE,Azerbaijan,2008,0,3,-3
MEX,Mexico,AZE,Azerbaijan,2009,0,2,-2
MEX,Mexico,AZE,Azerbaijan,2012,0,1,-1
MEX,Mexico,AZE,Azerbaijan,2013,0,5,-5
MEX,Mexico,AZE,Azerbaijan,2014,0,0,0
MEX,Mexico,AZE,Azerbaijan,2016,0,2,-2
NLD,Netherlands,AZE,Azerbaijan,2009,13,50,-37
NLD,Netherlands,AZE,Azerbaijan,2010,19,67,-48
NLD,Netherlands,AZE,Azerbaijan,2011,23,68,-45
NLD,Netherlands,AZE,Azerbaijan,2012,30,59,-29
NLD,Netherlands,AZE,Azerbaijan,2013,31,76,-45
NLD,Netherlands,AZE,Azerbaijan,2014,42,119,-77
NLD,Netherlands,AZE,Azerbaijan,2015,47,100,-53
NLD,Netherlands,AZE,Azerbaijan,2016,72,144,-72
NLD,Netherlands,AZE,Azerbaijan,2017,56,127,-71
NZL,New Zealand,AZE,Azerbaijan,2008,1,2,-1
NZL,New Zealand,AZE,Azerbaijan,2009,0,1,-1
NZL,New Zealand,AZE,Azerbaijan,2010,2,4,-2
NZL,New Zealand,AZE,Azerbaijan,2011,0,2,-2
NZL,New Zealand,AZE,Azerbaijan,2012,0,2,-2
NZL,New Zealand,AZE,Azerbaijan,2013,0,4,-4
NZL,New Zealand,AZE,Azerbaijan,2014,1,1,0
NZL,New Zealand,AZE,Azerbaijan,2015,2,2,0
NZL,New Zealand,AZE,Azerbaijan,2017,1,2,-1
NOR,Norway,AZE,Azerbaijan,2008,9,58,-49
NOR,Norway,AZE,Azerbaijan,2009,10,37,-27
NOR,Norway,AZE,Azerbaijan,2010,18,53,-35
NOR,Norway,AZE,Azerbaijan,2011,21,62,-41
NOR,Norway,AZE,Azerbaijan,2012,32,71,-39
NOR,Norway,AZE,Azerbaijan,2013,45,39,6
NOR,Norway,AZE,Azerbaijan,2014,29,31,-2
NOR,Norway,AZE,Azerbaijan,2015,29,39,-10
NOR,Norway,AZE,Azerbaijan,2016,13,28,-15
NOR,Norway,AZE,Azerbaijan,2017,14,20,-6
POL,Poland,AZE,Azerbaijan,2008,0,85,-85
POL,Poland,AZE,Azerbaijan,2009,0,71,-71
POL,Poland,AZE,Azerbaijan,2010,0,75,-75
POL,Poland,AZE,Azerbaijan,2011,0,95,-95
POL,Poland,AZE,Azerbaijan,2012,0,114,-114
POL,Poland,AZE,Azerbaijan,2013,0,158,-158
POL,Poland,AZE,Azerbaijan,2014,0,88,-88
POL,Poland,AZE,Azerbaijan,2015,0,303,-303
POL,Poland,AZE,Azerbaijan,2016,0,498,-498
POL,Poland,AZE,Azerbaijan,2017,0,434,-434
SVK,Slovak Republic,AZE,Azerbaijan,2008,0,4,-4
SVK,Slovak Republic,AZE,Azerbaijan,2009,0,3,-3
SVK,Slovak Republic,AZE,Azerbaijan,2010,3,3,0
SVK,Slovak Republic,AZE,Azerbaijan,2011,0,3,-3
SVK,Slovak Republic,AZE,Azerbaijan,2014,0,1,-1
SVK,Slovak Republic,AZE,Azerbaijan,2015,0,3,-3
SVK,Slovak Republic,AZE,Azerbaijan,2016,0,1,-1
ESP,Spain,AZE,Azerbaijan,2008,21,66,-45
ESP,Spain,AZE,Azerbaijan,2009,25,34,-9
ESP,Spain,AZE,Azerbaijan,2010,23,38,-15
ESP,Spain,AZE,Azerbaijan,2011,25,46,-21
ESP,Spain,AZE,Azerbaijan,2012,32,79,-47
ESP,Spain,AZE,Azerbaijan,2013,51,75,-24
ESP,Spain,AZE,Azerbaijan,2014,32,91,-59
ESP,Spain,AZE,Azerbaijan,2015,28,101,-73
ESP,Spain,AZE,Azerbaijan,2016,37,122,-85
ESP,Spain,AZE,Azerbaijan,2017,66,122,-56
SWE,Sweden,AZE,Azerbaijan,2008,7,114,-107
SWE,Sweden,AZE,Azerbaijan,2009,5,176,-171
SWE,Sweden,AZE,Azerbaijan,2010,10,228,-218
SWE,Sweden,AZE,Azerbaijan,2011,21,250,-229
SWE,Sweden,AZE,Azerbaijan,2012,23,247,-224
SWE,Sweden,AZE,Azerbaijan,2013,30,196,-166
SWE,Sweden,AZE,Azerbaijan,2014,36,193,-157
SWE,Sweden,AZE,Azerbaijan,2015,50,179,-129
SWE,Sweden,AZE,Azerbaijan,2016,21,238,-217
SWE,Sweden,AZE,Azerbaijan,2017,19,154,-135
CHE,Switzerland,AZE,Azerbaijan,2010,24,75,-51
CHE,Switzerland,AZE,Azerbaijan,2011,24,109,-85
CHE,Switzerland,AZE,Azerbaijan,2012,46,88,-42
CHE,Switzerland,AZE,Azerbaijan,2013,46,101,-55
CHE,Switzerland,AZE,Azerbaijan,2014,48,116,-68
CHE,Switzerland,AZE,Azerbaijan,2015,71,98,-27
CHE,Switzerland,AZE,Azerbaijan,2016,47,74,-27
CHE,Switzerland,AZE,Azerbaijan,2017,46,53,-7
TUR,Turkey,AZE,Azerbaijan,2010,0,2501,-2501
TUR,Turkey,AZE,Azerbaijan,2016,4290,15284,-10994
TUR,Turkey,AZE,Azerbaijan,2017,10555,20865,-10310
GBR,United Kingdom,AZE,Azerbaijan,2014,0,1000,-1000
USA,United States,AZE,Azerbaijan,2008,0,1071,-1071
USA,United States,AZE,Azerbaijan,2009,0,834,-834
USA,United States,AZE,Azerbaijan,2010,0,781,-781
USA,United States,AZE,Azerbaijan,2011,0,728,-728
USA,United States,AZE,Azerbaijan,2012,0,663,-663
USA,United States,AZE,Azerbaijan,2013,0,637,-637
USA,United States,AZE,Azerbaijan,2014,0,672,-672
USA,United States,AZE,Azerbaijan,2015,0,676,-676
USA,United States,AZE,Azerbaijan,2016,0,784,-784
USA,United States,AZE,Azerbaijan,2017,0,881,-881
CHL,Chile,AZE,Azerbaijan,2008,0,0,0
CHL,Chile,AZE,Azerbaijan,2009,0,1,-1
CHL,Chile,AZE,Azerbaijan,2010,0,0,0
CHL,Chile,AZE,Azerbaijan,2011,0,0,0
CHL,Chile,AZE,Azerbaijan,2012,0,0,0
CHL,Chile,AZE,Azerbaijan,2013,0,1,-1
CHL,Chile,AZE,Azerbaijan,2014,0,1,-1
CHL,Chile,AZE,Azerbaijan,2015,0,0,0
CHL,Chile,AZE,Azerbaijan,2016,0,0,0
EST,Estonia,AZE,Azerbaijan,2008,0,10,-10
EST,Estonia,AZE,Azerbaijan,2009,0,3,-3
EST,Estonia,AZE,Azerbaijan,2010,0,7,-7
EST,Estonia,AZE,Azerbaijan,2011,0,11,-11
EST,Estonia,AZE,Azerbaijan,2012,0,5,-5
EST,Estonia,AZE,Azerbaijan,2013,0,12,-12
EST,Estonia,AZE,Azerbaijan,2014,0,6,-6
EST,Estonia,AZE,Azerbaijan,2015,0,25,-25
EST,Estonia,AZE,Azerbaijan,2016,0,27,-27
EST,Estonia,AZE,Azerbaijan,2017,0,59,-59
SVN,Slovenia,AZE,Azerbaijan,2011,0,1,-1
SVN,Slovenia,AZE,Azerbaijan,2012,0,4,-4
SVN,Slovenia,AZE,Azerbaijan,2013,0,3,-3
SVN,Slovenia,AZE,Azerbaijan,2014,0,3,-3
SVN,Slovenia,AZE,Azerbaijan,2015,0,10,-10
SVN,Slovenia,AZE,Azerbaijan,2016,1,13,-12
SVN,Slovenia,AZE,Azerbaijan,2017,0,9,-9
AUS,Australia,BHS,Bahamas,2008,0,2,-2
AUS,Australia,BHS,Bahamas,2009,0,0,0
AUS,Australia,BHS,Bahamas,2010,0,1,-1
AUS,Australia,BHS,Bahamas,2011,6,3,3
AUS,Australia,BHS,Bahamas,2012,0,1,-1
AUS,Australia,BHS,Bahamas,2013,5,0,5
AUS,Australia,BHS,Bahamas,2014,0,11,-11
AUS,Australia,BHS,Bahamas,2015,0,0,0
AUS,Australia,BHS,Bahamas,2016,0,0,0
AUS,Australia,BHS,Bahamas,2017,0,3,-3
AUT,Austria,BHS,Bahamas,2008,0,0,0
AUT,Austria,BHS,Bahamas,2009,0,1,-1
AUT,Austria,BHS,Bahamas,2010,0,2,-2
AUT,Austria,BHS,Bahamas,2011,0,2,-2
AUT,Austria,BHS,Bahamas,2012,0,1,-1
AUT,Austria,BHS,Bahamas,2013,0,0,0
AUT,Austria,BHS,Bahamas,2014,0,1,-1
AUT,Austria,BHS,Bahamas,2015,1,1,0
AUT,Austria,BHS,Bahamas,2016,0,2,-2
AUT,Austria,BHS,Bahamas,2017,0,3,-3
BEL,Belgium,BHS,Bahamas,2008,0,0,0
BEL,Belgium,BHS,Bahamas,2009,0,0,0
BEL,Belgium,BHS,Bahamas,2010,1,0,1
BEL,Belgium,BHS,Bahamas,2012,0,1,-1
BEL,Belgium,BHS,Bahamas,2013,0,1,-1
BEL,Belgium,BHS,Bahamas,2014,1,2,-1
BEL,Belgium,BHS,Bahamas,2015,1,1,0
BEL,Belgium,BHS,Bahamas,2016,3,2,1
BEL,Belgium,BHS,Bahamas,2017,0,1,-1
CAN,Canada,BHS,Bahamas,2008,0,30,-30
CAN,Canada,BHS,Bahamas,2009,0,27,-27
CAN,Canada,BHS,Bahamas,2010,0,25,-25
CAN,Canada,BHS,Bahamas,2011,0,40,-40
CAN,Canada,BHS,Bahamas,2012,0,60,-60
CAN,Canada,BHS,Bahamas,2013,0,55,-55
CAN,Canada,BHS,Bahamas,2014,0,61,-61
CAN,Canada,BHS,Bahamas,2015,0,74,-74
CAN,Canada,BHS,Bahamas,2016,0,80,-80
CAN,Canada,BHS,Bahamas,2017,0,125,-125
DNK,Denmark,BHS,Bahamas,2012,1,0,1
DNK,Denmark,BHS,Bahamas,2013,2,2,0
DNK,Denmark,BHS,Bahamas,2014,0,0,0
DNK,Denmark,BHS,Bahamas,2015,0,1,-1
DNK,Denmark,BHS,Bahamas,2016,1,2,-1
DNK,Denmark,BHS,Bahamas,2017,0,0,0
FIN,Finland,BHS,Bahamas,2008,0,0,0
FIN,Finland,BHS,Bahamas,2009,0,0,0
FIN,Finland,BHS,Bahamas,2010,0,0,0
FIN,Finland,BHS,Bahamas,2011,0,0,0
FIN,Finland,BHS,Bahamas,2012,0,0,0
FIN,Finland,BHS,Bahamas,2013,0,0,0
FIN,Finland,BHS,Bahamas,2014,0,0,0
FIN,Finland,BHS,Bahamas,2015,0,1,-1
FIN,Finland,BHS,Bahamas,2016,0,0,0
FIN,Finland,BHS,Bahamas,2017,2,1,1
FRA,France,BHS,Bahamas,2008,0,0,0
FRA,France,BHS,Bahamas,2009,0,0,0
FRA,France,BHS,Bahamas,2010,0,5,-5
FRA,France,BHS,Bahamas,2011,0,4,-4
FRA,France,BHS,Bahamas,2012,0,0,0
FRA,France,BHS,Bahamas,2013,0,1,-1
FRA,France,BHS,Bahamas,2014,0,1,-1
FRA,France,BHS,Bahamas,2015,0,2,-2
FRA,France,BHS,Bahamas,2016,0,4,-4
FRA,France,BHS,Bahamas,2017,0,9,-9
DEU,Germany,BHS,Bahamas,2008,6,5,1
DEU,Germany,BHS,Bahamas,2009,4,8,-4
DEU,Germany,BHS,Bahamas,2010,5,8,-3
DEU,Germany,BHS,Bahamas,2011,2,1,1
DEU,Germany,BHS,Bahamas,2012,4,1,3
DEU,Germany,BHS,Bahamas,2013,0,7,-7
DEU,Germany,BHS,Bahamas,2014,6,7,-1
DEU,Germany,BHS,Bahamas,2015,5,13,-8
DEU,Germany,BHS,Bahamas,2016,5,4,1
DEU,Germany,BHS,Bahamas,2017,5,6,-1
HUN,Hungary,BHS,Bahamas,2008,0,1,-1
HUN,Hungary,BHS,Bahamas,2009,0,0,0
HUN,Hungary,BHS,Bahamas,2010,0,0,0
HUN,Hungary,BHS,Bahamas,2011,0,0,0
HUN,Hungary,BHS,Bahamas,2012,0,0,0
HUN,Hungary,BHS,Bahamas,2013,0,0,0
HUN,Hungary,BHS,Bahamas,2014,0,0,0
HUN,Hungary,BHS,Bahamas,2015,0,0,0
HUN,Hungary,BHS,Bahamas,2016,0,0,0
HUN,Hungary,BHS,Bahamas,2017,0,1,-1
ISL,Iceland,BHS,Bahamas,2008,0,1,-1
ISL,Iceland,BHS,Bahamas,2009,0,0,0
ISL,Iceland,BHS,Bahamas,2010,0,0,0
ISL,Iceland,BHS,Bahamas,2011,0,0,0
ISL,Iceland,BHS,Bahamas,2012,0,0,0
ISL,Iceland,BHS,Bahamas,2013,0,0,0
ISL,Iceland,BHS,Bahamas,2014,0,0,0
ISL,Iceland,BHS,Bahamas,2015,0,1,-1
ISL,Iceland,BHS,Bahamas,2016,1,0,1
ISL,Iceland,BHS,Bahamas,2017,0,1,-1
ITA,Italy,BHS,Bahamas,2008,0,4,-4
ITA,Italy,BHS,Bahamas,2009,0,2,-2
ITA,Italy,BHS,Bahamas,2010,2,11,-9
ITA,Italy,BHS,Bahamas,2011,2,2,0
ITA,Italy,BHS,Bahamas,2012,0,6,-6
ITA,Italy,BHS,Bahamas,2013,0,3,-3
ITA,Italy,BHS,Bahamas,2014,0,3,-3
ITA,Italy,BHS,Bahamas,2015,1,4,-3
ITA,Italy,BHS,Bahamas,2016,0,1,-1
ITA,Italy,BHS,Bahamas,2017,3,2,1
JPN,Japan,BHS,Bahamas,2008,2,3,-1
JPN,Japan,BHS,Bahamas,2009,3,4,-1
JPN,Japan,BHS,Bahamas,2010,2,3,-1
JPN,Japan,BHS,Bahamas,2011,3,6,-3
JPN,Japan,BHS,Bahamas,2012,3,4,-1
JPN,Japan,BHS,Bahamas,2013,1,5,-4
JPN,Japan,BHS,Bahamas,2014,5,4,1
JPN,Japan,BHS,Bahamas,2015,3,4,-1
JPN,Japan,BHS,Bahamas,2016,4,6,-2
JPN,Japan,BHS,Bahamas,2017,6,7,-1
KOR,Korea,BHS,Bahamas,2008,0,0,0
KOR,Korea,BHS,Bahamas,2009,0,0,0
KOR,Korea,BHS,Bahamas,2010,1,2,-1
KOR,Korea,BHS,Bahamas,2011,3,2,1
KOR,Korea,BHS,Bahamas,2012,1,1,0
KOR,Korea,BHS,Bahamas,2013,1,2,-1
KOR,Korea,BHS,Bahamas,2014,3,3,0
KOR,Korea,BHS,Bahamas,2015,2,2,0
KOR,Korea,BHS,Bahamas,2016,1,4,-3
KOR,Korea,BHS,Bahamas,2017,1,2,-1
LUX,Luxembourg,BHS,Bahamas,2008,0,0,0
LUX,Luxembourg,BHS,Bahamas,2009,0,0,0
LUX,Luxembourg,BHS,Bahamas,2010,0,0,0
LUX,Luxembourg,BHS,Bahamas,2011,0,0,0
LUX,Luxembourg,BHS,Bahamas,2012,0,0,0
LUX,Luxembourg,BHS,Bahamas,2013,0,0,0
LUX,Luxembourg,BHS,Bahamas,2014,0,0,0
LUX,Luxembourg,BHS,Bahamas,2015,0,0,0
LUX,Luxembourg,BHS,Bahamas,2016,0,0,0
LUX,Luxembourg,BHS,Bahamas,2017,0,0,0
MEX,Mexico,BHS,Bahamas,2011,0,1,-1
MEX,Mexico,BHS,Bahamas,2012,0,0,0
MEX,Mexico,BHS,Bahamas,2013,0,2,-2
MEX,Mexico,BHS,Bahamas,2014,0,1,-1
MEX,Mexico,BHS,Bahamas,2015,0,1,-1
MEX,Mexico,BHS,Bahamas,2016,0,2,-2
MEX,Mexico,BHS,Bahamas,2017,0,2,-2
NLD,Netherlands,BHS,Bahamas,2008,2,2,0
NLD,Netherlands,BHS,Bahamas,2011,0,1,-1
NLD,Netherlands,BHS,Bahamas,2012,3,2,1
NLD,Netherlands,BHS,Bahamas,2013,0,3,-3
NLD,Netherlands,BHS,Bahamas,2014,2,4,-2
NLD,Netherlands,BHS,Bahamas,2015,2,2,0
NLD,Netherlands,BHS,Bahamas,2016,1,1,0
NLD,Netherlands,BHS,Bahamas,2017,1,3,-2
NZL,New Zealand,BHS,Bahamas,2008,0,0,0
NZL,New Zealand,BHS,Bahamas,2012,0,1,-1
NZL,New Zealand,BHS,Bahamas,2014,0,2,-2
NZL,New Zealand,BHS,Bahamas,2015,0,2,-2
NOR,Norway,BHS,Bahamas,2008,0,3,-3
NOR,Norway,BHS,Bahamas,2009,0,0,0
NOR,Norway,BHS,Bahamas,2010,1,0,1
NOR,Norway,BHS,Bahamas,2011,0,2,-2
NOR,Norway,BHS,Bahamas,2012,1,1,0
NOR,Norway,BHS,Bahamas,2013,0,1,-1
NOR,Norway,BHS,Bahamas,2014,0,0,0
NOR,Norway,BHS,Bahamas,2015,0,2,-2
NOR,Norway,BHS,Bahamas,2016,1,0,1
NOR,Norway,BHS,Bahamas,2017,0,1,-1
POL,Poland,BHS,Bahamas,2009,0,0,0
POL,Poland,BHS,Bahamas,2010,0,0,0
POL,Poland,BHS,Bahamas,2011,0,0,0
POL,Poland,BHS,Bahamas,2012,0,0,0
POL,Poland,BHS,Bahamas,2013,0,1,-1
POL,Poland,BHS,Bahamas,2014,0,0,0
POL,Poland,BHS,Bahamas,2015,0,0,0
POL,Poland,BHS,Bahamas,2016,0,0,0
POL,Poland,BHS,Bahamas,2017,0,0,0
SVK,Slovak Republic,BHS,Bahamas,2008,0,0,0
SVK,Slovak Republic,BHS,Bahamas,2010,0,1,-1
ESP,Spain,BHS,Bahamas,2008,1,1,0
ESP,Spain,BHS,Bahamas,2009,2,0,2
ESP,Spain,BHS,Bahamas,2010,5,2,3
ESP,Spain,BHS,Bahamas,2011,1,1,0
ESP,Spain,BHS,Bahamas,2012,0,3,-3
ESP,Spain,BHS,Bahamas,2013,0,5,-5
ESP,Spain,BHS,Bahamas,2014,2,2,0
ESP,Spain,BHS,Bahamas,2015,2,7,-5
ESP,Spain,BHS,Bahamas,2016,0,4,-4
ESP,Spain,BHS,Bahamas,2017,3,4,-1
SWE,Sweden,BHS,Bahamas,2008,1,1,0
SWE,Sweden,BHS,Bahamas,2009,0,1,-1
SWE,Sweden,BHS,Bahamas,2010,1,2,-1
SWE,Sweden,BHS,Bahamas,2011,1,0,1
SWE,Sweden,BHS,Bahamas,2012,2,4,-2
SWE,Sweden,BHS,Bahamas,2013,4,0,4
SWE,Sweden,BHS,Bahamas,2014,0,1,-1
SWE,Sweden,BHS,Bahamas,2015,0,0,0
SWE,Sweden,BHS,Bahamas,2016,0,2,-2
SWE,Sweden,BHS,Bahamas,2017,0,0,0
CHE,Switzerland,BHS,Bahamas,2010,2,0,2
CHE,Switzerland,BHS,Bahamas,2011,3,5,-2
CHE,Switzerland,BHS,Bahamas,2012,2,2,0
CHE,Switzerland,BHS,Bahamas,2013,2,4,-2
CHE,Switzerland,BHS,Bahamas,2014,3,3,0
CHE,Switzerland,BHS,Bahamas,2015,3,2,1
CHE,Switzerland,BHS,Bahamas,2016,0,2,-2
CHE,Switzerland,BHS,Bahamas,2017,1,2,-1
TUR,Turkey,BHS,Bahamas,2010,0,1,-1
USA,United States,BHS,Bahamas,2008,0,682,-682
USA,United States,BHS,Bahamas,2009,0,751,-751
USA,United States,BHS,Bahamas,2010,0,652,-652
USA,United States,BHS,Bahamas,2011,0,668,-668
USA,United States,BHS,Bahamas,2012,0,619,-619
USA,United States,BHS,Bahamas,2013,0,630,-630
USA,United States,BHS,Bahamas,2014,0,654,-654
USA,United States,BHS,Bahamas,2015,0,725,-725
USA,United States,BHS,Bahamas,2016,0,656,-656
USA,United States,BHS,Bahamas,2017,0,725,-725
CHL,Chile,BHS,Bahamas,2008,0,1,-1
CHL,Chile,BHS,Bahamas,2009,0,0,0
CHL,Chile,BHS,Bahamas,2010,0,0,0
CHL,Chile,BHS,Bahamas,2011,0,0,0
CHL,Chile,BHS,Bahamas,2012,0,0,0
CHL,Chile,BHS,Bahamas,2013,0,0,0
CHL,Chile,BHS,Bahamas,2014,0,5,-5
CHL,Chile,BHS,Bahamas,2015,0,0,0
CHL,Chile,BHS,Bahamas,2016,0,1,-1
EST,Estonia,BHS,Bahamas,2008,0,0,0
EST,Estonia,BHS,Bahamas,2009,0,0,0
EST,Estonia,BHS,Bahamas,2010,0,0,0
EST,Estonia,BHS,Bahamas,2011,0,0,0
EST,Estonia,BHS,Bahamas,2012,0,0,0
EST,Estonia,BHS,Bahamas,2013,0,0,0
EST,Estonia,BHS,Bahamas,2014,0,0,0
EST,Estonia,BHS,Bahamas,2015,0,0,0
EST,Estonia,BHS,Bahamas,2016,0,0,0
EST,Estonia,BHS,Bahamas,2017,0,0,0
AUS,Australia,BHR,Bahrain,2008,19,10,9
AUS,Australia,BHR,Bahrain,2009,15,4,11
AUS,Australia,BHR,Bahrain,2010,18,7,11
AUS,Australia,BHR,Bahrain,2011,8,6,2
AUS,Australia,BHR,Bahrain,2012,15,15,0
AUS,Australia,BHR,Bahrain,2013,13,29,-16
AUS,Australia,BHR,Bahrain,2014,19,22,-3
AUS,Australia,BHR,Bahrain,2015,0,16,-16
AUS,Australia,BHR,Bahrain,2016,0,8,-8
AUS,Australia,BHR,Bahrain,2017,0,8,-8
AUT,Austria,BHR,Bahrain,2008,0,2,-2
AUT,Austria,BHR,Bahrain,2009,0,5,-5
AUT,Austria,BHR,Bahrain,2010,1,1,0
AUT,Austria,BHR,Bahrain,2011,1,0,1
AUT,Austria,BHR,Bahrain,2012,0,0,0
AUT,Austria,BHR,Bahrain,2013,0,2,-2
AUT,Austria,BHR,Bahrain,2014,1,1,0
AUT,Austria,BHR,Bahrain,2015,0,1,-1
AUT,Austria,BHR,Bahrain,2016,2,3,-1
AUT,Austria,BHR,Bahrain,2017,0,3,-3
BEL,Belgium,BHR,Bahrain,2008,0,1,-1
BEL,Belgium,BHR,Bahrain,2009,0,0,0
BEL,Belgium,BHR,Bahrain,2010,1,1,0
BEL,Belgium,BHR,Bahrain,2013,3,5,-2
BEL,Belgium,BHR,Bahrain,2014,1,1,0
BEL,Belgium,BHR,Bahrain,2015,3,3,0
BEL,Belgium,BHR,Bahrain,2016,0,2,-2
CAN,Canada,BHR,Bahrain,2008,0,9,-9
CAN,Canada,BHR,Bahrain,2009,0,35,-35
CAN,Canada,BHR,Bahrain,2010,0,28,-28
CAN,Canada,BHR,Bahrain,2011,0,21,-21
CAN,Canada,BHR,Bahrain,2012,0,39,-39
CAN,Canada,BHR,Bahrain,2013,0,32,-32
CAN,Canada,BHR,Bahrain,2014,0,25,-25
CAN,Canada,BHR,Bahrain,2015,0,33,-33
CAN,Canada,BHR,Bahrain,2016,0,20,-20
CAN,Canada,BHR,Bahrain,2017,0,35,-35
CZE,Czech Republic,BHR,Bahrain,2008,0,7,-7
CZE,Czech Republic,BHR,Bahrain,2009,0,8,-8
CZE,Czech Republic,BHR,Bahrain,2010,0,1,-1
CZE,Czech Republic,BHR,Bahrain,2014,1,1,0
CZE,Czech Republic,BHR,Bahrain,2015,0,3,-3
CZE,Czech Republic,BHR,Bahrain,2016,0,2,-2
CZE,Czech Republic,BHR,Bahrain,2017,0,2,-2
DNK,Denmark,BHR,Bahrain,2010,0,1,-1
DNK,Denmark,BHR,Bahrain,2011,0,1,-1
DNK,Denmark,BHR,Bahrain,2012,0,1,-1
DNK,Denmark,BHR,Bahrain,2013,0,2,-2
DNK,Denmark,BHR,Bahrain,2014,0,0,0
DNK,Denmark,BHR,Bahrain,2015,2,1,1
DNK,Denmark,BHR,Bahrain,2016,1,1,0
DNK,Denmark,BHR,Bahrain,2017,2,2,0
FIN,Finland,BHR,Bahrain,2008,1,0,1
FIN,Finland,BHR,Bahrain,2009,0,0,0
FIN,Finland,BHR,Bahrain,2010,0,0,0
FIN,Finland,BHR,Bahrain,2011,0,0,0
FIN,Finland,BHR,Bahrain,2012,0,1,-1
FIN,Finland,BHR,Bahrain,2013,0,0,0
FIN,Finland,BHR,Bahrain,2014,0,0,0
FIN,Finland,BHR,Bahrain,2015,0,0,0
FIN,Finland,BHR,Bahrain,2016,0,2,-2
FIN,Finland,BHR,Bahrain,2017,1,2,-1
FRA,France,BHR,Bahrain,2008,0,4,-4
FRA,France,BHR,Bahrain,2009,0,3,-3
FRA,France,BHR,Bahrain,2010,0,5,-5
FRA,France,BHR,Bahrain,2011,0,2,-2
FRA,France,BHR,Bahrain,2012,0,2,-2
FRA,France,BHR,Bahrain,2013,0,2,-2
FRA,France,BHR,Bahrain,2014,0,2,-2
FRA,France,BHR,Bahrain,2015,0,3,-3
FRA,France,BHR,Bahrain,2016,0,1,-1
FRA,France,BHR,Bahrain,2017,0,8,-8
DEU,Germany,BHR,Bahrain,2008,50,49,1
DEU,Germany,BHR,Bahrain,2009,67,79,-12
DEU,Germany,BHR,Bahrain,2010,78,89,-11
DEU,Germany,BHR,Bahrain,2011,53,53,0
DEU,Germany,BHR,Bahrain,2012,63,103,-40
DEU,Germany,BHR,Bahrain,2013,74,126,-52
DEU,Germany,BHR,Bahrain,2014,84,149,-65
DEU,Germany,BHR,Bahrain,2015,112,213,-101
DEU,Germany,BHR,Bahrain,2016,151,181,-30
DEU,Germany,BHR,Bahrain,2017,75,101,-26
HUN,Hungary,BHR,Bahrain,2008,0,0,0
HUN,Hungary,BHR,Bahrain,2009,0,0,0
HUN,Hungary,BHR,Bahrain,2010,0,0,0
HUN,Hungary,BHR,Bahrain,2011,0,3,-3
HUN,Hungary,BHR,Bahrain,2012,0,1,-1
HUN,Hungary,BHR,Bahrain,2013,0,0,0
HUN,Hungary,BHR,Bahrain,2014,0,0,0
HUN,Hungary,BHR,Bahrain,2015,0,1,-1
HUN,Hungary,BHR,Bahrain,2016,0,10,-10
HUN,Hungary,BHR,Bahrain,2017,0,8,-8
ISL,Iceland,BHR,Bahrain,2008,0,0,0
ISL,Iceland,BHR,Bahrain,2009,0,0,0
ISL,Iceland,BHR,Bahrain,2010,0,0,0
ISL,Iceland,BHR,Bahrain,2011,0,0,0
ISL,Iceland,BHR,Bahrain,2012,1,0,1
ISL,Iceland,BHR,Bahrain,2016,0,0,0
ISL,Iceland,BHR,Bahrain,2017,0,0,0
ITA,Italy,BHR,Bahrain,2008,0,2,-2
ITA,Italy,BHR,Bahrain,2009,0,2,-2
ITA,Italy,BHR,Bahrain,2010,0,2,-2
ITA,Italy,BHR,Bahrain,2011,2,1,1
ITA,Italy,BHR,Bahrain,2012,0,4,-4
ITA,Italy,BHR,Bahrain,2013,1,5,-4
ITA,Italy,BHR,Bahrain,2015,0,7,-7
JPN,Japan,BHR,Bahrain,2008,58,61,-3
JPN,Japan,BHR,Bahrain,2009,15,21,-6
JPN,Japan,BHR,Bahrain,2010,23,27,-4
JPN,Japan,BHR,Bahrain,2011,36,38,-2
JPN,Japan,BHR,Bahrain,2012,126,124,2
JPN,Japan,BHR,Bahrain,2013,86,94,-8
JPN,Japan,BHR,Bahrain,2014,42,49,-7
JPN,Japan,BHR,Bahrain,2015,61,62,-1
JPN,Japan,BHR,Bahrain,2016,42,59,-17
JPN,Japan,BHR,Bahrain,2017,53,58,-5
KOR,Korea,BHR,Bahrain,2008,0,8,-8
KOR,Korea,BHR,Bahrain,2009,12,3,9
KOR,Korea,BHR,Bahrain,2010,2,3,-1
KOR,Korea,BHR,Bahrain,2011,4,3,1
KOR,Korea,BHR,Bahrain,2012,3,4,-1
KOR,Korea,BHR,Bahrain,2013,0,1,-1
KOR,Korea,BHR,Bahrain,2014,1,2,-1
KOR,Korea,BHR,Bahrain,2015,5,7,-2
KOR,Korea,BHR,Bahrain,2016,4,6,-2
KOR,Korea,BHR,Bahrain,2017,5,5,0
LUX,Luxembourg,BHR,Bahrain,2008,0,0,0
LUX,Luxembourg,BHR,Bahrain,2009,0,0,0
LUX,Luxembourg,BHR,Bahrain,2010,0,0,0
LUX,Luxembourg,BHR,Bahrain,2011,0,0,0
LUX,Luxembourg,BHR,Bahrain,2012,0,0,0
LUX,Luxembourg,BHR,Bahrain,2013,0,0,0
LUX,Luxembourg,BHR,Bahrain,2014,0,0,0
LUX,Luxembourg,BHR,Bahrain,2015,0,0,0
LUX,Luxembourg,BHR,Bahrain,2016,0,0,0
LUX,Luxembourg,BHR,Bahrain,2017,0,0,0
MEX,Mexico,BHR,Bahrain,2012,0,0,0
MEX,Mexico,BHR,Bahrain,2013,0,0,0
MEX,Mexico,BHR,Bahrain,2014,0,0,0
MEX,Mexico,BHR,Bahrain,2017,0,1,-1
NLD,Netherlands,BHR,Bahrain,2010,0,1,-1
NLD,Netherlands,BHR,Bahrain,2011,1,5,-4
NLD,Netherlands,BHR,Bahrain,2012,4,6,-2
NLD,Netherlands,BHR,Bahrain,2013,4,2,2
NLD,Netherlands,BHR,Bahrain,2014,1,2,-1
NLD,Netherlands,BHR,Bahrain,2015,7,13,-6
NLD,Netherlands,BHR,Bahrain,2016,5,10,-5
NLD,Netherlands,BHR,Bahrain,2017,3,10,-7
NZL,New Zealand,BHR,Bahrain,2008,3,15,-12
NZL,New Zealand,BHR,Bahrain,2009,5,11,-6
NZL,New Zealand,BHR,Bahrain,2010,4,7,-3
NZL,New Zealand,BHR,Bahrain,2011,5,8,-3
NZL,New Zealand,BHR,Bahrain,2012,4,12,-8
NZL,New Zealand,BHR,Bahrain,2013,14,8,6
NZL,New Zealand,BHR,Bahrain,2014,0,5,-5
NZL,New Zealand,BHR,Bahrain,2015,0,2,-2
NZL,New Zealand,BHR,Bahrain,2016,0,2,-2
NZL,New Zealand,BHR,Bahrain,2017,0,1,-1
NOR,Norway,BHR,Bahrain,2008,3,0,3
NOR,Norway,BHR,Bahrain,2009,0,0,0
NOR,Norway,BHR,Bahrain,2010,0,1,-1
NOR,Norway,BHR,Bahrain,2011,1,1,0
NOR,Norway,BHR,Bahrain,2012,0,0,0
NOR,Norway,BHR,Bahrain,2013,0,0,0
NOR,Norway,BHR,Bahrain,2014,0,0,0
NOR,Norway,BHR,Bahrain,2015,0,1,-1
NOR,Norway,BHR,Bahrain,2016,0,2,-2
NOR,Norway,BHR,Bahrain,2017,1,0,1
POL,Poland,BHR,Bahrain,2009,0,0,0
POL,Poland,BHR,Bahrain,2010,0,1,-1
POL,Poland,BHR,Bahrain,2011,0,0,0
POL,Poland,BHR,Bahrain,2012,0,0,0
POL,Poland,BHR,Bahrain,2013,0,1,-1
POL,Poland,BHR,Bahrain,2014,0,0,0
POL,Poland,BHR,Bahrain,2015,0,1,-1
POL,Poland,BHR,Bahrain,2016,0,9,-9
POL,Poland,BHR,Bahrain,2017,0,5,-5
SVK,Slovak Republic,BHR,Bahrain,2008,0,1,-1
SVK,Slovak Republic,BHR,Bahrain,2010,0,1,-1
ESP,Spain,BHR,Bahrain,2008,0,1,-1
ESP,Spain,BHR,Bahrain,2009,1,0,1
ESP,Spain,BHR,Bahrain,2010,0,1,-1
ESP,Spain,BHR,Bahrain,2011,0,5,-5
ESP,Spain,BHR,Bahrain,2012,0,5,-5
ESP,Spain,BHR,Bahrain,2013,0,2,-2
ESP,Spain,BHR,Bahrain,2014,0,4,-4
ESP,Spain,BHR,Bahrain,2015,2,5,-3
ESP,Spain,BHR,Bahrain,2016,1,11,-10
ESP,Spain,BHR,Bahrain,2017,8,15,-7
SWE,Sweden,BHR,Bahrain,2008,1,3,-2
SWE,Sweden,BHR,Bahrain,2009,1,1,0
SWE,Sweden,BHR,Bahrain,2010,1,1,0
SWE,Sweden,BHR,Bahrain,2011,0,6,-6
SWE,Sweden,BHR,Bahrain,2012,3,3,0
SWE,Sweden,BHR,Bahrain,2013,7,11,-4
SWE,Sweden,BHR,Bahrain,2014,8,11,-3
SWE,Sweden,BHR,Bahrain,2015,4,0,4
SWE,Sweden,BHR,Bahrain,2016,0,4,-4
SWE,Sweden,BHR,Bahrain,2017,6,4,2
CHE,Switzerland,BHR,Bahrain,2010,7,8,-1
CHE,Switzerland,BHR,Bahrain,2011,3,8,-5
CHE,Switzerland,BHR,Bahrain,2012,13,13,0
CHE,Switzerland,BHR,Bahrain,2013,12,11,1
CHE,Switzerland,BHR,Bahrain,2014,7,5,2
CHE,Switzerland,BHR,Bahrain,2015,5,15,-10
CHE,Switzerland,BHR,Bahrain,2016,7,13,-6
CHE,Switzerland,BHR,Bahrain,2017,10,10,0
TUR,Turkey,BHR,Bahrain,2010,0,1,-1
GBR,United Kingdom,BHR,Bahrain,2015,0,1000,-1000
USA,United States,BHR,Bahrain,2008,0,96,-96
USA,United States,BHR,Bahrain,2009,0,120,-120
USA,United States,BHR,Bahrain,2010,0,104,-104
USA,United States,BHR,Bahrain,2011,0,119,-119
USA,United States,BHR,Bahrain,2012,0,104,-104
USA,United States,BHR,Bahrain,2013,0,115,-115
USA,United States,BHR,Bahrain,2014,0,122,-122
USA,United States,BHR,Bahrain,2015,0,145,-145
USA,United States,BHR,Bahrain,2016,0,138,-138
USA,United States,BHR,Bahrain,2017,0,130,-130
CHL,Chile,BHR,Bahrain,2008,0,0,0
CHL,Chile,BHR,Bahrain,2009,0,0,0
CHL,Chile,BHR,Bahrain,2010,0,0,0
CHL,Chile,BHR,Bahrain,2011,0,0,0
CHL,Chile,BHR,Bahrain,2012,0,0,0
CHL,Chile,BHR,Bahrain,2013,0,0,0
CHL,Chile,BHR,Bahrain,2014,0,0,0
CHL,Chile,BHR,Bahrain,2015,0,0,0
CHL,Chile,BHR,Bahrain,2016,0,0,0
EST,Estonia,BHR,Bahrain,2008,0,0,0
EST,Estonia,BHR,Bahrain,2009,0,0,0
EST,Estonia,BHR,Bahrain,2010,0,0,0
EST,Estonia,BHR,Bahrain,2011,0,0,0
EST,Estonia,BHR,Bahrain,2012,0,0,0
EST,Estonia,BHR,Bahrain,2013,0,0,0
EST,Estonia,BHR,Bahrain,2014,0,0,0
EST,Estonia,BHR,Bahrain,2015,0,0,0
EST,Estonia,BHR,Bahrain,2016,0,0,0
EST,Estonia,BHR,Bahrain,2017,0,0,0
SVN,Slovenia,BHR,Bahrain,2016,0,1,-1
SVN,Slovenia,BHR,Bahrain,2017,0,1,-1
AUS,Australia,BGD,Bangladesh,2008,143,2805,-2662
AUS,Australia,BGD,Bangladesh,2009,173,2180,-2007
AUS,Australia,BGD,Bangladesh,2010,159,2075,-1916
AUS,Australia,BGD,Bangladesh,2011,221,2276,-2055
AUS,Australia,BGD,Bangladesh,2012,140,2489,-2349
AUS,Australia,BGD,Bangladesh,2013,171,2834,-2663
AUS,Australia,BGD,Bangladesh,2014,193,2696,-2503
AUS,Australia,BGD,Bangladesh,2015,200,3426,-3226
AUS,Australia,BGD,Bangladesh,2016,200,3118,-2918
AUS,Australia,BGD,Bangladesh,2017,0,2604,-2604
AUT,Austria,BGD,Bangladesh,2008,99,137,-38
AUT,Austria,BGD,Bangladesh,2009,79,145,-66
AUT,Austria,BGD,Bangladesh,2010,90,146,-56
AUT,Austria,BGD,Bangladesh,2011,91,168,-77
AUT,Austria,BGD,Bangladesh,2012,85,257,-172
AUT,Austria,BGD,Bangladesh,2013,78,230,-152
AUT,Austria,BGD,Bangladesh,2014,82,230,-148
AUT,Austria,BGD,Bangladesh,2015,78,361,-283
AUT,Austria,BGD,Bangladesh,2016,119,347,-228
AUT,Austria,BGD,Bangladesh,2017,114,232,-118
BEL,Belgium,BGD,Bangladesh,2008,0,108,-108
BEL,Belgium,BGD,Bangladesh,2009,0,146,-146
BEL,Belgium,BGD,Bangladesh,2010,50,153,-103
BEL,Belgium,BGD,Bangladesh,2011,0,160,-160
BEL,Belgium,BGD,Bangladesh,2012,270,521,-251
BEL,Belgium,BGD,Bangladesh,2013,331,312,19
BEL,Belgium,BGD,Bangladesh,2014,390,139,251
BEL,Belgium,BGD,Bangladesh,2015,270,183,87
BEL,Belgium,BGD,Bangladesh,2016,142,191,-49
BEL,Belgium,BGD,Bangladesh,2017,91,173,-82
CAN,Canada,BGD,Bangladesh,2008,0,2939,-2939
CAN,Canada,BGD,Bangladesh,2009,0,2104,-2104
CAN,Canada,BGD,Bangladesh,2010,0,4721,-4721
CAN,Canada,BGD,Bangladesh,2011,0,2694,-2694
CAN,Canada,BGD,Bangladesh,2012,0,2630,-2630
CAN,Canada,BGD,Bangladesh,2013,0,3792,-3792
CAN,Canada,BGD,Bangladesh,2014,0,2233,-2233
CAN,Canada,BGD,Bangladesh,2015,0,3304,-3304
CAN,Canada,BGD,Bangladesh,2016,0,3230,-3230
CAN,Canada,BGD,Bangladesh,2017,0,3185,-3185
CZE,Czech Republic,BGD,Bangladesh,2008,0,15,-15
CZE,Czech Republic,BGD,Bangladesh,2009,1,44,-43
CZE,Czech Republic,BGD,Bangladesh,2010,0,29,-29
CZE,Czech Republic,BGD,Bangladesh,2011,0,6,-6
CZE,Czech Republic,BGD,Bangladesh,2012,3,14,-11
CZE,Czech Republic,BGD,Bangladesh,2013,15,15,0
CZE,Czech Republic,BGD,Bangladesh,2014,8,31,-23
CZE,Czech Republic,BGD,Bangladesh,2015,16,24,-8
CZE,Czech Republic,BGD,Bangladesh,2016,14,65,-51
CZE,Czech Republic,BGD,Bangladesh,2017,19,141,-122
DNK,Denmark,BGD,Bangladesh,2008,14,91,-77
DNK,Denmark,BGD,Bangladesh,2009,20,112,-92
DNK,Denmark,BGD,Bangladesh,2010,27,171,-144
DNK,Denmark,BGD,Bangladesh,2011,61,154,-93
DNK,Denmark,BGD,Bangladesh,2012,72,150,-78
DNK,Denmark,BGD,Bangladesh,2013,54,198,-144
DNK,Denmark,BGD,Bangladesh,2014,54,199,-145
DNK,Denmark,BGD,Bangladesh,2015,62,186,-124
DNK,Denmark,BGD,Bangladesh,2016,97,210,-113
DNK,Denmark,BGD,Bangladesh,2017,129,199,-70
FIN,Finland,BGD,Bangladesh,2008,16,169,-153
FIN,Finland,BGD,Bangladesh,2009,8,182,-174
FIN,Finland,BGD,Bangladesh,2010,8,161,-153
FIN,Finland,BGD,Bangladesh,2011,6,182,-176
FIN,Finland,BGD,Bangladesh,2012,16,154,-138
FIN,Finland,BGD,Bangladesh,2013,24,190,-166
FIN,Finland,BGD,Bangladesh,2014,16,182,-166
FIN,Finland,BGD,Bangladesh,2015,13,225,-212
FIN,Finland,BGD,Bangladesh,2016,28,306,-278
FIN,Finland,BGD,Bangladesh,2017,14,300,-286
FRA,France,BGD,Bangladesh,2008,0,443,-443
FRA,France,BGD,Bangladesh,2009,0,667,-667
FRA,France,BGD,Bangladesh,2010,0,647,-647
FRA,France,BGD,Bangladesh,2011,0,598,-598
FRA,France,BGD,Bangladesh,2012,0,804,-804
FRA,France,BGD,Bangladesh,2013,0,1212,-1212
FRA,France,BGD,Bangladesh,2014,0,1737,-1737
FRA,France,BGD,Bangladesh,2015,0,1975,-1975
FRA,France,BGD,Bangladesh,2016,0,2521,-2521
FRA,France,BGD,Bangladesh,2017,0,2488,-2488
DEU,Germany,BGD,Bangladesh,2008,320,458,-138
DEU,Germany,BGD,Bangladesh,2009,382,526,-144
DEU,Germany,BGD,Bangladesh,2010,375,743,-368
DEU,Germany,BGD,Bangladesh,2011,378,999,-621
DEU,Germany,BGD,Bangladesh,2012,440,1502,-1062
DEU,Germany,BGD,Bangladesh,2013,680,2375,-1695
DEU,Germany,BGD,Bangladesh,2014,795,2006,-1211
DEU,Germany,BGD,Bangladesh,2015,1070,4297,-3227
DEU,Germany,BGD,Bangladesh,2016,1979,1936,43
DEU,Germany,BGD,Bangladesh,2017,1366,1883,-517
HUN,Hungary,BGD,Bangladesh,2008,0,8,-8
HUN,Hungary,BGD,Bangladesh,2009,0,24,-24
HUN,Hungary,BGD,Bangladesh,2010,3,6,-3
HUN,Hungary,BGD,Bangladesh,2011,7,12,-5
HUN,Hungary,BGD,Bangladesh,2012,1,6,-5
HUN,Hungary,BGD,Bangladesh,2013,2,15,-13
HUN,Hungary,BGD,Bangladesh,2014,0,17,-17
HUN,Hungary,BGD,Bangladesh,2015,3,13,-10
HUN,Hungary,BGD,Bangladesh,2016,0,13,-13
HUN,Hungary,BGD,Bangladesh,2017,0,98,-98
ISL,Iceland,BGD,Bangladesh,2008,1,1,0
ISL,Iceland,BGD,Bangladesh,2009,1,0,1
ISL,Iceland,BGD,Bangladesh,2010,0,2,-2
ISL,Iceland,BGD,Bangladesh,2011,2,3,-1
ISL,Iceland,BGD,Bangladesh,2012,1,2,-1
ISL,Iceland,BGD,Bangladesh,2013,2,6,-4
ISL,Iceland,BGD,Bangladesh,2014,7,2,5
ISL,Iceland,BGD,Bangladesh,2015,2,1,1
ISL,Iceland,BGD,Bangladesh,2016,2,2,0
ISL,Iceland,BGD,Bangladesh,2017,1,3,-2
ITA,Italy,BGD,Bangladesh,2008,476,9332,-8856
ITA,Italy,BGD,Bangladesh,2009,551,8902,-8351
ITA,Italy,BGD,Bangladesh,2010,1039,9688,-8649
ITA,Italy,BGD,Bangladesh,2011,680,10348,-9668
ITA,Italy,BGD,Bangladesh,2012,770,10144,-9374
ITA,Italy,BGD,Bangladesh,2013,739,10487,-9748
ITA,Italy,BGD,Bangladesh,2014,754,12673,-11919
ITA,Italy,BGD,Bangladesh,2015,556,12443,-11887
ITA,Italy,BGD,Bangladesh,2016,0,10733,-10733
ITA,Italy,BGD,Bangladesh,2017,605,14551,-13946
JPN,Japan,BGD,Bangladesh,2008,888,1584,-696
JPN,Japan,BGD,Bangladesh,2009,923,1421,-498
JPN,Japan,BGD,Bangladesh,2010,870,1083,-213
JPN,Japan,BGD,Bangladesh,2011,774,848,-74
JPN,Japan,BGD,Bangladesh,2012,740,1192,-452
JPN,Japan,BGD,Bangladesh,2013,653,1237,-584
JPN,Japan,BGD,Bangladesh,2014,923,2023,-1100
JPN,Japan,BGD,Bangladesh,2015,1018,2360,-1342
JPN,Japan,BGD,Bangladesh,2016,1095,2755,-1660
JPN,Japan,BGD,Bangladesh,2017,990,2803,-1813
KOR,Korea,BGD,Bangladesh,2008,3089,2242,847
KOR,Korea,BGD,Bangladesh,2009,2674,1429,1245
KOR,Korea,BGD,Bangladesh,2010,1711,2902,-1191
KOR,Korea,BGD,Bangladesh,2011,1564,2295,-731
KOR,Korea,BGD,Bangladesh,2012,1558,1850,-292
KOR,Korea,BGD,Bangladesh,2013,2501,2520,-19
KOR,Korea,BGD,Bangladesh,2014,1364,2282,-918
KOR,Korea,BGD,Bangladesh,2015,2719,2918,-199
KOR,Korea,BGD,Bangladesh,2016,2074,2906,-832
KOR,Korea,BGD,Bangladesh,2017,1883,2728,-845
LUX,Luxembourg,BGD,Bangladesh,2008,0,6,-6
LUX,Luxembourg,BGD,Bangladesh,2009,0,2,-2
LUX,Luxembourg,BGD,Bangladesh,2010,2,7,-5
LUX,Luxembourg,BGD,Bangladesh,2011,2,10,-8
LUX,Luxembourg,BGD,Bangladesh,2012,5,4,1
LUX,Luxembourg,BGD,Bangladesh,2013,3,5,-2
LUX,Luxembourg,BGD,Bangladesh,2014,0,6,-6
LUX,Luxembourg,BGD,Bangladesh,2015,1,12,-11
LUX,Luxembourg,BGD,Bangladesh,2016,3,10,-7
LUX,Luxembourg,BGD,Bangladesh,2017,4,7,-3
MEX,Mexico,BGD,Bangladesh,2008,0,3,-3
MEX,Mexico,BGD,Bangladesh,2009,0,6,-6
MEX,Mexico,BGD,Bangladesh,2010,0,3,-3
MEX,Mexico,BGD,Bangladesh,2011,0,4,-4
MEX,Mexico,BGD,Bangladesh,2012,0,5,-5
MEX,Mexico,BGD,Bangladesh,2013,0,20,-20
MEX,Mexico,BGD,Bangladesh,2014,0,15,-15
MEX,Mexico,BGD,Bangladesh,2015,0,11,-11
MEX,Mexico,BGD,Bangladesh,2016,0,15,-15
MEX,Mexico,BGD,Bangladesh,2017,0,7,-7
NLD,Netherlands,BGD,Bangladesh,2008,53,90,-37
NLD,Netherlands,BGD,Bangladesh,2009,31,103,-72
NLD,Netherlands,BGD,Bangladesh,2010,53,113,-60
NLD,Netherlands,BGD,Bangladesh,2011,67,105,-38
NLD,Netherlands,BGD,Bangladesh,2012,66,113,-47
NLD,Netherlands,BGD,Bangladesh,2013,95,154,-59
NLD,Netherlands,BGD,Bangladesh,2014,88,143,-55
NLD,Netherlands,BGD,Bangladesh,2016,112,280,-168
NLD,Netherlands,BGD,Bangladesh,2017,175,302,-127
NZL,New Zealand,BGD,Bangladesh,2008,27,71,-44
NZL,New Zealand,BGD,Bangladesh,2009,20,98,-78
NZL,New Zealand,BGD,Bangladesh,2010,25,85,-60
NZL,New Zealand,BGD,Bangladesh,2011,36,100,-64
NZL,New Zealand,BGD,Bangladesh,2012,21,131,-110
NZL,New Zealand,BGD,Bangladesh,2013,10,128,-118
NZL,New Zealand,BGD,Bangladesh,2014,24,281,-257
NZL,New Zealand,BGD,Bangladesh,2015,23,416,-393
NZL,New Zealand,BGD,Bangladesh,2016,19,221,-202
NZL,New Zealand,BGD,Bangladesh,2017,64,181,-117
NOR,Norway,BGD,Bangladesh,2008,26,66,-40
NOR,Norway,BGD,Bangladesh,2009,46,87,-41
NOR,Norway,BGD,Bangladesh,2010,52,91,-39
NOR,Norway,BGD,Bangladesh,2011,29,77,-48
NOR,Norway,BGD,Bangladesh,2012,40,110,-70
NOR,Norway,BGD,Bangladesh,2013,47,89,-42
NOR,Norway,BGD,Bangladesh,2014,60,86,-26
NOR,Norway,BGD,Bangladesh,2015,45,96,-51
NOR,Norway,BGD,Bangladesh,2016,71,99,-28
NOR,Norway,BGD,Bangladesh,2017,39,169,-130
POL,Poland,BGD,Bangladesh,2008,0,74,-74
POL,Poland,BGD,Bangladesh,2009,0,85,-85
POL,Poland,BGD,Bangladesh,2010,0,75,-75
POL,Poland,BGD,Bangladesh,2011,0,110,-110
POL,Poland,BGD,Bangladesh,2012,0,116,-116
POL,Poland,BGD,Bangladesh,2013,0,138,-138
POL,Poland,BGD,Bangladesh,2014,0,122,-122
POL,Poland,BGD,Bangladesh,2015,0,208,-208
POL,Poland,BGD,Bangladesh,2016,0,330,-330
POL,Poland,BGD,Bangladesh,2017,0,591,-591
PRT,Portugal,BGD,Bangladesh,2008,0,176,-176
PRT,Portugal,BGD,Bangladesh,2009,0,218,-218
PRT,Portugal,BGD,Bangladesh,2010,0,187,-187
PRT,Portugal,BGD,Bangladesh,2011,0,332,-332
PRT,Portugal,BGD,Bangladesh,2012,0,299,-299
PRT,Portugal,BGD,Bangladesh,2013,0,518,-518
PRT,Portugal,BGD,Bangladesh,2014,0,408,-408
PRT,Portugal,BGD,Bangladesh,2015,0,657,-657
PRT,Portugal,BGD,Bangladesh,2016,0,437,-437
PRT,Portugal,BGD,Bangladesh,2017,0,737,-737
SVK,Slovak Republic,BGD,Bangladesh,2008,2,1,1
SVK,Slovak Republic,BGD,Bangladesh,2009,3,1,2
SVK,Slovak Republic,BGD,Bangladesh,2010,2,1,1
SVK,Slovak Republic,BGD,Bangladesh,2011,0,12,-12
SVK,Slovak Republic,BGD,Bangladesh,2012,0,1,-1
SVK,Slovak Republic,BGD,Bangladesh,2014,1,2,-1
SVK,Slovak Republic,BGD,Bangladesh,2017,0,1,-1
ESP,Spain,BGD,Bangladesh,2008,437,1616,-1179
ESP,Spain,BGD,Bangladesh,2009,751,1673,-922
ESP,Spain,BGD,Bangladesh,2010,1071,1409,-338
ESP,Spain,BGD,Bangladesh,2011,1652,1559,93
ESP,Spain,BGD,Bangladesh,2012,2050,1892,158
ESP,Spain,BGD,Bangladesh,2013,2141,1343,798
ESP,Spain,BGD,Bangladesh,2014,1399,1024,375
ESP,Spain,BGD,Bangladesh,2015,975,1277,-302
ESP,Spain,BGD,Bangladesh,2016,830,1673,-843
ESP,Spain,BGD,Bangladesh,2017,698,2039,-1341
SWE,Sweden,BGD,Bangladesh,2008,95,500,-405
SWE,Sweden,BGD,Bangladesh,2009,76,712,-636
SWE,Sweden,BGD,Bangladesh,2010,134,957,-823
SWE,Sweden,BGD,Bangladesh,2011,162,417,-255
SWE,Sweden,BGD,Bangladesh,2012,238,430,-192
SWE,Sweden,BGD,Bangladesh,2013,194,374,-180
SWE,Sweden,BGD,Bangladesh,2014,214,478,-264
SWE,Sweden,BGD,Bangladesh,2015,330,551,-221
SWE,Sweden,BGD,Bangladesh,2016,128,594,-466
SWE,Sweden,BGD,Bangladesh,2017,132,1004,-872
CHE,Switzerland,BGD,Bangladesh,2010,29,99,-70
CHE,Switzerland,BGD,Bangladesh,2011,39,104,-65
CHE,Switzerland,BGD,Bangladesh,2012,26,139,-113
CHE,Switzerland,BGD,Bangladesh,2013,23,114,-91
CHE,Switzerland,BGD,Bangladesh,2014,28,88,-60
CHE,Switzerland,BGD,Bangladesh,2015,29,135,-106
CHE,Switzerland,BGD,Bangladesh,2016,22,108,-86
CHE,Switzerland,BGD,Bangladesh,2017,28,101,-73
TUR,Turkey,BGD,Bangladesh,2010,0,21,-21
TUR,Turkey,BGD,Bangladesh,2016,95,187,-92
TUR,Turkey,BGD,Bangladesh,2017,113,273,-160
GBR,United Kingdom,BGD,Bangladesh,2008,0,6000,-6000
GBR,United Kingdom,BGD,Bangladesh,2009,0,13000,-13000
GBR,United Kingdom,BGD,Bangladesh,2010,0,9000,-9000
GBR,United Kingdom,BGD,Bangladesh,2011,1000,9000,-8000
GBR,United Kingdom,BGD,Bangladesh,2012,1000,2000,-1000
GBR,United Kingdom,BGD,Bangladesh,2013,1000,3000,-2000
GBR,United Kingdom,BGD,Bangladesh,2014,0,5000,-5000
GBR,United Kingdom,BGD,Bangladesh,2015,1000,2000,-1000
USA,United States,BGD,Bangladesh,2008,0,11753,-11753
USA,United States,BGD,Bangladesh,2009,0,16651,-16651
USA,United States,BGD,Bangladesh,2010,0,14819,-14819
USA,United States,BGD,Bangladesh,2011,0,16707,-16707
USA,United States,BGD,Bangladesh,2012,0,14705,-14705
USA,United States,BGD,Bangladesh,2013,0,12099,-12099
USA,United States,BGD,Bangladesh,2014,0,14645,-14645
USA,United States,BGD,Bangladesh,2015,0,13570,-13570
USA,United States,BGD,Bangladesh,2016,0,18723,-18723
USA,United States,BGD,Bangladesh,2017,0,14693,-14693
CHL,Chile,BGD,Bangladesh,2008,0,4,-4
CHL,Chile,BGD,Bangladesh,2009,0,4,-4
CHL,Chile,BGD,Bangladesh,2010,0,2,-2
CHL,Chile,BGD,Bangladesh,2011,0,2,-2
CHL,Chile,BGD,Bangladesh,2012,0,0,0
CHL,Chile,BGD,Bangladesh,2013,0,1,-1
CHL,Chile,BGD,Bangladesh,2014,0,4,-4
CHL,Chile,BGD,Bangladesh,2015,0,5,-5
CHL,Chile,BGD,Bangladesh,2016,0,14,-14
EST,Estonia,BGD,Bangladesh,2008,0,2,-2
EST,Estonia,BGD,Bangladesh,2009,0,2,-2
EST,Estonia,BGD,Bangladesh,2010,0,6,-6
EST,Estonia,BGD,Bangladesh,2011,0,2,-2
EST,Estonia,BGD,Bangladesh,2012,0,1,-1
EST,Estonia,BGD,Bangladesh,2013,0,4,-4
EST,Estonia,BGD,Bangladesh,2014,0,0,0
EST,Estonia,BGD,Bangladesh,2015,0,35,-35
EST,Estonia,BGD,Bangladesh,2016,0,49,-49
EST,Estonia,BGD,Bangladesh,2017,0,72,-72
SVN,Slovenia,BGD,Bangladesh,2008,0,1,-1
SVN,Slovenia,BGD,Bangladesh,2009,0,1,-1
SVN,Slovenia,BGD,Bangladesh,2010,0,1,-1
SVN,Slovenia,BGD,Bangladesh,2011,2,2,0
SVN,Slovenia,BGD,Bangladesh,2012,0,5,-5
SVN,Slovenia,BGD,Bangladesh,2013,0,4,-4
SVN,Slovenia,BGD,Bangladesh,2015,0,6,-6
SVN,Slovenia,BGD,Bangladesh,2016,0,6,-6
SVN,Slovenia,BGD,Bangladesh,2017,2,10,-8
AUS,Australia,BRB,Barbados,2008,0,2,-2
AUS,Australia,BRB,Barbados,2009,0,1,-1
AUS,Australia,BRB,Barbados,2010,0,1,-1
AUS,Australia,BRB,Barbados,2011,0,6,-6
AUS,Australia,BRB,Barbados,2012,0,0,0
AUS,Australia,BRB,Barbados,2013,0,4,-4
AUS,Australia,BRB,Barbados,2014,7,0,7
AUS,Australia,BRB,Barbados,2015,0,6,-6
AUS,Australia,BRB,Barbados,2016,0,5,-5
AUS,Australia,BRB,Barbados,2017,0,6,-6
AUT,Austria,BRB,Barbados,2008,4,2,2
AUT,Austria,BRB,Barbados,2009,1,0,1
AUT,Austria,BRB,Barbados,2010,2,3,-1
AUT,Austria,BRB,Barbados,2011,0,2,-2
AUT,Austria,BRB,Barbados,2012,0,2,-2
AUT,Austria,BRB,Barbados,2013,0,0,0
AUT,Austria,BRB,Barbados,2014,2,0,2
AUT,Austria,BRB,Barbados,2015,0,0,0
AUT,Austria,BRB,Barbados,2016,0,0,0
AUT,Austria,BRB,Barbados,2017,1,1,0
BEL,Belgium,BRB,Barbados,2008,0,1,-1
BEL,Belgium,BRB,Barbados,2009,0,0,0
BEL,Belgium,BRB,Barbados,2010,1,0,1
BEL,Belgium,BRB,Barbados,2015,2,1,1
BEL,Belgium,BRB,Barbados,2016,0,2,-2
BEL,Belgium,BRB,Barbados,2017,0,1,-1
CAN,Canada,BRB,Barbados,2008,0,134,-134
CAN,Canada,BRB,Barbados,2009,0,125,-125
CAN,Canada,BRB,Barbados,2010,0,121,-121
CAN,Canada,BRB,Barbados,2011,0,97,-97
CAN,Canada,BRB,Barbados,2012,0,132,-132
CAN,Canada,BRB,Barbados,2013,0,97,-97
CAN,Canada,BRB,Barbados,2014,0,133,-133
CAN,Canada,BRB,Barbados,2015,0,140,-140
CAN,Canada,BRB,Barbados,2016,0,140,-140
CAN,Canada,BRB,Barbados,2017,0,205,-205
CZE,Czech Republic,BRB,Barbados,2009,0,1,-1
CZE,Czech Republic,BRB,Barbados,2011,0,1,-1
DNK,Denmark,BRB,Barbados,2008,0,0,0
DNK,Denmark,BRB,Barbados,2009,2,1,1
DNK,Denmark,BRB,Barbados,2011,1,1,0
DNK,Denmark,BRB,Barbados,2012,0,1,-1
DNK,Denmark,BRB,Barbados,2013,0,1,-1
DNK,Denmark,BRB,Barbados,2014,0,1,-1
DNK,Denmark,BRB,Barbados,2015,0,2,-2
DNK,Denmark,BRB,Barbados,2016,1,2,-1
DNK,Denmark,BRB,Barbados,2017,0,0,0
FIN,Finland,BRB,Barbados,2008,0,2,-2
FIN,Finland,BRB,Barbados,2009,0,0,0
FIN,Finland,BRB,Barbados,2010,0,0,0
FIN,Finland,BRB,Barbados,2011,0,0,0
FIN,Finland,BRB,Barbados,2012,1,0,1
FIN,Finland,BRB,Barbados,2013,0,0,0
FIN,Finland,BRB,Barbados,2014,0,0,0
FIN,Finland,BRB,Barbados,2015,0,2,-2
FIN,Finland,BRB,Barbados,2016,0,1,-1
FIN,Finland,BRB,Barbados,2017,0,0,0
FRA,France,BRB,Barbados,2008,0,2,-2
FRA,France,BRB,Barbados,2009,0,4,-4
FRA,France,BRB,Barbados,2010,0,0,0
FRA,France,BRB,Barbados,2011,0,4,-4
FRA,France,BRB,Barbados,2012,0,5,-5
FRA,France,BRB,Barbados,2013,0,3,-3
FRA,France,BRB,Barbados,2014,0,16,-16
FRA,France,BRB,Barbados,2015,0,11,-11
FRA,France,BRB,Barbados,2016,0,12,-12
FRA,France,BRB,Barbados,2017,0,13,-13
DEU,Germany,BRB,Barbados,2008,13,8,5
DEU,Germany,BRB,Barbados,2009,16,9,7
DEU,Germany,BRB,Barbados,2010,9,5,4
DEU,Germany,BRB,Barbados,2011,2,8,-6
DEU,Germany,BRB,Barbados,2012,5,11,-6
DEU,Germany,BRB,Barbados,2013,7,16,-9
DEU,Germany,BRB,Barbados,2014,12,14,-2
DEU,Germany,BRB,Barbados,2015,6,14,-8
DEU,Germany,BRB,Barbados,2016,4,12,-8
DEU,Germany,BRB,Barbados,2017,7,13,-6
HUN,Hungary,BRB,Barbados,2008,0,1,-1
HUN,Hungary,BRB,Barbados,2009,0,0,0
HUN,Hungary,BRB,Barbados,2010,0,0,0
HUN,Hungary,BRB,Barbados,2011,0,0,0
HUN,Hungary,BRB,Barbados,2012,0,0,0
HUN,Hungary,BRB,Barbados,2013,0,0,0
HUN,Hungary,BRB,Barbados,2014,0,0,0
HUN,Hungary,BRB,Barbados,2015,0,0,0
HUN,Hungary,BRB,Barbados,2016,0,0,0
HUN,Hungary,BRB,Barbados,2017,0,0,0
ISL,Iceland,BRB,Barbados,2008,0,0,0
ISL,Iceland,BRB,Barbados,2009,0,1,-1
ISL,Iceland,BRB,Barbados,2010,1,1,0
ISL,Iceland,BRB,Barbados,2011,0,0,0
ISL,Iceland,BRB,Barbados,2012,0,0,0
ISL,Iceland,BRB,Barbados,2013,1,0,1
ISL,Iceland,BRB,Barbados,2014,0,0,0
ISL,Iceland,BRB,Barbados,2015,0,0,0
ISL,Iceland,BRB,Barbados,2016,0,0,0
ISL,Iceland,BRB,Barbados,2017,0,0,0
ITA,Italy,BRB,Barbados,2008,1,5,-4
ITA,Italy,BRB,Barbados,2009,1,0,1
ITA,Italy,BRB,Barbados,2010,0,1,-1
ITA,Italy,BRB,Barbados,2011,0,1,-1
ITA,Italy,BRB,Barbados,2012,0,0,0
ITA,Italy,BRB,Barbados,2013,0,1,-1
ITA,Italy,BRB,Barbados,2015,1,1,0
ITA,Italy,BRB,Barbados,2016,0,3,-3
ITA,Italy,BRB,Barbados,2017,0,1,-1
JPN,Japan,BRB,Barbados,2008,12,13,-1
JPN,Japan,BRB,Barbados,2009,7,8,-1
JPN,Japan,BRB,Barbados,2010,10,9,1
JPN,Japan,BRB,Barbados,2011,9,12,-3
JPN,Japan,BRB,Barbados,2012,10,10,0
JPN,Japan,BRB,Barbados,2013,14,12,2
JPN,Japan,BRB,Barbados,2014,4,7,-3
JPN,Japan,BRB,Barbados,2015,7,10,-3
JPN,Japan,BRB,Barbados,2016,5,11,-6
JPN,Japan,BRB,Barbados,2017,4,10,-6
KOR,Korea,BRB,Barbados,2008,0,0,0
KOR,Korea,BRB,Barbados,2009,1,3,-2
KOR,Korea,BRB,Barbados,2010,1,1,0
KOR,Korea,BRB,Barbados,2011,2,2,0
KOR,Korea,BRB,Barbados,2012,0,1,-1
KOR,Korea,BRB,Barbados,2013,2,1,1
KOR,Korea,BRB,Barbados,2014,1,3,-2
KOR,Korea,BRB,Barbados,2015,3,2,1
KOR,Korea,BRB,Barbados,2016,0,1,-1
KOR,Korea,BRB,Barbados,2017,1,4,-3
LUX,Luxembourg,BRB,Barbados,2008,0,0,0
LUX,Luxembourg,BRB,Barbados,2009,0,0,0
LUX,Luxembourg,BRB,Barbados,2010,0,0,0
LUX,Luxembourg,BRB,Barbados,2011,0,1,-1
LUX,Luxembourg,BRB,Barbados,2012,0,0,0
LUX,Luxembourg,BRB,Barbados,2013,0,0,0
LUX,Luxembourg,BRB,Barbados,2014,0,0,0
LUX,Luxembourg,BRB,Barbados,2015,0,1,-1
LUX,Luxembourg,BRB,Barbados,2016,0,1,-1
LUX,Luxembourg,BRB,Barbados,2017,1,0,1
MEX,Mexico,BRB,Barbados,2012,0,1,-1
MEX,Mexico,BRB,Barbados,2013,0,1,-1
MEX,Mexico,BRB,Barbados,2014,0,0,0
MEX,Mexico,BRB,Barbados,2017,0,1,-1
NLD,Netherlands,BRB,Barbados,2008,3,0,3
NLD,Netherlands,BRB,Barbados,2009,0,1,-1
NLD,Netherlands,BRB,Barbados,2010,2,1,1
NLD,Netherlands,BRB,Barbados,2011,1,3,-2
NLD,Netherlands,BRB,Barbados,2012,4,6,-2
NLD,Netherlands,BRB,Barbados,2013,2,5,-3
NLD,Netherlands,BRB,Barbados,2015,0,3,-3
NLD,Netherlands,BRB,Barbados,2016,1,7,-6
NLD,Netherlands,BRB,Barbados,2017,3,4,-1
NZL,New Zealand,BRB,Barbados,2008,0,3,-3
NZL,New Zealand,BRB,Barbados,2010,1,3,-2
NZL,New Zealand,BRB,Barbados,2012,0,4,-4
NZL,New Zealand,BRB,Barbados,2013,0,4,-4
NZL,New Zealand,BRB,Barbados,2014,0,1,-1
NZL,New Zealand,BRB,Barbados,2015,3,4,-1
NZL,New Zealand,BRB,Barbados,2016,0,3,-3
NZL,New Zealand,BRB,Barbados,2017,1,2,-1
NOR,Norway,BRB,Barbados,2008,0,0,0
NOR,Norway,BRB,Barbados,2009,1,0,1
NOR,Norway,BRB,Barbados,2010,0,1,-1
NOR,Norway,BRB,Barbados,2011,0,1,-1
NOR,Norway,BRB,Barbados,2012,0,0,0
NOR,Norway,BRB,Barbados,2013,0,0,0
NOR,Norway,BRB,Barbados,2014,1,2,-1
NOR,Norway,BRB,Barbados,2015,0,0,0
NOR,Norway,BRB,Barbados,2016,1,3,-2
NOR,Norway,BRB,Barbados,2017,0,0,0
POL,Poland,BRB,Barbados,2009,0,1,-1
POL,Poland,BRB,Barbados,2010,0,0,0
POL,Poland,BRB,Barbados,2011,0,0,0
POL,Poland,BRB,Barbados,2012,0,0,0
POL,Poland,BRB,Barbados,2013,0,0,0
POL,Poland,BRB,Barbados,2014,0,0,0
POL,Poland,BRB,Barbados,2015,0,0,0
POL,Poland,BRB,Barbados,2016,0,0,0
POL,Poland,BRB,Barbados,2017,0,0,0
SVK,Slovak Republic,BRB,Barbados,2008,0,0,0
ESP,Spain,BRB,Barbados,2008,1,0,1
ESP,Spain,BRB,Barbados,2009,0,3,-3
ESP,Spain,BRB,Barbados,2010,2,1,1
ESP,Spain,BRB,Barbados,2011,4,2,2
ESP,Spain,BRB,Barbados,2012,0,3,-3
ESP,Spain,BRB,Barbados,2013,0,4,-4
ESP,Spain,BRB,Barbados,2014,1,3,-2
ESP,Spain,BRB,Barbados,2015,1,4,-3
ESP,Spain,BRB,Barbados,2016,2,3,-1
ESP,Spain,BRB,Barbados,2017,2,4,-2
SWE,Sweden,BRB,Barbados,2008,0,3,-3
SWE,Sweden,BRB,Barbados,2009,4,3,1
SWE,Sweden,BRB,Barbados,2010,1,0,1
SWE,Sweden,BRB,Barbados,2011,0,3,-3
SWE,Sweden,BRB,Barbados,2012,0,1,-1
SWE,Sweden,BRB,Barbados,2013,2,0,2
SWE,Sweden,BRB,Barbados,2014,1,1,0
SWE,Sweden,BRB,Barbados,2015,1,2,-1
SWE,Sweden,BRB,Barbados,2016,0,5,-5
SWE,Sweden,BRB,Barbados,2017,1,2,-1
CHE,Switzerland,BRB,Barbados,2010,0,3,-3
CHE,Switzerland,BRB,Barbados,2011,2,6,-4
CHE,Switzerland,BRB,Barbados,2012,3,4,-1
CHE,Switzerland,BRB,Barbados,2013,1,1,0
CHE,Switzerland,BRB,Barbados,2014,0,1,-1
CHE,Switzerland,BRB,Barbados,2015,0,6,-6
CHE,Switzerland,BRB,Barbados,2016,2,1,1
CHE,Switzerland,BRB,Barbados,2017,0,0,0
TUR,Turkey,BRB,Barbados,2010,0,1,-1
USA,United States,BRB,Barbados,2008,0,585,-585
USA,United States,BRB,Barbados,2009,0,603,-603
USA,United States,BRB,Barbados,2010,0,465,-465
USA,United States,BRB,Barbados,2011,0,455,-455
USA,United States,BRB,Barbados,2012,0,460,-460
USA,United States,BRB,Barbados,2013,0,428,-428
USA,United States,BRB,Barbados,2014,0,384,-384
USA,United States,BRB,Barbados,2015,0,376,-376
USA,United States,BRB,Barbados,2016,0,371,-371
USA,United States,BRB,Barbados,2017,0,373,-373
CHL,Chile,BRB,Barbados,2008,0,0,0
CHL,Chile,BRB,Barbados,2009,0,0,0
CHL,Chile,BRB,Barbados,2010,0,0,0
CHL,Chile,BRB,Barbados,2011,0,0,0
CHL,Chile,BRB,Barbados,2012,0,0,0
CHL,Chile,BRB,Barbados,2013,0,0,0
CHL,Chile,BRB,Barbados,2014,0,0,0
CHL,Chile,BRB,Barbados,2015,0,0,0
CHL,Chile,BRB,Barbados,2016,0,0,0
EST,Estonia,BRB,Barbados,2008,0,0,0
EST,Estonia,BRB,Barbados,2009,0,0,0
EST,Estonia,BRB,Barbados,2010,0,0,0
EST,Estonia,BRB,Barbados,2011,0,0,0
EST,Estonia,BRB,Barbados,2012,0,0,0
EST,Estonia,BRB,Barbados,2013,0,0,0
EST,Estonia,BRB,Barbados,2014,0,0,0
EST,Estonia,BRB,Barbados,2015,0,1,-1
EST,Estonia,BRB,Barbados,2016,0,0,0
EST,Estonia,BRB,Barbados,2017,0,0,0
SVN,Slovenia,BRB,Barbados,2017,0,1,-1
AUS,Australia,BLR,Belarus,2008,12,41,-29
AUS,Australia,BLR,Belarus,2009,6,69,-63
AUS,Australia,BLR,Belarus,2010,10,47,-37
AUS,Australia,BLR,Belarus,2011,12,60,-48
AUS,Australia,BLR,Belarus,2012,16,37,-21
AUS,Australia,BLR,Belarus,2013,13,73,-60
AUS,Australia,BLR,Belarus,2014,12,101,-89
AUS,Australia,BLR,Belarus,2015,0,56,-56
AUS,Australia,BLR,Belarus,2016,0,56,-56
AUS,Australia,BLR,Belarus,2017,0,66,-66
AUT,Austria,BLR,Belarus,2008,100,154,-54
AUT,Austria,BLR,Belarus,2009,110,155,-45
AUT,Austria,BLR,Belarus,2010,108,111,-3
AUT,Austria,BLR,Belarus,2011,78,135,-57
AUT,Austria,BLR,Belarus,2012,75,176,-101
AUT,Austria,BLR,Belarus,2013,93,185,-92
AUT,Austria,BLR,Belarus,2014,83,218,-135
AUT,Austria,BLR,Belarus,2015,100,197,-97
AUT,Austria,BLR,Belarus,2016,120,166,-46
AUT,Austria,BLR,Belarus,2017,107,173,-66
BEL,Belgium,BLR,Belarus,2008,0,135,-135
BEL,Belgium,BLR,Belarus,2009,0,123,-123
BEL,Belgium,BLR,Belarus,2010,40,118,-78
BEL,Belgium,BLR,Belarus,2011,0,103,-103
BEL,Belgium,BLR,Belarus,2012,69,158,-89
BEL,Belgium,BLR,Belarus,2013,108,149,-41
BEL,Belgium,BLR,Belarus,2014,66,95,-29
BEL,Belgium,BLR,Belarus,2015,60,93,-33
BEL,Belgium,BLR,Belarus,2016,39,88,-49
BEL,Belgium,BLR,Belarus,2017,47,95,-48
CAN,Canada,BLR,Belarus,2008,0,524,-524
CAN,Canada,BLR,Belarus,2009,0,454,-454
CAN,Canada,BLR,Belarus,2010,0,438,-438
CAN,Canada,BLR,Belarus,2011,0,357,-357
CAN,Canada,BLR,Belarus,2012,0,277,-277
CAN,Canada,BLR,Belarus,2013,0,247,-247
CAN,Canada,BLR,Belarus,2014,0,175,-175
CAN,Canada,BLR,Belarus,2015,0,214,-214
CAN,Canada,BLR,Belarus,2016,0,360,-360
CAN,Canada,BLR,Belarus,2017,0,310,-310
CZE,Czech Republic,BLR,Belarus,2008,23,647,-624
CZE,Czech Republic,BLR,Belarus,2009,9,427,-418
CZE,Czech Republic,BLR,Belarus,2010,3,251,-248
CZE,Czech Republic,BLR,Belarus,2011,7,237,-230
CZE,Czech Republic,BLR,Belarus,2012,170,373,-203
CZE,Czech Republic,BLR,Belarus,2013,329,387,-58
CZE,Czech Republic,BLR,Belarus,2014,171,485,-314
CZE,Czech Republic,BLR,Belarus,2015,193,342,-149
CZE,Czech Republic,BLR,Belarus,2016,177,421,-244
CZE,Czech Republic,BLR,Belarus,2017,181,657,-476
DNK,Denmark,BLR,Belarus,2008,16,65,-49
DNK,Denmark,BLR,Belarus,2009,59,66,-7
DNK,Denmark,BLR,Belarus,2010,44,62,-18
DNK,Denmark,BLR,Belarus,2011,34,44,-10
DNK,Denmark,BLR,Belarus,2012,36,38,-2
DNK,Denmark,BLR,Belarus,2013,24,38,-14
DNK,Denmark,BLR,Belarus,2014,23,39,-16
DNK,Denmark,BLR,Belarus,2015,20,46,-26
DNK,Denmark,BLR,Belarus,2016,31,31,0
DNK,Denmark,BLR,Belarus,2017,25,28,-3
FIN,Finland,BLR,Belarus,2008,9,53,-44
FIN,Finland,BLR,Belarus,2009,3,39,-36
FIN,Finland,BLR,Belarus,2010,9,22,-13
FIN,Finland,BLR,Belarus,2011,3,38,-35
FIN,Finland,BLR,Belarus,2012,2,43,-41
FIN,Finland,BLR,Belarus,2013,6,34,-28
FIN,Finland,BLR,Belarus,2014,8,59,-51
FIN,Finland,BLR,Belarus,2015,3,42,-39
FIN,Finland,BLR,Belarus,2016,8,53,-45
FIN,Finland,BLR,Belarus,2017,13,55,-42
FRA,France,BLR,Belarus,2008,0,267,-267
FRA,France,BLR,Belarus,2009,0,245,-245
FRA,France,BLR,Belarus,2010,0,232,-232
FRA,France,BLR,Belarus,2011,0,214,-214
FRA,France,BLR,Belarus,2012,0,235,-235
FRA,France,BLR,Belarus,2013,0,231,-231
FRA,France,BLR,Belarus,2014,0,237,-237
FRA,France,BLR,Belarus,2015,0,223,-223
FRA,France,BLR,Belarus,2016,0,209,-209
FRA,France,BLR,Belarus,2017,0,214,-214
DEU,Germany,BLR,Belarus,2008,1292,1483,-191
DEU,Germany,BLR,Belarus,2009,1124,1363,-239
DEU,Germany,BLR,Belarus,2010,946,1354,-408
DEU,Germany,BLR,Belarus,2011,780,1435,-655
DEU,Germany,BLR,Belarus,2012,804,1647,-843
DEU,Germany,BLR,Belarus,2013,850,1638,-788
DEU,Germany,BLR,Belarus,2014,869,1707,-838
DEU,Germany,BLR,Belarus,2015,840,2021,-1181
DEU,Germany,BLR,Belarus,2016,872,1943,-1071
DEU,Germany,BLR,Belarus,2017,1021,1938,-917
HUN,Hungary,BLR,Belarus,2008,0,26,-26
HUN,Hungary,BLR,Belarus,2009,1,29,-28
HUN,Hungary,BLR,Belarus,2010,5,29,-24
HUN,Hungary,BLR,Belarus,2011,4,36,-32
HUN,Hungary,BLR,Belarus,2012,5,34,-29
HUN,Hungary,BLR,Belarus,2013,3,49,-46
HUN,Hungary,BLR,Belarus,2014,1,43,-42
HUN,Hungary,BLR,Belarus,2015,15,53,-38
HUN,Hungary,BLR,Belarus,2016,12,51,-39
HUN,Hungary,BLR,Belarus,2017,0,90,-90
ISL,Iceland,BLR,Belarus,2008,6,2,4
ISL,Iceland,BLR,Belarus,2009,3,3,0
ISL,Iceland,BLR,Belarus,2010,2,2,0
ISL,Iceland,BLR,Belarus,2011,0,1,-1
ISL,Iceland,BLR,Belarus,2012,1,1,0
ISL,Iceland,BLR,Belarus,2013,1,2,-1
ISL,Iceland,BLR,Belarus,2014,2,3,-1
ISL,Iceland,BLR,Belarus,2015,1,5,-4
ISL,Iceland,BLR,Belarus,2016,4,4,0
ISL,Iceland,BLR,Belarus,2017,3,7,-4
ITA,Italy,BLR,Belarus,2008,18,959,-941
ITA,Italy,BLR,Belarus,2009,23,949,-926
ITA,Italy,BLR,Belarus,2010,46,1296,-1250
ITA,Italy,BLR,Belarus,2011,41,988,-947
ITA,Italy,BLR,Belarus,2012,64,813,-749
ITA,Italy,BLR,Belarus,2013,68,698,-630
ITA,Italy,BLR,Belarus,2014,71,590,-519
ITA,Italy,BLR,Belarus,2015,70,545,-475
ITA,Italy,BLR,Belarus,2016,0,522,-522
ITA,Italy,BLR,Belarus,2017,68,551,-483
JPN,Japan,BLR,Belarus,2008,115,134,-19
JPN,Japan,BLR,Belarus,2009,89,104,-15
JPN,Japan,BLR,Belarus,2010,100,112,-12
JPN,Japan,BLR,Belarus,2011,98,120,-22
JPN,Japan,BLR,Belarus,2012,194,206,-12
JPN,Japan,BLR,Belarus,2013,121,129,-8
JPN,Japan,BLR,Belarus,2014,93,118,-25
JPN,Japan,BLR,Belarus,2015,126,143,-17
JPN,Japan,BLR,Belarus,2016,119,166,-47
JPN,Japan,BLR,Belarus,2017,109,151,-42
KOR,Korea,BLR,Belarus,2008,77,46,31
KOR,Korea,BLR,Belarus,2009,53,55,-2
KOR,Korea,BLR,Belarus,2010,66,48,18
KOR,Korea,BLR,Belarus,2011,40,58,-18
KOR,Korea,BLR,Belarus,2012,70,63,7
KOR,Korea,BLR,Belarus,2013,56,53,3
KOR,Korea,BLR,Belarus,2014,56,57,-1
KOR,Korea,BLR,Belarus,2015,66,85,-19
KOR,Korea,BLR,Belarus,2016,86,91,-5
KOR,Korea,BLR,Belarus,2017,80,106,-26
LUX,Luxembourg,BLR,Belarus,2008,14,15,-1
LUX,Luxembourg,BLR,Belarus,2009,9,28,-19
LUX,Luxembourg,BLR,Belarus,2010,3,19,-16
LUX,Luxembourg,BLR,Belarus,2011,8,19,-11
LUX,Luxembourg,BLR,Belarus,2012,16,27,-11
LUX,Luxembourg,BLR,Belarus,2013,11,30,-19
LUX,Luxembourg,BLR,Belarus,2014,16,20,-4
LUX,Luxembourg,BLR,Belarus,2015,6,24,-18
LUX,Luxembourg,BLR,Belarus,2016,19,26,-7
LUX,Luxembourg,BLR,Belarus,2017,15,31,-16
MEX,Mexico,BLR,Belarus,2008,0,2,-2
MEX,Mexico,BLR,Belarus,2009,0,3,-3
MEX,Mexico,BLR,Belarus,2010,0,7,-7
MEX,Mexico,BLR,Belarus,2011,0,8,-8
MEX,Mexico,BLR,Belarus,2012,0,2,-2
MEX,Mexico,BLR,Belarus,2013,0,17,-17
MEX,Mexico,BLR,Belarus,2014,0,10,-10
MEX,Mexico,BLR,Belarus,2015,0,12,-12
MEX,Mexico,BLR,Belarus,2016,0,11,-11
MEX,Mexico,BLR,Belarus,2017,0,14,-14
NLD,Netherlands,BLR,Belarus,2008,41,115,-74
NLD,Netherlands,BLR,Belarus,2009,36,113,-77
NLD,Netherlands,BLR,Belarus,2010,48,111,-63
NLD,Netherlands,BLR,Belarus,2011,44,127,-83
NLD,Netherlands,BLR,Belarus,2012,40,117,-77
NLD,Netherlands,BLR,Belarus,2013,55,111,-56
NLD,Netherlands,BLR,Belarus,2014,42,171,-129
NLD,Netherlands,BLR,Belarus,2015,51,150,-99
NLD,Netherlands,BLR,Belarus,2016,48,185,-137
NLD,Netherlands,BLR,Belarus,2017,64,192,-128
NZL,New Zealand,BLR,Belarus,2008,3,10,-7
NZL,New Zealand,BLR,Belarus,2009,0,10,-10
NZL,New Zealand,BLR,Belarus,2010,2,2,0
NZL,New Zealand,BLR,Belarus,2011,2,17,-15
NZL,New Zealand,BLR,Belarus,2012,0,7,-7
NZL,New Zealand,BLR,Belarus,2013,2,17,-15
NZL,New Zealand,BLR,Belarus,2014,6,18,-12
NZL,New Zealand,BLR,Belarus,2015,0,16,-16
NZL,New Zealand,BLR,Belarus,2016,8,20,-12
NZL,New Zealand,BLR,Belarus,2017,1,30,-29
NOR,Norway,BLR,Belarus,2008,22,78,-56
NOR,Norway,BLR,Belarus,2009,18,75,-57
NOR,Norway,BLR,Belarus,2010,26,64,-38
NOR,Norway,BLR,Belarus,2011,27,88,-61
NOR,Norway,BLR,Belarus,2012,16,97,-81
NOR,Norway,BLR,Belarus,2013,24,76,-52
NOR,Norway,BLR,Belarus,2014,23,59,-36
NOR,Norway,BLR,Belarus,2015,24,48,-24
NOR,Norway,BLR,Belarus,2016,35,51,-16
NOR,Norway,BLR,Belarus,2017,14,80,-66
POL,Poland,BLR,Belarus,2008,0,3077,-3077
POL,Poland,BLR,Belarus,2009,0,3154,-3154
POL,Poland,BLR,Belarus,2010,0,2920,-2920
POL,Poland,BLR,Belarus,2011,0,2515,-2515
POL,Poland,BLR,Belarus,2012,0,2618,-2618
POL,Poland,BLR,Belarus,2013,0,2338,-2338
POL,Poland,BLR,Belarus,2014,0,1415,-1415
POL,Poland,BLR,Belarus,2015,0,3178,-3178
POL,Poland,BLR,Belarus,2016,0,3499,-3499
POL,Poland,BLR,Belarus,2017,0,6192,-6192
SVK,Slovak Republic,BLR,Belarus,2008,1,9,-8
SVK,Slovak Republic,BLR,Belarus,2009,4,6,-2
SVK,Slovak Republic,BLR,Belarus,2010,4,3,1
SVK,Slovak Republic,BLR,Belarus,2011,10,4,6
SVK,Slovak Republic,BLR,Belarus,2012,0,4,-4
SVK,Slovak Republic,BLR,Belarus,2013,0,5,-5
SVK,Slovak Republic,BLR,Belarus,2014,2,4,-2
SVK,Slovak Republic,BLR,Belarus,2015,0,6,-6
SVK,Slovak Republic,BLR,Belarus,2016,1,2,-1
SVK,Slovak Republic,BLR,Belarus,2017,0,7,-7
ESP,Spain,BLR,Belarus,2008,172,341,-169
ESP,Spain,BLR,Belarus,2009,230,226,4
ESP,Spain,BLR,Belarus,2010,208,234,-26
ESP,Spain,BLR,Belarus,2011,185,304,-119
ESP,Spain,BLR,Belarus,2012,119,273,-154
ESP,Spain,BLR,Belarus,2013,167,335,-168
ESP,Spain,BLR,Belarus,2014,81,381,-300
ESP,Spain,BLR,Belarus,2015,89,343,-254
ESP,Spain,BLR,Belarus,2016,128,494,-366
ESP,Spain,BLR,Belarus,2017,235,556,-321
SWE,Sweden,BLR,Belarus,2008,17,166,-149
SWE,Sweden,BLR,Belarus,2009,11,247,-236
SWE,Sweden,BLR,Belarus,2010,20,215,-195
SWE,Sweden,BLR,Belarus,2011,24,240,-216
SWE,Sweden,BLR,Belarus,2012,34,239,-205
SWE,Sweden,BLR,Belarus,2013,20,156,-136
SWE,Sweden,BLR,Belarus,2014,33,174,-141
SWE,Sweden,BLR,Belarus,2015,72,158,-86
SWE,Sweden,BLR,Belarus,2016,30,162,-132
SWE,Sweden,BLR,Belarus,2017,22,169,-147
CHE,Switzerland,BLR,Belarus,2010,32,153,-121
CHE,Switzerland,BLR,Belarus,2011,29,140,-111
CHE,Switzerland,BLR,Belarus,2012,38,149,-111
CHE,Switzerland,BLR,Belarus,2013,68,125,-57
CHE,Switzerland,BLR,Belarus,2014,38,127,-89
CHE,Switzerland,BLR,Belarus,2015,40,112,-72
CHE,Switzerland,BLR,Belarus,2016,50,102,-52
CHE,Switzerland,BLR,Belarus,2017,35,91,-56
TUR,Turkey,BLR,Belarus,2010,0,107,-107
TUR,Turkey,BLR,Belarus,2016,249,564,-315
TUR,Turkey,BLR,Belarus,2017,323,609,-286
USA,United States,BLR,Belarus,2008,0,2390,-2390
USA,United States,BLR,Belarus,2009,0,2407,-2407
USA,United States,BLR,Belarus,2010,0,2038,-2038
USA,United States,BLR,Belarus,2011,0,1964,-1964
USA,United States,BLR,Belarus,2012,0,1659,-1659
USA,United States,BLR,Belarus,2013,0,1970,-1970
USA,United States,BLR,Belarus,2014,0,2015,-2015
USA,United States,BLR,Belarus,2015,0,1994,-1994
USA,United States,BLR,Belarus,2016,0,2127,-2127
USA,United States,BLR,Belarus,2017,0,1919,-1919
CHL,Chile,BLR,Belarus,2008,0,6,-6
CHL,Chile,BLR,Belarus,2009,0,9,-9
CHL,Chile,BLR,Belarus,2010,0,12,-12
CHL,Chile,BLR,Belarus,2011,0,16,-16
CHL,Chile,BLR,Belarus,2012,0,12,-12
CHL,Chile,BLR,Belarus,2013,0,7,-7
CHL,Chile,BLR,Belarus,2014,0,2,-2
CHL,Chile,BLR,Belarus,2015,0,22,-22
CHL,Chile,BLR,Belarus,2016,0,10,-10
EST,Estonia,BLR,Belarus,2008,0,36,-36
EST,Estonia,BLR,Belarus,2009,0,35,-35
EST,Estonia,BLR,Belarus,2010,0,19,-19
EST,Estonia,BLR,Belarus,2011,0,50,-50
EST,Estonia,BLR,Belarus,2012,0,35,-35
EST,Estonia,BLR,Belarus,2013,0,50,-50
EST,Estonia,BLR,Belarus,2014,0,45,-45
EST,Estonia,BLR,Belarus,2015,0,91,-91
EST,Estonia,BLR,Belarus,2016,0,118,-118
EST,Estonia,BLR,Belarus,2017,0,133,-133
SVN,Slovenia,BLR,Belarus,2008,0,26,-26
SVN,Slovenia,BLR,Belarus,2009,0,9,-9
SVN,Slovenia,BLR,Belarus,2010,0,1,-1
SVN,Slovenia,BLR,Belarus,2011,1,22,-21
SVN,Slovenia,BLR,Belarus,2012,2,20,-18
SVN,Slovenia,BLR,Belarus,2013,0,18,-18
SVN,Slovenia,BLR,Belarus,2014,1,10,-9
SVN,Slovenia,BLR,Belarus,2015,2,21,-19
SVN,Slovenia,BLR,Belarus,2016,2,21,-19
SVN,Slovenia,BLR,Belarus,2017,1,25,-24
ISL,Iceland,BEL,Belgium,2011,0,9,-9
NZL,New Zealand,BEL,Belgium,2011,0,122,-122
AUS,Australia,BLZ,Belize,2008,0,2,-2
AUS,Australia,BLZ,Belize,2009,0,1,-1
AUS,Australia,BLZ,Belize,2010,0,0,0
AUS,Australia,BLZ,Belize,2011,0,0,0
AUS,Australia,BLZ,Belize,2012,0,2,-2
AUS,Australia,BLZ,Belize,2013,0,2,-2
AUS,Australia,BLZ,Belize,2014,0,0,0
AUS,Australia,BLZ,Belize,2015,0,0,0
AUS,Australia,BLZ,Belize,2017,0,0,0
AUT,Austria,BLZ,Belize,2008,3,4,-1
AUT,Austria,BLZ,Belize,2009,2,0,2
AUT,Austria,BLZ,Belize,2010,1,1,0
AUT,Austria,BLZ,Belize,2011,1,0,1
AUT,Austria,BLZ,Belize,2012,0,0,0
AUT,Austria,BLZ,Belize,2013,1,0,1
AUT,Austria,BLZ,Belize,2014,1,1,0
AUT,Austria,BLZ,Belize,2015,1,3,-2
AUT,Austria,BLZ,Belize,2016,2,0,2
AUT,Austria,BLZ,Belize,2017,0,0,0
BEL,Belgium,BLZ,Belize,2008,0,1,-1
BEL,Belgium,BLZ,Belize,2009,0,0,0
BEL,Belgium,BLZ,Belize,2010,0,0,0
BEL,Belgium,BLZ,Belize,2013,1,1,0
BEL,Belgium,BLZ,Belize,2014,0,2,-2
BEL,Belgium,BLZ,Belize,2017,1,1,0
CAN,Canada,BLZ,Belize,2008,0,48,-48
CAN,Canada,BLZ,Belize,2009,0,38,-38
CAN,Canada,BLZ,Belize,2010,0,39,-39
CAN,Canada,BLZ,Belize,2011,0,35,-35
CAN,Canada,BLZ,Belize,2012,0,33,-33
CAN,Canada,BLZ,Belize,2013,0,53,-53
CAN,Canada,BLZ,Belize,2014,0,53,-53
CAN,Canada,BLZ,Belize,2015,0,27,-27
CAN,Canada,BLZ,Belize,2016,0,65,-65
CAN,Canada,BLZ,Belize,2017,0,80,-80
CZE,Czech Republic,BLZ,Belize,2016,0,2,-2
DNK,Denmark,BLZ,Belize,2008,0,0,0
DNK,Denmark,BLZ,Belize,2009,0,2,-2
DNK,Denmark,BLZ,Belize,2012,0,0,0
DNK,Denmark,BLZ,Belize,2013,0,1,-1
DNK,Denmark,BLZ,Belize,2014,0,0,0
DNK,Denmark,BLZ,Belize,2015,1,1,0
DNK,Denmark,BLZ,Belize,2016,0,1,-1
DNK,Denmark,BLZ,Belize,2017,0,0,0
FIN,Finland,BLZ,Belize,2008,0,0,0
FIN,Finland,BLZ,Belize,2009,0,0,0
FIN,Finland,BLZ,Belize,2010,0,0,0
FIN,Finland,BLZ,Belize,2011,0,0,0
FIN,Finland,BLZ,Belize,2012,0,0,0
FIN,Finland,BLZ,Belize,2013,0,0,0
FIN,Finland,BLZ,Belize,2014,0,0,0
FIN,Finland,BLZ,Belize,2015,0,0,0
FIN,Finland,BLZ,Belize,2016,1,0,1
FIN,Finland,BLZ,Belize,2017,0,0,0
FRA,France,BLZ,Belize,2008,0,0,0
FRA,France,BLZ,Belize,2009,0,1,-1
FRA,France,BLZ,Belize,2010,0,1,-1
FRA,France,BLZ,Belize,2011,0,0,0
FRA,France,BLZ,Belize,2012,0,1,-1
FRA,France,BLZ,Belize,2013,0,1,-1
FRA,France,BLZ,Belize,2014,0,1,-1
FRA,France,BLZ,Belize,2015,0,3,-3
FRA,France,BLZ,Belize,2016,0,0,0
FRA,France,BLZ,Belize,2017,0,0,0
DEU,Germany,BLZ,Belize,2008,1,2,-1
DEU,Germany,BLZ,Belize,2009,4,5,-1
DEU,Germany,BLZ,Belize,2010,8,11,-3
DEU,Germany,BLZ,Belize,2011,6,7,-1
DEU,Germany,BLZ,Belize,2012,2,5,-3
DEU,Germany,BLZ,Belize,2013,1,6,-5
DEU,Germany,BLZ,Belize,2014,5,7,-2
DEU,Germany,BLZ,Belize,2015,5,9,-4
DEU,Germany,BLZ,Belize,2016,7,11,-4
DEU,Germany,BLZ,Belize,2017,6,9,-3
HUN,Hungary,BLZ,Belize,2008,0,0,0
HUN,Hungary,BLZ,Belize,2009,0,1,-1
HUN,Hungary,BLZ,Belize,2010,0,0,0
HUN,Hungary,BLZ,Belize,2011,0,0,0
HUN,Hungary,BLZ,Belize,2012,0,0,0
HUN,Hungary,BLZ,Belize,2013,0,0,0
HUN,Hungary,BLZ,Belize,2014,0,1,-1
HUN,Hungary,BLZ,Belize,2015,0,0,0
HUN,Hungary,BLZ,Belize,2016,0,0,0
HUN,Hungary,BLZ,Belize,2017,0,0,0
ISL,Iceland,BLZ,Belize,2008,0,0,0
ISL,Iceland,BLZ,Belize,2009,0,1,-1
ISL,Iceland,BLZ,Belize,2010,1,0,1
ISL,Iceland,BLZ,Belize,2011,0,0,0
ISL,Iceland,BLZ,Belize,2012,0,0,0
ISL,Iceland,BLZ,Belize,2013,0,0,0
ISL,Iceland,BLZ,Belize,2014,0,0,0
ISL,Iceland,BLZ,Belize,2015,0,0,0
ISL,Iceland,BLZ,Belize,2016,0,0,0
ISL,Iceland,BLZ,Belize,2017,0,0,0
ITA,Italy,BLZ,Belize,2008,0,3,-3
ITA,Italy,BLZ,Belize,2009,0,1,-1
ITA,Italy,BLZ,Belize,2010,0,2,-2
ITA,Italy,BLZ,Belize,2011,0,2,-2
ITA,Italy,BLZ,Belize,2012,0,3,-3
ITA,Italy,BLZ,Belize,2013,0,0,0
ITA,Italy,BLZ,Belize,2014,2,1,1
ITA,Italy,BLZ,Belize,2015,0,3,-3
ITA,Italy,BLZ,Belize,2016,0,3,-3
ITA,Italy,BLZ,Belize,2017,1,2,-1
JPN,Japan,BLZ,Belize,2008,15,18,-3
JPN,Japan,BLZ,Belize,2009,20,21,-1
JPN,Japan,BLZ,Belize,2010,26,27,-1
JPN,Japan,BLZ,Belize,2011,8,8,0
JPN,Japan,BLZ,Belize,2012,15,17,-2
JPN,Japan,BLZ,Belize,2013,22,24,-2
JPN,Japan,BLZ,Belize,2014,21,23,-2
JPN,Japan,BLZ,Belize,2015,11,12,-1
JPN,Japan,BLZ,Belize,2016,14,13,1
JPN,Japan,BLZ,Belize,2017,20,20,0
KOR,Korea,BLZ,Belize,2008,1,7,-6
KOR,Korea,BLZ,Belize,2009,4,2,2
KOR,Korea,BLZ,Belize,2010,1,3,-2
KOR,Korea,BLZ,Belize,2011,3,5,-2
KOR,Korea,BLZ,Belize,2012,3,6,-3
KOR,Korea,BLZ,Belize,2013,3,7,-4
KOR,Korea,BLZ,Belize,2014,4,2,2
KOR,Korea,BLZ,Belize,2015,5,2,3
KOR,Korea,BLZ,Belize,2016,4,2,2
KOR,Korea,BLZ,Belize,2017,1,3,-2
LUX,Luxembourg,BLZ,Belize,2008,0,0,0
LUX,Luxembourg,BLZ,Belize,2009,0,0,0
LUX,Luxembourg,BLZ,Belize,2010,0,0,0
LUX,Luxembourg,BLZ,Belize,2011,0,0,0
LUX,Luxembourg,BLZ,Belize,2012,1,0,1
LUX,Luxembourg,BLZ,Belize,2013,0,0,0
LUX,Luxembourg,BLZ,Belize,2014,0,0,0
LUX,Luxembourg,BLZ,Belize,2015,0,0,0
LUX,Luxembourg,BLZ,Belize,2016,0,0,0
LUX,Luxembourg,BLZ,Belize,2017,0,0,0
MEX,Mexico,BLZ,Belize,2008,0,43,-43
MEX,Mexico,BLZ,Belize,2009,0,74,-74
MEX,Mexico,BLZ,Belize,2010,0,113,-113
MEX,Mexico,BLZ,Belize,2011,0,79,-79
MEX,Mexico,BLZ,Belize,2012,0,65,-65
MEX,Mexico,BLZ,Belize,2013,0,217,-217
MEX,Mexico,BLZ,Belize,2014,0,162,-162
MEX,Mexico,BLZ,Belize,2015,0,83,-83
MEX,Mexico,BLZ,Belize,2016,0,79,-79
MEX,Mexico,BLZ,Belize,2017,0,61,-61
NLD,Netherlands,BLZ,Belize,2008,1,4,-3
NLD,Netherlands,BLZ,Belize,2009,1,1,0
NLD,Netherlands,BLZ,Belize,2011,0,1,-1
NLD,Netherlands,BLZ,Belize,2012,0,1,-1
NLD,Netherlands,BLZ,Belize,2013,3,1,2
NLD,Netherlands,BLZ,Belize,2014,1,2,-1
NLD,Netherlands,BLZ,Belize,2015,0,1,-1
NLD,Netherlands,BLZ,Belize,2016,1,2,-1
NLD,Netherlands,BLZ,Belize,2017,2,2,0
NZL,New Zealand,BLZ,Belize,2008,0,0,0
NZL,New Zealand,BLZ,Belize,2009,0,1,-1
NZL,New Zealand,BLZ,Belize,2013,1,1,0
NZL,New Zealand,BLZ,Belize,2017,0,3,-3
NOR,Norway,BLZ,Belize,2008,0,3,-3
NOR,Norway,BLZ,Belize,2009,1,2,-1
NOR,Norway,BLZ,Belize,2010,0,2,-2
NOR,Norway,BLZ,Belize,2011,0,1,-1
NOR,Norway,BLZ,Belize,2012,1,1,0
NOR,Norway,BLZ,Belize,2013,2,2,0
NOR,Norway,BLZ,Belize,2014,0,0,0
NOR,Norway,BLZ,Belize,2015,0,0,0
NOR,Norway,BLZ,Belize,2016,0,1,-1
NOR,Norway,BLZ,Belize,2017,0,1,-1
POL,Poland,BLZ,Belize,2009,0,0,0
POL,Poland,BLZ,Belize,2010,0,1,-1
POL,Poland,BLZ,Belize,2011,0,1,-1
POL,Poland,BLZ,Belize,2012,0,0,0
POL,Poland,BLZ,Belize,2013,0,0,0
POL,Poland,BLZ,Belize,2014,0,1,-1
POL,Poland,BLZ,Belize,2015,0,1,-1
POL,Poland,BLZ,Belize,2016,0,1,-1
POL,Poland,BLZ,Belize,2017,0,1,-1
SVK,Slovak Republic,BLZ,Belize,2008,0,0,0
SVK,Slovak Republic,BLZ,Belize,2010,0,1,-1
ESP,Spain,BLZ,Belize,2008,2,0,2
ESP,Spain,BLZ,Belize,2009,1,2,-1
ESP,Spain,BLZ,Belize,2010,0,3,-3
ESP,Spain,BLZ,Belize,2011,2,2,0
ESP,Spain,BLZ,Belize,2012,0,4,-4
ESP,Spain,BLZ,Belize,2013,2,4,-2
ESP,Spain,BLZ,Belize,2014,0,1,-1
ESP,Spain,BLZ,Belize,2015,2,3,-1
ESP,Spain,BLZ,Belize,2016,1,1,0
ESP,Spain,BLZ,Belize,2017,2,11,-9
SWE,Sweden,BLZ,Belize,2008,0,2,-2
SWE,Sweden,BLZ,Belize,2009,0,3,-3
SWE,Sweden,BLZ,Belize,2010,0,1,-1
SWE,Sweden,BLZ,Belize,2011,0,1,-1
SWE,Sweden,BLZ,Belize,2012,0,1,-1
SWE,Sweden,BLZ,Belize,2013,0,3,-3
SWE,Sweden,BLZ,Belize,2014,2,3,-1
SWE,Sweden,BLZ,Belize,2015,4,2,2
SWE,Sweden,BLZ,Belize,2016,1,1,0
SWE,Sweden,BLZ,Belize,2017,0,1,-1
CHE,Switzerland,BLZ,Belize,2010,0,2,-2
CHE,Switzerland,BLZ,Belize,2011,1,1,0
CHE,Switzerland,BLZ,Belize,2012,0,2,-2
CHE,Switzerland,BLZ,Belize,2013,0,0,0
CHE,Switzerland,BLZ,Belize,2014,1,1,0
CHE,Switzerland,BLZ,Belize,2015,1,0,1
CHE,Switzerland,BLZ,Belize,2016,0,7,-7
CHE,Switzerland,BLZ,Belize,2017,3,0,3
TUR,Turkey,BLZ,Belize,2010,0,1,-1
USA,United States,BLZ,Belize,2008,0,1077,-1077
USA,United States,BLZ,Belize,2009,0,1041,-1041
USA,United States,BLZ,Belize,2010,0,965,-965
USA,United States,BLZ,Belize,2011,0,905,-905
USA,United States,BLZ,Belize,2012,0,847,-847
USA,United States,BLZ,Belize,2013,0,946,-946
USA,United States,BLZ,Belize,2014,0,789,-789
USA,United States,BLZ,Belize,2015,0,772,-772
USA,United States,BLZ,Belize,2016,0,851,-851
USA,United States,BLZ,Belize,2017,0,746,-746
CHL,Chile,BLZ,Belize,2008,0,1,-1
CHL,Chile,BLZ,Belize,2009,0,0,0
CHL,Chile,BLZ,Belize,2010,0,1,-1
CHL,Chile,BLZ,Belize,2011,0,2,-2
CHL,Chile,BLZ,Belize,2012,0,4,-4
CHL,Chile,BLZ,Belize,2013,0,0,0
CHL,Chile,BLZ,Belize,2014,0,6,-6
CHL,Chile,BLZ,Belize,2015,0,4,-4
CHL,Chile,BLZ,Belize,2016,0,2,-2
EST,Estonia,BLZ,Belize,2008,0,0,0
EST,Estonia,BLZ,Belize,2009,0,0,0
EST,Estonia,BLZ,Belize,2010,0,0,0
EST,Estonia,BLZ,Belize,2011,0,0,0
EST,Estonia,BLZ,Belize,2012,0,0,0
EST,Estonia,BLZ,Belize,2013,0,0,0
EST,Estonia,BLZ,Belize,2014,0,0,0
EST,Estonia,BLZ,Belize,2015,0,0,0
EST,Estonia,BLZ,Belize,2016,0,0,0
EST,Estonia,BLZ,Belize,2017,0,0,0
SVN,Slovenia,BLZ,Belize,2009,0,1,-1
SVN,Slovenia,BLZ,Belize,2010,0,1,-1
AUS,Australia,BEN,Benin,2008,0,0,0
AUS,Australia,BEN,Benin,2009,0,0,0
AUS,Australia,BEN,Benin,2010,0,0,0
AUS,Australia,BEN,Benin,2011,0,2,-2
AUS,Australia,BEN,Benin,2012,0,8,-8
AUS,Australia,BEN,Benin,2013,0,4,-4
AUS,Australia,BEN,Benin,2014,0,0,0
AUS,Australia,BEN,Benin,2015,0,0,0
AUS,Australia,BEN,Benin,2016,0,0,0
AUS,Australia,BEN,Benin,2017,0,0,0
AUT,Austria,BEN,Benin,2008,4,7,-3
AUT,Austria,BEN,Benin,2009,5,6,-1
AUT,Austria,BEN,Benin,2010,5,6,-1
AUT,Austria,BEN,Benin,2011,8,8,0
AUT,Austria,BEN,Benin,2012,5,11,-6
AUT,Austria,BEN,Benin,2013,7,13,-6
AUT,Austria,BEN,Benin,2014,10,29,-19
AUT,Austria,BEN,Benin,2015,4,32,-28
AUT,Austria,BEN,Benin,2016,15,23,-8
AUT,Austria,BEN,Benin,2017,18,27,-9
BEL,Belgium,BEN,Benin,2008,0,96,-96
BEL,Belgium,BEN,Benin,2009,0,110,-110
BEL,Belgium,BEN,Benin,2010,52,140,-88
BEL,Belgium,BEN,Benin,2011,0,145,-145
BEL,Belgium,BEN,Benin,2012,74,211,-137
BEL,Belgium,BEN,Benin,2013,123,174,-51
BEL,Belgium,BEN,Benin,2014,114,106,8
BEL,Belgium,BEN,Benin,2015,97,111,-14
BEL,Belgium,BEN,Benin,2016,67,126,-59
BEL,Belgium,BEN,Benin,2017,52,138,-86
CAN,Canada,BEN,Benin,2008,0,205,-205
CAN,Canada,BEN,Benin,2009,0,238,-238
CAN,Canada,BEN,Benin,2010,0,290,-290
CAN,Canada,BEN,Benin,2011,0,284,-284
CAN,Canada,BEN,Benin,2012,0,390,-390
CAN,Canada,BEN,Benin,2013,0,397,-397
CAN,Canada,BEN,Benin,2014,0,242,-242
CAN,Canada,BEN,Benin,2015,0,259,-259
CAN,Canada,BEN,Benin,2016,0,300,-300
CAN,Canada,BEN,Benin,2017,0,195,-195
CZE,Czech Republic,BEN,Benin,2008,0,4,-4
CZE,Czech Republic,BEN,Benin,2009,0,7,-7
CZE,Czech Republic,BEN,Benin,2010,0,2,-2
CZE,Czech Republic,BEN,Benin,2012,0,1,-1
CZE,Czech Republic,BEN,Benin,2013,1,1,0
CZE,Czech Republic,BEN,Benin,2014,4,6,-2
CZE,Czech Republic,BEN,Benin,2015,3,2,1
DNK,Denmark,BEN,Benin,2008,5,9,-4
DNK,Denmark,BEN,Benin,2009,0,2,-2
DNK,Denmark,BEN,Benin,2010,4,2,2
DNK,Denmark,BEN,Benin,2011,4,1,3
DNK,Denmark,BEN,Benin,2012,2,0,2
DNK,Denmark,BEN,Benin,2013,3,2,1
DNK,Denmark,BEN,Benin,2014,2,6,-4
DNK,Denmark,BEN,Benin,2015,4,9,-5
DNK,Denmark,BEN,Benin,2016,3,2,1
DNK,Denmark,BEN,Benin,2017,3,2,1
FIN,Finland,BEN,Benin,2008,0,1,-1
FIN,Finland,BEN,Benin,2009,0,1,-1
FIN,Finland,BEN,Benin,2010,0,2,-2
FIN,Finland,BEN,Benin,2011,0,5,-5
FIN,Finland,BEN,Benin,2012,0,3,-3
FIN,Finland,BEN,Benin,2013,0,2,-2
FIN,Finland,BEN,Benin,2014,1,2,-1
FIN,Finland,BEN,Benin,2015,0,0,0
FIN,Finland,BEN,Benin,2016,2,1,1
FIN,Finland,BEN,Benin,2017,0,0,0
FRA,France,BEN,Benin,2008,0,664,-664
FRA,France,BEN,Benin,2009,0,709,-709
FRA,France,BEN,Benin,2010,0,649,-649
FRA,France,BEN,Benin,2011,0,712,-712
FRA,France,BEN,Benin,2012,0,714,-714
FRA,France,BEN,Benin,2013,0,727,-727
FRA,France,BEN,Benin,2014,0,829,-829
FRA,France,BEN,Benin,2015,0,591,-591
FRA,France,BEN,Benin,2016,0,571,-571
FRA,France,BEN,Benin,2017,0,560,-560
DEU,Germany,BEN,Benin,2008,117,192,-75
DEU,Germany,BEN,Benin,2009,181,196,-15
DEU,Germany,BEN,Benin,2010,127,233,-106
DEU,Germany,BEN,Benin,2011,111,216,-105
DEU,Germany,BEN,Benin,2012,179,301,-122
DEU,Germany,BEN,Benin,2013,245,323,-78
DEU,Germany,BEN,Benin,2014,181,405,-224
DEU,Germany,BEN,Benin,2015,199,569,-370
DEU,Germany,BEN,Benin,2016,249,380,-131
DEU,Germany,BEN,Benin,2017,329,400,-71
HUN,Hungary,BEN,Benin,2008,0,0,0
HUN,Hungary,BEN,Benin,2009,0,0,0
HUN,Hungary,BEN,Benin,2010,0,0,0
HUN,Hungary,BEN,Benin,2011,0,0,0
HUN,Hungary,BEN,Benin,2012,0,1,-1
HUN,Hungary,BEN,Benin,2013,0,1,-1
HUN,Hungary,BEN,Benin,2014,0,0,0
HUN,Hungary,BEN,Benin,2015,0,1,-1
HUN,Hungary,BEN,Benin,2016,0,4,-4
HUN,Hungary,BEN,Benin,2017,0,4,-4
ISL,Iceland,BEN,Benin,2008,0,0,0
ISL,Iceland,BEN,Benin,2009,0,0,0
ISL,Iceland,BEN,Benin,2010,0,0,0
ISL,Iceland,BEN,Benin,2011,0,0,0
ISL,Iceland,BEN,Benin,2012,0,0,0
ISL,Iceland,BEN,Benin,2013,0,0,0
ISL,Iceland,BEN,Benin,2014,0,0,0
ISL,Iceland,BEN,Benin,2015,0,1,-1
ISL,Iceland,BEN,Benin,2016,0,0,0
ISL,Iceland,BEN,Benin,2017,0,0,0
ITA,Italy,BEN,Benin,2008,6,143,-137
ITA,Italy,BEN,Benin,2009,6,178,-172
ITA,Italy,BEN,Benin,2010,32,231,-199
ITA,Italy,BEN,Benin,2011,12,153,-141
ITA,Italy,BEN,Benin,2012,19,181,-162
ITA,Italy,BEN,Benin,2013,13,149,-136
ITA,Italy,BEN,Benin,2014,20,122,-102
ITA,Italy,BEN,Benin,2015,19,171,-152
ITA,Italy,BEN,Benin,2016,0,310,-310
ITA,Italy,BEN,Benin,2017,14,302,-288
JPN,Japan,BEN,Benin,2008,82,82,0
JPN,Japan,BEN,Benin,2009,48,60,-12
JPN,Japan,BEN,Benin,2010,52,59,-7
JPN,Japan,BEN,Benin,2011,48,51,-3
JPN,Japan,BEN,Benin,2012,75,77,-2
JPN,Japan,BEN,Benin,2013,120,123,-3
JPN,Japan,BEN,Benin,2014,46,53,-7
JPN,Japan,BEN,Benin,2015,74,89,-15
JPN,Japan,BEN,Benin,2016,54,71,-17
JPN,Japan,BEN,Benin,2017,49,67,-18
KOR,Korea,BEN,Benin,2008,1,4,-3
KOR,Korea,BEN,Benin,2009,9,7,2
KOR,Korea,BEN,Benin,2010,1,2,-1
KOR,Korea,BEN,Benin,2011,3,3,0
KOR,Korea,BEN,Benin,2012,6,7,-1
KOR,Korea,BEN,Benin,2013,3,3,0
KOR,Korea,BEN,Benin,2014,2,5,-3
KOR,Korea,BEN,Benin,2015,5,6,-1
KOR,Korea,BEN,Benin,2016,6,5,1
KOR,Korea,BEN,Benin,2017,8,7,1
LUX,Luxembourg,BEN,Benin,2008,2,4,-2
LUX,Luxembourg,BEN,Benin,2009,1,7,-6
LUX,Luxembourg,BEN,Benin,2010,1,3,-2
LUX,Luxembourg,BEN,Benin,2011,1,5,-4
LUX,Luxembourg,BEN,Benin,2012,0,7,-7
LUX,Luxembourg,BEN,Benin,2013,6,13,-7
LUX,Luxembourg,BEN,Benin,2014,6,6,0
LUX,Luxembourg,BEN,Benin,2015,5,5,0
LUX,Luxembourg,BEN,Benin,2016,2,8,-6
LUX,Luxembourg,BEN,Benin,2017,1,15,-14
MEX,Mexico,BEN,Benin,2010,0,2,-2
MEX,Mexico,BEN,Benin,2011,0,1,-1
MEX,Mexico,BEN,Benin,2012,0,0,0
MEX,Mexico,BEN,Benin,2013,0,0,0
MEX,Mexico,BEN,Benin,2014,0,2,-2
MEX,Mexico,BEN,Benin,2015,0,1,-1
MEX,Mexico,BEN,Benin,2017,0,1,-1
NLD,Netherlands,BEN,Benin,2008,5,15,-10
NLD,Netherlands,BEN,Benin,2009,7,13,-6
NLD,Netherlands,BEN,Benin,2010,18,17,1
NLD,Netherlands,BEN,Benin,2011,5,20,-15
NLD,Netherlands,BEN,Benin,2012,9,16,-7
NLD,Netherlands,BEN,Benin,2013,18,18,0
NLD,Netherlands,BEN,Benin,2014,10,14,-4
NLD,Netherlands,BEN,Benin,2015,11,17,-6
NLD,Netherlands,BEN,Benin,2016,10,10,0
NLD,Netherlands,BEN,Benin,2017,8,15,-7
NOR,Norway,BEN,Benin,2008,0,0,0
NOR,Norway,BEN,Benin,2009,0,0,0
NOR,Norway,BEN,Benin,2010,0,1,-1
NOR,Norway,BEN,Benin,2011,0,5,-5
NOR,Norway,BEN,Benin,2012,0,2,-2
NOR,Norway,BEN,Benin,2013,1,3,-2
NOR,Norway,BEN,Benin,2014,3,0,3
NOR,Norway,BEN,Benin,2015,0,0,0
NOR,Norway,BEN,Benin,2016,0,1,-1
NOR,Norway,BEN,Benin,2017,0,1,-1
POL,Poland,BEN,Benin,2009,0,6,-6
POL,Poland,BEN,Benin,2010,0,0,0
POL,Poland,BEN,Benin,2011,0,4,-4
POL,Poland,BEN,Benin,2012,0,5,-5
POL,Poland,BEN,Benin,2013,0,1,-1
POL,Poland,BEN,Benin,2014,0,4,-4
POL,Poland,BEN,Benin,2015,0,2,-2
POL,Poland,BEN,Benin,2016,0,3,-3
POL,Poland,BEN,Benin,2017,0,3,-3
SVK,Slovak Republic,BEN,Benin,2008,0,1,-1
SVK,Slovak Republic,BEN,Benin,2009,1,1,0
SVK,Slovak Republic,BEN,Benin,2010,0,4,-4
ESP,Spain,BEN,Benin,2008,24,50,-26
ESP,Spain,BEN,Benin,2009,48,33,15
ESP,Spain,BEN,Benin,2010,34,29,5
ESP,Spain,BEN,Benin,2011,50,34,16
ESP,Spain,BEN,Benin,2012,21,31,-10
ESP,Spain,BEN,Benin,2013,31,28,3
ESP,Spain,BEN,Benin,2014,8,30,-22
ESP,Spain,BEN,Benin,2015,5,31,-26
ESP,Spain,BEN,Benin,2016,15,28,-13
ESP,Spain,BEN,Benin,2017,25,30,-5
SWE,Sweden,BEN,Benin,2008,0,8,-8
SWE,Sweden,BEN,Benin,2009,0,7,-7
SWE,Sweden,BEN,Benin,2010,2,13,-11
SWE,Sweden,BEN,Benin,2011,3,3,0
SWE,Sweden,BEN,Benin,2012,0,7,-7
SWE,Sweden,BEN,Benin,2013,2,3,-1
SWE,Sweden,BEN,Benin,2014,1,2,-1
SWE,Sweden,BEN,Benin,2015,3,4,-1
SWE,Sweden,BEN,Benin,2016,2,6,-4
SWE,Sweden,BEN,Benin,2017,0,6,-6
CHE,Switzerland,BEN,Benin,2010,18,31,-13
CHE,Switzerland,BEN,Benin,2011,5,26,-21
CHE,Switzerland,BEN,Benin,2012,12,29,-17
CHE,Switzerland,BEN,Benin,2013,12,40,-28
CHE,Switzerland,BEN,Benin,2014,10,20,-10
CHE,Switzerland,BEN,Benin,2015,6,25,-19
CHE,Switzerland,BEN,Benin,2016,10,37,-27
CHE,Switzerland,BEN,Benin,2017,10,39,-29
TUR,Turkey,BEN,Benin,2010,0,3,-3
USA,United States,BEN,Benin,2008,0,317,-317
USA,United States,BEN,Benin,2009,0,401,-401
USA,United States,BEN,Benin,2010,0,486,-486
USA,United States,BEN,Benin,2011,0,462,-462
USA,United States,BEN,Benin,2012,0,415,-415
USA,United States,BEN,Benin,2013,0,342,-342
USA,United States,BEN,Benin,2014,0,517,-517
USA,United States,BEN,Benin,2015,0,466,-466
USA,United States,BEN,Benin,2016,0,577,-577
USA,United States,BEN,Benin,2017,0,648,-648
CHL,Chile,BEN,Benin,2008,0,0,0
CHL,Chile,BEN,Benin,2009,0,2,-2
CHL,Chile,BEN,Benin,2010,0,0,0
CHL,Chile,BEN,Benin,2011,0,0,0
CHL,Chile,BEN,Benin,2012,0,0,0
CHL,Chile,BEN,Benin,2013,0,0,0
CHL,Chile,BEN,Benin,2014,0,0,0
CHL,Chile,BEN,Benin,2015,0,2,-2
CHL,Chile,BEN,Benin,2016,0,1,-1
EST,Estonia,BEN,Benin,2008,0,0,0
EST,Estonia,BEN,Benin,2009,0,0,0
EST,Estonia,BEN,Benin,2010,0,0,0
EST,Estonia,BEN,Benin,2011,0,0,0
EST,Estonia,BEN,Benin,2012,0,0,0
EST,Estonia,BEN,Benin,2013,0,0,0
EST,Estonia,BEN,Benin,2014,0,0,0
EST,Estonia,BEN,Benin,2015,0,0,0
EST,Estonia,BEN,Benin,2016,0,1,-1
EST,Estonia,BEN,Benin,2017,0,0,0
SVN,Slovenia,BEN,Benin,2013,0,1,-1
AUS,Australia,BMU,Bermuda,2008,0,1,-1
AUS,Australia,BMU,Bermuda,2009,0,1,-1
AUS,Australia,BMU,Bermuda,2010,0,0,0
AUS,Australia,BMU,Bermuda,2011,0,0,0
AUS,Australia,BMU,Bermuda,2012,0,0,0
AUS,Australia,BMU,Bermuda,2013,0,0,0
AUS,Australia,BMU,Bermuda,2014,0,0,0
AUS,Australia,BMU,Bermuda,2015,0,0,0
AUS,Australia,BMU,Bermuda,2016,0,0,0
AUS,Australia,BMU,Bermuda,2017,0,3,-3
AUT,Austria,BMU,Bermuda,2014,0,0,0
AUT,Austria,BMU,Bermuda,2015,0,0,0
AUT,Austria,BMU,Bermuda,2016,0,0,0
AUT,Austria,BMU,Bermuda,2017,0,0,0
BEL,Belgium,BMU,Bermuda,2010,0,0,0
CAN,Canada,BMU,Bermuda,2008,0,0,0
CAN,Canada,BMU,Bermuda,2009,0,0,0
CAN,Canada,BMU,Bermuda,2010,0,0,0
CAN,Canada,BMU,Bermuda,2011,0,0,0
CAN,Canada,BMU,Bermuda,2012,0,0,0
CAN,Canada,BMU,Bermuda,2013,0,0,0
CAN,Canada,BMU,Bermuda,2014,0,0,0
CAN,Canada,BMU,Bermuda,2015,0,0,0
CAN,Canada,BMU,Bermuda,2016,0,0,0
CAN,Canada,BMU,Bermuda,2017,0,0,0
DNK,Denmark,BMU,Bermuda,2013,0,0,0
DNK,Denmark,BMU,Bermuda,2014,0,0,0
DNK,Denmark,BMU,Bermuda,2015,0,0,0
DNK,Denmark,BMU,Bermuda,2016,0,0,0
DNK,Denmark,BMU,Bermuda,2017,0,0,0
FIN,Finland,BMU,Bermuda,2008,0,0,0
FIN,Finland,BMU,Bermuda,2009,0,0,0
FIN,Finland,BMU,Bermuda,2010,0,0,0
FIN,Finland,BMU,Bermuda,2011,0,0,0
FIN,Finland,BMU,Bermuda,2012,0,0,0
FIN,Finland,BMU,Bermuda,2013,0,0,0
FIN,Finland,BMU,Bermuda,2014,0,0,0
FIN,Finland,BMU,Bermuda,2015,0,0,0
FIN,Finland,BMU,Bermuda,2016,0,0,0
FIN,Finland,BMU,Bermuda,2017,0,0,0
FRA,France,BMU,Bermuda,2008,0,0,0
FRA,France,BMU,Bermuda,2009,0,0,0
FRA,France,BMU,Bermuda,2010,0,0,0
FRA,France,BMU,Bermuda,2011,0,0,0
FRA,France,BMU,Bermuda,2012,0,0,0
FRA,France,BMU,Bermuda,2013,0,0,0
FRA,France,BMU,Bermuda,2014,0,0,0
FRA,France,BMU,Bermuda,2015,0,0,0
FRA,France,BMU,Bermuda,2016,0,0,0
FRA,France,BMU,Bermuda,2017,0,0,0
HUN,Hungary,BMU,Bermuda,2008,0,0,0
HUN,Hungary,BMU,Bermuda,2009,0,0,0
HUN,Hungary,BMU,Bermuda,2010,0,0,0
HUN,Hungary,BMU,Bermuda,2011,0,0,0
HUN,Hungary,BMU,Bermuda,2012,0,0,0
HUN,Hungary,BMU,Bermuda,2013,0,0,0
HUN,Hungary,BMU,Bermuda,2014,0,0,0
HUN,Hungary,BMU,Bermuda,2015,0,0,0
HUN,Hungary,BMU,Bermuda,2016,0,0,0
HUN,Hungary,BMU,Bermuda,2017,0,0,0
ISL,Iceland,BMU,Bermuda,2008,0,0,0
ISL,Iceland,BMU,Bermuda,2009,0,0,0
ISL,Iceland,BMU,Bermuda,2010,0,0,0
ISL,Iceland,BMU,Bermuda,2011,0,0,0
ISL,Iceland,BMU,Bermuda,2012,0,0,0
ISL,Iceland,BMU,Bermuda,2016,0,0,0
ISL,Iceland,BMU,Bermuda,2017,0,0,0
ITA,Italy,BMU,Bermuda,2008,0,0,0
ITA,Italy,BMU,Bermuda,2009,0,0,0
ITA,Italy,BMU,Bermuda,2010,0,0,0
ITA,Italy,BMU,Bermuda,2011,0,0,0
ITA,Italy,BMU,Bermuda,2012,0,0,0
ITA,Italy,BMU,Bermuda,2013,0,0,0
ITA,Italy,BMU,Bermuda,2015,0,0,0
JPN,Japan,BMU,Bermuda,2008,0,0,0
JPN,Japan,BMU,Bermuda,2009,0,0,0
JPN,Japan,BMU,Bermuda,2010,0,0,0
JPN,Japan,BMU,Bermuda,2011,0,0,0
JPN,Japan,BMU,Bermuda,2012,0,0,0
JPN,Japan,BMU,Bermuda,2013,0,0,0
JPN,Japan,BMU,Bermuda,2014,0,0,0
JPN,Japan,BMU,Bermuda,2015,0,0,0
JPN,Japan,BMU,Bermuda,2016,0,0,0
JPN,Japan,BMU,Bermuda,2017,0,0,0
KOR,Korea,BMU,Bermuda,2008,0,0,0
KOR,Korea,BMU,Bermuda,2009,0,0,0
KOR,Korea,BMU,Bermuda,2010,0,0,0
KOR,Korea,BMU,Bermuda,2011,0,0,0
KOR,Korea,BMU,Bermuda,2012,0,0,0
KOR,Korea,BMU,Bermuda,2013,0,0,0
KOR,Korea,BMU,Bermuda,2014,0,0,0
KOR,Korea,BMU,Bermuda,2015,0,0,0
KOR,Korea,BMU,Bermuda,2016,0,0,0
KOR,Korea,BMU,Bermuda,2017,0,0,0
LUX,Luxembourg,BMU,Bermuda,2008,0,0,0
LUX,Luxembourg,BMU,Bermuda,2009,0,0,0
LUX,Luxembourg,BMU,Bermuda,2010,0,0,0
LUX,Luxembourg,BMU,Bermuda,2011,0,0,0
LUX,Luxembourg,BMU,Bermuda,2012,0,0,0
LUX,Luxembourg,BMU,Bermuda,2013,0,0,0
LUX,Luxembourg,BMU,Bermuda,2014,0,0,0
LUX,Luxembourg,BMU,Bermuda,2015,0,0,0
LUX,Luxembourg,BMU,Bermuda,2016,0,0,0
LUX,Luxembourg,BMU,Bermuda,2017,0,0,0
MEX,Mexico,BMU,Bermuda,2012,0,1,-1
MEX,Mexico,BMU,Bermuda,2013,0,0,0
MEX,Mexico,BMU,Bermuda,2014,0,1,-1
MEX,Mexico,BMU,Bermuda,2017,0,2,-2
NZL,New Zealand,BMU,Bermuda,2008,0,1,-1
NZL,New Zealand,BMU,Bermuda,2011,0,1,-1
NOR,Norway,BMU,Bermuda,2008,0,0,0
NOR,Norway,BMU,Bermuda,2009,0,0,0
NOR,Norway,BMU,Bermuda,2010,0,0,0
NOR,Norway,BMU,Bermuda,2011,0,0,0
NOR,Norway,BMU,Bermuda,2012,0,0,0
NOR,Norway,BMU,Bermuda,2013,0,0,0
NOR,Norway,BMU,Bermuda,2014,0,0,0
NOR,Norway,BMU,Bermuda,2015,0,0,0
NOR,Norway,BMU,Bermuda,2016,0,0,0
NOR,Norway,BMU,Bermuda,2017,0,0,0
POL,Poland,BMU,Bermuda,2009,0,0,0
POL,Poland,BMU,Bermuda,2010,0,0,0
POL,Poland,BMU,Bermuda,2011,0,0,0
POL,Poland,BMU,Bermuda,2012,0,0,0
POL,Poland,BMU,Bermuda,2013,0,0,0
POL,Poland,BMU,Bermuda,2014,0,0,0
POL,Poland,BMU,Bermuda,2015,0,0,0
POL,Poland,BMU,Bermuda,2016,0,0,0
POL,Poland,BMU,Bermuda,2017,0,0,0
ESP,Spain,BMU,Bermuda,2008,0,0,0
ESP,Spain,BMU,Bermuda,2009,0,0,0
ESP,Spain,BMU,Bermuda,2010,0,0,0
ESP,Spain,BMU,Bermuda,2011,0,0,0
ESP,Spain,BMU,Bermuda,2012,0,0,0
ESP,Spain,BMU,Bermuda,2013,0,0,0
SWE,Sweden,BMU,Bermuda,2008,0,0,0
SWE,Sweden,BMU,Bermuda,2009,0,0,0
SWE,Sweden,BMU,Bermuda,2010,0,0,0
SWE,Sweden,BMU,Bermuda,2011,0,0,0
SWE,Sweden,BMU,Bermuda,2012,0,0,0
SWE,Sweden,BMU,Bermuda,2013,0,0,0
SWE,Sweden,BMU,Bermuda,2014,0,0,0
SWE,Sweden,BMU,Bermuda,2015,0,0,0
GBR,United Kingdom,BMU,Bermuda,2013,0,1000,-1000
USA,United States,BMU,Bermuda,2008,0,92,-92
USA,United States,BMU,Bermuda,2009,0,108,-108
USA,United States,BMU,Bermuda,2010,0,72,-72
USA,United States,BMU,Bermuda,2011,0,71,-71
USA,United States,BMU,Bermuda,2012,0,85,-85
USA,United States,BMU,Bermuda,2013,0,88,-88
USA,United States,BMU,Bermuda,2014,0,106,-106
USA,United States,BMU,Bermuda,2015,0,112,-112
USA,United States,BMU,Bermuda,2016,0,99,-99
USA,United States,BMU,Bermuda,2017,0,68,-68
CHL,Chile,BMU,Bermuda,2008,0,1,-1
CHL,Chile,BMU,Bermuda,2009,0,0,0
CHL,Chile,BMU,Bermuda,2010,0,0,0
CHL,Chile,BMU,Bermuda,2011,0,0,0
CHL,Chile,BMU,Bermuda,2012,0,0,0
CHL,Chile,BMU,Bermuda,2013,0,0,0
CHL,Chile,BMU,Bermuda,2014,0,0,0
CHL,Chile,BMU,Bermuda,2015,0,0,0
CHL,Chile,BMU,Bermuda,2016,0,0,0
EST,Estonia,BMU,Bermuda,2008,0,0,0
EST,Estonia,BMU,Bermuda,2009,0,0,0
EST,Estonia,BMU,Bermuda,2010,0,0,0
EST,Estonia,BMU,Bermuda,2011,0,0,0
EST,Estonia,BMU,Bermuda,2012,0,0,0
EST,Estonia,BMU,Bermuda,2013,0,0,0
EST,Estonia,BMU,Bermuda,2014,0,0,0
EST,Estonia,BMU,Bermuda,2015,0,0,0
EST,Estonia,BMU,Bermuda,2016,0,0,0
EST,Estonia,BMU,Bermuda,2017,0,0,0
AUS,Australia,BTN,Bhutan,2008,0,26,-26
AUS,Australia,BTN,Bhutan,2009,0,767,-767
AUS,Australia,BTN,Bhutan,2010,0,782,-782
AUS,Australia,BTN,Bhutan,2011,0,1113,-1113
AUS,Australia,BTN,Bhutan,2012,0,863,-863
AUS,Australia,BTN,Bhutan,2013,0,808,-808
AUS,Australia,BTN,Bhutan,2014,0,845,-845
AUS,Australia,BTN,Bhutan,2015,0,307,-307
AUS,Australia,BTN,Bhutan,2016,0,469,-469
AUS,Australia,BTN,Bhutan,2017,0,734,-734
AUT,Austria,BTN,Bhutan,2008,8,6,2
AUT,Austria,BTN,Bhutan,2009,8,7,1
AUT,Austria,BTN,Bhutan,2010,7,9,-2
AUT,Austria,BTN,Bhutan,2011,15,11,4
AUT,Austria,BTN,Bhutan,2012,11,9,2
AUT,Austria,BTN,Bhutan,2013,7,9,-2
AUT,Austria,BTN,Bhutan,2014,6,8,-2
AUT,Austria,BTN,Bhutan,2015,9,16,-7
AUT,Austria,BTN,Bhutan,2016,17,12,5
AUT,Austria,BTN,Bhutan,2017,9,12,-3
BEL,Belgium,BTN,Bhutan,2008,0,7,-7
BEL,Belgium,BTN,Bhutan,2009,0,8,-8
BEL,Belgium,BTN,Bhutan,2010,2,4,-2
BEL,Belgium,BTN,Bhutan,2012,21,7,14
BEL,Belgium,BTN,Bhutan,2013,19,4,15
BEL,Belgium,BTN,Bhutan,2014,14,1,13
BEL,Belgium,BTN,Bhutan,2015,13,1,12
BEL,Belgium,BTN,Bhutan,2016,5,2,3
BEL,Belgium,BTN,Bhutan,2017,1,1,0
CAN,Canada,BTN,Bhutan,2008,0,36,-36
CAN,Canada,BTN,Bhutan,2009,0,865,-865
CAN,Canada,BTN,Bhutan,2010,0,1464,-1464
CAN,Canada,BTN,Bhutan,2011,0,1879,-1879
CAN,Canada,BTN,Bhutan,2012,0,1075,-1075
CAN,Canada,BTN,Bhutan,2013,0,487,-487
CAN,Canada,BTN,Bhutan,2014,0,356,-356
CAN,Canada,BTN,Bhutan,2015,0,387,-387
CAN,Canada,BTN,Bhutan,2016,0,115,-115
CAN,Canada,BTN,Bhutan,2017,0,65,-65
CZE,Czech Republic,BTN,Bhutan,2008,0,1,-1
CZE,Czech Republic,BTN,Bhutan,2009,0,1,-1
CZE,Czech Republic,BTN,Bhutan,2014,0,2,-2
CZE,Czech Republic,BTN,Bhutan,2015,0,2,-2
CZE,Czech Republic,BTN,Bhutan,2016,0,1,-1
DNK,Denmark,BTN,Bhutan,2008,7,15,-8
DNK,Denmark,BTN,Bhutan,2009,0,295,-295
DNK,Denmark,BTN,Bhutan,2010,3,11,-8
DNK,Denmark,BTN,Bhutan,2011,3,177,-174
DNK,Denmark,BTN,Bhutan,2012,8,1,7
DNK,Denmark,BTN,Bhutan,2013,0,9,-9
DNK,Denmark,BTN,Bhutan,2014,3,2,1
DNK,Denmark,BTN,Bhutan,2015,1,1,0
DNK,Denmark,BTN,Bhutan,2016,0,1,-1
DNK,Denmark,BTN,Bhutan,2017,2,2,0
FIN,Finland,BTN,Bhutan,2008,0,0,0
FIN,Finland,BTN,Bhutan,2009,0,0,0
FIN,Finland,BTN,Bhutan,2010,0,0,0
FIN,Finland,BTN,Bhutan,2011,0,1,-1
FIN,Finland,BTN,Bhutan,2012,1,0,1
FIN,Finland,BTN,Bhutan,2013,0,0,0
FIN,Finland,BTN,Bhutan,2014,0,0,0
FIN,Finland,BTN,Bhutan,2015,0,0,0
FIN,Finland,BTN,Bhutan,2016,0,0,0
FIN,Finland,BTN,Bhutan,2017,0,0,0
FRA,France,BTN,Bhutan,2008,0,11,-11
FRA,France,BTN,Bhutan,2009,0,15,-15
FRA,France,BTN,Bhutan,2010,0,42,-42
FRA,France,BTN,Bhutan,2011,0,23,-23
FRA,France,BTN,Bhutan,2012,0,22,-22
FRA,France,BTN,Bhutan,2013,0,33,-33
FRA,France,BTN,Bhutan,2014,0,23,-23
FRA,France,BTN,Bhutan,2015,0,15,-15
FRA,France,BTN,Bhutan,2016,0,12,-12
FRA,France,BTN,Bhutan,2017,0,8,-8
DEU,Germany,BTN,Bhutan,2008,25,17,8
DEU,Germany,BTN,Bhutan,2009,24,22,2
DEU,Germany,BTN,Bhutan,2010,32,25,7
DEU,Germany,BTN,Bhutan,2011,19,20,-1
DEU,Germany,BTN,Bhutan,2012,22,16,6
DEU,Germany,BTN,Bhutan,2013,14,24,-10
DEU,Germany,BTN,Bhutan,2014,12,19,-7
DEU,Germany,BTN,Bhutan,2015,20,20,0
DEU,Germany,BTN,Bhutan,2016,16,11,5
DEU,Germany,BTN,Bhutan,2017,11,15,-4
HUN,Hungary,BTN,Bhutan,2008,0,0,0
HUN,Hungary,BTN,Bhutan,2009,0,1,-1
HUN,Hungary,BTN,Bhutan,2010,0,0,0
HUN,Hungary,BTN,Bhutan,2011,0,0,0
HUN,Hungary,BTN,Bhutan,2012,0,0,0
HUN,Hungary,BTN,Bhutan,2013,0,1,-1
HUN,Hungary,BTN,Bhutan,2014,0,0,0
HUN,Hungary,BTN,Bhutan,2015,0,0,0
HUN,Hungary,BTN,Bhutan,2016,1,7,-6
HUN,Hungary,BTN,Bhutan,2017,0,1,-1
ISL,Iceland,BTN,Bhutan,2016,0,0,0
ISL,Iceland,BTN,Bhutan,2017,0,0,0
ITA,Italy,BTN,Bhutan,2008,0,6,-6
ITA,Italy,BTN,Bhutan,2009,0,4,-4
ITA,Italy,BTN,Bhutan,2010,0,3,-3
ITA,Italy,BTN,Bhutan,2011,0,0,0
ITA,Italy,BTN,Bhutan,2012,0,3,-3
ITA,Italy,BTN,Bhutan,2013,2,13,-11
ITA,Italy,BTN,Bhutan,2014,0,7,-7
ITA,Italy,BTN,Bhutan,2015,0,0,0
ITA,Italy,BTN,Bhutan,2016,0,1,-1
ITA,Italy,BTN,Bhutan,2017,0,5,-5
JPN,Japan,BTN,Bhutan,2008,120,124,-4
JPN,Japan,BTN,Bhutan,2009,179,177,2
JPN,Japan,BTN,Bhutan,2010,205,208,-3
JPN,Japan,BTN,Bhutan,2011,266,265,1
JPN,Japan,BTN,Bhutan,2012,212,216,-4
JPN,Japan,BTN,Bhutan,2013,225,234,-9
JPN,Japan,BTN,Bhutan,2014,214,216,-2
JPN,Japan,BTN,Bhutan,2015,261,283,-22
JPN,Japan,BTN,Bhutan,2016,285,315,-30
JPN,Japan,BTN,Bhutan,2017,363,884,-521
KOR,Korea,BTN,Bhutan,2008,25,21,4
KOR,Korea,BTN,Bhutan,2009,15,16,-1
KOR,Korea,BTN,Bhutan,2010,13,15,-2
KOR,Korea,BTN,Bhutan,2011,14,14,0
KOR,Korea,BTN,Bhutan,2012,15,17,-2
KOR,Korea,BTN,Bhutan,2013,18,12,6
KOR,Korea,BTN,Bhutan,2014,15,12,3
KOR,Korea,BTN,Bhutan,2015,15,14,1
KOR,Korea,BTN,Bhutan,2016,11,15,-4
KOR,Korea,BTN,Bhutan,2017,21,32,-11
LUX,Luxembourg,BTN,Bhutan,2008,0,0,0
LUX,Luxembourg,BTN,Bhutan,2009,0,1,-1
LUX,Luxembourg,BTN,Bhutan,2010,0,0,0
LUX,Luxembourg,BTN,Bhutan,2011,0,0,0
LUX,Luxembourg,BTN,Bhutan,2012,0,1,-1
LUX,Luxembourg,BTN,Bhutan,2013,0,0,0
LUX,Luxembourg,BTN,Bhutan,2014,0,0,0
LUX,Luxembourg,BTN,Bhutan,2015,0,0,0
LUX,Luxembourg,BTN,Bhutan,2016,2,0,2
LUX,Luxembourg,BTN,Bhutan,2017,0,0,0
MEX,Mexico,BTN,Bhutan,2012,0,0,0
MEX,Mexico,BTN,Bhutan,2013,0,0,0
MEX,Mexico,BTN,Bhutan,2014,0,1,-1
MEX,Mexico,BTN,Bhutan,2017,0,3,-3
NLD,Netherlands,BTN,Bhutan,2008,32,28,4
NLD,Netherlands,BTN,Bhutan,2009,26,42,-16
NLD,Netherlands,BTN,Bhutan,2010,30,38,-8
NLD,Netherlands,BTN,Bhutan,2011,30,20,10
NLD,Netherlands,BTN,Bhutan,2012,13,16,-3
NLD,Netherlands,BTN,Bhutan,2013,38,20,18
NLD,Netherlands,BTN,Bhutan,2014,10,9,1
NLD,Netherlands,BTN,Bhutan,2015,16,19,-3
NLD,Netherlands,BTN,Bhutan,2016,12,12,0
NLD,Netherlands,BTN,Bhutan,2017,17,9,8
NZL,New Zealand,BTN,Bhutan,2008,1,126,-125
NZL,New Zealand,BTN,Bhutan,2009,3,169,-166
NZL,New Zealand,BTN,Bhutan,2010,0,195,-195
NZL,New Zealand,BTN,Bhutan,2011,0,92,-92
NZL,New Zealand,BTN,Bhutan,2012,1,120,-119
NZL,New Zealand,BTN,Bhutan,2013,3,152,-149
NZL,New Zealand,BTN,Bhutan,2014,2,83,-81
NZL,New Zealand,BTN,Bhutan,2015,1,57,-56
NZL,New Zealand,BTN,Bhutan,2016,0,60,-60
NZL,New Zealand,BTN,Bhutan,2017,3,33,-30
NOR,Norway,BTN,Bhutan,2008,3,21,-18
NOR,Norway,BTN,Bhutan,2009,3,246,-243
NOR,Norway,BTN,Bhutan,2010,5,52,-47
NOR,Norway,BTN,Bhutan,2011,3,17,-14
NOR,Norway,BTN,Bhutan,2012,9,168,-159
NOR,Norway,BTN,Bhutan,2013,2,6,-4
NOR,Norway,BTN,Bhutan,2014,1,9,-8
NOR,Norway,BTN,Bhutan,2015,2,7,-5
NOR,Norway,BTN,Bhutan,2016,4,7,-3
NOR,Norway,BTN,Bhutan,2017,1,2,-1
POL,Poland,BTN,Bhutan,2009,0,0,0
POL,Poland,BTN,Bhutan,2010,0,1,-1
POL,Poland,BTN,Bhutan,2011,0,2,-2
POL,Poland,BTN,Bhutan,2012,0,2,-2
POL,Poland,BTN,Bhutan,2013,0,2,-2
POL,Poland,BTN,Bhutan,2014,0,0,0
POL,Poland,BTN,Bhutan,2015,0,1,-1
POL,Poland,BTN,Bhutan,2016,0,0,0
POL,Poland,BTN,Bhutan,2017,0,0,0
SVK,Slovak Republic,BTN,Bhutan,2008,0,0,0
ESP,Spain,BTN,Bhutan,2008,0,0,0
ESP,Spain,BTN,Bhutan,2009,0,0,0
ESP,Spain,BTN,Bhutan,2010,0,0,0
ESP,Spain,BTN,Bhutan,2011,0,0,0
ESP,Spain,BTN,Bhutan,2012,0,2,-2
ESP,Spain,BTN,Bhutan,2013,0,1,-1
ESP,Spain,BTN,Bhutan,2014,1,4,-3
ESP,Spain,BTN,Bhutan,2015,0,1,-1
ESP,Spain,BTN,Bhutan,2016,2,5,-3
ESP,Spain,BTN,Bhutan,2017,2,3,-1
SWE,Sweden,BTN,Bhutan,2008,2,5,-3
SWE,Sweden,BTN,Bhutan,2009,1,4,-3
SWE,Sweden,BTN,Bhutan,2010,0,1,-1
SWE,Sweden,BTN,Bhutan,2011,6,1,5
SWE,Sweden,BTN,Bhutan,2012,4,1,3
SWE,Sweden,BTN,Bhutan,2013,0,3,-3
SWE,Sweden,BTN,Bhutan,2014,0,1,-1
SWE,Sweden,BTN,Bhutan,2015,0,1,-1
SWE,Sweden,BTN,Bhutan,2016,0,6,-6
SWE,Sweden,BTN,Bhutan,2017,0,3,-3
CHE,Switzerland,BTN,Bhutan,2010,1,3,-2
CHE,Switzerland,BTN,Bhutan,2011,6,3,3
CHE,Switzerland,BTN,Bhutan,2012,0,3,-3
CHE,Switzerland,BTN,Bhutan,2013,3,3,0
CHE,Switzerland,BTN,Bhutan,2014,1,4,-3
CHE,Switzerland,BTN,Bhutan,2015,3,13,-10
CHE,Switzerland,BTN,Bhutan,2016,11,2,9
CHE,Switzerland,BTN,Bhutan,2017,2,3,-1
USA,United States,BTN,Bhutan,2008,0,42,-42
USA,United States,BTN,Bhutan,2009,0,594,-594
USA,United States,BTN,Bhutan,2010,0,6109,-6109
USA,United States,BTN,Bhutan,2011,0,10137,-10137
USA,United States,BTN,Bhutan,2012,0,10198,-10198
USA,United States,BTN,Bhutan,2013,0,8954,-8954
USA,United States,BTN,Bhutan,2014,0,7298,-7298
USA,United States,BTN,Bhutan,2015,0,6325,-6325
USA,United States,BTN,Bhutan,2016,0,4217,-4217
USA,United States,BTN,Bhutan,2017,0,2940,-2940
CHL,Chile,BTN,Bhutan,2008,0,1,-1
CHL,Chile,BTN,Bhutan,2009,0,0,0
CHL,Chile,BTN,Bhutan,2010,0,0,0
CHL,Chile,BTN,Bhutan,2011,0,0,0
CHL,Chile,BTN,Bhutan,2012,0,0,0
CHL,Chile,BTN,Bhutan,2013,0,0,0
CHL,Chile,BTN,Bhutan,2014,0,0,0
CHL,Chile,BTN,Bhutan,2015,0,0,0
CHL,Chile,BTN,Bhutan,2016,0,0,0
EST,Estonia,BTN,Bhutan,2008,0,0,0
EST,Estonia,BTN,Bhutan,2009,0,0,0
EST,Estonia,BTN,Bhutan,2010,0,0,0
EST,Estonia,BTN,Bhutan,2011,0,0,0
EST,Estonia,BTN,Bhutan,2012,0,0,0
EST,Estonia,BTN,Bhutan,2013,0,0,0
EST,Estonia,BTN,Bhutan,2014,0,0,0
EST,Estonia,BTN,Bhutan,2015,0,1,-1
EST,Estonia,BTN,Bhutan,2016,0,1,-1
EST,Estonia,BTN,Bhutan,2017,0,1,-1
AUS,Australia,BOL,Bolivia,2008,10,24,-14
AUS,Australia,BOL,Bolivia,2009,14,18,-4
AUS,Australia,BOL,Bolivia,2010,11,23,-12
AUS,Australia,BOL,Bolivia,2011,13,26,-13
AUS,Australia,BOL,Bolivia,2012,5,27,-22
AUS,Australia,BOL,Bolivia,2013,13,27,-14
AUS,Australia,BOL,Bolivia,2014,12,13,-1
AUS,Australia,BOL,Bolivia,2015,0,14,-14
AUS,Australia,BOL,Bolivia,2016,0,20,-20
AUS,Australia,BOL,Bolivia,2017,0,16,-16
AUT,Austria,BOL,Bolivia,2008,8,15,-7
AUT,Austria,BOL,Bolivia,2009,9,24,-15
AUT,Austria,BOL,Bolivia,2010,10,17,-7
AUT,Austria,BOL,Bolivia,2011,9,14,-5
AUT,Austria,BOL,Bolivia,2012,11,15,-4
AUT,Austria,BOL,Bolivia,2013,6,18,-12
AUT,Austria,BOL,Bolivia,2014,10,17,-7
AUT,Austria,BOL,Bolivia,2015,8,10,-2
AUT,Austria,BOL,Bolivia,2016,12,23,-11
AUT,Austria,BOL,Bolivia,2017,8,12,-4
BEL,Belgium,BOL,Bolivia,2008,0,62,-62
BEL,Belgium,BOL,Bolivia,2009,0,85,-85
BEL,Belgium,BOL,Bolivia,2010,22,104,-82
BEL,Belgium,BOL,Bolivia,2011,0,78,-78
BEL,Belgium,BOL,Bolivia,2012,33,67,-34
BEL,Belgium,BOL,Bolivia,2013,31,54,-23
BEL,Belgium,BOL,Bolivia,2014,31,35,-4
BEL,Belgium,BOL,Bolivia,2015,28,40,-12
BEL,Belgium,BOL,Bolivia,2016,19,42,-23
BEL,Belgium,BOL,Bolivia,2017,15,50,-35
CAN,Canada,BOL,Bolivia,2008,0,142,-142
CAN,Canada,BOL,Bolivia,2009,0,214,-214
CAN,Canada,BOL,Bolivia,2010,0,180,-180
CAN,Canada,BOL,Bolivia,2011,0,86,-86
CAN,Canada,BOL,Bolivia,2012,0,83,-83
CAN,Canada,BOL,Bolivia,2013,0,107,-107
CAN,Canada,BOL,Bolivia,2014,0,95,-95
CAN,Canada,BOL,Bolivia,2015,0,74,-74
CAN,Canada,BOL,Bolivia,2016,0,110,-110
CAN,Canada,BOL,Bolivia,2017,0,100,-100
CZE,Czech Republic,BOL,Bolivia,2008,0,9,-9
CZE,Czech Republic,BOL,Bolivia,2009,0,6,-6
CZE,Czech Republic,BOL,Bolivia,2010,0,2,-2
CZE,Czech Republic,BOL,Bolivia,2011,0,1,-1
CZE,Czech Republic,BOL,Bolivia,2012,4,5,-1
CZE,Czech Republic,BOL,Bolivia,2013,5,2,3
CZE,Czech Republic,BOL,Bolivia,2014,3,9,-6
CZE,Czech Republic,BOL,Bolivia,2015,5,4,1
CZE,Czech Republic,BOL,Bolivia,2016,6,3,3
CZE,Czech Republic,BOL,Bolivia,2017,3,13,-10
DNK,Denmark,BOL,Bolivia,2008,8,9,-1
DNK,Denmark,BOL,Bolivia,2009,4,13,-9
DNK,Denmark,BOL,Bolivia,2010,3,5,-2
DNK,Denmark,BOL,Bolivia,2011,9,11,-2
DNK,Denmark,BOL,Bolivia,2012,11,7,4
DNK,Denmark,BOL,Bolivia,2013,4,11,-7
DNK,Denmark,BOL,Bolivia,2014,12,5,7
DNK,Denmark,BOL,Bolivia,2015,11,8,3
DNK,Denmark,BOL,Bolivia,2016,5,9,-4
DNK,Denmark,BOL,Bolivia,2017,7,12,-5
FIN,Finland,BOL,Bolivia,2008,1,5,-4
FIN,Finland,BOL,Bolivia,2009,1,6,-5
FIN,Finland,BOL,Bolivia,2010,0,8,-8
FIN,Finland,BOL,Bolivia,2011,0,6,-6
FIN,Finland,BOL,Bolivia,2012,2,6,-4
FIN,Finland,BOL,Bolivia,2013,1,4,-3
FIN,Finland,BOL,Bolivia,2014,1,3,-2
FIN,Finland,BOL,Bolivia,2015,1,3,-2
FIN,Finland,BOL,Bolivia,2016,2,5,-3
FIN,Finland,BOL,Bolivia,2017,3,3,0
FRA,France,BOL,Bolivia,2008,0,116,-116
FRA,France,BOL,Bolivia,2009,0,102,-102
FRA,France,BOL,Bolivia,2010,0,131,-131
FRA,France,BOL,Bolivia,2011,0,152,-152
FRA,France,BOL,Bolivia,2012,0,129,-129
FRA,France,BOL,Bolivia,2013,0,229,-229
FRA,France,BOL,Bolivia,2014,0,147,-147
FRA,France,BOL,Bolivia,2015,0,160,-160
FRA,France,BOL,Bolivia,2016,0,127,-127
FRA,France,BOL,Bolivia,2017,0,135,-135
DEU,Germany,BOL,Bolivia,2008,330,284,46
DEU,Germany,BOL,Bolivia,2009,298,319,-21
DEU,Germany,BOL,Bolivia,2010,273,288,-15
DEU,Germany,BOL,Bolivia,2011,230,267,-37
DEU,Germany,BOL,Bolivia,2012,177,312,-135
DEU,Germany,BOL,Bolivia,2013,223,313,-90
DEU,Germany,BOL,Bolivia,2014,199,307,-108
DEU,Germany,BOL,Bolivia,2015,197,314,-117
DEU,Germany,BOL,Bolivia,2016,217,319,-102
DEU,Germany,BOL,Bolivia,2017,169,339,-170
HUN,Hungary,BOL,Bolivia,2008,0,8,-8
HUN,Hungary,BOL,Bolivia,2009,0,2,-2
HUN,Hungary,BOL,Bolivia,2010,0,0,0
HUN,Hungary,BOL,Bolivia,2011,0,2,-2
HUN,Hungary,BOL,Bolivia,2012,0,0,0
HUN,Hungary,BOL,Bolivia,2013,0,1,-1
HUN,Hungary,BOL,Bolivia,2014,0,1,-1
HUN,Hungary,BOL,Bolivia,2015,0,2,-2
HUN,Hungary,BOL,Bolivia,2016,0,9,-9
HUN,Hungary,BOL,Bolivia,2017,0,6,-6
ISL,Iceland,BOL,Bolivia,2008,2,0,2
ISL,Iceland,BOL,Bolivia,2009,1,1,0
ISL,Iceland,BOL,Bolivia,2010,0,0,0
ISL,Iceland,BOL,Bolivia,2011,0,3,-3
ISL,Iceland,BOL,Bolivia,2012,1,0,1
ISL,Iceland,BOL,Bolivia,2013,0,1,-1
ISL,Iceland,BOL,Bolivia,2014,2,1,1
ISL,Iceland,BOL,Bolivia,2015,1,4,-3
ISL,Iceland,BOL,Bolivia,2016,1,2,-1
ISL,Iceland,BOL,Bolivia,2017,1,2,-1
ITA,Italy,BOL,Bolivia,2008,47,1143,-1096
ITA,Italy,BOL,Bolivia,2009,63,1625,-1562
ITA,Italy,BOL,Bolivia,2010,77,3362,-3285
ITA,Italy,BOL,Bolivia,2011,103,1670,-1567
ITA,Italy,BOL,Bolivia,2012,112,1027,-915
ITA,Italy,BOL,Bolivia,2013,98,735,-637
ITA,Italy,BOL,Bolivia,2014,117,410,-293
ITA,Italy,BOL,Bolivia,2015,127,324,-197
ITA,Italy,BOL,Bolivia,2016,0,238,-238
ITA,Italy,BOL,Bolivia,2017,65,260,-195
JPN,Japan,BOL,Bolivia,2008,209,376,-167
JPN,Japan,BOL,Bolivia,2009,421,167,254
JPN,Japan,BOL,Bolivia,2010,226,181,45
JPN,Japan,BOL,Bolivia,2011,166,243,-77
JPN,Japan,BOL,Bolivia,2012,119,251,-132
JPN,Japan,BOL,Bolivia,2013,127,257,-130
JPN,Japan,BOL,Bolivia,2014,109,213,-104
JPN,Japan,BOL,Bolivia,2015,109,253,-144
JPN,Japan,BOL,Bolivia,2016,93,270,-177
JPN,Japan,BOL,Bolivia,2017,85,316,-231
KOR,Korea,BOL,Bolivia,2008,21,13,8
KOR,Korea,BOL,Bolivia,2009,14,16,-2
KOR,Korea,BOL,Bolivia,2010,17,18,-1
KOR,Korea,BOL,Bolivia,2011,11,12,-1
KOR,Korea,BOL,Bolivia,2012,11,34,-23
KOR,Korea,BOL,Bolivia,2013,24,32,-8
KOR,Korea,BOL,Bolivia,2014,19,19,0
KOR,Korea,BOL,Bolivia,2015,21,19,2
KOR,Korea,BOL,Bolivia,2016,18,23,-5
KOR,Korea,BOL,Bolivia,2017,32,27,5
LUX,Luxembourg,BOL,Bolivia,2008,1,1,0
LUX,Luxembourg,BOL,Bolivia,2009,0,0,0
LUX,Luxembourg,BOL,Bolivia,2010,2,2,0
LUX,Luxembourg,BOL,Bolivia,2011,1,3,-2
LUX,Luxembourg,BOL,Bolivia,2012,0,1,-1
LUX,Luxembourg,BOL,Bolivia,2013,2,2,0
LUX,Luxembourg,BOL,Bolivia,2014,1,1,0
LUX,Luxembourg,BOL,Bolivia,2015,1,1,0
LUX,Luxembourg,BOL,Bolivia,2016,0,6,-6
LUX,Luxembourg,BOL,Bolivia,2017,3,7,-4
MEX,Mexico,BOL,Bolivia,2008,0,95,-95
MEX,Mexico,BOL,Bolivia,2009,0,169,-169
MEX,Mexico,BOL,Bolivia,2010,0,176,-176
MEX,Mexico,BOL,Bolivia,2011,0,101,-101
MEX,Mexico,BOL,Bolivia,2012,0,109,-109
MEX,Mexico,BOL,Bolivia,2013,0,329,-329
MEX,Mexico,BOL,Bolivia,2014,0,199,-199
MEX,Mexico,BOL,Bolivia,2015,0,174,-174
MEX,Mexico,BOL,Bolivia,2016,0,131,-131
MEX,Mexico,BOL,Bolivia,2017,0,114,-114
NLD,Netherlands,BOL,Bolivia,2008,25,54,-29
NLD,Netherlands,BOL,Bolivia,2009,30,56,-26
NLD,Netherlands,BOL,Bolivia,2010,43,48,-5
NLD,Netherlands,BOL,Bolivia,2011,25,42,-17
NLD,Netherlands,BOL,Bolivia,2012,40,39,1
NLD,Netherlands,BOL,Bolivia,2013,33,39,-6
NLD,Netherlands,BOL,Bolivia,2014,21,45,-24
NLD,Netherlands,BOL,Bolivia,2015,22,32,-10
NLD,Netherlands,BOL,Bolivia,2016,26,28,-2
NLD,Netherlands,BOL,Bolivia,2017,19,37,-18
NZL,New Zealand,BOL,Bolivia,2008,2,2,0
NZL,New Zealand,BOL,Bolivia,2009,2,7,-5
NZL,New Zealand,BOL,Bolivia,2010,1,3,-2
NZL,New Zealand,BOL,Bolivia,2011,4,2,2
NZL,New Zealand,BOL,Bolivia,2012,0,1,-1
NZL,New Zealand,BOL,Bolivia,2013,5,10,-5
NZL,New Zealand,BOL,Bolivia,2014,3,3,0
NZL,New Zealand,BOL,Bolivia,2015,2,4,-2
NZL,New Zealand,BOL,Bolivia,2016,2,3,-1
NZL,New Zealand,BOL,Bolivia,2017,1,2,-1
NOR,Norway,BOL,Bolivia,2008,5,18,-13
NOR,Norway,BOL,Bolivia,2009,7,19,-12
NOR,Norway,BOL,Bolivia,2010,6,20,-14
NOR,Norway,BOL,Bolivia,2011,8,21,-13
NOR,Norway,BOL,Bolivia,2012,11,18,-7
NOR,Norway,BOL,Bolivia,2013,8,13,-5
NOR,Norway,BOL,Bolivia,2014,10,14,-4
NOR,Norway,BOL,Bolivia,2015,10,11,-1
NOR,Norway,BOL,Bolivia,2016,5,7,-2
NOR,Norway,BOL,Bolivia,2017,5,10,-5
POL,Poland,BOL,Bolivia,2009,0,9,-9
POL,Poland,BOL,Bolivia,2010,0,14,-14
POL,Poland,BOL,Bolivia,2011,0,12,-12
POL,Poland,BOL,Bolivia,2012,0,12,-12
POL,Poland,BOL,Bolivia,2013,0,19,-19
POL,Poland,BOL,Bolivia,2014,0,5,-5
POL,Poland,BOL,Bolivia,2015,0,6,-6
POL,Poland,BOL,Bolivia,2016,0,13,-13
POL,Poland,BOL,Bolivia,2017,0,13,-13
SVK,Slovak Republic,BOL,Bolivia,2008,0,1,-1
SVK,Slovak Republic,BOL,Bolivia,2009,0,1,-1
SVK,Slovak Republic,BOL,Bolivia,2011,0,2,-2
SVK,Slovak Republic,BOL,Bolivia,2013,0,1,-1
ESP,Spain,BOL,Bolivia,2008,18942,10390,8552
ESP,Spain,BOL,Bolivia,2009,21304,5872,15432
ESP,Spain,BOL,Bolivia,2010,19728,4045,15683
ESP,Spain,BOL,Bolivia,2011,18505,4562,13943
ESP,Spain,BOL,Bolivia,2012,19030,3871,15159
ESP,Spain,BOL,Bolivia,2013,21321,3589,17732
ESP,Spain,BOL,Bolivia,2014,10661,4138,6523
ESP,Spain,BOL,Bolivia,2015,6119,4284,1835
ESP,Spain,BOL,Bolivia,2016,4395,5272,-877
ESP,Spain,BOL,Bolivia,2017,4741,6366,-1625
SWE,Sweden,BOL,Bolivia,2008,11,205,-194
SWE,Sweden,BOL,Bolivia,2009,11,282,-271
SWE,Sweden,BOL,Bolivia,2010,22,320,-298
SWE,Sweden,BOL,Bolivia,2011,15,284,-269
SWE,Sweden,BOL,Bolivia,2012,23,205,-182
SWE,Sweden,BOL,Bolivia,2013,34,123,-89
SWE,Sweden,BOL,Bolivia,2014,37,121,-84
SWE,Sweden,BOL,Bolivia,2015,74,126,-52
SWE,Sweden,BOL,Bolivia,2016,24,78,-54
SWE,Sweden,BOL,Bolivia,2017,33,87,-54
CHE,Switzerland,BOL,Bolivia,2010,43,247,-204
CHE,Switzerland,BOL,Bolivia,2011,51,206,-155
CHE,Switzerland,BOL,Bolivia,2012,67,179,-112
CHE,Switzerland,BOL,Bolivia,2013,40,197,-157
CHE,Switzerland,BOL,Bolivia,2014,47,176,-129
CHE,Switzerland,BOL,Bolivia,2015,34,18,16
CHE,Switzerland,BOL,Bolivia,2016,52,223,-171
CHE,Switzerland,BOL,Bolivia,2017,41,237,-196
TUR,Turkey,BOL,Bolivia,2010,0,1,-1
USA,United States,BOL,Bolivia,2008,0,2436,-2436
USA,United States,BOL,Bolivia,2009,0,2837,-2837
USA,United States,BOL,Bolivia,2010,0,2253,-2253
USA,United States,BOL,Bolivia,2011,0,2173,-2173
USA,United States,BOL,Bolivia,2012,0,1948,-1948
USA,United States,BOL,Bolivia,2013,0,2071,-2071
USA,United States,BOL,Bolivia,2014,0,1719,-1719
USA,United States,BOL,Bolivia,2015,0,1626,-1626
USA,United States,BOL,Bolivia,2016,0,1595,-1595
USA,United States,BOL,Bolivia,2017,0,1510,-1510
CHL,Chile,BOL,Bolivia,2008,0,3371,-3371
CHL,Chile,BOL,Bolivia,2009,0,2053,-2053
CHL,Chile,BOL,Bolivia,2010,0,4632,-4632
CHL,Chile,BOL,Bolivia,2011,0,6238,-6238
CHL,Chile,BOL,Bolivia,2012,0,10803,-10803
CHL,Chile,BOL,Bolivia,2013,0,23563,-23563
CHL,Chile,BOL,Bolivia,2014,0,21559,-21559
CHL,Chile,BOL,Bolivia,2015,0,19805,-19805
CHL,Chile,BOL,Bolivia,2016,0,14811,-14811
EST,Estonia,BOL,Bolivia,2008,0,0,0
EST,Estonia,BOL,Bolivia,2009,0,0,0
EST,Estonia,BOL,Bolivia,2010,0,0,0
EST,Estonia,BOL,Bolivia,2011,0,0,0
EST,Estonia,BOL,Bolivia,2012,0,0,0
EST,Estonia,BOL,Bolivia,2013,0,0,0
EST,Estonia,BOL,Bolivia,2014,0,0,0
EST,Estonia,BOL,Bolivia,2015,0,0,0
EST,Estonia,BOL,Bolivia,2016,0,1,-1
EST,Estonia,BOL,Bolivia,2017,0,1,-1
SVN,Slovenia,BOL,Bolivia,2008,0,1,-1
SVN,Slovenia,BOL,Bolivia,2009,0,2,-2
SVN,Slovenia,BOL,Bolivia,2010,0,11,-11
SVN,Slovenia,BOL,Bolivia,2015,0,2,-2
SVN,Slovenia,BOL,Bolivia,2017,0,1,-1
AUS,Australia,BIH,Bosnia and Herzegovina,2008,314,190,124
AUS,Australia,BIH,Bosnia and Herzegovina,2009,316,134,182
AUS,Australia,BIH,Bosnia and Herzegovina,2010,259,150,109
AUS,Australia,BIH,Bosnia and Herzegovina,2011,296,116,180
AUS,Australia,BIH,Bosnia and Herzegovina,2012,250,118,132
AUS,Australia,BIH,Bosnia and Herzegovina,2013,319,68,251
AUS,Australia,BIH,Bosnia and Herzegovina,2014,349,137,212
AUS,Australia,BIH,Bosnia and Herzegovina,2015,300,148,152
AUS,Australia,BIH,Bosnia and Herzegovina,2016,200,107,93
AUS,Australia,BIH,Bosnia and Herzegovina,2017,0,123,-123
AUT,Austria,BIH,Bosnia and Herzegovina,2008,2096,2924,-828
AUT,Austria,BIH,Bosnia and Herzegovina,2009,2146,2423,-277
AUT,Austria,BIH,Bosnia and Herzegovina,2010,1996,2526,-530
AUT,Austria,BIH,Bosnia and Herzegovina,2011,2650,3872,-1222
AUT,Austria,BIH,Bosnia and Herzegovina,2012,2597,4133,-1536
AUT,Austria,BIH,Bosnia and Herzegovina,2013,2574,4990,-2416
AUT,Austria,BIH,Bosnia and Herzegovina,2014,2539,5164,-2625
AUT,Austria,BIH,Bosnia and Herzegovina,2015,2483,5193,-2710
AUT,Austria,BIH,Bosnia and Herzegovina,2016,2515,4325,-1810
AUT,Austria,BIH,Bosnia and Herzegovina,2017,2426,4207,-1781
BEL,Belgium,BIH,Bosnia and Herzegovina,2008,0,123,-123
BEL,Belgium,BIH,Bosnia and Herzegovina,2009,0,113,-113
BEL,Belgium,BIH,Bosnia and Herzegovina,2010,24,148,-124
BEL,Belgium,BIH,Bosnia and Herzegovina,2011,0,110,-110
BEL,Belgium,BIH,Bosnia and Herzegovina,2012,214,235,-21
BEL,Belgium,BIH,Bosnia and Herzegovina,2013,313,204,109
BEL,Belgium,BIH,Bosnia and Herzegovina,2014,216,185,31
BEL,Belgium,BIH,Bosnia and Herzegovina,2015,206,140,66
BEL,Belgium,BIH,Bosnia and Herzegovina,2016,82,128,-46
BEL,Belgium,BIH,Bosnia and Herzegovina,2017,50,150,-100
CAN,Canada,BIH,Bosnia and Herzegovina,2008,0,182,-182
CAN,Canada,BIH,Bosnia and Herzegovina,2009,0,156,-156
CAN,Canada,BIH,Bosnia and Herzegovina,2010,0,168,-168
CAN,Canada,BIH,Bosnia and Herzegovina,2011,0,140,-140
CAN,Canada,BIH,Bosnia and Herzegovina,2012,0,121,-121
CAN,Canada,BIH,Bosnia and Herzegovina,2013,0,119,-119
CAN,Canada,BIH,Bosnia and Herzegovina,2014,0,147,-147
CAN,Canada,BIH,Bosnia and Herzegovina,2015,0,195,-195
CAN,Canada,BIH,Bosnia and Herzegovina,2016,0,140,-140
CAN,Canada,BIH,Bosnia and Herzegovina,2017,0,105,-105
CZE,Czech Republic,BIH,Bosnia and Herzegovina,2008,4,669,-665
CZE,Czech Republic,BIH,Bosnia and Herzegovina,2009,2,242,-240
CZE,Czech Republic,BIH,Bosnia and Herzegovina,2010,4,71,-67
CZE,Czech Republic,BIH,Bosnia and Herzegovina,2011,5,87,-82
CZE,Czech Republic,BIH,Bosnia and Herzegovina,2012,70,222,-152
CZE,Czech Republic,BIH,Bosnia and Herzegovina,2013,222,125,97
CZE,Czech Republic,BIH,Bosnia and Herzegovina,2014,209,139,70
CZE,Czech Republic,BIH,Bosnia and Herzegovina,2015,107,229,-122
CZE,Czech Republic,BIH,Bosnia and Herzegovina,2016,154,209,-55
CZE,Czech Republic,BIH,Bosnia and Herzegovina,2017,132,319,-187
DNK,Denmark,BIH,Bosnia and Herzegovina,2008,21,112,-91
DNK,Denmark,BIH,Bosnia and Herzegovina,2009,37,50,-13
DNK,Denmark,BIH,Bosnia and Herzegovina,2010,101,87,14
DNK,Denmark,BIH,Bosnia and Herzegovina,2011,129,51,78
DNK,Denmark,BIH,Bosnia and Herzegovina,2012,95,81,14
DNK,Denmark,BIH,Bosnia and Herzegovina,2013,71,100,-29
DNK,Denmark,BIH,Bosnia and Herzegovina,2014,74,87,-13
DNK,Denmark,BIH,Bosnia and Herzegovina,2015,80,68,12
DNK,Denmark,BIH,Bosnia and Herzegovina,2016,59,81,-22
DNK,Denmark,BIH,Bosnia and Herzegovina,2017,68,90,-22
FIN,Finland,BIH,Bosnia and Herzegovina,2008,13,146,-133
FIN,Finland,BIH,Bosnia and Herzegovina,2009,4,71,-67
FIN,Finland,BIH,Bosnia and Herzegovina,2010,4,42,-38
FIN,Finland,BIH,Bosnia and Herzegovina,2011,3,28,-25
FIN,Finland,BIH,Bosnia and Herzegovina,2012,8,55,-47
FIN,Finland,BIH,Bosnia and Herzegovina,2013,7,63,-56
FIN,Finland,BIH,Bosnia and Herzegovina,2014,33,88,-55
FIN,Finland,BIH,Bosnia and Herzegovina,2015,18,88,-70
FIN,Finland,BIH,Bosnia and Herzegovina,2016,18,50,-32
FIN,Finland,BIH,Bosnia and Herzegovina,2017,17,71,-54
FRA,France,BIH,Bosnia and Herzegovina,2008,0,504,-504
FRA,France,BIH,Bosnia and Herzegovina,2009,0,384,-384
FRA,France,BIH,Bosnia and Herzegovina,2010,0,333,-333
FRA,France,BIH,Bosnia and Herzegovina,2011,0,313,-313
FRA,France,BIH,Bosnia and Herzegovina,2012,0,294,-294
FRA,France,BIH,Bosnia and Herzegovina,2013,0,377,-377
FRA,France,BIH,Bosnia and Herzegovina,2014,0,376,-376
FRA,France,BIH,Bosnia and Herzegovina,2015,0,339,-339
FRA,France,BIH,Bosnia and Herzegovina,2016,0,349,-349
FRA,France,BIH,Bosnia and Herzegovina,2017,0,336,-336
DEU,Germany,BIH,Bosnia and Herzegovina,2008,6900,6154,746
DEU,Germany,BIH,Bosnia and Herzegovina,2009,7435,6145,1290
DEU,Germany,BIH,Bosnia and Herzegovina,2010,6607,6920,-313
DEU,Germany,BIH,Bosnia and Herzegovina,2011,8360,9533,-1173
DEU,Germany,BIH,Bosnia and Herzegovina,2012,8982,12235,-3253
DEU,Germany,BIH,Bosnia and Herzegovina,2013,11043,15083,-4040
DEU,Germany,BIH,Bosnia and Herzegovina,2014,13774,20659,-6885
DEU,Germany,BIH,Bosnia and Herzegovina,2015,16055,21737,-5682
DEU,Germany,BIH,Bosnia and Herzegovina,2016,16621,22393,-5772
DEU,Germany,BIH,Bosnia and Herzegovina,2017,11831,23980,-12149
HUN,Hungary,BIH,Bosnia and Herzegovina,2008,8,79,-71
HUN,Hungary,BIH,Bosnia and Herzegovina,2009,38,23,15
HUN,Hungary,BIH,Bosnia and Herzegovina,2010,18,28,-10
HUN,Hungary,BIH,Bosnia and Herzegovina,2011,6,45,-39
HUN,Hungary,BIH,Bosnia and Herzegovina,2012,21,71,-50
HUN,Hungary,BIH,Bosnia and Herzegovina,2013,24,105,-81
HUN,Hungary,BIH,Bosnia and Herzegovina,2014,23,86,-63
HUN,Hungary,BIH,Bosnia and Herzegovina,2015,23,111,-88
HUN,Hungary,BIH,Bosnia and Herzegovina,2016,41,118,-77
HUN,Hungary,BIH,Bosnia and Herzegovina,2017,0,91,-91
ISL,Iceland,BIH,Bosnia and Herzegovina,2008,5,7,-2
ISL,Iceland,BIH,Bosnia and Herzegovina,2009,1,2,-1
ISL,Iceland,BIH,Bosnia and Herzegovina,2010,8,6,2
ISL,Iceland,BIH,Bosnia and Herzegovina,2011,2,1,1
ISL,Iceland,BIH,Bosnia and Herzegovina,2012,2,4,-2
ISL,Iceland,BIH,Bosnia and Herzegovina,2013,2,8,-6
ISL,Iceland,BIH,Bosnia and Herzegovina,2014,7,5,2
ISL,Iceland,BIH,Bosnia and Herzegovina,2015,5,11,-6
ISL,Iceland,BIH,Bosnia and Herzegovina,2016,4,6,-2
ISL,Iceland,BIH,Bosnia and Herzegovina,2017,2,38,-36
ITA,Italy,BIH,Bosnia and Herzegovina,2008,114,1959,-1845
ITA,Italy,BIH,Bosnia and Herzegovina,2009,135,1435,-1300
ITA,Italy,BIH,Bosnia and Herzegovina,2010,215,997,-782
ITA,Italy,BIH,Bosnia and Herzegovina,2011,193,789,-596
ITA,Italy,BIH,Bosnia and Herzegovina,2012,272,731,-459
ITA,Italy,BIH,Bosnia and Herzegovina,2013,272,693,-421
ITA,Italy,BIH,Bosnia and Herzegovina,2014,251,562,-311
ITA,Italy,BIH,Bosnia and Herzegovina,2015,249,490,-241
ITA,Italy,BIH,Bosnia and Herzegovina,2016,0,440,-440
ITA,Italy,BIH,Bosnia and Herzegovina,2017,161,458,-297
JPN,Japan,BIH,Bosnia and Herzegovina,2008,48,49,-1
JPN,Japan,BIH,Bosnia and Herzegovina,2009,68,73,-5
JPN,Japan,BIH,Bosnia and Herzegovina,2010,58,60,-2
JPN,Japan,BIH,Bosnia and Herzegovina,2011,24,26,-2
JPN,Japan,BIH,Bosnia and Herzegovina,2012,41,46,-5
JPN,Japan,BIH,Bosnia and Herzegovina,2013,36,39,-3
JPN,Japan,BIH,Bosnia and Herzegovina,2014,41,44,-3
JPN,Japan,BIH,Bosnia and Herzegovina,2015,47,48,-1
JPN,Japan,BIH,Bosnia and Herzegovina,2016,30,36,-6
JPN,Japan,BIH,Bosnia and Herzegovina,2017,42,53,-11
KOR,Korea,BIH,Bosnia and Herzegovina,2008,3,3,0
KOR,Korea,BIH,Bosnia and Herzegovina,2009,1,3,-2
KOR,Korea,BIH,Bosnia and Herzegovina,2010,3,4,-1
KOR,Korea,BIH,Bosnia and Herzegovina,2011,7,3,4
KOR,Korea,BIH,Bosnia and Herzegovina,2012,5,2,3
KOR,Korea,BIH,Bosnia and Herzegovina,2013,1,1,0
KOR,Korea,BIH,Bosnia and Herzegovina,2014,1,2,-1
KOR,Korea,BIH,Bosnia and Herzegovina,2015,2,4,-2
KOR,Korea,BIH,Bosnia and Herzegovina,2016,4,5,-1
KOR,Korea,BIH,Bosnia and Herzegovina,2017,5,4,1
LUX,Luxembourg,BIH,Bosnia and Herzegovina,2008,35,53,-18
LUX,Luxembourg,BIH,Bosnia and Herzegovina,2009,17,47,-30
LUX,Luxembourg,BIH,Bosnia and Herzegovina,2010,11,65,-54
LUX,Luxembourg,BIH,Bosnia and Herzegovina,2011,16,94,-78
LUX,Luxembourg,BIH,Bosnia and Herzegovina,2012,31,239,-208
LUX,Luxembourg,BIH,Bosnia and Herzegovina,2013,142,171,-29
LUX,Luxembourg,BIH,Bosnia and Herzegovina,2014,81,178,-97
LUX,Luxembourg,BIH,Bosnia and Herzegovina,2015,205,121,84
LUX,Luxembourg,BIH,Bosnia and Herzegovina,2016,63,136,-73
LUX,Luxembourg,BIH,Bosnia and Herzegovina,2017,55,111,-56
MEX,Mexico,BIH,Bosnia and Herzegovina,2010,0,1,-1
MEX,Mexico,BIH,Bosnia and Herzegovina,2012,0,0,0
MEX,Mexico,BIH,Bosnia and Herzegovina,2013,0,3,-3
MEX,Mexico,BIH,Bosnia and Herzegovina,2014,0,2,-2
MEX,Mexico,BIH,Bosnia and Herzegovina,2015,0,2,-2
MEX,Mexico,BIH,Bosnia and Herzegovina,2017,0,3,-3
NLD,Netherlands,BIH,Bosnia and Herzegovina,2009,101,212,-111
NLD,Netherlands,BIH,Bosnia and Herzegovina,2010,194,147,47
NLD,Netherlands,BIH,Bosnia and Herzegovina,2011,129,223,-94
NLD,Netherlands,BIH,Bosnia and Herzegovina,2012,177,135,42
NLD,Netherlands,BIH,Bosnia and Herzegovina,2013,109,129,-20
NLD,Netherlands,BIH,Bosnia and Herzegovina,2014,123,138,-15
NLD,Netherlands,BIH,Bosnia and Herzegovina,2015,85,138,-53
NLD,Netherlands,BIH,Bosnia and Herzegovina,2016,68,156,-88
NLD,Netherlands,BIH,Bosnia and Herzegovina,2017,51,140,-89
NZL,New Zealand,BIH,Bosnia and Herzegovina,2008,0,4,-4
NZL,New Zealand,BIH,Bosnia and Herzegovina,2009,3,0,3
NZL,New Zealand,BIH,Bosnia and Herzegovina,2010,0,0,0
NZL,New Zealand,BIH,Bosnia and Herzegovina,2012,0,0,0
NZL,New Zealand,BIH,Bosnia and Herzegovina,2014,0,1,-1
NZL,New Zealand,BIH,Bosnia and Herzegovina,2015,0,1,-1
NZL,New Zealand,BIH,Bosnia and Herzegovina,2016,0,3,-3
NZL,New Zealand,BIH,Bosnia and Herzegovina,2017,0,10,-10
NOR,Norway,BIH,Bosnia and Herzegovina,2008,22,198,-176
NOR,Norway,BIH,Bosnia and Herzegovina,2009,40,130,-90
NOR,Norway,BIH,Bosnia and Herzegovina,2010,67,111,-44
NOR,Norway,BIH,Bosnia and Herzegovina,2011,61,107,-46
NOR,Norway,BIH,Bosnia and Herzegovina,2012,34,159,-125
NOR,Norway,BIH,Bosnia and Herzegovina,2013,46,172,-126
NOR,Norway,BIH,Bosnia and Herzegovina,2014,29,166,-137
NOR,Norway,BIH,Bosnia and Herzegovina,2015,52,222,-170
NOR,Norway,BIH,Bosnia and Herzegovina,2016,37,179,-142
NOR,Norway,BIH,Bosnia and Herzegovina,2017,41,194,-153
POL,Poland,BIH,Bosnia and Herzegovina,2009,0,91,-91
POL,Poland,BIH,Bosnia and Herzegovina,2010,0,61,-61
POL,Poland,BIH,Bosnia and Herzegovina,2011,0,60,-60
POL,Poland,BIH,Bosnia and Herzegovina,2012,0,34,-34
POL,Poland,BIH,Bosnia and Herzegovina,2013,0,0,0
POL,Poland,BIH,Bosnia and Herzegovina,2014,0,0,0
POL,Poland,BIH,Bosnia and Herzegovina,2015,0,0,0
POL,Poland,BIH,Bosnia and Herzegovina,2016,0,0,0
POL,Poland,BIH,Bosnia and Herzegovina,2017,0,0,0
SVK,Slovak Republic,BIH,Bosnia and Herzegovina,2008,17,6,11
SVK,Slovak Republic,BIH,Bosnia and Herzegovina,2009,7,2,5
SVK,Slovak Republic,BIH,Bosnia and Herzegovina,2010,7,9,-2
SVK,Slovak Republic,BIH,Bosnia and Herzegovina,2011,4,3,1
SVK,Slovak Republic,BIH,Bosnia and Herzegovina,2012,0,3,-3
SVK,Slovak Republic,BIH,Bosnia and Herzegovina,2013,0,2,-2
SVK,Slovak Republic,BIH,Bosnia and Herzegovina,2014,1,3,-2
SVK,Slovak Republic,BIH,Bosnia and Herzegovina,2015,0,5,-5
SVK,Slovak Republic,BIH,Bosnia and Herzegovina,2016,0,4,-4
ESP,Spain,BIH,Bosnia and Herzegovina,2008,126,132,-6
ESP,Spain,BIH,Bosnia and Herzegovina,2009,128,74,54
ESP,Spain,BIH,Bosnia and Herzegovina,2010,98,56,42
ESP,Spain,BIH,Bosnia and Herzegovina,2011,94,95,-1
ESP,Spain,BIH,Bosnia and Herzegovina,2012,54,96,-42
ESP,Spain,BIH,Bosnia and Herzegovina,2013,79,77,2
ESP,Spain,BIH,Bosnia and Herzegovina,2014,63,82,-19
ESP,Spain,BIH,Bosnia and Herzegovina,2015,37,80,-43
ESP,Spain,BIH,Bosnia and Herzegovina,2016,32,81,-49
ESP,Spain,BIH,Bosnia and Herzegovina,2017,63,90,-27
SWE,Sweden,BIH,Bosnia and Herzegovina,2008,84,607,-523
SWE,Sweden,BIH,Bosnia and Herzegovina,2009,52,538,-486
SWE,Sweden,BIH,Bosnia and Herzegovina,2010,79,516,-437
SWE,Sweden,BIH,Bosnia and Herzegovina,2011,94,520,-426
SWE,Sweden,BIH,Bosnia and Herzegovina,2012,50,745,-695
SWE,Sweden,BIH,Bosnia and Herzegovina,2013,55,569,-514
SWE,Sweden,BIH,Bosnia and Herzegovina,2014,72,633,-561
SWE,Sweden,BIH,Bosnia and Herzegovina,2015,109,630,-521
SWE,Sweden,BIH,Bosnia and Herzegovina,2016,83,603,-520
SWE,Sweden,BIH,Bosnia and Herzegovina,2017,66,855,-789
CHE,Switzerland,BIH,Bosnia and Herzegovina,2010,201,748,-547
CHE,Switzerland,BIH,Bosnia and Herzegovina,2011,271,660,-389
CHE,Switzerland,BIH,Bosnia and Herzegovina,2012,238,660,-422
CHE,Switzerland,BIH,Bosnia and Herzegovina,2013,257,698,-441
CHE,Switzerland,BIH,Bosnia and Herzegovina,2014,229,685,-456
CHE,Switzerland,BIH,Bosnia and Herzegovina,2015,248,668,-420
CHE,Switzerland,BIH,Bosnia and Herzegovina,2016,260,656,-396
CHE,Switzerland,BIH,Bosnia and Herzegovina,2017,284,646,-362
TUR,Turkey,BIH,Bosnia and Herzegovina,2010,0,66,-66
TUR,Turkey,BIH,Bosnia and Herzegovina,2016,180,284,-104
TUR,Turkey,BIH,Bosnia and Herzegovina,2017,202,242,-40
USA,United States,BIH,Bosnia and Herzegovina,2008,0,1491,-1491
USA,United States,BIH,Bosnia and Herzegovina,2009,0,1501,-1501
USA,United States,BIH,Bosnia and Herzegovina,2010,0,946,-946
USA,United States,BIH,Bosnia and Herzegovina,2011,0,878,-878
USA,United States,BIH,Bosnia and Herzegovina,2012,0,815,-815
USA,United States,BIH,Bosnia and Herzegovina,2013,0,697,-697
USA,United States,BIH,Bosnia and Herzegovina,2014,0,693,-693
USA,United States,BIH,Bosnia and Herzegovina,2015,0,859,-859
USA,United States,BIH,Bosnia and Herzegovina,2016,0,971,-971
USA,United States,BIH,Bosnia and Herzegovina,2017,0,846,-846
CHL,Chile,BIH,Bosnia and Herzegovina,2008,0,1,-1
CHL,Chile,BIH,Bosnia and Herzegovina,2009,0,1,-1
CHL,Chile,BIH,Bosnia and Herzegovina,2010,0,1,-1
CHL,Chile,BIH,Bosnia and Herzegovina,2011,0,4,-4
CHL,Chile,BIH,Bosnia and Herzegovina,2012,0,4,-4
CHL,Chile,BIH,Bosnia and Herzegovina,2013,0,1,-1
CHL,Chile,BIH,Bosnia and Herzegovina,2014,0,1,-1
CHL,Chile,BIH,Bosnia and Herzegovina,2015,0,38,-38
CHL,Chile,BIH,Bosnia and Herzegovina,2016,0,6,-6
EST,Estonia,BIH,Bosnia and Herzegovina,2008,0,0,0
EST,Estonia,BIH,Bosnia and Herzegovina,2009,0,1,-1
EST,Estonia,BIH,Bosnia and Herzegovina,2010,0,0,0
EST,Estonia,BIH,Bosnia and Herzegovina,2011,0,0,0
EST,Estonia,BIH,Bosnia and Herzegovina,2012,0,0,0
EST,Estonia,BIH,Bosnia and Herzegovina,2013,0,1,-1
EST,Estonia,BIH,Bosnia and Herzegovina,2014,0,0,0
EST,Estonia,BIH,Bosnia and Herzegovina,2015,0,0,0
EST,Estonia,BIH,Bosnia and Herzegovina,2016,0,0,0
EST,Estonia,BIH,Bosnia and Herzegovina,2017,0,1,-1
SVN,Slovenia,BIH,Bosnia and Herzegovina,2008,3016,17928,-14912
SVN,Slovenia,BIH,Bosnia and Herzegovina,2009,6658,5330,1328
SVN,Slovenia,BIH,Bosnia and Herzegovina,2010,4439,3694,745
SVN,Slovenia,BIH,Bosnia and Herzegovina,2011,635,4521,-3886
SVN,Slovenia,BIH,Bosnia and Herzegovina,2012,442,4386,-3944
SVN,Slovenia,BIH,Bosnia and Herzegovina,2013,332,3659,-3327
SVN,Slovenia,BIH,Bosnia and Herzegovina,2014,365,5068,-4703
SVN,Slovenia,BIH,Bosnia and Herzegovina,2015,592,5896,-5304
SVN,Slovenia,BIH,Bosnia and Herzegovina,2016,809,6774,-5965
SVN,Slovenia,BIH,Bosnia and Herzegovina,2017,947,11529,-10582
AUS,Australia,BWA,Botswana,2008,0,43,-43
AUS,Australia,BWA,Botswana,2009,8,46,-38
AUS,Australia,BWA,Botswana,2010,6,60,-54
AUS,Australia,BWA,Botswana,2011,6,52,-46
AUS,Australia,BWA,Botswana,2012,7,68,-61
AUS,Australia,BWA,Botswana,2013,7,76,-69
AUS,Australia,BWA,Botswana,2014,6,66,-60
AUS,Australia,BWA,Botswana,2015,0,42,-42
AUS,Australia,BWA,Botswana,2016,0,41,-41
AUS,Australia,BWA,Botswana,2017,0,44,-44
AUT,Austria,BWA,Botswana,2008,1,5,-4
AUT,Austria,BWA,Botswana,2009,3,0,3
AUT,Austria,BWA,Botswana,2010,3,0,3
AUT,Austria,BWA,Botswana,2011,0,2,-2
AUT,Austria,BWA,Botswana,2012,1,0,1
AUT,Austria,BWA,Botswana,2013,0,1,-1
AUT,Austria,BWA,Botswana,2014,0,2,-2
AUT,Austria,BWA,Botswana,2015,4,2,2
AUT,Austria,BWA,Botswana,2016,0,2,-2
AUT,Austria,BWA,Botswana,2017,1,1,0
BEL,Belgium,BWA,Botswana,2008,0,4,-4
BEL,Belgium,BWA,Botswana,2009,0,0,0
BEL,Belgium,BWA,Botswana,2010,1,5,-4
BEL,Belgium,BWA,Botswana,2011,0,4,-4
BEL,Belgium,BWA,Botswana,2012,1,3,-2
BEL,Belgium,BWA,Botswana,2013,2,1,1
BEL,Belgium,BWA,Botswana,2014,2,5,-3
BEL,Belgium,BWA,Botswana,2017,1,1,0
CAN,Canada,BWA,Botswana,2008,0,28,-28
CAN,Canada,BWA,Botswana,2009,0,15,-15
CAN,Canada,BWA,Botswana,2010,0,42,-42
CAN,Canada,BWA,Botswana,2011,0,53,-53
CAN,Canada,BWA,Botswana,2012,0,64,-64
CAN,Canada,BWA,Botswana,2013,0,77,-77
CAN,Canada,BWA,Botswana,2014,0,103,-103
CAN,Canada,BWA,Botswana,2015,0,96,-96
CAN,Canada,BWA,Botswana,2016,0,65,-65
CAN,Canada,BWA,Botswana,2017,0,75,-75
CZE,Czech Republic,BWA,Botswana,2008,0,15,-15
CZE,Czech Republic,BWA,Botswana,2009,0,34,-34
CZE,Czech Republic,BWA,Botswana,2010,0,22,-22
CZE,Czech Republic,BWA,Botswana,2011,0,22,-22
CZE,Czech Republic,BWA,Botswana,2012,18,27,-9
CZE,Czech Republic,BWA,Botswana,2013,23,10,13
CZE,Czech Republic,BWA,Botswana,2014,14,20,-6
CZE,Czech Republic,BWA,Botswana,2015,21,3,18
CZE,Czech Republic,BWA,Botswana,2016,12,3,9
CZE,Czech Republic,BWA,Botswana,2017,23,4,19
DNK,Denmark,BWA,Botswana,2008,0,2,-2
DNK,Denmark,BWA,Botswana,2009,2,2,0
DNK,Denmark,BWA,Botswana,2010,1,1,0
DNK,Denmark,BWA,Botswana,2011,7,1,6
DNK,Denmark,BWA,Botswana,2012,2,0,2
DNK,Denmark,BWA,Botswana,2013,0,0,0
DNK,Denmark,BWA,Botswana,2014,1,1,0
DNK,Denmark,BWA,Botswana,2015,1,0,1
DNK,Denmark,BWA,Botswana,2016,1,2,-1
DNK,Denmark,BWA,Botswana,2017,2,0,2
FIN,Finland,BWA,Botswana,2008,0,0,0
FIN,Finland,BWA,Botswana,2009,0,0,0
FIN,Finland,BWA,Botswana,2010,0,0,0
FIN,Finland,BWA,Botswana,2011,0,0,0
FIN,Finland,BWA,Botswana,2012,0,2,-2
FIN,Finland,BWA,Botswana,2013,0,1,-1
FIN,Finland,BWA,Botswana,2014,0,0,0
FIN,Finland,BWA,Botswana,2015,0,0,0
FIN,Finland,BWA,Botswana,2016,0,1,-1
FIN,Finland,BWA,Botswana,2017,0,0,0
FRA,France,BWA,Botswana,2008,0,1,-1
FRA,France,BWA,Botswana,2009,0,2,-2
FRA,France,BWA,Botswana,2010,0,3,-3
FRA,France,BWA,Botswana,2011,0,4,-4
FRA,France,BWA,Botswana,2012,0,2,-2
FRA,France,BWA,Botswana,2013,0,5,-5
FRA,France,BWA,Botswana,2014,0,2,-2
FRA,France,BWA,Botswana,2015,0,1,-1
FRA,France,BWA,Botswana,2016,0,2,-2
FRA,France,BWA,Botswana,2017,0,4,-4
DEU,Germany,BWA,Botswana,2008,27,17,10
DEU,Germany,BWA,Botswana,2009,19,15,4
DEU,Germany,BWA,Botswana,2010,13,15,-2
DEU,Germany,BWA,Botswana,2011,10,28,-18
DEU,Germany,BWA,Botswana,2012,18,25,-7
DEU,Germany,BWA,Botswana,2013,18,21,-3
DEU,Germany,BWA,Botswana,2014,13,34,-21
DEU,Germany,BWA,Botswana,2015,19,22,-3
DEU,Germany,BWA,Botswana,2016,14,22,-8
DEU,Germany,BWA,Botswana,2017,19,37,-18
HUN,Hungary,BWA,Botswana,2008,0,0,0
HUN,Hungary,BWA,Botswana,2009,0,0,0
HUN,Hungary,BWA,Botswana,2010,0,2,-2
HUN,Hungary,BWA,Botswana,2011,0,1,-1
HUN,Hungary,BWA,Botswana,2012,1,2,-1
HUN,Hungary,BWA,Botswana,2013,0,0,0
HUN,Hungary,BWA,Botswana,2014,0,0,0
HUN,Hungary,BWA,Botswana,2015,0,2,-2
HUN,Hungary,BWA,Botswana,2016,0,0,0
HUN,Hungary,BWA,Botswana,2017,0,2,-2
ISL,Iceland,BWA,Botswana,2016,0,0,0
ISL,Iceland,BWA,Botswana,2017,0,0,0
ITA,Italy,BWA,Botswana,2008,0,1,-1
ITA,Italy,BWA,Botswana,2009,0,3,-3
ITA,Italy,BWA,Botswana,2010,0,4,-4
ITA,Italy,BWA,Botswana,2011,0,8,-8
ITA,Italy,BWA,Botswana,2012,0,4,-4
ITA,Italy,BWA,Botswana,2013,0,1,-1
ITA,Italy,BWA,Botswana,2015,0,4,-4
ITA,Italy,BWA,Botswana,2016,0,3,-3
ITA,Italy,BWA,Botswana,2017,1,1,0
JPN,Japan,BWA,Botswana,2008,55,56,-1
JPN,Japan,BWA,Botswana,2009,36,35,1
JPN,Japan,BWA,Botswana,2010,72,91,-19
JPN,Japan,BWA,Botswana,2011,79,84,-5
JPN,Japan,BWA,Botswana,2012,62,66,-4
JPN,Japan,BWA,Botswana,2013,104,108,-4
JPN,Japan,BWA,Botswana,2014,69,71,-2
JPN,Japan,BWA,Botswana,2015,80,95,-15
JPN,Japan,BWA,Botswana,2016,54,67,-13
JPN,Japan,BWA,Botswana,2017,101,98,3
KOR,Korea,BWA,Botswana,2008,2,2,0
KOR,Korea,BWA,Botswana,2009,2,2,0
KOR,Korea,BWA,Botswana,2010,3,2,1
KOR,Korea,BWA,Botswana,2011,2,5,-3
KOR,Korea,BWA,Botswana,2012,4,1,3
KOR,Korea,BWA,Botswana,2013,4,5,-1
KOR,Korea,BWA,Botswana,2014,3,5,-2
KOR,Korea,BWA,Botswana,2015,7,6,1
KOR,Korea,BWA,Botswana,2016,1,3,-2
KOR,Korea,BWA,Botswana,2017,7,6,1
LUX,Luxembourg,BWA,Botswana,2008,0,0,0
LUX,Luxembourg,BWA,Botswana,2009,0,0,0
LUX,Luxembourg,BWA,Botswana,2010,0,1,-1
LUX,Luxembourg,BWA,Botswana,2011,0,0,0
LUX,Luxembourg,BWA,Botswana,2012,0,0,0
LUX,Luxembourg,BWA,Botswana,2013,0,0,0
LUX,Luxembourg,BWA,Botswana,2014,0,0,0
LUX,Luxembourg,BWA,Botswana,2015,0,0,0
LUX,Luxembourg,BWA,Botswana,2016,0,3,-3
LUX,Luxembourg,BWA,Botswana,2017,0,0,0
MEX,Mexico,BWA,Botswana,2012,0,0,0
MEX,Mexico,BWA,Botswana,2013,0,0,0
MEX,Mexico,BWA,Botswana,2014,0,0,0
MEX,Mexico,BWA,Botswana,2016,0,0,0
NLD,Netherlands,BWA,Botswana,2008,8,8,0
NLD,Netherlands,BWA,Botswana,2009,9,9,0
NLD,Netherlands,BWA,Botswana,2010,10,6,4
NLD,Netherlands,BWA,Botswana,2011,1,5,-4
NLD,Netherlands,BWA,Botswana,2012,2,5,-3
NLD,Netherlands,BWA,Botswana,2013,2,4,-2
NLD,Netherlands,BWA,Botswana,2014,4,5,-1
NLD,Netherlands,BWA,Botswana,2015,2,3,-1
NLD,Netherlands,BWA,Botswana,2016,5,6,-1
NLD,Netherlands,BWA,Botswana,2017,6,7,-1
NZL,New Zealand,BWA,Botswana,2008,3,3,0
NZL,New Zealand,BWA,Botswana,2009,1,12,-11
NZL,New Zealand,BWA,Botswana,2010,2,15,-13
NZL,New Zealand,BWA,Botswana,2011,2,9,-7
NZL,New Zealand,BWA,Botswana,2012,6,5,1
NZL,New Zealand,BWA,Botswana,2013,5,4,1
NZL,New Zealand,BWA,Botswana,2014,2,5,-3
NZL,New Zealand,BWA,Botswana,2015,3,7,-4
NZL,New Zealand,BWA,Botswana,2016,4,13,-9
NZL,New Zealand,BWA,Botswana,2017,6,3,3
NOR,Norway,BWA,Botswana,2008,4,12,-8
NOR,Norway,BWA,Botswana,2009,3,1,2
NOR,Norway,BWA,Botswana,2010,6,4,2
NOR,Norway,BWA,Botswana,2011,5,4,1
NOR,Norway,BWA,Botswana,2012,5,6,-1
NOR,Norway,BWA,Botswana,2013,2,6,-4
NOR,Norway,BWA,Botswana,2014,9,1,8
NOR,Norway,BWA,Botswana,2015,2,3,-1
NOR,Norway,BWA,Botswana,2016,0,3,-3
NOR,Norway,BWA,Botswana,2017,0,2,-2
POL,Poland,BWA,Botswana,2009,0,0,0
POL,Poland,BWA,Botswana,2010,0,1,-1
POL,Poland,BWA,Botswana,2011,0,0,0
POL,Poland,BWA,Botswana,2012,0,0,0
POL,Poland,BWA,Botswana,2013,0,1,-1
POL,Poland,BWA,Botswana,2014,0,0,0
POL,Poland,BWA,Botswana,2015,0,1,-1
POL,Poland,BWA,Botswana,2016,0,0,0
POL,Poland,BWA,Botswana,2017,0,0,0
SVK,Slovak Republic,BWA,Botswana,2008,0,0,0
SVK,Slovak Republic,BWA,Botswana,2010,0,1,-1
ESP,Spain,BWA,Botswana,2008,0,2,-2
ESP,Spain,BWA,Botswana,2009,0,2,-2
ESP,Spain,BWA,Botswana,2010,1,0,1
ESP,Spain,BWA,Botswana,2011,4,3,1
ESP,Spain,BWA,Botswana,2012,0,2,-2
ESP,Spain,BWA,Botswana,2013,2,3,-1
ESP,Spain,BWA,Botswana,2014,1,2,-1
ESP,Spain,BWA,Botswana,2015,0,3,-3
ESP,Spain,BWA,Botswana,2016,1,0,1
ESP,Spain,BWA,Botswana,2017,1,5,-4
SWE,Sweden,BWA,Botswana,2008,1,4,-3
SWE,Sweden,BWA,Botswana,2009,0,2,-2
SWE,Sweden,BWA,Botswana,2010,6,5,1
SWE,Sweden,BWA,Botswana,2011,0,7,-7
SWE,Sweden,BWA,Botswana,2012,0,1,-1
SWE,Sweden,BWA,Botswana,2013,1,3,-2
SWE,Sweden,BWA,Botswana,2014,4,5,-1
SWE,Sweden,BWA,Botswana,2015,1,2,-1
SWE,Sweden,BWA,Botswana,2016,1,6,-5
SWE,Sweden,BWA,Botswana,2017,2,3,-1
CHE,Switzerland,BWA,Botswana,2010,0,1,-1
CHE,Switzerland,BWA,Botswana,2011,0,1,-1
CHE,Switzerland,BWA,Botswana,2012,1,3,-2
CHE,Switzerland,BWA,Botswana,2013,0,2,-2
CHE,Switzerland,BWA,Botswana,2014,2,1,1
CHE,Switzerland,BWA,Botswana,2015,2,2,0
CHE,Switzerland,BWA,Botswana,2016,1,2,-1
CHE,Switzerland,BWA,Botswana,2017,4,7,-3
TUR,Turkey,BWA,Botswana,2010,0,1,-1
GBR,United Kingdom,BWA,Botswana,2012,0,1000,-1000
USA,United States,BWA,Botswana,2008,0,41,-41
USA,United States,BWA,Botswana,2009,0,55,-55
USA,United States,BWA,Botswana,2010,0,66,-66
USA,United States,BWA,Botswana,2011,0,76,-76
USA,United States,BWA,Botswana,2012,0,80,-80
USA,United States,BWA,Botswana,2013,0,53,-53
USA,United States,BWA,Botswana,2014,0,58,-58
USA,United States,BWA,Botswana,2015,0,61,-61
USA,United States,BWA,Botswana,2016,0,78,-78
USA,United States,BWA,Botswana,2017,0,112,-112
CHL,Chile,BWA,Botswana,2008,0,0,0
CHL,Chile,BWA,Botswana,2009,0,0,0
CHL,Chile,BWA,Botswana,2010,0,0,0
CHL,Chile,BWA,Botswana,2011,0,0,0
CHL,Chile,BWA,Botswana,2012,0,0,0
CHL,Chile,BWA,Botswana,2013,0,0,0
CHL,Chile,BWA,Botswana,2014,0,0,0
CHL,Chile,BWA,Botswana,2015,0,1,-1
CHL,Chile,BWA,Botswana,2016,0,0,0
EST,Estonia,BWA,Botswana,2008,0,0,0
EST,Estonia,BWA,Botswana,2009,0,0,0
EST,Estonia,BWA,Botswana,2010,0,0,0
EST,Estonia,BWA,Botswana,2011,0,0,0
EST,Estonia,BWA,Botswana,2012,0,0,0
EST,Estonia,BWA,Botswana,2013,0,0,0
EST,Estonia,BWA,Botswana,2014,0,0,0
EST,Estonia,BWA,Botswana,2015,0,0,0
EST,Estonia,BWA,Botswana,2016,0,0,0
EST,Estonia,BWA,Botswana,2017,0,0,0
SVN,Slovenia,BWA,Botswana,2008,0,1,-1
AUS,Australia,BRA,Brazil,2008,84,789,-705
AUS,Australia,BRA,Brazil,2009,109,911,-802
AUS,Australia,BRA,Brazil,2010,105,1206,-1101
AUS,Australia,BRA,Brazil,2011,147,908,-761
AUS,Australia,BRA,Brazil,2012,156,1084,-928
AUS,Australia,BRA,Brazil,2013,193,1285,-1092
AUS,Australia,BRA,Brazil,2014,206,1527,-1321
AUS,Australia,BRA,Brazil,2015,200,1286,-1086
AUS,Australia,BRA,Brazil,2016,100,1375,-1275
AUS,Australia,BRA,Brazil,2017,0,1742,-1742
AUT,Austria,BRA,Brazil,2008,284,476,-192
AUT,Austria,BRA,Brazil,2009,357,442,-85
AUT,Austria,BRA,Brazil,2010,315,408,-93
AUT,Austria,BRA,Brazil,2011,332,369,-37
AUT,Austria,BRA,Brazil,2012,312,424,-112
AUT,Austria,BRA,Brazil,2013,290,395,-105
AUT,Austria,BRA,Brazil,2014,284,433,-149
AUT,Austria,BRA,Brazil,2015,315,491,-176
AUT,Austria,BRA,Brazil,2016,315,544,-229
AUT,Austria,BRA,Brazil,2017,342,622,-280
BEL,Belgium,BRA,Brazil,2008,379,1209,-830
BEL,Belgium,BRA,Brazil,2009,486,1330,-844
BEL,Belgium,BRA,Brazil,2010,488,1608,-1120
BEL,Belgium,BRA,Brazil,2011,571,1342,-771
BEL,Belgium,BRA,Brazil,2012,639,1298,-659
BEL,Belgium,BRA,Brazil,2013,711,1108,-397
BEL,Belgium,BRA,Brazil,2014,488,826,-338
BEL,Belgium,BRA,Brazil,2015,488,965,-477
BEL,Belgium,BRA,Brazil,2016,423,1006,-583
BEL,Belgium,BRA,Brazil,2017,370,1172,-802
CAN,Canada,BRA,Brazil,2008,0,2137,-2137
CAN,Canada,BRA,Brazil,2009,0,2509,-2509
CAN,Canada,BRA,Brazil,2010,0,2598,-2598
CAN,Canada,BRA,Brazil,2011,0,1508,-1508
CAN,Canada,BRA,Brazil,2012,0,1641,-1641
CAN,Canada,BRA,Brazil,2013,0,1712,-1712
CAN,Canada,BRA,Brazil,2014,0,1916,-1916
CAN,Canada,BRA,Brazil,2015,0,1750,-1750
CAN,Canada,BRA,Brazil,2016,0,1730,-1730
CAN,Canada,BRA,Brazil,2017,0,2760,-2760
CZE,Czech Republic,BRA,Brazil,2008,0,138,-138
CZE,Czech Republic,BRA,Brazil,2009,1,106,-105
CZE,Czech Republic,BRA,Brazil,2010,0,91,-91
CZE,Czech Republic,BRA,Brazil,2011,0,59,-59
CZE,Czech Republic,BRA,Brazil,2012,28,54,-26
CZE,Czech Republic,BRA,Brazil,2013,51,83,-32
CZE,Czech Republic,BRA,Brazil,2014,51,78,-27
CZE,Czech Republic,BRA,Brazil,2015,54,96,-42
CZE,Czech Republic,BRA,Brazil,2016,41,166,-125
CZE,Czech Republic,BRA,Brazil,2017,59,251,-192
DNK,Denmark,BRA,Brazil,2008,149,304,-155
DNK,Denmark,BRA,Brazil,2009,256,245,11
DNK,Denmark,BRA,Brazil,2010,252,267,-15
DNK,Denmark,BRA,Brazil,2011,241,202,39
DNK,Denmark,BRA,Brazil,2012,254,168,86
DNK,Denmark,BRA,Brazil,2013,252,237,15
DNK,Denmark,BRA,Brazil,2014,265,288,-23
DNK,Denmark,BRA,Brazil,2015,281,295,-14
DNK,Denmark,BRA,Brazil,2016,268,346,-78
DNK,Denmark,BRA,Brazil,2017,270,385,-115
FIN,Finland,BRA,Brazil,2008,36,115,-79
FIN,Finland,BRA,Brazil,2009,24,114,-90
FIN,Finland,BRA,Brazil,2010,36,99,-63
FIN,Finland,BRA,Brazil,2011,38,118,-80
FIN,Finland,BRA,Brazil,2012,56,82,-26
FIN,Finland,BRA,Brazil,2013,33,90,-57
FIN,Finland,BRA,Brazil,2014,43,113,-70
FIN,Finland,BRA,Brazil,2015,24,114,-90
FIN,Finland,BRA,Brazil,2016,30,159,-129
FIN,Finland,BRA,Brazil,2017,23,150,-127
FRA,France,BRA,Brazil,2008,0,2192,-2192
FRA,France,BRA,Brazil,2009,0,2318,-2318
FRA,France,BRA,Brazil,2010,0,2678,-2678
FRA,France,BRA,Brazil,2011,0,2282,-2282
FRA,France,BRA,Brazil,2012,0,2618,-2618
FRA,France,BRA,Brazil,2013,0,2737,-2737
FRA,France,BRA,Brazil,2014,0,3070,-3070
FRA,France,BRA,Brazil,2015,0,3113,-3113
FRA,France,BRA,Brazil,2016,0,2998,-2998
FRA,France,BRA,Brazil,2017,0,3239,-3239
DEU,Germany,BRA,Brazil,2008,5364,6290,-926
DEU,Germany,BRA,Brazil,2009,5238,6390,-1152
DEU,Germany,BRA,Brazil,2010,5123,6127,-1004
DEU,Germany,BRA,Brazil,2011,4821,6870,-2049
DEU,Germany,BRA,Brazil,2012,5194,7091,-1897
DEU,Germany,BRA,Brazil,2013,5553,7779,-2226
DEU,Germany,BRA,Brazil,2014,5773,8926,-3153
DEU,Germany,BRA,Brazil,2015,6522,8010,-1488
DEU,Germany,BRA,Brazil,2016,6418,8429,-2011
DEU,Germany,BRA,Brazil,2017,4903,9477,-4574
HUN,Hungary,BRA,Brazil,2008,9,121,-112
HUN,Hungary,BRA,Brazil,2009,18,109,-91
HUN,Hungary,BRA,Brazil,2010,22,101,-79
HUN,Hungary,BRA,Brazil,2011,9,90,-81
HUN,Hungary,BRA,Brazil,2012,19,137,-118
HUN,Hungary,BRA,Brazil,2013,17,419,-402
HUN,Hungary,BRA,Brazil,2014,50,495,-445
HUN,Hungary,BRA,Brazil,2015,129,213,-84
HUN,Hungary,BRA,Brazil,2016,53,175,-122
HUN,Hungary,BRA,Brazil,2017,0,284,-284
ISL,Iceland,BRA,Brazil,2008,13,21,-8
ISL,Iceland,BRA,Brazil,2009,15,16,-1
ISL,Iceland,BRA,Brazil,2010,8,11,-3
ISL,Iceland,BRA,Brazil,2011,4,14,-10
ISL,Iceland,BRA,Brazil,2012,6,7,-1
ISL,Iceland,BRA,Brazil,2013,12,15,-3
ISL,Iceland,BRA,Brazil,2014,6,13,-7
ISL,Iceland,BRA,Brazil,2015,4,15,-11
ISL,Iceland,BRA,Brazil,2016,8,22,-14
ISL,Iceland,BRA,Brazil,2017,10,23,-13
ITA,Italy,BRA,Brazil,2008,637,12645,-12008
ITA,Italy,BRA,Brazil,2009,758,9658,-8900
ITA,Italy,BRA,Brazil,2010,670,8566,-7896
ITA,Italy,BRA,Brazil,2011,620,7097,-6477
ITA,Italy,BRA,Brazil,2012,753,5716,-4963
ITA,Italy,BRA,Brazil,2013,724,4963,-4239
ITA,Italy,BRA,Brazil,2014,632,5010,-4378
ITA,Italy,BRA,Brazil,2015,501,7008,-6507
ITA,Italy,BRA,Brazil,2016,0,10495,-10495
ITA,Italy,BRA,Brazil,2017,562,15686,-15124
JPN,Japan,BRA,Brazil,2008,11558,14402,-2844
JPN,Japan,BRA,Brazil,2009,33153,2954,30199
JPN,Japan,BRA,Brazil,2010,10435,4719,5716
JPN,Japan,BRA,Brazil,2011,6763,4517,2246
JPN,Japan,BRA,Brazil,2012,3852,5790,-1938
JPN,Japan,BRA,Brazil,2013,2813,4814,-2001
JPN,Japan,BRA,Brazil,2014,2493,6118,-3625
JPN,Japan,BRA,Brazil,2015,2419,9062,-6643
JPN,Japan,BRA,Brazil,2016,2216,12830,-10614
JPN,Japan,BRA,Brazil,2017,2344,14188,-11844
KOR,Korea,BRA,Brazil,2008,320,352,-32
KOR,Korea,BRA,Brazil,2009,338,347,-9
KOR,Korea,BRA,Brazil,2010,352,427,-75
KOR,Korea,BRA,Brazil,2011,465,478,-13
KOR,Korea,BRA,Brazil,2012,502,494,8
KOR,Korea,BRA,Brazil,2013,354,584,-230
KOR,Korea,BRA,Brazil,2014,496,469,27
KOR,Korea,BRA,Brazil,2015,480,417,63
KOR,Korea,BRA,Brazil,2016,379,371,8
KOR,Korea,BRA,Brazil,2017,304,401,-97
LUX,Luxembourg,BRA,Brazil,2008,64,204,-140
LUX,Luxembourg,BRA,Brazil,2009,78,216,-138
LUX,Luxembourg,BRA,Brazil,2010,59,209,-150
LUX,Luxembourg,BRA,Brazil,2011,75,185,-110
LUX,Luxembourg,BRA,Brazil,2012,76,160,-84
LUX,Luxembourg,BRA,Brazil,2013,78,267,-189
LUX,Luxembourg,BRA,Brazil,2014,62,179,-117
LUX,Luxembourg,BRA,Brazil,2015,97,199,-102
LUX,Luxembourg,BRA,Brazil,2016,55,214,-159
LUX,Luxembourg,BRA,Brazil,2017,79,302,-223
MEX,Mexico,BRA,Brazil,2008,0,304,-304
MEX,Mexico,BRA,Brazil,2009,0,439,-439
MEX,Mexico,BRA,Brazil,2010,0,460,-460
MEX,Mexico,BRA,Brazil,2011,0,370,-370
MEX,Mexico,BRA,Brazil,2012,0,290,-290
MEX,Mexico,BRA,Brazil,2013,0,1058,-1058
MEX,Mexico,BRA,Brazil,2014,0,733,-733
MEX,Mexico,BRA,Brazil,2015,0,627,-627
MEX,Mexico,BRA,Brazil,2016,0,617,-617
MEX,Mexico,BRA,Brazil,2017,0,541,-541
NLD,Netherlands,BRA,Brazil,2008,485,1164,-679
NLD,Netherlands,BRA,Brazil,2009,559,1124,-565
NLD,Netherlands,BRA,Brazil,2010,587,1153,-566
NLD,Netherlands,BRA,Brazil,2011,627,1152,-525
NLD,Netherlands,BRA,Brazil,2012,664,1138,-474
NLD,Netherlands,BRA,Brazil,2013,886,1556,-670
NLD,Netherlands,BRA,Brazil,2014,1096,1610,-514
NLD,Netherlands,BRA,Brazil,2015,1044,1940,-896
NLD,Netherlands,BRA,Brazil,2016,1284,1505,-221
NLD,Netherlands,BRA,Brazil,2017,898,2178,-1280
NZL,New Zealand,BRA,Brazil,2008,435,227,208
NZL,New Zealand,BRA,Brazil,2009,496,265,231
NZL,New Zealand,BRA,Brazil,2010,503,241,262
NZL,New Zealand,BRA,Brazil,2011,359,227,132
NZL,New Zealand,BRA,Brazil,2012,312,238,74
NZL,New Zealand,BRA,Brazil,2013,236,263,-27
NZL,New Zealand,BRA,Brazil,2014,172,435,-263
NZL,New Zealand,BRA,Brazil,2015,209,526,-317
NZL,New Zealand,BRA,Brazil,2016,252,576,-324
NZL,New Zealand,BRA,Brazil,2017,268,804,-536
NOR,Norway,BRA,Brazil,2008,95,393,-298
NOR,Norway,BRA,Brazil,2009,153,448,-295
NOR,Norway,BRA,Brazil,2010,142,315,-173
NOR,Norway,BRA,Brazil,2011,179,443,-264
NOR,Norway,BRA,Brazil,2012,146,470,-324
NOR,Norway,BRA,Brazil,2013,180,441,-261
NOR,Norway,BRA,Brazil,2014,205,497,-292
NOR,Norway,BRA,Brazil,2015,300,384,-84
NOR,Norway,BRA,Brazil,2016,260,378,-118
NOR,Norway,BRA,Brazil,2017,108,342,-234
POL,Poland,BRA,Brazil,2008,0,153,-153
POL,Poland,BRA,Brazil,2009,0,192,-192
POL,Poland,BRA,Brazil,2010,0,189,-189
POL,Poland,BRA,Brazil,2011,0,160,-160
POL,Poland,BRA,Brazil,2012,0,175,-175
POL,Poland,BRA,Brazil,2013,0,219,-219
POL,Poland,BRA,Brazil,2014,0,103,-103
POL,Poland,BRA,Brazil,2015,0,258,-258
POL,Poland,BRA,Brazil,2016,0,307,-307
POL,Poland,BRA,Brazil,2017,0,412,-412
PRT,Portugal,BRA,Brazil,2008,0,32751,-32751
PRT,Portugal,BRA,Brazil,2009,0,23138,-23138
PRT,Portugal,BRA,Brazil,2010,0,16165,-16165
PRT,Portugal,BRA,Brazil,2011,0,12896,-12896
PRT,Portugal,BRA,Brazil,2012,0,11715,-11715
PRT,Portugal,BRA,Brazil,2013,0,6680,-6680
PRT,Portugal,BRA,Brazil,2014,0,5560,-5560
PRT,Portugal,BRA,Brazil,2015,0,5716,-5716
PRT,Portugal,BRA,Brazil,2016,0,7059,-7059
PRT,Portugal,BRA,Brazil,2017,0,11574,-11574
SVK,Slovak Republic,BRA,Brazil,2008,3,4,-1
SVK,Slovak Republic,BRA,Brazil,2009,21,6,15
SVK,Slovak Republic,BRA,Brazil,2010,1,9,-8
SVK,Slovak Republic,BRA,Brazil,2011,14,5,9
SVK,Slovak Republic,BRA,Brazil,2012,0,6,-6
SVK,Slovak Republic,BRA,Brazil,2013,0,4,-4
SVK,Slovak Republic,BRA,Brazil,2014,0,3,-3
SVK,Slovak Republic,BRA,Brazil,2015,0,11,-11
SVK,Slovak Republic,BRA,Brazil,2016,1,5,-4
SVK,Slovak Republic,BRA,Brazil,2017,0,6,-6
ESP,Spain,BRA,Brazil,2008,12489,20489,-8000
ESP,Spain,BRA,Brazil,2009,16776,10473,6303
ESP,Spain,BRA,Brazil,2010,15582,8691,6891
ESP,Spain,BRA,Brazil,2011,14568,7945,6623
ESP,Spain,BRA,Brazil,2012,13801,6397,7404
ESP,Spain,BRA,Brazil,2013,14977,5076,9901
ESP,Spain,BRA,Brazil,2014,7524,5644,1880
ESP,Spain,BRA,Brazil,2015,4890,7086,-2196
ESP,Spain,BRA,Brazil,2016,4271,9715,-5444
ESP,Spain,BRA,Brazil,2017,5800,12535,-6735
SWE,Sweden,BRA,Brazil,2008,118,475,-357
SWE,Sweden,BRA,Brazil,2009,125,436,-311
SWE,Sweden,BRA,Brazil,2010,141,380,-239
SWE,Sweden,BRA,Brazil,2011,119,414,-295
SWE,Sweden,BRA,Brazil,2012,145,353,-208
SWE,Sweden,BRA,Brazil,2013,144,383,-239
SWE,Sweden,BRA,Brazil,2014,179,358,-179
SWE,Sweden,BRA,Brazil,2015,221,554,-333
SWE,Sweden,BRA,Brazil,2016,190,643,-453
SWE,Sweden,BRA,Brazil,2017,258,689,-431
CHE,Switzerland,BRA,Brazil,2010,952,2473,-1521
CHE,Switzerland,BRA,Brazil,2011,943,2152,-1209
CHE,Switzerland,BRA,Brazil,2012,945,1942,-997
CHE,Switzerland,BRA,Brazil,2013,1005,1904,-899
CHE,Switzerland,BRA,Brazil,2014,883,1730,-847
CHE,Switzerland,BRA,Brazil,2015,778,1769,-991
CHE,Switzerland,BRA,Brazil,2016,759,1793,-1034
CHE,Switzerland,BRA,Brazil,2017,713,1917,-1204
TUR,Turkey,BRA,Brazil,2010,0,53,-53
TUR,Turkey,BRA,Brazil,2016,168,324,-156
TUR,Turkey,BRA,Brazil,2017,281,373,-92
GBR,United Kingdom,BRA,Brazil,2011,1000,1000,0
GBR,United Kingdom,BRA,Brazil,2012,2000,1000,1000
GBR,United Kingdom,BRA,Brazil,2013,1000,3000,-2000
GBR,United Kingdom,BRA,Brazil,2014,1000,9000,-8000
GBR,United Kingdom,BRA,Brazil,2015,3000,2000,1000
USA,United States,BRA,Brazil,2008,0,12195,-12195
USA,United States,BRA,Brazil,2009,0,14701,-14701
USA,United States,BRA,Brazil,2010,0,12258,-12258
USA,United States,BRA,Brazil,2011,0,11763,-11763
USA,United States,BRA,Brazil,2012,0,11441,-11441
USA,United States,BRA,Brazil,2013,0,11033,-11033
USA,United States,BRA,Brazil,2014,0,10429,-10429
USA,United States,BRA,Brazil,2015,0,11424,-11424
USA,United States,BRA,Brazil,2016,0,13812,-13812
USA,United States,BRA,Brazil,2017,0,14989,-14989
CHL,Chile,BRA,Brazil,2008,0,909,-909
CHL,Chile,BRA,Brazil,2009,0,800,-800
CHL,Chile,BRA,Brazil,2010,0,998,-998
CHL,Chile,BRA,Brazil,2011,0,1095,-1095
CHL,Chile,BRA,Brazil,2012,0,1235,-1235
CHL,Chile,BRA,Brazil,2013,0,1163,-1163
CHL,Chile,BRA,Brazil,2014,0,1218,-1218
CHL,Chile,BRA,Brazil,2015,0,1707,-1707
CHL,Chile,BRA,Brazil,2016,0,1991,-1991
EST,Estonia,BRA,Brazil,2008,0,5,-5
EST,Estonia,BRA,Brazil,2009,0,4,-4
EST,Estonia,BRA,Brazil,2010,0,4,-4
EST,Estonia,BRA,Brazil,2011,0,12,-12
EST,Estonia,BRA,Brazil,2012,0,3,-3
EST,Estonia,BRA,Brazil,2013,0,12,-12
EST,Estonia,BRA,Brazil,2014,0,6,-6
EST,Estonia,BRA,Brazil,2015,0,22,-22
EST,Estonia,BRA,Brazil,2016,0,32,-32
EST,Estonia,BRA,Brazil,2017,0,38,-38
ISR,Israel,BRA,Brazil,2008,0,208,-208
ISR,Israel,BRA,Brazil,2009,0,236,-236
ISR,Israel,BRA,Brazil,2010,0,244,-244
ISR,Israel,BRA,Brazil,2011,0,157,-157
ISR,Israel,BRA,Brazil,2012,0,163,-163
ISR,Israel,BRA,Brazil,2013,0,169,-169
ISR,Israel,BRA,Brazil,2014,0,251,-251
ISR,Israel,BRA,Brazil,2015,0,404,-404
ISR,Israel,BRA,Brazil,2016,0,579,-579
ISR,Israel,BRA,Brazil,2017,0,618,-618
SVN,Slovenia,BRA,Brazil,2008,0,21,-21
SVN,Slovenia,BRA,Brazil,2009,0,26,-26
SVN,Slovenia,BRA,Brazil,2010,0,21,-21
SVN,Slovenia,BRA,Brazil,2011,0,12,-12
SVN,Slovenia,BRA,Brazil,2012,4,12,-8
SVN,Slovenia,BRA,Brazil,2013,0,8,-8
SVN,Slovenia,BRA,Brazil,2014,0,8,-8
SVN,Slovenia,BRA,Brazil,2015,1,34,-33
SVN,Slovenia,BRA,Brazil,2016,0,8,-8
SVN,Slovenia,BRA,Brazil,2017,5,34,-29
AUS,Australia,BRN,Brunei Darussalam,2008,31,39,-8
AUS,Australia,BRN,Brunei Darussalam,2009,16,30,-14
AUS,Australia,BRN,Brunei Darussalam,2010,19,37,-18
AUS,Australia,BRN,Brunei Darussalam,2011,31,28,3
AUS,Australia,BRN,Brunei Darussalam,2012,18,31,-13
AUS,Australia,BRN,Brunei Darussalam,2013,24,36,-12
AUS,Australia,BRN,Brunei Darussalam,2014,27,29,-2
AUS,Australia,BRN,Brunei Darussalam,2015,0,26,-26
AUS,Australia,BRN,Brunei Darussalam,2016,0,41,-41
AUS,Australia,BRN,Brunei Darussalam,2017,0,24,-24
AUT,Austria,BRN,Brunei Darussalam,2008,0,0,0
AUT,Austria,BRN,Brunei Darussalam,2009,0,4,-4
AUT,Austria,BRN,Brunei Darussalam,2010,0,1,-1
AUT,Austria,BRN,Brunei Darussalam,2011,1,4,-3
AUT,Austria,BRN,Brunei Darussalam,2012,0,0,0
AUT,Austria,BRN,Brunei Darussalam,2013,0,1,-1
AUT,Austria,BRN,Brunei Darussalam,2014,0,0,0
AUT,Austria,BRN,Brunei Darussalam,2015,1,4,-3
AUT,Austria,BRN,Brunei Darussalam,2016,1,4,-3
AUT,Austria,BRN,Brunei Darussalam,2017,4,0,4
BEL,Belgium,BRN,Brunei Darussalam,2010,0,1,-1
CAN,Canada,BRN,Brunei Darussalam,2008,0,10,-10
CAN,Canada,BRN,Brunei Darussalam,2009,0,5,-5
CAN,Canada,BRN,Brunei Darussalam,2010,0,12,-12
CAN,Canada,BRN,Brunei Darussalam,2011,0,6,-6
CAN,Canada,BRN,Brunei Darussalam,2012,0,3,-3
CAN,Canada,BRN,Brunei Darussalam,2013,0,6,-6
CAN,Canada,BRN,Brunei Darussalam,2014,0,3,-3
CAN,Canada,BRN,Brunei Darussalam,2015,0,9,-9
CAN,Canada,BRN,Brunei Darussalam,2016,0,5,-5
CAN,Canada,BRN,Brunei Darussalam,2017,0,10,-10
DNK,Denmark,BRN,Brunei Darussalam,2013,0,0,0
DNK,Denmark,BRN,Brunei Darussalam,2014,0,0,0
DNK,Denmark,BRN,Brunei Darussalam,2015,0,0,0
DNK,Denmark,BRN,Brunei Darussalam,2016,0,1,-1
DNK,Denmark,BRN,Brunei Darussalam,2017,0,0,0
FIN,Finland,BRN,Brunei Darussalam,2008,1,0,1
FIN,Finland,BRN,Brunei Darussalam,2009,0,0,0
FIN,Finland,BRN,Brunei Darussalam,2010,0,0,0
FIN,Finland,BRN,Brunei Darussalam,2011,0,0,0
FIN,Finland,BRN,Brunei Darussalam,2012,0,0,0
FIN,Finland,BRN,Brunei Darussalam,2013,0,0,0
FIN,Finland,BRN,Brunei Darussalam,2014,0,1,-1
FIN,Finland,BRN,Brunei Darussalam,2015,0,0,0
FIN,Finland,BRN,Brunei Darussalam,2016,0,0,0
FIN,Finland,BRN,Brunei Darussalam,2017,0,1,-1
FRA,France,BRN,Brunei Darussalam,2008,0,0,0
FRA,France,BRN,Brunei Darussalam,2009,0,0,0
FRA,France,BRN,Brunei Darussalam,2010,0,1,-1
FRA,France,BRN,Brunei Darussalam,2011,0,1,-1
FRA,France,BRN,Brunei Darussalam,2012,0,2,-2
FRA,France,BRN,Brunei Darussalam,2013,0,2,-2
FRA,France,BRN,Brunei Darussalam,2014,0,1,-1
FRA,France,BRN,Brunei Darussalam,2015,0,2,-2
FRA,France,BRN,Brunei Darussalam,2016,0,1,-1
FRA,France,BRN,Brunei Darussalam,2017,0,0,0
DEU,Germany,BRN,Brunei Darussalam,2008,17,12,5
DEU,Germany,BRN,Brunei Darussalam,2009,4,61,-57
DEU,Germany,BRN,Brunei Darussalam,2010,45,89,-44
DEU,Germany,BRN,Brunei Darussalam,2011,132,56,76
DEU,Germany,BRN,Brunei Darussalam,2012,7,19,-12
DEU,Germany,BRN,Brunei Darussalam,2013,15,17,-2
DEU,Germany,BRN,Brunei Darussalam,2014,16,22,-6
DEU,Germany,BRN,Brunei Darussalam,2015,16,14,2
DEU,Germany,BRN,Brunei Darussalam,2016,8,10,-2
DEU,Germany,BRN,Brunei Darussalam,2017,9,6,3
HUN,Hungary,BRN,Brunei Darussalam,2008,0,0,0
HUN,Hungary,BRN,Brunei Darussalam,2009,0,0,0
HUN,Hungary,BRN,Brunei Darussalam,2010,0,0,0
HUN,Hungary,BRN,Brunei Darussalam,2011,0,0,0
HUN,Hungary,BRN,Brunei Darussalam,2012,0,0,0
HUN,Hungary,BRN,Brunei Darussalam,2013,0,1,-1
HUN,Hungary,BRN,Brunei Darussalam,2014,0,0,0
HUN,Hungary,BRN,Brunei Darussalam,2015,0,0,0
HUN,Hungary,BRN,Brunei Darussalam,2016,0,0,0
HUN,Hungary,BRN,Brunei Darussalam,2017,0,0,0
ISL,Iceland,BRN,Brunei Darussalam,2016,0,0,0
ISL,Iceland,BRN,Brunei Darussalam,2017,0,0,0
ITA,Italy,BRN,Brunei Darussalam,2008,2,9,-7
ITA,Italy,BRN,Brunei Darussalam,2009,2,8,-6
ITA,Italy,BRN,Brunei Darussalam,2010,0,8,-8
ITA,Italy,BRN,Brunei Darussalam,2011,0,1,-1
ITA,Italy,BRN,Brunei Darussalam,2012,0,3,-3
ITA,Italy,BRN,Brunei Darussalam,2013,0,2,-2
ITA,Italy,BRN,Brunei Darussalam,2014,0,2,-2
ITA,Italy,BRN,Brunei Darussalam,2015,1,0,1
JPN,Japan,BRN,Brunei Darussalam,2008,19,21,-2
JPN,Japan,BRN,Brunei Darussalam,2009,27,20,7
JPN,Japan,BRN,Brunei Darussalam,2010,16,24,-8
JPN,Japan,BRN,Brunei Darussalam,2011,14,15,-1
JPN,Japan,BRN,Brunei Darussalam,2012,26,32,-6
JPN,Japan,BRN,Brunei Darussalam,2013,43,47,-4
JPN,Japan,BRN,Brunei Darussalam,2014,48,67,-19
JPN,Japan,BRN,Brunei Darussalam,2015,79,83,-4
JPN,Japan,BRN,Brunei Darussalam,2016,80,82,-2
JPN,Japan,BRN,Brunei Darussalam,2017,79,76,3
KOR,Korea,BRN,Brunei Darussalam,2008,2,4,-2
KOR,Korea,BRN,Brunei Darussalam,2009,3,7,-4
KOR,Korea,BRN,Brunei Darussalam,2010,2,14,-12
KOR,Korea,BRN,Brunei Darussalam,2011,17,10,7
KOR,Korea,BRN,Brunei Darussalam,2012,44,61,-17
KOR,Korea,BRN,Brunei Darussalam,2013,89,114,-25
KOR,Korea,BRN,Brunei Darussalam,2014,135,135,0
KOR,Korea,BRN,Brunei Darussalam,2015,161,119,42
KOR,Korea,BRN,Brunei Darussalam,2016,121,125,-4
KOR,Korea,BRN,Brunei Darussalam,2017,107,101,6
LUX,Luxembourg,BRN,Brunei Darussalam,2008,0,0,0
LUX,Luxembourg,BRN,Brunei Darussalam,2009,0,0,0
LUX,Luxembourg,BRN,Brunei Darussalam,2010,0,0,0
LUX,Luxembourg,BRN,Brunei Darussalam,2011,0,0,0
LUX,Luxembourg,BRN,Brunei Darussalam,2012,0,0,0
LUX,Luxembourg,BRN,Brunei Darussalam,2013,0,0,0
LUX,Luxembourg,BRN,Brunei Darussalam,2014,0,0,0
LUX,Luxembourg,BRN,Brunei Darussalam,2015,0,0,0
LUX,Luxembourg,BRN,Brunei Darussalam,2016,0,0,0
LUX,Luxembourg,BRN,Brunei Darussalam,2017,0,1,-1
MEX,Mexico,BRN,Brunei Darussalam,2012,0,0,0
MEX,Mexico,BRN,Brunei Darussalam,2013,0,0,0
MEX,Mexico,BRN,Brunei Darussalam,2014,0,0,0
NLD,Netherlands,BRN,Brunei Darussalam,2008,14,5,9
NLD,Netherlands,BRN,Brunei Darussalam,2009,12,7,5
NLD,Netherlands,BRN,Brunei Darussalam,2010,4,6,-2
NLD,Netherlands,BRN,Brunei Darussalam,2011,12,10,2
NLD,Netherlands,BRN,Brunei Darussalam,2012,12,7,5
NLD,Netherlands,BRN,Brunei Darussalam,2013,1,31,-30
NLD,Netherlands,BRN,Brunei Darussalam,2014,7,14,-7
NLD,Netherlands,BRN,Brunei Darussalam,2015,12,16,-4
NLD,Netherlands,BRN,Brunei Darussalam,2016,16,3,13
NLD,Netherlands,BRN,Brunei Darussalam,2017,19,10,9
NZL,New Zealand,BRN,Brunei Darussalam,2008,4,14,-10
NZL,New Zealand,BRN,Brunei Darussalam,2009,9,12,-3
NZL,New Zealand,BRN,Brunei Darussalam,2010,6,18,-12
NZL,New Zealand,BRN,Brunei Darussalam,2011,8,19,-11
NZL,New Zealand,BRN,Brunei Darussalam,2012,10,19,-9
NZL,New Zealand,BRN,Brunei Darussalam,2013,15,15,0
NZL,New Zealand,BRN,Brunei Darussalam,2014,9,22,-13
NZL,New Zealand,BRN,Brunei Darussalam,2015,7,26,-19
NZL,New Zealand,BRN,Brunei Darussalam,2016,8,24,-16
NZL,New Zealand,BRN,Brunei Darussalam,2017,9,14,-5
NOR,Norway,BRN,Brunei Darussalam,2008,0,0,0
NOR,Norway,BRN,Brunei Darussalam,2009,0,3,-3
NOR,Norway,BRN,Brunei Darussalam,2010,0,0,0
NOR,Norway,BRN,Brunei Darussalam,2011,0,3,-3
NOR,Norway,BRN,Brunei Darussalam,2012,3,0,3
NOR,Norway,BRN,Brunei Darussalam,2013,3,1,2
NOR,Norway,BRN,Brunei Darussalam,2014,0,0,0
NOR,Norway,BRN,Brunei Darussalam,2015,0,0,0
NOR,Norway,BRN,Brunei Darussalam,2016,1,1,0
NOR,Norway,BRN,Brunei Darussalam,2017,0,0,0
POL,Poland,BRN,Brunei Darussalam,2009,0,0,0
POL,Poland,BRN,Brunei Darussalam,2010,0,0,0
POL,Poland,BRN,Brunei Darussalam,2011,0,1,-1
POL,Poland,BRN,Brunei Darussalam,2012,0,0,0
POL,Poland,BRN,Brunei Darussalam,2013,0,0,0
POL,Poland,BRN,Brunei Darussalam,2014,0,0,0
POL,Poland,BRN,Brunei Darussalam,2015,0,0,0
POL,Poland,BRN,Brunei Darussalam,2016,0,0,0
POL,Poland,BRN,Brunei Darussalam,2017,0,0,0
SVK,Slovak Republic,BRN,Brunei Darussalam,2008,0,0,0
ESP,Spain,BRN,Brunei Darussalam,2008,0,1,-1
ESP,Spain,BRN,Brunei Darussalam,2009,2,1,1
ESP,Spain,BRN,Brunei Darussalam,2010,0,0,0
ESP,Spain,BRN,Brunei Darussalam,2011,0,0,0
ESP,Spain,BRN,Brunei Darussalam,2012,0,0,0
ESP,Spain,BRN,Brunei Darussalam,2013,0,1,-1
ESP,Spain,BRN,Brunei Darussalam,2014,0,1,-1
ESP,Spain,BRN,Brunei Darussalam,2015,0,2,-2
ESP,Spain,BRN,Brunei Darussalam,2016,0,0,0
ESP,Spain,BRN,Brunei Darussalam,2017,0,1,-1
SWE,Sweden,BRN,Brunei Darussalam,2008,0,1,-1
SWE,Sweden,BRN,Brunei Darussalam,2009,0,0,0
SWE,Sweden,BRN,Brunei Darussalam,2010,1,0,1
SWE,Sweden,BRN,Brunei Darussalam,2011,1,3,-2
SWE,Sweden,BRN,Brunei Darussalam,2012,2,0,2
SWE,Sweden,BRN,Brunei Darussalam,2013,0,0,0
SWE,Sweden,BRN,Brunei Darussalam,2014,0,0,0
SWE,Sweden,BRN,Brunei Darussalam,2015,0,0,0
SWE,Sweden,BRN,Brunei Darussalam,2016,0,0,0
SWE,Sweden,BRN,Brunei Darussalam,2017,0,0,0
CHE,Switzerland,BRN,Brunei Darussalam,2010,1,1,0
CHE,Switzerland,BRN,Brunei Darussalam,2011,2,1,1
CHE,Switzerland,BRN,Brunei Darussalam,2012,2,1,1
CHE,Switzerland,BRN,Brunei Darussalam,2013,1,2,-1
CHE,Switzerland,BRN,Brunei Darussalam,2014,1,2,-1
CHE,Switzerland,BRN,Brunei Darussalam,2015,0,2,-2
CHE,Switzerland,BRN,Brunei Darussalam,2016,1,2,-1
CHE,Switzerland,BRN,Brunei Darussalam,2017,2,3,-1
TUR,Turkey,BRN,Brunei Darussalam,2010,0,1,-1
USA,United States,BRN,Brunei Darussalam,2008,0,18,-18
USA,United States,BRN,Brunei Darussalam,2009,0,26,-26
USA,United States,BRN,Brunei Darussalam,2010,0,20,-20
USA,United States,BRN,Brunei Darussalam,2011,0,25,-25
USA,United States,BRN,Brunei Darussalam,2012,0,19,-19
USA,United States,BRN,Brunei Darussalam,2013,0,21,-21
USA,United States,BRN,Brunei Darussalam,2014,0,25,-25
USA,United States,BRN,Brunei Darussalam,2015,0,21,-21
USA,United States,BRN,Brunei Darussalam,2016,0,31,-31
USA,United States,BRN,Brunei Darussalam,2017,0,24,-24
CHL,Chile,BRN,Brunei Darussalam,2008,0,0,0
CHL,Chile,BRN,Brunei Darussalam,2009,0,0,0
CHL,Chile,BRN,Brunei Darussalam,2010,0,0,0
CHL,Chile,BRN,Brunei Darussalam,2011,0,0,0
CHL,Chile,BRN,Brunei Darussalam,2012,0,0,0
CHL,Chile,BRN,Brunei Darussalam,2013,0,0,0
CHL,Chile,BRN,Brunei Darussalam,2014,0,0,0
CHL,Chile,BRN,Brunei Darussalam,2015,0,0,0
CHL,Chile,BRN,Brunei Darussalam,2016,0,0,0
EST,Estonia,BRN,Brunei Darussalam,2008,0,0,0
EST,Estonia,BRN,Brunei Darussalam,2009,0,0,0
EST,Estonia,BRN,Brunei Darussalam,2010,0,0,0
EST,Estonia,BRN,Brunei Darussalam,2011,0,0,0
EST,Estonia,BRN,Brunei Darussalam,2012,0,0,0
EST,Estonia,BRN,Brunei Darussalam,2013,0,0,0
EST,Estonia,BRN,Brunei Darussalam,2014,0,0,0
EST,Estonia,BRN,Brunei Darussalam,2015,0,0,0
EST,Estonia,BRN,Brunei Darussalam,2016,0,0,0
EST,Estonia,BRN,Brunei Darussalam,2017,0,0,0
AUS,Australia,BGR,Bulgaria,2008,57,106,-49
AUS,Australia,BGR,Bulgaria,2009,44,93,-49
AUS,Australia,BGR,Bulgaria,2010,43,88,-45
AUS,Australia,BGR,Bulgaria,2011,39,64,-25
AUS,Australia,BGR,Bulgaria,2012,53,79,-26
AUS,Australia,BGR,Bulgaria,2013,29,66,-37
AUS,Australia,BGR,Bulgaria,2014,33,120,-87
AUS,Australia,BGR,Bulgaria,2015,0,89,-89
AUS,Australia,BGR,Bulgaria,2016,0,88,-88
AUS,Australia,BGR,Bulgaria,2017,0,90,-90
AUT,Austria,BGR,Bulgaria,2008,1204,2457,-1253
AUT,Austria,BGR,Bulgaria,2009,1698,2628,-930
AUT,Austria,BGR,Bulgaria,2010,1896,3121,-1225
AUT,Austria,BGR,Bulgaria,2011,2097,3242,-1145
AUT,Austria,BGR,Bulgaria,2012,2137,3631,-1494
AUT,Austria,BGR,Bulgaria,2013,2294,3909,-1615
AUT,Austria,BGR,Bulgaria,2014,2419,5824,-3405
AUT,Austria,BGR,Bulgaria,2015,2690,5232,-2542
AUT,Austria,BGR,Bulgaria,2016,2746,4929,-2183
AUT,Austria,BGR,Bulgaria,2017,2800,5001,-2201
BEL,Belgium,BGR,Bulgaria,2008,351,3887,-3536
BEL,Belgium,BGR,Bulgaria,2009,673,3277,-2604
BEL,Belgium,BGR,Bulgaria,2010,752,4227,-3475
BEL,Belgium,BGR,Bulgaria,2011,1445,4285,-2840
BEL,Belgium,BGR,Bulgaria,2012,1688,4517,-2829
BEL,Belgium,BGR,Bulgaria,2013,1616,3934,-2318
BEL,Belgium,BGR,Bulgaria,2014,1453,4231,-2778
BEL,Belgium,BGR,Bulgaria,2015,1190,3753,-2563
BEL,Belgium,BGR,Bulgaria,2016,1139,3273,-2134
BEL,Belgium,BGR,Bulgaria,2017,1111,3623,-2512
CAN,Canada,BGR,Bulgaria,2008,0,994,-994
CAN,Canada,BGR,Bulgaria,2009,0,784,-784
CAN,Canada,BGR,Bulgaria,2010,0,556,-556
CAN,Canada,BGR,Bulgaria,2011,0,365,-365
CAN,Canada,BGR,Bulgaria,2012,0,451,-451
CAN,Canada,BGR,Bulgaria,2013,0,512,-512
CAN,Canada,BGR,Bulgaria,2014,0,451,-451
CAN,Canada,BGR,Bulgaria,2015,0,371,-371
CAN,Canada,BGR,Bulgaria,2016,0,370,-370
CAN,Canada,BGR,Bulgaria,2017,0,300,-300
CZE,Czech Republic,BGR,Bulgaria,2008,81,1031,-950
CZE,Czech Republic,BGR,Bulgaria,2009,131,571,-440
CZE,Czech Republic,BGR,Bulgaria,2010,59,583,-524
CZE,Czech Republic,BGR,Bulgaria,2011,24,488,-464
CZE,Czech Republic,BGR,Bulgaria,2012,30,733,-703
CZE,Czech Republic,BGR,Bulgaria,2013,79,951,-872
CZE,Czech Republic,BGR,Bulgaria,2014,79,1102,-1023
CZE,Czech Republic,BGR,Bulgaria,2015,101,1022,-921
CZE,Czech Republic,BGR,Bulgaria,2016,120,1331,-1211
CZE,Czech Republic,BGR,Bulgaria,2017,183,1620,-1437
DNK,Denmark,BGR,Bulgaria,2008,101,697,-596
DNK,Denmark,BGR,Bulgaria,2009,155,853,-698
DNK,Denmark,BGR,Bulgaria,2010,236,933,-697
DNK,Denmark,BGR,Bulgaria,2011,277,991,-714
DNK,Denmark,BGR,Bulgaria,2012,329,1172,-843
DNK,Denmark,BGR,Bulgaria,2013,502,1364,-862
DNK,Denmark,BGR,Bulgaria,2014,537,1445,-908
DNK,Denmark,BGR,Bulgaria,2015,671,1389,-718
DNK,Denmark,BGR,Bulgaria,2016,815,1373,-558
DNK,Denmark,BGR,Bulgaria,2017,891,1319,-428
FIN,Finland,BGR,Bulgaria,2008,24,166,-142
FIN,Finland,BGR,Bulgaria,2009,34,127,-93
FIN,Finland,BGR,Bulgaria,2010,11,129,-118
FIN,Finland,BGR,Bulgaria,2011,12,195,-183
FIN,Finland,BGR,Bulgaria,2012,16,269,-253
FIN,Finland,BGR,Bulgaria,2013,25,272,-247
FIN,Finland,BGR,Bulgaria,2014,28,251,-223
FIN,Finland,BGR,Bulgaria,2015,36,228,-192
FIN,Finland,BGR,Bulgaria,2016,47,182,-135
FIN,Finland,BGR,Bulgaria,2017,44,200,-156
FRA,France,BGR,Bulgaria,2008,0,0,0
FRA,France,BGR,Bulgaria,2009,0,0,0
FRA,France,BGR,Bulgaria,2010,0,0,0
FRA,France,BGR,Bulgaria,2011,0,0,0
FRA,France,BGR,Bulgaria,2012,0,0,0
FRA,France,BGR,Bulgaria,2013,0,1820,-1820
FRA,France,BGR,Bulgaria,2014,0,1346,-1346
FRA,France,BGR,Bulgaria,2015,0,1771,-1771
FRA,France,BGR,Bulgaria,2016,0,1423,-1423
FRA,France,BGR,Bulgaria,2017,0,1260,-1260
DEU,Germany,BGR,Bulgaria,2008,15990,24093,-8103
DEU,Germany,BGR,Bulgaria,2009,20065,29221,-9156
DEU,Germany,BGR,Bulgaria,2010,23985,39844,-15859
DEU,Germany,BGR,Bulgaria,2011,29756,52417,-22661
DEU,Germany,BGR,Bulgaria,2012,34276,60209,-25933
DEU,Germany,BGR,Bulgaria,2013,39172,60896,-21724
DEU,Germany,BGR,Bulgaria,2014,45216,80069,-34853
DEU,Germany,BGR,Bulgaria,2015,46754,86274,-39520
DEU,Germany,BGR,Bulgaria,2016,55859,82956,-27097
DEU,Germany,BGR,Bulgaria,2017,51290,81627,-30337
HUN,Hungary,BGR,Bulgaria,2008,75,91,-16
HUN,Hungary,BGR,Bulgaria,2009,19,72,-53
HUN,Hungary,BGR,Bulgaria,2010,42,65,-23
HUN,Hungary,BGR,Bulgaria,2011,0,77,-77
HUN,Hungary,BGR,Bulgaria,2012,77,80,-3
HUN,Hungary,BGR,Bulgaria,2013,80,54,26
HUN,Hungary,BGR,Bulgaria,2014,49,85,-36
HUN,Hungary,BGR,Bulgaria,2015,39,69,-30
HUN,Hungary,BGR,Bulgaria,2016,51,99,-48
HUN,Hungary,BGR,Bulgaria,2017,52,81,-29
ISL,Iceland,BGR,Bulgaria,2008,16,15,1
ISL,Iceland,BGR,Bulgaria,2009,10,6,4
ISL,Iceland,BGR,Bulgaria,2010,3,3,0
ISL,Iceland,BGR,Bulgaria,2011,10,9,1
ISL,Iceland,BGR,Bulgaria,2012,1,18,-17
ISL,Iceland,BGR,Bulgaria,2013,7,39,-32
ISL,Iceland,BGR,Bulgaria,2014,9,72,-63
ISL,Iceland,BGR,Bulgaria,2015,11,64,-53
ISL,Iceland,BGR,Bulgaria,2016,36,96,-60
ISL,Iceland,BGR,Bulgaria,2017,27,95,-68
ITA,Italy,BGR,Bulgaria,2008,540,8436,-7896
ITA,Italy,BGR,Bulgaria,2009,640,6244,-5604
ITA,Italy,BGR,Bulgaria,2010,448,5877,-5429
ITA,Italy,BGR,Bulgaria,2011,401,5101,-4700
ITA,Italy,BGR,Bulgaria,2012,539,4794,-4255
ITA,Italy,BGR,Bulgaria,2013,728,3734,-3006
ITA,Italy,BGR,Bulgaria,2014,770,2932,-2162
ITA,Italy,BGR,Bulgaria,2015,723,2794,-2071
ITA,Italy,BGR,Bulgaria,2016,0,2760,-2760
ITA,Italy,BGR,Bulgaria,2017,827,2566,-1739
JPN,Japan,BGR,Bulgaria,2008,463,474,-11
JPN,Japan,BGR,Bulgaria,2009,255,260,-5
JPN,Japan,BGR,Bulgaria,2010,15,21,-6
JPN,Japan,BGR,Bulgaria,2011,188,173,15
JPN,Japan,BGR,Bulgaria,2012,328,352,-24
JPN,Japan,BGR,Bulgaria,2013,168,167,1
JPN,Japan,BGR,Bulgaria,2014,135,176,-41
JPN,Japan,BGR,Bulgaria,2015,348,413,-65
JPN,Japan,BGR,Bulgaria,2016,211,321,-110
JPN,Japan,BGR,Bulgaria,2017,153,153,0
KOR,Korea,BGR,Bulgaria,2008,81,78,3
KOR,Korea,BGR,Bulgaria,2009,57,45,12
KOR,Korea,BGR,Bulgaria,2010,54,51,3
KOR,Korea,BGR,Bulgaria,2011,38,43,-5
KOR,Korea,BGR,Bulgaria,2012,37,44,-7
KOR,Korea,BGR,Bulgaria,2013,53,46,7
KOR,Korea,BGR,Bulgaria,2014,48,49,-1
KOR,Korea,BGR,Bulgaria,2015,38,38,0
KOR,Korea,BGR,Bulgaria,2016,42,42,0
KOR,Korea,BGR,Bulgaria,2017,53,45,8
LUX,Luxembourg,BGR,Bulgaria,2008,29,163,-134
LUX,Luxembourg,BGR,Bulgaria,2009,26,106,-80
LUX,Luxembourg,BGR,Bulgaria,2010,22,100,-78
LUX,Luxembourg,BGR,Bulgaria,2011,35,138,-103
LUX,Luxembourg,BGR,Bulgaria,2012,52,127,-75
LUX,Luxembourg,BGR,Bulgaria,2013,59,102,-43
LUX,Luxembourg,BGR,Bulgaria,2014,37,191,-154
LUX,Luxembourg,BGR,Bulgaria,2015,42,194,-152
LUX,Luxembourg,BGR,Bulgaria,2016,67,204,-137
LUX,Luxembourg,BGR,Bulgaria,2017,86,203,-117
MEX,Mexico,BGR,Bulgaria,2008,0,20,-20
MEX,Mexico,BGR,Bulgaria,2009,0,28,-28
MEX,Mexico,BGR,Bulgaria,2010,0,27,-27
MEX,Mexico,BGR,Bulgaria,2011,0,15,-15
MEX,Mexico,BGR,Bulgaria,2012,0,7,-7
MEX,Mexico,BGR,Bulgaria,2013,0,57,-57
MEX,Mexico,BGR,Bulgaria,2014,0,38,-38
MEX,Mexico,BGR,Bulgaria,2015,0,19,-19
MEX,Mexico,BGR,Bulgaria,2016,0,20,-20
MEX,Mexico,BGR,Bulgaria,2017,0,21,-21
NLD,Netherlands,BGR,Bulgaria,2008,1529,5231,-3702
NLD,Netherlands,BGR,Bulgaria,2009,2310,4333,-2023
NLD,Netherlands,BGR,Bulgaria,2010,2593,4269,-1676
NLD,Netherlands,BGR,Bulgaria,2011,2853,5350,-2497
NLD,Netherlands,BGR,Bulgaria,2012,4290,5030,-740
NLD,Netherlands,BGR,Bulgaria,2013,4413,4519,-106
NLD,Netherlands,BGR,Bulgaria,2014,3273,5184,-1911
NLD,Netherlands,BGR,Bulgaria,2015,2934,4828,-1894
NLD,Netherlands,BGR,Bulgaria,2016,3039,4981,-1942
NLD,Netherlands,BGR,Bulgaria,2017,3087,5971,-2884
NZL,New Zealand,BGR,Bulgaria,2008,11,24,-13
NZL,New Zealand,BGR,Bulgaria,2009,13,8,5
NZL,New Zealand,BGR,Bulgaria,2010,16,18,-2
NZL,New Zealand,BGR,Bulgaria,2011,10,13,-3
NZL,New Zealand,BGR,Bulgaria,2012,3,26,-23
NZL,New Zealand,BGR,Bulgaria,2013,9,44,-35
NZL,New Zealand,BGR,Bulgaria,2014,8,25,-17
NZL,New Zealand,BGR,Bulgaria,2015,12,36,-24
NZL,New Zealand,BGR,Bulgaria,2016,16,22,-6
NZL,New Zealand,BGR,Bulgaria,2017,5,12,-7
NOR,Norway,BGR,Bulgaria,2008,27,420,-393
NOR,Norway,BGR,Bulgaria,2009,70,419,-349
NOR,Norway,BGR,Bulgaria,2010,107,638,-531
NOR,Norway,BGR,Bulgaria,2011,155,779,-624
NOR,Norway,BGR,Bulgaria,2012,197,1027,-830
NOR,Norway,BGR,Bulgaria,2013,127,1204,-1077
NOR,Norway,BGR,Bulgaria,2014,108,965,-857
NOR,Norway,BGR,Bulgaria,2015,118,903,-785
NOR,Norway,BGR,Bulgaria,2016,317,674,-357
NOR,Norway,BGR,Bulgaria,2017,350,672,-322
POL,Poland,BGR,Bulgaria,2008,0,378,-378
POL,Poland,BGR,Bulgaria,2009,0,398,-398
POL,Poland,BGR,Bulgaria,2010,0,407,-407
POL,Poland,BGR,Bulgaria,2011,0,321,-321
POL,Poland,BGR,Bulgaria,2012,0,394,-394
POL,Poland,BGR,Bulgaria,2013,0,572,-572
POL,Poland,BGR,Bulgaria,2014,0,572,-572
POL,Poland,BGR,Bulgaria,2015,0,435,-435
POL,Poland,BGR,Bulgaria,2016,0,685,-685
POL,Poland,BGR,Bulgaria,2017,0,753,-753
PRT,Portugal,BGR,Bulgaria,2008,0,884,-884
PRT,Portugal,BGR,Bulgaria,2009,0,1519,-1519
PRT,Portugal,BGR,Bulgaria,2010,0,1367,-1367
PRT,Portugal,BGR,Bulgaria,2011,0,973,-973
PRT,Portugal,BGR,Bulgaria,2012,0,695,-695
PRT,Portugal,BGR,Bulgaria,2013,0,839,-839
PRT,Portugal,BGR,Bulgaria,2014,0,780,-780
PRT,Portugal,BGR,Bulgaria,2015,0,857,-857
PRT,Portugal,BGR,Bulgaria,2016,0,857,-857
PRT,Portugal,BGR,Bulgaria,2017,0,802,-802
SVK,Slovak Republic,BGR,Bulgaria,2008,5,350,-345
SVK,Slovak Republic,BGR,Bulgaria,2009,11,124,-113
SVK,Slovak Republic,BGR,Bulgaria,2010,6,135,-129
SVK,Slovak Republic,BGR,Bulgaria,2011,17,205,-188
SVK,Slovak Republic,BGR,Bulgaria,2012,6,177,-171
SVK,Slovak Republic,BGR,Bulgaria,2013,0,51,-51
SVK,Slovak Republic,BGR,Bulgaria,2014,4,54,-50
SVK,Slovak Republic,BGR,Bulgaria,2015,0,146,-146
SVK,Slovak Republic,BGR,Bulgaria,2016,0,140,-140
SVK,Slovak Republic,BGR,Bulgaria,2017,0,82,-82
ESP,Spain,BGR,Bulgaria,2008,7010,10766,-3756
ESP,Spain,BGR,Bulgaria,2009,11090,7680,3410
ESP,Spain,BGR,Bulgaria,2010,11376,8386,2990
ESP,Spain,BGR,Bulgaria,2011,8546,9890,-1344
ESP,Spain,BGR,Bulgaria,2012,11307,6224,5083
ESP,Spain,BGR,Bulgaria,2013,12822,4947,7875
ESP,Spain,BGR,Bulgaria,2014,10610,4699,5911
ESP,Spain,BGR,Bulgaria,2015,9359,4921,4438
ESP,Spain,BGR,Bulgaria,2016,8515,5150,3365
ESP,Spain,BGR,Bulgaria,2017,8728,6071,2657
SWE,Sweden,BGR,Bulgaria,2008,117,962,-845
SWE,Sweden,BGR,Bulgaria,2009,145,767,-622
SWE,Sweden,BGR,Bulgaria,2010,162,629,-467
SWE,Sweden,BGR,Bulgaria,2011,215,600,-385
SWE,Sweden,BGR,Bulgaria,2012,231,764,-533
SWE,Sweden,BGR,Bulgaria,2013,223,862,-639
SWE,Sweden,BGR,Bulgaria,2014,234,934,-700
SWE,Sweden,BGR,Bulgaria,2015,242,877,-635
SWE,Sweden,BGR,Bulgaria,2016,252,804,-552
SWE,Sweden,BGR,Bulgaria,2017,193,812,-619
CHE,Switzerland,BGR,Bulgaria,2008,170,349,-179
CHE,Switzerland,BGR,Bulgaria,2009,165,490,-325
CHE,Switzerland,BGR,Bulgaria,2010,155,600,-445
CHE,Switzerland,BGR,Bulgaria,2011,167,898,-731
CHE,Switzerland,BGR,Bulgaria,2012,183,1025,-842
CHE,Switzerland,BGR,Bulgaria,2013,240,1057,-817
CHE,Switzerland,BGR,Bulgaria,2014,228,949,-721
CHE,Switzerland,BGR,Bulgaria,2015,258,991,-733
CHE,Switzerland,BGR,Bulgaria,2016,262,1773,-1511
CHE,Switzerland,BGR,Bulgaria,2017,326,1691,-1365
TUR,Turkey,BGR,Bulgaria,2010,0,1076,-1076
TUR,Turkey,BGR,Bulgaria,2016,1135,1381,-246
TUR,Turkey,BGR,Bulgaria,2017,1520,1391,129
GBR,United Kingdom,BGR,Bulgaria,2011,1000,4000,-3000
GBR,United Kingdom,BGR,Bulgaria,2012,1000,3000,-2000
GBR,United Kingdom,BGR,Bulgaria,2013,1000,4000,-3000
GBR,United Kingdom,BGR,Bulgaria,2014,1000,8000,-7000
GBR,United Kingdom,BGR,Bulgaria,2015,1000,5000,-4000
GBR,United Kingdom,BGR,Bulgaria,2016,0,6000,-6000
GBR,United Kingdom,BGR,Bulgaria,2017,0,6000,-6000
USA,United States,BGR,Bulgaria,2008,0,2960,-2960
USA,United States,BGR,Bulgaria,2009,0,3133,-3133
USA,United States,BGR,Bulgaria,2010,0,2570,-2570
USA,United States,BGR,Bulgaria,2011,0,2661,-2661
USA,United States,BGR,Bulgaria,2012,0,2440,-2440
USA,United States,BGR,Bulgaria,2013,0,2844,-2844
USA,United States,BGR,Bulgaria,2014,0,2981,-2981
USA,United States,BGR,Bulgaria,2015,0,2688,-2688
USA,United States,BGR,Bulgaria,2016,0,2670,-2670
USA,United States,BGR,Bulgaria,2017,0,2184,-2184
CHL,Chile,BGR,Bulgaria,2008,0,12,-12
CHL,Chile,BGR,Bulgaria,2009,0,6,-6
CHL,Chile,BGR,Bulgaria,2010,0,10,-10
CHL,Chile,BGR,Bulgaria,2011,0,16,-16
CHL,Chile,BGR,Bulgaria,2012,0,8,-8
CHL,Chile,BGR,Bulgaria,2013,0,16,-16
CHL,Chile,BGR,Bulgaria,2014,0,22,-22
CHL,Chile,BGR,Bulgaria,2015,0,79,-79
CHL,Chile,BGR,Bulgaria,2016,0,75,-75
EST,Estonia,BGR,Bulgaria,2008,0,14,-14
EST,Estonia,BGR,Bulgaria,2009,0,7,-7
EST,Estonia,BGR,Bulgaria,2010,0,13,-13
EST,Estonia,BGR,Bulgaria,2011,0,6,-6
EST,Estonia,BGR,Bulgaria,2012,0,1,-1
EST,Estonia,BGR,Bulgaria,2013,0,18,-18
EST,Estonia,BGR,Bulgaria,2014,0,20,-20
EST,Estonia,BGR,Bulgaria,2015,0,50,-50
EST,Estonia,BGR,Bulgaria,2016,0,76,-76
EST,Estonia,BGR,Bulgaria,2017,0,75,-75
ISR,Israel,BGR,Bulgaria,2008,0,21,-21
ISR,Israel,BGR,Bulgaria,2009,0,17,-17
ISR,Israel,BGR,Bulgaria,2010,0,30,-30
ISR,Israel,BGR,Bulgaria,2011,0,33,-33
ISR,Israel,BGR,Bulgaria,2012,0,17,-17
ISR,Israel,BGR,Bulgaria,2013,0,15,-15
ISR,Israel,BGR,Bulgaria,2014,0,24,-24
ISR,Israel,BGR,Bulgaria,2015,0,13,-13
ISR,Israel,BGR,Bulgaria,2016,0,11,-11
ISR,Israel,BGR,Bulgaria,2017,0,14,-14
SVN,Slovenia,BGR,Bulgaria,2008,130,2329,-2199
SVN,Slovenia,BGR,Bulgaria,2009,382,1292,-910
SVN,Slovenia,BGR,Bulgaria,2010,311,19,292
SVN,Slovenia,BGR,Bulgaria,2011,154,2330,-2176
SVN,Slovenia,BGR,Bulgaria,2012,224,2423,-2199
SVN,Slovenia,BGR,Bulgaria,2013,2,2475,-2473
SVN,Slovenia,BGR,Bulgaria,2014,38,2103,-2065
SVN,Slovenia,BGR,Bulgaria,2015,88,1848,-1760
SVN,Slovenia,BGR,Bulgaria,2016,81,1554,-1473
SVN,Slovenia,BGR,Bulgaria,2017,112,1446,-1334
AUS,Australia,BFA,Burkina Faso,2008,0,0,0
AUS,Australia,BFA,Burkina Faso,2009,0,1,-1
AUS,Australia,BFA,Burkina Faso,2010,0,11,-11
AUS,Australia,BFA,Burkina Faso,2011,0,0,0
AUS,Australia,BFA,Burkina Faso,2012,0,2,-2
AUS,Australia,BFA,Burkina Faso,2013,0,1,-1
AUS,Australia,BFA,Burkina Faso,2014,0,0,0
AUS,Australia,BFA,Burkina Faso,2015,0,0,0
AUS,Australia,BFA,Burkina Faso,2017,0,0,0
AUT,Austria,BFA,Burkina Faso,2008,1,12,-11
AUT,Austria,BFA,Burkina Faso,2009,5,12,-7
AUT,Austria,BFA,Burkina Faso,2010,8,21,-13
AUT,Austria,BFA,Burkina Faso,2011,8,3,5
AUT,Austria,BFA,Burkina Faso,2012,6,13,-7
AUT,Austria,BFA,Burkina Faso,2013,9,18,-9
AUT,Austria,BFA,Burkina Faso,2014,10,13,-3
AUT,Austria,BFA,Burkina Faso,2015,11,20,-9
AUT,Austria,BFA,Burkina Faso,2016,9,18,-9
AUT,Austria,BFA,Burkina Faso,2017,7,12,-5
BEL,Belgium,BFA,Burkina Faso,2008,0,96,-96
BEL,Belgium,BFA,Burkina Faso,2009,0,75,-75
BEL,Belgium,BFA,Burkina Faso,2010,30,123,-93
BEL,Belgium,BFA,Burkina Faso,2011,0,101,-101
BEL,Belgium,BFA,Burkina Faso,2012,95,183,-88
BEL,Belgium,BFA,Burkina Faso,2013,101,164,-63
BEL,Belgium,BFA,Burkina Faso,2014,76,142,-66
BEL,Belgium,BFA,Burkina Faso,2015,77,139,-62
BEL,Belgium,BFA,Burkina Faso,2016,42,107,-65
BEL,Belgium,BFA,Burkina Faso,2017,43,118,-75
CAN,Canada,BFA,Burkina Faso,2008,0,139,-139
CAN,Canada,BFA,Burkina Faso,2009,0,162,-162
CAN,Canada,BFA,Burkina Faso,2010,0,186,-186
CAN,Canada,BFA,Burkina Faso,2011,0,144,-144
CAN,Canada,BFA,Burkina Faso,2012,0,269,-269
CAN,Canada,BFA,Burkina Faso,2013,0,322,-322
CAN,Canada,BFA,Burkina Faso,2014,0,339,-339
CAN,Canada,BFA,Burkina Faso,2015,0,236,-236
CAN,Canada,BFA,Burkina Faso,2016,0,280,-280
CAN,Canada,BFA,Burkina Faso,2017,0,260,-260
CZE,Czech Republic,BFA,Burkina Faso,2008,0,1,-1
CZE,Czech Republic,BFA,Burkina Faso,2009,0,4,-4
CZE,Czech Republic,BFA,Burkina Faso,2011,0,11,-11
CZE,Czech Republic,BFA,Burkina Faso,2012,11,1,10
CZE,Czech Republic,BFA,Burkina Faso,2013,0,1,-1
CZE,Czech Republic,BFA,Burkina Faso,2014,0,1,-1
DNK,Denmark,BFA,Burkina Faso,2008,4,1,3
DNK,Denmark,BFA,Burkina Faso,2009,4,4,0
DNK,Denmark,BFA,Burkina Faso,2010,5,5,0
DNK,Denmark,BFA,Burkina Faso,2011,2,2,0
DNK,Denmark,BFA,Burkina Faso,2012,0,9,-9
DNK,Denmark,BFA,Burkina Faso,2013,6,4,2
DNK,Denmark,BFA,Burkina Faso,2014,1,1,0
DNK,Denmark,BFA,Burkina Faso,2015,0,6,-6
DNK,Denmark,BFA,Burkina Faso,2016,2,1,1
DNK,Denmark,BFA,Burkina Faso,2017,2,3,-1
FIN,Finland,BFA,Burkina Faso,2008,1,1,0
FIN,Finland,BFA,Burkina Faso,2009,0,0,0
FIN,Finland,BFA,Burkina Faso,2010,0,2,-2
FIN,Finland,BFA,Burkina Faso,2011,0,2,-2
FIN,Finland,BFA,Burkina Faso,2012,0,0,0
FIN,Finland,BFA,Burkina Faso,2013,0,3,-3
FIN,Finland,BFA,Burkina Faso,2014,0,5,-5
FIN,Finland,BFA,Burkina Faso,2015,0,1,-1
FIN,Finland,BFA,Burkina Faso,2016,0,5,-5
FIN,Finland,BFA,Burkina Faso,2017,0,2,-2
FRA,France,BFA,Burkina Faso,2008,0,406,-406
FRA,France,BFA,Burkina Faso,2009,0,427,-427
FRA,France,BFA,Burkina Faso,2010,0,422,-422
FRA,France,BFA,Burkina Faso,2011,0,430,-430
FRA,France,BFA,Burkina Faso,2012,0,446,-446
FRA,France,BFA,Burkina Faso,2013,0,456,-456
FRA,France,BFA,Burkina Faso,2014,0,514,-514
FRA,France,BFA,Burkina Faso,2015,0,457,-457
FRA,France,BFA,Burkina Faso,2016,0,398,-398
FRA,France,BFA,Burkina Faso,2017,0,465,-465
DEU,Germany,BFA,Burkina Faso,2008,192,150,42
DEU,Germany,BFA,Burkina Faso,2009,132,165,-33
DEU,Germany,BFA,Burkina Faso,2010,150,191,-41
DEU,Germany,BFA,Burkina Faso,2011,118,194,-76
DEU,Germany,BFA,Burkina Faso,2012,133,239,-106
DEU,Germany,BFA,Burkina Faso,2013,152,348,-196
DEU,Germany,BFA,Burkina Faso,2014,227,353,-126
DEU,Germany,BFA,Burkina Faso,2015,203,425,-222
DEU,Germany,BFA,Burkina Faso,2016,268,442,-174
DEU,Germany,BFA,Burkina Faso,2017,410,424,-14
HUN,Hungary,BFA,Burkina Faso,2008,0,1,-1
HUN,Hungary,BFA,Burkina Faso,2009,0,0,0
HUN,Hungary,BFA,Burkina Faso,2010,0,0,0
HUN,Hungary,BFA,Burkina Faso,2011,0,0,0
HUN,Hungary,BFA,Burkina Faso,2012,0,1,-1
HUN,Hungary,BFA,Burkina Faso,2013,0,0,0
HUN,Hungary,BFA,Burkina Faso,2014,0,1,-1
HUN,Hungary,BFA,Burkina Faso,2015,0,2,-2
HUN,Hungary,BFA,Burkina Faso,2016,0,3,-3
HUN,Hungary,BFA,Burkina Faso,2017,0,4,-4
ISL,Iceland,BFA,Burkina Faso,2008,0,0,0
ISL,Iceland,BFA,Burkina Faso,2009,0,0,0
ISL,Iceland,BFA,Burkina Faso,2010,0,0,0
ISL,Iceland,BFA,Burkina Faso,2011,0,0,0
ISL,Iceland,BFA,Burkina Faso,2012,0,0,0
ISL,Iceland,BFA,Burkina Faso,2013,0,0,0
ISL,Iceland,BFA,Burkina Faso,2014,0,0,0
ISL,Iceland,BFA,Burkina Faso,2015,0,0,0
ISL,Iceland,BFA,Burkina Faso,2016,0,0,0
ISL,Iceland,BFA,Burkina Faso,2017,0,0,0
ITA,Italy,BFA,Burkina Faso,2008,31,1334,-1303
ITA,Italy,BFA,Burkina Faso,2009,35,1105,-1070
ITA,Italy,BFA,Burkina Faso,2010,62,1255,-1193
ITA,Italy,BFA,Burkina Faso,2011,40,913,-873
ITA,Italy,BFA,Burkina Faso,2012,64,1015,-951
ITA,Italy,BFA,Burkina Faso,2013,56,829,-773
ITA,Italy,BFA,Burkina Faso,2014,55,519,-464
ITA,Italy,BFA,Burkina Faso,2015,56,619,-563
ITA,Italy,BFA,Burkina Faso,2016,0,809,-809
ITA,Italy,BFA,Burkina Faso,2017,55,1072,-1017
JPN,Japan,BFA,Burkina Faso,2008,85,92,-7
JPN,Japan,BFA,Burkina Faso,2009,76,77,-1
JPN,Japan,BFA,Burkina Faso,2010,96,170,-74
JPN,Japan,BFA,Burkina Faso,2011,75,78,-3
JPN,Japan,BFA,Burkina Faso,2012,105,111,-6
JPN,Japan,BFA,Burkina Faso,2013,123,131,-8
JPN,Japan,BFA,Burkina Faso,2014,83,99,-16
JPN,Japan,BFA,Burkina Faso,2015,129,135,-6
JPN,Japan,BFA,Burkina Faso,2016,97,113,-16
JPN,Japan,BFA,Burkina Faso,2017,110,124,-14
KOR,Korea,BFA,Burkina Faso,2008,3,1,2
KOR,Korea,BFA,Burkina Faso,2009,2,3,-1
KOR,Korea,BFA,Burkina Faso,2010,3,1,2
KOR,Korea,BFA,Burkina Faso,2011,1,1,0
KOR,Korea,BFA,Burkina Faso,2012,11,19,-8
KOR,Korea,BFA,Burkina Faso,2013,0,2,-2
KOR,Korea,BFA,Burkina Faso,2014,7,3,4
KOR,Korea,BFA,Burkina Faso,2015,4,4,0
KOR,Korea,BFA,Burkina Faso,2016,2,14,-12
KOR,Korea,BFA,Burkina Faso,2017,7,18,-11
LUX,Luxembourg,BFA,Burkina Faso,2008,0,1,-1
LUX,Luxembourg,BFA,Burkina Faso,2009,0,8,-8
LUX,Luxembourg,BFA,Burkina Faso,2010,3,3,0
LUX,Luxembourg,BFA,Burkina Faso,2011,0,4,-4
LUX,Luxembourg,BFA,Burkina Faso,2012,1,4,-3
LUX,Luxembourg,BFA,Burkina Faso,2013,4,1,3
LUX,Luxembourg,BFA,Burkina Faso,2014,0,3,-3
LUX,Luxembourg,BFA,Burkina Faso,2015,4,3,1
LUX,Luxembourg,BFA,Burkina Faso,2016,1,5,-4
LUX,Luxembourg,BFA,Burkina Faso,2017,1,8,-7
MEX,Mexico,BFA,Burkina Faso,2010,0,1,-1
MEX,Mexico,BFA,Burkina Faso,2011,0,1,-1
MEX,Mexico,BFA,Burkina Faso,2012,0,0,0
MEX,Mexico,BFA,Burkina Faso,2013,0,0,0
MEX,Mexico,BFA,Burkina Faso,2014,0,2,-2
MEX,Mexico,BFA,Burkina Faso,2015,0,1,-1
MEX,Mexico,BFA,Burkina Faso,2017,0,1,-1
NLD,Netherlands,BFA,Burkina Faso,2008,9,12,-3
NLD,Netherlands,BFA,Burkina Faso,2009,6,24,-18
NLD,Netherlands,BFA,Burkina Faso,2010,15,11,4
NLD,Netherlands,BFA,Burkina Faso,2011,6,23,-17
NLD,Netherlands,BFA,Burkina Faso,2012,5,11,-6
NLD,Netherlands,BFA,Burkina Faso,2013,4,8,-4
NLD,Netherlands,BFA,Burkina Faso,2014,2,14,-12
NLD,Netherlands,BFA,Burkina Faso,2015,4,12,-8
NLD,Netherlands,BFA,Burkina Faso,2016,8,18,-10
NLD,Netherlands,BFA,Burkina Faso,2017,5,14,-9
NOR,Norway,BFA,Burkina Faso,2008,0,4,-4
NOR,Norway,BFA,Burkina Faso,2009,1,3,-2
NOR,Norway,BFA,Burkina Faso,2010,0,2,-2
NOR,Norway,BFA,Burkina Faso,2011,0,3,-3
NOR,Norway,BFA,Burkina Faso,2012,2,2,0
NOR,Norway,BFA,Burkina Faso,2013,1,3,-2
NOR,Norway,BFA,Burkina Faso,2014,1,2,-1
NOR,Norway,BFA,Burkina Faso,2015,1,2,-1
NOR,Norway,BFA,Burkina Faso,2016,3,2,1
NOR,Norway,BFA,Burkina Faso,2017,0,3,-3
POL,Poland,BFA,Burkina Faso,2009,0,7,-7
POL,Poland,BFA,Burkina Faso,2010,0,8,-8
POL,Poland,BFA,Burkina Faso,2011,0,6,-6
POL,Poland,BFA,Burkina Faso,2012,0,4,-4
POL,Poland,BFA,Burkina Faso,2013,0,1,-1
POL,Poland,BFA,Burkina Faso,2014,0,3,-3
POL,Poland,BFA,Burkina Faso,2015,0,0,0
POL,Poland,BFA,Burkina Faso,2016,0,0,0
POL,Poland,BFA,Burkina Faso,2017,0,0,0
SVK,Slovak Republic,BFA,Burkina Faso,2008,0,0,0
ESP,Spain,BFA,Burkina Faso,2008,39,178,-139
ESP,Spain,BFA,Burkina Faso,2009,36,138,-102
ESP,Spain,BFA,Burkina Faso,2010,73,99,-26
ESP,Spain,BFA,Burkina Faso,2011,93,107,-14
ESP,Spain,BFA,Burkina Faso,2012,58,106,-48
ESP,Spain,BFA,Burkina Faso,2013,95,86,9
ESP,Spain,BFA,Burkina Faso,2014,47,88,-41
ESP,Spain,BFA,Burkina Faso,2015,55,120,-65
ESP,Spain,BFA,Burkina Faso,2016,45,94,-49
ESP,Spain,BFA,Burkina Faso,2017,69,105,-36
SWE,Sweden,BFA,Burkina Faso,2008,0,3,-3
SWE,Sweden,BFA,Burkina Faso,2009,0,4,-4
SWE,Sweden,BFA,Burkina Faso,2010,0,8,-8
SWE,Sweden,BFA,Burkina Faso,2011,6,4,2
SWE,Sweden,BFA,Burkina Faso,2012,2,12,-10
SWE,Sweden,BFA,Burkina Faso,2013,3,9,-6
SWE,Sweden,BFA,Burkina Faso,2014,3,0,3
SWE,Sweden,BFA,Burkina Faso,2015,4,4,0
SWE,Sweden,BFA,Burkina Faso,2016,3,3,0
SWE,Sweden,BFA,Burkina Faso,2017,1,7,-6
CHE,Switzerland,BFA,Burkina Faso,2010,25,44,-19
CHE,Switzerland,BFA,Burkina Faso,2011,27,42,-15
CHE,Switzerland,BFA,Burkina Faso,2012,13,51,-38
CHE,Switzerland,BFA,Burkina Faso,2013,14,30,-16
CHE,Switzerland,BFA,Burkina Faso,2014,18,39,-21
CHE,Switzerland,BFA,Burkina Faso,2015,13,36,-23
CHE,Switzerland,BFA,Burkina Faso,2016,19,32,-13
CHE,Switzerland,BFA,Burkina Faso,2017,10,40,-30
TUR,Turkey,BFA,Burkina Faso,2010,0,10,-10
USA,United States,BFA,Burkina Faso,2008,0,238,-238
USA,United States,BFA,Burkina Faso,2009,0,416,-416
USA,United States,BFA,Burkina Faso,2010,0,377,-377
USA,United States,BFA,Burkina Faso,2011,0,433,-433
USA,United States,BFA,Burkina Faso,2012,0,558,-558
USA,United States,BFA,Burkina Faso,2013,0,585,-585
USA,United States,BFA,Burkina Faso,2014,0,583,-583
USA,United States,BFA,Burkina Faso,2015,0,575,-575
USA,United States,BFA,Burkina Faso,2016,0,642,-642
USA,United States,BFA,Burkina Faso,2017,0,541,-541
CHL,Chile,BFA,Burkina Faso,2008,0,0,0
CHL,Chile,BFA,Burkina Faso,2009,0,0,0
CHL,Chile,BFA,Burkina Faso,2010,0,1,-1
CHL,Chile,BFA,Burkina Faso,2011,0,0,0
CHL,Chile,BFA,Burkina Faso,2012,0,0,0
CHL,Chile,BFA,Burkina Faso,2013,0,1,-1
CHL,Chile,BFA,Burkina Faso,2014,0,0,0
CHL,Chile,BFA,Burkina Faso,2015,0,0,0
CHL,Chile,BFA,Burkina Faso,2016,0,0,0
EST,Estonia,BFA,Burkina Faso,2008,0,0,0
EST,Estonia,BFA,Burkina Faso,2009,0,0,0
EST,Estonia,BFA,Burkina Faso,2010,0,0,0
EST,Estonia,BFA,Burkina Faso,2011,0,0,0
EST,Estonia,BFA,Burkina Faso,2012,0,0,0
EST,Estonia,BFA,Burkina Faso,2013,0,0,0
EST,Estonia,BFA,Burkina Faso,2014,0,0,0
EST,Estonia,BFA,Burkina Faso,2015,0,0,0
EST,Estonia,BFA,Burkina Faso,2016,0,0,0
EST,Estonia,BFA,Burkina Faso,2017,0,0,0
SVN,Slovenia,BFA,Burkina Faso,2008,0,1,-1
SVN,Slovenia,BFA,Burkina Faso,2009,0,1,-1
SVN,Slovenia,BFA,Burkina Faso,2010,0,1,-1
SVN,Slovenia,BFA,Burkina Faso,2015,0,2,-2
SVN,Slovenia,BFA,Burkina Faso,2017,0,1,-1
AUS,Australia,BDI,Burundi,2008,0,445,-445
AUS,Australia,BDI,Burundi,2009,0,333,-333
AUS,Australia,BDI,Burundi,2010,0,247,-247
AUS,Australia,BDI,Burundi,2011,0,120,-120
AUS,Australia,BDI,Burundi,2012,0,111,-111
AUS,Australia,BDI,Burundi,2013,6,82,-76
AUS,Australia,BDI,Burundi,2014,7,104,-97
AUS,Australia,BDI,Burundi,2015,0,122,-122
AUS,Australia,BDI,Burundi,2016,0,120,-120
AUS,Australia,BDI,Burundi,2017,0,105,-105
AUT,Austria,BDI,Burundi,2008,0,3,-3
AUT,Austria,BDI,Burundi,2009,1,3,-2
AUT,Austria,BDI,Burundi,2010,3,2,1
AUT,Austria,BDI,Burundi,2011,0,0,0
AUT,Austria,BDI,Burundi,2012,1,6,-5
AUT,Austria,BDI,Burundi,2013,1,4,-3
AUT,Austria,BDI,Burundi,2014,0,0,0
AUT,Austria,BDI,Burundi,2015,0,3,-3
AUT,Austria,BDI,Burundi,2016,0,6,-6
AUT,Austria,BDI,Burundi,2017,0,10,-10
BEL,Belgium,BDI,Burundi,2008,0,205,-205
BEL,Belgium,BDI,Burundi,2009,0,212,-212
BEL,Belgium,BDI,Burundi,2010,118,237,-119
BEL,Belgium,BDI,Burundi,2011,85,246,-161
BEL,Belgium,BDI,Burundi,2012,114,242,-128
BEL,Belgium,BDI,Burundi,2013,170,203,-33
BEL,Belgium,BDI,Burundi,2014,155,136,19
BEL,Belgium,BDI,Burundi,2015,61,369,-308
BEL,Belgium,BDI,Burundi,2016,53,333,-280
BEL,Belgium,BDI,Burundi,2017,45,370,-325
CAN,Canada,BDI,Burundi,2008,0,448,-448
CAN,Canada,BDI,Burundi,2009,0,566,-566
CAN,Canada,BDI,Burundi,2010,0,529,-529
CAN,Canada,BDI,Burundi,2011,0,604,-604
CAN,Canada,BDI,Burundi,2012,0,682,-682
CAN,Canada,BDI,Burundi,2013,0,480,-480
CAN,Canada,BDI,Burundi,2014,0,517,-517
CAN,Canada,BDI,Burundi,2015,0,938,-938
CAN,Canada,BDI,Burundi,2016,0,635,-635
CAN,Canada,BDI,Burundi,2017,0,805,-805
CZE,Czech Republic,BDI,Burundi,2009,0,1,-1
CZE,Czech Republic,BDI,Burundi,2014,1,1,0
CZE,Czech Republic,BDI,Burundi,2015,0,1,-1
CZE,Czech Republic,BDI,Burundi,2016,0,2,-2
DNK,Denmark,BDI,Burundi,2008,0,26,-26
DNK,Denmark,BDI,Burundi,2009,0,27,-27
DNK,Denmark,BDI,Burundi,2010,2,13,-11
DNK,Denmark,BDI,Burundi,2011,6,6,0
DNK,Denmark,BDI,Burundi,2012,3,3,0
DNK,Denmark,BDI,Burundi,2013,2,6,-4
DNK,Denmark,BDI,Burundi,2014,2,3,-1
DNK,Denmark,BDI,Burundi,2015,2,7,-5
DNK,Denmark,BDI,Burundi,2016,2,10,-8
DNK,Denmark,BDI,Burundi,2017,5,6,-1
FIN,Finland,BDI,Burundi,2008,0,3,-3
FIN,Finland,BDI,Burundi,2009,0,21,-21
FIN,Finland,BDI,Burundi,2010,0,1,-1
FIN,Finland,BDI,Burundi,2011,0,1,-1
FIN,Finland,BDI,Burundi,2012,0,0,0
FIN,Finland,BDI,Burundi,2013,0,5,-5
FIN,Finland,BDI,Burundi,2014,0,4,-4
FIN,Finland,BDI,Burundi,2015,0,3,-3
FIN,Finland,BDI,Burundi,2016,0,1,-1
FIN,Finland,BDI,Burundi,2017,0,8,-8
FRA,France,BDI,Burundi,2008,0,72,-72
FRA,France,BDI,Burundi,2009,0,60,-60
FRA,France,BDI,Burundi,2010,0,63,-63
FRA,France,BDI,Burundi,2011,0,68,-68
FRA,France,BDI,Burundi,2012,0,72,-72
FRA,France,BDI,Burundi,2013,0,84,-84
FRA,France,BDI,Burundi,2014,0,74,-74
FRA,France,BDI,Burundi,2015,0,65,-65
FRA,France,BDI,Burundi,2016,0,129,-129
FRA,France,BDI,Burundi,2017,0,175,-175
DEU,Germany,BDI,Burundi,2008,53,39,14
DEU,Germany,BDI,Burundi,2009,33,36,-3
DEU,Germany,BDI,Burundi,2010,28,27,1
DEU,Germany,BDI,Burundi,2011,19,22,-3
DEU,Germany,BDI,Burundi,2012,17,27,-10
DEU,Germany,BDI,Burundi,2013,17,28,-11
DEU,Germany,BDI,Burundi,2014,15,32,-17
DEU,Germany,BDI,Burundi,2015,21,54,-33
DEU,Germany,BDI,Burundi,2016,13,65,-52
DEU,Germany,BDI,Burundi,2017,18,47,-29
HUN,Hungary,BDI,Burundi,2008,0,0,0
HUN,Hungary,BDI,Burundi,2009,0,0,0
HUN,Hungary,BDI,Burundi,2010,0,0,0
HUN,Hungary,BDI,Burundi,2011,0,0,0
HUN,Hungary,BDI,Burundi,2012,0,0,0
HUN,Hungary,BDI,Burundi,2013,0,0,0
HUN,Hungary,BDI,Burundi,2014,0,1,-1
HUN,Hungary,BDI,Burundi,2015,0,1,-1
HUN,Hungary,BDI,Burundi,2016,0,0,0
HUN,Hungary,BDI,Burundi,2017,0,7,-7
ISL,Iceland,BDI,Burundi,2008,0,0,0
ISL,Iceland,BDI,Burundi,2009,0,0,0
ISL,Iceland,BDI,Burundi,2010,0,0,0
ISL,Iceland,BDI,Burundi,2011,0,0,0
ISL,Iceland,BDI,Burundi,2012,0,0,0
ISL,Iceland,BDI,Burundi,2013,0,1,-1
ISL,Iceland,BDI,Burundi,2014,1,0,1
ISL,Iceland,BDI,Burundi,2015,0,0,0
ISL,Iceland,BDI,Burundi,2016,0,0,0
ISL,Iceland,BDI,Burundi,2017,0,0,0
ITA,Italy,BDI,Burundi,2008,5,45,-40
ITA,Italy,BDI,Burundi,2009,6,52,-46
ITA,Italy,BDI,Burundi,2010,6,37,-31
ITA,Italy,BDI,Burundi,2011,2,42,-40
ITA,Italy,BDI,Burundi,2012,11,60,-49
ITA,Italy,BDI,Burundi,2013,7,58,-51
ITA,Italy,BDI,Burundi,2014,9,36,-27
ITA,Italy,BDI,Burundi,2015,8,50,-42
ITA,Italy,BDI,Burundi,2016,0,57,-57
ITA,Italy,BDI,Burundi,2017,2,60,-58
JPN,Japan,BDI,Burundi,2008,35,35,0
JPN,Japan,BDI,Burundi,2009,26,26,0
JPN,Japan,BDI,Burundi,2010,24,99,-75
JPN,Japan,BDI,Burundi,2011,26,26,0
JPN,Japan,BDI,Burundi,2012,59,59,0
JPN,Japan,BDI,Burundi,2013,42,44,-2
JPN,Japan,BDI,Burundi,2014,31,31,0
JPN,Japan,BDI,Burundi,2015,46,49,-3
JPN,Japan,BDI,Burundi,2016,44,48,-4
JPN,Japan,BDI,Burundi,2017,29,29,0
KOR,Korea,BDI,Burundi,2008,1,2,-1
KOR,Korea,BDI,Burundi,2009,1,3,-2
KOR,Korea,BDI,Burundi,2010,3,6,-3
KOR,Korea,BDI,Burundi,2011,3,11,-8
KOR,Korea,BDI,Burundi,2012,9,8,1
KOR,Korea,BDI,Burundi,2013,5,13,-8
KOR,Korea,BDI,Burundi,2014,5,26,-21
KOR,Korea,BDI,Burundi,2015,8,22,-14
KOR,Korea,BDI,Burundi,2016,14,17,-3
KOR,Korea,BDI,Burundi,2017,12,15,-3
LUX,Luxembourg,BDI,Burundi,2008,11,1,10
LUX,Luxembourg,BDI,Burundi,2009,0,4,-4
LUX,Luxembourg,BDI,Burundi,2010,0,1,-1
LUX,Luxembourg,BDI,Burundi,2011,1,3,-2
LUX,Luxembourg,BDI,Burundi,2012,1,2,-1
LUX,Luxembourg,BDI,Burundi,2013,2,2,0
LUX,Luxembourg,BDI,Burundi,2014,1,2,-1
LUX,Luxembourg,BDI,Burundi,2015,0,1,-1
LUX,Luxembourg,BDI,Burundi,2016,1,7,-6
LUX,Luxembourg,BDI,Burundi,2017,2,2,0
MEX,Mexico,BDI,Burundi,2012,0,1,-1
MEX,Mexico,BDI,Burundi,2013,0,2,-2
MEX,Mexico,BDI,Burundi,2014,0,1,-1
MEX,Mexico,BDI,Burundi,2015,0,2,-2
NLD,Netherlands,BDI,Burundi,2008,4,41,-37
NLD,Netherlands,BDI,Burundi,2009,0,48,-48
NLD,Netherlands,BDI,Burundi,2010,10,29,-19
NLD,Netherlands,BDI,Burundi,2011,4,5,-1
NLD,Netherlands,BDI,Burundi,2012,16,13,3
NLD,Netherlands,BDI,Burundi,2013,9,15,-6
NLD,Netherlands,BDI,Burundi,2014,7,18,-11
NLD,Netherlands,BDI,Burundi,2015,5,16,-11
NLD,Netherlands,BDI,Burundi,2016,0,23,-23
NLD,Netherlands,BDI,Burundi,2017,4,27,-23
NZL,New Zealand,BDI,Burundi,2008,0,10,-10
NZL,New Zealand,BDI,Burundi,2009,0,35,-35
NZL,New Zealand,BDI,Burundi,2010,1,14,-13
NZL,New Zealand,BDI,Burundi,2011,0,9,-9
NZL,New Zealand,BDI,Burundi,2012,0,8,-8
NZL,New Zealand,BDI,Burundi,2013,0,2,-2
NZL,New Zealand,BDI,Burundi,2014,0,1,-1
NZL,New Zealand,BDI,Burundi,2015,0,5,-5
NZL,New Zealand,BDI,Burundi,2016,0,2,-2
NZL,New Zealand,BDI,Burundi,2017,0,4,-4
NOR,Norway,BDI,Burundi,2008,8,51,-43
NOR,Norway,BDI,Burundi,2009,13,80,-67
NOR,Norway,BDI,Burundi,2010,7,34,-27
NOR,Norway,BDI,Burundi,2011,5,46,-41
NOR,Norway,BDI,Burundi,2012,12,43,-31
NOR,Norway,BDI,Burundi,2013,8,29,-21
NOR,Norway,BDI,Burundi,2014,1,18,-17
NOR,Norway,BDI,Burundi,2015,5,45,-40
NOR,Norway,BDI,Burundi,2016,3,28,-25
NOR,Norway,BDI,Burundi,2017,3,17,-14
POL,Poland,BDI,Burundi,2009,0,3,-3
POL,Poland,BDI,Burundi,2010,0,0,0
POL,Poland,BDI,Burundi,2011,0,2,-2
POL,Poland,BDI,Burundi,2012,0,3,-3
POL,Poland,BDI,Burundi,2013,0,2,-2
POL,Poland,BDI,Burundi,2014,0,0,0
POL,Poland,BDI,Burundi,2015,0,0,0
POL,Poland,BDI,Burundi,2016,0,3,-3
POL,Poland,BDI,Burundi,2017,0,2,-2
SVK,Slovak Republic,BDI,Burundi,2008,0,0,0
ESP,Spain,BDI,Burundi,2008,6,12,-6
ESP,Spain,BDI,Burundi,2009,2,8,-6
ESP,Spain,BDI,Burundi,2010,9,7,2
ESP,Spain,BDI,Burundi,2011,18,15,3
ESP,Spain,BDI,Burundi,2012,2,9,-7
ESP,Spain,BDI,Burundi,2013,4,9,-5
ESP,Spain,BDI,Burundi,2014,0,8,-8
ESP,Spain,BDI,Burundi,2015,1,15,-14
ESP,Spain,BDI,Burundi,2016,6,14,-8
ESP,Spain,BDI,Burundi,2017,4,10,-6
SWE,Sweden,BDI,Burundi,2008,4,202,-198
SWE,Sweden,BDI,Burundi,2009,2,159,-157
SWE,Sweden,BDI,Burundi,2010,6,107,-101
SWE,Sweden,BDI,Burundi,2011,9,86,-77
SWE,Sweden,BDI,Burundi,2012,4,98,-94
SWE,Sweden,BDI,Burundi,2013,7,62,-55
SWE,Sweden,BDI,Burundi,2014,1,73,-72
SWE,Sweden,BDI,Burundi,2015,7,63,-56
SWE,Sweden,BDI,Burundi,2016,5,94,-89
SWE,Sweden,BDI,Burundi,2017,2,124,-122
CHE,Switzerland,BDI,Burundi,2010,11,19,-8
CHE,Switzerland,BDI,Burundi,2011,12,18,-6
CHE,Switzerland,BDI,Burundi,2012,7,11,-4
CHE,Switzerland,BDI,Burundi,2013,7,11,-4
CHE,Switzerland,BDI,Burundi,2014,2,12,-10
CHE,Switzerland,BDI,Burundi,2015,5,13,-8
CHE,Switzerland,BDI,Burundi,2016,0,19,-19
CHE,Switzerland,BDI,Burundi,2017,4,27,-23
USA,United States,BDI,Burundi,2008,0,255,-255
USA,United States,BDI,Burundi,2009,0,1505,-1505
USA,United States,BDI,Burundi,2010,0,841,-841
USA,United States,BDI,Burundi,2011,0,593,-593
USA,United States,BDI,Burundi,2012,0,535,-535
USA,United States,BDI,Burundi,2013,0,260,-260
USA,United States,BDI,Burundi,2014,0,273,-273
USA,United States,BDI,Burundi,2015,0,351,-351
USA,United States,BDI,Burundi,2016,0,415,-415
USA,United States,BDI,Burundi,2017,0,1094,-1094
CHL,Chile,BDI,Burundi,2008,0,0,0
CHL,Chile,BDI,Burundi,2009,0,1,-1
CHL,Chile,BDI,Burundi,2010,0,0,0
CHL,Chile,BDI,Burundi,2011,0,0,0
CHL,Chile,BDI,Burundi,2012,0,0,0
CHL,Chile,BDI,Burundi,2013,0,0,0
CHL,Chile,BDI,Burundi,2014,0,0,0
CHL,Chile,BDI,Burundi,2015,0,0,0
CHL,Chile,BDI,Burundi,2016,0,0,0
EST,Estonia,BDI,Burundi,2008,0,0,0
EST,Estonia,BDI,Burundi,2009,0,0,0
EST,Estonia,BDI,Burundi,2010,0,0,0
EST,Estonia,BDI,Burundi,2011,0,0,0
EST,Estonia,BDI,Burundi,2012,0,0,0
EST,Estonia,BDI,Burundi,2013,0,0,0
EST,Estonia,BDI,Burundi,2014,0,0,0
EST,Estonia,BDI,Burundi,2015,0,0,0
EST,Estonia,BDI,Burundi,2016,0,0,0
EST,Estonia,BDI,Burundi,2017,0,0,0
SVN,Slovenia,BDI,Burundi,2017,0,1,-1
AUS,Australia,KHM,Cambodia,2008,163,654,-491
AUS,Australia,KHM,Cambodia,2009,100,727,-627
AUS,Australia,KHM,Cambodia,2010,99,873,-774
AUS,Australia,KHM,Cambodia,2011,101,773,-672
AUS,Australia,KHM,Cambodia,2012,85,779,-694
AUS,Australia,KHM,Cambodia,2013,128,754,-626
AUS,Australia,KHM,Cambodia,2014,110,812,-702
AUS,Australia,KHM,Cambodia,2015,100,763,-663
AUS,Australia,KHM,Cambodia,2016,100,826,-726
AUS,Australia,KHM,Cambodia,2017,0,674,-674
AUT,Austria,KHM,Cambodia,2008,16,32,-16
AUT,Austria,KHM,Cambodia,2009,7,19,-12
AUT,Austria,KHM,Cambodia,2010,4,7,-3
AUT,Austria,KHM,Cambodia,2011,8,20,-12
AUT,Austria,KHM,Cambodia,2012,6,15,-9
AUT,Austria,KHM,Cambodia,2013,7,16,-9
AUT,Austria,KHM,Cambodia,2014,6,15,-9
AUT,Austria,KHM,Cambodia,2015,7,22,-15
AUT,Austria,KHM,Cambodia,2016,6,22,-16
AUT,Austria,KHM,Cambodia,2017,11,19,-8
BEL,Belgium,KHM,Cambodia,2008,0,42,-42
BEL,Belgium,KHM,Cambodia,2009,0,46,-46
BEL,Belgium,KHM,Cambodia,2010,12,57,-45
BEL,Belgium,KHM,Cambodia,2011,0,40,-40
BEL,Belgium,KHM,Cambodia,2012,18,28,-10
BEL,Belgium,KHM,Cambodia,2013,20,29,-9
BEL,Belgium,KHM,Cambodia,2014,15,27,-12
BEL,Belgium,KHM,Cambodia,2015,8,26,-18
BEL,Belgium,KHM,Cambodia,2016,9,32,-23
BEL,Belgium,KHM,Cambodia,2017,11,27,-16
CAN,Canada,KHM,Cambodia,2008,0,354,-354
CAN,Canada,KHM,Cambodia,2009,0,203,-203
CAN,Canada,KHM,Cambodia,2010,0,200,-200
CAN,Canada,KHM,Cambodia,2011,0,196,-196
CAN,Canada,KHM,Cambodia,2012,0,233,-233
CAN,Canada,KHM,Cambodia,2013,0,289,-289
CAN,Canada,KHM,Cambodia,2014,0,237,-237
CAN,Canada,KHM,Cambodia,2015,0,205,-205
CAN,Canada,KHM,Cambodia,2016,0,250,-250
CAN,Canada,KHM,Cambodia,2017,0,225,-225
CZE,Czech Republic,KHM,Cambodia,2008,0,5,-5
CZE,Czech Republic,KHM,Cambodia,2009,0,3,-3
CZE,Czech Republic,KHM,Cambodia,2010,0,2,-2
CZE,Czech Republic,KHM,Cambodia,2011,0,3,-3
CZE,Czech Republic,KHM,Cambodia,2012,3,10,-7
CZE,Czech Republic,KHM,Cambodia,2013,4,6,-2
CZE,Czech Republic,KHM,Cambodia,2014,5,13,-8
CZE,Czech Republic,KHM,Cambodia,2015,6,10,-4
CZE,Czech Republic,KHM,Cambodia,2016,8,15,-7
CZE,Czech Republic,KHM,Cambodia,2017,5,7,-2
DNK,Denmark,KHM,Cambodia,2008,5,7,-2
DNK,Denmark,KHM,Cambodia,2009,2,12,-10
DNK,Denmark,KHM,Cambodia,2010,2,17,-15
DNK,Denmark,KHM,Cambodia,2011,0,10,-10
DNK,Denmark,KHM,Cambodia,2012,1,14,-13
DNK,Denmark,KHM,Cambodia,2013,2,7,-5
DNK,Denmark,KHM,Cambodia,2014,2,11,-9
DNK,Denmark,KHM,Cambodia,2015,5,10,-5
DNK,Denmark,KHM,Cambodia,2016,5,10,-5
DNK,Denmark,KHM,Cambodia,2017,2,18,-16
FIN,Finland,KHM,Cambodia,2008,1,3,-2
FIN,Finland,KHM,Cambodia,2009,0,6,-6
FIN,Finland,KHM,Cambodia,2010,0,11,-11
FIN,Finland,KHM,Cambodia,2011,0,9,-9
FIN,Finland,KHM,Cambodia,2012,1,6,-5
FIN,Finland,KHM,Cambodia,2013,0,11,-11
FIN,Finland,KHM,Cambodia,2014,1,16,-15
FIN,Finland,KHM,Cambodia,2015,0,12,-12
FIN,Finland,KHM,Cambodia,2016,2,10,-8
FIN,Finland,KHM,Cambodia,2017,0,6,-6
FRA,France,KHM,Cambodia,2008,0,436,-436
FRA,France,KHM,Cambodia,2009,0,568,-568
FRA,France,KHM,Cambodia,2010,0,532,-532
FRA,France,KHM,Cambodia,2011,0,424,-424
FRA,France,KHM,Cambodia,2012,0,422,-422
FRA,France,KHM,Cambodia,2013,0,435,-435
FRA,France,KHM,Cambodia,2014,0,478,-478
FRA,France,KHM,Cambodia,2015,0,391,-391
FRA,France,KHM,Cambodia,2016,0,335,-335
FRA,France,KHM,Cambodia,2017,0,314,-314
DEU,Germany,KHM,Cambodia,2008,54,86,-32
DEU,Germany,KHM,Cambodia,2009,60,73,-13
DEU,Germany,KHM,Cambodia,2010,67,74,-7
DEU,Germany,KHM,Cambodia,2011,55,100,-45
DEU,Germany,KHM,Cambodia,2012,40,100,-60
DEU,Germany,KHM,Cambodia,2013,31,102,-71
DEU,Germany,KHM,Cambodia,2014,38,103,-65
DEU,Germany,KHM,Cambodia,2015,55,101,-46
DEU,Germany,KHM,Cambodia,2016,36,104,-68
DEU,Germany,KHM,Cambodia,2017,43,118,-75
HUN,Hungary,KHM,Cambodia,2008,0,1,-1
HUN,Hungary,KHM,Cambodia,2009,0,3,-3
HUN,Hungary,KHM,Cambodia,2010,0,1,-1
HUN,Hungary,KHM,Cambodia,2011,0,3,-3
HUN,Hungary,KHM,Cambodia,2012,0,0,0
HUN,Hungary,KHM,Cambodia,2013,0,1,-1
HUN,Hungary,KHM,Cambodia,2014,0,2,-2
HUN,Hungary,KHM,Cambodia,2015,0,2,-2
HUN,Hungary,KHM,Cambodia,2016,0,13,-13
HUN,Hungary,KHM,Cambodia,2017,0,10,-10
ISL,Iceland,KHM,Cambodia,2008,1,0,1
ISL,Iceland,KHM,Cambodia,2009,0,0,0
ISL,Iceland,KHM,Cambodia,2010,0,0,0
ISL,Iceland,KHM,Cambodia,2011,0,0,0
ISL,Iceland,KHM,Cambodia,2012,0,0,0
ISL,Iceland,KHM,Cambodia,2013,0,0,0
ISL,Iceland,KHM,Cambodia,2014,0,0,0
ISL,Iceland,KHM,Cambodia,2015,0,0,0
ISL,Iceland,KHM,Cambodia,2016,0,0,0
ISL,Iceland,KHM,Cambodia,2017,0,0,0
ITA,Italy,KHM,Cambodia,2008,4,153,-149
ITA,Italy,KHM,Cambodia,2009,4,94,-90
ITA,Italy,KHM,Cambodia,2010,0,81,-81
ITA,Italy,KHM,Cambodia,2011,2,69,-67
ITA,Italy,KHM,Cambodia,2012,1,24,-23
ITA,Italy,KHM,Cambodia,2013,2,21,-19
ITA,Italy,KHM,Cambodia,2014,2,11,-9
ITA,Italy,KHM,Cambodia,2015,5,18,-13
ITA,Italy,KHM,Cambodia,2016,0,12,-12
ITA,Italy,KHM,Cambodia,2017,1,16,-15
JPN,Japan,KHM,Cambodia,2008,789,918,-129
JPN,Japan,KHM,Cambodia,2009,909,1092,-183
JPN,Japan,KHM,Cambodia,2010,1004,1097,-93
JPN,Japan,KHM,Cambodia,2011,980,1131,-151
JPN,Japan,KHM,Cambodia,2012,947,1099,-152
JPN,Japan,KHM,Cambodia,2013,997,1299,-302
JPN,Japan,KHM,Cambodia,2014,1283,2342,-1059
JPN,Japan,KHM,Cambodia,2015,1662,3726,-2064
JPN,Japan,KHM,Cambodia,2016,1835,4213,-2378
JPN,Japan,KHM,Cambodia,2017,2297,4767,-2470
KOR,Korea,KHM,Cambodia,2008,814,3420,-2606
KOR,Korea,KHM,Cambodia,2009,941,2591,-1650
KOR,Korea,KHM,Cambodia,2010,733,3679,-2946
KOR,Korea,KHM,Cambodia,2011,982,6444,-5462
KOR,Korea,KHM,Cambodia,2012,1960,9523,-7563
KOR,Korea,KHM,Cambodia,2013,2859,10496,-7637
KOR,Korea,KHM,Cambodia,2014,2917,9493,-6576
KOR,Korea,KHM,Cambodia,2015,4569,9564,-4995
KOR,Korea,KHM,Cambodia,2016,7172,10248,-3076
KOR,Korea,KHM,Cambodia,2017,8071,9523,-1452
LUX,Luxembourg,KHM,Cambodia,2008,0,0,0
LUX,Luxembourg,KHM,Cambodia,2009,1,2,-1
LUX,Luxembourg,KHM,Cambodia,2010,1,2,-1
LUX,Luxembourg,KHM,Cambodia,2011,0,3,-3
LUX,Luxembourg,KHM,Cambodia,2012,2,2,0
LUX,Luxembourg,KHM,Cambodia,2013,1,2,-1
LUX,Luxembourg,KHM,Cambodia,2014,2,1,1
LUX,Luxembourg,KHM,Cambodia,2015,1,3,-2
LUX,Luxembourg,KHM,Cambodia,2016,1,3,-2
LUX,Luxembourg,KHM,Cambodia,2017,2,2,0
MEX,Mexico,KHM,Cambodia,2012,0,0,0
MEX,Mexico,KHM,Cambodia,2013,0,0,0
MEX,Mexico,KHM,Cambodia,2014,0,0,0
MEX,Mexico,KHM,Cambodia,2016,0,1,-1
MEX,Mexico,KHM,Cambodia,2017,0,3,-3
NLD,Netherlands,KHM,Cambodia,2008,4,13,-9
NLD,Netherlands,KHM,Cambodia,2009,4,15,-11
NLD,Netherlands,KHM,Cambodia,2010,9,15,-6
NLD,Netherlands,KHM,Cambodia,2011,7,10,-3
NLD,Netherlands,KHM,Cambodia,2012,1,14,-13
NLD,Netherlands,KHM,Cambodia,2013,6,11,-5
NLD,Netherlands,KHM,Cambodia,2014,2,26,-24
NLD,Netherlands,KHM,Cambodia,2015,5,18,-13
NLD,Netherlands,KHM,Cambodia,2016,9,19,-10
NLD,Netherlands,KHM,Cambodia,2017,5,12,-7
NZL,New Zealand,KHM,Cambodia,2008,25,245,-220
NZL,New Zealand,KHM,Cambodia,2009,14,199,-185
NZL,New Zealand,KHM,Cambodia,2010,34,181,-147
NZL,New Zealand,KHM,Cambodia,2011,25,236,-211
NZL,New Zealand,KHM,Cambodia,2012,22,183,-161
NZL,New Zealand,KHM,Cambodia,2013,34,222,-188
NZL,New Zealand,KHM,Cambodia,2014,37,169,-132
NZL,New Zealand,KHM,Cambodia,2015,28,184,-156
NZL,New Zealand,KHM,Cambodia,2016,36,210,-174
NZL,New Zealand,KHM,Cambodia,2017,60,197,-137
NOR,Norway,KHM,Cambodia,2008,7,13,-6
NOR,Norway,KHM,Cambodia,2009,4,19,-15
NOR,Norway,KHM,Cambodia,2010,3,10,-7
NOR,Norway,KHM,Cambodia,2011,8,26,-18
NOR,Norway,KHM,Cambodia,2012,8,15,-7
NOR,Norway,KHM,Cambodia,2013,2,26,-24
NOR,Norway,KHM,Cambodia,2014,2,17,-15
NOR,Norway,KHM,Cambodia,2015,10,26,-16
NOR,Norway,KHM,Cambodia,2016,13,23,-10
NOR,Norway,KHM,Cambodia,2017,3,14,-11
POL,Poland,KHM,Cambodia,2009,0,2,-2
POL,Poland,KHM,Cambodia,2010,0,4,-4
POL,Poland,KHM,Cambodia,2011,0,9,-9
POL,Poland,KHM,Cambodia,2012,0,11,-11
POL,Poland,KHM,Cambodia,2013,0,6,-6
POL,Poland,KHM,Cambodia,2014,0,6,-6
POL,Poland,KHM,Cambodia,2015,0,4,-4
POL,Poland,KHM,Cambodia,2016,0,9,-9
POL,Poland,KHM,Cambodia,2017,0,5,-5
SVK,Slovak Republic,KHM,Cambodia,2008,0,0,0
SVK,Slovak Republic,KHM,Cambodia,2010,0,1,-1
ESP,Spain,KHM,Cambodia,2008,1,10,-9
ESP,Spain,KHM,Cambodia,2009,4,4,0
ESP,Spain,KHM,Cambodia,2010,4,1,3
ESP,Spain,KHM,Cambodia,2011,4,8,-4
ESP,Spain,KHM,Cambodia,2012,0,10,-10
ESP,Spain,KHM,Cambodia,2013,1,7,-6
ESP,Spain,KHM,Cambodia,2014,1,3,-2
ESP,Spain,KHM,Cambodia,2015,0,12,-12
ESP,Spain,KHM,Cambodia,2016,4,8,-4
ESP,Spain,KHM,Cambodia,2017,5,11,-6
SWE,Sweden,KHM,Cambodia,2008,2,25,-23
SWE,Sweden,KHM,Cambodia,2009,1,35,-34
SWE,Sweden,KHM,Cambodia,2010,0,30,-30
SWE,Sweden,KHM,Cambodia,2011,2,26,-24
SWE,Sweden,KHM,Cambodia,2012,6,19,-13
SWE,Sweden,KHM,Cambodia,2013,2,38,-36
SWE,Sweden,KHM,Cambodia,2014,7,35,-28
SWE,Sweden,KHM,Cambodia,2015,8,34,-26
SWE,Sweden,KHM,Cambodia,2016,6,28,-22
SWE,Sweden,KHM,Cambodia,2017,3,26,-23
CHE,Switzerland,KHM,Cambodia,2010,9,37,-28
CHE,Switzerland,KHM,Cambodia,2011,6,25,-19
CHE,Switzerland,KHM,Cambodia,2012,9,26,-17
CHE,Switzerland,KHM,Cambodia,2013,12,39,-27
CHE,Switzerland,KHM,Cambodia,2014,11,34,-23
CHE,Switzerland,KHM,Cambodia,2015,10,42,-32
CHE,Switzerland,KHM,Cambodia,2016,6,36,-30
CHE,Switzerland,KHM,Cambodia,2017,19,41,-22
TUR,Turkey,KHM,Cambodia,2010,0,3,-3
USA,United States,KHM,Cambodia,2008,0,3713,-3713
USA,United States,KHM,Cambodia,2009,0,3771,-3771
USA,United States,KHM,Cambodia,2010,0,2986,-2986
USA,United States,KHM,Cambodia,2011,0,2745,-2745
USA,United States,KHM,Cambodia,2012,0,2473,-2473
USA,United States,KHM,Cambodia,2013,0,2624,-2624
USA,United States,KHM,Cambodia,2014,0,2536,-2536
USA,United States,KHM,Cambodia,2015,0,1868,-1868
USA,United States,KHM,Cambodia,2016,0,3173,-3173
USA,United States,KHM,Cambodia,2017,0,4056,-4056
CHL,Chile,KHM,Cambodia,2008,0,0,0
CHL,Chile,KHM,Cambodia,2009,0,0,0
CHL,Chile,KHM,Cambodia,2010,0,0,0
CHL,Chile,KHM,Cambodia,2011,0,0,0
CHL,Chile,KHM,Cambodia,2012,0,1,-1
CHL,Chile,KHM,Cambodia,2013,0,0,0
CHL,Chile,KHM,Cambodia,2014,0,0,0
CHL,Chile,KHM,Cambodia,2015,0,0,0
CHL,Chile,KHM,Cambodia,2016,0,0,0
EST,Estonia,KHM,Cambodia,2008,0,0,0
EST,Estonia,KHM,Cambodia,2009,0,0,0
EST,Estonia,KHM,Cambodia,2010,0,0,0
EST,Estonia,KHM,Cambodia,2011,0,0,0
EST,Estonia,KHM,Cambodia,2012,0,0,0
EST,Estonia,KHM,Cambodia,2013,0,0,0
EST,Estonia,KHM,Cambodia,2014,0,0,0
EST,Estonia,KHM,Cambodia,2015,0,2,-2
EST,Estonia,KHM,Cambodia,2016,0,1,-1
EST,Estonia,KHM,Cambodia,2017,0,1,-1
SVN,Slovenia,KHM,Cambodia,2008,0,1,-1
SVN,Slovenia,KHM,Cambodia,2012,0,1,-1
AUS,Australia,CMR,Cameroon,2008,0,27,-27
AUS,Australia,CMR,Cameroon,2009,5,15,-10
AUS,Australia,CMR,Cameroon,2010,0,21,-21
AUS,Australia,CMR,Cameroon,2011,0,41,-41
AUS,Australia,CMR,Cameroon,2012,0,13,-13
AUS,Australia,CMR,Cameroon,2013,7,8,-1
AUS,Australia,CMR,Cameroon,2014,5,12,-7
AUS,Australia,CMR,Cameroon,2015,0,26,-26
AUS,Australia,CMR,Cameroon,2016,0,18,-18
AUS,Australia,CMR,Cameroon,2017,0,11,-11
AUT,Austria,CMR,Cameroon,2008,34,65,-31
AUT,Austria,CMR,Cameroon,2009,31,51,-20
AUT,Austria,CMR,Cameroon,2010,43,59,-16
AUT,Austria,CMR,Cameroon,2011,41,50,-9
AUT,Austria,CMR,Cameroon,2012,36,82,-46
AUT,Austria,CMR,Cameroon,2013,47,65,-18
AUT,Austria,CMR,Cameroon,2014,21,48,-27
AUT,Austria,CMR,Cameroon,2015,26,93,-67
AUT,Austria,CMR,Cameroon,2016,40,72,-32
AUT,Austria,CMR,Cameroon,2017,49,85,-36
BEL,Belgium,CMR,Cameroon,2008,124,1220,-1096
BEL,Belgium,CMR,Cameroon,2009,192,1176,-984
BEL,Belgium,CMR,Cameroon,2010,187,1233,-1046
BEL,Belgium,CMR,Cameroon,2011,278,1292,-1014
BEL,Belgium,CMR,Cameroon,2012,502,1775,-1273
BEL,Belgium,CMR,Cameroon,2013,618,1346,-728
BEL,Belgium,CMR,Cameroon,2014,592,1435,-843
BEL,Belgium,CMR,Cameroon,2015,527,1504,-977
BEL,Belgium,CMR,Cameroon,2016,385,1562,-1177
BEL,Belgium,CMR,Cameroon,2017,311,1668,-1357
CAN,Canada,CMR,Cameroon,2008,0,1277,-1277
CAN,Canada,CMR,Cameroon,2009,0,1343,-1343
CAN,Canada,CMR,Cameroon,2010,0,1801,-1801
CAN,Canada,CMR,Cameroon,2011,0,1635,-1635
CAN,Canada,CMR,Cameroon,2012,0,2503,-2503
CAN,Canada,CMR,Cameroon,2013,0,2438,-2438
CAN,Canada,CMR,Cameroon,2014,0,2107,-2107
CAN,Canada,CMR,Cameroon,2015,0,2034,-2034
CAN,Canada,CMR,Cameroon,2016,0,2110,-2110
CAN,Canada,CMR,Cameroon,2017,0,2285,-2285
CZE,Czech Republic,CMR,Cameroon,2008,0,12,-12
CZE,Czech Republic,CMR,Cameroon,2009,0,23,-23
CZE,Czech Republic,CMR,Cameroon,2010,0,9,-9
CZE,Czech Republic,CMR,Cameroon,2011,0,3,-3
CZE,Czech Republic,CMR,Cameroon,2012,4,6,-2
CZE,Czech Republic,CMR,Cameroon,2013,1,10,-9
CZE,Czech Republic,CMR,Cameroon,2014,8,15,-7
CZE,Czech Republic,CMR,Cameroon,2015,6,8,-2
CZE,Czech Republic,CMR,Cameroon,2016,4,5,-1
DNK,Denmark,CMR,Cameroon,2008,23,68,-45
DNK,Denmark,CMR,Cameroon,2009,20,84,-64
DNK,Denmark,CMR,Cameroon,2010,42,96,-54
DNK,Denmark,CMR,Cameroon,2011,46,105,-59
DNK,Denmark,CMR,Cameroon,2012,49,62,-13
DNK,Denmark,CMR,Cameroon,2013,68,93,-25
DNK,Denmark,CMR,Cameroon,2014,68,99,-31
DNK,Denmark,CMR,Cameroon,2015,54,88,-34
DNK,Denmark,CMR,Cameroon,2016,56,87,-31
DNK,Denmark,CMR,Cameroon,2017,71,71,0
FIN,Finland,CMR,Cameroon,2008,5,111,-106
FIN,Finland,CMR,Cameroon,2009,3,58,-55
FIN,Finland,CMR,Cameroon,2010,7,60,-53
FIN,Finland,CMR,Cameroon,2011,4,49,-45
FIN,Finland,CMR,Cameroon,2012,8,66,-58
FIN,Finland,CMR,Cameroon,2013,8,76,-68
FIN,Finland,CMR,Cameroon,2014,12,117,-105
FIN,Finland,CMR,Cameroon,2015,4,67,-63
FIN,Finland,CMR,Cameroon,2016,6,112,-106
FIN,Finland,CMR,Cameroon,2017,4,87,-83
FRA,France,CMR,Cameroon,2008,0,3828,-3828
FRA,France,CMR,Cameroon,2009,0,3867,-3867
FRA,France,CMR,Cameroon,2010,0,3599,-3599
FRA,France,CMR,Cameroon,2011,0,3583,-3583
FRA,France,CMR,Cameroon,2012,0,3764,-3764
FRA,France,CMR,Cameroon,2013,0,3787,-3787
FRA,France,CMR,Cameroon,2014,0,4072,-4072
FRA,France,CMR,Cameroon,2015,0,3164,-3164
FRA,France,CMR,Cameroon,2016,0,3197,-3197
FRA,France,CMR,Cameroon,2017,0,3418,-3418
DEU,Germany,CMR,Cameroon,2008,1389,1392,-3
DEU,Germany,CMR,Cameroon,2009,1186,1784,-598
DEU,Germany,CMR,Cameroon,2010,1120,1786,-666
DEU,Germany,CMR,Cameroon,2011,1003,2037,-1034
DEU,Germany,CMR,Cameroon,2012,807,2010,-1203
DEU,Germany,CMR,Cameroon,2013,924,2427,-1503
DEU,Germany,CMR,Cameroon,2014,969,2810,-1841
DEU,Germany,CMR,Cameroon,2015,980,3189,-2209
DEU,Germany,CMR,Cameroon,2016,1301,3109,-1808
DEU,Germany,CMR,Cameroon,2017,1095,2583,-1488
HUN,Hungary,CMR,Cameroon,2008,7,51,-44
HUN,Hungary,CMR,Cameroon,2009,8,60,-52
HUN,Hungary,CMR,Cameroon,2010,11,33,-22
HUN,Hungary,CMR,Cameroon,2011,2,33,-31
HUN,Hungary,CMR,Cameroon,2012,9,60,-51
HUN,Hungary,CMR,Cameroon,2013,21,58,-37
HUN,Hungary,CMR,Cameroon,2014,20,51,-31
HUN,Hungary,CMR,Cameroon,2015,25,63,-38
HUN,Hungary,CMR,Cameroon,2016,22,95,-73
HUN,Hungary,CMR,Cameroon,2017,0,80,-80
ISL,Iceland,CMR,Cameroon,2008,2,2,0
ISL,Iceland,CMR,Cameroon,2009,1,2,-1
ISL,Iceland,CMR,Cameroon,2010,1,3,-2
ISL,Iceland,CMR,Cameroon,2011,0,1,-1
ISL,Iceland,CMR,Cameroon,2012,1,3,-2
ISL,Iceland,CMR,Cameroon,2013,3,2,1
ISL,Iceland,CMR,Cameroon,2014,1,1,0
ISL,Iceland,CMR,Cameroon,2015,2,3,-1
ISL,Iceland,CMR,Cameroon,2016,1,4,-3
ISL,Iceland,CMR,Cameroon,2017,3,1,2
ITA,Italy,CMR,Cameroon,2008,24,964,-940
ITA,Italy,CMR,Cameroon,2009,32,1141,-1109
ITA,Italy,CMR,Cameroon,2010,48,1226,-1178
ITA,Italy,CMR,Cameroon,2011,62,983,-921
ITA,Italy,CMR,Cameroon,2012,58,1262,-1204
ITA,Italy,CMR,Cameroon,2013,76,1117,-1041
ITA,Italy,CMR,Cameroon,2014,68,816,-748
ITA,Italy,CMR,Cameroon,2015,68,821,-753
ITA,Italy,CMR,Cameroon,2016,0,1242,-1242
ITA,Italy,CMR,Cameroon,2017,88,2006,-1918
JPN,Japan,CMR,Cameroon,2008,106,136,-30
JPN,Japan,CMR,Cameroon,2009,92,119,-27
JPN,Japan,CMR,Cameroon,2010,125,145,-20
JPN,Japan,CMR,Cameroon,2011,84,84,0
JPN,Japan,CMR,Cameroon,2012,125,146,-21
JPN,Japan,CMR,Cameroon,2013,103,144,-41
JPN,Japan,CMR,Cameroon,2014,106,126,-20
JPN,Japan,CMR,Cameroon,2015,121,131,-10
JPN,Japan,CMR,Cameroon,2016,104,138,-34
JPN,Japan,CMR,Cameroon,2017,140,209,-69
KOR,Korea,CMR,Cameroon,2008,20,49,-29
KOR,Korea,CMR,Cameroon,2009,28,72,-44
KOR,Korea,CMR,Cameroon,2010,40,75,-35
KOR,Korea,CMR,Cameroon,2011,54,88,-34
KOR,Korea,CMR,Cameroon,2012,70,213,-143
KOR,Korea,CMR,Cameroon,2013,74,199,-125
KOR,Korea,CMR,Cameroon,2014,86,166,-80
KOR,Korea,CMR,Cameroon,2015,102,157,-55
KOR,Korea,CMR,Cameroon,2016,139,252,-113
KOR,Korea,CMR,Cameroon,2017,147,240,-93
LUX,Luxembourg,CMR,Cameroon,2008,8,37,-29
LUX,Luxembourg,CMR,Cameroon,2009,12,63,-51
LUX,Luxembourg,CMR,Cameroon,2010,16,56,-40
LUX,Luxembourg,CMR,Cameroon,2011,9,63,-54
LUX,Luxembourg,CMR,Cameroon,2012,23,46,-23
LUX,Luxembourg,CMR,Cameroon,2013,25,37,-12
LUX,Luxembourg,CMR,Cameroon,2014,15,59,-44
LUX,Luxembourg,CMR,Cameroon,2015,24,77,-53
LUX,Luxembourg,CMR,Cameroon,2016,14,70,-56
LUX,Luxembourg,CMR,Cameroon,2017,23,114,-91
MEX,Mexico,CMR,Cameroon,2008,0,12,-12
MEX,Mexico,CMR,Cameroon,2009,0,19,-19
MEX,Mexico,CMR,Cameroon,2010,0,31,-31
MEX,Mexico,CMR,Cameroon,2011,0,14,-14
MEX,Mexico,CMR,Cameroon,2012,0,6,-6
MEX,Mexico,CMR,Cameroon,2013,0,29,-29
MEX,Mexico,CMR,Cameroon,2014,0,23,-23
MEX,Mexico,CMR,Cameroon,2015,0,12,-12
MEX,Mexico,CMR,Cameroon,2016,0,15,-15
MEX,Mexico,CMR,Cameroon,2017,0,14,-14
NLD,Netherlands,CMR,Cameroon,2008,79,109,-30
NLD,Netherlands,CMR,Cameroon,2009,64,160,-96
NLD,Netherlands,CMR,Cameroon,2010,82,134,-52
NLD,Netherlands,CMR,Cameroon,2011,104,118,-14
NLD,Netherlands,CMR,Cameroon,2012,73,99,-26
NLD,Netherlands,CMR,Cameroon,2013,80,76,4
NLD,Netherlands,CMR,Cameroon,2014,61,76,-15
NLD,Netherlands,CMR,Cameroon,2015,45,68,-23
NLD,Netherlands,CMR,Cameroon,2016,46,68,-22
NLD,Netherlands,CMR,Cameroon,2017,29,95,-66
NZL,New Zealand,CMR,Cameroon,2008,0,3,-3
NZL,New Zealand,CMR,Cameroon,2009,0,0,0
NZL,New Zealand,CMR,Cameroon,2010,1,0,1
NZL,New Zealand,CMR,Cameroon,2011,2,1,1
NZL,New Zealand,CMR,Cameroon,2012,0,1,-1
NZL,New Zealand,CMR,Cameroon,2014,0,4,-4
NZL,New Zealand,CMR,Cameroon,2015,0,7,-7
NZL,New Zealand,CMR,Cameroon,2016,2,9,-7
NZL,New Zealand,CMR,Cameroon,2017,1,3,-2
NOR,Norway,CMR,Cameroon,2008,15,44,-29
NOR,Norway,CMR,Cameroon,2009,30,60,-30
NOR,Norway,CMR,Cameroon,2010,18,64,-46
NOR,Norway,CMR,Cameroon,2011,36,53,-17
NOR,Norway,CMR,Cameroon,2012,29,46,-17
NOR,Norway,CMR,Cameroon,2013,32,40,-8
NOR,Norway,CMR,Cameroon,2014,28,53,-25
NOR,Norway,CMR,Cameroon,2015,20,56,-36
NOR,Norway,CMR,Cameroon,2016,20,37,-17
NOR,Norway,CMR,Cameroon,2017,21,56,-35
POL,Poland,CMR,Cameroon,2008,0,97,-97
POL,Poland,CMR,Cameroon,2009,0,130,-130
POL,Poland,CMR,Cameroon,2010,0,120,-120
POL,Poland,CMR,Cameroon,2011,0,132,-132
POL,Poland,CMR,Cameroon,2012,0,130,-130
POL,Poland,CMR,Cameroon,2013,0,108,-108
POL,Poland,CMR,Cameroon,2014,0,60,-60
POL,Poland,CMR,Cameroon,2015,0,96,-96
POL,Poland,CMR,Cameroon,2016,0,81,-81
POL,Poland,CMR,Cameroon,2017,0,65,-65
SVK,Slovak Republic,CMR,Cameroon,2008,0,1,-1
SVK,Slovak Republic,CMR,Cameroon,2009,2,7,-5
SVK,Slovak Republic,CMR,Cameroon,2010,2,3,-1
SVK,Slovak Republic,CMR,Cameroon,2011,2,3,-1
ESP,Spain,CMR,Cameroon,2008,262,807,-545
ESP,Spain,CMR,Cameroon,2009,437,595,-158
ESP,Spain,CMR,Cameroon,2010,512,520,-8
ESP,Spain,CMR,Cameroon,2011,697,511,186
ESP,Spain,CMR,Cameroon,2012,683,480,203
ESP,Spain,CMR,Cameroon,2013,770,470,300
ESP,Spain,CMR,Cameroon,2014,444,467,-23
ESP,Spain,CMR,Cameroon,2015,352,443,-91
ESP,Spain,CMR,Cameroon,2016,336,480,-144
ESP,Spain,CMR,Cameroon,2017,415,620,-205
SWE,Sweden,CMR,Cameroon,2008,84,282,-198
SWE,Sweden,CMR,Cameroon,2009,49,263,-214
SWE,Sweden,CMR,Cameroon,2010,64,117,-53
SWE,Sweden,CMR,Cameroon,2011,106,92,14
SWE,Sweden,CMR,Cameroon,2012,116,91,25
SWE,Sweden,CMR,Cameroon,2013,70,105,-35
SWE,Sweden,CMR,Cameroon,2014,69,115,-46
SWE,Sweden,CMR,Cameroon,2015,128,111,17
SWE,Sweden,CMR,Cameroon,2016,31,107,-76
SWE,Sweden,CMR,Cameroon,2017,17,127,-110
CHE,Switzerland,CMR,Cameroon,2010,103,396,-293
CHE,Switzerland,CMR,Cameroon,2011,93,299,-206
CHE,Switzerland,CMR,Cameroon,2012,54,256,-202
CHE,Switzerland,CMR,Cameroon,2013,95,260,-165
CHE,Switzerland,CMR,Cameroon,2014,58,239,-181
CHE,Switzerland,CMR,Cameroon,2015,50,277,-227
CHE,Switzerland,CMR,Cameroon,2016,66,251,-185
CHE,Switzerland,CMR,Cameroon,2017,63,242,-179
TUR,Turkey,CMR,Cameroon,2010,0,17,-17
TUR,Turkey,CMR,Cameroon,2016,121,304,-183
TUR,Turkey,CMR,Cameroon,2017,183,280,-97
GBR,United Kingdom,CMR,Cameroon,2014,0,1000,-1000
USA,United States,CMR,Cameroon,2008,0,3771,-3771
USA,United States,CMR,Cameroon,2009,0,3463,-3463
USA,United States,CMR,Cameroon,2010,0,4161,-4161
USA,United States,CMR,Cameroon,2011,0,4754,-4754
USA,United States,CMR,Cameroon,2012,0,3815,-3815
USA,United States,CMR,Cameroon,2013,0,3908,-3908
USA,United States,CMR,Cameroon,2014,0,3943,-3943
USA,United States,CMR,Cameroon,2015,0,4374,-4374
USA,United States,CMR,Cameroon,2016,0,4899,-4899
USA,United States,CMR,Cameroon,2017,0,4668,-4668
CHL,Chile,CMR,Cameroon,2008,0,7,-7
CHL,Chile,CMR,Cameroon,2009,0,3,-3
CHL,Chile,CMR,Cameroon,2010,0,7,-7
CHL,Chile,CMR,Cameroon,2011,0,4,-4
CHL,Chile,CMR,Cameroon,2012,0,0,0
CHL,Chile,CMR,Cameroon,2013,0,4,-4
CHL,Chile,CMR,Cameroon,2014,0,4,-4
CHL,Chile,CMR,Cameroon,2015,0,2,-2
CHL,Chile,CMR,Cameroon,2016,0,6,-6
EST,Estonia,CMR,Cameroon,2008,0,0,0
EST,Estonia,CMR,Cameroon,2009,0,1,-1
EST,Estonia,CMR,Cameroon,2010,0,0,0
EST,Estonia,CMR,Cameroon,2011,0,1,-1
EST,Estonia,CMR,Cameroon,2012,0,2,-2
EST,Estonia,CMR,Cameroon,2013,0,1,-1
EST,Estonia,CMR,Cameroon,2014,0,2,-2
EST,Estonia,CMR,Cameroon,2015,0,12,-12
EST,Estonia,CMR,Cameroon,2016,0,15,-15
EST,Estonia,CMR,Cameroon,2017,0,29,-29
SVN,Slovenia,CMR,Cameroon,2008,0,4,-4
SVN,Slovenia,CMR,Cameroon,2009,0,5,-5
SVN,Slovenia,CMR,Cameroon,2010,0,3,-3
SVN,Slovenia,CMR,Cameroon,2011,1,6,-5
SVN,Slovenia,CMR,Cameroon,2012,0,1,-1
SVN,Slovenia,CMR,Cameroon,2013,0,3,-3
SVN,Slovenia,CMR,Cameroon,2014,0,1,-1
SVN,Slovenia,CMR,Cameroon,2015,1,1,0
SVN,Slovenia,CMR,Cameroon,2016,1,4,-3
SVN,Slovenia,CMR,Cameroon,2017,0,4,-4
AUS,Australia,CPV,Cape Verde,2008,0,0,0
AUS,Australia,CPV,Cape Verde,2009,0,0,0
AUS,Australia,CPV,Cape Verde,2010,0,0,0
AUS,Australia,CPV,Cape Verde,2011,0,1,-1
AUS,Australia,CPV,Cape Verde,2012,0,0,0
AUS,Australia,CPV,Cape Verde,2013,0,2,-2
AUS,Australia,CPV,Cape Verde,2014,0,0,0
AUS,Australia,CPV,Cape Verde,2015,0,0,0
AUS,Australia,CPV,Cape Verde,2016,0,0,0
AUS,Australia,CPV,Cape Verde,2017,0,0,0
AUT,Austria,CPV,Cape Verde,2008,3,0,3
AUT,Austria,CPV,Cape Verde,2009,0,4,-4
AUT,Austria,CPV,Cape Verde,2010,3,4,-1
AUT,Austria,CPV,Cape Verde,2011,2,0,2
AUT,Austria,CPV,Cape Verde,2012,0,0,0
AUT,Austria,CPV,Cape Verde,2013,4,4,0
AUT,Austria,CPV,Cape Verde,2014,2,5,-3
AUT,Austria,CPV,Cape Verde,2015,2,6,-4
AUT,Austria,CPV,Cape Verde,2016,7,5,2
AUT,Austria,CPV,Cape Verde,2017,2,9,-7
BEL,Belgium,CPV,Cape Verde,2008,0,21,-21
BEL,Belgium,CPV,Cape Verde,2009,0,24,-24
BEL,Belgium,CPV,Cape Verde,2010,3,20,-17
BEL,Belgium,CPV,Cape Verde,2011,0,28,-28
BEL,Belgium,CPV,Cape Verde,2012,6,25,-19
BEL,Belgium,CPV,Cape Verde,2013,19,21,-2
BEL,Belgium,CPV,Cape Verde,2014,8,31,-23
BEL,Belgium,CPV,Cape Verde,2015,3,30,-27
BEL,Belgium,CPV,Cape Verde,2016,9,30,-21
BEL,Belgium,CPV,Cape Verde,2017,7,33,-26
CAN,Canada,CPV,Cape Verde,2008,0,5,-5
CAN,Canada,CPV,Cape Verde,2009,0,1,-1
CAN,Canada,CPV,Cape Verde,2010,0,3,-3
CAN,Canada,CPV,Cape Verde,2011,0,3,-3
CAN,Canada,CPV,Cape Verde,2012,0,6,-6
CAN,Canada,CPV,Cape Verde,2013,0,2,-2
CAN,Canada,CPV,Cape Verde,2014,0,0,0
CAN,Canada,CPV,Cape Verde,2015,0,0,0
CAN,Canada,CPV,Cape Verde,2016,0,0,0
CAN,Canada,CPV,Cape Verde,2017,0,0,0
CZE,Czech Republic,CPV,Cape Verde,2008,0,1,-1
CZE,Czech Republic,CPV,Cape Verde,2009,0,1,-1
CZE,Czech Republic,CPV,Cape Verde,2010,0,2,-2
CZE,Czech Republic,CPV,Cape Verde,2013,2,2,0
CZE,Czech Republic,CPV,Cape Verde,2014,0,2,-2
CZE,Czech Republic,CPV,Cape Verde,2015,0,2,-2
CZE,Czech Republic,CPV,Cape Verde,2016,0,4,-4
DNK,Denmark,CPV,Cape Verde,2008,0,2,-2
DNK,Denmark,CPV,Cape Verde,2009,0,2,-2
DNK,Denmark,CPV,Cape Verde,2010,0,1,-1
DNK,Denmark,CPV,Cape Verde,2011,0,1,-1
DNK,Denmark,CPV,Cape Verde,2012,0,1,-1
DNK,Denmark,CPV,Cape Verde,2013,0,1,-1
DNK,Denmark,CPV,Cape Verde,2014,0,1,-1
DNK,Denmark,CPV,Cape Verde,2015,0,0,0
DNK,Denmark,CPV,Cape Verde,2016,0,1,-1
DNK,Denmark,CPV,Cape Verde,2017,1,1,0
FIN,Finland,CPV,Cape Verde,2008,0,0,0
FIN,Finland,CPV,Cape Verde,2009,0,0,0
FIN,Finland,CPV,Cape Verde,2010,0,1,-1
FIN,Finland,CPV,Cape Verde,2011,0,1,-1
FIN,Finland,CPV,Cape Verde,2012,0,2,-2
FIN,Finland,CPV,Cape Verde,2013,2,1,1
FIN,Finland,CPV,Cape Verde,2014,1,2,-1
FIN,Finland,CPV,Cape Verde,2015,0,1,-1
FIN,Finland,CPV,Cape Verde,2016,0,0,0
FIN,Finland,CPV,Cape Verde,2017,0,0,0
FRA,France,CPV,Cape Verde,2008,0,620,-620
FRA,France,CPV,Cape Verde,2009,0,702,-702
FRA,France,CPV,Cape Verde,2010,0,729,-729
FRA,France,CPV,Cape Verde,2011,0,660,-660
FRA,France,CPV,Cape Verde,2012,0,776,-776
FRA,France,CPV,Cape Verde,2013,0,1077,-1077
FRA,France,CPV,Cape Verde,2014,0,998,-998
FRA,France,CPV,Cape Verde,2015,0,1056,-1056
FRA,France,CPV,Cape Verde,2016,0,990,-990
FRA,France,CPV,Cape Verde,2017,0,879,-879
DEU,Germany,CPV,Cape Verde,2008,29,24,5
DEU,Germany,CPV,Cape Verde,2009,42,29,13
DEU,Germany,CPV,Cape Verde,2010,23,26,-3
DEU,Germany,CPV,Cape Verde,2011,28,29,-1
DEU,Germany,CPV,Cape Verde,2012,26,30,-4
DEU,Germany,CPV,Cape Verde,2013,19,45,-26
DEU,Germany,CPV,Cape Verde,2014,11,28,-17
DEU,Germany,CPV,Cape Verde,2015,15,32,-17
DEU,Germany,CPV,Cape Verde,2016,15,25,-10
DEU,Germany,CPV,Cape Verde,2017,12,35,-23
HUN,Hungary,CPV,Cape Verde,2008,0,0,0
HUN,Hungary,CPV,Cape Verde,2009,0,1,-1
HUN,Hungary,CPV,Cape Verde,2010,0,0,0
HUN,Hungary,CPV,Cape Verde,2011,0,0,0
HUN,Hungary,CPV,Cape Verde,2012,0,1,-1
HUN,Hungary,CPV,Cape Verde,2013,0,0,0
HUN,Hungary,CPV,Cape Verde,2014,0,2,-2
HUN,Hungary,CPV,Cape Verde,2015,1,3,-2
HUN,Hungary,CPV,Cape Verde,2016,0,1,-1
HUN,Hungary,CPV,Cape Verde,2017,0,1,-1
ISL,Iceland,CPV,Cape Verde,2008,0,5,-5
ISL,Iceland,CPV,Cape Verde,2009,1,1,0
ISL,Iceland,CPV,Cape Verde,2010,3,0,3
ISL,Iceland,CPV,Cape Verde,2011,1,0,1
ISL,Iceland,CPV,Cape Verde,2012,3,1,2
ISL,Iceland,CPV,Cape Verde,2013,0,2,-2
ISL,Iceland,CPV,Cape Verde,2014,0,2,-2
ISL,Iceland,CPV,Cape Verde,2015,1,2,-1
ISL,Iceland,CPV,Cape Verde,2016,1,1,0
ISL,Iceland,CPV,Cape Verde,2017,2,2,0
ITA,Italy,CPV,Cape Verde,2008,4,179,-175
ITA,Italy,CPV,Cape Verde,2009,4,236,-232
ITA,Italy,CPV,Cape Verde,2010,8,224,-216
ITA,Italy,CPV,Cape Verde,2011,12,216,-204
ITA,Italy,CPV,Cape Verde,2012,14,221,-207
ITA,Italy,CPV,Cape Verde,2013,9,165,-156
ITA,Italy,CPV,Cape Verde,2014,11,117,-106
ITA,Italy,CPV,Cape Verde,2015,6,107,-101
ITA,Italy,CPV,Cape Verde,2016,0,112,-112
ITA,Italy,CPV,Cape Verde,2017,10,102,-92
JPN,Japan,CPV,Cape Verde,2008,14,15,-1
JPN,Japan,CPV,Cape Verde,2009,4,4,0
JPN,Japan,CPV,Cape Verde,2010,8,9,-1
JPN,Japan,CPV,Cape Verde,2011,7,7,0
JPN,Japan,CPV,Cape Verde,2012,16,16,0
JPN,Japan,CPV,Cape Verde,2013,15,16,-1
JPN,Japan,CPV,Cape Verde,2014,13,16,-3
JPN,Japan,CPV,Cape Verde,2015,16,16,0
JPN,Japan,CPV,Cape Verde,2016,9,11,-2
JPN,Japan,CPV,Cape Verde,2017,7,6,1
KOR,Korea,CPV,Cape Verde,2008,0,1,-1
KOR,Korea,CPV,Cape Verde,2009,0,0,0
KOR,Korea,CPV,Cape Verde,2010,0,0,0
KOR,Korea,CPV,Cape Verde,2011,0,0,0
KOR,Korea,CPV,Cape Verde,2012,0,1,-1
KOR,Korea,CPV,Cape Verde,2013,0,0,0
KOR,Korea,CPV,Cape Verde,2014,0,0,0
KOR,Korea,CPV,Cape Verde,2015,0,0,0
KOR,Korea,CPV,Cape Verde,2016,0,0,0
KOR,Korea,CPV,Cape Verde,2017,1,1,0
LUX,Luxembourg,CPV,Cape Verde,2008,52,189,-137
LUX,Luxembourg,CPV,Cape Verde,2009,33,196,-163
LUX,Luxembourg,CPV,Cape Verde,2010,32,158,-126
LUX,Luxembourg,CPV,Cape Verde,2011,23,167,-144
LUX,Luxembourg,CPV,Cape Verde,2012,36,161,-125
LUX,Luxembourg,CPV,Cape Verde,2013,32,185,-153
LUX,Luxembourg,CPV,Cape Verde,2014,22,168,-146
LUX,Luxembourg,CPV,Cape Verde,2015,38,156,-118
LUX,Luxembourg,CPV,Cape Verde,2016,35,156,-121
LUX,Luxembourg,CPV,Cape Verde,2017,45,147,-102
MEX,Mexico,CPV,Cape Verde,2012,0,0,0
MEX,Mexico,CPV,Cape Verde,2013,0,0,0
MEX,Mexico,CPV,Cape Verde,2014,0,0,0
MEX,Mexico,CPV,Cape Verde,2016,0,3,-3
NLD,Netherlands,CPV,Cape Verde,2008,51,167,-116
NLD,Netherlands,CPV,Cape Verde,2009,16,102,-86
NLD,Netherlands,CPV,Cape Verde,2010,17,75,-58
NLD,Netherlands,CPV,Cape Verde,2011,28,53,-25
NLD,Netherlands,CPV,Cape Verde,2012,25,63,-38
NLD,Netherlands,CPV,Cape Verde,2013,12,57,-45
NLD,Netherlands,CPV,Cape Verde,2014,28,72,-44
NLD,Netherlands,CPV,Cape Verde,2015,18,50,-32
NLD,Netherlands,CPV,Cape Verde,2016,20,52,-32
NLD,Netherlands,CPV,Cape Verde,2017,24,45,-21
NOR,Norway,CPV,Cape Verde,2008,0,3,-3
NOR,Norway,CPV,Cape Verde,2009,0,7,-7
NOR,Norway,CPV,Cape Verde,2010,1,5,-4
NOR,Norway,CPV,Cape Verde,2011,2,5,-3
NOR,Norway,CPV,Cape Verde,2012,2,7,-5
NOR,Norway,CPV,Cape Verde,2013,2,2,0
NOR,Norway,CPV,Cape Verde,2014,1,2,-1
NOR,Norway,CPV,Cape Verde,2015,2,6,-4
NOR,Norway,CPV,Cape Verde,2016,1,3,-2
NOR,Norway,CPV,Cape Verde,2017,1,2,-1
POL,Poland,CPV,Cape Verde,2009,0,10,-10
POL,Poland,CPV,Cape Verde,2010,0,1,-1
POL,Poland,CPV,Cape Verde,2011,0,0,0
POL,Poland,CPV,Cape Verde,2012,0,0,0
POL,Poland,CPV,Cape Verde,2013,0,0,0
POL,Poland,CPV,Cape Verde,2014,0,0,0
POL,Poland,CPV,Cape Verde,2015,0,0,0
POL,Poland,CPV,Cape Verde,2016,0,0,0
POL,Poland,CPV,Cape Verde,2017,0,0,0
PRT,Portugal,CPV,Cape Verde,2008,0,5260,-5260
PRT,Portugal,CPV,Cape Verde,2009,0,4575,-4575
PRT,Portugal,CPV,Cape Verde,2010,0,4223,-4223
PRT,Portugal,CPV,Cape Verde,2011,0,4610,-4610
PRT,Portugal,CPV,Cape Verde,2012,0,3431,-3431
PRT,Portugal,CPV,Cape Verde,2013,0,2738,-2738
PRT,Portugal,CPV,Cape Verde,2014,0,2185,-2185
PRT,Portugal,CPV,Cape Verde,2015,0,2025,-2025
PRT,Portugal,CPV,Cape Verde,2016,0,1991,-1991
PRT,Portugal,CPV,Cape Verde,2017,0,2060,-2060
SVK,Slovak Republic,CPV,Cape Verde,2008,0,0,0
SVK,Slovak Republic,CPV,Cape Verde,2011,0,1,-1
ESP,Spain,CPV,Cape Verde,2008,181,445,-264
ESP,Spain,CPV,Cape Verde,2009,155,320,-165
ESP,Spain,CPV,Cape Verde,2010,162,183,-21
ESP,Spain,CPV,Cape Verde,2011,159,203,-44
ESP,Spain,CPV,Cape Verde,2012,105,140,-35
ESP,Spain,CPV,Cape Verde,2013,125,149,-24
ESP,Spain,CPV,Cape Verde,2014,83,138,-55
ESP,Spain,CPV,Cape Verde,2015,103,157,-54
ESP,Spain,CPV,Cape Verde,2016,123,139,-16
ESP,Spain,CPV,Cape Verde,2017,139,136,3
SWE,Sweden,CPV,Cape Verde,2008,1,5,-4
SWE,Sweden,CPV,Cape Verde,2009,1,5,-4
SWE,Sweden,CPV,Cape Verde,2010,0,9,-9
SWE,Sweden,CPV,Cape Verde,2011,0,8,-8
SWE,Sweden,CPV,Cape Verde,2012,0,11,-11
SWE,Sweden,CPV,Cape Verde,2013,1,1,0
SWE,Sweden,CPV,Cape Verde,2014,1,7,-6
SWE,Sweden,CPV,Cape Verde,2015,2,10,-8
SWE,Sweden,CPV,Cape Verde,2016,1,4,-3
SWE,Sweden,CPV,Cape Verde,2017,0,10,-10
CHE,Switzerland,CPV,Cape Verde,2010,6,45,-39
CHE,Switzerland,CPV,Cape Verde,2011,10,60,-50
CHE,Switzerland,CPV,Cape Verde,2012,9,45,-36
CHE,Switzerland,CPV,Cape Verde,2013,9,45,-36
CHE,Switzerland,CPV,Cape Verde,2014,9,50,-41
CHE,Switzerland,CPV,Cape Verde,2015,9,38,-29
CHE,Switzerland,CPV,Cape Verde,2016,7,46,-39
CHE,Switzerland,CPV,Cape Verde,2017,3,49,-46
USA,United States,CPV,Cape Verde,2008,0,1916,-1916
USA,United States,CPV,Cape Verde,2009,0,2238,-2238
USA,United States,CPV,Cape Verde,2010,0,1668,-1668
USA,United States,CPV,Cape Verde,2011,0,1808,-1808
USA,United States,CPV,Cape Verde,2012,0,1684,-1684
USA,United States,CPV,Cape Verde,2013,0,1673,-1673
USA,United States,CPV,Cape Verde,2014,0,1154,-1154
USA,United States,CPV,Cape Verde,2015,0,1253,-1253
USA,United States,CPV,Cape Verde,2016,0,2242,-2242
USA,United States,CPV,Cape Verde,2017,0,2618,-2618
CHL,Chile,CPV,Cape Verde,2008,0,0,0
CHL,Chile,CPV,Cape Verde,2009,0,0,0
CHL,Chile,CPV,Cape Verde,2010,0,0,0
CHL,Chile,CPV,Cape Verde,2011,0,0,0
CHL,Chile,CPV,Cape Verde,2012,0,0,0
CHL,Chile,CPV,Cape Verde,2013,0,0,0
CHL,Chile,CPV,Cape Verde,2014,0,0,0
CHL,Chile,CPV,Cape Verde,2015,0,0,0
CHL,Chile,CPV,Cape Verde,2016,0,0,0
EST,Estonia,CPV,Cape Verde,2008,0,0,0
EST,Estonia,CPV,Cape Verde,2009,0,0,0
EST,Estonia,CPV,Cape Verde,2010,0,0,0
EST,Estonia,CPV,Cape Verde,2011,0,0,0
EST,Estonia,CPV,Cape Verde,2012,0,1,-1
EST,Estonia,CPV,Cape Verde,2013,0,0,0
EST,Estonia,CPV,Cape Verde,2014,0,0,0
EST,Estonia,CPV,Cape Verde,2015,0,0,0
EST,Estonia,CPV,Cape Verde,2016,0,1,-1
EST,Estonia,CPV,Cape Verde,2017,0,0,0
SVN,Slovenia,CPV,Cape Verde,2008,0,1,-1
SVN,Slovenia,CPV,Cape Verde,2010,0,1,-1
SVN,Slovenia,CPV,Cape Verde,2011,0,2,-2
SVN,Slovenia,CPV,Cape Verde,2013,0,3,-3
AUS,Australia,CAF,Central African Republic,2008,0,13,-13
AUS,Australia,CAF,Central African Republic,2009,0,0,0
AUS,Australia,CAF,Central African Republic,2010,0,1,-1
AUS,Australia,CAF,Central African Republic,2011,0,2,-2
AUS,Australia,CAF,Central African Republic,2012,0,1,-1
AUS,Australia,CAF,Central African Republic,2013,0,0,0
AUS,Australia,CAF,Central African Republic,2014,0,0,0
AUS,Australia,CAF,Central African Republic,2015,0,0,0
AUS,Australia,CAF,Central African Republic,2016,0,0,0
AUS,Australia,CAF,Central African Republic,2017,0,0,0
AUT,Austria,CAF,Central African Republic,2008,1,0,1
AUT,Austria,CAF,Central African Republic,2009,1,1,0
AUT,Austria,CAF,Central African Republic,2010,1,1,0
AUT,Austria,CAF,Central African Republic,2011,1,0,1
AUT,Austria,CAF,Central African Republic,2012,0,0,0
AUT,Austria,CAF,Central African Republic,2013,1,1,0
AUT,Austria,CAF,Central African Republic,2014,0,0,0
AUT,Austria,CAF,Central African Republic,2015,0,2,-2
AUT,Austria,CAF,Central African Republic,2016,2,3,-1
AUT,Austria,CAF,Central African Republic,2017,2,2,0
BEL,Belgium,CAF,Central African Republic,2008,0,7,-7
BEL,Belgium,CAF,Central African Republic,2009,0,17,-17
BEL,Belgium,CAF,Central African Republic,2010,7,15,-8
BEL,Belgium,CAF,Central African Republic,2011,0,23,-23
BEL,Belgium,CAF,Central African Republic,2012,6,19,-13
BEL,Belgium,CAF,Central African Republic,2013,5,14,-9
BEL,Belgium,CAF,Central African Republic,2014,6,56,-50
BEL,Belgium,CAF,Central African Republic,2015,9,35,-26
BEL,Belgium,CAF,Central African Republic,2016,5,37,-32
BEL,Belgium,CAF,Central African Republic,2017,6,22,-16
CAN,Canada,CAF,Central African Republic,2008,0,28,-28
CAN,Canada,CAF,Central African Republic,2009,0,19,-19
CAN,Canada,CAF,Central African Republic,2010,0,25,-25
CAN,Canada,CAF,Central African Republic,2011,0,18,-18
CAN,Canada,CAF,Central African Republic,2012,0,44,-44
CAN,Canada,CAF,Central African Republic,2013,0,169,-169
CAN,Canada,CAF,Central African Republic,2014,0,129,-129
CAN,Canada,CAF,Central African Republic,2015,0,456,-456
CAN,Canada,CAF,Central African Republic,2016,0,100,-100
CAN,Canada,CAF,Central African Republic,2017,0,225,-225
DNK,Denmark,CAF,Central African Republic,2008,0,0,0
DNK,Denmark,CAF,Central African Republic,2009,1,4,-3
DNK,Denmark,CAF,Central African Republic,2012,0,0,0
DNK,Denmark,CAF,Central African Republic,2013,0,0,0
DNK,Denmark,CAF,Central African Republic,2014,0,12,-12
DNK,Denmark,CAF,Central African Republic,2015,0,0,0
DNK,Denmark,CAF,Central African Republic,2016,0,9,-9
DNK,Denmark,CAF,Central African Republic,2017,0,0,0
FIN,Finland,CAF,Central African Republic,2008,0,0,0
FIN,Finland,CAF,Central African Republic,2009,0,1,-1
FIN,Finland,CAF,Central African Republic,2010,0,0,0
FIN,Finland,CAF,Central African Republic,2011,0,0,0
FIN,Finland,CAF,Central African Republic,2012,0,0,0
FIN,Finland,CAF,Central African Republic,2013,0,0,0
FIN,Finland,CAF,Central African Republic,2014,0,1,-1
FIN,Finland,CAF,Central African Republic,2015,0,1,-1
FIN,Finland,CAF,Central African Republic,2016,0,2,-2
FIN,Finland,CAF,Central African Republic,2017,0,1,-1
FRA,France,CAF,Central African Republic,2008,0,577,-577
FRA,France,CAF,Central African Republic,2009,0,557,-557
FRA,France,CAF,Central African Republic,2010,0,503,-503
FRA,France,CAF,Central African Republic,2011,0,426,-426
FRA,France,CAF,Central African Republic,2012,0,425,-425
FRA,France,CAF,Central African Republic,2013,0,474,-474
FRA,France,CAF,Central African Republic,2014,0,722,-722
FRA,France,CAF,Central African Republic,2015,0,597,-597
FRA,France,CAF,Central African Republic,2016,0,1004,-1004
FRA,France,CAF,Central African Republic,2017,0,934,-934
DEU,Germany,CAF,Central African Republic,2008,21,16,5
DEU,Germany,CAF,Central African Republic,2009,43,18,25
DEU,Germany,CAF,Central African Republic,2010,16,17,-1
DEU,Germany,CAF,Central African Republic,2011,6,13,-7
DEU,Germany,CAF,Central African Republic,2012,8,12,-4
DEU,Germany,CAF,Central African Republic,2013,13,27,-14
DEU,Germany,CAF,Central African Republic,2014,9,70,-61
DEU,Germany,CAF,Central African Republic,2015,20,81,-61
DEU,Germany,CAF,Central African Republic,2016,26,61,-35
DEU,Germany,CAF,Central African Republic,2017,32,47,-15
HUN,Hungary,CAF,Central African Republic,2008,0,0,0
HUN,Hungary,CAF,Central African Republic,2009,0,1,-1
HUN,Hungary,CAF,Central African Republic,2010,0,0,0
HUN,Hungary,CAF,Central African Republic,2011,0,1,-1
HUN,Hungary,CAF,Central African Republic,2012,0,0,0
HUN,Hungary,CAF,Central African Republic,2013,0,0,0
HUN,Hungary,CAF,Central African Republic,2014,0,1,-1
HUN,Hungary,CAF,Central African Republic,2015,0,0,0
HUN,Hungary,CAF,Central African Republic,2016,0,8,-8
HUN,Hungary,CAF,Central African Republic,2017,0,4,-4
ISL,Iceland,CAF,Central African Republic,2016,0,0,0
ISL,Iceland,CAF,Central African Republic,2017,0,0,0
ITA,Italy,CAF,Central African Republic,2008,1,9,-8
ITA,Italy,CAF,Central African Republic,2009,1,8,-7
ITA,Italy,CAF,Central African Republic,2010,4,12,-8
ITA,Italy,CAF,Central African Republic,2011,3,15,-12
ITA,Italy,CAF,Central African Republic,2012,1,15,-14
ITA,Italy,CAF,Central African Republic,2013,6,115,-109
ITA,Italy,CAF,Central African Republic,2014,1,13,-12
ITA,Italy,CAF,Central African Republic,2015,1,39,-38
ITA,Italy,CAF,Central African Republic,2016,0,21,-21
ITA,Italy,CAF,Central African Republic,2017,3,42,-39
JPN,Japan,CAF,Central African Republic,2008,46,46,0
JPN,Japan,CAF,Central African Republic,2009,13,15,-2
JPN,Japan,CAF,Central African Republic,2010,9,10,-1
JPN,Japan,CAF,Central African Republic,2011,5,4,1
JPN,Japan,CAF,Central African Republic,2012,15,15,0
JPN,Japan,CAF,Central African Republic,2013,2,2,0
JPN,Japan,CAF,Central African Republic,2014,1,4,-3
JPN,Japan,CAF,Central African Republic,2015,3,4,-1
JPN,Japan,CAF,Central African Republic,2016,2,2,0
JPN,Japan,CAF,Central African Republic,2017,3,5,-2
KOR,Korea,CAF,Central African Republic,2008,1,0,1
KOR,Korea,CAF,Central African Republic,2009,0,0,0
KOR,Korea,CAF,Central African Republic,2010,1,0,1
KOR,Korea,CAF,Central African Republic,2011,1,3,-2
KOR,Korea,CAF,Central African Republic,2012,5,8,-3
KOR,Korea,CAF,Central African Republic,2013,1,1,0
KOR,Korea,CAF,Central African Republic,2014,0,1,-1
KOR,Korea,CAF,Central African Republic,2015,1,3,-2
KOR,Korea,CAF,Central African Republic,2016,3,1,2
KOR,Korea,CAF,Central African Republic,2017,0,3,-3
LUX,Luxembourg,CAF,Central African Republic,2008,0,1,-1
LUX,Luxembourg,CAF,Central African Republic,2009,1,1,0
LUX,Luxembourg,CAF,Central African Republic,2010,0,0,0
LUX,Luxembourg,CAF,Central African Republic,2011,0,0,0
LUX,Luxembourg,CAF,Central African Republic,2012,1,0,1
LUX,Luxembourg,CAF,Central African Republic,2013,0,0,0
LUX,Luxembourg,CAF,Central African Republic,2014,0,1,-1
LUX,Luxembourg,CAF,Central African Republic,2015,0,4,-4
LUX,Luxembourg,CAF,Central African Republic,2016,1,3,-2
LUX,Luxembourg,CAF,Central African Republic,2017,0,0,0
MEX,Mexico,CAF,Central African Republic,2012,0,0,0
MEX,Mexico,CAF,Central African Republic,2013,0,0,0
MEX,Mexico,CAF,Central African Republic,2014,0,0,0
MEX,Mexico,CAF,Central African Republic,2015,0,1,-1
NLD,Netherlands,CAF,Central African Republic,2009,0,1,-1
NLD,Netherlands,CAF,Central African Republic,2010,0,1,-1
NLD,Netherlands,CAF,Central African Republic,2013,0,1,-1
NLD,Netherlands,CAF,Central African Republic,2014,0,3,-3
NLD,Netherlands,CAF,Central African Republic,2015,0,3,-3
NLD,Netherlands,CAF,Central African Republic,2016,2,4,-2
NLD,Netherlands,CAF,Central African Republic,2017,0,7,-7
NOR,Norway,CAF,Central African Republic,2008,0,3,-3
NOR,Norway,CAF,Central African Republic,2009,0,0,0
NOR,Norway,CAF,Central African Republic,2010,0,0,0
NOR,Norway,CAF,Central African Republic,2011,1,0,1
NOR,Norway,CAF,Central African Republic,2012,0,5,-5
NOR,Norway,CAF,Central African Republic,2013,0,1,-1
NOR,Norway,CAF,Central African Republic,2014,0,5,-5
NOR,Norway,CAF,Central African Republic,2015,1,1,0
NOR,Norway,CAF,Central African Republic,2016,0,1,-1
NOR,Norway,CAF,Central African Republic,2017,1,10,-9
POL,Poland,CAF,Central African Republic,2009,0,0,0
POL,Poland,CAF,Central African Republic,2010,0,1,-1
POL,Poland,CAF,Central African Republic,2011,0,1,-1
POL,Poland,CAF,Central African Republic,2012,0,0,0
POL,Poland,CAF,Central African Republic,2013,0,1,-1
POL,Poland,CAF,Central African Republic,2014,0,1,-1
POL,Poland,CAF,Central African Republic,2015,0,0,0
POL,Poland,CAF,Central African Republic,2016,0,2,-2
POL,Poland,CAF,Central African Republic,2017,0,0,0
SVK,Slovak Republic,CAF,Central African Republic,2008,0,0,0
SVK,Slovak Republic,CAF,Central African Republic,2009,0,2,-2
ESP,Spain,CAF,Central African Republic,2008,3,7,-4
ESP,Spain,CAF,Central African Republic,2009,4,17,-13
ESP,Spain,CAF,Central African Republic,2010,10,7,3
ESP,Spain,CAF,Central African Republic,2011,10,7,3
ESP,Spain,CAF,Central African Republic,2012,5,17,-12
ESP,Spain,CAF,Central African Republic,2013,4,20,-16
ESP,Spain,CAF,Central African Republic,2014,3,20,-17
ESP,Spain,CAF,Central African Republic,2015,4,25,-21
ESP,Spain,CAF,Central African Republic,2016,5,58,-53
ESP,Spain,CAF,Central African Republic,2017,10,36,-26
SWE,Sweden,CAF,Central African Republic,2008,0,9,-9
SWE,Sweden,CAF,Central African Republic,2009,0,4,-4
SWE,Sweden,CAF,Central African Republic,2010,0,1,-1
SWE,Sweden,CAF,Central African Republic,2011,2,11,-9
SWE,Sweden,CAF,Central African Republic,2012,0,2,-2
SWE,Sweden,CAF,Central African Republic,2013,0,14,-14
SWE,Sweden,CAF,Central African Republic,2014,1,10,-9
SWE,Sweden,CAF,Central African Republic,2015,0,1,-1
SWE,Sweden,CAF,Central African Republic,2016,0,0,0
SWE,Sweden,CAF,Central African Republic,2017,0,8,-8
CHE,Switzerland,CAF,Central African Republic,2010,1,2,-1
CHE,Switzerland,CAF,Central African Republic,2011,4,4,0
CHE,Switzerland,CAF,Central African Republic,2012,1,1,0
CHE,Switzerland,CAF,Central African Republic,2013,4,4,0
CHE,Switzerland,CAF,Central African Republic,2014,1,3,-2
CHE,Switzerland,CAF,Central African Republic,2015,1,3,-2
CHE,Switzerland,CAF,Central African Republic,2016,0,5,-5
CHE,Switzerland,CAF,Central African Republic,2017,2,4,-2
TUR,Turkey,CAF,Central African Republic,2010,0,4,-4
USA,United States,CAF,Central African Republic,2008,0,88,-88
USA,United States,CAF,Central African Republic,2009,0,107,-107
USA,United States,CAF,Central African Republic,2010,0,101,-101
USA,United States,CAF,Central African Republic,2011,0,134,-134
USA,United States,CAF,Central African Republic,2012,0,116,-116
USA,United States,CAF,Central African Republic,2013,0,213,-213
USA,United States,CAF,Central African Republic,2014,0,155,-155
USA,United States,CAF,Central African Republic,2015,0,234,-234
USA,United States,CAF,Central African Republic,2016,0,202,-202
USA,United States,CAF,Central African Republic,2017,0,178,-178
CHL,Chile,CAF,Central African Republic,2008,0,0,0
CHL,Chile,CAF,Central African Republic,2009,0,0,0
CHL,Chile,CAF,Central African Republic,2010,0,0,0
CHL,Chile,CAF,Central African Republic,2011,0,0,0
CHL,Chile,CAF,Central African Republic,2012,0,0,0
CHL,Chile,CAF,Central African Republic,2013,0,1,-1
CHL,Chile,CAF,Central African Republic,2014,0,0,0
CHL,Chile,CAF,Central African Republic,2015,0,1,-1
CHL,Chile,CAF,Central African Republic,2016,0,0,0
EST,Estonia,CAF,Central African Republic,2008,0,0,0
EST,Estonia,CAF,Central African Republic,2009,0,0,0
EST,Estonia,CAF,Central African Republic,2010,0,0,0
EST,Estonia,CAF,Central African Republic,2011,0,0,0
EST,Estonia,CAF,Central African Republic,2012,0,0,0
EST,Estonia,CAF,Central African Republic,2013,0,0,0
EST,Estonia,CAF,Central African Republic,2014,0,0,0
EST,Estonia,CAF,Central African Republic,2015,0,0,0
EST,Estonia,CAF,Central African Republic,2016,0,0,0
EST,Estonia,CAF,Central African Republic,2017,0,0,0
AUS,Australia,TCD,Chad,2008,0,4,-4
AUS,Australia,TCD,Chad,2009,0,0,0
AUS,Australia,TCD,Chad,2010,0,5,-5
AUS,Australia,TCD,Chad,2011,0,6,-6
AUS,Australia,TCD,Chad,2012,0,7,-7
AUS,Australia,TCD,Chad,2013,0,0,0
AUS,Australia,TCD,Chad,2014,0,0,0
AUS,Australia,TCD,Chad,2015,0,0,0
AUS,Australia,TCD,Chad,2016,0,0,0
AUS,Australia,TCD,Chad,2017,0,0,0
AUT,Austria,TCD,Chad,2008,1,1,0
AUT,Austria,TCD,Chad,2009,1,3,-2
AUT,Austria,TCD,Chad,2010,2,1,1
AUT,Austria,TCD,Chad,2011,0,5,-5
AUT,Austria,TCD,Chad,2012,2,4,-2
AUT,Austria,TCD,Chad,2013,2,4,-2
AUT,Austria,TCD,Chad,2014,3,3,0
AUT,Austria,TCD,Chad,2015,2,6,-4
AUT,Austria,TCD,Chad,2016,5,4,1
AUT,Austria,TCD,Chad,2017,2,3,-1
BEL,Belgium,TCD,Chad,2008,0,19,-19
BEL,Belgium,TCD,Chad,2009,0,11,-11
BEL,Belgium,TCD,Chad,2010,1,26,-25
BEL,Belgium,TCD,Chad,2011,0,19,-19
BEL,Belgium,TCD,Chad,2012,13,39,-26
BEL,Belgium,TCD,Chad,2013,24,42,-18
BEL,Belgium,TCD,Chad,2014,21,31,-10
BEL,Belgium,TCD,Chad,2015,16,37,-21
BEL,Belgium,TCD,Chad,2016,16,19,-3
BEL,Belgium,TCD,Chad,2017,9,30,-21
CAN,Canada,TCD,Chad,2008,0,95,-95
CAN,Canada,TCD,Chad,2009,0,87,-87
CAN,Canada,TCD,Chad,2010,0,98,-98
CAN,Canada,TCD,Chad,2011,0,79,-79
CAN,Canada,TCD,Chad,2012,0,97,-97
CAN,Canada,TCD,Chad,2013,0,86,-86
CAN,Canada,TCD,Chad,2014,0,82,-82
CAN,Canada,TCD,Chad,2015,0,87,-87
CAN,Canada,TCD,Chad,2016,0,100,-100
CAN,Canada,TCD,Chad,2017,0,120,-120
CZE,Czech Republic,TCD,Chad,2011,0,3,-3
CZE,Czech Republic,TCD,Chad,2013,0,1,-1
DNK,Denmark,TCD,Chad,2008,1,2,-1
DNK,Denmark,TCD,Chad,2009,0,0,0
DNK,Denmark,TCD,Chad,2012,0,1,-1
DNK,Denmark,TCD,Chad,2013,0,0,0
DNK,Denmark,TCD,Chad,2014,1,1,0
DNK,Denmark,TCD,Chad,2015,0,0,0
DNK,Denmark,TCD,Chad,2016,1,0,1
DNK,Denmark,TCD,Chad,2017,0,0,0
FIN,Finland,TCD,Chad,2008,0,0,0
FIN,Finland,TCD,Chad,2009,0,0,0
FIN,Finland,TCD,Chad,2010,0,0,0
FIN,Finland,TCD,Chad,2011,0,0,0
FIN,Finland,TCD,Chad,2012,0,1,-1
FIN,Finland,TCD,Chad,2013,0,0,0
FIN,Finland,TCD,Chad,2014,0,0,0
FIN,Finland,TCD,Chad,2015,0,1,-1
FIN,Finland,TCD,Chad,2016,0,0,0
FIN,Finland,TCD,Chad,2017,0,0,0
FRA,France,TCD,Chad,2008,0,212,-212
FRA,France,TCD,Chad,2009,0,233,-233
FRA,France,TCD,Chad,2010,0,203,-203
FRA,France,TCD,Chad,2011,0,180,-180
FRA,France,TCD,Chad,2012,0,210,-210
FRA,France,TCD,Chad,2013,0,194,-194
FRA,France,TCD,Chad,2014,0,245,-245
FRA,France,TCD,Chad,2015,0,187,-187
FRA,France,TCD,Chad,2016,0,274,-274
FRA,France,TCD,Chad,2017,0,308,-308
DEU,Germany,TCD,Chad,2008,28,21,7
DEU,Germany,TCD,Chad,2009,15,27,-12
DEU,Germany,TCD,Chad,2010,19,36,-17
DEU,Germany,TCD,Chad,2011,14,26,-12
DEU,Germany,TCD,Chad,2012,28,82,-54
DEU,Germany,TCD,Chad,2013,34,265,-231
DEU,Germany,TCD,Chad,2014,76,178,-102
DEU,Germany,TCD,Chad,2015,67,159,-92
DEU,Germany,TCD,Chad,2016,119,180,-61
DEU,Germany,TCD,Chad,2017,149,152,-3
HUN,Hungary,TCD,Chad,2008,0,0,0
HUN,Hungary,TCD,Chad,2009,0,0,0
HUN,Hungary,TCD,Chad,2010,0,0,0
HUN,Hungary,TCD,Chad,2011,0,0,0
HUN,Hungary,TCD,Chad,2012,0,0,0
HUN,Hungary,TCD,Chad,2013,0,0,0
HUN,Hungary,TCD,Chad,2014,0,0,0
HUN,Hungary,TCD,Chad,2015,0,0,0
HUN,Hungary,TCD,Chad,2016,0,2,-2
HUN,Hungary,TCD,Chad,2017,0,0,0
ISL,Iceland,TCD,Chad,2016,0,0,0
ISL,Iceland,TCD,Chad,2017,0,2,-2
ITA,Italy,TCD,Chad,2008,0,23,-23
ITA,Italy,TCD,Chad,2009,0,36,-36
ITA,Italy,TCD,Chad,2010,0,13,-13
ITA,Italy,TCD,Chad,2011,0,40,-40
ITA,Italy,TCD,Chad,2012,0,266,-266
ITA,Italy,TCD,Chad,2013,11,124,-113
ITA,Italy,TCD,Chad,2014,0,20,-20
ITA,Italy,TCD,Chad,2015,3,31,-28
ITA,Italy,TCD,Chad,2016,0,57,-57
ITA,Italy,TCD,Chad,2017,1,73,-72
JPN,Japan,TCD,Chad,2008,4,4,0
JPN,Japan,TCD,Chad,2009,6,7,-1
JPN,Japan,TCD,Chad,2010,11,11,0
JPN,Japan,TCD,Chad,2011,17,19,-2
JPN,Japan,TCD,Chad,2012,28,28,0
JPN,Japan,TCD,Chad,2013,66,64,2
JPN,Japan,TCD,Chad,2014,28,28,0
JPN,Japan,TCD,Chad,2015,23,23,0
JPN,Japan,TCD,Chad,2016,63,65,-2
JPN,Japan,TCD,Chad,2017,19,22,-3
KOR,Korea,TCD,Chad,2008,1,1,0
KOR,Korea,TCD,Chad,2009,0,1,-1
KOR,Korea,TCD,Chad,2010,1,4,-3
KOR,Korea,TCD,Chad,2011,0,3,-3
KOR,Korea,TCD,Chad,2012,5,2,3
KOR,Korea,TCD,Chad,2013,1,2,-1
KOR,Korea,TCD,Chad,2014,3,1,2
KOR,Korea,TCD,Chad,2015,2,1,1
KOR,Korea,TCD,Chad,2016,0,1,-1
KOR,Korea,TCD,Chad,2017,0,4,-4
LUX,Luxembourg,TCD,Chad,2008,0,0,0
LUX,Luxembourg,TCD,Chad,2009,0,0,0
LUX,Luxembourg,TCD,Chad,2010,0,0,0
LUX,Luxembourg,TCD,Chad,2011,0,0,0
LUX,Luxembourg,TCD,Chad,2012,0,0,0
LUX,Luxembourg,TCD,Chad,2013,0,2,-2
LUX,Luxembourg,TCD,Chad,2014,1,1,0
LUX,Luxembourg,TCD,Chad,2015,0,0,0
LUX,Luxembourg,TCD,Chad,2016,0,0,0
LUX,Luxembourg,TCD,Chad,2017,0,0,0
MEX,Mexico,TCD,Chad,2010,0,1,-1
MEX,Mexico,TCD,Chad,2012,0,0,0
MEX,Mexico,TCD,Chad,2013,0,1,-1
MEX,Mexico,TCD,Chad,2014,0,0,0
NLD,Netherlands,TCD,Chad,2011,1,1,0
NLD,Netherlands,TCD,Chad,2012,0,1,-1
NLD,Netherlands,TCD,Chad,2013,1,3,-2
NLD,Netherlands,TCD,Chad,2014,0,3,-3
NLD,Netherlands,TCD,Chad,2015,3,2,1
NLD,Netherlands,TCD,Chad,2016,-1,4,-5
NLD,Netherlands,TCD,Chad,2017,2,2,0
NZL,New Zealand,TCD,Chad,2009,0,0,0
NZL,New Zealand,TCD,Chad,2014,0,1,-1
NZL,New Zealand,TCD,Chad,2015,0,3,-3
NOR,Norway,TCD,Chad,2008,0,0,0
NOR,Norway,TCD,Chad,2009,0,0,0
NOR,Norway,TCD,Chad,2010,0,5,-5
NOR,Norway,TCD,Chad,2011,1,1,0
NOR,Norway,TCD,Chad,2012,0,1,-1
NOR,Norway,TCD,Chad,2013,2,1,1
NOR,Norway,TCD,Chad,2014,0,1,-1
NOR,Norway,TCD,Chad,2015,0,1,-1
NOR,Norway,TCD,Chad,2016,1,0,1
NOR,Norway,TCD,Chad,2017,1,0,1
POL,Poland,TCD,Chad,2009,0,1,-1
POL,Poland,TCD,Chad,2010,0,2,-2
POL,Poland,TCD,Chad,2011,0,1,-1
POL,Poland,TCD,Chad,2012,0,3,-3
POL,Poland,TCD,Chad,2013,0,2,-2
POL,Poland,TCD,Chad,2014,0,1,-1
POL,Poland,TCD,Chad,2015,0,0,0
POL,Poland,TCD,Chad,2016,0,2,-2
POL,Poland,TCD,Chad,2017,0,1,-1
SVK,Slovak Republic,TCD,Chad,2008,0,1,-1
ESP,Spain,TCD,Chad,2008,5,9,-4
ESP,Spain,TCD,Chad,2009,8,14,-6
ESP,Spain,TCD,Chad,2010,6,14,-8
ESP,Spain,TCD,Chad,2011,16,12,4
ESP,Spain,TCD,Chad,2012,4,13,-9
ESP,Spain,TCD,Chad,2013,6,26,-20
ESP,Spain,TCD,Chad,2014,4,15,-11
ESP,Spain,TCD,Chad,2015,11,13,-2
ESP,Spain,TCD,Chad,2016,13,12,1
ESP,Spain,TCD,Chad,2017,18,5,13
SWE,Sweden,TCD,Chad,2008,0,4,-4
SWE,Sweden,TCD,Chad,2009,1,6,-5
SWE,Sweden,TCD,Chad,2010,0,2,-2
SWE,Sweden,TCD,Chad,2011,0,2,-2
SWE,Sweden,TCD,Chad,2012,0,6,-6
SWE,Sweden,TCD,Chad,2013,0,0,0
SWE,Sweden,TCD,Chad,2014,0,2,-2
SWE,Sweden,TCD,Chad,2015,0,5,-5
SWE,Sweden,TCD,Chad,2016,0,9,-9
SWE,Sweden,TCD,Chad,2017,0,6,-6
CHE,Switzerland,TCD,Chad,2010,1,7,-6
CHE,Switzerland,TCD,Chad,2011,1,1,0
CHE,Switzerland,TCD,Chad,2012,1,2,-1
CHE,Switzerland,TCD,Chad,2013,2,12,-10
CHE,Switzerland,TCD,Chad,2014,4,1,3
CHE,Switzerland,TCD,Chad,2015,2,2,0
CHE,Switzerland,TCD,Chad,2016,1,2,-1
CHE,Switzerland,TCD,Chad,2017,0,3,-3
TUR,Turkey,TCD,Chad,2010,0,6,-6
TUR,Turkey,TCD,Chad,2017,45,112,-67
USA,United States,TCD,Chad,2008,0,96,-96
USA,United States,TCD,Chad,2009,0,102,-102
USA,United States,TCD,Chad,2010,0,120,-120
USA,United States,TCD,Chad,2011,0,171,-171
USA,United States,TCD,Chad,2012,0,155,-155
USA,United States,TCD,Chad,2013,0,111,-111
USA,United States,TCD,Chad,2014,0,119,-119
USA,United States,TCD,Chad,2015,0,175,-175
USA,United States,TCD,Chad,2016,0,136,-136
USA,United States,TCD,Chad,2017,0,205,-205
CHL,Chile,TCD,Chad,2008,0,0,0
CHL,Chile,TCD,Chad,2009,0,0,0
CHL,Chile,TCD,Chad,2010,0,0,0
CHL,Chile,TCD,Chad,2011,0,0,0
CHL,Chile,TCD,Chad,2012,0,0,0
CHL,Chile,TCD,Chad,2013,0,0,0
CHL,Chile,TCD,Chad,2014,0,0,0
CHL,Chile,TCD,Chad,2015,0,0,0
CHL,Chile,TCD,Chad,2016,0,0,0
EST,Estonia,TCD,Chad,2008,0,0,0
EST,Estonia,TCD,Chad,2009,0,0,0
EST,Estonia,TCD,Chad,2010,0,0,0
EST,Estonia,TCD,Chad,2011,0,0,0
EST,Estonia,TCD,Chad,2012,0,0,0
EST,Estonia,TCD,Chad,2013,0,0,0
EST,Estonia,TCD,Chad,2014,0,0,0
EST,Estonia,TCD,Chad,2015,0,0,0
EST,Estonia,TCD,Chad,2016,0,0,0
EST,Estonia,TCD,Chad,2017,0,0,0
SVN,Slovenia,TCD,Chad,2010,0,1,-1
AUS,Australia,CHL,Chile,2017,0,282,-282
AUT,Austria,CHL,Chile,2017,0,89,-89
BEL,Belgium,CHL,Chile,2017,0,120,-120
CAN,Canada,CHL,Chile,2017,0,310,-310
CZE,Czech Republic,CHL,Chile,2017,0,25,-25
DNK,Denmark,CHL,Chile,2017,0,152,-152
FIN,Finland,CHL,Chile,2017,0,37,-37
FRA,France,CHL,Chile,2017,0,337,-337
DEU,Germany,CHL,Chile,2017,0,1786,-1786
HUN,Hungary,CHL,Chile,2017,0,34,-34
ISL,Iceland,CHL,Chile,2017,0,5,-5
ITA,Italy,CHL,Chile,2017,0,201,-201
JPN,Japan,CHL,Chile,2017,0,171,-171
KOR,Korea,CHL,Chile,2017,0,79,-79
LUX,Luxembourg,CHL,Chile,2017,0,8,-8
MEX,Mexico,CHL,Chile,2017,0,329,-329
NLD,Netherlands,CHL,Chile,2017,0,266,-266
NZL,New Zealand,CHL,Chile,2017,0,712,-712
NOR,Norway,CHL,Chile,2017,0,72,-72
POL,Poland,CHL,Chile,2017,0,34,-34
ESP,Spain,CHL,Chile,2017,0,3452,-3452
SWE,Sweden,CHL,Chile,2017,0,218,-218
CHE,Switzerland,CHL,Chile,2017,0,161,-161
USA,United States,CHL,Chile,2017,0,1625,-1625
EST,Estonia,CHL,Chile,2017,0,3,-3
ISR,Israel,CHL,Chile,2017,0,26,-26
SVN,Slovenia,CHL,Chile,2017,0,4,-4
AUS,Australia,CHN,China,2008,2651,20694,-18043
AUS,Australia,CHN,China,2009,2456,22297,-19841
AUS,Australia,CHN,China,2010,3001,24525,-21524
AUS,Australia,CHN,China,2011,3213,28718,-25505
AUS,Australia,CHN,China,2012,2666,25308,-22642
AUS,Australia,CHN,China,2013,2451,27898,-25447
AUS,Australia,CHN,China,2014,2211,27122,-24911
AUS,Australia,CHN,China,2015,2200,27924,-25724
AUS,Australia,CHN,China,2016,2100,29077,-26977
AUS,Australia,CHN,China,2017,0,29277,-29277
AUT,Austria,CHN,China,2008,1102,1199,-97
AUT,Austria,CHN,China,2009,1306,1379,-73
AUT,Austria,CHN,China,2010,1376,1297,79
AUT,Austria,CHN,China,2011,1222,1403,-181
AUT,Austria,CHN,China,2012,1001,1521,-520
AUT,Austria,CHN,China,2013,1069,1635,-566
AUT,Austria,CHN,China,2014,1130,1800,-670
AUT,Austria,CHN,China,2015,1202,2053,-851
AUT,Austria,CHN,China,2016,1357,1947,-590
AUT,Austria,CHN,China,2017,1581,1862,-281
BEL,Belgium,CHN,China,2008,983,1270,-287
BEL,Belgium,CHN,China,2009,951,1344,-393
BEL,Belgium,CHN,China,2010,755,1614,-859
BEL,Belgium,CHN,China,2011,957,1577,-620
BEL,Belgium,CHN,China,2012,1004,1711,-707
BEL,Belgium,CHN,China,2013,1015,1766,-751
BEL,Belgium,CHN,China,2014,753,1182,-429
BEL,Belgium,CHN,China,2015,762,1236,-474
BEL,Belgium,CHN,China,2016,661,1472,-811
BEL,Belgium,CHN,China,2017,604,1346,-742
CAN,Canada,CHN,China,2008,0,30030,-30030
CAN,Canada,CHN,China,2009,0,29617,-29617
CAN,Canada,CHN,China,2010,0,30378,-30378
CAN,Canada,CHN,China,2011,0,28491,-28491
CAN,Canada,CHN,China,2012,0,33009,-33009
CAN,Canada,CHN,China,2013,0,34115,-34115
CAN,Canada,CHN,China,2014,0,24626,-24626
CAN,Canada,CHN,China,2015,0,19531,-19531
CAN,Canada,CHN,China,2016,0,26855,-26855
CAN,Canada,CHN,China,2017,0,30280,-30280
CZE,Czech Republic,CHN,China,2008,5,940,-935
CZE,Czech Republic,CHN,China,2009,2,592,-590
CZE,Czech Republic,CHN,China,2010,6,459,-453
CZE,Czech Republic,CHN,China,2011,2,325,-323
CZE,Czech Republic,CHN,China,2012,251,400,-149
CZE,Czech Republic,CHN,China,2013,454,376,78
CZE,Czech Republic,CHN,China,2014,351,496,-145
CZE,Czech Republic,CHN,China,2015,341,469,-128
CZE,Czech Republic,CHN,China,2016,405,551,-146
CZE,Czech Republic,CHN,China,2017,288,823,-535
DNK,Denmark,CHN,China,2008,776,1272,-496
DNK,Denmark,CHN,China,2009,942,950,-8
DNK,Denmark,CHN,China,2010,1006,791,215
DNK,Denmark,CHN,China,2011,951,777,174
DNK,Denmark,CHN,China,2012,952,833,119
DNK,Denmark,CHN,China,2013,947,1156,-209
DNK,Denmark,CHN,China,2014,1011,1164,-153
DNK,Denmark,CHN,China,2015,1116,1288,-172
DNK,Denmark,CHN,China,2016,1312,1375,-63
DNK,Denmark,CHN,China,2017,1585,1225,360
FIN,Finland,CHN,China,2008,278,963,-685
FIN,Finland,CHN,China,2009,195,771,-576
FIN,Finland,CHN,China,2010,149,566,-417
FIN,Finland,CHN,China,2011,135,763,-628
FIN,Finland,CHN,China,2012,240,748,-508
FIN,Finland,CHN,China,2013,224,807,-583
FIN,Finland,CHN,China,2014,206,696,-490
FIN,Finland,CHN,China,2015,233,732,-499
FIN,Finland,CHN,China,2016,289,768,-479
FIN,Finland,CHN,China,2017,267,711,-444
FRA,France,CHN,China,2008,0,5241,-5241
FRA,France,CHN,China,2009,0,5453,-5453
FRA,France,CHN,China,2010,0,5720,-5720
FRA,France,CHN,China,2011,0,5540,-5540
FRA,France,CHN,China,2012,0,6256,-6256
FRA,France,CHN,China,2013,0,7600,-7600
FRA,France,CHN,China,2014,0,7596,-7596
FRA,France,CHN,China,2015,0,4991,-4991
FRA,France,CHN,China,2016,0,5309,-5309
FRA,France,CHN,China,2017,0,4644,-4644
DEU,Germany,CHN,China,2008,13647,14293,-646
DEU,Germany,CHN,China,2009,14762,15369,-607
DEU,Germany,CHN,China,2010,14094,16248,-2154
DEU,Germany,CHN,China,2011,12853,18276,-5423
DEU,Germany,CHN,China,2012,12359,19740,-7381
DEU,Germany,CHN,China,2013,14571,22350,-7779
DEU,Germany,CHN,China,2014,14132,23163,-9031
DEU,Germany,CHN,China,2015,15592,25511,-9919
DEU,Germany,CHN,China,2016,17247,26632,-9385
DEU,Germany,CHN,China,2017,17100,26590,-9490
HUN,Hungary,CHN,China,2008,172,1523,-1351
HUN,Hungary,CHN,China,2009,148,1282,-1134
HUN,Hungary,CHN,China,2010,211,1141,-930
HUN,Hungary,CHN,China,2011,226,883,-657
HUN,Hungary,CHN,China,2012,224,1137,-913
HUN,Hungary,CHN,China,2013,330,2165,-1835
HUN,Hungary,CHN,China,2014,343,4718,-4375
HUN,Hungary,CHN,China,2015,418,3524,-3106
HUN,Hungary,CHN,China,2016,344,1461,-1117
HUN,Hungary,CHN,China,2017,391,2259,-1868
ISL,Iceland,CHN,China,2008,214,69,145
ISL,Iceland,CHN,China,2009,49,64,-15
ISL,Iceland,CHN,China,2010,43,76,-33
ISL,Iceland,CHN,China,2011,80,61,19
ISL,Iceland,CHN,China,2012,19,50,-31
ISL,Iceland,CHN,China,2013,50,36,14
ISL,Iceland,CHN,China,2014,40,67,-27
ISL,Iceland,CHN,China,2015,37,60,-23
ISL,Iceland,CHN,China,2016,54,64,-10
ISL,Iceland,CHN,China,2017,46,84,-38
ITA,Italy,CHN,China,2008,728,12791,-12063
ITA,Italy,CHN,China,2009,879,16843,-15964
ITA,Italy,CHN,China,2010,1517,22866,-21349
ITA,Italy,CHN,China,2011,1672,20055,-18383
ITA,Italy,CHN,China,2012,1773,20463,-18690
ITA,Italy,CHN,China,2013,1943,17592,-15649
ITA,Italy,CHN,China,2014,1987,15828,-13841
ITA,Italy,CHN,China,2015,1799,14866,-13067
ITA,Italy,CHN,China,2016,0,12366,-12366
ITA,Italy,CHN,China,2017,1920,11253,-9333
JPN,Japan,CHN,China,2008,71766,134178,-62412
JPN,Japan,CHN,China,2009,79478,121227,-41749
JPN,Japan,CHN,China,2010,81470,107930,-26460
JPN,Japan,CHN,China,2011,84196,100358,-16162
JPN,Japan,CHN,China,2012,65201,106957,-41756
JPN,Japan,CHN,China,2013,64387,93003,-28616
JPN,Japan,CHN,China,2014,65405,98630,-33225
JPN,Japan,CHN,China,2015,64618,100571,-35953
JPN,Japan,CHN,China,2016,58773,103294,-44521
JPN,Japan,CHN,China,2017,61792,109763,-47971
KOR,Korea,CHN,China,2008,99387,161734,-62347
KOR,Korea,CHN,China,2009,121473,117563,3910
KOR,Korea,CHN,China,2010,91351,155252,-63901
KOR,Korea,CHN,China,2011,94714,149208,-54494
KOR,Korea,CHN,China,2012,139657,127289,12368
KOR,Korea,CHN,China,2013,131219,178606,-47387
KOR,Korea,CHN,China,2014,135939,192858,-56919
KOR,Korea,CHN,China,2015,135284,177001,-41717
KOR,Korea,CHN,China,2016,147443,165494,-18051
KOR,Korea,CHN,China,2017,156123,156848,-725
LUX,Luxembourg,CHN,China,2008,49,100,-51
LUX,Luxembourg,CHN,China,2009,62,139,-77
LUX,Luxembourg,CHN,China,2010,48,149,-101
LUX,Luxembourg,CHN,China,2011,48,150,-102
LUX,Luxembourg,CHN,China,2012,78,187,-109
LUX,Luxembourg,CHN,China,2013,86,431,-345
LUX,Luxembourg,CHN,China,2014,80,344,-264
LUX,Luxembourg,CHN,China,2015,102,448,-346
LUX,Luxembourg,CHN,China,2016,108,421,-313
LUX,Luxembourg,CHN,China,2017,130,459,-329
MEX,Mexico,CHN,China,2008,0,1327,-1327
MEX,Mexico,CHN,China,2009,0,1958,-1958
MEX,Mexico,CHN,China,2010,0,1736,-1736
MEX,Mexico,CHN,China,2011,0,1149,-1149
MEX,Mexico,CHN,China,2012,0,841,-841
MEX,Mexico,CHN,China,2013,0,5222,-5222
MEX,Mexico,CHN,China,2014,0,2619,-2619
MEX,Mexico,CHN,China,2015,0,2226,-2226
MEX,Mexico,CHN,China,2016,0,2127,-2127
MEX,Mexico,CHN,China,2017,0,1454,-1454
NLD,Netherlands,CHN,China,2008,1861,4234,-2373
NLD,Netherlands,CHN,China,2009,2076,4346,-2270
NLD,Netherlands,CHN,China,2010,2547,4466,-1919
NLD,Netherlands,CHN,China,2011,2801,5495,-2694
NLD,Netherlands,CHN,China,2012,3065,5184,-2119
NLD,Netherlands,CHN,China,2013,3293,4744,-1451
NLD,Netherlands,CHN,China,2014,3609,4837,-1228
NLD,Netherlands,CHN,China,2015,3600,5406,-1806
NLD,Netherlands,CHN,China,2016,4011,5734,-1723
NLD,Netherlands,CHN,China,2017,4218,6450,-2232
NZL,New Zealand,CHN,China,2008,2157,4736,-2579
NZL,New Zealand,CHN,China,2009,1995,5627,-3632
NZL,New Zealand,CHN,China,2010,2374,5843,-3469
NZL,New Zealand,CHN,China,2011,2433,7166,-4733
NZL,New Zealand,CHN,China,2012,2279,7623,-5344
NZL,New Zealand,CHN,China,2013,2223,7932,-5709
NZL,New Zealand,CHN,China,2014,2099,9127,-7028
NZL,New Zealand,CHN,China,2015,1930,10706,-8776
NZL,New Zealand,CHN,China,2016,1955,12145,-10190
NZL,New Zealand,CHN,China,2017,2552,12200,-9648
NOR,Norway,CHN,China,2008,314,837,-523
NOR,Norway,CHN,China,2009,339,849,-510
NOR,Norway,CHN,China,2010,490,955,-465
NOR,Norway,CHN,China,2011,644,1103,-459
NOR,Norway,CHN,China,2012,553,994,-441
NOR,Norway,CHN,China,2013,567,930,-363
NOR,Norway,CHN,China,2014,545,906,-361
NOR,Norway,CHN,China,2015,555,903,-348
NOR,Norway,CHN,China,2016,594,760,-166
NOR,Norway,CHN,China,2017,391,748,-357
POL,Poland,CHN,China,2008,0,1235,-1235
POL,Poland,CHN,China,2009,0,2001,-2001
POL,Poland,CHN,China,2010,0,2267,-2267
POL,Poland,CHN,China,2011,0,2785,-2785
POL,Poland,CHN,China,2012,0,2911,-2911
POL,Poland,CHN,China,2013,0,2997,-2997
POL,Poland,CHN,China,2014,0,1630,-1630
POL,Poland,CHN,China,2015,0,3759,-3759
POL,Poland,CHN,China,2016,0,3939,-3939
POL,Poland,CHN,China,2017,0,4172,-4172
PRT,Portugal,CHN,China,2008,0,2046,-2046
PRT,Portugal,CHN,China,2009,0,1947,-1947
PRT,Portugal,CHN,China,2010,0,1653,-1653
PRT,Portugal,CHN,China,2011,0,1507,-1507
PRT,Portugal,CHN,China,2012,0,1362,-1362
PRT,Portugal,CHN,China,2013,0,1863,-1863
PRT,Portugal,CHN,China,2014,0,3728,-3728
PRT,Portugal,CHN,China,2015,0,2576,-2576
PRT,Portugal,CHN,China,2016,0,2839,-2839
PRT,Portugal,CHN,China,2017,0,2600,-2600
SVK,Slovak Republic,CHN,China,2008,1,26,-25
SVK,Slovak Republic,CHN,China,2009,3,19,-16
SVK,Slovak Republic,CHN,China,2010,99,29,70
SVK,Slovak Republic,CHN,China,2011,3,64,-61
SVK,Slovak Republic,CHN,China,2012,0,71,-71
SVK,Slovak Republic,CHN,China,2013,2,36,-34
SVK,Slovak Republic,CHN,China,2014,3,24,-21
SVK,Slovak Republic,CHN,China,2015,0,28,-28
SVK,Slovak Republic,CHN,China,2016,0,18,-18
SVK,Slovak Republic,CHN,China,2017,0,19,-19
ESP,Spain,CHN,China,2008,7042,20080,-13038
ESP,Spain,CHN,China,2009,9205,11881,-2676
ESP,Spain,CHN,China,2010,10442,10473,-31
ESP,Spain,CHN,China,2011,13369,10706,2663
ESP,Spain,CHN,China,2012,14096,9184,4912
ESP,Spain,CHN,China,2013,15422,9127,6295
ESP,Spain,CHN,China,2014,10365,9410,955
ESP,Spain,CHN,China,2015,7560,10134,-2574
ESP,Spain,CHN,China,2016,7291,10215,-2924
ESP,Spain,CHN,China,2017,7860,11494,-3634
SWE,Sweden,CHN,China,2008,532,2677,-2145
SWE,Sweden,CHN,China,2009,376,3098,-2722
SWE,Sweden,CHN,China,2010,549,3186,-2637
SWE,Sweden,CHN,China,2011,1047,2619,-1572
SWE,Sweden,CHN,China,2012,1379,2453,-1074
SWE,Sweden,CHN,China,2013,1015,2075,-1060
SWE,Sweden,CHN,China,2014,1681,2351,-670
SWE,Sweden,CHN,China,2015,2712,2326,386
SWE,Sweden,CHN,China,2016,1032,2180,-1148
SWE,Sweden,CHN,China,2017,1039,2697,-1658
CHE,Switzerland,CHN,China,2010,1253,1945,-692
CHE,Switzerland,CHN,China,2011,1138,2136,-998
CHE,Switzerland,CHN,China,2012,1309,2362,-1053
CHE,Switzerland,CHN,China,2013,1591,2870,-1279
CHE,Switzerland,CHN,China,2014,1706,2930,-1224
CHE,Switzerland,CHN,China,2015,1899,3265,-1366
CHE,Switzerland,CHN,China,2016,2236,3180,-944
CHE,Switzerland,CHN,China,2017,2347,3138,-791
TUR,Turkey,CHN,China,2010,0,788,-788
TUR,Turkey,CHN,China,2016,3057,8281,-5224
TUR,Turkey,CHN,China,2017,6322,5189,1133
GBR,United Kingdom,CHN,China,2008,8000,18000,-10000
GBR,United Kingdom,CHN,China,2009,10000,22000,-12000
GBR,United Kingdom,CHN,China,2010,11000,28000,-17000
GBR,United Kingdom,CHN,China,2011,11000,45000,-34000
GBR,United Kingdom,CHN,China,2012,14000,41000,-27000
GBR,United Kingdom,CHN,China,2013,14000,46000,-32000
GBR,United Kingdom,CHN,China,2014,18000,39000,-21000
GBR,United Kingdom,CHN,China,2015,12000,43000,-31000
GBR,United Kingdom,CHN,China,2016,12000,35000,-23000
GBR,United Kingdom,CHN,China,2017,15000,58000,-43000
USA,United States,CHN,China,2008,0,80271,-80271
USA,United States,CHN,China,2009,0,64238,-64238
USA,United States,CHN,China,2010,0,70863,-70863
USA,United States,CHN,China,2011,0,87016,-87016
USA,United States,CHN,China,2012,0,81784,-81784
USA,United States,CHN,China,2013,0,71798,-71798
USA,United States,CHN,China,2014,0,76089,-76089
USA,United States,CHN,China,2015,0,74558,-74558
USA,United States,CHN,China,2016,0,81772,-81772
USA,United States,CHN,China,2017,0,71565,-71565
CHL,Chile,CHN,China,2008,0,825,-825
CHL,Chile,CHN,China,2009,0,867,-867
CHL,Chile,CHN,China,2010,0,822,-822
CHL,Chile,CHN,China,2011,0,1015,-1015
CHL,Chile,CHN,China,2012,0,1042,-1042
CHL,Chile,CHN,China,2013,0,1093,-1093
CHL,Chile,CHN,China,2014,0,1401,-1401
CHL,Chile,CHN,China,2015,0,1703,-1703
CHL,Chile,CHN,China,2016,0,1682,-1682
EST,Estonia,CHN,China,2008,0,43,-43
EST,Estonia,CHN,China,2009,0,87,-87
EST,Estonia,CHN,China,2010,0,26,-26
EST,Estonia,CHN,China,2011,0,32,-32
EST,Estonia,CHN,China,2012,0,22,-22
EST,Estonia,CHN,China,2013,0,50,-50
EST,Estonia,CHN,China,2014,0,12,-12
EST,Estonia,CHN,China,2015,0,55,-55
EST,Estonia,CHN,China,2016,0,59,-59
EST,Estonia,CHN,China,2017,0,66,-66
SVN,Slovenia,CHN,China,2008,0,198,-198
SVN,Slovenia,CHN,China,2009,0,395,-395
SVN,Slovenia,CHN,China,2010,0,164,-164
SVN,Slovenia,CHN,China,2011,33,167,-134
SVN,Slovenia,CHN,China,2012,26,119,-93
SVN,Slovenia,CHN,China,2013,9,105,-96
SVN,Slovenia,CHN,China,2014,4,119,-115
SVN,Slovenia,CHN,China,2015,18,143,-125
SVN,Slovenia,CHN,China,2016,17,124,-107
SVN,Slovenia,CHN,China,2017,17,158,-141
AUS,Australia,COL,Colombia,2008,62,467,-405
AUS,Australia,COL,Colombia,2009,79,515,-436
AUS,Australia,COL,Colombia,2010,79,768,-689
AUS,Australia,COL,Colombia,2011,97,765,-668
AUS,Australia,COL,Colombia,2012,114,930,-816
AUS,Australia,COL,Colombia,2013,131,1136,-1005
AUS,Australia,COL,Colombia,2014,160,982,-822
AUS,Australia,COL,Colombia,2015,100,939,-839
AUS,Australia,COL,Colombia,2016,200,1006,-806
AUS,Australia,COL,Colombia,2017,0,1066,-1066
AUT,Austria,COL,Colombia,2008,46,106,-60
AUT,Austria,COL,Colombia,2009,59,104,-45
AUT,Austria,COL,Colombia,2010,65,92,-27
AUT,Austria,COL,Colombia,2011,77,119,-42
AUT,Austria,COL,Colombia,2012,97,148,-51
AUT,Austria,COL,Colombia,2013,83,147,-64
AUT,Austria,COL,Colombia,2014,97,134,-37
AUT,Austria,COL,Colombia,2015,67,158,-91
AUT,Austria,COL,Colombia,2016,102,200,-98
AUT,Austria,COL,Colombia,2017,129,227,-98
BEL,Belgium,COL,Colombia,2008,0,257,-257
BEL,Belgium,COL,Colombia,2009,0,237,-237
BEL,Belgium,COL,Colombia,2010,119,357,-238
BEL,Belgium,COL,Colombia,2011,124,322,-198
BEL,Belgium,COL,Colombia,2012,159,317,-158
BEL,Belgium,COL,Colombia,2013,182,289,-107
BEL,Belgium,COL,Colombia,2014,112,232,-120
BEL,Belgium,COL,Colombia,2015,118,242,-124
BEL,Belgium,COL,Colombia,2016,119,282,-163
BEL,Belgium,COL,Colombia,2017,105,360,-255
CAN,Canada,COL,Colombia,2008,0,5449,-5449
CAN,Canada,COL,Colombia,2009,0,4652,-4652
CAN,Canada,COL,Colombia,2010,0,5218,-5218
CAN,Canada,COL,Colombia,2011,0,4366,-4366
CAN,Canada,COL,Colombia,2012,0,3736,-3736
CAN,Canada,COL,Colombia,2013,0,3632,-3632
CAN,Canada,COL,Colombia,2014,0,2859,-2859
CAN,Canada,COL,Colombia,2015,0,2181,-2181
CAN,Canada,COL,Colombia,2016,0,2440,-2440
CAN,Canada,COL,Colombia,2017,0,2230,-2230
CZE,Czech Republic,COL,Colombia,2008,1,20,-19
CZE,Czech Republic,COL,Colombia,2009,0,25,-25
CZE,Czech Republic,COL,Colombia,2010,0,27,-27
CZE,Czech Republic,COL,Colombia,2011,0,30,-30
CZE,Czech Republic,COL,Colombia,2012,10,27,-17
CZE,Czech Republic,COL,Colombia,2013,16,33,-17
CZE,Czech Republic,COL,Colombia,2014,25,45,-20
CZE,Czech Republic,COL,Colombia,2015,23,29,-6
CZE,Czech Republic,COL,Colombia,2016,24,28,-4
CZE,Czech Republic,COL,Colombia,2017,15,59,-44
DNK,Denmark,COL,Colombia,2008,20,72,-52
DNK,Denmark,COL,Colombia,2009,30,57,-27
DNK,Denmark,COL,Colombia,2010,45,63,-18
DNK,Denmark,COL,Colombia,2011,39,46,-7
DNK,Denmark,COL,Colombia,2012,51,61,-10
DNK,Denmark,COL,Colombia,2013,57,273,-216
DNK,Denmark,COL,Colombia,2014,56,149,-93
DNK,Denmark,COL,Colombia,2015,56,75,-19
DNK,Denmark,COL,Colombia,2016,91,87,4
DNK,Denmark,COL,Colombia,2017,138,98,40
FIN,Finland,COL,Colombia,2008,8,29,-21
FIN,Finland,COL,Colombia,2009,8,20,-12
FIN,Finland,COL,Colombia,2010,3,24,-21
FIN,Finland,COL,Colombia,2011,1,28,-27
FIN,Finland,COL,Colombia,2012,9,50,-41
FIN,Finland,COL,Colombia,2013,9,33,-24
FIN,Finland,COL,Colombia,2014,2,36,-34
FIN,Finland,COL,Colombia,2015,10,35,-25
FIN,Finland,COL,Colombia,2016,3,44,-41
FIN,Finland,COL,Colombia,2017,11,27,-16
FRA,France,COL,Colombia,2008,0,907,-907
FRA,France,COL,Colombia,2009,0,955,-955
FRA,France,COL,Colombia,2010,0,989,-989
FRA,France,COL,Colombia,2011,0,1043,-1043
FRA,France,COL,Colombia,2012,0,1030,-1030
FRA,France,COL,Colombia,2013,0,1046,-1046
FRA,France,COL,Colombia,2014,0,977,-977
FRA,France,COL,Colombia,2015,0,778,-778
FRA,France,COL,Colombia,2016,0,693,-693
FRA,France,COL,Colombia,2017,0,842,-842
DEU,Germany,COL,Colombia,2008,1407,1707,-300
DEU,Germany,COL,Colombia,2009,1500,1902,-402
DEU,Germany,COL,Colombia,2010,1487,1954,-467
DEU,Germany,COL,Colombia,2011,1411,2358,-947
DEU,Germany,COL,Colombia,2012,1450,2561,-1111
DEU,Germany,COL,Colombia,2013,1716,2790,-1074
DEU,Germany,COL,Colombia,2014,1797,2672,-875
DEU,Germany,COL,Colombia,2015,1786,2751,-965
DEU,Germany,COL,Colombia,2016,1980,3225,-1245
DEU,Germany,COL,Colombia,2017,1694,3424,-1730
HUN,Hungary,COL,Colombia,2008,0,34,-34
HUN,Hungary,COL,Colombia,2009,0,22,-22
HUN,Hungary,COL,Colombia,2010,3,36,-33
HUN,Hungary,COL,Colombia,2011,1,26,-25
HUN,Hungary,COL,Colombia,2012,1,17,-16
HUN,Hungary,COL,Colombia,2013,3,19,-16
HUN,Hungary,COL,Colombia,2014,4,28,-24
HUN,Hungary,COL,Colombia,2015,2,30,-28
HUN,Hungary,COL,Colombia,2016,1,34,-33
HUN,Hungary,COL,Colombia,2017,0,73,-73
ISL,Iceland,COL,Colombia,2008,8,5,3
ISL,Iceland,COL,Colombia,2009,4,9,-5
ISL,Iceland,COL,Colombia,2010,2,6,-4
ISL,Iceland,COL,Colombia,2011,2,4,-2
ISL,Iceland,COL,Colombia,2012,3,11,-8
ISL,Iceland,COL,Colombia,2013,4,8,-4
ISL,Iceland,COL,Colombia,2014,4,8,-4
ISL,Iceland,COL,Colombia,2015,5,7,-2
ISL,Iceland,COL,Colombia,2016,2,16,-14
ISL,Iceland,COL,Colombia,2017,11,10,1
ITA,Italy,COL,Colombia,2008,163,2160,-1997
ITA,Italy,COL,Colombia,2009,201,2068,-1867
ITA,Italy,COL,Colombia,2010,145,2132,-1987
ITA,Italy,COL,Colombia,2011,182,1772,-1590
ITA,Italy,COL,Colombia,2012,214,1525,-1311
ITA,Italy,COL,Colombia,2013,182,1178,-996
ITA,Italy,COL,Colombia,2014,221,854,-633
ITA,Italy,COL,Colombia,2015,185,773,-588
ITA,Italy,COL,Colombia,2016,0,841,-841
ITA,Italy,COL,Colombia,2017,153,1056,-903
JPN,Japan,COL,Colombia,2008,246,329,-83
JPN,Japan,COL,Colombia,2009,310,355,-45
JPN,Japan,COL,Colombia,2010,355,370,-15
JPN,Japan,COL,Colombia,2011,373,414,-41
JPN,Japan,COL,Colombia,2012,340,388,-48
JPN,Japan,COL,Colombia,2013,304,356,-52
JPN,Japan,COL,Colombia,2014,332,388,-56
JPN,Japan,COL,Colombia,2015,287,364,-77
JPN,Japan,COL,Colombia,2016,322,432,-110
JPN,Japan,COL,Colombia,2017,237,324,-87
KOR,Korea,COL,Colombia,2008,74,88,-14
KOR,Korea,COL,Colombia,2009,80,91,-11
KOR,Korea,COL,Colombia,2010,98,106,-8
KOR,Korea,COL,Colombia,2011,88,104,-16
KOR,Korea,COL,Colombia,2012,114,121,-7
KOR,Korea,COL,Colombia,2013,98,117,-19
KOR,Korea,COL,Colombia,2014,154,153,1
KOR,Korea,COL,Colombia,2015,118,107,11
KOR,Korea,COL,Colombia,2016,112,120,-8
KOR,Korea,COL,Colombia,2017,138,132,6
LUX,Luxembourg,COL,Colombia,2008,1,9,-8
LUX,Luxembourg,COL,Colombia,2009,3,14,-11
LUX,Luxembourg,COL,Colombia,2010,1,10,-9
LUX,Luxembourg,COL,Colombia,2011,1,9,-8
LUX,Luxembourg,COL,Colombia,2012,4,21,-17
LUX,Luxembourg,COL,Colombia,2013,3,21,-18
LUX,Luxembourg,COL,Colombia,2014,0,17,-17
LUX,Luxembourg,COL,Colombia,2015,8,19,-11
LUX,Luxembourg,COL,Colombia,2016,8,22,-14
LUX,Luxembourg,COL,Colombia,2017,10,44,-34
MEX,Mexico,COL,Colombia,2008,0,1051,-1051
MEX,Mexico,COL,Colombia,2009,0,1898,-1898
MEX,Mexico,COL,Colombia,2010,0,2312,-2312
MEX,Mexico,COL,Colombia,2011,0,1806,-1806
MEX,Mexico,COL,Colombia,2012,0,1411,-1411
MEX,Mexico,COL,Colombia,2013,0,3186,-3186
MEX,Mexico,COL,Colombia,2014,0,2488,-2488
MEX,Mexico,COL,Colombia,2015,0,2050,-2050
MEX,Mexico,COL,Colombia,2016,0,2197,-2197
MEX,Mexico,COL,Colombia,2017,0,2162,-2162
NLD,Netherlands,COL,Colombia,2008,172,364,-192
NLD,Netherlands,COL,Colombia,2009,184,445,-261
NLD,Netherlands,COL,Colombia,2010,238,458,-220
NLD,Netherlands,COL,Colombia,2011,276,450,-174
NLD,Netherlands,COL,Colombia,2012,258,411,-153
NLD,Netherlands,COL,Colombia,2013,332,484,-152
NLD,Netherlands,COL,Colombia,2014,288,416,-128
NLD,Netherlands,COL,Colombia,2015,304,438,-134
NLD,Netherlands,COL,Colombia,2016,283,514,-231
NLD,Netherlands,COL,Colombia,2017,376,587,-211
NZL,New Zealand,COL,Colombia,2008,16,75,-59
NZL,New Zealand,COL,Colombia,2009,26,94,-68
NZL,New Zealand,COL,Colombia,2010,31,130,-99
NZL,New Zealand,COL,Colombia,2011,20,162,-142
NZL,New Zealand,COL,Colombia,2012,36,123,-87
NZL,New Zealand,COL,Colombia,2013,25,109,-84
NZL,New Zealand,COL,Colombia,2014,40,257,-217
NZL,New Zealand,COL,Colombia,2015,40,189,-149
NZL,New Zealand,COL,Colombia,2016,40,195,-155
NZL,New Zealand,COL,Colombia,2017,80,288,-208
NOR,Norway,COL,Colombia,2008,17,105,-88
NOR,Norway,COL,Colombia,2009,34,58,-24
NOR,Norway,COL,Colombia,2010,36,75,-39
NOR,Norway,COL,Colombia,2011,37,126,-89
NOR,Norway,COL,Colombia,2012,46,144,-98
NOR,Norway,COL,Colombia,2013,41,154,-113
NOR,Norway,COL,Colombia,2014,36,99,-63
NOR,Norway,COL,Colombia,2015,44,76,-32
NOR,Norway,COL,Colombia,2016,57,116,-59
NOR,Norway,COL,Colombia,2017,34,106,-72
POL,Poland,COL,Colombia,2008,0,61,-61
POL,Poland,COL,Colombia,2009,0,49,-49
POL,Poland,COL,Colombia,2010,0,57,-57
POL,Poland,COL,Colombia,2011,0,68,-68
POL,Poland,COL,Colombia,2012,0,77,-77
POL,Poland,COL,Colombia,2013,0,71,-71
POL,Poland,COL,Colombia,2014,0,32,-32
POL,Poland,COL,Colombia,2015,0,83,-83
POL,Poland,COL,Colombia,2016,0,66,-66
POL,Poland,COL,Colombia,2017,0,96,-96
SVK,Slovak Republic,COL,Colombia,2008,0,2,-2
SVK,Slovak Republic,COL,Colombia,2009,3,3,0
SVK,Slovak Republic,COL,Colombia,2010,2,7,-5
SVK,Slovak Republic,COL,Colombia,2011,1,1,0
SVK,Slovak Republic,COL,Colombia,2012,0,1,-1
SVK,Slovak Republic,COL,Colombia,2013,0,1,-1
SVK,Slovak Republic,COL,Colombia,2014,0,1,-1
SVK,Slovak Republic,COL,Colombia,2016,0,1,-1
SVK,Slovak Republic,COL,Colombia,2017,0,1,-1
ESP,Spain,COL,Colombia,2008,9824,36040,-26216
ESP,Spain,COL,Colombia,2009,13448,20409,-6961
ESP,Spain,COL,Colombia,2010,14633,13664,969
ESP,Spain,COL,Colombia,2011,15787,13161,2626
ESP,Spain,COL,Colombia,2012,16763,9955,6808
ESP,Spain,COL,Colombia,2013,19426,8688,10738
ESP,Spain,COL,Colombia,2014,11152,8451,2701
ESP,Spain,COL,Colombia,2015,7273,9368,-2095
ESP,Spain,COL,Colombia,2016,6274,22594,-16320
ESP,Spain,COL,Colombia,2017,7879,34210,-26331
SWE,Sweden,COL,Colombia,2008,53,297,-244
SWE,Sweden,COL,Colombia,2009,37,246,-209
SWE,Sweden,COL,Colombia,2010,32,269,-237
SWE,Sweden,COL,Colombia,2011,55,224,-169
SWE,Sweden,COL,Colombia,2012,56,304,-248
SWE,Sweden,COL,Colombia,2013,48,396,-348
SWE,Sweden,COL,Colombia,2014,61,204,-143
SWE,Sweden,COL,Colombia,2015,107,284,-177
SWE,Sweden,COL,Colombia,2016,59,172,-113
SWE,Sweden,COL,Colombia,2017,40,235,-195
CHE,Switzerland,COL,Colombia,2010,161,499,-338
CHE,Switzerland,COL,Colombia,2011,195,459,-264
CHE,Switzerland,COL,Colombia,2012,202,462,-260
CHE,Switzerland,COL,Colombia,2013,205,464,-259
CHE,Switzerland,COL,Colombia,2014,160,424,-264
CHE,Switzerland,COL,Colombia,2015,199,419,-220
CHE,Switzerland,COL,Colombia,2016,180,414,-234
CHE,Switzerland,COL,Colombia,2017,179,476,-297
TUR,Turkey,COL,Colombia,2010,0,30,-30
TUR,Turkey,COL,Colombia,2016,114,144,-30
TUR,Turkey,COL,Colombia,2017,110,157,-47
GBR,United Kingdom,COL,Colombia,2011,1000,2000,-1000
GBR,United Kingdom,COL,Colombia,2014,0,1000,-1000
GBR,United Kingdom,COL,Colombia,2015,0,1000,-1000
USA,United States,COL,Colombia,2008,0,30213,-30213
USA,United States,COL,Colombia,2009,0,27849,-27849
USA,United States,COL,Colombia,2010,0,22406,-22406
USA,United States,COL,Colombia,2011,0,22635,-22635
USA,United States,COL,Colombia,2012,0,20931,-20931
USA,United States,COL,Colombia,2013,0,21131,-21131
USA,United States,COL,Colombia,2014,0,18175,-18175
USA,United States,COL,Colombia,2015,0,17316,-17316
USA,United States,COL,Colombia,2016,0,18610,-18610
USA,United States,COL,Colombia,2017,0,17956,-17956
CHL,Chile,COL,Colombia,2008,0,3155,-3155
CHL,Chile,COL,Colombia,2009,0,4143,-4143
CHL,Chile,COL,Colombia,2010,0,5469,-5469
CHL,Chile,COL,Colombia,2011,0,9423,-9423
CHL,Chile,COL,Colombia,2012,0,12123,-12123
CHL,Chile,COL,Colombia,2013,0,16680,-16680
CHL,Chile,COL,Colombia,2014,0,15387,-15387
CHL,Chile,COL,Colombia,2015,0,19523,-19523
CHL,Chile,COL,Colombia,2016,0,26870,-26870
EST,Estonia,COL,Colombia,2008,0,2,-2
EST,Estonia,COL,Colombia,2009,0,4,-4
EST,Estonia,COL,Colombia,2010,0,1,-1
EST,Estonia,COL,Colombia,2011,0,0,0
EST,Estonia,COL,Colombia,2012,0,1,-1
EST,Estonia,COL,Colombia,2013,0,3,-3
EST,Estonia,COL,Colombia,2014,0,1,-1
EST,Estonia,COL,Colombia,2015,0,11,-11
EST,Estonia,COL,Colombia,2016,0,5,-5
EST,Estonia,COL,Colombia,2017,0,9,-9
ISR,Israel,COL,Colombia,2008,0,55,-55
ISR,Israel,COL,Colombia,2009,0,52,-52
ISR,Israel,COL,Colombia,2010,0,47,-47
ISR,Israel,COL,Colombia,2011,0,90,-90
ISR,Israel,COL,Colombia,2012,0,44,-44
ISR,Israel,COL,Colombia,2013,0,62,-62
ISR,Israel,COL,Colombia,2014,0,55,-55
ISR,Israel,COL,Colombia,2015,0,98,-98
ISR,Israel,COL,Colombia,2016,0,81,-81
ISR,Israel,COL,Colombia,2017,0,74,-74
SVN,Slovenia,COL,Colombia,2008,0,7,-7
SVN,Slovenia,COL,Colombia,2009,0,8,-8
SVN,Slovenia,COL,Colombia,2010,0,11,-11
SVN,Slovenia,COL,Colombia,2011,6,16,-10
SVN,Slovenia,COL,Colombia,2012,1,2,-1
SVN,Slovenia,COL,Colombia,2013,0,1,-1
SVN,Slovenia,COL,Colombia,2014,0,1,-1
SVN,Slovenia,COL,Colombia,2015,0,7,-7
SVN,Slovenia,COL,Colombia,2016,0,2,-2
SVN,Slovenia,COL,Colombia,2017,0,14,-14
AUS,Australia,COM,Comoros,2008,0,0,0
AUS,Australia,COM,Comoros,2009,0,0,0
AUS,Australia,COM,Comoros,2010,0,1,-1
AUS,Australia,COM,Comoros,2011,0,1,-1
AUS,Australia,COM,Comoros,2012,0,0,0
AUS,Australia,COM,Comoros,2013,0,1,-1
AUS,Australia,COM,Comoros,2014,0,0,0
AUS,Australia,COM,Comoros,2015,0,0,0
AUS,Australia,COM,Comoros,2017,0,0,0
AUT,Austria,COM,Comoros,2008,0,0,0
AUT,Austria,COM,Comoros,2009,0,0,0
AUT,Austria,COM,Comoros,2010,0,0,0
AUT,Austria,COM,Comoros,2011,0,1,-1
AUT,Austria,COM,Comoros,2012,0,0,0
AUT,Austria,COM,Comoros,2013,0,1,-1
AUT,Austria,COM,Comoros,2014,0,2,-2
AUT,Austria,COM,Comoros,2015,2,2,0
AUT,Austria,COM,Comoros,2016,1,1,0
AUT,Austria,COM,Comoros,2017,0,0,0
BEL,Belgium,COM,Comoros,2008,0,1,-1
BEL,Belgium,COM,Comoros,2009,0,2,-2
BEL,Belgium,COM,Comoros,2010,0,6,-6
BEL,Belgium,COM,Comoros,2012,1,4,-3
BEL,Belgium,COM,Comoros,2013,3,1,2
BEL,Belgium,COM,Comoros,2014,1,9,-8
BEL,Belgium,COM,Comoros,2015,2,3,-1
BEL,Belgium,COM,Comoros,2016,4,3,1
BEL,Belgium,COM,Comoros,2017,2,6,-4
CAN,Canada,COM,Comoros,2008,0,3,-3
CAN,Canada,COM,Comoros,2009,0,19,-19
CAN,Canada,COM,Comoros,2010,0,22,-22
CAN,Canada,COM,Comoros,2011,0,14,-14
CAN,Canada,COM,Comoros,2012,0,18,-18
CAN,Canada,COM,Comoros,2013,0,22,-22
CAN,Canada,COM,Comoros,2014,0,8,-8
CAN,Canada,COM,Comoros,2015,0,11,-11
CAN,Canada,COM,Comoros,2016,0,10,-10
CAN,Canada,COM,Comoros,2017,0,10,-10
DNK,Denmark,COM,Comoros,2008,0,3,-3
DNK,Denmark,COM,Comoros,2009,0,0,0
DNK,Denmark,COM,Comoros,2012,0,0,0
DNK,Denmark,COM,Comoros,2013,0,0,0
DNK,Denmark,COM,Comoros,2014,0,0,0
DNK,Denmark,COM,Comoros,2015,0,1,-1
DNK,Denmark,COM,Comoros,2016,0,1,-1
DNK,Denmark,COM,Comoros,2017,0,0,0
FIN,Finland,COM,Comoros,2008,0,0,0
FIN,Finland,COM,Comoros,2009,0,0,0
FIN,Finland,COM,Comoros,2010,0,0,0
FIN,Finland,COM,Comoros,2011,0,0,0
FIN,Finland,COM,Comoros,2012,0,0,0
FIN,Finland,COM,Comoros,2013,0,0,0
FIN,Finland,COM,Comoros,2014,0,0,0
FIN,Finland,COM,Comoros,2015,0,0,0
FIN,Finland,COM,Comoros,2016,0,0,0
FIN,Finland,COM,Comoros,2017,0,0,0
FRA,France,COM,Comoros,2008,0,3075,-3075
FRA,France,COM,Comoros,2009,0,3307,-3307
FRA,France,COM,Comoros,2010,0,2875,-2875
FRA,France,COM,Comoros,2011,0,2502,-2502
FRA,France,COM,Comoros,2012,0,3067,-3067
FRA,France,COM,Comoros,2013,0,4845,-4845
FRA,France,COM,Comoros,2014,0,5633,-5633
FRA,France,COM,Comoros,2015,0,7342,-7342
FRA,France,COM,Comoros,2016,0,3869,-3869
FRA,France,COM,Comoros,2017,0,4159,-4159
DEU,Germany,COM,Comoros,2008,4,6,-2
DEU,Germany,COM,Comoros,2009,10,8,2
DEU,Germany,COM,Comoros,2010,4,11,-7
DEU,Germany,COM,Comoros,2011,3,4,-1
DEU,Germany,COM,Comoros,2012,1,2,-1
DEU,Germany,COM,Comoros,2013,21,23,-2
DEU,Germany,COM,Comoros,2014,9,23,-14
DEU,Germany,COM,Comoros,2015,6,37,-31
DEU,Germany,COM,Comoros,2016,21,25,-4
DEU,Germany,COM,Comoros,2017,22,18,4
HUN,Hungary,COM,Comoros,2008,0,0,0
HUN,Hungary,COM,Comoros,2009,0,0,0
HUN,Hungary,COM,Comoros,2010,0,0,0
HUN,Hungary,COM,Comoros,2011,0,0,0
HUN,Hungary,COM,Comoros,2012,0,0,0
HUN,Hungary,COM,Comoros,2013,0,0,0
HUN,Hungary,COM,Comoros,2014,0,0,0
HUN,Hungary,COM,Comoros,2015,0,2,-2
HUN,Hungary,COM,Comoros,2016,0,6,-6
HUN,Hungary,COM,Comoros,2017,0,4,-4
ISL,Iceland,COM,Comoros,2008,0,0,0
ISL,Iceland,COM,Comoros,2009,0,0,0
ISL,Iceland,COM,Comoros,2010,1,1,0
ISL,Iceland,COM,Comoros,2011,0,0,0
ISL,Iceland,COM,Comoros,2012,0,0,0
ISL,Iceland,COM,Comoros,2013,0,0,0
ISL,Iceland,COM,Comoros,2014,0,0,0
ISL,Iceland,COM,Comoros,2015,1,1,0
ISL,Iceland,COM,Comoros,2016,0,0,0
ISL,Iceland,COM,Comoros,2017,0,0,0
ITA,Italy,COM,Comoros,2008,0,3,-3
ITA,Italy,COM,Comoros,2009,0,2,-2
ITA,Italy,COM,Comoros,2010,0,0,0
ITA,Italy,COM,Comoros,2011,1,2,-1
ITA,Italy,COM,Comoros,2012,0,4,-4
ITA,Italy,COM,Comoros,2013,0,1,-1
ITA,Italy,COM,Comoros,2014,1,17,-16
ITA,Italy,COM,Comoros,2015,0,0,0
ITA,Italy,COM,Comoros,2016,0,2,-2
ITA,Italy,COM,Comoros,2017,0,1,-1
JPN,Japan,COM,Comoros,2008,9,9,0
JPN,Japan,COM,Comoros,2009,6,6,0
JPN,Japan,COM,Comoros,2010,8,8,0
JPN,Japan,COM,Comoros,2011,7,8,-1
JPN,Japan,COM,Comoros,2012,27,27,0
JPN,Japan,COM,Comoros,2013,34,33,1
JPN,Japan,COM,Comoros,2014,24,24,0
JPN,Japan,COM,Comoros,2015,10,12,-2
JPN,Japan,COM,Comoros,2016,12,12,0
JPN,Japan,COM,Comoros,2017,18,21,-3
KOR,Korea,COM,Comoros,2008,0,0,0
KOR,Korea,COM,Comoros,2009,0,0,0
KOR,Korea,COM,Comoros,2010,0,0,0
KOR,Korea,COM,Comoros,2011,0,0,0
KOR,Korea,COM,Comoros,2012,2,1,1
KOR,Korea,COM,Comoros,2013,0,1,-1
KOR,Korea,COM,Comoros,2014,2,4,-2
KOR,Korea,COM,Comoros,2015,6,4,2
KOR,Korea,COM,Comoros,2016,1,5,-4
KOR,Korea,COM,Comoros,2017,2,2,0
LUX,Luxembourg,COM,Comoros,2008,0,1,-1
LUX,Luxembourg,COM,Comoros,2009,1,0,1
LUX,Luxembourg,COM,Comoros,2010,0,1,-1
LUX,Luxembourg,COM,Comoros,2011,0,1,-1
LUX,Luxembourg,COM,Comoros,2012,0,1,-1
LUX,Luxembourg,COM,Comoros,2013,1,0,1
LUX,Luxembourg,COM,Comoros,2014,0,1,-1
LUX,Luxembourg,COM,Comoros,2015,0,1,-1
LUX,Luxembourg,COM,Comoros,2016,0,1,-1
LUX,Luxembourg,COM,Comoros,2017,0,3,-3
MEX,Mexico,COM,Comoros,2012,0,0,0
MEX,Mexico,COM,Comoros,2013,0,0,0
MEX,Mexico,COM,Comoros,2014,0,0,0
NLD,Netherlands,COM,Comoros,2009,0,1,-1
NLD,Netherlands,COM,Comoros,2016,0,1,-1
NLD,Netherlands,COM,Comoros,2017,0,1,-1
NOR,Norway,COM,Comoros,2008,0,0,0
NOR,Norway,COM,Comoros,2009,0,0,0
NOR,Norway,COM,Comoros,2010,0,0,0
NOR,Norway,COM,Comoros,2011,0,0,0
NOR,Norway,COM,Comoros,2012,0,0,0
NOR,Norway,COM,Comoros,2013,0,0,0
NOR,Norway,COM,Comoros,2014,0,0,0
NOR,Norway,COM,Comoros,2015,0,0,0
NOR,Norway,COM,Comoros,2016,0,0,0
NOR,Norway,COM,Comoros,2017,0,0,0
POL,Poland,COM,Comoros,2009,0,0,0
POL,Poland,COM,Comoros,2010,0,1,-1
POL,Poland,COM,Comoros,2011,0,0,0
POL,Poland,COM,Comoros,2012,0,1,-1
POL,Poland,COM,Comoros,2013,0,1,-1
POL,Poland,COM,Comoros,2014,0,4,-4
POL,Poland,COM,Comoros,2015,0,0,0
POL,Poland,COM,Comoros,2016,0,2,-2
POL,Poland,COM,Comoros,2017,0,0,0
SVK,Slovak Republic,COM,Comoros,2008,0,0,0
SVK,Slovak Republic,COM,Comoros,2010,0,10,-10
ESP,Spain,COM,Comoros,2008,1,0,1
ESP,Spain,COM,Comoros,2009,0,1,-1
ESP,Spain,COM,Comoros,2010,0,3,-3
ESP,Spain,COM,Comoros,2011,0,0,0
ESP,Spain,COM,Comoros,2012,1,1,0
ESP,Spain,COM,Comoros,2013,0,5,-5
ESP,Spain,COM,Comoros,2014,1,1,0
ESP,Spain,COM,Comoros,2015,1,1,0
ESP,Spain,COM,Comoros,2016,0,4,-4
ESP,Spain,COM,Comoros,2017,0,1,-1
SWE,Sweden,COM,Comoros,2008,0,0,0
SWE,Sweden,COM,Comoros,2009,0,0,0
SWE,Sweden,COM,Comoros,2010,0,1,-1
SWE,Sweden,COM,Comoros,2011,0,0,0
SWE,Sweden,COM,Comoros,2012,0,0,0
SWE,Sweden,COM,Comoros,2013,0,4,-4
SWE,Sweden,COM,Comoros,2014,0,0,0
SWE,Sweden,COM,Comoros,2015,0,1,-1
SWE,Sweden,COM,Comoros,2016,0,0,0
SWE,Sweden,COM,Comoros,2017,0,0,0
CHE,Switzerland,COM,Comoros,2010,0,0,0
CHE,Switzerland,COM,Comoros,2011,0,1,-1
CHE,Switzerland,COM,Comoros,2012,1,2,-1
CHE,Switzerland,COM,Comoros,2013,0,0,0
CHE,Switzerland,COM,Comoros,2015,0,3,-3
CHE,Switzerland,COM,Comoros,2016,0,3,-3
CHE,Switzerland,COM,Comoros,2017,1,0,1
USA,United States,COM,Comoros,2008,0,3,-3
USA,United States,COM,Comoros,2009,0,3,-3
USA,United States,COM,Comoros,2010,0,4,-4
USA,United States,COM,Comoros,2011,0,8,-8
USA,United States,COM,Comoros,2012,0,10,-10
USA,United States,COM,Comoros,2013,0,3,-3
USA,United States,COM,Comoros,2014,0,9,-9
USA,United States,COM,Comoros,2015,0,5,-5
USA,United States,COM,Comoros,2016,0,4,-4
USA,United States,COM,Comoros,2017,0,4,-4
CHL,Chile,COM,Comoros,2008,0,0,0
CHL,Chile,COM,Comoros,2009,0,0,0
CHL,Chile,COM,Comoros,2010,0,0,0
CHL,Chile,COM,Comoros,2011,0,0,0
CHL,Chile,COM,Comoros,2012,0,1,-1
CHL,Chile,COM,Comoros,2013,0,0,0
CHL,Chile,COM,Comoros,2014,0,0,0
CHL,Chile,COM,Comoros,2015,0,0,0
CHL,Chile,COM,Comoros,2016,0,0,0
EST,Estonia,COM,Comoros,2008,0,0,0
EST,Estonia,COM,Comoros,2009,0,0,0
EST,Estonia,COM,Comoros,2010,0,0,0
EST,Estonia,COM,Comoros,2011,0,0,0
EST,Estonia,COM,Comoros,2012,0,0,0
EST,Estonia,COM,Comoros,2013,0,0,0
EST,Estonia,COM,Comoros,2014,0,0,0
EST,Estonia,COM,Comoros,2015,0,0,0
EST,Estonia,COM,Comoros,2016,0,0,0
EST,Estonia,COM,Comoros,2017,0,0,0
SVN,Slovenia,COM,Comoros,2009,0,1,-1
AUS,Australia,COG,Congo,2008,0,113,-113
AUS,Australia,COG,Congo,2009,5,127,-122
AUS,Australia,COG,Congo,2010,0,138,-138
AUS,Australia,COG,Congo,2011,5,110,-105
AUS,Australia,COG,Congo,2012,0,209,-209
AUS,Australia,COG,Congo,2013,0,51,-51
AUS,Australia,COG,Congo,2014,5,33,-28
AUS,Australia,COG,Congo,2015,0,41,-41
AUS,Australia,COG,Congo,2016,0,10,-10
AUS,Australia,COG,Congo,2017,0,44,-44
AUT,Austria,COG,Congo,2008,16,28,-12
AUT,Austria,COG,Congo,2009,7,42,-35
AUT,Austria,COG,Congo,2010,12,34,-22
AUT,Austria,COG,Congo,2011,17,44,-27
AUT,Austria,COG,Congo,2012,8,35,-27
AUT,Austria,COG,Congo,2013,14,34,-20
AUT,Austria,COG,Congo,2014,14,39,-25
AUT,Austria,COG,Congo,2015,8,50,-42
AUT,Austria,COG,Congo,2016,17,46,-29
AUT,Austria,COG,Congo,2017,26,45,-19
BEL,Belgium,COG,Congo,2008,0,74,-74
BEL,Belgium,COG,Congo,2009,0,79,-79
BEL,Belgium,COG,Congo,2010,28,68,-40
BEL,Belgium,COG,Congo,2011,0,71,-71
BEL,Belgium,COG,Congo,2012,39,81,-42
BEL,Belgium,COG,Congo,2013,44,51,-7
BEL,Belgium,COG,Congo,2014,43,31,12
BEL,Belgium,COG,Congo,2015,46,30,16
BEL,Belgium,COG,Congo,2016,22,51,-29
BEL,Belgium,COG,Congo,2017,19,45,-26
CAN,Canada,COG,Congo,2008,0,72,-72
CAN,Canada,COG,Congo,2009,0,69,-69
CAN,Canada,COG,Congo,2010,0,75,-75
CAN,Canada,COG,Congo,2011,0,81,-81
CAN,Canada,COG,Congo,2012,0,91,-91
CAN,Canada,COG,Congo,2013,0,114,-114
CAN,Canada,COG,Congo,2014,0,84,-84
CAN,Canada,COG,Congo,2015,0,131,-131
CAN,Canada,COG,Congo,2016,0,140,-140
CAN,Canada,COG,Congo,2017,0,130,-130
CZE,Czech Republic,COG,Congo,2008,0,6,-6
CZE,Czech Republic,COG,Congo,2009,0,3,-3
CZE,Czech Republic,COG,Congo,2010,0,9,-9
CZE,Czech Republic,COG,Congo,2011,0,4,-4
CZE,Czech Republic,COG,Congo,2012,0,2,-2
CZE,Czech Republic,COG,Congo,2013,0,4,-4
CZE,Czech Republic,COG,Congo,2014,0,2,-2
CZE,Czech Republic,COG,Congo,2015,0,3,-3
CZE,Czech Republic,COG,Congo,2016,0,2,-2
DNK,Denmark,COG,Congo,2008,8,60,-52
DNK,Denmark,COG,Congo,2009,8,32,-24
DNK,Denmark,COG,Congo,2010,2,61,-59
DNK,Denmark,COG,Congo,2011,13,43,-30
DNK,Denmark,COG,Congo,2012,4,21,-17
DNK,Denmark,COG,Congo,2013,9,9,0
DNK,Denmark,COG,Congo,2014,0,8,-8
DNK,Denmark,COG,Congo,2015,1,23,-22
DNK,Denmark,COG,Congo,2016,2,7,-5
DNK,Denmark,COG,Congo,2017,9,6,3
FIN,Finland,COG,Congo,2008,1,4,-3
FIN,Finland,COG,Congo,2009,0,11,-11
FIN,Finland,COG,Congo,2010,2,15,-13
FIN,Finland,COG,Congo,2011,0,8,-8
FIN,Finland,COG,Congo,2012,0,3,-3
FIN,Finland,COG,Congo,2013,0,13,-13
FIN,Finland,COG,Congo,2014,0,2,-2
FIN,Finland,COG,Congo,2015,0,3,-3
FIN,Finland,COG,Congo,2016,1,1,0
FIN,Finland,COG,Congo,2017,0,1,-1
FRA,France,COG,Congo,2008,0,2211,-2211
FRA,France,COG,Congo,2009,0,2321,-2321
FRA,France,COG,Congo,2010,0,2229,-2229
FRA,France,COG,Congo,2011,0,2146,-2146
FRA,France,COG,Congo,2012,0,2194,-2194
FRA,France,COG,Congo,2013,0,2251,-2251
FRA,France,COG,Congo,2014,0,2175,-2175
FRA,France,COG,Congo,2015,0,2015,-2015
FRA,France,COG,Congo,2016,0,1967,-1967
FRA,France,COG,Congo,2017,0,2020,-2020
DEU,Germany,COG,Congo,2008,337,270,67
DEU,Germany,COG,Congo,2009,325,265,60
DEU,Germany,COG,Congo,2010,320,289,31
DEU,Germany,COG,Congo,2011,253,258,-5
DEU,Germany,COG,Congo,2012,257,310,-53
DEU,Germany,COG,Congo,2013,123,199,-76
DEU,Germany,COG,Congo,2014,142,243,-101
DEU,Germany,COG,Congo,2015,143,268,-125
DEU,Germany,COG,Congo,2016,149,207,-58
DEU,Germany,COG,Congo,2017,127,175,-48
HUN,Hungary,COG,Congo,2008,0,2,-2
HUN,Hungary,COG,Congo,2009,0,2,-2
HUN,Hungary,COG,Congo,2010,0,1,-1
HUN,Hungary,COG,Congo,2011,0,0,0
HUN,Hungary,COG,Congo,2012,0,3,-3
HUN,Hungary,COG,Congo,2013,0,8,-8
HUN,Hungary,COG,Congo,2014,0,1,-1
HUN,Hungary,COG,Congo,2015,0,5,-5
HUN,Hungary,COG,Congo,2016,0,5,-5
HUN,Hungary,COG,Congo,2017,0,6,-6
ISL,Iceland,COG,Congo,2008,0,0,0
ISL,Iceland,COG,Congo,2009,0,1,-1
ISL,Iceland,COG,Congo,2010,1,0,1
ISL,Iceland,COG,Congo,2011,0,0,0
ISL,Iceland,COG,Congo,2012,0,0,0
ISL,Iceland,COG,Congo,2013,0,0,0
ISL,Iceland,COG,Congo,2014,0,0,0
ISL,Iceland,COG,Congo,2015,1,1,0
ISL,Iceland,COG,Congo,2016,0,0,0
ISL,Iceland,COG,Congo,2017,0,0,0
ITA,Italy,COG,Congo,2008,41,352,-311
ITA,Italy,COG,Congo,2009,47,371,-324
ITA,Italy,COG,Congo,2010,14,367,-353
ITA,Italy,COG,Congo,2011,26,260,-234
ITA,Italy,COG,Congo,2012,33,335,-302
ITA,Italy,COG,Congo,2013,15,194,-179
ITA,Italy,COG,Congo,2014,31,211,-180
ITA,Italy,COG,Congo,2015,31,210,-179
ITA,Italy,COG,Congo,2016,0,297,-297
ITA,Italy,COG,Congo,2017,17,241,-224
JPN,Japan,COG,Congo,2008,200,100,100
JPN,Japan,COG,Congo,2009,19,10,9
JPN,Japan,COG,Congo,2010,32,16,16
JPN,Japan,COG,Congo,2011,28,19,9
JPN,Japan,COG,Congo,2012,26,30,-4
JPN,Japan,COG,Congo,2013,25,30,-5
JPN,Japan,COG,Congo,2014,23,23,0
JPN,Japan,COG,Congo,2015,17,16,1
JPN,Japan,COG,Congo,2016,21,22,-1
JPN,Japan,COG,Congo,2017,12,25,-13
KOR,Korea,COG,Congo,2008,4,5,-1
KOR,Korea,COG,Congo,2009,9,6,3
KOR,Korea,COG,Congo,2010,3,5,-2
KOR,Korea,COG,Congo,2011,5,8,-3
KOR,Korea,COG,Congo,2012,5,1,4
KOR,Korea,COG,Congo,2013,3,5,-2
KOR,Korea,COG,Congo,2014,8,33,-25
KOR,Korea,COG,Congo,2015,22,9,13
KOR,Korea,COG,Congo,2016,32,4,28
KOR,Korea,COG,Congo,2017,2,2,0
LUX,Luxembourg,COG,Congo,2008,4,6,-2
LUX,Luxembourg,COG,Congo,2009,3,8,-5
LUX,Luxembourg,COG,Congo,2010,3,6,-3
LUX,Luxembourg,COG,Congo,2011,1,6,-5
LUX,Luxembourg,COG,Congo,2012,2,3,-1
LUX,Luxembourg,COG,Congo,2013,3,5,-2
LUX,Luxembourg,COG,Congo,2014,4,3,1
LUX,Luxembourg,COG,Congo,2015,2,4,-2
LUX,Luxembourg,COG,Congo,2016,2,2,0
LUX,Luxembourg,COG,Congo,2017,1,3,-2
MEX,Mexico,COG,Congo,2008,0,7,-7
MEX,Mexico,COG,Congo,2009,0,8,-8
MEX,Mexico,COG,Congo,2010,0,4,-4
MEX,Mexico,COG,Congo,2011,0,14,-14
MEX,Mexico,COG,Congo,2012,0,8,-8
MEX,Mexico,COG,Congo,2013,0,19,-19
MEX,Mexico,COG,Congo,2014,0,11,-11
MEX,Mexico,COG,Congo,2015,0,7,-7
MEX,Mexico,COG,Congo,2016,0,7,-7
MEX,Mexico,COG,Congo,2017,0,2,-2
NLD,Netherlands,COG,Congo,2008,21,39,-18
NLD,Netherlands,COG,Congo,2009,9,61,-52
NLD,Netherlands,COG,Congo,2010,19,39,-20
NLD,Netherlands,COG,Congo,2011,20,42,-22
NLD,Netherlands,COG,Congo,2012,18,47,-29
NLD,Netherlands,COG,Congo,2013,13,45,-32
NLD,Netherlands,COG,Congo,2014,17,73,-56
NLD,Netherlands,COG,Congo,2015,26,73,-47
NLD,Netherlands,COG,Congo,2016,17,30,-13
NLD,Netherlands,COG,Congo,2017,11,22,-11
NZL,New Zealand,COG,Congo,2008,0,39,-39
NZL,New Zealand,COG,Congo,2009,1,24,-23
NZL,New Zealand,COG,Congo,2010,0,9,-9
NZL,New Zealand,COG,Congo,2011,1,3,-2
NZL,New Zealand,COG,Congo,2012,1,3,-2
NZL,New Zealand,COG,Congo,2015,0,1,-1
NZL,New Zealand,COG,Congo,2016,0,2,-2
NZL,New Zealand,COG,Congo,2017,1,2,-1
NOR,Norway,COG,Congo,2008,9,9,0
NOR,Norway,COG,Congo,2009,3,75,-72
NOR,Norway,COG,Congo,2010,10,99,-89
NOR,Norway,COG,Congo,2011,12,67,-55
NOR,Norway,COG,Congo,2012,11,62,-51
NOR,Norway,COG,Congo,2013,31,246,-215
NOR,Norway,COG,Congo,2014,14,158,-144
NOR,Norway,COG,Congo,2015,13,247,-234
NOR,Norway,COG,Congo,2016,11,51,-40
NOR,Norway,COG,Congo,2017,7,84,-77
POL,Poland,COG,Congo,2008,0,56,-56
POL,Poland,COG,Congo,2009,0,85,-85
POL,Poland,COG,Congo,2010,0,63,-63
POL,Poland,COG,Congo,2011,0,53,-53
POL,Poland,COG,Congo,2012,0,51,-51
POL,Poland,COG,Congo,2013,0,49,-49
POL,Poland,COG,Congo,2014,0,22,-22
POL,Poland,COG,Congo,2015,0,44,-44
POL,Poland,COG,Congo,2016,0,53,-53
POL,Poland,COG,Congo,2017,0,56,-56
SVK,Slovak Republic,COG,Congo,2008,1,1,0
SVK,Slovak Republic,COG,Congo,2009,0,3,-3
SVK,Slovak Republic,COG,Congo,2011,0,1,-1
SVK,Slovak Republic,COG,Congo,2013,0,1,-1
SVK,Slovak Republic,COG,Congo,2015,0,1,-1
SVK,Slovak Republic,COG,Congo,2017,0,1,-1
ESP,Spain,COG,Congo,2008,106,186,-80
ESP,Spain,COG,Congo,2009,138,136,2
ESP,Spain,COG,Congo,2010,159,98,61
ESP,Spain,COG,Congo,2011,157,125,32
ESP,Spain,COG,Congo,2012,156,111,45
ESP,Spain,COG,Congo,2013,144,138,6
ESP,Spain,COG,Congo,2014,92,132,-40
ESP,Spain,COG,Congo,2015,57,120,-63
ESP,Spain,COG,Congo,2016,61,136,-75
ESP,Spain,COG,Congo,2017,126,145,-19
SWE,Sweden,COG,Congo,2008,4,67,-63
SWE,Sweden,COG,Congo,2009,2,62,-60
SWE,Sweden,COG,Congo,2010,2,54,-52
SWE,Sweden,COG,Congo,2011,4,68,-64
SWE,Sweden,COG,Congo,2012,1,50,-49
SWE,Sweden,COG,Congo,2013,5,42,-37
SWE,Sweden,COG,Congo,2014,3,19,-16
SWE,Sweden,COG,Congo,2015,6,23,-17
SWE,Sweden,COG,Congo,2016,5,24,-19
SWE,Sweden,COG,Congo,2017,2,18,-16
CHE,Switzerland,COG,Congo,2010,5,19,-14
CHE,Switzerland,COG,Congo,2011,7,23,-16
CHE,Switzerland,COG,Congo,2012,5,20,-15
CHE,Switzerland,COG,Congo,2013,8,26,-18
CHE,Switzerland,COG,Congo,2014,3,10,-7
CHE,Switzerland,COG,Congo,2015,8,8,0
CHE,Switzerland,COG,Congo,2016,4,18,-14
CHE,Switzerland,COG,Congo,2017,3,13,-10
TUR,Turkey,COG,Congo,2010,0,16,-16
GBR,United Kingdom,COG,Congo,2011,0,1000,-1000
GBR,United Kingdom,COG,Congo,2014,0,1000,-1000
USA,United States,COG,Congo,2008,0,950,-950
USA,United States,COG,Congo,2009,0,1563,-1563
USA,United States,COG,Congo,2010,0,968,-968
USA,United States,COG,Congo,2011,0,1371,-1371
USA,United States,COG,Congo,2012,0,1461,-1461
USA,United States,COG,Congo,2013,0,1059,-1059
USA,United States,COG,Congo,2014,0,552,-552
USA,United States,COG,Congo,2015,0,496,-496
USA,United States,COG,Congo,2016,0,625,-625
USA,United States,COG,Congo,2017,0,632,-632
CHL,Chile,COG,Congo,2008,0,0,0
CHL,Chile,COG,Congo,2009,0,0,0
CHL,Chile,COG,Congo,2010,0,1,-1
CHL,Chile,COG,Congo,2011,0,0,0
CHL,Chile,COG,Congo,2012,0,3,-3
CHL,Chile,COG,Congo,2013,0,0,0
CHL,Chile,COG,Congo,2014,0,0,0
CHL,Chile,COG,Congo,2015,0,0,0
CHL,Chile,COG,Congo,2016,0,0,0
EST,Estonia,COG,Congo,2008,0,0,0
EST,Estonia,COG,Congo,2009,0,0,0
EST,Estonia,COG,Congo,2010,0,0,0
EST,Estonia,COG,Congo,2011,0,0,0
EST,Estonia,COG,Congo,2012,0,0,0
EST,Estonia,COG,Congo,2013,0,0,0
EST,Estonia,COG,Congo,2014,0,0,0
EST,Estonia,COG,Congo,2015,0,0,0
EST,Estonia,COG,Congo,2016,0,0,0
EST,Estonia,COG,Congo,2017,0,1,-1
AUS,Australia,COK,Cook Islands,2008,17,0,17
AUS,Australia,COK,Cook Islands,2009,12,0,12
AUS,Australia,COK,Cook Islands,2010,5,0,5
AUS,Australia,COK,Cook Islands,2011,7,0,7
AUS,Australia,COK,Cook Islands,2012,11,0,11
AUS,Australia,COK,Cook Islands,2013,12,0,12
AUS,Australia,COK,Cook Islands,2014,8,0,8
AUS,Australia,COK,Cook Islands,2015,0,0,0
AUS,Australia,COK,Cook Islands,2016,0,0,0
AUS,Australia,COK,Cook Islands,2017,0,0,0
AUT,Austria,COK,Cook Islands,2014,0,0,0
AUT,Austria,COK,Cook Islands,2015,0,0,0
AUT,Austria,COK,Cook Islands,2016,0,0,0
AUT,Austria,COK,Cook Islands,2017,0,0,0
BEL,Belgium,COK,Cook Islands,2010,0,0,0
CAN,Canada,COK,Cook Islands,2008,0,0,0
CAN,Canada,COK,Cook Islands,2009,0,0,0
CAN,Canada,COK,Cook Islands,2010,0,0,0
CAN,Canada,COK,Cook Islands,2011,0,0,0
CAN,Canada,COK,Cook Islands,2012,0,0,0
CAN,Canada,COK,Cook Islands,2013,0,0,0
CAN,Canada,COK,Cook Islands,2014,0,0,0
CAN,Canada,COK,Cook Islands,2015,0,0,0
CAN,Canada,COK,Cook Islands,2016,0,0,0
CAN,Canada,COK,Cook Islands,2017,0,0,0
DNK,Denmark,COK,Cook Islands,2015,0,0,0
DNK,Denmark,COK,Cook Islands,2016,0,0,0
FIN,Finland,COK,Cook Islands,2008,0,0,0
FIN,Finland,COK,Cook Islands,2009,0,0,0
FIN,Finland,COK,Cook Islands,2010,0,0,0
FIN,Finland,COK,Cook Islands,2011,0,0,0
FIN,Finland,COK,Cook Islands,2012,0,0,0
FIN,Finland,COK,Cook Islands,2013,0,0,0
FIN,Finland,COK,Cook Islands,2014,0,0,0
FIN,Finland,COK,Cook Islands,2015,0,0,0
FIN,Finland,COK,Cook Islands,2016,0,0,0
FIN,Finland,COK,Cook Islands,2017,0,0,0
FRA,France,COK,Cook Islands,2008,0,0,0
FRA,France,COK,Cook Islands,2009,0,0,0
FRA,France,COK,Cook Islands,2010,0,0,0
FRA,France,COK,Cook Islands,2011,0,0,0
FRA,France,COK,Cook Islands,2012,0,0,0
FRA,France,COK,Cook Islands,2013,0,0,0
FRA,France,COK,Cook Islands,2014,0,0,0
FRA,France,COK,Cook Islands,2015,0,0,0
FRA,France,COK,Cook Islands,2016,0,0,0
FRA,France,COK,Cook Islands,2017,0,0,0
DEU,Germany,COK,Cook Islands,2008,0,0,0
DEU,Germany,COK,Cook Islands,2009,0,0,0
DEU,Germany,COK,Cook Islands,2010,0,2,-2
DEU,Germany,COK,Cook Islands,2011,0,0,0
DEU,Germany,COK,Cook Islands,2012,1,0,1
DEU,Germany,COK,Cook Islands,2013,0,0,0
DEU,Germany,COK,Cook Islands,2014,0,0,0
DEU,Germany,COK,Cook Islands,2015,0,0,0
DEU,Germany,COK,Cook Islands,2016,0,0,0
DEU,Germany,COK,Cook Islands,2017,0,0,0
HUN,Hungary,COK,Cook Islands,2008,0,0,0
HUN,Hungary,COK,Cook Islands,2009,0,0,0
HUN,Hungary,COK,Cook Islands,2010,0,0,0
HUN,Hungary,COK,Cook Islands,2011,0,0,0
HUN,Hungary,COK,Cook Islands,2012,0,0,0
HUN,Hungary,COK,Cook Islands,2013,0,0,0
HUN,Hungary,COK,Cook Islands,2014,0,0,0
HUN,Hungary,COK,Cook Islands,2015,0,0,0
HUN,Hungary,COK,Cook Islands,2016,0,0,0
HUN,Hungary,COK,Cook Islands,2017,0,0,0
ISL,Iceland,COK,Cook Islands,2016,0,0,0
ISL,Iceland,COK,Cook Islands,2017,0,0,0
JPN,Japan,COK,Cook Islands,2008,0,0,0
JPN,Japan,COK,Cook Islands,2009,0,0,0
JPN,Japan,COK,Cook Islands,2010,0,0,0
JPN,Japan,COK,Cook Islands,2011,0,0,0
JPN,Japan,COK,Cook Islands,2012,0,0,0
JPN,Japan,COK,Cook Islands,2013,0,0,0
JPN,Japan,COK,Cook Islands,2014,0,0,0
JPN,Japan,COK,Cook Islands,2015,0,0,0
JPN,Japan,COK,Cook Islands,2016,0,0,0
JPN,Japan,COK,Cook Islands,2017,0,0,0
KOR,Korea,COK,Cook Islands,2008,0,0,0
KOR,Korea,COK,Cook Islands,2009,0,0,0
KOR,Korea,COK,Cook Islands,2010,0,0,0
KOR,Korea,COK,Cook Islands,2011,0,0,0
KOR,Korea,COK,Cook Islands,2012,0,0,0
KOR,Korea,COK,Cook Islands,2013,0,0,0
KOR,Korea,COK,Cook Islands,2014,0,0,0
KOR,Korea,COK,Cook Islands,2015,0,0,0
KOR,Korea,COK,Cook Islands,2016,0,0,0
KOR,Korea,COK,Cook Islands,2017,0,0,0
LUX,Luxembourg,COK,Cook Islands,2008,0,0,0
LUX,Luxembourg,COK,Cook Islands,2009,0,0,0
LUX,Luxembourg,COK,Cook Islands,2010,0,0,0
LUX,Luxembourg,COK,Cook Islands,2011,0,0,0
LUX,Luxembourg,COK,Cook Islands,2012,0,0,0
LUX,Luxembourg,COK,Cook Islands,2013,0,0,0
LUX,Luxembourg,COK,Cook Islands,2014,0,0,0
LUX,Luxembourg,COK,Cook Islands,2015,0,0,0
LUX,Luxembourg,COK,Cook Islands,2016,0,0,0
LUX,Luxembourg,COK,Cook Islands,2017,0,0,0
MEX,Mexico,COK,Cook Islands,2008,0,3,-3
MEX,Mexico,COK,Cook Islands,2012,0,0,0
MEX,Mexico,COK,Cook Islands,2013,0,0,0
MEX,Mexico,COK,Cook Islands,2014,0,0,0
NOR,Norway,COK,Cook Islands,2008,0,0,0
NOR,Norway,COK,Cook Islands,2009,0,0,0
NOR,Norway,COK,Cook Islands,2010,0,0,0
NOR,Norway,COK,Cook Islands,2011,0,0,0
NOR,Norway,COK,Cook Islands,2012,0,0,0
NOR,Norway,COK,Cook Islands,2013,0,0,0
NOR,Norway,COK,Cook Islands,2014,0,0,0
NOR,Norway,COK,Cook Islands,2015,0,0,0
NOR,Norway,COK,Cook Islands,2016,0,0,0
NOR,Norway,COK,Cook Islands,2017,0,0,0
POL,Poland,COK,Cook Islands,2009,0,0,0
POL,Poland,COK,Cook Islands,2010,0,0,0
POL,Poland,COK,Cook Islands,2011,0,0,0
POL,Poland,COK,Cook Islands,2012,0,0,0
POL,Poland,COK,Cook Islands,2013,0,0,0
POL,Poland,COK,Cook Islands,2014,0,0,0
POL,Poland,COK,Cook Islands,2015,0,0,0
POL,Poland,COK,Cook Islands,2016,0,0,0
POL,Poland,COK,Cook Islands,2017,0,0,0
SVK,Slovak Republic,COK,Cook Islands,2008,0,0,0
ESP,Spain,COK,Cook Islands,2008,0,2,-2
ESP,Spain,COK,Cook Islands,2009,0,4,-4
ESP,Spain,COK,Cook Islands,2010,0,2,-2
ESP,Spain,COK,Cook Islands,2011,1,1,0
ESP,Spain,COK,Cook Islands,2012,0,4,-4
ESP,Spain,COK,Cook Islands,2013,0,4,-4
ESP,Spain,COK,Cook Islands,2014,0,0,0
ESP,Spain,COK,Cook Islands,2015,0,0,0
ESP,Spain,COK,Cook Islands,2016,0,1,-1
ESP,Spain,COK,Cook Islands,2017,0,4,-4
SWE,Sweden,COK,Cook Islands,2008,0,0,0
SWE,Sweden,COK,Cook Islands,2009,0,0,0
SWE,Sweden,COK,Cook Islands,2010,0,0,0
SWE,Sweden,COK,Cook Islands,2011,0,0,0
SWE,Sweden,COK,Cook Islands,2012,0,0,0
SWE,Sweden,COK,Cook Islands,2013,0,0,0
SWE,Sweden,COK,Cook Islands,2014,0,0,0
SWE,Sweden,COK,Cook Islands,2015,0,0,0
USA,United States,COK,Cook Islands,2011,0,3,-3
USA,United States,COK,Cook Islands,2012,0,0,0
USA,United States,COK,Cook Islands,2013,0,0,0
USA,United States,COK,Cook Islands,2014,0,0,0
CHL,Chile,COK,Cook Islands,2008,0,0,0
CHL,Chile,COK,Cook Islands,2009,0,0,0
CHL,Chile,COK,Cook Islands,2010,0,0,0
CHL,Chile,COK,Cook Islands,2011,0,0,0
CHL,Chile,COK,Cook Islands,2012,0,0,0
CHL,Chile,COK,Cook Islands,2013,0,0,0
CHL,Chile,COK,Cook Islands,2014,0,0,0
CHL,Chile,COK,Cook Islands,2015,0,0,0
CHL,Chile,COK,Cook Islands,2016,0,0,0
EST,Estonia,COK,Cook Islands,2017,0,0,0
AUS,Australia,CRI,Costa Rica,2008,0,7,-7
AUS,Australia,CRI,Costa Rica,2009,5,3,2
AUS,Australia,CRI,Costa Rica,2010,0,10,-10
AUS,Australia,CRI,Costa Rica,2011,0,14,-14
AUS,Australia,CRI,Costa Rica,2012,5,14,-9
AUS,Australia,CRI,Costa Rica,2013,8,17,-9
AUS,Australia,CRI,Costa Rica,2014,7,11,-4
AUS,Australia,CRI,Costa Rica,2015,0,11,-11
AUS,Australia,CRI,Costa Rica,2016,0,12,-12
AUS,Australia,CRI,Costa Rica,2017,0,11,-11
AUT,Austria,CRI,Costa Rica,2008,21,14,7
AUT,Austria,CRI,Costa Rica,2009,16,24,-8
AUT,Austria,CRI,Costa Rica,2010,17,16,1
AUT,Austria,CRI,Costa Rica,2011,9,17,-8
AUT,Austria,CRI,Costa Rica,2012,10,14,-4
AUT,Austria,CRI,Costa Rica,2013,15,21,-6
AUT,Austria,CRI,Costa Rica,2014,10,21,-11
AUT,Austria,CRI,Costa Rica,2015,21,27,-6
AUT,Austria,CRI,Costa Rica,2016,12,28,-16
AUT,Austria,CRI,Costa Rica,2017,25,37,-12
BEL,Belgium,CRI,Costa Rica,2008,0,25,-25
BEL,Belgium,CRI,Costa Rica,2009,0,28,-28
BEL,Belgium,CRI,Costa Rica,2010,9,37,-28
BEL,Belgium,CRI,Costa Rica,2011,0,27,-27
BEL,Belgium,CRI,Costa Rica,2012,34,37,-3
BEL,Belgium,CRI,Costa Rica,2013,26,29,-3
BEL,Belgium,CRI,Costa Rica,2014,11,12,-1
BEL,Belgium,CRI,Costa Rica,2015,13,19,-6
BEL,Belgium,CRI,Costa Rica,2016,8,31,-23
BEL,Belgium,CRI,Costa Rica,2017,16,29,-13
CAN,Canada,CRI,Costa Rica,2008,0,246,-246
CAN,Canada,CRI,Costa Rica,2009,0,217,-217
CAN,Canada,CRI,Costa Rica,2010,0,190,-190
CAN,Canada,CRI,Costa Rica,2011,0,148,-148
CAN,Canada,CRI,Costa Rica,2012,0,183,-183
CAN,Canada,CRI,Costa Rica,2013,0,122,-122
CAN,Canada,CRI,Costa Rica,2014,0,165,-165
CAN,Canada,CRI,Costa Rica,2015,0,121,-121
CAN,Canada,CRI,Costa Rica,2016,0,135,-135
CAN,Canada,CRI,Costa Rica,2017,0,135,-135
CZE,Czech Republic,CRI,Costa Rica,2008,0,3,-3
CZE,Czech Republic,CRI,Costa Rica,2009,0,19,-19
CZE,Czech Republic,CRI,Costa Rica,2010,0,10,-10
CZE,Czech Republic,CRI,Costa Rica,2011,0,15,-15
CZE,Czech Republic,CRI,Costa Rica,2012,2,3,-1
CZE,Czech Republic,CRI,Costa Rica,2013,3,12,-9
CZE,Czech Republic,CRI,Costa Rica,2014,4,15,-11
CZE,Czech Republic,CRI,Costa Rica,2015,6,9,-3
CZE,Czech Republic,CRI,Costa Rica,2016,5,16,-11
CZE,Czech Republic,CRI,Costa Rica,2017,5,44,-39
DNK,Denmark,CRI,Costa Rica,2008,5,9,-4
DNK,Denmark,CRI,Costa Rica,2009,14,12,2
DNK,Denmark,CRI,Costa Rica,2010,15,14,1
DNK,Denmark,CRI,Costa Rica,2011,9,22,-13
DNK,Denmark,CRI,Costa Rica,2012,16,9,7
DNK,Denmark,CRI,Costa Rica,2013,11,10,1
DNK,Denmark,CRI,Costa Rica,2014,17,14,3
DNK,Denmark,CRI,Costa Rica,2015,16,14,2
DNK,Denmark,CRI,Costa Rica,2016,19,12,7
DNK,Denmark,CRI,Costa Rica,2017,33,14,19
FIN,Finland,CRI,Costa Rica,2008,2,2,0
FIN,Finland,CRI,Costa Rica,2009,1,6,-5
FIN,Finland,CRI,Costa Rica,2010,0,6,-6
FIN,Finland,CRI,Costa Rica,2011,1,5,-4
FIN,Finland,CRI,Costa Rica,2012,3,6,-3
FIN,Finland,CRI,Costa Rica,2013,4,4,0
FIN,Finland,CRI,Costa Rica,2014,2,7,-5
FIN,Finland,CRI,Costa Rica,2015,2,4,-2
FIN,Finland,CRI,Costa Rica,2016,3,5,-2
FIN,Finland,CRI,Costa Rica,2017,1,6,-5
FRA,France,CRI,Costa Rica,2008,0,39,-39
FRA,France,CRI,Costa Rica,2009,0,34,-34
FRA,France,CRI,Costa Rica,2010,0,31,-31
FRA,France,CRI,Costa Rica,2011,0,35,-35
FRA,France,CRI,Costa Rica,2012,0,44,-44
FRA,France,CRI,Costa Rica,2013,0,38,-38
FRA,France,CRI,Costa Rica,2014,0,70,-70
FRA,France,CRI,Costa Rica,2015,0,81,-81
FRA,France,CRI,Costa Rica,2016,0,67,-67
FRA,France,CRI,Costa Rica,2017,0,70,-70
DEU,Germany,CRI,Costa Rica,2008,168,180,-12
DEU,Germany,CRI,Costa Rica,2009,210,239,-29
DEU,Germany,CRI,Costa Rica,2010,182,222,-40
DEU,Germany,CRI,Costa Rica,2011,154,219,-65
DEU,Germany,CRI,Costa Rica,2012,144,242,-98
DEU,Germany,CRI,Costa Rica,2013,181,270,-89
DEU,Germany,CRI,Costa Rica,2014,170,271,-101
DEU,Germany,CRI,Costa Rica,2015,186,323,-137
DEU,Germany,CRI,Costa Rica,2016,197,320,-123
DEU,Germany,CRI,Costa Rica,2017,214,333,-119
HUN,Hungary,CRI,Costa Rica,2008,0,2,-2
HUN,Hungary,CRI,Costa Rica,2009,0,2,-2
HUN,Hungary,CRI,Costa Rica,2010,2,4,-2
HUN,Hungary,CRI,Costa Rica,2011,1,4,-3
HUN,Hungary,CRI,Costa Rica,2012,1,5,-4
HUN,Hungary,CRI,Costa Rica,2013,0,10,-10
HUN,Hungary,CRI,Costa Rica,2014,1,9,-8
HUN,Hungary,CRI,Costa Rica,2015,4,6,-2
HUN,Hungary,CRI,Costa Rica,2016,2,8,-6
HUN,Hungary,CRI,Costa Rica,2017,0,6,-6
ISL,Iceland,CRI,Costa Rica,2008,4,1,3
ISL,Iceland,CRI,Costa Rica,2009,3,2,1
ISL,Iceland,CRI,Costa Rica,2010,2,2,0
ISL,Iceland,CRI,Costa Rica,2011,2,1,1
ISL,Iceland,CRI,Costa Rica,2012,0,0,0
ISL,Iceland,CRI,Costa Rica,2013,0,2,-2
ISL,Iceland,CRI,Costa Rica,2014,1,1,0
ISL,Iceland,CRI,Costa Rica,2015,1,2,-1
ISL,Iceland,CRI,Costa Rica,2016,0,7,-7
ISL,Iceland,CRI,Costa Rica,2017,2,2,0
ITA,Italy,CRI,Costa Rica,2008,10,78,-68
ITA,Italy,CRI,Costa Rica,2009,14,56,-42
ITA,Italy,CRI,Costa Rica,2010,8,68,-60
ITA,Italy,CRI,Costa Rica,2011,12,61,-49
ITA,Italy,CRI,Costa Rica,2012,6,66,-60
ITA,Italy,CRI,Costa Rica,2013,4,44,-40
ITA,Italy,CRI,Costa Rica,2014,6,48,-42
ITA,Italy,CRI,Costa Rica,2015,3,48,-45
ITA,Italy,CRI,Costa Rica,2016,0,48,-48
ITA,Italy,CRI,Costa Rica,2017,8,61,-53
JPN,Japan,CRI,Costa Rica,2008,75,77,-2
JPN,Japan,CRI,Costa Rica,2009,86,89,-3
JPN,Japan,CRI,Costa Rica,2010,95,98,-3
JPN,Japan,CRI,Costa Rica,2011,85,85,0
JPN,Japan,CRI,Costa Rica,2012,50,59,-9
JPN,Japan,CRI,Costa Rica,2013,76,82,-6
JPN,Japan,CRI,Costa Rica,2014,62,70,-8
JPN,Japan,CRI,Costa Rica,2015,75,78,-3
JPN,Japan,CRI,Costa Rica,2016,79,90,-11
JPN,Japan,CRI,Costa Rica,2017,68,74,-6
KOR,Korea,CRI,Costa Rica,2008,7,8,-1
KOR,Korea,CRI,Costa Rica,2009,6,13,-7
KOR,Korea,CRI,Costa Rica,2010,11,11,0
KOR,Korea,CRI,Costa Rica,2011,12,11,1
KOR,Korea,CRI,Costa Rica,2012,10,13,-3
KOR,Korea,CRI,Costa Rica,2013,8,12,-4
KOR,Korea,CRI,Costa Rica,2014,13,8,5
KOR,Korea,CRI,Costa Rica,2015,11,23,-12
KOR,Korea,CRI,Costa Rica,2016,17,28,-11
KOR,Korea,CRI,Costa Rica,2017,29,15,14
LUX,Luxembourg,CRI,Costa Rica,2008,0,2,-2
LUX,Luxembourg,CRI,Costa Rica,2009,2,1,1
LUX,Luxembourg,CRI,Costa Rica,2010,1,1,0
LUX,Luxembourg,CRI,Costa Rica,2011,1,1,0
LUX,Luxembourg,CRI,Costa Rica,2012,0,2,-2
LUX,Luxembourg,CRI,Costa Rica,2013,0,2,-2
LUX,Luxembourg,CRI,Costa Rica,2014,0,1,-1
LUX,Luxembourg,CRI,Costa Rica,2015,0,0,0
LUX,Luxembourg,CRI,Costa Rica,2016,2,2,0
LUX,Luxembourg,CRI,Costa Rica,2017,0,5,-5
MEX,Mexico,CRI,Costa Rica,2008,0,101,-101
MEX,Mexico,CRI,Costa Rica,2009,0,138,-138
MEX,Mexico,CRI,Costa Rica,2010,0,162,-162
MEX,Mexico,CRI,Costa Rica,2011,0,139,-139
MEX,Mexico,CRI,Costa Rica,2012,0,114,-114
MEX,Mexico,CRI,Costa Rica,2013,0,408,-408
MEX,Mexico,CRI,Costa Rica,2014,0,264,-264
MEX,Mexico,CRI,Costa Rica,2015,0,238,-238
MEX,Mexico,CRI,Costa Rica,2016,0,220,-220
MEX,Mexico,CRI,Costa Rica,2017,0,180,-180
NLD,Netherlands,CRI,Costa Rica,2008,22,39,-17
NLD,Netherlands,CRI,Costa Rica,2009,31,45,-14
NLD,Netherlands,CRI,Costa Rica,2010,28,52,-24
NLD,Netherlands,CRI,Costa Rica,2011,24,41,-17
NLD,Netherlands,CRI,Costa Rica,2012,42,62,-20
NLD,Netherlands,CRI,Costa Rica,2013,45,39,6
NLD,Netherlands,CRI,Costa Rica,2014,33,61,-28
NLD,Netherlands,CRI,Costa Rica,2015,37,62,-25
NLD,Netherlands,CRI,Costa Rica,2016,38,64,-26
NLD,Netherlands,CRI,Costa Rica,2017,24,63,-39
NZL,New Zealand,CRI,Costa Rica,2008,2,19,-17
NZL,New Zealand,CRI,Costa Rica,2009,3,9,-6
NZL,New Zealand,CRI,Costa Rica,2010,6,6,0
NZL,New Zealand,CRI,Costa Rica,2011,6,14,-8
NZL,New Zealand,CRI,Costa Rica,2012,1,11,-10
NZL,New Zealand,CRI,Costa Rica,2013,1,10,-9
NZL,New Zealand,CRI,Costa Rica,2014,4,3,1
NZL,New Zealand,CRI,Costa Rica,2015,1,3,-2
NZL,New Zealand,CRI,Costa Rica,2016,1,13,-12
NZL,New Zealand,CRI,Costa Rica,2017,2,11,-9
NOR,Norway,CRI,Costa Rica,2008,5,13,-8
NOR,Norway,CRI,Costa Rica,2009,16,14,2
NOR,Norway,CRI,Costa Rica,2010,13,5,8
NOR,Norway,CRI,Costa Rica,2011,12,17,-5
NOR,Norway,CRI,Costa Rica,2012,9,10,-1
NOR,Norway,CRI,Costa Rica,2013,5,18,-13
NOR,Norway,CRI,Costa Rica,2014,7,18,-11
NOR,Norway,CRI,Costa Rica,2015,13,10,3
NOR,Norway,CRI,Costa Rica,2016,10,12,-2
NOR,Norway,CRI,Costa Rica,2017,0,13,-13
POL,Poland,CRI,Costa Rica,2009,0,4,-4
POL,Poland,CRI,Costa Rica,2010,0,11,-11
POL,Poland,CRI,Costa Rica,2011,0,10,-10
POL,Poland,CRI,Costa Rica,2012,0,15,-15
POL,Poland,CRI,Costa Rica,2013,0,12,-12
POL,Poland,CRI,Costa Rica,2014,0,5,-5
POL,Poland,CRI,Costa Rica,2015,0,10,-10
POL,Poland,CRI,Costa Rica,2016,0,18,-18
POL,Poland,CRI,Costa Rica,2017,0,19,-19
SVK,Slovak Republic,CRI,Costa Rica,2008,0,2,-2
SVK,Slovak Republic,CRI,Costa Rica,2009,1,1,0
SVK,Slovak Republic,CRI,Costa Rica,2010,0,1,-1
SVK,Slovak Republic,CRI,Costa Rica,2013,0,3,-3
SVK,Slovak Republic,CRI,Costa Rica,2015,0,3,-3
ESP,Spain,CRI,Costa Rica,2008,157,415,-258
ESP,Spain,CRI,Costa Rica,2009,249,297,-48
ESP,Spain,CRI,Costa Rica,2010,250,285,-35
ESP,Spain,CRI,Costa Rica,2011,277,404,-127
ESP,Spain,CRI,Costa Rica,2012,234,350,-116
ESP,Spain,CRI,Costa Rica,2013,376,354,22
ESP,Spain,CRI,Costa Rica,2014,217,408,-191
ESP,Spain,CRI,Costa Rica,2015,160,425,-265
ESP,Spain,CRI,Costa Rica,2016,181,601,-420
ESP,Spain,CRI,Costa Rica,2017,288,731,-443
SWE,Sweden,CRI,Costa Rica,2008,3,26,-23
SWE,Sweden,CRI,Costa Rica,2009,2,16,-14
SWE,Sweden,CRI,Costa Rica,2010,5,20,-15
SWE,Sweden,CRI,Costa Rica,2011,8,19,-11
SWE,Sweden,CRI,Costa Rica,2012,11,26,-15
SWE,Sweden,CRI,Costa Rica,2013,10,23,-13
SWE,Sweden,CRI,Costa Rica,2014,5,9,-4
SWE,Sweden,CRI,Costa Rica,2015,13,18,-5
SWE,Sweden,CRI,Costa Rica,2016,6,23,-17
SWE,Sweden,CRI,Costa Rica,2017,7,16,-9
CHE,Switzerland,CRI,Costa Rica,2010,26,66,-40
CHE,Switzerland,CRI,Costa Rica,2011,22,65,-43
CHE,Switzerland,CRI,Costa Rica,2012,30,62,-32
CHE,Switzerland,CRI,Costa Rica,2013,32,57,-25
CHE,Switzerland,CRI,Costa Rica,2014,52,45,7
CHE,Switzerland,CRI,Costa Rica,2015,30,65,-35
CHE,Switzerland,CRI,Costa Rica,2016,29,81,-52
CHE,Switzerland,CRI,Costa Rica,2017,35,68,-33
USA,United States,CRI,Costa Rica,2008,0,2090,-2090
USA,United States,CRI,Costa Rica,2009,0,2384,-2384
USA,United States,CRI,Costa Rica,2010,0,2164,-2164
USA,United States,CRI,Costa Rica,2011,0,2135,-2135
USA,United States,CRI,Costa Rica,2012,0,2020,-2020
USA,United States,CRI,Costa Rica,2013,0,2114,-2114
USA,United States,CRI,Costa Rica,2014,0,1966,-1966
USA,United States,CRI,Costa Rica,2015,0,2029,-2029
USA,United States,CRI,Costa Rica,2016,0,2224,-2224
USA,United States,CRI,Costa Rica,2017,0,2184,-2184
CHL,Chile,CRI,Costa Rica,2008,0,50,-50
CHL,Chile,CRI,Costa Rica,2009,0,44,-44
CHL,Chile,CRI,Costa Rica,2010,0,62,-62
CHL,Chile,CRI,Costa Rica,2011,0,95,-95
CHL,Chile,CRI,Costa Rica,2012,0,92,-92
CHL,Chile,CRI,Costa Rica,2013,0,80,-80
CHL,Chile,CRI,Costa Rica,2014,0,105,-105
CHL,Chile,CRI,Costa Rica,2015,0,108,-108
CHL,Chile,CRI,Costa Rica,2016,0,89,-89
EST,Estonia,CRI,Costa Rica,2008,0,0,0
EST,Estonia,CRI,Costa Rica,2009,0,0,0
EST,Estonia,CRI,Costa Rica,2010,0,0,0
EST,Estonia,CRI,Costa Rica,2011,0,1,-1
EST,Estonia,CRI,Costa Rica,2012,0,1,-1
EST,Estonia,CRI,Costa Rica,2013,0,0,0
EST,Estonia,CRI,Costa Rica,2014,0,0,0
EST,Estonia,CRI,Costa Rica,2015,0,2,-2
EST,Estonia,CRI,Costa Rica,2016,0,0,0
EST,Estonia,CRI,Costa Rica,2017,0,2,-2
SVN,Slovenia,CRI,Costa Rica,2008,0,1,-1
SVN,Slovenia,CRI,Costa Rica,2009,0,2,-2
SVN,Slovenia,CRI,Costa Rica,2013,0,1,-1
SVN,Slovenia,CRI,Costa Rica,2015,0,1,-1
AUS,Australia,CIV,Côte d'Ivoire,2008,0,8,-8
AUS,Australia,CIV,Côte d'Ivoire,2009,5,12,-7
AUS,Australia,CIV,Côte d'Ivoire,2010,0,4,-4
AUS,Australia,CIV,Côte d'Ivoire,2011,0,4,-4
AUS,Australia,CIV,Côte d'Ivoire,2012,0,16,-16
AUS,Australia,CIV,Côte d'Ivoire,2013,0,7,-7
AUS,Australia,CIV,Côte d'Ivoire,2014,0,9,-9
AUS,Australia,CIV,Côte d'Ivoire,2015,0,5,-5
AUS,Australia,CIV,Côte d'Ivoire,2016,0,6,-6
AUS,Australia,CIV,Côte d'Ivoire,2017,0,6,-6
AUT,Austria,CIV,Côte d'Ivoire,2008,13,22,-9
AUT,Austria,CIV,Côte d'Ivoire,2009,10,13,-3
AUT,Austria,CIV,Côte d'Ivoire,2010,18,24,-6
AUT,Austria,CIV,Côte d'Ivoire,2011,12,31,-19
AUT,Austria,CIV,Côte d'Ivoire,2012,10,24,-14
AUT,Austria,CIV,Côte d'Ivoire,2013,3,32,-29
AUT,Austria,CIV,Côte d'Ivoire,2014,14,30,-16
AUT,Austria,CIV,Côte d'Ivoire,2015,15,37,-22
AUT,Austria,CIV,Côte d'Ivoire,2016,21,32,-11
AUT,Austria,CIV,Côte d'Ivoire,2017,22,28,-6
BEL,Belgium,CIV,Côte d'Ivoire,2008,0,236,-236
BEL,Belgium,CIV,Côte d'Ivoire,2009,0,240,-240
BEL,Belgium,CIV,Côte d'Ivoire,2010,75,286,-211
BEL,Belgium,CIV,Côte d'Ivoire,2011,0,334,-334
BEL,Belgium,CIV,Côte d'Ivoire,2012,142,429,-287
BEL,Belgium,CIV,Côte d'Ivoire,2013,223,322,-99
BEL,Belgium,CIV,Côte d'Ivoire,2014,214,292,-78
BEL,Belgium,CIV,Côte d'Ivoire,2015,142,309,-167
BEL,Belgium,CIV,Côte d'Ivoire,2016,88,280,-192
BEL,Belgium,CIV,Côte d'Ivoire,2017,69,335,-266
CAN,Canada,CIV,Côte d'Ivoire,2008,0,646,-646
CAN,Canada,CIV,Côte d'Ivoire,2009,0,668,-668
CAN,Canada,CIV,Côte d'Ivoire,2010,0,1066,-1066
CAN,Canada,CIV,Côte d'Ivoire,2011,0,636,-636
CAN,Canada,CIV,Côte d'Ivoire,2012,0,1023,-1023
CAN,Canada,CIV,Côte d'Ivoire,2013,0,1170,-1170
CAN,Canada,CIV,Côte d'Ivoire,2014,0,1521,-1521
CAN,Canada,CIV,Côte d'Ivoire,2015,0,1361,-1361
CAN,Canada,CIV,Côte d'Ivoire,2016,0,1765,-1765
CAN,Canada,CIV,Côte d'Ivoire,2017,0,1400,-1400
CZE,Czech Republic,CIV,Côte d'Ivoire,2008,0,7,-7
CZE,Czech Republic,CIV,Côte d'Ivoire,2009,0,6,-6
CZE,Czech Republic,CIV,Côte d'Ivoire,2010,1,2,-1
CZE,Czech Republic,CIV,Côte d'Ivoire,2011,0,5,-5
CZE,Czech Republic,CIV,Côte d'Ivoire,2012,3,4,-1
CZE,Czech Republic,CIV,Côte d'Ivoire,2013,2,1,1
CZE,Czech Republic,CIV,Côte d'Ivoire,2014,1,8,-7
CZE,Czech Republic,CIV,Côte d'Ivoire,2015,3,5,-2
CZE,Czech Republic,CIV,Côte d'Ivoire,2016,3,3,0
CZE,Czech Republic,CIV,Côte d'Ivoire,2017,1,5,-4
DNK,Denmark,CIV,Côte d'Ivoire,2008,4,10,-6
DNK,Denmark,CIV,Côte d'Ivoire,2009,7,13,-6
DNK,Denmark,CIV,Côte d'Ivoire,2010,4,23,-19
DNK,Denmark,CIV,Côte d'Ivoire,2011,3,5,-2
DNK,Denmark,CIV,Côte d'Ivoire,2012,5,12,-7
DNK,Denmark,CIV,Côte d'Ivoire,2013,1,18,-17
DNK,Denmark,CIV,Côte d'Ivoire,2014,1,18,-17
DNK,Denmark,CIV,Côte d'Ivoire,2015,4,13,-9
DNK,Denmark,CIV,Côte d'Ivoire,2016,7,9,-2
DNK,Denmark,CIV,Côte d'Ivoire,2017,8,7,1
FIN,Finland,CIV,Côte d'Ivoire,2008,0,4,-4
FIN,Finland,CIV,Côte d'Ivoire,2009,1,9,-8
FIN,Finland,CIV,Côte d'Ivoire,2010,0,4,-4
FIN,Finland,CIV,Côte d'Ivoire,2011,0,8,-8
FIN,Finland,CIV,Côte d'Ivoire,2012,1,4,-3
FIN,Finland,CIV,Côte d'Ivoire,2013,1,8,-7
FIN,Finland,CIV,Côte d'Ivoire,2014,2,6,-4
FIN,Finland,CIV,Côte d'Ivoire,2015,1,10,-9
FIN,Finland,CIV,Côte d'Ivoire,2016,0,2,-2
FIN,Finland,CIV,Côte d'Ivoire,2017,2,3,-1
FRA,France,CIV,Côte d'Ivoire,2008,0,3419,-3419
FRA,France,CIV,Côte d'Ivoire,2009,0,3463,-3463
FRA,France,CIV,Côte d'Ivoire,2010,0,3307,-3307
FRA,France,CIV,Côte d'Ivoire,2011,0,3228,-3228
FRA,France,CIV,Côte d'Ivoire,2012,0,3362,-3362
FRA,France,CIV,Côte d'Ivoire,2013,0,3619,-3619
FRA,France,CIV,Côte d'Ivoire,2014,0,4341,-4341
FRA,France,CIV,Côte d'Ivoire,2015,0,3676,-3676
FRA,France,CIV,Côte d'Ivoire,2016,0,3888,-3888
FRA,France,CIV,Côte d'Ivoire,2017,0,4177,-4177
DEU,Germany,CIV,Côte d'Ivoire,2008,251,258,-7
DEU,Germany,CIV,Côte d'Ivoire,2009,200,236,-36
DEU,Germany,CIV,Côte d'Ivoire,2010,173,234,-61
DEU,Germany,CIV,Côte d'Ivoire,2011,174,362,-188
DEU,Germany,CIV,Côte d'Ivoire,2012,199,329,-130
DEU,Germany,CIV,Côte d'Ivoire,2013,189,562,-373
DEU,Germany,CIV,Côte d'Ivoire,2014,289,563,-274
DEU,Germany,CIV,Côte d'Ivoire,2015,310,1324,-1014
DEU,Germany,CIV,Côte d'Ivoire,2016,494,1692,-1198
DEU,Germany,CIV,Côte d'Ivoire,2017,751,1604,-853
HUN,Hungary,CIV,Côte d'Ivoire,2008,0,6,-6
HUN,Hungary,CIV,Côte d'Ivoire,2009,0,8,-8
HUN,Hungary,CIV,Côte d'Ivoire,2010,2,4,-2
HUN,Hungary,CIV,Côte d'Ivoire,2011,2,6,-4
HUN,Hungary,CIV,Côte d'Ivoire,2012,0,1,-1
HUN,Hungary,CIV,Côte d'Ivoire,2013,2,4,-2
HUN,Hungary,CIV,Côte d'Ivoire,2014,0,11,-11
HUN,Hungary,CIV,Côte d'Ivoire,2015,0,7,-7
HUN,Hungary,CIV,Côte d'Ivoire,2016,0,9,-9
HUN,Hungary,CIV,Côte d'Ivoire,2017,0,9,-9
ISL,Iceland,CIV,Côte d'Ivoire,2008,0,0,0
ISL,Iceland,CIV,Côte d'Ivoire,2009,0,0,0
ISL,Iceland,CIV,Côte d'Ivoire,2010,0,0,0
ISL,Iceland,CIV,Côte d'Ivoire,2011,0,0,0
ISL,Iceland,CIV,Côte d'Ivoire,2012,0,0,0
ISL,Iceland,CIV,Côte d'Ivoire,2013,0,0,0
ISL,Iceland,CIV,Côte d'Ivoire,2014,0,0,0
ISL,Iceland,CIV,Côte d'Ivoire,2015,0,0,0
ISL,Iceland,CIV,Côte d'Ivoire,2016,0,3,-3
ISL,Iceland,CIV,Côte d'Ivoire,2017,0,0,0
ITA,Italy,CIV,Côte d'Ivoire,2008,96,2255,-2159
ITA,Italy,CIV,Côte d'Ivoire,2009,116,1970,-1854
ITA,Italy,CIV,Côte d'Ivoire,2010,86,1915,-1829
ITA,Italy,CIV,Côte d'Ivoire,2011,119,1734,-1615
ITA,Italy,CIV,Côte d'Ivoire,2012,114,2715,-2601
ITA,Italy,CIV,Côte d'Ivoire,2013,177,1800,-1623
ITA,Italy,CIV,Côte d'Ivoire,2014,210,1272,-1062
ITA,Italy,CIV,Côte d'Ivoire,2015,165,2046,-1881
ITA,Italy,CIV,Côte d'Ivoire,2016,0,3536,-3536
ITA,Italy,CIV,Côte d'Ivoire,2017,156,6528,-6372
JPN,Japan,CIV,Côte d'Ivoire,2008,84,94,-10
JPN,Japan,CIV,Côte d'Ivoire,2009,78,87,-9
JPN,Japan,CIV,Côte d'Ivoire,2010,74,83,-9
JPN,Japan,CIV,Côte d'Ivoire,2011,16,32,-16
JPN,Japan,CIV,Côte d'Ivoire,2012,104,103,1
JPN,Japan,CIV,Côte d'Ivoire,2013,155,168,-13
JPN,Japan,CIV,Côte d'Ivoire,2014,114,120,-6
JPN,Japan,CIV,Côte d'Ivoire,2015,126,144,-18
JPN,Japan,CIV,Côte d'Ivoire,2016,142,149,-7
JPN,Japan,CIV,Côte d'Ivoire,2017,108,124,-16
KOR,Korea,CIV,Côte d'Ivoire,2008,19,34,-15
KOR,Korea,CIV,Côte d'Ivoire,2009,16,11,5
KOR,Korea,CIV,Côte d'Ivoire,2010,18,23,-5
KOR,Korea,CIV,Côte d'Ivoire,2011,36,22,14
KOR,Korea,CIV,Côte d'Ivoire,2012,28,23,5
KOR,Korea,CIV,Côte d'Ivoire,2013,13,20,-7
KOR,Korea,CIV,Côte d'Ivoire,2014,12,29,-17
KOR,Korea,CIV,Côte d'Ivoire,2015,22,38,-16
KOR,Korea,CIV,Côte d'Ivoire,2016,29,32,-3
KOR,Korea,CIV,Côte d'Ivoire,2017,37,35,2
LUX,Luxembourg,CIV,Côte d'Ivoire,2008,7,7,0
LUX,Luxembourg,CIV,Côte d'Ivoire,2009,2,19,-17
LUX,Luxembourg,CIV,Côte d'Ivoire,2010,1,16,-15
LUX,Luxembourg,CIV,Côte d'Ivoire,2011,2,18,-16
LUX,Luxembourg,CIV,Côte d'Ivoire,2012,2,15,-13
LUX,Luxembourg,CIV,Côte d'Ivoire,2013,5,20,-15
LUX,Luxembourg,CIV,Côte d'Ivoire,2014,9,23,-14
LUX,Luxembourg,CIV,Côte d'Ivoire,2015,9,18,-9
LUX,Luxembourg,CIV,Côte d'Ivoire,2016,3,28,-25
LUX,Luxembourg,CIV,Côte d'Ivoire,2017,5,36,-31
MEX,Mexico,CIV,Côte d'Ivoire,2008,0,1,-1
MEX,Mexico,CIV,Côte d'Ivoire,2009,0,1,-1
MEX,Mexico,CIV,Côte d'Ivoire,2011,0,8,-8
MEX,Mexico,CIV,Côte d'Ivoire,2012,0,4,-4
MEX,Mexico,CIV,Côte d'Ivoire,2013,0,4,-4
MEX,Mexico,CIV,Côte d'Ivoire,2014,0,1,-1
MEX,Mexico,CIV,Côte d'Ivoire,2015,0,3,-3
MEX,Mexico,CIV,Côte d'Ivoire,2016,0,7,-7
MEX,Mexico,CIV,Côte d'Ivoire,2017,0,4,-4
NLD,Netherlands,CIV,Côte d'Ivoire,2008,7,33,-26
NLD,Netherlands,CIV,Côte d'Ivoire,2009,4,39,-35
NLD,Netherlands,CIV,Côte d'Ivoire,2010,13,26,-13
NLD,Netherlands,CIV,Côte d'Ivoire,2011,9,25,-16
NLD,Netherlands,CIV,Côte d'Ivoire,2012,9,29,-20
NLD,Netherlands,CIV,Côte d'Ivoire,2013,22,27,-5
NLD,Netherlands,CIV,Côte d'Ivoire,2014,14,46,-32
NLD,Netherlands,CIV,Côte d'Ivoire,2015,6,33,-27
NLD,Netherlands,CIV,Côte d'Ivoire,2016,20,18,2
NLD,Netherlands,CIV,Côte d'Ivoire,2017,7,25,-18
NZL,New Zealand,CIV,Côte d'Ivoire,2011,0,0,0
NZL,New Zealand,CIV,Côte d'Ivoire,2014,0,1,-1
NOR,Norway,CIV,Côte d'Ivoire,2008,3,18,-15
NOR,Norway,CIV,Côte d'Ivoire,2009,10,18,-8
NOR,Norway,CIV,Côte d'Ivoire,2010,6,15,-9
NOR,Norway,CIV,Côte d'Ivoire,2011,13,14,-1
NOR,Norway,CIV,Côte d'Ivoire,2012,7,24,-17
NOR,Norway,CIV,Côte d'Ivoire,2013,9,19,-10
NOR,Norway,CIV,Côte d'Ivoire,2014,10,13,-3
NOR,Norway,CIV,Côte d'Ivoire,2015,4,12,-8
NOR,Norway,CIV,Côte d'Ivoire,2016,4,10,-6
NOR,Norway,CIV,Côte d'Ivoire,2017,3,22,-19
POL,Poland,CIV,Côte d'Ivoire,2009,0,4,-4
POL,Poland,CIV,Côte d'Ivoire,2010,0,10,-10
POL,Poland,CIV,Côte d'Ivoire,2011,0,8,-8
POL,Poland,CIV,Côte d'Ivoire,2012,0,7,-7
POL,Poland,CIV,Côte d'Ivoire,2013,0,8,-8
POL,Poland,CIV,Côte d'Ivoire,2014,0,5,-5
POL,Poland,CIV,Côte d'Ivoire,2015,0,12,-12
POL,Poland,CIV,Côte d'Ivoire,2016,0,10,-10
POL,Poland,CIV,Côte d'Ivoire,2017,0,11,-11
SVK,Slovak Republic,CIV,Côte d'Ivoire,2008,1,3,-2
SVK,Slovak Republic,CIV,Côte d'Ivoire,2009,0,1,-1
SVK,Slovak Republic,CIV,Côte d'Ivoire,2010,0,4,-4
ESP,Spain,CIV,Côte d'Ivoire,2008,131,563,-432
ESP,Spain,CIV,Côte d'Ivoire,2009,178,462,-284
ESP,Spain,CIV,Côte d'Ivoire,2010,256,241,15
ESP,Spain,CIV,Côte d'Ivoire,2011,377,307,70
ESP,Spain,CIV,Côte d'Ivoire,2012,327,242,85
ESP,Spain,CIV,Côte d'Ivoire,2013,311,234,77
ESP,Spain,CIV,Côte d'Ivoire,2014,220,182,38
ESP,Spain,CIV,Côte d'Ivoire,2015,148,243,-95
ESP,Spain,CIV,Côte d'Ivoire,2016,125,362,-237
ESP,Spain,CIV,Côte d'Ivoire,2017,175,634,-459
SWE,Sweden,CIV,Côte d'Ivoire,2008,3,41,-38
SWE,Sweden,CIV,Côte d'Ivoire,2009,0,65,-65
SWE,Sweden,CIV,Côte d'Ivoire,2010,5,50,-45
SWE,Sweden,CIV,Côte d'Ivoire,2011,3,62,-59
SWE,Sweden,CIV,Côte d'Ivoire,2012,3,55,-52
SWE,Sweden,CIV,Côte d'Ivoire,2013,4,50,-46
SWE,Sweden,CIV,Côte d'Ivoire,2014,2,68,-66
SWE,Sweden,CIV,Côte d'Ivoire,2015,6,50,-44
SWE,Sweden,CIV,Côte d'Ivoire,2016,1,39,-38
SWE,Sweden,CIV,Côte d'Ivoire,2017,4,34,-30
CHE,Switzerland,CIV,Côte d'Ivoire,2010,50,166,-116
CHE,Switzerland,CIV,Côte d'Ivoire,2011,39,135,-96
CHE,Switzerland,CIV,Côte d'Ivoire,2012,40,147,-107
CHE,Switzerland,CIV,Côte d'Ivoire,2013,36,109,-73
CHE,Switzerland,CIV,Côte d'Ivoire,2014,37,136,-99
CHE,Switzerland,CIV,Côte d'Ivoire,2015,45,134,-89
CHE,Switzerland,CIV,Côte d'Ivoire,2016,35,120,-85
CHE,Switzerland,CIV,Côte d'Ivoire,2017,42,98,-56
TUR,Turkey,CIV,Côte d'Ivoire,2010,0,2,-2
TUR,Turkey,CIV,Côte d'Ivoire,2016,37,107,-70
TUR,Turkey,CIV,Côte d'Ivoire,2017,0,0,0
USA,United States,CIV,Côte d'Ivoire,2008,0,1645,-1645
USA,United States,CIV,Côte d'Ivoire,2009,0,2159,-2159
USA,United States,CIV,Côte d'Ivoire,2010,0,1621,-1621
USA,United States,CIV,Côte d'Ivoire,2011,0,1302,-1302
USA,United States,CIV,Côte d'Ivoire,2012,0,1760,-1760
USA,United States,CIV,Côte d'Ivoire,2013,0,1486,-1486
USA,United States,CIV,Côte d'Ivoire,2014,0,1477,-1477
USA,United States,CIV,Côte d'Ivoire,2015,0,1497,-1497
USA,United States,CIV,Côte d'Ivoire,2016,0,1617,-1617
USA,United States,CIV,Côte d'Ivoire,2017,0,1810,-1810
CHL,Chile,CIV,Côte d'Ivoire,2008,0,2,-2
CHL,Chile,CIV,Côte d'Ivoire,2009,0,2,-2
CHL,Chile,CIV,Côte d'Ivoire,2010,0,3,-3
CHL,Chile,CIV,Côte d'Ivoire,2011,0,0,0
CHL,Chile,CIV,Côte d'Ivoire,2012,0,0,0
CHL,Chile,CIV,Côte d'Ivoire,2013,0,0,0
CHL,Chile,CIV,Côte d'Ivoire,2014,0,0,0
CHL,Chile,CIV,Côte d'Ivoire,2015,0,0,0
CHL,Chile,CIV,Côte d'Ivoire,2016,0,1,-1
EST,Estonia,CIV,Côte d'Ivoire,2008,0,0,0
EST,Estonia,CIV,Côte d'Ivoire,2009,0,1,-1
EST,Estonia,CIV,Côte d'Ivoire,2010,0,0,0
EST,Estonia,CIV,Côte d'Ivoire,2011,0,0,0
EST,Estonia,CIV,Côte d'Ivoire,2012,0,0,0
EST,Estonia,CIV,Côte d'Ivoire,2013,0,2,-2
EST,Estonia,CIV,Côte d'Ivoire,2014,0,0,0
EST,Estonia,CIV,Côte d'Ivoire,2015,0,0,0
EST,Estonia,CIV,Côte d'Ivoire,2016,0,0,0
EST,Estonia,CIV,Côte d'Ivoire,2017,0,1,-1
SVN,Slovenia,CIV,Côte d'Ivoire,2010,0,1,-1
AUS,Australia,HRV,Croatia,2008,408,92,316
AUS,Australia,HRV,Croatia,2009,360,127,233
AUS,Australia,HRV,Croatia,2010,355,102,253
AUS,Australia,HRV,Croatia,2011,284,94,190
AUS,Australia,HRV,Croatia,2012,327,110,217
AUS,Australia,HRV,Croatia,2013,292,102,190
AUS,Australia,HRV,Croatia,2014,342,128,214
AUS,Australia,HRV,Croatia,2015,300,153,147
AUS,Australia,HRV,Croatia,2016,300,116,184
AUS,Australia,HRV,Croatia,2017,0,132,-132
AUT,Austria,HRV,Croatia,2008,1980,2022,-42
AUT,Austria,HRV,Croatia,2009,2057,1937,120
AUT,Austria,HRV,Croatia,2010,1876,1894,-18
AUT,Austria,HRV,Croatia,2011,1678,1908,-230
AUT,Austria,HRV,Croatia,2012,1547,2008,-461
AUT,Austria,HRV,Croatia,2013,1357,4183,-2826
AUT,Austria,HRV,Croatia,2014,2014,6036,-4022
AUT,Austria,HRV,Croatia,2015,2614,5832,-3218
AUT,Austria,HRV,Croatia,2016,2530,5097,-2567
AUT,Austria,HRV,Croatia,2017,2381,5082,-2701
BEL,Belgium,HRV,Croatia,2008,0,135,-135
BEL,Belgium,HRV,Croatia,2009,0,129,-129
BEL,Belgium,HRV,Croatia,2010,66,146,-80
BEL,Belgium,HRV,Croatia,2011,0,193,-193
BEL,Belgium,HRV,Croatia,2012,105,208,-103
BEL,Belgium,HRV,Croatia,2013,140,315,-175
BEL,Belgium,HRV,Croatia,2014,93,345,-252
BEL,Belgium,HRV,Croatia,2015,128,384,-256
BEL,Belgium,HRV,Croatia,2016,87,351,-264
BEL,Belgium,HRV,Croatia,2017,107,382,-275
CAN,Canada,HRV,Croatia,2008,0,131,-131
CAN,Canada,HRV,Croatia,2009,0,92,-92
CAN,Canada,HRV,Croatia,2010,0,91,-91
CAN,Canada,HRV,Croatia,2011,0,135,-135
CAN,Canada,HRV,Croatia,2012,0,112,-112
CAN,Canada,HRV,Croatia,2013,0,125,-125
CAN,Canada,HRV,Croatia,2014,0,293,-293
CAN,Canada,HRV,Croatia,2015,0,500,-500
CAN,Canada,HRV,Croatia,2016,0,635,-635
CAN,Canada,HRV,Croatia,2017,0,580,-580
CZE,Czech Republic,HRV,Croatia,2008,6,196,-190
CZE,Czech Republic,HRV,Croatia,2009,1,89,-88
CZE,Czech Republic,HRV,Croatia,2010,3,129,-126
CZE,Czech Republic,HRV,Croatia,2011,1,129,-128
CZE,Czech Republic,HRV,Croatia,2012,52,134,-82
CZE,Czech Republic,HRV,Croatia,2013,145,129,16
CZE,Czech Republic,HRV,Croatia,2014,65,149,-84
CZE,Czech Republic,HRV,Croatia,2015,72,134,-62
CZE,Czech Republic,HRV,Croatia,2016,34,119,-85
CZE,Czech Republic,HRV,Croatia,2017,298,181,117
DNK,Denmark,HRV,Croatia,2008,14,35,-21
DNK,Denmark,HRV,Croatia,2009,13,23,-10
DNK,Denmark,HRV,Croatia,2010,11,21,-10
DNK,Denmark,HRV,Croatia,2011,20,32,-12
DNK,Denmark,HRV,Croatia,2012,26,35,-9
DNK,Denmark,HRV,Croatia,2013,29,122,-93
DNK,Denmark,HRV,Croatia,2014,41,306,-265
DNK,Denmark,HRV,Croatia,2015,71,358,-287
DNK,Denmark,HRV,Croatia,2016,212,422,-210
DNK,Denmark,HRV,Croatia,2017,189,366,-177
FIN,Finland,HRV,Croatia,2008,3,16,-13
FIN,Finland,HRV,Croatia,2009,6,16,-10
FIN,Finland,HRV,Croatia,2010,2,15,-13
FIN,Finland,HRV,Croatia,2011,3,20,-17
FIN,Finland,HRV,Croatia,2012,2,18,-16
FIN,Finland,HRV,Croatia,2013,1,32,-31
FIN,Finland,HRV,Croatia,2014,6,54,-48
FIN,Finland,HRV,Croatia,2015,5,58,-53
FIN,Finland,HRV,Croatia,2016,16,34,-18
FIN,Finland,HRV,Croatia,2017,18,45,-27
FRA,France,HRV,Croatia,2008,0,116,-116
FRA,France,HRV,Croatia,2009,0,104,-104
FRA,France,HRV,Croatia,2010,0,114,-114
FRA,France,HRV,Croatia,2011,0,102,-102
FRA,France,HRV,Croatia,2012,0,150,-150
FRA,France,HRV,Croatia,2013,0,195,-195
FRA,France,HRV,Croatia,2014,0,149,-149
FRA,France,HRV,Croatia,2015,0,290,-290
FRA,France,HRV,Croatia,2016,0,281,-281
FRA,France,HRV,Croatia,2017,0,436,-436
DEU,Germany,HRV,Croatia,2008,11816,8732,3084
DEU,Germany,HRV,Croatia,2009,12063,9129,2934
DEU,Germany,HRV,Croatia,2010,11184,10198,986
DEU,Germany,HRV,Croatia,2011,11859,11484,375
DEU,Germany,HRV,Croatia,2012,11847,12887,-1040
DEU,Germany,HRV,Croatia,2013,12635,25772,-13137
DEU,Germany,HRV,Croatia,2014,17535,46090,-28555
DEU,Germany,HRV,Croatia,2015,21321,60980,-39659
DEU,Germany,HRV,Croatia,2016,27474,62109,-34635
DEU,Germany,HRV,Croatia,2017,25800,58603,-32803
HUN,Hungary,HRV,Croatia,2008,34,417,-383
HUN,Hungary,HRV,Croatia,2009,186,140,46
HUN,Hungary,HRV,Croatia,2010,211,178,33
HUN,Hungary,HRV,Croatia,2011,61,221,-160
HUN,Hungary,HRV,Croatia,2012,54,175,-121
HUN,Hungary,HRV,Croatia,2013,64,165,-101
HUN,Hungary,HRV,Croatia,2014,7,219,-212
HUN,Hungary,HRV,Croatia,2015,8,210,-202
HUN,Hungary,HRV,Croatia,2016,0,149,-149
HUN,Hungary,HRV,Croatia,2017,2,189,-187
ISL,Iceland,HRV,Croatia,2008,9,8,1
ISL,Iceland,HRV,Croatia,2009,7,1,6
ISL,Iceland,HRV,Croatia,2010,1,1,0
ISL,Iceland,HRV,Croatia,2011,3,2,1
ISL,Iceland,HRV,Croatia,2012,2,4,-2
ISL,Iceland,HRV,Croatia,2013,3,8,-5
ISL,Iceland,HRV,Croatia,2014,7,16,-9
ISL,Iceland,HRV,Croatia,2015,7,25,-18
ISL,Iceland,HRV,Croatia,2016,8,109,-101
ISL,Iceland,HRV,Croatia,2017,11,233,-222
ITA,Italy,HRV,Croatia,2008,290,852,-562
ITA,Italy,HRV,Croatia,2009,358,680,-322
ITA,Italy,HRV,Croatia,2010,257,730,-473
ITA,Italy,HRV,Croatia,2011,213,559,-346
ITA,Italy,HRV,Croatia,2012,350,437,-87
ITA,Italy,HRV,Croatia,2013,261,665,-404
ITA,Italy,HRV,Croatia,2014,351,765,-414
ITA,Italy,HRV,Croatia,2015,369,673,-304
ITA,Italy,HRV,Croatia,2016,0,694,-694
ITA,Italy,HRV,Croatia,2017,308,678,-370
JPN,Japan,HRV,Croatia,2008,67,79,-12
JPN,Japan,HRV,Croatia,2009,67,58,9
JPN,Japan,HRV,Croatia,2010,68,75,-7
JPN,Japan,HRV,Croatia,2011,45,55,-10
JPN,Japan,HRV,Croatia,2012,55,74,-19
JPN,Japan,HRV,Croatia,2013,63,58,5
JPN,Japan,HRV,Croatia,2014,115,135,-20
JPN,Japan,HRV,Croatia,2015,73,146,-73
JPN,Japan,HRV,Croatia,2016,78,86,-8
JPN,Japan,HRV,Croatia,2017,77,69,8
KOR,Korea,HRV,Croatia,2008,54,39,15
KOR,Korea,HRV,Croatia,2009,58,43,15
KOR,Korea,HRV,Croatia,2010,37,24,13
KOR,Korea,HRV,Croatia,2011,35,45,-10
KOR,Korea,HRV,Croatia,2012,39,41,-2
KOR,Korea,HRV,Croatia,2013,50,47,3
KOR,Korea,HRV,Croatia,2014,57,27,30
KOR,Korea,HRV,Croatia,2015,54,25,29
KOR,Korea,HRV,Croatia,2016,34,35,-1
KOR,Korea,HRV,Croatia,2017,51,29,22
LUX,Luxembourg,HRV,Croatia,2008,7,8,-1
LUX,Luxembourg,HRV,Croatia,2009,8,13,-5
LUX,Luxembourg,HRV,Croatia,2010,7,37,-30
LUX,Luxembourg,HRV,Croatia,2011,5,39,-34
LUX,Luxembourg,HRV,Croatia,2012,3,77,-74
LUX,Luxembourg,HRV,Croatia,2013,25,83,-58
LUX,Luxembourg,HRV,Croatia,2014,22,140,-118
LUX,Luxembourg,HRV,Croatia,2015,33,131,-98
LUX,Luxembourg,HRV,Croatia,2016,48,182,-134
LUX,Luxembourg,HRV,Croatia,2017,43,146,-103
MEX,Mexico,HRV,Croatia,2008,0,5,-5
MEX,Mexico,HRV,Croatia,2009,0,16,-16
MEX,Mexico,HRV,Croatia,2010,0,5,-5
MEX,Mexico,HRV,Croatia,2011,0,3,-3
MEX,Mexico,HRV,Croatia,2012,0,5,-5
MEX,Mexico,HRV,Croatia,2013,0,12,-12
MEX,Mexico,HRV,Croatia,2014,0,12,-12
MEX,Mexico,HRV,Croatia,2015,0,6,-6
MEX,Mexico,HRV,Croatia,2016,0,12,-12
MEX,Mexico,HRV,Croatia,2017,0,10,-10
NLD,Netherlands,HRV,Croatia,2009,75,116,-41
NLD,Netherlands,HRV,Croatia,2010,89,140,-51
NLD,Netherlands,HRV,Croatia,2011,116,147,-31
NLD,Netherlands,HRV,Croatia,2012,174,188,-14
NLD,Netherlands,HRV,Croatia,2013,132,361,-229
NLD,Netherlands,HRV,Croatia,2014,218,489,-271
NLD,Netherlands,HRV,Croatia,2015,251,455,-204
NLD,Netherlands,HRV,Croatia,2016,281,487,-206
NLD,Netherlands,HRV,Croatia,2017,338,568,-230
NZL,New Zealand,HRV,Croatia,2008,11,14,-3
NZL,New Zealand,HRV,Croatia,2009,6,4,2
NZL,New Zealand,HRV,Croatia,2010,3,10,-7
NZL,New Zealand,HRV,Croatia,2011,3,4,-1
NZL,New Zealand,HRV,Croatia,2012,4,19,-15
NZL,New Zealand,HRV,Croatia,2013,8,22,-14
NZL,New Zealand,HRV,Croatia,2014,6,37,-31
NZL,New Zealand,HRV,Croatia,2015,10,85,-75
NZL,New Zealand,HRV,Croatia,2016,19,94,-75
NZL,New Zealand,HRV,Croatia,2017,14,75,-61
NOR,Norway,HRV,Croatia,2008,16,82,-66
NOR,Norway,HRV,Croatia,2009,17,55,-38
NOR,Norway,HRV,Croatia,2010,20,67,-47
NOR,Norway,HRV,Croatia,2011,31,151,-120
NOR,Norway,HRV,Croatia,2012,19,158,-139
NOR,Norway,HRV,Croatia,2013,40,114,-74
NOR,Norway,HRV,Croatia,2014,40,476,-436
NOR,Norway,HRV,Croatia,2015,104,584,-480
NOR,Norway,HRV,Croatia,2016,61,568,-507
NOR,Norway,HRV,Croatia,2017,53,519,-466
POL,Poland,HRV,Croatia,2008,0,57,-57
POL,Poland,HRV,Croatia,2009,0,74,-74
POL,Poland,HRV,Croatia,2010,0,66,-66
POL,Poland,HRV,Croatia,2011,0,76,-76
POL,Poland,HRV,Croatia,2012,0,95,-95
POL,Poland,HRV,Croatia,2013,0,118,-118
POL,Poland,HRV,Croatia,2014,0,81,-81
POL,Poland,HRV,Croatia,2015,0,147,-147
POL,Poland,HRV,Croatia,2016,0,100,-100
POL,Poland,HRV,Croatia,2017,0,121,-121
SVK,Slovak Republic,HRV,Croatia,2008,33,4,29
SVK,Slovak Republic,HRV,Croatia,2009,26,5,21
SVK,Slovak Republic,HRV,Croatia,2010,26,10,16
SVK,Slovak Republic,HRV,Croatia,2011,1,7,-6
SVK,Slovak Republic,HRV,Croatia,2012,1,10,-9
SVK,Slovak Republic,HRV,Croatia,2013,0,136,-136
SVK,Slovak Republic,HRV,Croatia,2014,2,72,-70
SVK,Slovak Republic,HRV,Croatia,2015,1,153,-152
SVK,Slovak Republic,HRV,Croatia,2016,5,131,-126
SVK,Slovak Republic,HRV,Croatia,2017,0,90,-90
ESP,Spain,HRV,Croatia,2008,175,189,-14
ESP,Spain,HRV,Croatia,2009,169,165,4
ESP,Spain,HRV,Croatia,2010,205,132,73
ESP,Spain,HRV,Croatia,2011,213,171,42
ESP,Spain,HRV,Croatia,2012,92,177,-85
ESP,Spain,HRV,Croatia,2013,113,208,-95
ESP,Spain,HRV,Croatia,2014,84,236,-152
ESP,Spain,HRV,Croatia,2015,72,294,-222
ESP,Spain,HRV,Croatia,2016,90,322,-232
ESP,Spain,HRV,Croatia,2017,173,415,-242
SWE,Sweden,HRV,Croatia,2008,34,136,-102
SWE,Sweden,HRV,Croatia,2009,21,170,-149
SWE,Sweden,HRV,Croatia,2010,39,142,-103
SWE,Sweden,HRV,Croatia,2011,36,152,-116
SWE,Sweden,HRV,Croatia,2012,40,179,-139
SWE,Sweden,HRV,Croatia,2013,28,495,-467
SWE,Sweden,HRV,Croatia,2014,55,1174,-1119
SWE,Sweden,HRV,Croatia,2015,76,1450,-1374
SWE,Sweden,HRV,Croatia,2016,118,1569,-1451
SWE,Sweden,HRV,Croatia,2017,160,1554,-1394
CHE,Switzerland,HRV,Croatia,2010,463,426,37
CHE,Switzerland,HRV,Croatia,2011,408,508,-100
CHE,Switzerland,HRV,Croatia,2012,421,484,-63
CHE,Switzerland,HRV,Croatia,2013,538,412,126
CHE,Switzerland,HRV,Croatia,2014,325,481,-156
CHE,Switzerland,HRV,Croatia,2015,367,485,-118
CHE,Switzerland,HRV,Croatia,2016,401,499,-98
CHE,Switzerland,HRV,Croatia,2017,451,567,-116
TUR,Turkey,HRV,Croatia,2010,0,30,-30
GBR,United Kingdom,HRV,Croatia,2014,0,1000,-1000
GBR,United Kingdom,HRV,Croatia,2015,0,1000,-1000
USA,United States,HRV,Croatia,2008,0,455,-455
USA,United States,HRV,Croatia,2009,0,496,-496
USA,United States,HRV,Croatia,2010,0,357,-357
USA,United States,HRV,Croatia,2011,0,349,-349
USA,United States,HRV,Croatia,2012,0,336,-336
USA,United States,HRV,Croatia,2013,0,353,-353
USA,United States,HRV,Croatia,2014,0,297,-297
USA,United States,HRV,Croatia,2015,0,348,-348
USA,United States,HRV,Croatia,2016,0,388,-388
USA,United States,HRV,Croatia,2017,0,375,-375
CHL,Chile,HRV,Croatia,2008,0,50,-50
CHL,Chile,HRV,Croatia,2009,0,11,-11
CHL,Chile,HRV,Croatia,2010,0,7,-7
CHL,Chile,HRV,Croatia,2011,0,11,-11
CHL,Chile,HRV,Croatia,2012,0,18,-18
CHL,Chile,HRV,Croatia,2013,0,6,-6
CHL,Chile,HRV,Croatia,2014,0,10,-10
CHL,Chile,HRV,Croatia,2015,0,14,-14
CHL,Chile,HRV,Croatia,2016,0,26,-26
EST,Estonia,HRV,Croatia,2008,0,0,0
EST,Estonia,HRV,Croatia,2009,0,0,0
EST,Estonia,HRV,Croatia,2010,0,0,0
EST,Estonia,HRV,Croatia,2011,0,0,0
EST,Estonia,HRV,Croatia,2012,0,2,-2
EST,Estonia,HRV,Croatia,2013,0,1,-1
EST,Estonia,HRV,Croatia,2014,0,0,0
EST,Estonia,HRV,Croatia,2015,0,14,-14
EST,Estonia,HRV,Croatia,2016,0,13,-13
EST,Estonia,HRV,Croatia,2017,0,11,-11
SVN,Slovenia,HRV,Croatia,2008,555,2265,-1710
SVN,Slovenia,HRV,Croatia,2009,751,1976,-1225
SVN,Slovenia,HRV,Croatia,2010,828,1777,-949
SVN,Slovenia,HRV,Croatia,2011,235,1904,-1669
SVN,Slovenia,HRV,Croatia,2012,209,2246,-2037
SVN,Slovenia,HRV,Croatia,2013,113,752,-639
SVN,Slovenia,HRV,Croatia,2014,136,2373,-2237
SVN,Slovenia,HRV,Croatia,2015,144,1593,-1449
SVN,Slovenia,HRV,Croatia,2016,241,1608,-1367
SVN,Slovenia,HRV,Croatia,2017,207,1491,-1284
AUS,Australia,CUB,Cuba,2008,5,38,-33
AUS,Australia,CUB,Cuba,2009,6,38,-32
AUS,Australia,CUB,Cuba,2010,0,33,-33
AUS,Australia,CUB,Cuba,2011,5,19,-14
AUS,Australia,CUB,Cuba,2012,11,56,-45
AUS,Australia,CUB,Cuba,2013,0,54,-54
AUS,Australia,CUB,Cuba,2014,7,19,-12
AUS,Australia,CUB,Cuba,2015,0,19,-19
AUS,Australia,CUB,Cuba,2016,0,15,-15
AUS,Australia,CUB,Cuba,2017,0,32,-32
AUT,Austria,CUB,Cuba,2008,48,66,-18
AUT,Austria,CUB,Cuba,2009,32,62,-30
AUT,Austria,CUB,Cuba,2010,38,43,-5
AUT,Austria,CUB,Cuba,2011,35,60,-25
AUT,Austria,CUB,Cuba,2012,32,54,-22
AUT,Austria,CUB,Cuba,2013,45,86,-41
AUT,Austria,CUB,Cuba,2014,45,77,-32
AUT,Austria,CUB,Cuba,2015,49,73,-24
AUT,Austria,CUB,Cuba,2016,48,64,-16
AUT,Austria,CUB,Cuba,2017,37,81,-44
BEL,Belgium,CUB,Cuba,2008,0,115,-115
BEL,Belgium,CUB,Cuba,2009,0,110,-110
BEL,Belgium,CUB,Cuba,2010,28,118,-90
BEL,Belgium,CUB,Cuba,2011,0,100,-100
BEL,Belgium,CUB,Cuba,2012,45,83,-38
BEL,Belgium,CUB,Cuba,2013,38,84,-46
BEL,Belgium,CUB,Cuba,2014,27,82,-55
BEL,Belgium,CUB,Cuba,2015,36,69,-33
BEL,Belgium,CUB,Cuba,2016,29,66,-37
BEL,Belgium,CUB,Cuba,2017,23,82,-59
CAN,Canada,CUB,Cuba,2008,0,1300,-1300
CAN,Canada,CUB,Cuba,2009,0,1426,-1426
CAN,Canada,CUB,Cuba,2010,0,961,-961
CAN,Canada,CUB,Cuba,2011,0,961,-961
CAN,Canada,CUB,Cuba,2012,0,1301,-1301
CAN,Canada,CUB,Cuba,2013,0,1402,-1402
CAN,Canada,CUB,Cuba,2014,0,1079,-1079
CAN,Canada,CUB,Cuba,2015,0,827,-827
CAN,Canada,CUB,Cuba,2016,0,1120,-1120
CAN,Canada,CUB,Cuba,2017,0,875,-875
CZE,Czech Republic,CUB,Cuba,2008,2,56,-54
CZE,Czech Republic,CUB,Cuba,2009,1,25,-24
CZE,Czech Republic,CUB,Cuba,2010,7,20,-13
CZE,Czech Republic,CUB,Cuba,2011,20,22,-2
CZE,Czech Republic,CUB,Cuba,2012,9,30,-21
CZE,Czech Republic,CUB,Cuba,2013,10,42,-32
CZE,Czech Republic,CUB,Cuba,2014,27,43,-16
CZE,Czech Republic,CUB,Cuba,2015,21,65,-44
CZE,Czech Republic,CUB,Cuba,2016,39,64,-25
CZE,Czech Republic,CUB,Cuba,2017,73,37,36
DNK,Denmark,CUB,Cuba,2008,2,35,-33
DNK,Denmark,CUB,Cuba,2009,10,24,-14
DNK,Denmark,CUB,Cuba,2010,7,22,-15
DNK,Denmark,CUB,Cuba,2011,6,19,-13
DNK,Denmark,CUB,Cuba,2012,11,19,-8
DNK,Denmark,CUB,Cuba,2013,14,25,-11
DNK,Denmark,CUB,Cuba,2014,4,28,-24
DNK,Denmark,CUB,Cuba,2015,9,15,-6
DNK,Denmark,CUB,Cuba,2016,14,22,-8
DNK,Denmark,CUB,Cuba,2017,8,21,-13
FIN,Finland,CUB,Cuba,2008,4,21,-17
FIN,Finland,CUB,Cuba,2009,4,28,-24
FIN,Finland,CUB,Cuba,2010,4,29,-25
FIN,Finland,CUB,Cuba,2011,3,24,-21
FIN,Finland,CUB,Cuba,2012,7,30,-23
FIN,Finland,CUB,Cuba,2013,4,35,-31
FIN,Finland,CUB,Cuba,2014,5,40,-35
FIN,Finland,CUB,Cuba,2015,6,33,-27
FIN,Finland,CUB,Cuba,2016,5,24,-19
FIN,Finland,CUB,Cuba,2017,5,21,-16
FRA,France,CUB,Cuba,2008,0,257,-257
FRA,France,CUB,Cuba,2009,0,234,-234
FRA,France,CUB,Cuba,2010,0,268,-268
FRA,France,CUB,Cuba,2011,0,258,-258
FRA,France,CUB,Cuba,2012,0,205,-205
FRA,France,CUB,Cuba,2013,0,277,-277
FRA,France,CUB,Cuba,2014,0,286,-286
FRA,France,CUB,Cuba,2015,0,273,-273
FRA,France,CUB,Cuba,2016,0,262,-262
FRA,France,CUB,Cuba,2017,0,232,-232
DEU,Germany,CUB,Cuba,2008,672,701,-29
DEU,Germany,CUB,Cuba,2009,633,676,-43
DEU,Germany,CUB,Cuba,2010,505,641,-136
DEU,Germany,CUB,Cuba,2011,440,700,-260
DEU,Germany,CUB,Cuba,2012,424,720,-296
DEU,Germany,CUB,Cuba,2013,470,818,-348
DEU,Germany,CUB,Cuba,2014,476,751,-275
DEU,Germany,CUB,Cuba,2015,435,753,-318
DEU,Germany,CUB,Cuba,2016,516,743,-227
DEU,Germany,CUB,Cuba,2017,375,701,-326
HUN,Hungary,CUB,Cuba,2008,0,26,-26
HUN,Hungary,CUB,Cuba,2009,2,24,-22
HUN,Hungary,CUB,Cuba,2010,7,13,-6
HUN,Hungary,CUB,Cuba,2011,2,18,-16
HUN,Hungary,CUB,Cuba,2012,3,21,-18
HUN,Hungary,CUB,Cuba,2013,1,20,-19
HUN,Hungary,CUB,Cuba,2014,5,37,-32
HUN,Hungary,CUB,Cuba,2015,7,19,-12
HUN,Hungary,CUB,Cuba,2016,3,20,-17
HUN,Hungary,CUB,Cuba,2017,0,22,-22
ISL,Iceland,CUB,Cuba,2008,3,6,-3
ISL,Iceland,CUB,Cuba,2009,3,4,-1
ISL,Iceland,CUB,Cuba,2010,0,2,-2
ISL,Iceland,CUB,Cuba,2011,1,1,0
ISL,Iceland,CUB,Cuba,2012,0,5,-5
ISL,Iceland,CUB,Cuba,2013,0,5,-5
ISL,Iceland,CUB,Cuba,2014,2,7,-5
ISL,Iceland,CUB,Cuba,2015,2,4,-2
ISL,Iceland,CUB,Cuba,2016,4,3,1
ISL,Iceland,CUB,Cuba,2017,1,4,-3
ITA,Italy,CUB,Cuba,2008,116,2802,-2686
ITA,Italy,CUB,Cuba,2009,137,2274,-2137
ITA,Italy,CUB,Cuba,2010,120,2088,-1968
ITA,Italy,CUB,Cuba,2011,113,2067,-1954
ITA,Italy,CUB,Cuba,2012,116,1847,-1731
ITA,Italy,CUB,Cuba,2013,197,1811,-1614
ITA,Italy,CUB,Cuba,2014,209,1692,-1483
ITA,Italy,CUB,Cuba,2015,236,1747,-1511
ITA,Italy,CUB,Cuba,2016,0,1655,-1655
ITA,Italy,CUB,Cuba,2017,204,1736,-1532
JPN,Japan,CUB,Cuba,2008,156,175,-19
JPN,Japan,CUB,Cuba,2009,158,169,-11
JPN,Japan,CUB,Cuba,2010,179,172,7
JPN,Japan,CUB,Cuba,2011,114,130,-16
JPN,Japan,CUB,Cuba,2012,102,119,-17
JPN,Japan,CUB,Cuba,2013,204,220,-16
JPN,Japan,CUB,Cuba,2014,74,87,-13
JPN,Japan,CUB,Cuba,2015,119,130,-11
JPN,Japan,CUB,Cuba,2016,103,135,-32
JPN,Japan,CUB,Cuba,2017,120,154,-34
KOR,Korea,CUB,Cuba,2008,4,7,-3
KOR,Korea,CUB,Cuba,2009,4,4,0
KOR,Korea,CUB,Cuba,2010,2,3,-1
KOR,Korea,CUB,Cuba,2011,3,6,-3
KOR,Korea,CUB,Cuba,2012,5,5,0
KOR,Korea,CUB,Cuba,2013,4,9,-5
KOR,Korea,CUB,Cuba,2014,4,7,-3
KOR,Korea,CUB,Cuba,2015,13,17,-4
KOR,Korea,CUB,Cuba,2016,15,18,-3
KOR,Korea,CUB,Cuba,2017,12,6,6
LUX,Luxembourg,CUB,Cuba,2008,2,14,-12
LUX,Luxembourg,CUB,Cuba,2009,9,4,5
LUX,Luxembourg,CUB,Cuba,2010,1,12,-11
LUX,Luxembourg,CUB,Cuba,2011,2,5,-3
LUX,Luxembourg,CUB,Cuba,2012,3,9,-6
LUX,Luxembourg,CUB,Cuba,2013,4,11,-7
LUX,Luxembourg,CUB,Cuba,2014,2,9,-7
LUX,Luxembourg,CUB,Cuba,2015,5,11,-6
LUX,Luxembourg,CUB,Cuba,2016,1,12,-11
LUX,Luxembourg,CUB,Cuba,2017,4,6,-2
MEX,Mexico,CUB,Cuba,2008,0,970,-970
MEX,Mexico,CUB,Cuba,2009,0,1735,-1735
MEX,Mexico,CUB,Cuba,2010,0,1847,-1847
MEX,Mexico,CUB,Cuba,2011,0,1722,-1722
MEX,Mexico,CUB,Cuba,2012,0,1833,-1833
MEX,Mexico,CUB,Cuba,2013,0,3249,-3249
MEX,Mexico,CUB,Cuba,2014,0,2674,-2674
MEX,Mexico,CUB,Cuba,2015,0,2611,-2611
MEX,Mexico,CUB,Cuba,2016,0,2416,-2416
MEX,Mexico,CUB,Cuba,2017,0,2129,-2129
NLD,Netherlands,CUB,Cuba,2008,36,57,-21
NLD,Netherlands,CUB,Cuba,2009,28,74,-46
NLD,Netherlands,CUB,Cuba,2010,34,79,-45
NLD,Netherlands,CUB,Cuba,2011,22,47,-25
NLD,Netherlands,CUB,Cuba,2012,34,47,-13
NLD,Netherlands,CUB,Cuba,2013,23,49,-26
NLD,Netherlands,CUB,Cuba,2014,28,53,-25
NLD,Netherlands,CUB,Cuba,2015,24,48,-24
NLD,Netherlands,CUB,Cuba,2016,33,40,-7
NLD,Netherlands,CUB,Cuba,2017,23,52,-29
NZL,New Zealand,CUB,Cuba,2008,0,5,-5
NZL,New Zealand,CUB,Cuba,2009,0,3,-3
NZL,New Zealand,CUB,Cuba,2010,1,2,-1
NZL,New Zealand,CUB,Cuba,2011,1,8,-7
NZL,New Zealand,CUB,Cuba,2012,3,1,2
NZL,New Zealand,CUB,Cuba,2013,0,8,-8
NZL,New Zealand,CUB,Cuba,2014,0,2,-2
NZL,New Zealand,CUB,Cuba,2015,4,11,-7
NZL,New Zealand,CUB,Cuba,2016,1,6,-5
NZL,New Zealand,CUB,Cuba,2017,5,3,2
NOR,Norway,CUB,Cuba,2008,9,65,-56
NOR,Norway,CUB,Cuba,2009,18,57,-39
NOR,Norway,CUB,Cuba,2010,22,53,-31
NOR,Norway,CUB,Cuba,2011,23,71,-48
NOR,Norway,CUB,Cuba,2012,20,45,-25
NOR,Norway,CUB,Cuba,2013,12,65,-53
NOR,Norway,CUB,Cuba,2014,21,46,-25
NOR,Norway,CUB,Cuba,2015,19,53,-34
NOR,Norway,CUB,Cuba,2016,17,55,-38
NOR,Norway,CUB,Cuba,2017,14,43,-29
POL,Poland,CUB,Cuba,2009,0,32,-32
POL,Poland,CUB,Cuba,2010,0,39,-39
POL,Poland,CUB,Cuba,2011,0,55,-55
POL,Poland,CUB,Cuba,2012,0,59,-59
POL,Poland,CUB,Cuba,2013,0,61,-61
POL,Poland,CUB,Cuba,2014,0,28,-28
POL,Poland,CUB,Cuba,2015,0,65,-65
POL,Poland,CUB,Cuba,2016,0,44,-44
POL,Poland,CUB,Cuba,2017,0,51,-51
SVK,Slovak Republic,CUB,Cuba,2008,3,10,-7
SVK,Slovak Republic,CUB,Cuba,2009,6,4,2
SVK,Slovak Republic,CUB,Cuba,2010,7,3,4
SVK,Slovak Republic,CUB,Cuba,2011,2,7,-5
SVK,Slovak Republic,CUB,Cuba,2012,0,7,-7
SVK,Slovak Republic,CUB,Cuba,2013,0,1,-1
SVK,Slovak Republic,CUB,Cuba,2014,0,1,-1
SVK,Slovak Republic,CUB,Cuba,2015,0,3,-3
SVK,Slovak Republic,CUB,Cuba,2016,0,1,-1
SVK,Slovak Republic,CUB,Cuba,2017,0,1,-1
ESP,Spain,CUB,Cuba,2008,1740,8911,-7171
ESP,Spain,CUB,Cuba,2009,2164,5634,-3470
ESP,Spain,CUB,Cuba,2010,2272,6114,-3842
ESP,Spain,CUB,Cuba,2011,2088,7399,-5311
ESP,Spain,CUB,Cuba,2012,2420,5730,-3310
ESP,Spain,CUB,Cuba,2013,3076,5116,-2040
ESP,Spain,CUB,Cuba,2014,2105,4608,-2503
ESP,Spain,CUB,Cuba,2015,1633,4853,-3220
ESP,Spain,CUB,Cuba,2016,1544,5871,-4327
ESP,Spain,CUB,Cuba,2017,2007,7991,-5984
SWE,Sweden,CUB,Cuba,2008,19,145,-126
SWE,Sweden,CUB,Cuba,2009,12,131,-119
SWE,Sweden,CUB,Cuba,2010,23,106,-83
SWE,Sweden,CUB,Cuba,2011,23,100,-77
SWE,Sweden,CUB,Cuba,2012,21,97,-76
SWE,Sweden,CUB,Cuba,2013,13,100,-87
SWE,Sweden,CUB,Cuba,2014,32,95,-63
SWE,Sweden,CUB,Cuba,2015,17,82,-65
SWE,Sweden,CUB,Cuba,2016,17,101,-84
SWE,Sweden,CUB,Cuba,2017,17,93,-76
CHE,Switzerland,CUB,Cuba,2010,57,193,-136
CHE,Switzerland,CUB,Cuba,2011,55,160,-105
CHE,Switzerland,CUB,Cuba,2012,60,134,-74
CHE,Switzerland,CUB,Cuba,2013,49,172,-123
CHE,Switzerland,CUB,Cuba,2014,63,123,-60
CHE,Switzerland,CUB,Cuba,2015,52,141,-89
CHE,Switzerland,CUB,Cuba,2016,50,141,-91
CHE,Switzerland,CUB,Cuba,2017,49,126,-77
TUR,Turkey,CUB,Cuba,2010,0,4,-4
TUR,Turkey,CUB,Cuba,2016,84,248,-164
TUR,Turkey,CUB,Cuba,2017,176,192,-16
GBR,United Kingdom,CUB,Cuba,2014,0,1000,-1000
USA,United States,CUB,Cuba,2008,0,49500,-49500
USA,United States,CUB,Cuba,2009,0,38954,-38954
USA,United States,CUB,Cuba,2010,0,33573,-33573
USA,United States,CUB,Cuba,2011,0,36452,-36452
USA,United States,CUB,Cuba,2012,0,32820,-32820
USA,United States,CUB,Cuba,2013,0,32219,-32219
USA,United States,CUB,Cuba,2014,0,46679,-46679
USA,United States,CUB,Cuba,2015,0,54396,-54396
USA,United States,CUB,Cuba,2016,0,66516,-66516
USA,United States,CUB,Cuba,2017,0,65028,-65028
CHL,Chile,CUB,Cuba,2008,0,333,-333
CHL,Chile,CUB,Cuba,2009,0,270,-270
CHL,Chile,CUB,Cuba,2010,0,313,-313
CHL,Chile,CUB,Cuba,2011,0,251,-251
CHL,Chile,CUB,Cuba,2012,0,267,-267
CHL,Chile,CUB,Cuba,2013,0,339,-339
CHL,Chile,CUB,Cuba,2014,0,479,-479
CHL,Chile,CUB,Cuba,2015,0,777,-777
CHL,Chile,CUB,Cuba,2016,0,721,-721
EST,Estonia,CUB,Cuba,2008,0,0,0
EST,Estonia,CUB,Cuba,2009,0,1,-1
EST,Estonia,CUB,Cuba,2010,0,0,0
EST,Estonia,CUB,Cuba,2011,0,0,0
EST,Estonia,CUB,Cuba,2012,0,0,0
EST,Estonia,CUB,Cuba,2013,0,0,0
EST,Estonia,CUB,Cuba,2014,0,0,0
EST,Estonia,CUB,Cuba,2015,0,1,-1
EST,Estonia,CUB,Cuba,2016,0,5,-5
EST,Estonia,CUB,Cuba,2017,0,2,-2
ISR,Israel,CUB,Cuba,2008,0,63,-63
ISR,Israel,CUB,Cuba,2009,0,41,-41
ISR,Israel,CUB,Cuba,2010,0,36,-36
ISR,Israel,CUB,Cuba,2011,0,54,-54
ISR,Israel,CUB,Cuba,2012,0,64,-64
ISR,Israel,CUB,Cuba,2013,0,72,-72
ISR,Israel,CUB,Cuba,2014,0,104,-104
ISR,Israel,CUB,Cuba,2015,0,41,-41
ISR,Israel,CUB,Cuba,2016,0,11,-11
ISR,Israel,CUB,Cuba,2017,0,5,-5
SVN,Slovenia,CUB,Cuba,2008,0,16,-16
SVN,Slovenia,CUB,Cuba,2009,0,3,-3
SVN,Slovenia,CUB,Cuba,2011,0,1,-1
SVN,Slovenia,CUB,Cuba,2012,4,1,3
SVN,Slovenia,CUB,Cuba,2013,0,2,-2
SVN,Slovenia,CUB,Cuba,2015,2,8,-6
SVN,Slovenia,CUB,Cuba,2016,0,2,-2
SVN,Slovenia,CUB,Cuba,2017,0,6,-6
AUS,Australia,CYP,Cyprus,2008,133,12,121
AUS,Australia,CYP,Cyprus,2009,117,8,109
AUS,Australia,CYP,Cyprus,2010,106,17,89
AUS,Australia,CYP,Cyprus,2011,100,15,85
AUS,Australia,CYP,Cyprus,2012,78,14,64
AUS,Australia,CYP,Cyprus,2013,89,24,65
AUS,Australia,CYP,Cyprus,2014,100,49,51
AUS,Australia,CYP,Cyprus,2015,100,34,66
AUS,Australia,CYP,Cyprus,2016,100,30,70
AUS,Australia,CYP,Cyprus,2017,0,35,-35
AUT,Austria,CYP,Cyprus,2008,14,25,-11
AUT,Austria,CYP,Cyprus,2009,18,27,-9
AUT,Austria,CYP,Cyprus,2010,24,26,-2
AUT,Austria,CYP,Cyprus,2011,16,19,-3
AUT,Austria,CYP,Cyprus,2012,21,22,-1
AUT,Austria,CYP,Cyprus,2013,28,51,-23
AUT,Austria,CYP,Cyprus,2014,34,38,-4
AUT,Austria,CYP,Cyprus,2015,23,31,-8
AUT,Austria,CYP,Cyprus,2016,21,43,-22
AUT,Austria,CYP,Cyprus,2017,33,32,1
BEL,Belgium,CYP,Cyprus,2008,0,52,-52
BEL,Belgium,CYP,Cyprus,2009,0,69,-69
BEL,Belgium,CYP,Cyprus,2010,45,69,-24
BEL,Belgium,CYP,Cyprus,2011,0,45,-45
BEL,Belgium,CYP,Cyprus,2012,50,56,-6
BEL,Belgium,CYP,Cyprus,2013,37,78,-41
BEL,Belgium,CYP,Cyprus,2014,37,69,-32
BEL,Belgium,CYP,Cyprus,2015,43,60,-17
BEL,Belgium,CYP,Cyprus,2016,33,62,-29
BEL,Belgium,CYP,Cyprus,2017,30,50,-20
CAN,Canada,CYP,Cyprus,2008,0,7,-7
CAN,Canada,CYP,Cyprus,2009,0,6,-6
CAN,Canada,CYP,Cyprus,2010,0,18,-18
CAN,Canada,CYP,Cyprus,2011,0,6,-6
CAN,Canada,CYP,Cyprus,2012,0,12,-12
CAN,Canada,CYP,Cyprus,2013,0,16,-16
CAN,Canada,CYP,Cyprus,2014,0,28,-28
CAN,Canada,CYP,Cyprus,2015,0,27,-27
CAN,Canada,CYP,Cyprus,2016,0,15,-15
CAN,Canada,CYP,Cyprus,2017,0,15,-15
CZE,Czech Republic,CYP,Cyprus,2008,0,9,-9
CZE,Czech Republic,CYP,Cyprus,2009,1,9,-8
CZE,Czech Republic,CYP,Cyprus,2010,1,9,-8
CZE,Czech Republic,CYP,Cyprus,2011,1,6,-5
CZE,Czech Republic,CYP,Cyprus,2012,0,2,-2
CZE,Czech Republic,CYP,Cyprus,2013,4,6,-2
CZE,Czech Republic,CYP,Cyprus,2014,3,9,-6
CZE,Czech Republic,CYP,Cyprus,2015,0,6,-6
CZE,Czech Republic,CYP,Cyprus,2016,0,8,-8
CZE,Czech Republic,CYP,Cyprus,2017,0,17,-17
DNK,Denmark,CYP,Cyprus,2008,5,3,2
DNK,Denmark,CYP,Cyprus,2009,5,4,1
DNK,Denmark,CYP,Cyprus,2010,8,4,4
DNK,Denmark,CYP,Cyprus,2011,6,10,-4
DNK,Denmark,CYP,Cyprus,2012,7,12,-5
DNK,Denmark,CYP,Cyprus,2013,10,16,-6
DNK,Denmark,CYP,Cyprus,2014,11,26,-15
DNK,Denmark,CYP,Cyprus,2015,10,27,-17
DNK,Denmark,CYP,Cyprus,2016,12,31,-19
DNK,Denmark,CYP,Cyprus,2017,23,25,-2
FIN,Finland,CYP,Cyprus,2008,0,3,-3
FIN,Finland,CYP,Cyprus,2009,2,2,0
FIN,Finland,CYP,Cyprus,2010,1,7,-6
FIN,Finland,CYP,Cyprus,2011,0,7,-7
FIN,Finland,CYP,Cyprus,2012,3,3,0
FIN,Finland,CYP,Cyprus,2013,2,12,-10
FIN,Finland,CYP,Cyprus,2014,3,8,-5
FIN,Finland,CYP,Cyprus,2015,3,12,-9
FIN,Finland,CYP,Cyprus,2016,5,5,0
FIN,Finland,CYP,Cyprus,2017,4,7,-3
FRA,France,CYP,Cyprus,2008,0,0,0
FRA,France,CYP,Cyprus,2009,0,0,0
FRA,France,CYP,Cyprus,2010,0,0,0
FRA,France,CYP,Cyprus,2011,0,0,0
FRA,France,CYP,Cyprus,2012,0,0,0
FRA,France,CYP,Cyprus,2013,0,48,-48
FRA,France,CYP,Cyprus,2014,0,16,-16
FRA,France,CYP,Cyprus,2015,0,110,-110
FRA,France,CYP,Cyprus,2016,0,65,-65
FRA,France,CYP,Cyprus,2017,0,24,-24
DEU,Germany,CYP,Cyprus,2008,127,134,-7
DEU,Germany,CYP,Cyprus,2009,135,155,-20
DEU,Germany,CYP,Cyprus,2010,119,171,-52
DEU,Germany,CYP,Cyprus,2011,109,273,-164
DEU,Germany,CYP,Cyprus,2012,120,380,-260
DEU,Germany,CYP,Cyprus,2013,186,511,-325
DEU,Germany,CYP,Cyprus,2014,292,531,-239
DEU,Germany,CYP,Cyprus,2015,277,465,-188
DEU,Germany,CYP,Cyprus,2016,274,492,-218
DEU,Germany,CYP,Cyprus,2017,290,465,-175
HUN,Hungary,CYP,Cyprus,2008,15,37,-22
HUN,Hungary,CYP,Cyprus,2009,7,28,-21
HUN,Hungary,CYP,Cyprus,2010,11,18,-7
HUN,Hungary,CYP,Cyprus,2011,0,32,-32
HUN,Hungary,CYP,Cyprus,2012,39,27,12
HUN,Hungary,CYP,Cyprus,2013,13,24,-11
HUN,Hungary,CYP,Cyprus,2014,20,15,5
HUN,Hungary,CYP,Cyprus,2015,16,8,8
HUN,Hungary,CYP,Cyprus,2016,18,23,-5
HUN,Hungary,CYP,Cyprus,2017,0,25,-25
ISL,Iceland,CYP,Cyprus,2008,1,1,0
ISL,Iceland,CYP,Cyprus,2009,1,2,-1
ISL,Iceland,CYP,Cyprus,2010,2,1,1
ISL,Iceland,CYP,Cyprus,2011,0,0,0
ISL,Iceland,CYP,Cyprus,2012,0,0,0
ISL,Iceland,CYP,Cyprus,2013,1,0,1
ISL,Iceland,CYP,Cyprus,2014,0,0,0
ISL,Iceland,CYP,Cyprus,2015,0,0,0
ISL,Iceland,CYP,Cyprus,2016,0,2,-2
ISL,Iceland,CYP,Cyprus,2017,0,4,-4
ITA,Italy,CYP,Cyprus,2008,4,18,-14
ITA,Italy,CYP,Cyprus,2009,3,22,-19
ITA,Italy,CYP,Cyprus,2010,2,10,-8
ITA,Italy,CYP,Cyprus,2011,2,17,-15
ITA,Italy,CYP,Cyprus,2012,1,15,-14
ITA,Italy,CYP,Cyprus,2013,1,17,-16
ITA,Italy,CYP,Cyprus,2014,2,13,-11
ITA,Italy,CYP,Cyprus,2015,6,20,-14
ITA,Italy,CYP,Cyprus,2016,0,21,-21
ITA,Italy,CYP,Cyprus,2017,6,23,-17
JPN,Japan,CYP,Cyprus,2008,5,8,-3
JPN,Japan,CYP,Cyprus,2009,4,3,1
JPN,Japan,CYP,Cyprus,2010,2,6,-4
JPN,Japan,CYP,Cyprus,2011,3,3,0
JPN,Japan,CYP,Cyprus,2012,6,3,3
JPN,Japan,CYP,Cyprus,2013,5,11,-6
JPN,Japan,CYP,Cyprus,2014,4,11,-7
JPN,Japan,CYP,Cyprus,2015,9,11,-2
JPN,Japan,CYP,Cyprus,2016,9,15,-6
JPN,Japan,CYP,Cyprus,2017,6,14,-8
KOR,Korea,CYP,Cyprus,2008,1,4,-3
KOR,Korea,CYP,Cyprus,2009,1,1,0
KOR,Korea,CYP,Cyprus,2010,3,5,-2
KOR,Korea,CYP,Cyprus,2011,0,9,-9
KOR,Korea,CYP,Cyprus,2012,5,6,-1
KOR,Korea,CYP,Cyprus,2013,4,2,2
KOR,Korea,CYP,Cyprus,2014,4,3,1
KOR,Korea,CYP,Cyprus,2015,5,6,-1
KOR,Korea,CYP,Cyprus,2016,3,8,-5
KOR,Korea,CYP,Cyprus,2017,5,3,2
LUX,Luxembourg,CYP,Cyprus,2008,2,5,-3
LUX,Luxembourg,CYP,Cyprus,2009,0,10,-10
LUX,Luxembourg,CYP,Cyprus,2010,1,8,-7
LUX,Luxembourg,CYP,Cyprus,2011,1,11,-10
LUX,Luxembourg,CYP,Cyprus,2012,4,11,-7
LUX,Luxembourg,CYP,Cyprus,2013,3,11,-8
LUX,Luxembourg,CYP,Cyprus,2014,8,24,-16
LUX,Luxembourg,CYP,Cyprus,2015,7,15,-8
LUX,Luxembourg,CYP,Cyprus,2016,12,21,-9
LUX,Luxembourg,CYP,Cyprus,2017,12,24,-12
MEX,Mexico,CYP,Cyprus,2008,0,1,-1
MEX,Mexico,CYP,Cyprus,2010,0,1,-1
MEX,Mexico,CYP,Cyprus,2011,0,2,-2
MEX,Mexico,CYP,Cyprus,2012,0,2,-2
MEX,Mexico,CYP,Cyprus,2013,0,2,-2
MEX,Mexico,CYP,Cyprus,2014,0,2,-2
MEX,Mexico,CYP,Cyprus,2015,0,2,-2
NLD,Netherlands,CYP,Cyprus,2008,37,50,-13
NLD,Netherlands,CYP,Cyprus,2009,25,53,-28
NLD,Netherlands,CYP,Cyprus,2010,38,66,-28
NLD,Netherlands,CYP,Cyprus,2011,41,94,-53
NLD,Netherlands,CYP,Cyprus,2012,61,104,-43
NLD,Netherlands,CYP,Cyprus,2013,98,129,-31
NLD,Netherlands,CYP,Cyprus,2014,99,137,-38
NLD,Netherlands,CYP,Cyprus,2015,97,161,-64
NLD,Netherlands,CYP,Cyprus,2016,118,216,-98
NLD,Netherlands,CYP,Cyprus,2017,135,296,-161
NZL,New Zealand,CYP,Cyprus,2008,1,2,-1
NZL,New Zealand,CYP,Cyprus,2009,0,0,0
NZL,New Zealand,CYP,Cyprus,2010,1,3,-2
NZL,New Zealand,CYP,Cyprus,2011,3,2,1
NZL,New Zealand,CYP,Cyprus,2012,0,3,-3
NZL,New Zealand,CYP,Cyprus,2013,2,2,0
NZL,New Zealand,CYP,Cyprus,2014,0,1,-1
NZL,New Zealand,CYP,Cyprus,2015,1,4,-3
NZL,New Zealand,CYP,Cyprus,2016,2,1,1
NZL,New Zealand,CYP,Cyprus,2017,1,2,-1
NOR,Norway,CYP,Cyprus,2008,0,5,-5
NOR,Norway,CYP,Cyprus,2009,2,5,-3
NOR,Norway,CYP,Cyprus,2010,2,9,-7
NOR,Norway,CYP,Cyprus,2011,4,8,-4
NOR,Norway,CYP,Cyprus,2012,5,7,-2
NOR,Norway,CYP,Cyprus,2013,3,17,-14
NOR,Norway,CYP,Cyprus,2014,5,20,-15
NOR,Norway,CYP,Cyprus,2015,5,18,-13
NOR,Norway,CYP,Cyprus,2016,6,13,-7
NOR,Norway,CYP,Cyprus,2017,7,10,-3
POL,Poland,CYP,Cyprus,2008,0,6,-6
POL,Poland,CYP,Cyprus,2009,0,7,-7
POL,Poland,CYP,Cyprus,2010,0,8,-8
POL,Poland,CYP,Cyprus,2011,0,6,-6
POL,Poland,CYP,Cyprus,2012,0,8,-8
POL,Poland,CYP,Cyprus,2013,0,8,-8
POL,Poland,CYP,Cyprus,2014,0,8,-8
POL,Poland,CYP,Cyprus,2015,0,8,-8
POL,Poland,CYP,Cyprus,2016,0,6,-6
POL,Poland,CYP,Cyprus,2017,0,8,-8
SVK,Slovak Republic,CYP,Cyprus,2008,0,2,-2
SVK,Slovak Republic,CYP,Cyprus,2009,0,6,-6
SVK,Slovak Republic,CYP,Cyprus,2010,1,4,-3
SVK,Slovak Republic,CYP,Cyprus,2011,0,2,-2
SVK,Slovak Republic,CYP,Cyprus,2012,0,2,-2
SVK,Slovak Republic,CYP,Cyprus,2013,0,1,-1
SVK,Slovak Republic,CYP,Cyprus,2014,0,3,-3
SVK,Slovak Republic,CYP,Cyprus,2015,0,2,-2
SVK,Slovak Republic,CYP,Cyprus,2016,0,3,-3
SVK,Slovak Republic,CYP,Cyprus,2017,0,1,-1
ESP,Spain,CYP,Cyprus,2008,6,30,-24
ESP,Spain,CYP,Cyprus,2009,14,20,-6
ESP,Spain,CYP,Cyprus,2010,21,27,-6
ESP,Spain,CYP,Cyprus,2011,16,32,-16
ESP,Spain,CYP,Cyprus,2012,11,34,-23
ESP,Spain,CYP,Cyprus,2013,12,42,-30
ESP,Spain,CYP,Cyprus,2014,19,48,-29
ESP,Spain,CYP,Cyprus,2015,6,52,-46
ESP,Spain,CYP,Cyprus,2016,7,66,-59
ESP,Spain,CYP,Cyprus,2017,28,64,-36
SWE,Sweden,CYP,Cyprus,2008,6,41,-35
SWE,Sweden,CYP,Cyprus,2009,9,22,-13
SWE,Sweden,CYP,Cyprus,2010,11,20,-9
SWE,Sweden,CYP,Cyprus,2011,14,23,-9
SWE,Sweden,CYP,Cyprus,2012,12,24,-12
SWE,Sweden,CYP,Cyprus,2013,8,51,-43
SWE,Sweden,CYP,Cyprus,2014,11,33,-22
SWE,Sweden,CYP,Cyprus,2015,13,54,-41
SWE,Sweden,CYP,Cyprus,2016,14,46,-32
SWE,Sweden,CYP,Cyprus,2017,13,53,-40
CHE,Switzerland,CYP,Cyprus,2008,16,25,-9
CHE,Switzerland,CYP,Cyprus,2009,24,44,-20
CHE,Switzerland,CYP,Cyprus,2010,18,31,-13
CHE,Switzerland,CYP,Cyprus,2011,34,44,-10
CHE,Switzerland,CYP,Cyprus,2012,25,67,-42
CHE,Switzerland,CYP,Cyprus,2013,15,87,-72
CHE,Switzerland,CYP,Cyprus,2014,34,67,-33
CHE,Switzerland,CYP,Cyprus,2015,42,95,-53
CHE,Switzerland,CYP,Cyprus,2016,33,92,-59
CHE,Switzerland,CYP,Cyprus,2017,59,117,-58
TUR,Turkey,CYP,Cyprus,2010,0,4,-4
GBR,United Kingdom,CYP,Cyprus,2013,0,2000,-2000
GBR,United Kingdom,CYP,Cyprus,2017,0,9000,-9000
USA,United States,CYP,Cyprus,2008,0,141,-141
USA,United States,CYP,Cyprus,2009,0,142,-142
USA,United States,CYP,Cyprus,2010,0,122,-122
USA,United States,CYP,Cyprus,2011,0,101,-101
USA,United States,CYP,Cyprus,2012,0,107,-107
USA,United States,CYP,Cyprus,2013,0,126,-126
USA,United States,CYP,Cyprus,2014,0,129,-129
USA,United States,CYP,Cyprus,2015,0,113,-113
USA,United States,CYP,Cyprus,2016,0,131,-131
USA,United States,CYP,Cyprus,2017,0,117,-117
CHL,Chile,CYP,Cyprus,2008,0,0,0
CHL,Chile,CYP,Cyprus,2009,0,0,0
CHL,Chile,CYP,Cyprus,2010,0,0,0
CHL,Chile,CYP,Cyprus,2011,0,2,-2
CHL,Chile,CYP,Cyprus,2012,0,0,0
CHL,Chile,CYP,Cyprus,2013,0,1,-1
CHL,Chile,CYP,Cyprus,2014,0,1,-1
CHL,Chile,CYP,Cyprus,2015,0,3,-3
CHL,Chile,CYP,Cyprus,2016,0,1,-1
EST,Estonia,CYP,Cyprus,2008,0,1,-1
EST,Estonia,CYP,Cyprus,2009,0,2,-2
EST,Estonia,CYP,Cyprus,2010,0,0,0
EST,Estonia,CYP,Cyprus,2011,0,0,0
EST,Estonia,CYP,Cyprus,2012,0,1,-1
EST,Estonia,CYP,Cyprus,2013,0,0,0
EST,Estonia,CYP,Cyprus,2014,0,0,0
EST,Estonia,CYP,Cyprus,2015,0,4,-4
EST,Estonia,CYP,Cyprus,2016,0,5,-5
EST,Estonia,CYP,Cyprus,2017,0,1,-1
SVN,Slovenia,CYP,Cyprus,2008,0,2,-2
SVN,Slovenia,CYP,Cyprus,2009,0,1,-1
SVN,Slovenia,CYP,Cyprus,2012,0,7,-7
SVN,Slovenia,CYP,Cyprus,2013,0,5,-5
SVN,Slovenia,CYP,Cyprus,2014,1,4,-3
SVN,Slovenia,CYP,Cyprus,2015,0,3,-3
SVN,Slovenia,CYP,Cyprus,2016,0,2,-2
SVN,Slovenia,CYP,Cyprus,2017,0,6,-6
ISL,Iceland,CZE,Czech Republic,2012,0,26,-26
LUX,Luxembourg,CZE,Czech Republic,2009,0,94,-94
AUS,Australia,PRK,Democratic People's Republic of Korea,2009,96,0,96
AUS,Australia,PRK,Democratic People's Republic of Korea,2010,109,0,109
AUS,Australia,PRK,Democratic People's Republic of Korea,2011,114,0,114
AUS,Australia,PRK,Democratic People's Republic of Korea,2012,101,0,101
AUS,Australia,PRK,Democratic People's Republic of Korea,2013,79,0,79
AUS,Australia,PRK,Democratic People's Republic of Korea,2014,69,0,69
AUS,Australia,PRK,Democratic People's Republic of Korea,2015,0,0,0
AUS,Australia,PRK,Democratic People's Republic of Korea,2016,100,0,100
AUS,Australia,PRK,Democratic People's Republic of Korea,2017,0,0,0
AUT,Austria,PRK,Democratic People's Republic of Korea,2008,27,11,16
AUT,Austria,PRK,Democratic People's Republic of Korea,2009,46,9,37
AUT,Austria,PRK,Democratic People's Republic of Korea,2010,17,14,3
AUT,Austria,PRK,Democratic People's Republic of Korea,2011,15,12,3
AUT,Austria,PRK,Democratic People's Republic of Korea,2012,12,14,-2
AUT,Austria,PRK,Democratic People's Republic of Korea,2013,9,29,-20
AUT,Austria,PRK,Democratic People's Republic of Korea,2014,10,27,-17
AUT,Austria,PRK,Democratic People's Republic of Korea,2015,16,42,-26
AUT,Austria,PRK,Democratic People's Republic of Korea,2016,28,35,-7
AUT,Austria,PRK,Democratic People's Republic of Korea,2017,15,20,-5
BEL,Belgium,PRK,Democratic People's Republic of Korea,2008,0,2,-2
BEL,Belgium,PRK,Democratic People's Republic of Korea,2009,0,0,0
BEL,Belgium,PRK,Democratic People's Republic of Korea,2010,1,1,0
BEL,Belgium,PRK,Democratic People's Republic of Korea,2012,8,113,-105
BEL,Belgium,PRK,Democratic People's Republic of Korea,2013,95,40,55
BEL,Belgium,PRK,Democratic People's Republic of Korea,2014,48,3,45
BEL,Belgium,PRK,Democratic People's Republic of Korea,2015,14,1,13
BEL,Belgium,PRK,Democratic People's Republic of Korea,2017,2,2,0
CAN,Canada,PRK,Democratic People's Republic of Korea,2008,0,19,-19
CAN,Canada,PRK,Democratic People's Republic of Korea,2009,0,11,-11
CAN,Canada,PRK,Democratic People's Republic of Korea,2010,0,45,-45
CAN,Canada,PRK,Democratic People's Republic of Korea,2011,0,97,-97
CAN,Canada,PRK,Democratic People's Republic of Korea,2012,0,66,-66
CAN,Canada,PRK,Democratic People's Republic of Korea,2013,0,17,-17
CAN,Canada,PRK,Democratic People's Republic of Korea,2014,0,13,-13
CAN,Canada,PRK,Democratic People's Republic of Korea,2015,0,12,-12
CAN,Canada,PRK,Democratic People's Republic of Korea,2016,0,10,-10
CAN,Canada,PRK,Democratic People's Republic of Korea,2017,0,10,-10
CZE,Czech Republic,PRK,Democratic People's Republic of Korea,2008,0,2,-2
CZE,Czech Republic,PRK,Democratic People's Republic of Korea,2009,0,1,-1
CZE,Czech Republic,PRK,Democratic People's Republic of Korea,2010,0,4,-4
CZE,Czech Republic,PRK,Democratic People's Republic of Korea,2011,0,2,-2
CZE,Czech Republic,PRK,Democratic People's Republic of Korea,2012,2,4,-2
CZE,Czech Republic,PRK,Democratic People's Republic of Korea,2013,5,1,4
DNK,Denmark,PRK,Democratic People's Republic of Korea,2008,6,10,-4
DNK,Denmark,PRK,Democratic People's Republic of Korea,2009,19,9,10
DNK,Denmark,PRK,Democratic People's Republic of Korea,2010,12,8,4
DNK,Denmark,PRK,Democratic People's Republic of Korea,2011,8,9,-1
DNK,Denmark,PRK,Democratic People's Republic of Korea,2012,12,15,-3
DNK,Denmark,PRK,Democratic People's Republic of Korea,2013,10,18,-8
DNK,Denmark,PRK,Democratic People's Republic of Korea,2014,23,15,8
DNK,Denmark,PRK,Democratic People's Republic of Korea,2015,32,16,16
DNK,Denmark,PRK,Democratic People's Republic of Korea,2016,29,29,0
DNK,Denmark,PRK,Democratic People's Republic of Korea,2017,35,10,25
FIN,Finland,PRK,Democratic People's Republic of Korea,2008,0,0,0
FIN,Finland,PRK,Democratic People's Republic of Korea,2009,0,0,0
FIN,Finland,PRK,Democratic People's Republic of Korea,2010,0,0,0
FIN,Finland,PRK,Democratic People's Republic of Korea,2011,0,0,0
FIN,Finland,PRK,Democratic People's Republic of Korea,2012,0,0,0
FIN,Finland,PRK,Democratic People's Republic of Korea,2013,0,3,-3
FIN,Finland,PRK,Democratic People's Republic of Korea,2014,0,0,0
FIN,Finland,PRK,Democratic People's Republic of Korea,2015,0,1,-1
FIN,Finland,PRK,Democratic People's Republic of Korea,2016,0,0,0
FIN,Finland,PRK,Democratic People's Republic of Korea,2017,0,0,0
FRA,France,PRK,Democratic People's Republic of Korea,2008,0,24,-24
FRA,France,PRK,Democratic People's Republic of Korea,2009,0,38,-38
FRA,France,PRK,Democratic People's Republic of Korea,2010,0,12,-12
FRA,France,PRK,Democratic People's Republic of Korea,2011,0,14,-14
FRA,France,PRK,Democratic People's Republic of Korea,2012,0,15,-15
FRA,France,PRK,Democratic People's Republic of Korea,2013,0,9,-9
FRA,France,PRK,Democratic People's Republic of Korea,2014,0,11,-11
FRA,France,PRK,Democratic People's Republic of Korea,2015,0,7,-7
FRA,France,PRK,Democratic People's Republic of Korea,2016,0,15,-15
FRA,France,PRK,Democratic People's Republic of Korea,2017,0,9,-9
DEU,Germany,PRK,Democratic People's Republic of Korea,2008,443,213,230
DEU,Germany,PRK,Democratic People's Republic of Korea,2009,397,265,132
DEU,Germany,PRK,Democratic People's Republic of Korea,2010,131,258,-127
DEU,Germany,PRK,Democratic People's Republic of Korea,2011,232,225,7
DEU,Germany,PRK,Democratic People's Republic of Korea,2012,163,229,-66
DEU,Germany,PRK,Democratic People's Republic of Korea,2013,181,285,-104
DEU,Germany,PRK,Democratic People's Republic of Korea,2014,199,263,-64
DEU,Germany,PRK,Democratic People's Republic of Korea,2015,169,291,-122
DEU,Germany,PRK,Democratic People's Republic of Korea,2016,164,160,4
DEU,Germany,PRK,Democratic People's Republic of Korea,2017,136,181,-45
HUN,Hungary,PRK,Democratic People's Republic of Korea,2008,0,12,-12
HUN,Hungary,PRK,Democratic People's Republic of Korea,2009,0,0,0
HUN,Hungary,PRK,Democratic People's Republic of Korea,2010,0,1,-1
HUN,Hungary,PRK,Democratic People's Republic of Korea,2011,0,0,0
HUN,Hungary,PRK,Democratic People's Republic of Korea,2012,0,0,0
HUN,Hungary,PRK,Democratic People's Republic of Korea,2013,0,1,-1
HUN,Hungary,PRK,Democratic People's Republic of Korea,2014,0,0,0
HUN,Hungary,PRK,Democratic People's Republic of Korea,2015,0,0,0
HUN,Hungary,PRK,Democratic People's Republic of Korea,2016,0,0,0
HUN,Hungary,PRK,Democratic People's Republic of Korea,2017,0,1,-1
ISL,Iceland,PRK,Democratic People's Republic of Korea,2008,0,0,0
ISL,Iceland,PRK,Democratic People's Republic of Korea,2009,0,2,-2
ISL,Iceland,PRK,Democratic People's Republic of Korea,2010,2,0,2
ISL,Iceland,PRK,Democratic People's Republic of Korea,2011,0,0,0
ISL,Iceland,PRK,Democratic People's Republic of Korea,2012,0,0,0
ISL,Iceland,PRK,Democratic People's Republic of Korea,2013,0,0,0
ISL,Iceland,PRK,Democratic People's Republic of Korea,2014,0,0,0
ISL,Iceland,PRK,Democratic People's Republic of Korea,2015,0,0,0
ISL,Iceland,PRK,Democratic People's Republic of Korea,2016,0,1,-1
ISL,Iceland,PRK,Democratic People's Republic of Korea,2017,0,0,0
ITA,Italy,PRK,Democratic People's Republic of Korea,2008,0,10,-10
ITA,Italy,PRK,Democratic People's Republic of Korea,2009,0,19,-19
ITA,Italy,PRK,Democratic People's Republic of Korea,2010,2,21,-19
ITA,Italy,PRK,Democratic People's Republic of Korea,2011,1,24,-23
ITA,Italy,PRK,Democratic People's Republic of Korea,2012,29,27,2
ITA,Italy,PRK,Democratic People's Republic of Korea,2013,8,21,-13
ITA,Italy,PRK,Democratic People's Republic of Korea,2014,0,7,-7
ITA,Italy,PRK,Democratic People's Republic of Korea,2015,0,8,-8
ITA,Italy,PRK,Democratic People's Republic of Korea,2016,0,14,-14
ITA,Italy,PRK,Democratic People's Republic of Korea,2017,0,19,-19
JPN,Japan,PRK,Democratic People's Republic of Korea,2008,0,7,-7
JPN,Japan,PRK,Democratic People's Republic of Korea,2009,0,1,-1
JPN,Japan,PRK,Democratic People's Republic of Korea,2010,0,1,-1
JPN,Japan,PRK,Democratic People's Republic of Korea,2011,9,11,-2
JPN,Japan,PRK,Democratic People's Republic of Korea,2012,0,2,-2
JPN,Japan,PRK,Democratic People's Republic of Korea,2013,0,1,-1
JPN,Japan,PRK,Democratic People's Republic of Korea,2014,0,0,0
JPN,Japan,PRK,Democratic People's Republic of Korea,2015,0,0,0
JPN,Japan,PRK,Democratic People's Republic of Korea,2016,0,0,0
JPN,Japan,PRK,Democratic People's Republic of Korea,2017,0,0,0
KOR,Korea,PRK,Democratic People's Republic of Korea,2008,0,0,0
KOR,Korea,PRK,Democratic People's Republic of Korea,2009,0,0,0
KOR,Korea,PRK,Democratic People's Republic of Korea,2010,0,0,0
KOR,Korea,PRK,Democratic People's Republic of Korea,2011,0,0,0
KOR,Korea,PRK,Democratic People's Republic of Korea,2012,0,0,0
KOR,Korea,PRK,Democratic People's Republic of Korea,2013,0,0,0
KOR,Korea,PRK,Democratic People's Republic of Korea,2014,0,0,0
KOR,Korea,PRK,Democratic People's Republic of Korea,2015,0,0,0
KOR,Korea,PRK,Democratic People's Republic of Korea,2016,0,0,0
KOR,Korea,PRK,Democratic People's Republic of Korea,2017,0,0,0
LUX,Luxembourg,PRK,Democratic People's Republic of Korea,2008,0,3,-3
LUX,Luxembourg,PRK,Democratic People's Republic of Korea,2009,0,0,0
LUX,Luxembourg,PRK,Democratic People's Republic of Korea,2010,11,0,11
LUX,Luxembourg,PRK,Democratic People's Republic of Korea,2011,0,1,-1
LUX,Luxembourg,PRK,Democratic People's Republic of Korea,2012,1,1,0
LUX,Luxembourg,PRK,Democratic People's Republic of Korea,2013,1,9,-8
LUX,Luxembourg,PRK,Democratic People's Republic of Korea,2014,0,0,0
LUX,Luxembourg,PRK,Democratic People's Republic of Korea,2015,0,0,0
LUX,Luxembourg,PRK,Democratic People's Republic of Korea,2016,5,0,5
LUX,Luxembourg,PRK,Democratic People's Republic of Korea,2017,0,2,-2
MEX,Mexico,PRK,Democratic People's Republic of Korea,2008,0,4,-4
MEX,Mexico,PRK,Democratic People's Republic of Korea,2009,0,4,-4
MEX,Mexico,PRK,Democratic People's Republic of Korea,2010,0,5,-5
MEX,Mexico,PRK,Democratic People's Republic of Korea,2011,0,1,-1
MEX,Mexico,PRK,Democratic People's Republic of Korea,2012,0,1,-1
MEX,Mexico,PRK,Democratic People's Republic of Korea,2013,0,0,0
MEX,Mexico,PRK,Democratic People's Republic of Korea,2014,0,0,0
MEX,Mexico,PRK,Democratic People's Republic of Korea,2015,0,3,-3
MEX,Mexico,PRK,Democratic People's Republic of Korea,2017,0,1,-1
NLD,Netherlands,PRK,Democratic People's Republic of Korea,2008,386,2,384
NLD,Netherlands,PRK,Democratic People's Republic of Korea,2010,496,2,494
NLD,Netherlands,PRK,Democratic People's Republic of Korea,2011,583,13,570
NLD,Netherlands,PRK,Democratic People's Republic of Korea,2014,5,27,-22
NLD,Netherlands,PRK,Democratic People's Republic of Korea,2015,14,1,13
NLD,Netherlands,PRK,Democratic People's Republic of Korea,2016,1,1,0
NLD,Netherlands,PRK,Democratic People's Republic of Korea,2017,3,2,1
NZL,New Zealand,PRK,Democratic People's Republic of Korea,2009,2,0,2
NOR,Norway,PRK,Democratic People's Republic of Korea,2008,4,0,4
NOR,Norway,PRK,Democratic People's Republic of Korea,2009,0,4,-4
NOR,Norway,PRK,Democratic People's Republic of Korea,2010,4,0,4
NOR,Norway,PRK,Democratic People's Republic of Korea,2011,0,4,-4
NOR,Norway,PRK,Democratic People's Republic of Korea,2012,0,1,-1
NOR,Norway,PRK,Democratic People's Republic of Korea,2013,1,1,0
NOR,Norway,PRK,Democratic People's Republic of Korea,2014,1,1,0
NOR,Norway,PRK,Democratic People's Republic of Korea,2015,1,0,1
NOR,Norway,PRK,Democratic People's Republic of Korea,2016,0,0,0
NOR,Norway,PRK,Democratic People's Republic of Korea,2017,0,0,0
POL,Poland,PRK,Democratic People's Republic of Korea,2009,0,152,-152
POL,Poland,PRK,Democratic People's Republic of Korea,2010,0,151,-151
POL,Poland,PRK,Democratic People's Republic of Korea,2011,0,280,-280
POL,Poland,PRK,Democratic People's Republic of Korea,2012,0,187,-187
POL,Poland,PRK,Democratic People's Republic of Korea,2013,0,283,-283
POL,Poland,PRK,Democratic People's Republic of Korea,2014,0,130,-130
POL,Poland,PRK,Democratic People's Republic of Korea,2015,0,356,-356
POL,Poland,PRK,Democratic People's Republic of Korea,2016,0,349,-349
POL,Poland,PRK,Democratic People's Republic of Korea,2017,0,128,-128
SVK,Slovak Republic,PRK,Democratic People's Republic of Korea,2008,0,0,0
ESP,Spain,PRK,Democratic People's Republic of Korea,2008,3,10,-7
ESP,Spain,PRK,Democratic People's Republic of Korea,2009,8,8,0
ESP,Spain,PRK,Democratic People's Republic of Korea,2010,2,14,-12
ESP,Spain,PRK,Democratic People's Republic of Korea,2011,6,8,-2
ESP,Spain,PRK,Democratic People's Republic of Korea,2012,4,6,-2
ESP,Spain,PRK,Democratic People's Republic of Korea,2013,5,10,-5
ESP,Spain,PRK,Democratic People's Republic of Korea,2014,0,9,-9
ESP,Spain,PRK,Democratic People's Republic of Korea,2015,4,8,-4
ESP,Spain,PRK,Democratic People's Republic of Korea,2016,4,8,-4
ESP,Spain,PRK,Democratic People's Republic of Korea,2017,11,17,-6
SWE,Sweden,PRK,Democratic People's Republic of Korea,2008,0,5,-5
SWE,Sweden,PRK,Democratic People's Republic of Korea,2009,1,10,-9
SWE,Sweden,PRK,Democratic People's Republic of Korea,2010,1,1,0
SWE,Sweden,PRK,Democratic People's Republic of Korea,2011,1,4,-3
SWE,Sweden,PRK,Democratic People's Republic of Korea,2012,4,0,4
SWE,Sweden,PRK,Democratic People's Republic of Korea,2013,0,3,-3
SWE,Sweden,PRK,Democratic People's Republic of Korea,2014,1,0,1
SWE,Sweden,PRK,Democratic People's Republic of Korea,2015,0,2,-2
SWE,Sweden,PRK,Democratic People's Republic of Korea,2016,2,5,-3
SWE,Sweden,PRK,Democratic People's Republic of Korea,2017,0,0,0
CHE,Switzerland,PRK,Democratic People's Republic of Korea,2010,1,13,-12
CHE,Switzerland,PRK,Democratic People's Republic of Korea,2011,2,1,1
CHE,Switzerland,PRK,Democratic People's Republic of Korea,2012,0,4,-4
CHE,Switzerland,PRK,Democratic People's Republic of Korea,2013,6,5,1
CHE,Switzerland,PRK,Democratic People's Republic of Korea,2014,4,0,4
CHE,Switzerland,PRK,Democratic People's Republic of Korea,2015,1,0,1
CHE,Switzerland,PRK,Democratic People's Republic of Korea,2016,4,2,2
CHE,Switzerland,PRK,Democratic People's Republic of Korea,2017,5,2,3
TUR,Turkey,PRK,Democratic People's Republic of Korea,2010,0,3,-3
USA,United States,PRK,Democratic People's Republic of Korea,2009,0,67,-67
USA,United States,PRK,Democratic People's Republic of Korea,2010,0,35,-35
USA,United States,PRK,Democratic People's Republic of Korea,2011,0,36,-36
USA,United States,PRK,Democratic People's Republic of Korea,2012,0,49,-49
USA,United States,PRK,Democratic People's Republic of Korea,2013,0,48,-48
USA,United States,PRK,Democratic People's Republic of Korea,2014,0,142,-142
USA,United States,PRK,Democratic People's Republic of Korea,2015,0,55,-55
USA,United States,PRK,Democratic People's Republic of Korea,2016,0,47,-47
USA,United States,PRK,Democratic People's Republic of Korea,2017,0,32,-32
CHL,Chile,PRK,Democratic People's Republic of Korea,2008,0,14,-14
CHL,Chile,PRK,Democratic People's Republic of Korea,2009,0,40,-40
CHL,Chile,PRK,Democratic People's Republic of Korea,2010,0,4,-4
CHL,Chile,PRK,Democratic People's Republic of Korea,2011,0,9,-9
CHL,Chile,PRK,Democratic People's Republic of Korea,2012,0,6,-6
CHL,Chile,PRK,Democratic People's Republic of Korea,2013,0,3,-3
CHL,Chile,PRK,Democratic People's Republic of Korea,2014,0,3,-3
CHL,Chile,PRK,Democratic People's Republic of Korea,2015,0,0,0
CHL,Chile,PRK,Democratic People's Republic of Korea,2016,0,0,0
EST,Estonia,PRK,Democratic People's Republic of Korea,2008,0,0,0
EST,Estonia,PRK,Democratic People's Republic of Korea,2009,0,0,0
EST,Estonia,PRK,Democratic People's Republic of Korea,2010,0,0,0
EST,Estonia,PRK,Democratic People's Republic of Korea,2011,0,0,0
EST,Estonia,PRK,Democratic People's Republic of Korea,2012,0,0,0
EST,Estonia,PRK,Democratic People's Republic of Korea,2013,0,0,0
EST,Estonia,PRK,Democratic People's Republic of Korea,2014,0,0,0
EST,Estonia,PRK,Democratic People's Republic of Korea,2015,0,0,0
EST,Estonia,PRK,Democratic People's Republic of Korea,2016,0,0,0
EST,Estonia,PRK,Democratic People's Republic of Korea,2017,0,0,0
AUS,Australia,COD,Democratic Republic of the Congo,2008,0,456,-456
AUS,Australia,COD,Democratic Republic of the Congo,2009,0,218,-218
AUS,Australia,COD,Democratic Republic of the Congo,2010,8,404,-396
AUS,Australia,COD,Democratic Republic of the Congo,2011,7,359,-352
AUS,Australia,COD,Democratic Republic of the Congo,2012,8,420,-412
AUS,Australia,COD,Democratic Republic of the Congo,2013,6,266,-260
AUS,Australia,COD,Democratic Republic of the Congo,2014,6,572,-566
AUS,Australia,COD,Democratic Republic of the Congo,2015,0,416,-416
AUS,Australia,COD,Democratic Republic of the Congo,2016,0,719,-719
AUS,Australia,COD,Democratic Republic of the Congo,2017,0,372,-372
AUT,Austria,COD,Democratic Republic of the Congo,2008,6,39,-33
AUT,Austria,COD,Democratic Republic of the Congo,2009,21,34,-13
AUT,Austria,COD,Democratic Republic of the Congo,2010,19,39,-20
AUT,Austria,COD,Democratic Republic of the Congo,2011,19,34,-15
AUT,Austria,COD,Democratic Republic of the Congo,2012,17,36,-19
AUT,Austria,COD,Democratic Republic of the Congo,2013,8,39,-31
AUT,Austria,COD,Democratic Republic of the Congo,2014,14,44,-30
AUT,Austria,COD,Democratic Republic of the Congo,2015,13,36,-23
AUT,Austria,COD,Democratic Republic of the Congo,2016,17,31,-14
AUT,Austria,COD,Democratic Republic of the Congo,2017,17,31,-14
BEL,Belgium,COD,Democratic Republic of the Congo,2008,300,1164,-864
BEL,Belgium,COD,Democratic Republic of the Congo,2009,203,1231,-1028
BEL,Belgium,COD,Democratic Republic of the Congo,2010,310,1403,-1093
BEL,Belgium,COD,Democratic Republic of the Congo,2011,382,1522,-1140
BEL,Belgium,COD,Democratic Republic of the Congo,2012,722,2432,-1710
BEL,Belgium,COD,Democratic Republic of the Congo,2013,1076,2028,-952
BEL,Belgium,COD,Democratic Republic of the Congo,2014,1314,1516,-202
BEL,Belgium,COD,Democratic Republic of the Congo,2015,976,1608,-632
BEL,Belgium,COD,Democratic Republic of the Congo,2016,651,1348,-697
BEL,Belgium,COD,Democratic Republic of the Congo,2017,512,1581,-1069
CAN,Canada,COD,Democratic Republic of the Congo,2008,0,1395,-1395
CAN,Canada,COD,Democratic Republic of the Congo,2009,0,1580,-1580
CAN,Canada,COD,Democratic Republic of the Congo,2010,0,1237,-1237
CAN,Canada,COD,Democratic Republic of the Congo,2011,0,1217,-1217
CAN,Canada,COD,Democratic Republic of the Congo,2012,0,1711,-1711
CAN,Canada,COD,Democratic Republic of the Congo,2013,0,2050,-2050
CAN,Canada,COD,Democratic Republic of the Congo,2014,0,1749,-1749
CAN,Canada,COD,Democratic Republic of the Congo,2015,0,1714,-1714
CAN,Canada,COD,Democratic Republic of the Congo,2016,0,2550,-2550
CAN,Canada,COD,Democratic Republic of the Congo,2017,0,2400,-2400
CZE,Czech Republic,COD,Democratic Republic of the Congo,2008,0,13,-13
CZE,Czech Republic,COD,Democratic Republic of the Congo,2009,0,5,-5
CZE,Czech Republic,COD,Democratic Republic of the Congo,2010,0,10,-10
CZE,Czech Republic,COD,Democratic Republic of the Congo,2011,0,8,-8
CZE,Czech Republic,COD,Democratic Republic of the Congo,2012,4,7,-3
CZE,Czech Republic,COD,Democratic Republic of the Congo,2013,7,9,-2
CZE,Czech Republic,COD,Democratic Republic of the Congo,2014,8,9,-1
CZE,Czech Republic,COD,Democratic Republic of the Congo,2015,7,7,0
CZE,Czech Republic,COD,Democratic Republic of the Congo,2016,9,6,3
CZE,Czech Republic,COD,Democratic Republic of the Congo,2017,7,5,2
DNK,Denmark,COD,Democratic Republic of the Congo,2008,1,169,-168
DNK,Denmark,COD,Democratic Republic of the Congo,2009,2,25,-23
DNK,Denmark,COD,Democratic Republic of the Congo,2010,3,99,-96
DNK,Denmark,COD,Democratic Republic of the Congo,2011,8,107,-99
DNK,Denmark,COD,Democratic Republic of the Congo,2012,1,167,-166
DNK,Denmark,COD,Democratic Republic of the Congo,2013,4,53,-49
DNK,Denmark,COD,Democratic Republic of the Congo,2014,4,186,-182
DNK,Denmark,COD,Democratic Republic of the Congo,2015,17,265,-248
DNK,Denmark,COD,Democratic Republic of the Congo,2016,15,53,-38
DNK,Denmark,COD,Democratic Republic of the Congo,2017,19,55,-36
FIN,Finland,COD,Democratic Republic of the Congo,2008,6,168,-162
FIN,Finland,COD,Democratic Republic of the Congo,2009,0,159,-159
FIN,Finland,COD,Democratic Republic of the Congo,2010,5,194,-189
FIN,Finland,COD,Democratic Republic of the Congo,2011,1,103,-102
FIN,Finland,COD,Democratic Republic of the Congo,2012,1,308,-307
FIN,Finland,COD,Democratic Republic of the Congo,2013,3,86,-83
FIN,Finland,COD,Democratic Republic of the Congo,2014,9,238,-229
FIN,Finland,COD,Democratic Republic of the Congo,2015,5,240,-235
FIN,Finland,COD,Democratic Republic of the Congo,2016,8,249,-241
FIN,Finland,COD,Democratic Republic of the Congo,2017,11,47,-36
FRA,France,COD,Democratic Republic of the Congo,2008,0,3723,-3723
FRA,France,COD,Democratic Republic of the Congo,2009,0,3521,-3521
FRA,France,COD,Democratic Republic of the Congo,2010,0,3409,-3409
FRA,France,COD,Democratic Republic of the Congo,2011,0,3558,-3558
FRA,France,COD,Democratic Republic of the Congo,2012,0,3881,-3881
FRA,France,COD,Democratic Republic of the Congo,2013,0,4296,-4296
FRA,France,COD,Democratic Republic of the Congo,2014,0,4342,-4342
FRA,France,COD,Democratic Republic of the Congo,2015,0,4172,-4172
FRA,France,COD,Democratic Republic of the Congo,2016,0,4438,-4438
FRA,France,COD,Democratic Republic of the Congo,2017,0,4345,-4345
DEU,Germany,COD,Democratic Republic of the Congo,2008,195,223,-28
DEU,Germany,COD,Democratic Republic of the Congo,2009,200,290,-90
DEU,Germany,COD,Democratic Republic of the Congo,2010,286,258,28
DEU,Germany,COD,Democratic Republic of the Congo,2011,167,188,-21
DEU,Germany,COD,Democratic Republic of the Congo,2012,145,190,-45
DEU,Germany,COD,Democratic Republic of the Congo,2013,291,337,-46
DEU,Germany,COD,Democratic Republic of the Congo,2014,212,233,-21
DEU,Germany,COD,Democratic Republic of the Congo,2015,212,335,-123
DEU,Germany,COD,Democratic Republic of the Congo,2016,243,368,-125
DEU,Germany,COD,Democratic Republic of the Congo,2017,214,435,-221
HUN,Hungary,COD,Democratic Republic of the Congo,2008,0,1,-1
HUN,Hungary,COD,Democratic Republic of the Congo,2009,0,0,0
HUN,Hungary,COD,Democratic Republic of the Congo,2010,0,2,-2
HUN,Hungary,COD,Democratic Republic of the Congo,2011,0,1,-1
HUN,Hungary,COD,Democratic Republic of the Congo,2012,0,2,-2
HUN,Hungary,COD,Democratic Republic of the Congo,2013,0,1,-1
HUN,Hungary,COD,Democratic Republic of the Congo,2014,0,5,-5
HUN,Hungary,COD,Democratic Republic of the Congo,2015,1,2,-1
HUN,Hungary,COD,Democratic Republic of the Congo,2016,0,14,-14
HUN,Hungary,COD,Democratic Republic of the Congo,2017,0,15,-15
ISL,Iceland,COD,Democratic Republic of the Congo,2008,0,0,0
ISL,Iceland,COD,Democratic Republic of the Congo,2009,0,0,0
ISL,Iceland,COD,Democratic Republic of the Congo,2010,0,0,0
ISL,Iceland,COD,Democratic Republic of the Congo,2011,0,0,0
ISL,Iceland,COD,Democratic Republic of the Congo,2012,0,0,0
ISL,Iceland,COD,Democratic Republic of the Congo,2016,0,0,0
ISL,Iceland,COD,Democratic Republic of the Congo,2017,0,0,0
ITA,Italy,COD,Democratic Republic of the Congo,2008,9,233,-224
ITA,Italy,COD,Democratic Republic of the Congo,2009,11,232,-221
ITA,Italy,COD,Democratic Republic of the Congo,2010,11,236,-225
ITA,Italy,COD,Democratic Republic of the Congo,2011,19,236,-217
ITA,Italy,COD,Democratic Republic of the Congo,2012,23,323,-300
ITA,Italy,COD,Democratic Republic of the Congo,2013,5,192,-187
ITA,Italy,COD,Democratic Republic of the Congo,2014,22,214,-192
ITA,Italy,COD,Democratic Republic of the Congo,2015,13,213,-200
ITA,Italy,COD,Democratic Republic of the Congo,2016,0,278,-278
ITA,Italy,COD,Democratic Republic of the Congo,2017,23,249,-226
JPN,Japan,COD,Democratic Republic of the Congo,2008,65,70,-5
JPN,Japan,COD,Democratic Republic of the Congo,2009,28,41,-13
JPN,Japan,COD,Democratic Republic of the Congo,2010,108,111,-3
JPN,Japan,COD,Democratic Republic of the Congo,2011,94,90,4
JPN,Japan,COD,Democratic Republic of the Congo,2012,26,138,-112
JPN,Japan,COD,Democratic Republic of the Congo,2013,144,157,-13
JPN,Japan,COD,Democratic Republic of the Congo,2014,142,167,-25
JPN,Japan,COD,Democratic Republic of the Congo,2015,192,220,-28
JPN,Japan,COD,Democratic Republic of the Congo,2016,138,152,-14
JPN,Japan,COD,Democratic Republic of the Congo,2017,137,164,-27
KOR,Korea,COD,Democratic Republic of the Congo,2008,17,14,3
KOR,Korea,COD,Democratic Republic of the Congo,2009,14,8,6
KOR,Korea,COD,Democratic Republic of the Congo,2010,21,46,-25
KOR,Korea,COD,Democratic Republic of the Congo,2011,14,29,-15
KOR,Korea,COD,Democratic Republic of the Congo,2012,31,30,1
KOR,Korea,COD,Democratic Republic of the Congo,2013,19,26,-7
KOR,Korea,COD,Democratic Republic of the Congo,2014,24,33,-9
KOR,Korea,COD,Democratic Republic of the Congo,2015,25,32,-7
KOR,Korea,COD,Democratic Republic of the Congo,2016,17,24,-7
KOR,Korea,COD,Democratic Republic of the Congo,2017,19,43,-24
LUX,Luxembourg,COD,Democratic Republic of the Congo,2008,11,9,2
LUX,Luxembourg,COD,Democratic Republic of the Congo,2009,3,10,-7
LUX,Luxembourg,COD,Democratic Republic of the Congo,2010,7,15,-8
LUX,Luxembourg,COD,Democratic Republic of the Congo,2011,2,22,-20
LUX,Luxembourg,COD,Democratic Republic of the Congo,2012,7,12,-5
LUX,Luxembourg,COD,Democratic Republic of the Congo,2013,7,22,-15
LUX,Luxembourg,COD,Democratic Republic of the Congo,2014,4,13,-9
LUX,Luxembourg,COD,Democratic Republic of the Congo,2015,4,23,-19
LUX,Luxembourg,COD,Democratic Republic of the Congo,2016,10,30,-20
LUX,Luxembourg,COD,Democratic Republic of the Congo,2017,8,17,-9
MEX,Mexico,COD,Democratic Republic of the Congo,2008,0,1,-1
MEX,Mexico,COD,Democratic Republic of the Congo,2009,0,3,-3
MEX,Mexico,COD,Democratic Republic of the Congo,2010,0,2,-2
MEX,Mexico,COD,Democratic Republic of the Congo,2011,0,27,-27
MEX,Mexico,COD,Democratic Republic of the Congo,2012,0,10,-10
MEX,Mexico,COD,Democratic Republic of the Congo,2013,0,18,-18
MEX,Mexico,COD,Democratic Republic of the Congo,2014,0,12,-12
MEX,Mexico,COD,Democratic Republic of the Congo,2015,0,9,-9
MEX,Mexico,COD,Democratic Republic of the Congo,2016,0,21,-21
MEX,Mexico,COD,Democratic Republic of the Congo,2017,0,7,-7
NLD,Netherlands,COD,Democratic Republic of the Congo,2009,11,13,-2
NLD,Netherlands,COD,Democratic Republic of the Congo,2010,39,35,4
NLD,Netherlands,COD,Democratic Republic of the Congo,2011,19,27,-8
NLD,Netherlands,COD,Democratic Republic of the Congo,2012,16,26,-10
NLD,Netherlands,COD,Democratic Republic of the Congo,2013,11,40,-29
NLD,Netherlands,COD,Democratic Republic of the Congo,2014,14,18,-4
NLD,Netherlands,COD,Democratic Republic of the Congo,2015,10,98,-88
NLD,Netherlands,COD,Democratic Republic of the Congo,2016,10,91,-81
NLD,Netherlands,COD,Democratic Republic of the Congo,2017,10,48,-38
NZL,New Zealand,COD,Democratic Republic of the Congo,2008,0,10,-10
NZL,New Zealand,COD,Democratic Republic of the Congo,2009,0,42,-42
NZL,New Zealand,COD,Democratic Republic of the Congo,2010,0,19,-19
NZL,New Zealand,COD,Democratic Republic of the Congo,2011,1,6,-5
NZL,New Zealand,COD,Democratic Republic of the Congo,2012,0,3,-3
NZL,New Zealand,COD,Democratic Republic of the Congo,2013,0,12,-12
NZL,New Zealand,COD,Democratic Republic of the Congo,2014,1,7,-6
NZL,New Zealand,COD,Democratic Republic of the Congo,2015,0,12,-12
NZL,New Zealand,COD,Democratic Republic of the Congo,2016,0,4,-4
NZL,New Zealand,COD,Democratic Republic of the Congo,2017,0,13,-13
NOR,Norway,COD,Democratic Republic of the Congo,2008,5,83,-78
NOR,Norway,COD,Democratic Republic of the Congo,2009,5,19,-14
NOR,Norway,COD,Democratic Republic of the Congo,2010,6,14,-8
NOR,Norway,COD,Democratic Republic of the Congo,2011,7,29,-22
NOR,Norway,COD,Democratic Republic of the Congo,2012,10,30,-20
NOR,Norway,COD,Democratic Republic of the Congo,2013,2,35,-33
NOR,Norway,COD,Democratic Republic of the Congo,2014,3,24,-21
NOR,Norway,COD,Democratic Republic of the Congo,2015,17,19,-2
NOR,Norway,COD,Democratic Republic of the Congo,2016,8,14,-6
NOR,Norway,COD,Democratic Republic of the Congo,2017,12,11,1
POL,Poland,COD,Democratic Republic of the Congo,2008,0,26,-26
POL,Poland,COD,Democratic Republic of the Congo,2009,0,21,-21
POL,Poland,COD,Democratic Republic of the Congo,2010,0,15,-15
POL,Poland,COD,Democratic Republic of the Congo,2011,0,14,-14
POL,Poland,COD,Democratic Republic of the Congo,2012,0,13,-13
POL,Poland,COD,Democratic Republic of the Congo,2013,0,9,-9
POL,Poland,COD,Democratic Republic of the Congo,2014,0,6,-6
POL,Poland,COD,Democratic Republic of the Congo,2015,0,8,-8
POL,Poland,COD,Democratic Republic of the Congo,2016,0,10,-10
POL,Poland,COD,Democratic Republic of the Congo,2017,0,16,-16
SVK,Slovak Republic,COD,Democratic Republic of the Congo,2008,1,1,0
SVK,Slovak Republic,COD,Democratic Republic of the Congo,2009,4,4,0
SVK,Slovak Republic,COD,Democratic Republic of the Congo,2010,1,3,-2
ESP,Spain,COD,Democratic Republic of the Congo,2008,57,105,-48
ESP,Spain,COD,Democratic Republic of the Congo,2009,76,104,-28
ESP,Spain,COD,Democratic Republic of the Congo,2010,95,66,29
ESP,Spain,COD,Democratic Republic of the Congo,2011,130,68,62
ESP,Spain,COD,Democratic Republic of the Congo,2012,118,78,40
ESP,Spain,COD,Democratic Republic of the Congo,2013,72,82,-10
ESP,Spain,COD,Democratic Republic of the Congo,2014,77,70,7
ESP,Spain,COD,Democratic Republic of the Congo,2015,59,52,7
ESP,Spain,COD,Democratic Republic of the Congo,2016,42,97,-55
ESP,Spain,COD,Democratic Republic of the Congo,2017,70,61,9
SWE,Sweden,COD,Democratic Republic of the Congo,2008,5,201,-196
SWE,Sweden,COD,Democratic Republic of the Congo,2009,2,198,-196
SWE,Sweden,COD,Democratic Republic of the Congo,2010,10,186,-176
SWE,Sweden,COD,Democratic Republic of the Congo,2011,14,196,-182
SWE,Sweden,COD,Democratic Republic of the Congo,2012,6,197,-191
SWE,Sweden,COD,Democratic Republic of the Congo,2013,13,289,-276
SWE,Sweden,COD,Democratic Republic of the Congo,2014,17,336,-319
SWE,Sweden,COD,Democratic Republic of the Congo,2015,16,347,-331
SWE,Sweden,COD,Democratic Republic of the Congo,2016,7,432,-425
SWE,Sweden,COD,Democratic Republic of the Congo,2017,4,660,-656
CHE,Switzerland,COD,Democratic Republic of the Congo,2010,30,362,-332
CHE,Switzerland,COD,Democratic Republic of the Congo,2012,31,208,-177
CHE,Switzerland,COD,Democratic Republic of the Congo,2013,22,239,-217
CHE,Switzerland,COD,Democratic Republic of the Congo,2014,29,301,-272
CHE,Switzerland,COD,Democratic Republic of the Congo,2015,11,247,-236
CHE,Switzerland,COD,Democratic Republic of the Congo,2016,34,209,-175
CHE,Switzerland,COD,Democratic Republic of the Congo,2017,13,200,-187
TUR,Turkey,COD,Democratic Republic of the Congo,2017,59,172,-113
USA,United States,COD,Democratic Republic of the Congo,2008,0,1261,-1261
USA,United States,COD,Democratic Republic of the Congo,2009,0,2122,-2122
USA,United States,COD,Democratic Republic of the Congo,2010,0,1764,-1764
USA,United States,COD,Democratic Republic of the Congo,2011,0,2424,-2424
USA,United States,COD,Democratic Republic of the Congo,2012,0,3731,-3731
USA,United States,COD,Democratic Republic of the Congo,2013,0,2792,-2792
USA,United States,COD,Democratic Republic of the Congo,2014,0,4347,-4347
USA,United States,COD,Democratic Republic of the Congo,2015,0,5345,-5345
USA,United States,COD,Democratic Republic of the Congo,2016,0,6791,-6791
USA,United States,COD,Democratic Republic of the Congo,2017,0,8709,-8709
CHL,Chile,COD,Democratic Republic of the Congo,2008,0,5,-5
CHL,Chile,COD,Democratic Republic of the Congo,2009,0,4,-4
CHL,Chile,COD,Democratic Republic of the Congo,2010,0,5,-5
CHL,Chile,COD,Democratic Republic of the Congo,2011,0,4,-4
CHL,Chile,COD,Democratic Republic of the Congo,2012,0,13,-13
CHL,Chile,COD,Democratic Republic of the Congo,2013,0,2,-2
CHL,Chile,COD,Democratic Republic of the Congo,2014,0,8,-8
CHL,Chile,COD,Democratic Republic of the Congo,2015,0,5,-5
CHL,Chile,COD,Democratic Republic of the Congo,2016,0,3,-3
EST,Estonia,COD,Democratic Republic of the Congo,2008,0,0,0
EST,Estonia,COD,Democratic Republic of the Congo,2009,0,0,0
EST,Estonia,COD,Democratic Republic of the Congo,2010,0,0,0
EST,Estonia,COD,Democratic Republic of the Congo,2011,0,0,0
EST,Estonia,COD,Democratic Republic of the Congo,2012,0,0,0
EST,Estonia,COD,Democratic Republic of the Congo,2013,0,0,0
EST,Estonia,COD,Democratic Republic of the Congo,2014,0,0,0
EST,Estonia,COD,Democratic Republic of the Congo,2015,0,3,-3
EST,Estonia,COD,Democratic Republic of the Congo,2016,0,2,-2
EST,Estonia,COD,Democratic Republic of the Congo,2017,0,3,-3
SVN,Slovenia,COD,Democratic Republic of the Congo,2013,0,1,-1
AUS,Australia,DJI,Djibouti,2008,0,1,-1
AUS,Australia,DJI,Djibouti,2009,0,3,-3
AUS,Australia,DJI,Djibouti,2010,0,4,-4
AUS,Australia,DJI,Djibouti,2011,0,11,-11
AUS,Australia,DJI,Djibouti,2012,0,13,-13
AUS,Australia,DJI,Djibouti,2013,0,1,-1
AUS,Australia,DJI,Djibouti,2014,0,6,-6
AUS,Australia,DJI,Djibouti,2015,0,0,0
AUS,Australia,DJI,Djibouti,2016,0,6,-6
AUS,Australia,DJI,Djibouti,2017,0,6,-6
AUT,Austria,DJI,Djibouti,2008,0,0,0
AUT,Austria,DJI,Djibouti,2009,0,0,0
AUT,Austria,DJI,Djibouti,2010,0,0,0
AUT,Austria,DJI,Djibouti,2011,0,2,-2
AUT,Austria,DJI,Djibouti,2012,0,0,0
AUT,Austria,DJI,Djibouti,2013,2,0,2
AUT,Austria,DJI,Djibouti,2014,0,0,0
AUT,Austria,DJI,Djibouti,2015,0,1,-1
AUT,Austria,DJI,Djibouti,2016,1,1,0
AUT,Austria,DJI,Djibouti,2017,0,0,0
BEL,Belgium,DJI,Djibouti,2008,0,14,-14
BEL,Belgium,DJI,Djibouti,2009,0,28,-28
BEL,Belgium,DJI,Djibouti,2010,5,28,-23
BEL,Belgium,DJI,Djibouti,2012,26,123,-97
BEL,Belgium,DJI,Djibouti,2013,22,149,-127
BEL,Belgium,DJI,Djibouti,2014,42,139,-97
BEL,Belgium,DJI,Djibouti,2015,44,126,-82
BEL,Belgium,DJI,Djibouti,2016,23,119,-96
BEL,Belgium,DJI,Djibouti,2017,28,87,-59
CAN,Canada,DJI,Djibouti,2008,0,47,-47
CAN,Canada,DJI,Djibouti,2009,0,70,-70
CAN,Canada,DJI,Djibouti,2010,0,123,-123
CAN,Canada,DJI,Djibouti,2011,0,127,-127
CAN,Canada,DJI,Djibouti,2012,0,164,-164
CAN,Canada,DJI,Djibouti,2013,0,204,-204
CAN,Canada,DJI,Djibouti,2014,0,99,-99
CAN,Canada,DJI,Djibouti,2015,0,147,-147
CAN,Canada,DJI,Djibouti,2016,0,270,-270
CAN,Canada,DJI,Djibouti,2017,0,185,-185
DNK,Denmark,DJI,Djibouti,2008,0,1,-1
DNK,Denmark,DJI,Djibouti,2009,0,0,0
DNK,Denmark,DJI,Djibouti,2012,0,0,0
DNK,Denmark,DJI,Djibouti,2013,0,0,0
DNK,Denmark,DJI,Djibouti,2014,0,1,-1
DNK,Denmark,DJI,Djibouti,2015,0,0,0
DNK,Denmark,DJI,Djibouti,2016,0,2,-2
DNK,Denmark,DJI,Djibouti,2017,0,1,-1
FIN,Finland,DJI,Djibouti,2008,0,0,0
FIN,Finland,DJI,Djibouti,2009,0,1,-1
FIN,Finland,DJI,Djibouti,2010,0,0,0
FIN,Finland,DJI,Djibouti,2011,0,1,-1
FIN,Finland,DJI,Djibouti,2012,0,1,-1
FIN,Finland,DJI,Djibouti,2013,1,0,1
FIN,Finland,DJI,Djibouti,2014,0,0,0
FIN,Finland,DJI,Djibouti,2015,0,5,-5
FIN,Finland,DJI,Djibouti,2016,0,0,0
FIN,Finland,DJI,Djibouti,2017,0,1,-1
FRA,France,DJI,Djibouti,2008,0,109,-109
FRA,France,DJI,Djibouti,2009,0,107,-107
FRA,France,DJI,Djibouti,2010,0,99,-99
FRA,France,DJI,Djibouti,2011,0,100,-100
FRA,France,DJI,Djibouti,2012,0,120,-120
FRA,France,DJI,Djibouti,2013,0,104,-104
FRA,France,DJI,Djibouti,2014,0,118,-118
FRA,France,DJI,Djibouti,2015,0,107,-107
FRA,France,DJI,Djibouti,2016,0,127,-127
FRA,France,DJI,Djibouti,2017,0,119,-119
DEU,Germany,DJI,Djibouti,2008,10,5,5
DEU,Germany,DJI,Djibouti,2009,11,11,0
DEU,Germany,DJI,Djibouti,2010,11,12,-1
DEU,Germany,DJI,Djibouti,2011,2,6,-4
DEU,Germany,DJI,Djibouti,2012,6,12,-6
DEU,Germany,DJI,Djibouti,2013,9,20,-11
DEU,Germany,DJI,Djibouti,2014,6,26,-20
DEU,Germany,DJI,Djibouti,2015,14,16,-2
DEU,Germany,DJI,Djibouti,2016,12,24,-12
DEU,Germany,DJI,Djibouti,2017,8,24,-16
HUN,Hungary,DJI,Djibouti,2008,0,0,0
HUN,Hungary,DJI,Djibouti,2009,0,0,0
HUN,Hungary,DJI,Djibouti,2010,0,0,0
HUN,Hungary,DJI,Djibouti,2011,0,0,0
HUN,Hungary,DJI,Djibouti,2012,0,0,0
HUN,Hungary,DJI,Djibouti,2013,0,0,0
HUN,Hungary,DJI,Djibouti,2014,0,0,0
HUN,Hungary,DJI,Djibouti,2015,0,0,0
HUN,Hungary,DJI,Djibouti,2016,0,0,0
HUN,Hungary,DJI,Djibouti,2017,0,0,0
ISL,Iceland,DJI,Djibouti,2008,0,0,0
ISL,Iceland,DJI,Djibouti,2009,2,2,0
ISL,Iceland,DJI,Djibouti,2010,1,1,0
ISL,Iceland,DJI,Djibouti,2011,0,0,0
ISL,Iceland,DJI,Djibouti,2012,0,1,-1
ISL,Iceland,DJI,Djibouti,2013,0,2,-2
ISL,Iceland,DJI,Djibouti,2014,6,2,4
ISL,Iceland,DJI,Djibouti,2015,2,4,-2
ISL,Iceland,DJI,Djibouti,2016,4,3,1
ISL,Iceland,DJI,Djibouti,2017,2,2,0
ITA,Italy,DJI,Djibouti,2008,0,1,-1
ITA,Italy,DJI,Djibouti,2009,0,1,-1
ITA,Italy,DJI,Djibouti,2010,0,3,-3
ITA,Italy,DJI,Djibouti,2011,0,2,-2
ITA,Italy,DJI,Djibouti,2012,0,0,0
ITA,Italy,DJI,Djibouti,2013,0,2,-2
ITA,Italy,DJI,Djibouti,2014,0,2,-2
ITA,Italy,DJI,Djibouti,2015,0,1,-1
ITA,Italy,DJI,Djibouti,2016,0,2,-2
JPN,Japan,DJI,Djibouti,2008,48,48,0
JPN,Japan,DJI,Djibouti,2009,27,25,2
JPN,Japan,DJI,Djibouti,2010,78,81,-3
JPN,Japan,DJI,Djibouti,2011,34,31,3
JPN,Japan,DJI,Djibouti,2012,39,39,0
JPN,Japan,DJI,Djibouti,2013,53,55,-2
JPN,Japan,DJI,Djibouti,2014,42,44,-2
JPN,Japan,DJI,Djibouti,2015,52,52,0
JPN,Japan,DJI,Djibouti,2016,47,51,-4
JPN,Japan,DJI,Djibouti,2017,39,43,-4
KOR,Korea,DJI,Djibouti,2008,1,1,0
KOR,Korea,DJI,Djibouti,2009,1,1,0
KOR,Korea,DJI,Djibouti,2010,1,1,0
KOR,Korea,DJI,Djibouti,2011,0,0,0
KOR,Korea,DJI,Djibouti,2012,4,0,4
KOR,Korea,DJI,Djibouti,2013,0,0,0
KOR,Korea,DJI,Djibouti,2014,0,0,0
KOR,Korea,DJI,Djibouti,2015,0,0,0
KOR,Korea,DJI,Djibouti,2016,0,1,-1
KOR,Korea,DJI,Djibouti,2017,1,0,1
LUX,Luxembourg,DJI,Djibouti,2008,0,2,-2
LUX,Luxembourg,DJI,Djibouti,2009,0,2,-2
LUX,Luxembourg,DJI,Djibouti,2010,1,0,1
LUX,Luxembourg,DJI,Djibouti,2011,0,0,0
LUX,Luxembourg,DJI,Djibouti,2012,0,0,0
LUX,Luxembourg,DJI,Djibouti,2013,1,0,1
LUX,Luxembourg,DJI,Djibouti,2014,0,0,0
LUX,Luxembourg,DJI,Djibouti,2015,0,0,0
LUX,Luxembourg,DJI,Djibouti,2016,0,1,-1
LUX,Luxembourg,DJI,Djibouti,2017,1,0,1
MEX,Mexico,DJI,Djibouti,2012,0,0,0
MEX,Mexico,DJI,Djibouti,2013,0,0,0
MEX,Mexico,DJI,Djibouti,2014,0,0,0
NLD,Netherlands,DJI,Djibouti,2008,0,0,0
NLD,Netherlands,DJI,Djibouti,2009,0,2,-2
NLD,Netherlands,DJI,Djibouti,2010,1,1,0
NLD,Netherlands,DJI,Djibouti,2011,0,2,-2
NLD,Netherlands,DJI,Djibouti,2013,-1,0,-1
NLD,Netherlands,DJI,Djibouti,2014,0,1,-1
NLD,Netherlands,DJI,Djibouti,2015,0,4,-4
NLD,Netherlands,DJI,Djibouti,2016,0,2,-2
NLD,Netherlands,DJI,Djibouti,2017,0,5,-5
NZL,New Zealand,DJI,Djibouti,2008,0,3,-3
NZL,New Zealand,DJI,Djibouti,2009,0,1,-1
NZL,New Zealand,DJI,Djibouti,2010,0,0,0
NZL,New Zealand,DJI,Djibouti,2011,0,1,-1
NZL,New Zealand,DJI,Djibouti,2012,0,0,0
NOR,Norway,DJI,Djibouti,2008,0,6,-6
NOR,Norway,DJI,Djibouti,2009,0,3,-3
NOR,Norway,DJI,Djibouti,2010,1,6,-5
NOR,Norway,DJI,Djibouti,2011,0,5,-5
NOR,Norway,DJI,Djibouti,2012,4,6,-2
NOR,Norway,DJI,Djibouti,2013,3,4,-1
NOR,Norway,DJI,Djibouti,2014,2,6,-4
NOR,Norway,DJI,Djibouti,2015,2,5,-3
NOR,Norway,DJI,Djibouti,2016,4,2,2
NOR,Norway,DJI,Djibouti,2017,8,3,5
POL,Poland,DJI,Djibouti,2009,0,0,0
POL,Poland,DJI,Djibouti,2010,0,0,0
POL,Poland,DJI,Djibouti,2011,0,0,0
POL,Poland,DJI,Djibouti,2012,0,0,0
POL,Poland,DJI,Djibouti,2013,0,0,0
POL,Poland,DJI,Djibouti,2014,0,0,0
POL,Poland,DJI,Djibouti,2015,0,0,0
POL,Poland,DJI,Djibouti,2016,0,0,0
POL,Poland,DJI,Djibouti,2017,0,0,0
SVK,Slovak Republic,DJI,Djibouti,2008,0,0,0
ESP,Spain,DJI,Djibouti,2008,0,1,-1
ESP,Spain,DJI,Djibouti,2009,0,1,-1
ESP,Spain,DJI,Djibouti,2010,2,1,1
ESP,Spain,DJI,Djibouti,2011,0,3,-3
ESP,Spain,DJI,Djibouti,2012,2,1,1
ESP,Spain,DJI,Djibouti,2013,0,0,0
ESP,Spain,DJI,Djibouti,2014,0,1,-1
ESP,Spain,DJI,Djibouti,2015,1,0,1
ESP,Spain,DJI,Djibouti,2016,0,2,-2
SWE,Sweden,DJI,Djibouti,2008,0,7,-7
SWE,Sweden,DJI,Djibouti,2009,0,8,-8
SWE,Sweden,DJI,Djibouti,2010,1,8,-7
SWE,Sweden,DJI,Djibouti,2011,0,8,-8
SWE,Sweden,DJI,Djibouti,2012,1,28,-27
SWE,Sweden,DJI,Djibouti,2013,0,22,-22
SWE,Sweden,DJI,Djibouti,2014,2,24,-22
SWE,Sweden,DJI,Djibouti,2015,2,36,-34
SWE,Sweden,DJI,Djibouti,2016,0,47,-47
SWE,Sweden,DJI,Djibouti,2017,3,47,-44
CHE,Switzerland,DJI,Djibouti,2010,1,0,1
CHE,Switzerland,DJI,Djibouti,2011,0,2,-2
CHE,Switzerland,DJI,Djibouti,2012,0,4,-4
CHE,Switzerland,DJI,Djibouti,2013,1,3,-2
CHE,Switzerland,DJI,Djibouti,2014,0,2,-2
CHE,Switzerland,DJI,Djibouti,2015,0,1,-1
CHE,Switzerland,DJI,Djibouti,2016,0,2,-2
CHE,Switzerland,DJI,Djibouti,2017,0,3,-3
TUR,Turkey,DJI,Djibouti,2010,0,2,-2
TUR,Turkey,DJI,Djibouti,2016,46,122,-76
TUR,Turkey,DJI,Djibouti,2017,76,153,-77
USA,United States,DJI,Djibouti,2008,0,39,-39
USA,United States,DJI,Djibouti,2009,0,54,-54
USA,United States,DJI,Djibouti,2010,0,37,-37
USA,United States,DJI,Djibouti,2011,0,56,-56
USA,United States,DJI,Djibouti,2012,0,106,-106
USA,United States,DJI,Djibouti,2013,0,90,-90
USA,United States,DJI,Djibouti,2014,0,190,-190
USA,United States,DJI,Djibouti,2015,0,370,-370
USA,United States,DJI,Djibouti,2016,0,281,-281
USA,United States,DJI,Djibouti,2017,0,222,-222
CHL,Chile,DJI,Djibouti,2008,0,0,0
CHL,Chile,DJI,Djibouti,2009,0,0,0
CHL,Chile,DJI,Djibouti,2010,0,0,0
CHL,Chile,DJI,Djibouti,2011,0,0,0
CHL,Chile,DJI,Djibouti,2012,0,0,0
CHL,Chile,DJI,Djibouti,2013,0,0,0
CHL,Chile,DJI,Djibouti,2014,0,0,0
CHL,Chile,DJI,Djibouti,2015,0,0,0
CHL,Chile,DJI,Djibouti,2016,0,1,-1
EST,Estonia,DJI,Djibouti,2008,0,0,0
EST,Estonia,DJI,Djibouti,2009,0,0,0
EST,Estonia,DJI,Djibouti,2010,0,0,0
EST,Estonia,DJI,Djibouti,2011,0,0,0
EST,Estonia,DJI,Djibouti,2012,0,0,0
EST,Estonia,DJI,Djibouti,2013,0,0,0
EST,Estonia,DJI,Djibouti,2014,0,0,0
EST,Estonia,DJI,Djibouti,2015,0,0,0
EST,Estonia,DJI,Djibouti,2016,0,0,0
EST,Estonia,DJI,Djibouti,2017,0,0,0
AUS,Australia,DMA,Dominica,2008,0,3,-3
AUS,Australia,DMA,Dominica,2009,0,1,-1
AUS,Australia,DMA,Dominica,2010,0,0,0
AUS,Australia,DMA,Dominica,2011,0,0,0
AUS,Australia,DMA,Dominica,2012,0,0,0
AUS,Australia,DMA,Dominica,2013,0,4,-4
AUS,Australia,DMA,Dominica,2014,0,0,0
AUS,Australia,DMA,Dominica,2015,0,0,0
AUS,Australia,DMA,Dominica,2016,0,0,0
AUS,Australia,DMA,Dominica,2017,0,3,-3
AUT,Austria,DMA,Dominica,2008,2,4,-2
AUT,Austria,DMA,Dominica,2009,2,3,-1
AUT,Austria,DMA,Dominica,2010,0,1,-1
AUT,Austria,DMA,Dominica,2011,2,2,0
AUT,Austria,DMA,Dominica,2012,1,4,-3
AUT,Austria,DMA,Dominica,2013,0,3,-3
AUT,Austria,DMA,Dominica,2014,0,1,-1
AUT,Austria,DMA,Dominica,2015,0,4,-4
AUT,Austria,DMA,Dominica,2016,0,6,-6
AUT,Austria,DMA,Dominica,2017,5,6,-1
BEL,Belgium,DMA,Dominica,2008,0,9,-9
BEL,Belgium,DMA,Dominica,2009,0,3,-3
BEL,Belgium,DMA,Dominica,2010,1,10,-9
BEL,Belgium,DMA,Dominica,2012,1,7,-6
BEL,Belgium,DMA,Dominica,2013,2,7,-5
BEL,Belgium,DMA,Dominica,2014,2,8,-6
BEL,Belgium,DMA,Dominica,2015,1,6,-5
BEL,Belgium,DMA,Dominica,2016,1,4,-3
BEL,Belgium,DMA,Dominica,2017,0,9,-9
CAN,Canada,DMA,Dominica,2008,0,60,-60
CAN,Canada,DMA,Dominica,2009,0,59,-59
CAN,Canada,DMA,Dominica,2010,0,43,-43
CAN,Canada,DMA,Dominica,2011,0,36,-36
CAN,Canada,DMA,Dominica,2012,0,43,-43
CAN,Canada,DMA,Dominica,2013,0,48,-48
CAN,Canada,DMA,Dominica,2014,0,34,-34
CAN,Canada,DMA,Dominica,2015,0,28,-28
CAN,Canada,DMA,Dominica,2016,0,30,-30
CAN,Canada,DMA,Dominica,2017,0,35,-35
CZE,Czech Republic,DMA,Dominica,2010,0,1,-1
DNK,Denmark,DMA,Dominica,2008,1,0,1
DNK,Denmark,DMA,Dominica,2009,0,0,0
DNK,Denmark,DMA,Dominica,2012,0,1,-1
DNK,Denmark,DMA,Dominica,2013,0,1,-1
DNK,Denmark,DMA,Dominica,2014,0,1,-1
DNK,Denmark,DMA,Dominica,2015,0,0,0
DNK,Denmark,DMA,Dominica,2016,0,0,0
DNK,Denmark,DMA,Dominica,2017,0,0,0
FIN,Finland,DMA,Dominica,2008,0,0,0
FIN,Finland,DMA,Dominica,2009,0,0,0
FIN,Finland,DMA,Dominica,2010,0,0,0
FIN,Finland,DMA,Dominica,2011,0,1,-1
FIN,Finland,DMA,Dominica,2012,0,0,0
FIN,Finland,DMA,Dominica,2013,0,0,0
FIN,Finland,DMA,Dominica,2014,0,0,0
FIN,Finland,DMA,Dominica,2015,0,1,-1
FIN,Finland,DMA,Dominica,2016,0,0,0
FIN,Finland,DMA,Dominica,2017,0,2,-2
FRA,France,DMA,Dominica,2008,0,90,-90
FRA,France,DMA,Dominica,2009,0,108,-108
FRA,France,DMA,Dominica,2010,0,116,-116
FRA,France,DMA,Dominica,2011,0,137,-137
FRA,France,DMA,Dominica,2012,0,116,-116
FRA,France,DMA,Dominica,2013,0,121,-121
FRA,France,DMA,Dominica,2014,0,129,-129
FRA,France,DMA,Dominica,2015,0,95,-95
FRA,France,DMA,Dominica,2016,0,135,-135
FRA,France,DMA,Dominica,2017,0,141,-141
DEU,Germany,DMA,Dominica,2008,38,57,-19
DEU,Germany,DMA,Dominica,2009,34,71,-37
DEU,Germany,DMA,Dominica,2010,45,69,-24
DEU,Germany,DMA,Dominica,2011,25,68,-43
DEU,Germany,DMA,Dominica,2012,27,56,-29
DEU,Germany,DMA,Dominica,2013,30,57,-27
DEU,Germany,DMA,Dominica,2014,25,53,-28
DEU,Germany,DMA,Dominica,2015,29,46,-17
DEU,Germany,DMA,Dominica,2016,25,33,-8
DEU,Germany,DMA,Dominica,2017,12,30,-18
HUN,Hungary,DMA,Dominica,2008,0,0,0
HUN,Hungary,DMA,Dominica,2009,0,0,0
HUN,Hungary,DMA,Dominica,2010,0,0,0
HUN,Hungary,DMA,Dominica,2011,0,0,0
HUN,Hungary,DMA,Dominica,2012,0,0,0
HUN,Hungary,DMA,Dominica,2013,0,0,0
HUN,Hungary,DMA,Dominica,2014,0,0,0
HUN,Hungary,DMA,Dominica,2015,0,0,0
HUN,Hungary,DMA,Dominica,2016,0,2,-2
HUN,Hungary,DMA,Dominica,2017,0,3,-3
ISL,Iceland,DMA,Dominica,2008,0,0,0
ISL,Iceland,DMA,Dominica,2009,0,0,0
ISL,Iceland,DMA,Dominica,2010,1,1,0
ISL,Iceland,DMA,Dominica,2011,0,0,0
ISL,Iceland,DMA,Dominica,2012,0,0,0
ISL,Iceland,DMA,Dominica,2013,0,0,0
ISL,Iceland,DMA,Dominica,2014,0,1,-1
ISL,Iceland,DMA,Dominica,2015,1,2,-1
ISL,Iceland,DMA,Dominica,2016,1,0,1
ISL,Iceland,DMA,Dominica,2017,0,0,0
ITA,Italy,DMA,Dominica,2008,5,119,-114
ITA,Italy,DMA,Dominica,2009,7,121,-114
ITA,Italy,DMA,Dominica,2010,4,140,-136
ITA,Italy,DMA,Dominica,2011,5,106,-101
ITA,Italy,DMA,Dominica,2012,7,153,-146
ITA,Italy,DMA,Dominica,2013,8,74,-66
ITA,Italy,DMA,Dominica,2014,12,85,-73
ITA,Italy,DMA,Dominica,2015,5,60,-55
ITA,Italy,DMA,Dominica,2016,0,72,-72
ITA,Italy,DMA,Dominica,2017,4,72,-68
JPN,Japan,DMA,Dominica,2008,22,25,-3
JPN,Japan,DMA,Dominica,2009,9,6,3
JPN,Japan,DMA,Dominica,2010,12,10,2
JPN,Japan,DMA,Dominica,2011,7,10,-3
JPN,Japan,DMA,Dominica,2012,10,6,4
JPN,Japan,DMA,Dominica,2013,9,10,-1
JPN,Japan,DMA,Dominica,2014,12,11,1
JPN,Japan,DMA,Dominica,2015,17,17,0
JPN,Japan,DMA,Dominica,2016,4,6,-2
JPN,Japan,DMA,Dominica,2017,9,9,0
KOR,Korea,DMA,Dominica,2008,0,2,-2
KOR,Korea,DMA,Dominica,2009,2,0,2
KOR,Korea,DMA,Dominica,2010,0,1,-1
KOR,Korea,DMA,Dominica,2011,2,0,2
KOR,Korea,DMA,Dominica,2012,2,2,0
KOR,Korea,DMA,Dominica,2013,1,0,1
KOR,Korea,DMA,Dominica,2014,0,1,-1
KOR,Korea,DMA,Dominica,2015,1,0,1
KOR,Korea,DMA,Dominica,2016,1,0,1
KOR,Korea,DMA,Dominica,2017,0,1,-1
LUX,Luxembourg,DMA,Dominica,2008,0,0,0
LUX,Luxembourg,DMA,Dominica,2009,0,1,-1
LUX,Luxembourg,DMA,Dominica,2010,0,0,0
LUX,Luxembourg,DMA,Dominica,2011,0,0,0
LUX,Luxembourg,DMA,Dominica,2012,0,0,0
LUX,Luxembourg,DMA,Dominica,2013,0,0,0
LUX,Luxembourg,DMA,Dominica,2014,0,0,0
LUX,Luxembourg,DMA,Dominica,2015,0,0,0
LUX,Luxembourg,DMA,Dominica,2016,0,0,0
LUX,Luxembourg,DMA,Dominica,2017,0,0,0
MEX,Mexico,DMA,Dominica,2008,0,2,-2
MEX,Mexico,DMA,Dominica,2009,0,4,-4
MEX,Mexico,DMA,Dominica,2010,0,11,-11
MEX,Mexico,DMA,Dominica,2011,0,3,-3
MEX,Mexico,DMA,Dominica,2012,0,5,-5
MEX,Mexico,DMA,Dominica,2013,0,4,-4
MEX,Mexico,DMA,Dominica,2014,0,4,-4
MEX,Mexico,DMA,Dominica,2015,0,2,-2
MEX,Mexico,DMA,Dominica,2016,0,2,-2
MEX,Mexico,DMA,Dominica,2017,0,1,-1
NLD,Netherlands,DMA,Dominica,2008,0,1,-1
NLD,Netherlands,DMA,Dominica,2009,2,1,1
NLD,Netherlands,DMA,Dominica,2010,2,2,0
NLD,Netherlands,DMA,Dominica,2012,0,1,-1
NLD,Netherlands,DMA,Dominica,2013,0,2,-2
NLD,Netherlands,DMA,Dominica,2014,1,1,0
NLD,Netherlands,DMA,Dominica,2016,1,0,1
NLD,Netherlands,DMA,Dominica,2017,0,1,-1
NZL,New Zealand,DMA,Dominica,2008,0,2,-2
NZL,New Zealand,DMA,Dominica,2009,1,1,0
NZL,New Zealand,DMA,Dominica,2013,0,2,-2
NZL,New Zealand,DMA,Dominica,2016,0,7,-7
NZL,New Zealand,DMA,Dominica,2017,0,1,-1
NOR,Norway,DMA,Dominica,2008,0,0,0
NOR,Norway,DMA,Dominica,2009,8,0,8
NOR,Norway,DMA,Dominica,2010,0,0,0
NOR,Norway,DMA,Dominica,2011,0,55,-55
NOR,Norway,DMA,Dominica,2012,0,0,0
NOR,Norway,DMA,Dominica,2013,0,4,-4
NOR,Norway,DMA,Dominica,2014,0,0,0
NOR,Norway,DMA,Dominica,2015,0,0,0
NOR,Norway,DMA,Dominica,2016,0,0,0
NOR,Norway,DMA,Dominica,2017,0,0,0
POL,Poland,DMA,Dominica,2009,0,0,0
POL,Poland,DMA,Dominica,2010,0,0,0
POL,Poland,DMA,Dominica,2011,0,0,0
POL,Poland,DMA,Dominica,2012,0,0,0
POL,Poland,DMA,Dominica,2013,0,0,0
POL,Poland,DMA,Dominica,2014,0,0,0
POL,Poland,DMA,Dominica,2015,0,0,0
POL,Poland,DMA,Dominica,2016,0,2,-2
POL,Poland,DMA,Dominica,2017,0,5,-5
SVK,Slovak Republic,DMA,Dominica,2008,0,0,0
ESP,Spain,DMA,Dominica,2008,23,165,-142
ESP,Spain,DMA,Dominica,2009,20,71,-51
ESP,Spain,DMA,Dominica,2010,17,56,-39
ESP,Spain,DMA,Dominica,2011,38,73,-35
ESP,Spain,DMA,Dominica,2012,15,99,-84
ESP,Spain,DMA,Dominica,2013,13,94,-81
ESP,Spain,DMA,Dominica,2014,10,90,-80
ESP,Spain,DMA,Dominica,2015,7,85,-78
ESP,Spain,DMA,Dominica,2016,10,74,-64
ESP,Spain,DMA,Dominica,2017,18,60,-42
SWE,Sweden,DMA,Dominica,2008,0,2,-2
SWE,Sweden,DMA,Dominica,2009,0,0,0
SWE,Sweden,DMA,Dominica,2010,0,0,0
SWE,Sweden,DMA,Dominica,2011,1,0,1
SWE,Sweden,DMA,Dominica,2012,0,0,0
SWE,Sweden,DMA,Dominica,2013,0,0,0
SWE,Sweden,DMA,Dominica,2014,0,0,0
SWE,Sweden,DMA,Dominica,2015,0,0,0
SWE,Sweden,DMA,Dominica,2016,0,2,-2
SWE,Sweden,DMA,Dominica,2017,0,2,-2
CHE,Switzerland,DMA,Dominica,2010,0,0,0
CHE,Switzerland,DMA,Dominica,2011,1,1,0
CHE,Switzerland,DMA,Dominica,2012,1,4,-3
CHE,Switzerland,DMA,Dominica,2013,0,1,-1
CHE,Switzerland,DMA,Dominica,2014,0,0,0
CHE,Switzerland,DMA,Dominica,2015,0,2,-2
CHE,Switzerland,DMA,Dominica,2016,0,1,-1
CHE,Switzerland,DMA,Dominica,2017,1,4,-3
USA,United States,DMA,Dominica,2008,0,454,-454
USA,United States,DMA,Dominica,2009,0,484,-484
USA,United States,DMA,Dominica,2010,0,366,-366
USA,United States,DMA,Dominica,2011,0,287,-287
USA,United States,DMA,Dominica,2012,0,125,-125
USA,United States,DMA,Dominica,2013,0,244,-244
USA,United States,DMA,Dominica,2014,0,345,-345
USA,United States,DMA,Dominica,2015,0,229,-229
USA,United States,DMA,Dominica,2016,0,298,-298
USA,United States,DMA,Dominica,2017,0,510,-510
CHL,Chile,DMA,Dominica,2008,0,0,0
CHL,Chile,DMA,Dominica,2009,0,0,0
CHL,Chile,DMA,Dominica,2010,0,0,0
CHL,Chile,DMA,Dominica,2011,0,0,0
CHL,Chile,DMA,Dominica,2012,0,0,0
CHL,Chile,DMA,Dominica,2013,0,0,0
CHL,Chile,DMA,Dominica,2014,0,1,-1
CHL,Chile,DMA,Dominica,2015,0,0,0
CHL,Chile,DMA,Dominica,2016,0,0,0
EST,Estonia,DMA,Dominica,2008,0,0,0
EST,Estonia,DMA,Dominica,2009,0,0,0
EST,Estonia,DMA,Dominica,2010,0,0,0
EST,Estonia,DMA,Dominica,2011,0,0,0
EST,Estonia,DMA,Dominica,2012,0,0,0
EST,Estonia,DMA,Dominica,2013,0,0,0
EST,Estonia,DMA,Dominica,2014,0,0,0
EST,Estonia,DMA,Dominica,2015,0,0,0
EST,Estonia,DMA,Dominica,2016,0,0,0
EST,Estonia,DMA,Dominica,2017,0,0,0
AUS,Australia,DOM,Dominican Republic,2008,0,10,-10
AUS,Australia,DOM,Dominican Republic,2009,0,8,-8
AUS,Australia,DOM,Dominican Republic,2010,0,4,-4
AUS,Australia,DOM,Dominican Republic,2011,0,10,-10
AUS,Australia,DOM,Dominican Republic,2012,0,8,-8
AUS,Australia,DOM,Dominican Republic,2013,0,14,-14
AUS,Australia,DOM,Dominican Republic,2014,5,9,-4
AUS,Australia,DOM,Dominican Republic,2015,0,5,-5
AUS,Australia,DOM,Dominican Republic,2017,0,8,-8
AUT,Austria,DOM,Dominican Republic,2008,99,178,-79
AUT,Austria,DOM,Dominican Republic,2009,102,155,-53
AUT,Austria,DOM,Dominican Republic,2010,104,138,-34
AUT,Austria,DOM,Dominican Republic,2011,66,137,-71
AUT,Austria,DOM,Dominican Republic,2012,103,106,-3
AUT,Austria,DOM,Dominican Republic,2013,80,139,-59
AUT,Austria,DOM,Dominican Republic,2014,60,141,-81
AUT,Austria,DOM,Dominican Republic,2015,63,97,-34
AUT,Austria,DOM,Dominican Republic,2016,59,104,-45
AUT,Austria,DOM,Dominican Republic,2017,73,111,-38
BEL,Belgium,DOM,Dominican Republic,2008,0,130,-130
BEL,Belgium,DOM,Dominican Republic,2009,0,131,-131
BEL,Belgium,DOM,Dominican Republic,2010,22,128,-106
BEL,Belgium,DOM,Dominican Republic,2011,0,137,-137
BEL,Belgium,DOM,Dominican Republic,2012,46,116,-70
BEL,Belgium,DOM,Dominican Republic,2013,43,141,-98
BEL,Belgium,DOM,Dominican Republic,2014,28,99,-71
BEL,Belgium,DOM,Dominican Republic,2015,34,110,-76
BEL,Belgium,DOM,Dominican Republic,2016,25,106,-81
BEL,Belgium,DOM,Dominican Republic,2017,24,83,-59
CAN,Canada,DOM,Dominican Republic,2008,0,430,-430
CAN,Canada,DOM,Dominican Republic,2009,0,362,-362
CAN,Canada,DOM,Dominican Republic,2010,0,455,-455
CAN,Canada,DOM,Dominican Republic,2011,0,735,-735
CAN,Canada,DOM,Dominican Republic,2012,0,604,-604
CAN,Canada,DOM,Dominican Republic,2013,0,589,-589
CAN,Canada,DOM,Dominican Republic,2014,0,445,-445
CAN,Canada,DOM,Dominican Republic,2015,0,602,-602
CAN,Canada,DOM,Dominican Republic,2016,0,605,-605
CAN,Canada,DOM,Dominican Republic,2017,0,655,-655
CZE,Czech Republic,DOM,Dominican Republic,2008,0,7,-7
CZE,Czech Republic,DOM,Dominican Republic,2009,0,4,-4
CZE,Czech Republic,DOM,Dominican Republic,2010,0,2,-2
CZE,Czech Republic,DOM,Dominican Republic,2011,0,3,-3
CZE,Czech Republic,DOM,Dominican Republic,2012,0,7,-7
CZE,Czech Republic,DOM,Dominican Republic,2013,2,3,-1
CZE,Czech Republic,DOM,Dominican Republic,2014,3,7,-4
CZE,Czech Republic,DOM,Dominican Republic,2015,2,9,-7
CZE,Czech Republic,DOM,Dominican Republic,2016,3,6,-3
CZE,Czech Republic,DOM,Dominican Republic,2017,1,7,-6
DNK,Denmark,DOM,Dominican Republic,2008,3,6,-3
DNK,Denmark,DOM,Dominican Republic,2009,4,5,-1
DNK,Denmark,DOM,Dominican Republic,2010,3,8,-5
DNK,Denmark,DOM,Dominican Republic,2011,2,12,-10
DNK,Denmark,DOM,Dominican Republic,2012,1,5,-4
DNK,Denmark,DOM,Dominican Republic,2013,6,6,0
DNK,Denmark,DOM,Dominican Republic,2014,2,6,-4
DNK,Denmark,DOM,Dominican Republic,2015,3,8,-5
DNK,Denmark,DOM,Dominican Republic,2016,4,5,-1
DNK,Denmark,DOM,Dominican Republic,2017,3,9,-6
FIN,Finland,DOM,Dominican Republic,2008,1,10,-9
FIN,Finland,DOM,Dominican Republic,2009,0,8,-8
FIN,Finland,DOM,Dominican Republic,2010,0,9,-9
FIN,Finland,DOM,Dominican Republic,2011,3,15,-12
FIN,Finland,DOM,Dominican Republic,2012,0,11,-11
FIN,Finland,DOM,Dominican Republic,2013,4,12,-8
FIN,Finland,DOM,Dominican Republic,2014,0,7,-7
FIN,Finland,DOM,Dominican Republic,2015,0,8,-8
FIN,Finland,DOM,Dominican Republic,2016,0,5,-5
FIN,Finland,DOM,Dominican Republic,2017,0,7,-7
FRA,France,DOM,Dominican Republic,2008,0,296,-296
FRA,France,DOM,Dominican Republic,2009,0,343,-343
FRA,France,DOM,Dominican Republic,2010,0,482,-482
FRA,France,DOM,Dominican Republic,2011,0,462,-462
FRA,France,DOM,Dominican Republic,2012,0,445,-445
FRA,France,DOM,Dominican Republic,2013,0,434,-434
FRA,France,DOM,Dominican Republic,2014,0,509,-509
FRA,France,DOM,Dominican Republic,2015,0,547,-547
FRA,France,DOM,Dominican Republic,2016,0,547,-547
FRA,France,DOM,Dominican Republic,2017,0,503,-503
DEU,Germany,DOM,Dominican Republic,2008,442,497,-55
DEU,Germany,DOM,Dominican Republic,2009,359,530,-171
DEU,Germany,DOM,Dominican Republic,2010,381,568,-187
DEU,Germany,DOM,Dominican Republic,2011,320,591,-271
DEU,Germany,DOM,Dominican Republic,2012,292,613,-321
DEU,Germany,DOM,Dominican Republic,2013,364,715,-351
DEU,Germany,DOM,Dominican Republic,2014,338,564,-226
DEU,Germany,DOM,Dominican Republic,2015,339,596,-257
DEU,Germany,DOM,Dominican Republic,2016,352,598,-246
DEU,Germany,DOM,Dominican Republic,2017,294,539,-245
HUN,Hungary,DOM,Dominican Republic,2008,0,2,-2
HUN,Hungary,DOM,Dominican Republic,2009,0,3,-3
HUN,Hungary,DOM,Dominican Republic,2010,1,7,-6
HUN,Hungary,DOM,Dominican Republic,2011,0,2,-2
HUN,Hungary,DOM,Dominican Republic,2012,1,1,0
HUN,Hungary,DOM,Dominican Republic,2013,2,1,1
HUN,Hungary,DOM,Dominican Republic,2014,0,3,-3
HUN,Hungary,DOM,Dominican Republic,2015,0,2,-2
HUN,Hungary,DOM,Dominican Republic,2016,1,3,-2
HUN,Hungary,DOM,Dominican Republic,2017,0,4,-4
ISL,Iceland,DOM,Dominican Republic,2008,0,4,-4
ISL,Iceland,DOM,Dominican Republic,2009,0,0,0
ISL,Iceland,DOM,Dominican Republic,2010,1,4,-3
ISL,Iceland,DOM,Dominican Republic,2011,0,3,-3
ISL,Iceland,DOM,Dominican Republic,2012,1,2,-1
ISL,Iceland,DOM,Dominican Republic,2013,1,4,-3
ISL,Iceland,DOM,Dominican Republic,2014,0,1,-1
ISL,Iceland,DOM,Dominican Republic,2015,1,8,-7
ISL,Iceland,DOM,Dominican Republic,2016,1,5,-4
ISL,Iceland,DOM,Dominican Republic,2017,0,8,-8
ITA,Italy,DOM,Dominican Republic,2008,118,3082,-2964
ITA,Italy,DOM,Dominican Republic,2009,147,3319,-3172
ITA,Italy,DOM,Dominican Republic,2010,144,2742,-2598
ITA,Italy,DOM,Dominican Republic,2011,150,2240,-2090
ITA,Italy,DOM,Dominican Republic,2012,184,2565,-2381
ITA,Italy,DOM,Dominican Republic,2013,204,2194,-1990
ITA,Italy,DOM,Dominican Republic,2014,229,1718,-1489
ITA,Italy,DOM,Dominican Republic,2015,192,1124,-932
ITA,Italy,DOM,Dominican Republic,2016,0,1439,-1439
ITA,Italy,DOM,Dominican Republic,2017,181,1816,-1635
JPN,Japan,DOM,Dominican Republic,2008,80,105,-25
JPN,Japan,DOM,Dominican Republic,2009,113,127,-14
JPN,Japan,DOM,Dominican Republic,2010,77,88,-11
JPN,Japan,DOM,Dominican Republic,2011,88,89,-1
JPN,Japan,DOM,Dominican Republic,2012,61,70,-9
JPN,Japan,DOM,Dominican Republic,2013,71,84,-13
JPN,Japan,DOM,Dominican Republic,2014,76,106,-30
JPN,Japan,DOM,Dominican Republic,2015,75,105,-30
JPN,Japan,DOM,Dominican Republic,2016,63,93,-30
JPN,Japan,DOM,Dominican Republic,2017,75,94,-19
KOR,Korea,DOM,Dominican Republic,2008,13,16,-3
KOR,Korea,DOM,Dominican Republic,2009,18,23,-5
KOR,Korea,DOM,Dominican Republic,2010,19,16,3
KOR,Korea,DOM,Dominican Republic,2011,14,15,-1
KOR,Korea,DOM,Dominican Republic,2012,18,18,0
KOR,Korea,DOM,Dominican Republic,2013,19,27,-8
KOR,Korea,DOM,Dominican Republic,2014,19,25,-6
KOR,Korea,DOM,Dominican Republic,2015,30,29,1
KOR,Korea,DOM,Dominican Republic,2016,35,38,-3
KOR,Korea,DOM,Dominican Republic,2017,40,27,13
LUX,Luxembourg,DOM,Dominican Republic,2008,9,14,-5
LUX,Luxembourg,DOM,Dominican Republic,2009,4,17,-13
LUX,Luxembourg,DOM,Dominican Republic,2010,2,15,-13
LUX,Luxembourg,DOM,Dominican Republic,2011,5,20,-15
LUX,Luxembourg,DOM,Dominican Republic,2012,7,11,-4
LUX,Luxembourg,DOM,Dominican Republic,2013,5,17,-12
LUX,Luxembourg,DOM,Dominican Republic,2014,9,12,-3
LUX,Luxembourg,DOM,Dominican Republic,2015,1,17,-16
LUX,Luxembourg,DOM,Dominican Republic,2016,7,24,-17
LUX,Luxembourg,DOM,Dominican Republic,2017,7,23,-16
MEX,Mexico,DOM,Dominican Republic,2008,0,120,-120
MEX,Mexico,DOM,Dominican Republic,2009,0,244,-244
MEX,Mexico,DOM,Dominican Republic,2010,0,195,-195
MEX,Mexico,DOM,Dominican Republic,2011,0,184,-184
MEX,Mexico,DOM,Dominican Republic,2012,0,154,-154
MEX,Mexico,DOM,Dominican Republic,2013,0,467,-467
MEX,Mexico,DOM,Dominican Republic,2014,0,343,-343
MEX,Mexico,DOM,Dominican Republic,2015,0,310,-310
MEX,Mexico,DOM,Dominican Republic,2016,0,314,-314
MEX,Mexico,DOM,Dominican Republic,2017,0,313,-313
NLD,Netherlands,DOM,Dominican Republic,2008,45,115,-70
NLD,Netherlands,DOM,Dominican Republic,2009,22,154,-132
NLD,Netherlands,DOM,Dominican Republic,2010,38,148,-110
NLD,Netherlands,DOM,Dominican Republic,2011,41,142,-101
NLD,Netherlands,DOM,Dominican Republic,2012,56,105,-49
NLD,Netherlands,DOM,Dominican Republic,2013,40,94,-54
NLD,Netherlands,DOM,Dominican Republic,2014,43,107,-64
NLD,Netherlands,DOM,Dominican Republic,2015,25,88,-63
NLD,Netherlands,DOM,Dominican Republic,2016,31,85,-54
NLD,Netherlands,DOM,Dominican Republic,2017,38,91,-53
NZL,New Zealand,DOM,Dominican Republic,2008,0,1,-1
NZL,New Zealand,DOM,Dominican Republic,2009,1,2,-1
NZL,New Zealand,DOM,Dominican Republic,2011,0,0,0
NZL,New Zealand,DOM,Dominican Republic,2012,0,3,-3
NZL,New Zealand,DOM,Dominican Republic,2013,0,1,-1
NZL,New Zealand,DOM,Dominican Republic,2015,0,3,-3
NZL,New Zealand,DOM,Dominican Republic,2016,1,1,0
NOR,Norway,DOM,Dominican Republic,2008,8,28,-20
NOR,Norway,DOM,Dominican Republic,2009,6,42,-36
NOR,Norway,DOM,Dominican Republic,2010,17,37,-20
NOR,Norway,DOM,Dominican Republic,2011,7,0,7
NOR,Norway,DOM,Dominican Republic,2012,7,39,-32
NOR,Norway,DOM,Dominican Republic,2013,9,44,-35
NOR,Norway,DOM,Dominican Republic,2014,9,29,-20
NOR,Norway,DOM,Dominican Republic,2015,13,35,-22
NOR,Norway,DOM,Dominican Republic,2016,8,47,-39
NOR,Norway,DOM,Dominican Republic,2017,12,37,-25
POL,Poland,DOM,Dominican Republic,2009,0,14,-14
POL,Poland,DOM,Dominican Republic,2010,0,16,-16
POL,Poland,DOM,Dominican Republic,2011,0,19,-19
POL,Poland,DOM,Dominican Republic,2012,0,16,-16
POL,Poland,DOM,Dominican Republic,2013,0,15,-15
POL,Poland,DOM,Dominican Republic,2014,0,10,-10
POL,Poland,DOM,Dominican Republic,2015,0,12,-12
POL,Poland,DOM,Dominican Republic,2016,0,10,-10
POL,Poland,DOM,Dominican Republic,2017,0,13,-13
SVK,Slovak Republic,DOM,Dominican Republic,2008,1,1,0
SVK,Slovak Republic,DOM,Dominican Republic,2009,0,1,-1
SVK,Slovak Republic,DOM,Dominican Republic,2010,0,1,-1
SVK,Slovak Republic,DOM,Dominican Republic,2011,0,1,-1
SVK,Slovak Republic,DOM,Dominican Republic,2013,0,1,-1
SVK,Slovak Republic,DOM,Dominican Republic,2015,0,3,-3
SVK,Slovak Republic,DOM,Dominican Republic,2016,0,2,-2
SVK,Slovak Republic,DOM,Dominican Republic,2017,0,1,-1
ESP,Spain,DOM,Dominican Republic,2008,2576,16211,-13635
ESP,Spain,DOM,Dominican Republic,2009,3304,9486,-6182
ESP,Spain,DOM,Dominican Republic,2010,3822,6907,-3085
ESP,Spain,DOM,Dominican Republic,2011,4498,10359,-5861
ESP,Spain,DOM,Dominican Republic,2012,5304,9974,-4670
ESP,Spain,DOM,Dominican Republic,2013,7047,8117,-1070
ESP,Spain,DOM,Dominican Republic,2014,4930,7675,-2745
ESP,Spain,DOM,Dominican Republic,2015,3422,6705,-3283
ESP,Spain,DOM,Dominican Republic,2016,3146,8058,-4912
ESP,Spain,DOM,Dominican Republic,2017,3131,9277,-6146
SWE,Sweden,DOM,Dominican Republic,2008,13,44,-31
SWE,Sweden,DOM,Dominican Republic,2009,8,42,-34
SWE,Sweden,DOM,Dominican Republic,2010,5,41,-36
SWE,Sweden,DOM,Dominican Republic,2011,8,21,-13
SWE,Sweden,DOM,Dominican Republic,2012,11,40,-29
SWE,Sweden,DOM,Dominican Republic,2013,6,42,-36
SWE,Sweden,DOM,Dominican Republic,2014,9,33,-24
SWE,Sweden,DOM,Dominican Republic,2015,8,22,-14
SWE,Sweden,DOM,Dominican Republic,2016,2,35,-33
SWE,Sweden,DOM,Dominican Republic,2017,8,30,-22
CHE,Switzerland,DOM,Dominican Republic,2010,120,419,-299
CHE,Switzerland,DOM,Dominican Republic,2011,129,406,-277
CHE,Switzerland,DOM,Dominican Republic,2012,121,394,-273
CHE,Switzerland,DOM,Dominican Republic,2013,165,459,-294
CHE,Switzerland,DOM,Dominican Republic,2014,133,338,-205
CHE,Switzerland,DOM,Dominican Republic,2015,104,396,-292
CHE,Switzerland,DOM,Dominican Republic,2016,142,354,-212
CHE,Switzerland,DOM,Dominican Republic,2017,129,300,-171
TUR,Turkey,DOM,Dominican Republic,2010,0,5,-5
USA,United States,DOM,Dominican Republic,2008,0,31879,-31879
USA,United States,DOM,Dominican Republic,2009,0,49414,-49414
USA,United States,DOM,Dominican Republic,2010,0,53870,-53870
USA,United States,DOM,Dominican Republic,2011,0,46109,-46109
USA,United States,DOM,Dominican Republic,2012,0,41566,-41566
USA,United States,DOM,Dominican Republic,2013,0,41311,-41311
USA,United States,DOM,Dominican Republic,2014,0,44577,-44577
USA,United States,DOM,Dominican Republic,2015,0,50610,-50610
USA,United States,DOM,Dominican Republic,2016,0,61161,-61161
USA,United States,DOM,Dominican Republic,2017,0,58520,-58520
CHL,Chile,DOM,Dominican Republic,2008,0,244,-244
CHL,Chile,DOM,Dominican Republic,2009,0,367,-367
CHL,Chile,DOM,Dominican Republic,2010,0,753,-753
CHL,Chile,DOM,Dominican Republic,2011,0,1223,-1223
CHL,Chile,DOM,Dominican Republic,2012,0,2948,-2948
CHL,Chile,DOM,Dominican Republic,2013,0,706,-706
CHL,Chile,DOM,Dominican Republic,2014,0,351,-351
CHL,Chile,DOM,Dominican Republic,2015,0,564,-564
CHL,Chile,DOM,Dominican Republic,2016,0,812,-812
EST,Estonia,DOM,Dominican Republic,2008,0,0,0
EST,Estonia,DOM,Dominican Republic,2009,0,0,0
EST,Estonia,DOM,Dominican Republic,2010,0,0,0
EST,Estonia,DOM,Dominican Republic,2011,0,0,0
EST,Estonia,DOM,Dominican Republic,2012,0,0,0
EST,Estonia,DOM,Dominican Republic,2013,0,0,0
EST,Estonia,DOM,Dominican Republic,2014,0,0,0
EST,Estonia,DOM,Dominican Republic,2015,0,2,-2
EST,Estonia,DOM,Dominican Republic,2016,0,0,0
EST,Estonia,DOM,Dominican Republic,2017,0,0,0
SVN,Slovenia,DOM,Dominican Republic,2008,0,86,-86
SVN,Slovenia,DOM,Dominican Republic,2009,0,72,-72
SVN,Slovenia,DOM,Dominican Republic,2010,0,30,-30
SVN,Slovenia,DOM,Dominican Republic,2011,13,49,-36
SVN,Slovenia,DOM,Dominican Republic,2012,3,8,-5
SVN,Slovenia,DOM,Dominican Republic,2013,5,7,-2
SVN,Slovenia,DOM,Dominican Republic,2015,4,9,-5
SVN,Slovenia,DOM,Dominican Republic,2016,1,3,-2
SVN,Slovenia,DOM,Dominican Republic,2017,2,10,-8
AUS,Australia,ECU,Ecuador,2008,26,39,-13
AUS,Australia,ECU,Ecuador,2009,21,45,-24
AUS,Australia,ECU,Ecuador,2010,13,46,-33
AUS,Australia,ECU,Ecuador,2011,19,39,-20
AUS,Australia,ECU,Ecuador,2012,26,40,-14
AUS,Australia,ECU,Ecuador,2013,35,34,1
AUS,Australia,ECU,Ecuador,2014,28,51,-23
AUS,Australia,ECU,Ecuador,2015,0,33,-33
AUS,Australia,ECU,Ecuador,2016,0,41,-41
AUS,Australia,ECU,Ecuador,2017,0,33,-33
AUT,Austria,ECU,Ecuador,2008,26,35,-9
AUT,Austria,ECU,Ecuador,2009,30,41,-11
AUT,Austria,ECU,Ecuador,2010,29,48,-19
AUT,Austria,ECU,Ecuador,2011,41,42,-1
AUT,Austria,ECU,Ecuador,2012,28,54,-26
AUT,Austria,ECU,Ecuador,2013,36,56,-20
AUT,Austria,ECU,Ecuador,2014,38,41,-3
AUT,Austria,ECU,Ecuador,2015,19,39,-20
AUT,Austria,ECU,Ecuador,2016,21,38,-17
AUT,Austria,ECU,Ecuador,2017,23,26,-3
BEL,Belgium,ECU,Ecuador,2008,0,351,-351
BEL,Belgium,ECU,Ecuador,2009,0,490,-490
BEL,Belgium,ECU,Ecuador,2010,101,858,-757
BEL,Belgium,ECU,Ecuador,2011,0,399,-399
BEL,Belgium,ECU,Ecuador,2012,99,298,-199
BEL,Belgium,ECU,Ecuador,2013,122,209,-87
BEL,Belgium,ECU,Ecuador,2014,88,120,-32
BEL,Belgium,ECU,Ecuador,2015,87,133,-46
BEL,Belgium,ECU,Ecuador,2016,98,166,-68
BEL,Belgium,ECU,Ecuador,2017,72,164,-92
CAN,Canada,ECU,Ecuador,2008,0,437,-437
CAN,Canada,ECU,Ecuador,2009,0,373,-373
CAN,Canada,ECU,Ecuador,2010,0,353,-353
CAN,Canada,ECU,Ecuador,2011,0,348,-348
CAN,Canada,ECU,Ecuador,2012,0,279,-279
CAN,Canada,ECU,Ecuador,2013,0,418,-418
CAN,Canada,ECU,Ecuador,2014,0,334,-334
CAN,Canada,ECU,Ecuador,2015,0,215,-215
CAN,Canada,ECU,Ecuador,2016,0,250,-250
CAN,Canada,ECU,Ecuador,2017,0,210,-210
CZE,Czech Republic,ECU,Ecuador,2008,0,15,-15
CZE,Czech Republic,ECU,Ecuador,2009,0,4,-4
CZE,Czech Republic,ECU,Ecuador,2010,0,6,-6
CZE,Czech Republic,ECU,Ecuador,2011,0,6,-6
CZE,Czech Republic,ECU,Ecuador,2012,4,6,-2
CZE,Czech Republic,ECU,Ecuador,2013,9,7,2
CZE,Czech Republic,ECU,Ecuador,2014,4,8,-4
CZE,Czech Republic,ECU,Ecuador,2015,5,6,-1
CZE,Czech Republic,ECU,Ecuador,2016,4,11,-7
CZE,Czech Republic,ECU,Ecuador,2017,10,22,-12
DNK,Denmark,ECU,Ecuador,2008,8,19,-11
DNK,Denmark,ECU,Ecuador,2009,11,20,-9
DNK,Denmark,ECU,Ecuador,2010,9,21,-12
DNK,Denmark,ECU,Ecuador,2011,19,12,7
DNK,Denmark,ECU,Ecuador,2012,13,18,-5
DNK,Denmark,ECU,Ecuador,2013,19,25,-6
DNK,Denmark,ECU,Ecuador,2014,18,24,-6
DNK,Denmark,ECU,Ecuador,2015,21,21,0
DNK,Denmark,ECU,Ecuador,2016,16,20,-4
DNK,Denmark,ECU,Ecuador,2017,22,17,5
FIN,Finland,ECU,Ecuador,2008,3,11,-8
FIN,Finland,ECU,Ecuador,2009,1,21,-20
FIN,Finland,ECU,Ecuador,2010,1,13,-12
FIN,Finland,ECU,Ecuador,2011,2,14,-12
FIN,Finland,ECU,Ecuador,2012,6,14,-8
FIN,Finland,ECU,Ecuador,2013,1,12,-11
FIN,Finland,ECU,Ecuador,2014,8,4,4
FIN,Finland,ECU,Ecuador,2015,3,10,-7
FIN,Finland,ECU,Ecuador,2016,2,12,-10
FIN,Finland,ECU,Ecuador,2017,3,9,-6
FRA,France,ECU,Ecuador,2008,0,227,-227
FRA,France,ECU,Ecuador,2009,0,221,-221
FRA,France,ECU,Ecuador,2010,0,230,-230
FRA,France,ECU,Ecuador,2011,0,191,-191
FRA,France,ECU,Ecuador,2012,0,195,-195
FRA,France,ECU,Ecuador,2013,0,217,-217
FRA,France,ECU,Ecuador,2014,0,179,-179
FRA,France,ECU,Ecuador,2015,0,142,-142
FRA,France,ECU,Ecuador,2016,0,151,-151
FRA,France,ECU,Ecuador,2017,0,172,-172
DEU,Germany,ECU,Ecuador,2008,490,578,-88
DEU,Germany,ECU,Ecuador,2009,498,600,-102
DEU,Germany,ECU,Ecuador,2010,478,666,-188
DEU,Germany,ECU,Ecuador,2011,441,710,-269
DEU,Germany,ECU,Ecuador,2012,438,815,-377
DEU,Germany,ECU,Ecuador,2013,500,795,-295
DEU,Germany,ECU,Ecuador,2014,486,713,-227
DEU,Germany,ECU,Ecuador,2015,493,776,-283
DEU,Germany,ECU,Ecuador,2016,460,830,-370
DEU,Germany,ECU,Ecuador,2017,434,835,-401
HUN,Hungary,ECU,Ecuador,2008,2,11,-9
HUN,Hungary,ECU,Ecuador,2009,2,2,0
HUN,Hungary,ECU,Ecuador,2010,3,8,-5
HUN,Hungary,ECU,Ecuador,2011,1,5,-4
HUN,Hungary,ECU,Ecuador,2012,0,7,-7
HUN,Hungary,ECU,Ecuador,2013,0,3,-3
HUN,Hungary,ECU,Ecuador,2014,1,6,-5
HUN,Hungary,ECU,Ecuador,2015,1,49,-48
HUN,Hungary,ECU,Ecuador,2016,0,43,-43
HUN,Hungary,ECU,Ecuador,2017,0,61,-61
ISL,Iceland,ECU,Ecuador,2008,2,0,2
ISL,Iceland,ECU,Ecuador,2009,1,3,-2
ISL,Iceland,ECU,Ecuador,2010,5,3,2
ISL,Iceland,ECU,Ecuador,2011,0,7,-7
ISL,Iceland,ECU,Ecuador,2012,1,1,0
ISL,Iceland,ECU,Ecuador,2013,1,3,-2
ISL,Iceland,ECU,Ecuador,2014,2,2,0
ISL,Iceland,ECU,Ecuador,2015,1,3,-2
ISL,Iceland,ECU,Ecuador,2016,2,2,0
ISL,Iceland,ECU,Ecuador,2017,1,3,-2
ITA,Italy,ECU,Ecuador,2008,293,6874,-6581
ITA,Italy,ECU,Ecuador,2009,334,6324,-5990
ITA,Italy,ECU,Ecuador,2010,434,6168,-5734
ITA,Italy,ECU,Ecuador,2011,411,4164,-3753
ITA,Italy,ECU,Ecuador,2012,537,3037,-2500
ITA,Italy,ECU,Ecuador,2013,777,1926,-1149
ITA,Italy,ECU,Ecuador,2014,744,1120,-376
ITA,Italy,ECU,Ecuador,2015,599,814,-215
ITA,Italy,ECU,Ecuador,2016,0,717,-717
ITA,Italy,ECU,Ecuador,2017,240,1022,-782
JPN,Japan,ECU,Ecuador,2008,89,106,-17
JPN,Japan,ECU,Ecuador,2009,132,156,-24
JPN,Japan,ECU,Ecuador,2010,222,220,2
JPN,Japan,ECU,Ecuador,2011,99,118,-19
JPN,Japan,ECU,Ecuador,2012,139,153,-14
JPN,Japan,ECU,Ecuador,2013,89,100,-11
JPN,Japan,ECU,Ecuador,2014,120,130,-10
JPN,Japan,ECU,Ecuador,2015,137,144,-7
JPN,Japan,ECU,Ecuador,2016,100,117,-17
JPN,Japan,ECU,Ecuador,2017,120,147,-27
KOR,Korea,ECU,Ecuador,2008,39,46,-7
KOR,Korea,ECU,Ecuador,2009,43,37,6
KOR,Korea,ECU,Ecuador,2010,35,46,-11
KOR,Korea,ECU,Ecuador,2011,41,54,-13
KOR,Korea,ECU,Ecuador,2012,71,61,10
KOR,Korea,ECU,Ecuador,2013,48,73,-25
KOR,Korea,ECU,Ecuador,2014,74,104,-30
KOR,Korea,ECU,Ecuador,2015,79,106,-27
KOR,Korea,ECU,Ecuador,2016,93,110,-17
KOR,Korea,ECU,Ecuador,2017,96,107,-11
LUX,Luxembourg,ECU,Ecuador,2008,10,4,6
LUX,Luxembourg,ECU,Ecuador,2009,3,6,-3
LUX,Luxembourg,ECU,Ecuador,2010,1,13,-12
LUX,Luxembourg,ECU,Ecuador,2011,1,5,-4
LUX,Luxembourg,ECU,Ecuador,2012,3,1,2
LUX,Luxembourg,ECU,Ecuador,2013,0,11,-11
LUX,Luxembourg,ECU,Ecuador,2014,3,7,-4
LUX,Luxembourg,ECU,Ecuador,2015,1,3,-2
LUX,Luxembourg,ECU,Ecuador,2016,3,4,-1
LUX,Luxembourg,ECU,Ecuador,2017,2,4,-2
MEX,Mexico,ECU,Ecuador,2008,0,130,-130
MEX,Mexico,ECU,Ecuador,2009,0,226,-226
MEX,Mexico,ECU,Ecuador,2010,0,232,-232
MEX,Mexico,ECU,Ecuador,2011,0,169,-169
MEX,Mexico,ECU,Ecuador,2012,0,182,-182
MEX,Mexico,ECU,Ecuador,2013,0,507,-507
MEX,Mexico,ECU,Ecuador,2014,0,377,-377
MEX,Mexico,ECU,Ecuador,2015,0,262,-262
MEX,Mexico,ECU,Ecuador,2016,0,304,-304
MEX,Mexico,ECU,Ecuador,2017,0,232,-232
NLD,Netherlands,ECU,Ecuador,2008,64,128,-64
NLD,Netherlands,ECU,Ecuador,2009,53,111,-58
NLD,Netherlands,ECU,Ecuador,2010,74,132,-58
NLD,Netherlands,ECU,Ecuador,2011,62,122,-60
NLD,Netherlands,ECU,Ecuador,2012,86,126,-40
NLD,Netherlands,ECU,Ecuador,2013,79,128,-49
NLD,Netherlands,ECU,Ecuador,2014,73,131,-58
NLD,Netherlands,ECU,Ecuador,2015,99,156,-57
NLD,Netherlands,ECU,Ecuador,2016,90,135,-45
NLD,Netherlands,ECU,Ecuador,2017,116,137,-21
NZL,New Zealand,ECU,Ecuador,2008,0,4,-4
NZL,New Zealand,ECU,Ecuador,2009,3,16,-13
NZL,New Zealand,ECU,Ecuador,2010,4,12,-8
NZL,New Zealand,ECU,Ecuador,2011,3,23,-20
NZL,New Zealand,ECU,Ecuador,2012,5,16,-11
NZL,New Zealand,ECU,Ecuador,2013,3,21,-18
NZL,New Zealand,ECU,Ecuador,2014,3,37,-34
NZL,New Zealand,ECU,Ecuador,2015,5,16,-11
NZL,New Zealand,ECU,Ecuador,2016,3,16,-13
NZL,New Zealand,ECU,Ecuador,2017,4,25,-21
NOR,Norway,ECU,Ecuador,2008,12,31,-19
NOR,Norway,ECU,Ecuador,2009,0,26,-26
NOR,Norway,ECU,Ecuador,2010,12,17,-5
NOR,Norway,ECU,Ecuador,2011,17,22,-5
NOR,Norway,ECU,Ecuador,2012,16,25,-9
NOR,Norway,ECU,Ecuador,2013,16,33,-17
NOR,Norway,ECU,Ecuador,2014,10,25,-15
NOR,Norway,ECU,Ecuador,2015,3,16,-13
NOR,Norway,ECU,Ecuador,2016,11,14,-3
NOR,Norway,ECU,Ecuador,2017,7,16,-9
POL,Poland,ECU,Ecuador,2008,0,25,-25
POL,Poland,ECU,Ecuador,2009,0,28,-28
POL,Poland,ECU,Ecuador,2010,0,17,-17
POL,Poland,ECU,Ecuador,2011,0,19,-19
POL,Poland,ECU,Ecuador,2012,0,19,-19
POL,Poland,ECU,Ecuador,2013,0,14,-14
POL,Poland,ECU,Ecuador,2014,0,7,-7
POL,Poland,ECU,Ecuador,2015,0,15,-15
POL,Poland,ECU,Ecuador,2016,0,10,-10
POL,Poland,ECU,Ecuador,2017,0,21,-21
SVK,Slovak Republic,ECU,Ecuador,2008,4,1,3
SVK,Slovak Republic,ECU,Ecuador,2009,1,2,-1
SVK,Slovak Republic,ECU,Ecuador,2010,1,3,-2
SVK,Slovak Republic,ECU,Ecuador,2011,0,1,-1
SVK,Slovak Republic,ECU,Ecuador,2013,0,2,-2
SVK,Slovak Republic,ECU,Ecuador,2014,0,1,-1
SVK,Slovak Republic,ECU,Ecuador,2015,0,2,-2
SVK,Slovak Republic,ECU,Ecuador,2017,0,1,-1
ESP,Spain,ECU,Ecuador,2008,12964,32464,-19500
ESP,Spain,ECU,Ecuador,2009,18108,13512,4596
ESP,Spain,ECU,Ecuador,2010,21112,6939,14173
ESP,Spain,ECU,Ecuador,2011,21097,6523,14574
ESP,Spain,ECU,Ecuador,2012,21280,5581,15699
ESP,Spain,ECU,Ecuador,2013,23245,5262,17983
ESP,Spain,ECU,Ecuador,2014,13031,4943,8088
ESP,Spain,ECU,Ecuador,2015,7750,5252,2498
ESP,Spain,ECU,Ecuador,2016,6235,6762,-527
ESP,Spain,ECU,Ecuador,2017,8068,8954,-886
SWE,Sweden,ECU,Ecuador,2008,11,106,-95
SWE,Sweden,ECU,Ecuador,2009,10,97,-87
SWE,Sweden,ECU,Ecuador,2010,17,112,-95
SWE,Sweden,ECU,Ecuador,2011,10,90,-80
SWE,Sweden,ECU,Ecuador,2012,21,82,-61
SWE,Sweden,ECU,Ecuador,2013,11,59,-48
SWE,Sweden,ECU,Ecuador,2014,28,59,-31
SWE,Sweden,ECU,Ecuador,2015,34,66,-32
SWE,Sweden,ECU,Ecuador,2016,17,36,-19
SWE,Sweden,ECU,Ecuador,2017,13,46,-33
CHE,Switzerland,ECU,Ecuador,2010,75,345,-270
CHE,Switzerland,ECU,Ecuador,2011,77,326,-249
CHE,Switzerland,ECU,Ecuador,2012,73,281,-208
CHE,Switzerland,ECU,Ecuador,2013,77,290,-213
CHE,Switzerland,ECU,Ecuador,2014,69,203,-134
CHE,Switzerland,ECU,Ecuador,2015,81,203,-122
CHE,Switzerland,ECU,Ecuador,2016,70,202,-132
CHE,Switzerland,ECU,Ecuador,2017,58,204,-146
TUR,Turkey,ECU,Ecuador,2010,0,7,-7
USA,United States,ECU,Ecuador,2008,0,11663,-11663
USA,United States,ECU,Ecuador,2009,0,12128,-12128
USA,United States,ECU,Ecuador,2010,0,11492,-11492
USA,United States,ECU,Ecuador,2011,0,11103,-11103
USA,United States,ECU,Ecuador,2012,0,9342,-9342
USA,United States,ECU,Ecuador,2013,0,10591,-10591
USA,United States,ECU,Ecuador,2014,0,10960,-10960
USA,United States,ECU,Ecuador,2015,0,10187,-10187
USA,United States,ECU,Ecuador,2016,0,10757,-10757
USA,United States,ECU,Ecuador,2017,0,10594,-10594
CHL,Chile,ECU,Ecuador,2008,0,2030,-2030
CHL,Chile,ECU,Ecuador,2009,0,1804,-1804
CHL,Chile,ECU,Ecuador,2010,0,1573,-1573
CHL,Chile,ECU,Ecuador,2011,0,1890,-1890
CHL,Chile,ECU,Ecuador,2012,0,2048,-2048
CHL,Chile,ECU,Ecuador,2013,0,2256,-2256
CHL,Chile,ECU,Ecuador,2014,0,2190,-2190
CHL,Chile,ECU,Ecuador,2015,0,2844,-2844
CHL,Chile,ECU,Ecuador,2016,0,4318,-4318
EST,Estonia,ECU,Ecuador,2008,0,0,0
EST,Estonia,ECU,Ecuador,2009,0,1,-1
EST,Estonia,ECU,Ecuador,2010,0,0,0
EST,Estonia,ECU,Ecuador,2011,0,0,0
EST,Estonia,ECU,Ecuador,2012,0,1,-1
EST,Estonia,ECU,Ecuador,2013,0,0,0
EST,Estonia,ECU,Ecuador,2014,0,1,-1
EST,Estonia,ECU,Ecuador,2015,0,2,-2
EST,Estonia,ECU,Ecuador,2016,0,3,-3
EST,Estonia,ECU,Ecuador,2017,0,2,-2
SVN,Slovenia,ECU,Ecuador,2008,0,1,-1
SVN,Slovenia,ECU,Ecuador,2009,0,2,-2
SVN,Slovenia,ECU,Ecuador,2010,0,1,-1
SVN,Slovenia,ECU,Ecuador,2014,0,1,-1
SVN,Slovenia,ECU,Ecuador,2015,0,3,-3
AUS,Australia,EGY,Egypt,2008,159,703,-544
AUS,Australia,EGY,Egypt,2009,155,878,-723
AUS,Australia,EGY,Egypt,2010,147,955,-808
AUS,Australia,EGY,Egypt,2011,154,898,-744
AUS,Australia,EGY,Egypt,2012,143,948,-805
AUS,Australia,EGY,Egypt,2013,178,1307,-1129
AUS,Australia,EGY,Egypt,2014,214,1362,-1148
AUS,Australia,EGY,Egypt,2015,200,1225,-1025
AUS,Australia,EGY,Egypt,2016,200,1274,-1074
AUS,Australia,EGY,Egypt,2017,0,1423,-1423
AUT,Austria,EGY,Egypt,2008,374,494,-120
AUT,Austria,EGY,Egypt,2009,389,478,-89
AUT,Austria,EGY,Egypt,2010,376,409,-33
AUT,Austria,EGY,Egypt,2011,337,520,-183
AUT,Austria,EGY,Egypt,2012,344,623,-279
AUT,Austria,EGY,Egypt,2013,351,664,-313
AUT,Austria,EGY,Egypt,2014,344,610,-266
AUT,Austria,EGY,Egypt,2015,321,654,-333
AUT,Austria,EGY,Egypt,2016,364,629,-265
AUT,Austria,EGY,Egypt,2017,355,705,-350
BEL,Belgium,EGY,Egypt,2008,0,257,-257
BEL,Belgium,EGY,Egypt,2009,0,291,-291
BEL,Belgium,EGY,Egypt,2010,31,268,-237
BEL,Belgium,EGY,Egypt,2011,0,303,-303
BEL,Belgium,EGY,Egypt,2012,141,312,-171
BEL,Belgium,EGY,Egypt,2013,218,387,-169
BEL,Belgium,EGY,Egypt,2014,152,294,-142
BEL,Belgium,EGY,Egypt,2015,170,245,-75
BEL,Belgium,EGY,Egypt,2016,109,314,-205
BEL,Belgium,EGY,Egypt,2017,86,322,-236
CAN,Canada,EGY,Egypt,2008,0,3347,-3347
CAN,Canada,EGY,Egypt,2009,0,3495,-3495
CAN,Canada,EGY,Egypt,2010,0,5982,-5982
CAN,Canada,EGY,Egypt,2011,0,4663,-4663
CAN,Canada,EGY,Egypt,2012,0,5550,-5550
CAN,Canada,EGY,Egypt,2013,0,4165,-4165
CAN,Canada,EGY,Egypt,2014,0,3159,-3159
CAN,Canada,EGY,Egypt,2015,0,3762,-3762
CAN,Canada,EGY,Egypt,2016,0,3090,-3090
CAN,Canada,EGY,Egypt,2017,0,2865,-2865
CZE,Czech Republic,EGY,Egypt,2008,0,97,-97
CZE,Czech Republic,EGY,Egypt,2009,0,106,-106
CZE,Czech Republic,EGY,Egypt,2010,1,80,-79
CZE,Czech Republic,EGY,Egypt,2011,0,58,-58
CZE,Czech Republic,EGY,Egypt,2012,27,83,-56
CZE,Czech Republic,EGY,Egypt,2013,34,81,-47
CZE,Czech Republic,EGY,Egypt,2014,54,140,-86
CZE,Czech Republic,EGY,Egypt,2015,50,101,-51
CZE,Czech Republic,EGY,Egypt,2016,50,128,-78
CZE,Czech Republic,EGY,Egypt,2017,37,204,-167
DNK,Denmark,EGY,Egypt,2008,23,47,-24
DNK,Denmark,EGY,Egypt,2009,20,69,-49
DNK,Denmark,EGY,Egypt,2010,28,48,-20
DNK,Denmark,EGY,Egypt,2011,26,78,-52
DNK,Denmark,EGY,Egypt,2012,23,60,-37
DNK,Denmark,EGY,Egypt,2013,52,106,-54
DNK,Denmark,EGY,Egypt,2014,26,105,-79
DNK,Denmark,EGY,Egypt,2015,60,93,-33
DNK,Denmark,EGY,Egypt,2016,64,87,-23
DNK,Denmark,EGY,Egypt,2017,75,110,-35
FIN,Finland,EGY,Egypt,2008,8,50,-42
FIN,Finland,EGY,Egypt,2009,4,67,-63
FIN,Finland,EGY,Egypt,2010,14,60,-46
FIN,Finland,EGY,Egypt,2011,4,60,-56
FIN,Finland,EGY,Egypt,2012,16,86,-70
FIN,Finland,EGY,Egypt,2013,8,78,-70
FIN,Finland,EGY,Egypt,2014,10,89,-79
FIN,Finland,EGY,Egypt,2015,16,79,-63
FIN,Finland,EGY,Egypt,2016,25,102,-77
FIN,Finland,EGY,Egypt,2017,20,82,-62
FRA,France,EGY,Egypt,2008,0,871,-871
FRA,France,EGY,Egypt,2009,0,1008,-1008
FRA,France,EGY,Egypt,2010,0,918,-918
FRA,France,EGY,Egypt,2011,0,1018,-1018
FRA,France,EGY,Egypt,2012,0,1208,-1208
FRA,France,EGY,Egypt,2013,0,1249,-1249
FRA,France,EGY,Egypt,2014,0,1445,-1445
FRA,France,EGY,Egypt,2015,0,1216,-1216
FRA,France,EGY,Egypt,2016,0,1298,-1298
FRA,France,EGY,Egypt,2017,0,1255,-1255
DEU,Germany,EGY,Egypt,2008,1599,1847,-248
DEU,Germany,EGY,Egypt,2009,1770,1906,-136
DEU,Germany,EGY,Egypt,2010,1676,2057,-381
DEU,Germany,EGY,Egypt,2011,1607,2254,-647
DEU,Germany,EGY,Egypt,2012,1573,2916,-1343
DEU,Germany,EGY,Egypt,2013,1962,5465,-3503
DEU,Germany,EGY,Egypt,2014,2101,4650,-2549
DEU,Germany,EGY,Egypt,2015,2564,5831,-3267
DEU,Germany,EGY,Egypt,2016,2887,6723,-3836
DEU,Germany,EGY,Egypt,2017,2753,5913,-3160
GRC,Greece,EGY,Egypt,2008,0,1404,-1404
GRC,Greece,EGY,Egypt,2009,0,1400,-1400
GRC,Greece,EGY,Egypt,2010,0,1084,-1084
GRC,Greece,EGY,Egypt,2011,0,908,-908
HUN,Hungary,EGY,Egypt,2008,2,96,-94
HUN,Hungary,EGY,Egypt,2009,5,114,-109
HUN,Hungary,EGY,Egypt,2010,9,81,-72
HUN,Hungary,EGY,Egypt,2011,14,79,-65
HUN,Hungary,EGY,Egypt,2012,5,127,-122
HUN,Hungary,EGY,Egypt,2013,16,129,-113
HUN,Hungary,EGY,Egypt,2014,27,155,-128
HUN,Hungary,EGY,Egypt,2015,40,143,-103
HUN,Hungary,EGY,Egypt,2016,26,154,-128
HUN,Hungary,EGY,Egypt,2017,0,186,-186
ISL,Iceland,EGY,Egypt,2008,1,3,-2
ISL,Iceland,EGY,Egypt,2009,1,3,-2
ISL,Iceland,EGY,Egypt,2010,3,3,0
ISL,Iceland,EGY,Egypt,2011,0,4,-4
ISL,Iceland,EGY,Egypt,2012,0,5,-5
ISL,Iceland,EGY,Egypt,2013,1,0,1
ISL,Iceland,EGY,Egypt,2014,1,2,-1
ISL,Iceland,EGY,Egypt,2015,1,7,-6
ISL,Iceland,EGY,Egypt,2016,1,4,-3
ISL,Iceland,EGY,Egypt,2017,1,0,1
ITA,Italy,EGY,Egypt,2008,111,5274,-5163
ITA,Italy,EGY,Egypt,2009,137,7977,-7840
ITA,Italy,EGY,Egypt,2010,333,9345,-9012
ITA,Italy,EGY,Egypt,2011,304,9572,-9268
ITA,Italy,EGY,Egypt,2012,449,8623,-8174
ITA,Italy,EGY,Egypt,2013,360,9754,-9394
ITA,Italy,EGY,Egypt,2014,434,8665,-8231
ITA,Italy,EGY,Egypt,2015,446,7448,-7002
ITA,Italy,EGY,Egypt,2016,0,6631,-6631
ITA,Italy,EGY,Egypt,2017,375,7709,-7334
JPN,Japan,EGY,Egypt,2008,659,857,-198
JPN,Japan,EGY,Egypt,2009,615,625,-10
JPN,Japan,EGY,Egypt,2010,802,635,167
JPN,Japan,EGY,Egypt,2011,592,521,71
JPN,Japan,EGY,Egypt,2012,694,831,-137
JPN,Japan,EGY,Egypt,2013,552,893,-341
JPN,Japan,EGY,Egypt,2014,619,870,-251
JPN,Japan,EGY,Egypt,2015,659,957,-298
JPN,Japan,EGY,Egypt,2016,824,1130,-306
JPN,Japan,EGY,Egypt,2017,773,924,-151
KOR,Korea,EGY,Egypt,2008,431,351,80
KOR,Korea,EGY,Egypt,2009,387,275,112
KOR,Korea,EGY,Egypt,2010,286,387,-101
KOR,Korea,EGY,Egypt,2011,349,529,-180
KOR,Korea,EGY,Egypt,2012,299,419,-120
KOR,Korea,EGY,Egypt,2013,342,863,-521
KOR,Korea,EGY,Egypt,2014,489,1171,-682
KOR,Korea,EGY,Egypt,2015,551,1024,-473
KOR,Korea,EGY,Egypt,2016,668,1127,-459
KOR,Korea,EGY,Egypt,2017,635,991,-356
LUX,Luxembourg,EGY,Egypt,2008,0,15,-15
LUX,Luxembourg,EGY,Egypt,2009,2,9,-7
LUX,Luxembourg,EGY,Egypt,2010,8,10,-2
LUX,Luxembourg,EGY,Egypt,2011,2,13,-11
LUX,Luxembourg,EGY,Egypt,2012,1,17,-16
LUX,Luxembourg,EGY,Egypt,2013,9,25,-16
LUX,Luxembourg,EGY,Egypt,2014,8,20,-12
LUX,Luxembourg,EGY,Egypt,2015,10,15,-5
LUX,Luxembourg,EGY,Egypt,2016,6,43,-37
LUX,Luxembourg,EGY,Egypt,2017,10,50,-40
MEX,Mexico,EGY,Egypt,2008,0,20,-20
MEX,Mexico,EGY,Egypt,2009,0,31,-31
MEX,Mexico,EGY,Egypt,2010,0,26,-26
MEX,Mexico,EGY,Egypt,2011,0,30,-30
MEX,Mexico,EGY,Egypt,2012,0,31,-31
MEX,Mexico,EGY,Egypt,2013,0,56,-56
MEX,Mexico,EGY,Egypt,2014,0,37,-37
MEX,Mexico,EGY,Egypt,2015,0,40,-40
MEX,Mexico,EGY,Egypt,2016,0,36,-36
MEX,Mexico,EGY,Egypt,2017,0,41,-41
NLD,Netherlands,EGY,Egypt,2008,162,356,-194
NLD,Netherlands,EGY,Egypt,2009,207,568,-361
NLD,Netherlands,EGY,Egypt,2010,164,425,-261
NLD,Netherlands,EGY,Egypt,2011,164,394,-230
NLD,Netherlands,EGY,Egypt,2012,192,410,-218
NLD,Netherlands,EGY,Egypt,2013,226,525,-299
NLD,Netherlands,EGY,Egypt,2014,164,562,-398
NLD,Netherlands,EGY,Egypt,2015,206,451,-245
NLD,Netherlands,EGY,Egypt,2016,243,655,-412
NLD,Netherlands,EGY,Egypt,2017,218,821,-603
NZL,New Zealand,EGY,Egypt,2008,9,58,-49
NZL,New Zealand,EGY,Egypt,2009,9,48,-39
NZL,New Zealand,EGY,Egypt,2010,13,46,-33
NZL,New Zealand,EGY,Egypt,2011,5,53,-48
NZL,New Zealand,EGY,Egypt,2012,12,63,-51
NZL,New Zealand,EGY,Egypt,2013,12,69,-57
NZL,New Zealand,EGY,Egypt,2014,7,120,-113
NZL,New Zealand,EGY,Egypt,2015,7,127,-120
NZL,New Zealand,EGY,Egypt,2016,19,165,-146
NZL,New Zealand,EGY,Egypt,2017,13,138,-125
NOR,Norway,EGY,Egypt,2008,17,51,-34
NOR,Norway,EGY,Egypt,2009,15,62,-47
NOR,Norway,EGY,Egypt,2010,21,55,-34
NOR,Norway,EGY,Egypt,2011,38,79,-41
NOR,Norway,EGY,Egypt,2012,20,105,-85
NOR,Norway,EGY,Egypt,2013,38,89,-51
NOR,Norway,EGY,Egypt,2014,32,106,-74
NOR,Norway,EGY,Egypt,2015,50,68,-18
NOR,Norway,EGY,Egypt,2016,38,87,-49
NOR,Norway,EGY,Egypt,2017,17,99,-82
POL,Poland,EGY,Egypt,2008,0,249,-249
POL,Poland,EGY,Egypt,2009,0,339,-339
POL,Poland,EGY,Egypt,2010,0,441,-441
POL,Poland,EGY,Egypt,2011,0,483,-483
POL,Poland,EGY,Egypt,2012,0,500,-500
POL,Poland,EGY,Egypt,2013,0,532,-532
POL,Poland,EGY,Egypt,2014,0,267,-267
POL,Poland,EGY,Egypt,2015,0,553,-553
POL,Poland,EGY,Egypt,2016,0,513,-513
POL,Poland,EGY,Egypt,2017,0,540,-540
SVK,Slovak Republic,EGY,Egypt,2008,9,15,-6
SVK,Slovak Republic,EGY,Egypt,2009,4,14,-10
SVK,Slovak Republic,EGY,Egypt,2010,6,11,-5
SVK,Slovak Republic,EGY,Egypt,2011,2,9,-7
SVK,Slovak Republic,EGY,Egypt,2012,0,10,-10
SVK,Slovak Republic,EGY,Egypt,2013,0,6,-6
SVK,Slovak Republic,EGY,Egypt,2014,0,4,-4
SVK,Slovak Republic,EGY,Egypt,2015,0,12,-12
SVK,Slovak Republic,EGY,Egypt,2016,0,4,-4
SVK,Slovak Republic,EGY,Egypt,2017,2,12,-10
ESP,Spain,EGY,Egypt,2008,223,435,-212
ESP,Spain,EGY,Egypt,2009,286,297,-11
ESP,Spain,EGY,Egypt,2010,286,304,-18
ESP,Spain,EGY,Egypt,2011,436,356,80
ESP,Spain,EGY,Egypt,2012,362,456,-94
ESP,Spain,EGY,Egypt,2013,425,487,-62
ESP,Spain,EGY,Egypt,2014,264,549,-285
ESP,Spain,EGY,Egypt,2015,278,537,-259
ESP,Spain,EGY,Egypt,2016,314,520,-206
ESP,Spain,EGY,Egypt,2017,402,591,-189
SWE,Sweden,EGY,Egypt,2008,28,230,-202
SWE,Sweden,EGY,Egypt,2009,16,314,-298
SWE,Sweden,EGY,Egypt,2010,55,406,-351
SWE,Sweden,EGY,Egypt,2011,49,673,-624
SWE,Sweden,EGY,Egypt,2012,35,648,-613
SWE,Sweden,EGY,Egypt,2013,70,501,-431
SWE,Sweden,EGY,Egypt,2014,135,485,-350
SWE,Sweden,EGY,Egypt,2015,145,517,-372
SWE,Sweden,EGY,Egypt,2016,99,537,-438
SWE,Sweden,EGY,Egypt,2017,97,693,-596
CHE,Switzerland,EGY,Egypt,2010,123,249,-126
CHE,Switzerland,EGY,Egypt,2011,115,275,-160
CHE,Switzerland,EGY,Egypt,2012,116,250,-134
CHE,Switzerland,EGY,Egypt,2013,132,309,-177
CHE,Switzerland,EGY,Egypt,2014,149,288,-139
CHE,Switzerland,EGY,Egypt,2015,118,286,-168
CHE,Switzerland,EGY,Egypt,2016,136,281,-145
CHE,Switzerland,EGY,Egypt,2017,118,308,-190
TUR,Turkey,EGY,Egypt,2010,0,60,-60
TUR,Turkey,EGY,Egypt,2016,873,4094,-3221
TUR,Turkey,EGY,Egypt,2017,1250,8582,-7332
GBR,United Kingdom,EGY,Egypt,2011,0,1000,-1000
GBR,United Kingdom,EGY,Egypt,2012,0,1000,-1000
GBR,United Kingdom,EGY,Egypt,2013,1000,2000,-1000
GBR,United Kingdom,EGY,Egypt,2014,0,1000,-1000
GBR,United Kingdom,EGY,Egypt,2015,1000,1000,0
USA,United States,EGY,Egypt,2008,0,8712,-8712
USA,United States,EGY,Egypt,2009,0,8844,-8844
USA,United States,EGY,Egypt,2010,0,8978,-8978
USA,United States,EGY,Egypt,2011,0,7778,-7778
USA,United States,EGY,Egypt,2012,0,8988,-8988
USA,United States,EGY,Egypt,2013,0,10294,-10294
USA,United States,EGY,Egypt,2014,0,11477,-11477
USA,United States,EGY,Egypt,2015,0,12085,-12085
USA,United States,EGY,Egypt,2016,0,12045,-12045
USA,United States,EGY,Egypt,2017,0,9834,-9834
CHL,Chile,EGY,Egypt,2008,0,3,-3
CHL,Chile,EGY,Egypt,2009,0,6,-6
CHL,Chile,EGY,Egypt,2010,0,3,-3
CHL,Chile,EGY,Egypt,2011,0,4,-4
CHL,Chile,EGY,Egypt,2012,0,11,-11
CHL,Chile,EGY,Egypt,2013,0,5,-5
CHL,Chile,EGY,Egypt,2014,0,8,-8
CHL,Chile,EGY,Egypt,2015,0,17,-17
CHL,Chile,EGY,Egypt,2016,0,22,-22
EST,Estonia,EGY,Egypt,2008,0,7,-7
EST,Estonia,EGY,Egypt,2009,0,5,-5
EST,Estonia,EGY,Egypt,2010,0,10,-10
EST,Estonia,EGY,Egypt,2011,0,9,-9
EST,Estonia,EGY,Egypt,2012,0,5,-5
EST,Estonia,EGY,Egypt,2013,0,12,-12
EST,Estonia,EGY,Egypt,2014,0,3,-3
EST,Estonia,EGY,Egypt,2015,0,27,-27
EST,Estonia,EGY,Egypt,2016,0,21,-21
EST,Estonia,EGY,Egypt,2017,0,21,-21
SVN,Slovenia,EGY,Egypt,2008,0,26,-26
SVN,Slovenia,EGY,Egypt,2009,0,12,-12
SVN,Slovenia,EGY,Egypt,2010,0,8,-8
SVN,Slovenia,EGY,Egypt,2011,0,6,-6
SVN,Slovenia,EGY,Egypt,2012,1,9,-8
SVN,Slovenia,EGY,Egypt,2013,1,6,-5
SVN,Slovenia,EGY,Egypt,2014,0,3,-3
SVN,Slovenia,EGY,Egypt,2015,0,7,-7
SVN,Slovenia,EGY,Egypt,2016,0,6,-6
SVN,Slovenia,EGY,Egypt,2017,0,18,-18
AUS,Australia,SLV,El Salvador,2008,59,53,6
AUS,Australia,SLV,El Salvador,2009,59,52,7
AUS,Australia,SLV,El Salvador,2010,35,59,-24
AUS,Australia,SLV,El Salvador,2011,49,51,-2
AUS,Australia,SLV,El Salvador,2012,39,38,1
AUS,Australia,SLV,El Salvador,2013,48,40,8
AUS,Australia,SLV,El Salvador,2014,51,41,10
AUS,Australia,SLV,El Salvador,2015,0,30,-30
AUS,Australia,SLV,El Salvador,2016,0,38,-38
AUS,Australia,SLV,El Salvador,2017,0,39,-39
AUT,Austria,SLV,El Salvador,2008,1,8,-7
AUT,Austria,SLV,El Salvador,2009,4,3,1
AUT,Austria,SLV,El Salvador,2010,3,3,0
AUT,Austria,SLV,El Salvador,2011,4,7,-3
AUT,Austria,SLV,El Salvador,2012,2,10,-8
AUT,Austria,SLV,El Salvador,2013,8,15,-7
AUT,Austria,SLV,El Salvador,2014,7,7,0
AUT,Austria,SLV,El Salvador,2015,4,12,-8
AUT,Austria,SLV,El Salvador,2016,2,11,-9
AUT,Austria,SLV,El Salvador,2017,10,8,2
BEL,Belgium,SLV,El Salvador,2008,0,11,-11
BEL,Belgium,SLV,El Salvador,2009,0,17,-17
BEL,Belgium,SLV,El Salvador,2010,2,26,-24
BEL,Belgium,SLV,El Salvador,2012,3,35,-32
BEL,Belgium,SLV,El Salvador,2013,6,32,-26
BEL,Belgium,SLV,El Salvador,2014,21,34,-13
BEL,Belgium,SLV,El Salvador,2015,5,50,-45
BEL,Belgium,SLV,El Salvador,2016,9,97,-88
BEL,Belgium,SLV,El Salvador,2017,10,135,-125
CAN,Canada,SLV,El Salvador,2008,0,1114,-1114
CAN,Canada,SLV,El Salvador,2009,0,841,-841
CAN,Canada,SLV,El Salvador,2010,0,768,-768
CAN,Canada,SLV,El Salvador,2011,0,690,-690
CAN,Canada,SLV,El Salvador,2012,0,641,-641
CAN,Canada,SLV,El Salvador,2013,0,637,-637
CAN,Canada,SLV,El Salvador,2014,0,700,-700
CAN,Canada,SLV,El Salvador,2015,0,656,-656
CAN,Canada,SLV,El Salvador,2016,0,625,-625
CAN,Canada,SLV,El Salvador,2017,0,720,-720
CZE,Czech Republic,SLV,El Salvador,2008,0,2,-2
CZE,Czech Republic,SLV,El Salvador,2009,0,2,-2
CZE,Czech Republic,SLV,El Salvador,2010,0,2,-2
CZE,Czech Republic,SLV,El Salvador,2011,0,1,-1
CZE,Czech Republic,SLV,El Salvador,2013,1,13,-12
CZE,Czech Republic,SLV,El Salvador,2014,9,6,3
CZE,Czech Republic,SLV,El Salvador,2015,5,2,3
DNK,Denmark,SLV,El Salvador,2008,0,4,-4
DNK,Denmark,SLV,El Salvador,2009,0,1,-1
DNK,Denmark,SLV,El Salvador,2010,1,7,-6
DNK,Denmark,SLV,El Salvador,2011,2,3,-1
DNK,Denmark,SLV,El Salvador,2012,1,1,0
DNK,Denmark,SLV,El Salvador,2013,0,5,-5
DNK,Denmark,SLV,El Salvador,2014,7,1,6
DNK,Denmark,SLV,El Salvador,2015,1,5,-4
DNK,Denmark,SLV,El Salvador,2016,0,7,-7
DNK,Denmark,SLV,El Salvador,2017,1,1,0
FIN,Finland,SLV,El Salvador,2008,0,0,0
FIN,Finland,SLV,El Salvador,2009,1,2,-1
FIN,Finland,SLV,El Salvador,2010,0,4,-4
FIN,Finland,SLV,El Salvador,2011,0,2,-2
FIN,Finland,SLV,El Salvador,2012,0,4,-4
FIN,Finland,SLV,El Salvador,2013,1,2,-1
FIN,Finland,SLV,El Salvador,2014,2,5,-3
FIN,Finland,SLV,El Salvador,2015,1,2,-1
FIN,Finland,SLV,El Salvador,2016,0,7,-7
FIN,Finland,SLV,El Salvador,2017,0,6,-6
FRA,France,SLV,El Salvador,2008,0,25,-25
FRA,France,SLV,El Salvador,2009,0,39,-39
FRA,France,SLV,El Salvador,2010,0,39,-39
FRA,France,SLV,El Salvador,2011,0,51,-51
FRA,France,SLV,El Salvador,2012,0,55,-55
FRA,France,SLV,El Salvador,2013,0,64,-64
FRA,France,SLV,El Salvador,2014,0,52,-52
FRA,France,SLV,El Salvador,2015,0,52,-52
FRA,France,SLV,El Salvador,2016,0,50,-50
FRA,France,SLV,El Salvador,2017,0,44,-44
DEU,Germany,SLV,El Salvador,2008,64,73,-9
DEU,Germany,SLV,El Salvador,2009,61,101,-40
DEU,Germany,SLV,El Salvador,2010,64,96,-32
DEU,Germany,SLV,El Salvador,2011,62,138,-76
DEU,Germany,SLV,El Salvador,2012,73,138,-65
DEU,Germany,SLV,El Salvador,2013,77,126,-49
DEU,Germany,SLV,El Salvador,2014,78,145,-67
DEU,Germany,SLV,El Salvador,2015,66,179,-113
DEU,Germany,SLV,El Salvador,2016,118,237,-119
DEU,Germany,SLV,El Salvador,2017,88,216,-128
HUN,Hungary,SLV,El Salvador,2008,1,3,-2
HUN,Hungary,SLV,El Salvador,2009,0,1,-1
HUN,Hungary,SLV,El Salvador,2010,0,3,-3
HUN,Hungary,SLV,El Salvador,2011,0,1,-1
HUN,Hungary,SLV,El Salvador,2012,0,4,-4
HUN,Hungary,SLV,El Salvador,2013,0,1,-1
HUN,Hungary,SLV,El Salvador,2014,0,1,-1
HUN,Hungary,SLV,El Salvador,2015,0,4,-4
HUN,Hungary,SLV,El Salvador,2016,0,2,-2
HUN,Hungary,SLV,El Salvador,2017,0,4,-4
ISL,Iceland,SLV,El Salvador,2008,4,3,1
ISL,Iceland,SLV,El Salvador,2009,2,3,-1
ISL,Iceland,SLV,El Salvador,2010,4,4,0
ISL,Iceland,SLV,El Salvador,2011,3,4,-1
ISL,Iceland,SLV,El Salvador,2012,0,2,-2
ISL,Iceland,SLV,El Salvador,2013,2,2,0
ISL,Iceland,SLV,El Salvador,2014,3,1,2
ISL,Iceland,SLV,El Salvador,2015,2,0,2
ISL,Iceland,SLV,El Salvador,2016,1,9,-8
ISL,Iceland,SLV,El Salvador,2017,1,2,-1
ITA,Italy,SLV,El Salvador,2008,5,433,-428
ITA,Italy,SLV,El Salvador,2009,6,691,-685
ITA,Italy,SLV,El Salvador,2010,8,1535,-1527
ITA,Italy,SLV,El Salvador,2011,14,1359,-1345
ITA,Italy,SLV,El Salvador,2012,20,1036,-1016
ITA,Italy,SLV,El Salvador,2013,15,990,-975
ITA,Italy,SLV,El Salvador,2014,27,822,-795
ITA,Italy,SLV,El Salvador,2015,29,669,-640
ITA,Italy,SLV,El Salvador,2016,0,767,-767
ITA,Italy,SLV,El Salvador,2017,15,1211,-1196
JPN,Japan,SLV,El Salvador,2008,54,57,-3
JPN,Japan,SLV,El Salvador,2009,81,82,-1
JPN,Japan,SLV,El Salvador,2010,109,115,-6
JPN,Japan,SLV,El Salvador,2011,93,96,-3
JPN,Japan,SLV,El Salvador,2012,101,102,-1
JPN,Japan,SLV,El Salvador,2013,82,88,-6
JPN,Japan,SLV,El Salvador,2014,83,88,-5
JPN,Japan,SLV,El Salvador,2015,108,110,-2
JPN,Japan,SLV,El Salvador,2016,67,75,-8
JPN,Japan,SLV,El Salvador,2017,66,74,-8
KOR,Korea,SLV,El Salvador,2008,5,18,-13
KOR,Korea,SLV,El Salvador,2009,3,13,-10
KOR,Korea,SLV,El Salvador,2010,7,19,-12
KOR,Korea,SLV,El Salvador,2011,21,10,11
KOR,Korea,SLV,El Salvador,2012,16,11,5
KOR,Korea,SLV,El Salvador,2013,9,13,-4
KOR,Korea,SLV,El Salvador,2014,12,16,-4
KOR,Korea,SLV,El Salvador,2015,18,21,-3
KOR,Korea,SLV,El Salvador,2016,12,15,-3
KOR,Korea,SLV,El Salvador,2017,16,23,-7
LUX,Luxembourg,SLV,El Salvador,2008,0,8,-8
LUX,Luxembourg,SLV,El Salvador,2009,1,2,-1
LUX,Luxembourg,SLV,El Salvador,2010,0,0,0
LUX,Luxembourg,SLV,El Salvador,2011,0,1,-1
LUX,Luxembourg,SLV,El Salvador,2012,0,4,-4
LUX,Luxembourg,SLV,El Salvador,2013,3,4,-1
LUX,Luxembourg,SLV,El Salvador,2014,6,3,3
LUX,Luxembourg,SLV,El Salvador,2015,1,6,-5
LUX,Luxembourg,SLV,El Salvador,2016,2,9,-7
LUX,Luxembourg,SLV,El Salvador,2017,1,2,-1
MEX,Mexico,SLV,El Salvador,2008,0,457,-457
MEX,Mexico,SLV,El Salvador,2009,0,796,-796
MEX,Mexico,SLV,El Salvador,2010,0,708,-708
MEX,Mexico,SLV,El Salvador,2011,0,694,-694
MEX,Mexico,SLV,El Salvador,2012,0,361,-361
MEX,Mexico,SLV,El Salvador,2013,0,1613,-1613
MEX,Mexico,SLV,El Salvador,2014,0,1210,-1210
MEX,Mexico,SLV,El Salvador,2015,0,1136,-1136
MEX,Mexico,SLV,El Salvador,2016,0,1772,-1772
MEX,Mexico,SLV,El Salvador,2017,0,2260,-2260
NLD,Netherlands,SLV,El Salvador,2008,3,11,-8
NLD,Netherlands,SLV,El Salvador,2009,7,8,-1
NLD,Netherlands,SLV,El Salvador,2010,3,11,-8
NLD,Netherlands,SLV,El Salvador,2011,6,22,-16
NLD,Netherlands,SLV,El Salvador,2012,3,11,-8
NLD,Netherlands,SLV,El Salvador,2013,8,12,-4
NLD,Netherlands,SLV,El Salvador,2014,8,15,-7
NLD,Netherlands,SLV,El Salvador,2015,10,22,-12
NLD,Netherlands,SLV,El Salvador,2016,22,21,1
NLD,Netherlands,SLV,El Salvador,2017,10,26,-16
NZL,New Zealand,SLV,El Salvador,2008,4,4,0
NZL,New Zealand,SLV,El Salvador,2009,0,3,-3
NZL,New Zealand,SLV,El Salvador,2010,2,2,0
NZL,New Zealand,SLV,El Salvador,2011,0,1,-1
NZL,New Zealand,SLV,El Salvador,2012,0,6,-6
NZL,New Zealand,SLV,El Salvador,2013,1,2,-1
NZL,New Zealand,SLV,El Salvador,2014,2,4,-2
NZL,New Zealand,SLV,El Salvador,2015,0,2,-2
NZL,New Zealand,SLV,El Salvador,2016,0,1,-1
NZL,New Zealand,SLV,El Salvador,2017,0,4,-4
NOR,Norway,SLV,El Salvador,2008,3,11,-8
NOR,Norway,SLV,El Salvador,2009,2,3,-1
NOR,Norway,SLV,El Salvador,2010,2,7,-5
NOR,Norway,SLV,El Salvador,2011,2,5,-3
NOR,Norway,SLV,El Salvador,2012,1,15,-14
NOR,Norway,SLV,El Salvador,2013,4,7,-3
NOR,Norway,SLV,El Salvador,2014,2,15,-13
NOR,Norway,SLV,El Salvador,2015,2,6,-4
NOR,Norway,SLV,El Salvador,2016,3,7,-4
NOR,Norway,SLV,El Salvador,2017,1,6,-5
POL,Poland,SLV,El Salvador,2009,0,1,-1
POL,Poland,SLV,El Salvador,2010,0,3,-3
POL,Poland,SLV,El Salvador,2011,0,5,-5
POL,Poland,SLV,El Salvador,2012,0,8,-8
POL,Poland,SLV,El Salvador,2013,0,12,-12
POL,Poland,SLV,El Salvador,2014,0,4,-4
POL,Poland,SLV,El Salvador,2015,0,12,-12
POL,Poland,SLV,El Salvador,2016,0,4,-4
POL,Poland,SLV,El Salvador,2017,0,13,-13
SVK,Slovak Republic,SLV,El Salvador,2008,0,0,0
SVK,Slovak Republic,SLV,El Salvador,2011,0,1,-1
SVK,Slovak Republic,SLV,El Salvador,2013,0,1,-1
SVK,Slovak Republic,SLV,El Salvador,2014,0,1,-1
ESP,Spain,SLV,El Salvador,2008,289,1035,-746
ESP,Spain,SLV,El Salvador,2009,354,742,-388
ESP,Spain,SLV,El Salvador,2010,398,831,-433
ESP,Spain,SLV,El Salvador,2011,471,1047,-576
ESP,Spain,SLV,El Salvador,2012,495,861,-366
ESP,Spain,SLV,El Salvador,2013,720,715,5
ESP,Spain,SLV,El Salvador,2014,375,976,-601
ESP,Spain,SLV,El Salvador,2015,261,1291,-1030
ESP,Spain,SLV,El Salvador,2016,311,1972,-1661
ESP,Spain,SLV,El Salvador,2017,371,2810,-2439
SWE,Sweden,SLV,El Salvador,2008,7,50,-43
SWE,Sweden,SLV,El Salvador,2009,0,50,-50
SWE,Sweden,SLV,El Salvador,2010,9,63,-54
SWE,Sweden,SLV,El Salvador,2011,2,51,-49
SWE,Sweden,SLV,El Salvador,2012,8,80,-72
SWE,Sweden,SLV,El Salvador,2013,6,64,-58
SWE,Sweden,SLV,El Salvador,2014,3,63,-60
SWE,Sweden,SLV,El Salvador,2015,4,63,-59
SWE,Sweden,SLV,El Salvador,2016,6,62,-56
SWE,Sweden,SLV,El Salvador,2017,4,69,-65
CHE,Switzerland,SLV,El Salvador,2010,8,40,-32
CHE,Switzerland,SLV,El Salvador,2011,13,30,-17
CHE,Switzerland,SLV,El Salvador,2012,14,27,-13
CHE,Switzerland,SLV,El Salvador,2013,6,27,-21
CHE,Switzerland,SLV,El Salvador,2014,13,22,-9
CHE,Switzerland,SLV,El Salvador,2015,16,20,-4
CHE,Switzerland,SLV,El Salvador,2016,5,31,-26
CHE,Switzerland,SLV,El Salvador,2017,6,31,-25
USA,United States,SLV,El Salvador,2008,0,19659,-19659
USA,United States,SLV,El Salvador,2009,0,19909,-19909
USA,United States,SLV,El Salvador,2010,0,18806,-18806
USA,United States,SLV,El Salvador,2011,0,18667,-18667
USA,United States,SLV,El Salvador,2012,0,16256,-16256
USA,United States,SLV,El Salvador,2013,0,18260,-18260
USA,United States,SLV,El Salvador,2014,0,19273,-19273
USA,United States,SLV,El Salvador,2015,0,19487,-19487
USA,United States,SLV,El Salvador,2016,0,23449,-23449
USA,United States,SLV,El Salvador,2017,0,25109,-25109
CHL,Chile,SLV,El Salvador,2008,0,73,-73
CHL,Chile,SLV,El Salvador,2009,0,57,-57
CHL,Chile,SLV,El Salvador,2010,0,84,-84
CHL,Chile,SLV,El Salvador,2011,0,103,-103
CHL,Chile,SLV,El Salvador,2012,0,110,-110
CHL,Chile,SLV,El Salvador,2013,0,87,-87
CHL,Chile,SLV,El Salvador,2014,0,76,-76
CHL,Chile,SLV,El Salvador,2015,0,150,-150
CHL,Chile,SLV,El Salvador,2016,0,146,-146
EST,Estonia,SLV,El Salvador,2008,0,0,0
EST,Estonia,SLV,El Salvador,2009,0,0,0
EST,Estonia,SLV,El Salvador,2010,0,0,0
EST,Estonia,SLV,El Salvador,2011,0,0,0
EST,Estonia,SLV,El Salvador,2012,0,0,0
EST,Estonia,SLV,El Salvador,2013,0,0,0
EST,Estonia,SLV,El Salvador,2014,0,0,0
EST,Estonia,SLV,El Salvador,2015,0,1,-1
EST,Estonia,SLV,El Salvador,2016,0,0,0
EST,Estonia,SLV,El Salvador,2017,0,0,0
SVN,Slovenia,SLV,El Salvador,2008,0,1,-1
AUS,Australia,GNQ,Equatorial Guinea,2009,0,0,0
AUS,Australia,GNQ,Equatorial Guinea,2010,0,0,0
AUS,Australia,GNQ,Equatorial Guinea,2011,0,0,0
AUS,Australia,GNQ,Equatorial Guinea,2012,0,1,-1
AUS,Australia,GNQ,Equatorial Guinea,2013,0,4,-4
AUS,Australia,GNQ,Equatorial Guinea,2014,0,0,0
AUS,Australia,GNQ,Equatorial Guinea,2015,0,0,0
AUS,Australia,GNQ,Equatorial Guinea,2016,0,0,0
AUS,Australia,GNQ,Equatorial Guinea,2017,0,0,0
AUT,Austria,GNQ,Equatorial Guinea,2008,1,1,0
AUT,Austria,GNQ,Equatorial Guinea,2009,2,0,2
AUT,Austria,GNQ,Equatorial Guinea,2010,1,1,0
AUT,Austria,GNQ,Equatorial Guinea,2011,2,0,2
AUT,Austria,GNQ,Equatorial Guinea,2012,0,1,-1
AUT,Austria,GNQ,Equatorial Guinea,2013,0,1,-1
AUT,Austria,GNQ,Equatorial Guinea,2014,0,0,0
AUT,Austria,GNQ,Equatorial Guinea,2015,3,4,-1
AUT,Austria,GNQ,Equatorial Guinea,2016,0,0,0
AUT,Austria,GNQ,Equatorial Guinea,2017,1,1,0
BEL,Belgium,GNQ,Equatorial Guinea,2008,0,2,-2
BEL,Belgium,GNQ,Equatorial Guinea,2009,0,0,0
BEL,Belgium,GNQ,Equatorial Guinea,2010,1,5,-4
BEL,Belgium,GNQ,Equatorial Guinea,2012,2,10,-8
BEL,Belgium,GNQ,Equatorial Guinea,2013,7,8,-1
BEL,Belgium,GNQ,Equatorial Guinea,2014,3,6,-3
BEL,Belgium,GNQ,Equatorial Guinea,2015,5,5,0
BEL,Belgium,GNQ,Equatorial Guinea,2016,0,6,-6
BEL,Belgium,GNQ,Equatorial Guinea,2017,2,12,-10
CAN,Canada,GNQ,Equatorial Guinea,2008,0,1,-1
CAN,Canada,GNQ,Equatorial Guinea,2009,0,5,-5
CAN,Canada,GNQ,Equatorial Guinea,2010,0,4,-4
CAN,Canada,GNQ,Equatorial Guinea,2011,0,4,-4
CAN,Canada,GNQ,Equatorial Guinea,2012,0,4,-4
CAN,Canada,GNQ,Equatorial Guinea,2013,0,11,-11
CAN,Canada,GNQ,Equatorial Guinea,2014,0,2,-2
CAN,Canada,GNQ,Equatorial Guinea,2015,0,0,0
CAN,Canada,GNQ,Equatorial Guinea,2016,0,5,-5
CAN,Canada,GNQ,Equatorial Guinea,2017,0,0,0
DNK,Denmark,GNQ,Equatorial Guinea,2008,0,0,0
DNK,Denmark,GNQ,Equatorial Guinea,2009,0,1,-1
DNK,Denmark,GNQ,Equatorial Guinea,2013,0,0,0
DNK,Denmark,GNQ,Equatorial Guinea,2014,0,1,-1
DNK,Denmark,GNQ,Equatorial Guinea,2015,0,1,-1
DNK,Denmark,GNQ,Equatorial Guinea,2016,0,0,0
DNK,Denmark,GNQ,Equatorial Guinea,2017,0,0,0
FIN,Finland,GNQ,Equatorial Guinea,2008,0,1,-1
FIN,Finland,GNQ,Equatorial Guinea,2009,0,3,-3
FIN,Finland,GNQ,Equatorial Guinea,2010,0,0,0
FIN,Finland,GNQ,Equatorial Guinea,2011,0,1,-1
FIN,Finland,GNQ,Equatorial Guinea,2012,0,0,0
FIN,Finland,GNQ,Equatorial Guinea,2013,0,1,-1
FIN,Finland,GNQ,Equatorial Guinea,2014,0,0,0
FIN,Finland,GNQ,Equatorial Guinea,2015,0,0,0
FIN,Finland,GNQ,Equatorial Guinea,2016,0,0,0
FIN,Finland,GNQ,Equatorial Guinea,2017,0,0,0
FRA,France,GNQ,Equatorial Guinea,2008,0,17,-17
FRA,France,GNQ,Equatorial Guinea,2009,0,17,-17
FRA,France,GNQ,Equatorial Guinea,2010,0,23,-23
FRA,France,GNQ,Equatorial Guinea,2011,0,16,-16
FRA,France,GNQ,Equatorial Guinea,2012,0,16,-16
FRA,France,GNQ,Equatorial Guinea,2013,0,27,-27
FRA,France,GNQ,Equatorial Guinea,2014,0,27,-27
FRA,France,GNQ,Equatorial Guinea,2015,0,18,-18
FRA,France,GNQ,Equatorial Guinea,2016,0,24,-24
FRA,France,GNQ,Equatorial Guinea,2017,0,42,-42
DEU,Germany,GNQ,Equatorial Guinea,2008,2,6,-4
DEU,Germany,GNQ,Equatorial Guinea,2009,5,12,-7
DEU,Germany,GNQ,Equatorial Guinea,2010,10,27,-17
DEU,Germany,GNQ,Equatorial Guinea,2011,12,10,2
DEU,Germany,GNQ,Equatorial Guinea,2012,11,8,3
DEU,Germany,GNQ,Equatorial Guinea,2013,15,12,3
DEU,Germany,GNQ,Equatorial Guinea,2014,5,21,-16
DEU,Germany,GNQ,Equatorial Guinea,2015,20,34,-14
DEU,Germany,GNQ,Equatorial Guinea,2016,6,20,-14
DEU,Germany,GNQ,Equatorial Guinea,2017,12,16,-4
HUN,Hungary,GNQ,Equatorial Guinea,2008,0,0,0
HUN,Hungary,GNQ,Equatorial Guinea,2009,0,0,0
HUN,Hungary,GNQ,Equatorial Guinea,2010,0,0,0
HUN,Hungary,GNQ,Equatorial Guinea,2011,0,0,0
HUN,Hungary,GNQ,Equatorial Guinea,2012,0,0,0
HUN,Hungary,GNQ,Equatorial Guinea,2013,0,0,0
HUN,Hungary,GNQ,Equatorial Guinea,2014,0,0,0
HUN,Hungary,GNQ,Equatorial Guinea,2015,0,1,-1
HUN,Hungary,GNQ,Equatorial Guinea,2016,0,0,0
HUN,Hungary,GNQ,Equatorial Guinea,2017,0,0,0
ISL,Iceland,GNQ,Equatorial Guinea,2008,0,0,0
ISL,Iceland,GNQ,Equatorial Guinea,2009,0,0,0
ISL,Iceland,GNQ,Equatorial Guinea,2010,0,0,0
ISL,Iceland,GNQ,Equatorial Guinea,2011,0,2,-2
ISL,Iceland,GNQ,Equatorial Guinea,2012,0,0,0
ISL,Iceland,GNQ,Equatorial Guinea,2013,0,0,0
ISL,Iceland,GNQ,Equatorial Guinea,2014,0,0,0
ISL,Iceland,GNQ,Equatorial Guinea,2015,0,0,0
ISL,Iceland,GNQ,Equatorial Guinea,2016,0,3,-3
ISL,Iceland,GNQ,Equatorial Guinea,2017,0,1,-1
ITA,Italy,GNQ,Equatorial Guinea,2008,0,5,-5
ITA,Italy,GNQ,Equatorial Guinea,2009,0,4,-4
ITA,Italy,GNQ,Equatorial Guinea,2010,0,14,-14
ITA,Italy,GNQ,Equatorial Guinea,2011,0,11,-11
ITA,Italy,GNQ,Equatorial Guinea,2012,0,10,-10
ITA,Italy,GNQ,Equatorial Guinea,2013,0,16,-16
ITA,Italy,GNQ,Equatorial Guinea,2014,0,9,-9
ITA,Italy,GNQ,Equatorial Guinea,2015,1,16,-15
ITA,Italy,GNQ,Equatorial Guinea,2016,0,16,-16
ITA,Italy,GNQ,Equatorial Guinea,2017,0,35,-35
JPN,Japan,GNQ,Equatorial Guinea,2008,21,20,1
JPN,Japan,GNQ,Equatorial Guinea,2009,3,3,0
JPN,Japan,GNQ,Equatorial Guinea,2010,9,9,0
JPN,Japan,GNQ,Equatorial Guinea,2011,4,4,0
JPN,Japan,GNQ,Equatorial Guinea,2012,19,19,0
JPN,Japan,GNQ,Equatorial Guinea,2013,10,10,0
JPN,Japan,GNQ,Equatorial Guinea,2014,0,0,0
JPN,Japan,GNQ,Equatorial Guinea,2015,9,9,0
JPN,Japan,GNQ,Equatorial Guinea,2016,2,3,-1
JPN,Japan,GNQ,Equatorial Guinea,2017,0,4,-4
KOR,Korea,GNQ,Equatorial Guinea,2008,1,2,-1
KOR,Korea,GNQ,Equatorial Guinea,2009,0,1,-1
KOR,Korea,GNQ,Equatorial Guinea,2010,3,3,0
KOR,Korea,GNQ,Equatorial Guinea,2011,1,1,0
KOR,Korea,GNQ,Equatorial Guinea,2012,6,4,2
KOR,Korea,GNQ,Equatorial Guinea,2013,0,2,-2
KOR,Korea,GNQ,Equatorial Guinea,2014,0,0,0
KOR,Korea,GNQ,Equatorial Guinea,2015,0,0,0
KOR,Korea,GNQ,Equatorial Guinea,2016,1,2,-1
KOR,Korea,GNQ,Equatorial Guinea,2017,2,1,1
LUX,Luxembourg,GNQ,Equatorial Guinea,2008,0,0,0
LUX,Luxembourg,GNQ,Equatorial Guinea,2009,0,0,0
LUX,Luxembourg,GNQ,Equatorial Guinea,2010,0,1,-1
LUX,Luxembourg,GNQ,Equatorial Guinea,2011,0,0,0
LUX,Luxembourg,GNQ,Equatorial Guinea,2012,0,0,0
LUX,Luxembourg,GNQ,Equatorial Guinea,2013,0,0,0
LUX,Luxembourg,GNQ,Equatorial Guinea,2014,0,0,0
LUX,Luxembourg,GNQ,Equatorial Guinea,2015,0,0,0
LUX,Luxembourg,GNQ,Equatorial Guinea,2016,0,1,-1
LUX,Luxembourg,GNQ,Equatorial Guinea,2017,1,0,1
MEX,Mexico,GNQ,Equatorial Guinea,2010,0,2,-2
MEX,Mexico,GNQ,Equatorial Guinea,2011,0,2,-2
MEX,Mexico,GNQ,Equatorial Guinea,2012,0,0,0
MEX,Mexico,GNQ,Equatorial Guinea,2013,0,2,-2
MEX,Mexico,GNQ,Equatorial Guinea,2014,0,0,0
MEX,Mexico,GNQ,Equatorial Guinea,2015,0,2,-2
MEX,Mexico,GNQ,Equatorial Guinea,2016,0,3,-3
MEX,Mexico,GNQ,Equatorial Guinea,2017,0,3,-3
NLD,Netherlands,GNQ,Equatorial Guinea,2008,0,0,0
NLD,Netherlands,GNQ,Equatorial Guinea,2009,0,2,-2
NLD,Netherlands,GNQ,Equatorial Guinea,2014,0,3,-3
NOR,Norway,GNQ,Equatorial Guinea,2008,0,0,0
NOR,Norway,GNQ,Equatorial Guinea,2009,0,1,-1
NOR,Norway,GNQ,Equatorial Guinea,2010,0,0,0
NOR,Norway,GNQ,Equatorial Guinea,2011,0,0,0
NOR,Norway,GNQ,Equatorial Guinea,2012,1,1,0
NOR,Norway,GNQ,Equatorial Guinea,2013,0,1,-1
NOR,Norway,GNQ,Equatorial Guinea,2014,0,0,0
NOR,Norway,GNQ,Equatorial Guinea,2015,0,0,0
NOR,Norway,GNQ,Equatorial Guinea,2016,0,0,0
NOR,Norway,GNQ,Equatorial Guinea,2017,0,0,0
POL,Poland,GNQ,Equatorial Guinea,2009,0,0,0
POL,Poland,GNQ,Equatorial Guinea,2010,0,0,0
POL,Poland,GNQ,Equatorial Guinea,2011,0,2,-2
POL,Poland,GNQ,Equatorial Guinea,2012,0,3,-3
POL,Poland,GNQ,Equatorial Guinea,2013,0,5,-5
POL,Poland,GNQ,Equatorial Guinea,2014,0,1,-1
POL,Poland,GNQ,Equatorial Guinea,2015,0,0,0
POL,Poland,GNQ,Equatorial Guinea,2016,0,2,-2
POL,Poland,GNQ,Equatorial Guinea,2017,0,1,-1
SVK,Slovak Republic,GNQ,Equatorial Guinea,2008,0,0,0
SVK,Slovak Republic,GNQ,Equatorial Guinea,2010,1,1,0
ESP,Spain,GNQ,Equatorial Guinea,2008,1465,2177,-712
ESP,Spain,GNQ,Equatorial Guinea,2009,1691,1463,228
ESP,Spain,GNQ,Equatorial Guinea,2010,1863,1320,543
ESP,Spain,GNQ,Equatorial Guinea,2011,1904,1185,719
ESP,Spain,GNQ,Equatorial Guinea,2012,1482,1070,412
ESP,Spain,GNQ,Equatorial Guinea,2013,1784,1053,731
ESP,Spain,GNQ,Equatorial Guinea,2014,1035,1220,-185
ESP,Spain,GNQ,Equatorial Guinea,2015,673,1506,-833
ESP,Spain,GNQ,Equatorial Guinea,2016,805,1691,-886
ESP,Spain,GNQ,Equatorial Guinea,2017,1235,1696,-461
SWE,Sweden,GNQ,Equatorial Guinea,2008,0,0,0
SWE,Sweden,GNQ,Equatorial Guinea,2009,0,0,0
SWE,Sweden,GNQ,Equatorial Guinea,2010,1,2,-1
SWE,Sweden,GNQ,Equatorial Guinea,2011,0,8,-8
SWE,Sweden,GNQ,Equatorial Guinea,2012,0,0,0
SWE,Sweden,GNQ,Equatorial Guinea,2013,0,1,-1
SWE,Sweden,GNQ,Equatorial Guinea,2014,2,1,1
SWE,Sweden,GNQ,Equatorial Guinea,2015,2,4,-2
SWE,Sweden,GNQ,Equatorial Guinea,2016,0,2,-2
SWE,Sweden,GNQ,Equatorial Guinea,2017,0,1,-1
CHE,Switzerland,GNQ,Equatorial Guinea,2010,1,0,1
CHE,Switzerland,GNQ,Equatorial Guinea,2011,1,6,-5
CHE,Switzerland,GNQ,Equatorial Guinea,2012,0,3,-3
CHE,Switzerland,GNQ,Equatorial Guinea,2013,0,0,0
CHE,Switzerland,GNQ,Equatorial Guinea,2014,0,3,-3
CHE,Switzerland,GNQ,Equatorial Guinea,2015,0,3,-3
CHE,Switzerland,GNQ,Equatorial Guinea,2016,0,3,-3
CHE,Switzerland,GNQ,Equatorial Guinea,2017,1,3,-2
USA,United States,GNQ,Equatorial Guinea,2008,0,16,-16
USA,United States,GNQ,Equatorial Guinea,2009,0,32,-32
USA,United States,GNQ,Equatorial Guinea,2010,0,12,-12
USA,United States,GNQ,Equatorial Guinea,2011,0,13,-13
USA,United States,GNQ,Equatorial Guinea,2012,0,20,-20
USA,United States,GNQ,Equatorial Guinea,2013,0,18,-18
USA,United States,GNQ,Equatorial Guinea,2014,0,15,-15
USA,United States,GNQ,Equatorial Guinea,2015,0,25,-25
USA,United States,GNQ,Equatorial Guinea,2016,0,18,-18
USA,United States,GNQ,Equatorial Guinea,2017,0,20,-20
CHL,Chile,GNQ,Equatorial Guinea,2008,0,0,0
CHL,Chile,GNQ,Equatorial Guinea,2009,0,0,0
CHL,Chile,GNQ,Equatorial Guinea,2010,0,0,0
CHL,Chile,GNQ,Equatorial Guinea,2011,0,1,-1
CHL,Chile,GNQ,Equatorial Guinea,2012,0,0,0
CHL,Chile,GNQ,Equatorial Guinea,2013,0,0,0
CHL,Chile,GNQ,Equatorial Guinea,2014,0,1,-1
CHL,Chile,GNQ,Equatorial Guinea,2015,0,0,0
CHL,Chile,GNQ,Equatorial Guinea,2016,0,0,0
EST,Estonia,GNQ,Equatorial Guinea,2008,0,0,0
EST,Estonia,GNQ,Equatorial Guinea,2009,0,0,0
EST,Estonia,GNQ,Equatorial Guinea,2010,0,0,0
EST,Estonia,GNQ,Equatorial Guinea,2011,0,0,0
EST,Estonia,GNQ,Equatorial Guinea,2012,0,0,0
EST,Estonia,GNQ,Equatorial Guinea,2013,0,0,0
EST,Estonia,GNQ,Equatorial Guinea,2014,0,0,0
EST,Estonia,GNQ,Equatorial Guinea,2015,0,0,0
EST,Estonia,GNQ,Equatorial Guinea,2016,0,0,0
EST,Estonia,GNQ,Equatorial Guinea,2017,0,0,0
SVN,Slovenia,GNQ,Equatorial Guinea,2017,0,1,-1
AUS,Australia,ERI,Eritrea,2008,16,220,-204
AUS,Australia,ERI,Eritrea,2009,13,224,-211
AUS,Australia,ERI,Eritrea,2010,22,198,-176
AUS,Australia,ERI,Eritrea,2011,15,205,-190
AUS,Australia,ERI,Eritrea,2012,23,420,-397
AUS,Australia,ERI,Eritrea,2013,17,177,-160
AUS,Australia,ERI,Eritrea,2014,16,370,-354
AUS,Australia,ERI,Eritrea,2015,0,517,-517
AUS,Australia,ERI,Eritrea,2016,0,395,-395
AUS,Australia,ERI,Eritrea,2017,0,474,-474
AUT,Austria,ERI,Eritrea,2008,2,12,-10
AUT,Austria,ERI,Eritrea,2009,4,17,-13
AUT,Austria,ERI,Eritrea,2010,7,8,-1
AUT,Austria,ERI,Eritrea,2011,3,19,-16
AUT,Austria,ERI,Eritrea,2012,6,14,-8
AUT,Austria,ERI,Eritrea,2013,4,48,-44
AUT,Austria,ERI,Eritrea,2014,15,97,-82
AUT,Austria,ERI,Eritrea,2015,29,71,-42
AUT,Austria,ERI,Eritrea,2016,22,73,-51
AUT,Austria,ERI,Eritrea,2017,31,49,-18
BEL,Belgium,ERI,Eritrea,2008,0,9,-9
BEL,Belgium,ERI,Eritrea,2009,0,9,-9
BEL,Belgium,ERI,Eritrea,2010,3,16,-13
BEL,Belgium,ERI,Eritrea,2012,26,99,-73
BEL,Belgium,ERI,Eritrea,2013,27,71,-44
BEL,Belgium,ERI,Eritrea,2014,33,733,-700
BEL,Belgium,ERI,Eritrea,2015,36,329,-293
BEL,Belgium,ERI,Eritrea,2016,25,305,-280
BEL,Belgium,ERI,Eritrea,2017,22,604,-582
CAN,Canada,ERI,Eritrea,2008,0,797,-797
CAN,Canada,ERI,Eritrea,2009,0,903,-903
CAN,Canada,ERI,Eritrea,2010,0,931,-931
CAN,Canada,ERI,Eritrea,2011,0,1182,-1182
CAN,Canada,ERI,Eritrea,2012,0,1335,-1335
CAN,Canada,ERI,Eritrea,2013,0,1719,-1719
CAN,Canada,ERI,Eritrea,2014,0,1974,-1974
CAN,Canada,ERI,Eritrea,2015,0,2171,-2171
CAN,Canada,ERI,Eritrea,2016,0,4630,-4630
CAN,Canada,ERI,Eritrea,2017,0,4680,-4680
CZE,Czech Republic,ERI,Eritrea,2012,0,5,-5
CZE,Czech Republic,ERI,Eritrea,2014,3,1,2
CZE,Czech Republic,ERI,Eritrea,2015,0,1,-1
CZE,Czech Republic,ERI,Eritrea,2016,0,5,-5
CZE,Czech Republic,ERI,Eritrea,2017,0,2,-2
DNK,Denmark,ERI,Eritrea,2008,0,4,-4
DNK,Denmark,ERI,Eritrea,2009,1,7,-6
DNK,Denmark,ERI,Eritrea,2010,1,23,-22
DNK,Denmark,ERI,Eritrea,2011,1,40,-39
DNK,Denmark,ERI,Eritrea,2012,1,32,-31
DNK,Denmark,ERI,Eritrea,2013,3,87,-84
DNK,Denmark,ERI,Eritrea,2014,0,235,-235
DNK,Denmark,ERI,Eritrea,2015,5,2838,-2833
DNK,Denmark,ERI,Eritrea,2016,15,985,-970
DNK,Denmark,ERI,Eritrea,2017,56,1000,-944
FIN,Finland,ERI,Eritrea,2008,0,4,-4
FIN,Finland,ERI,Eritrea,2009,2,13,-11
FIN,Finland,ERI,Eritrea,2010,0,10,-10
FIN,Finland,ERI,Eritrea,2011,1,19,-18
FIN,Finland,ERI,Eritrea,2012,0,15,-15
FIN,Finland,ERI,Eritrea,2013,0,50,-50
FIN,Finland,ERI,Eritrea,2014,0,9,-9
FIN,Finland,ERI,Eritrea,2015,1,14,-13
FIN,Finland,ERI,Eritrea,2016,0,268,-268
FIN,Finland,ERI,Eritrea,2017,0,262,-262
FRA,France,ERI,Eritrea,2008,0,64,-64
FRA,France,ERI,Eritrea,2009,0,133,-133
FRA,France,ERI,Eritrea,2010,0,251,-251
FRA,France,ERI,Eritrea,2011,0,349,-349
FRA,France,ERI,Eritrea,2012,0,282,-282
FRA,France,ERI,Eritrea,2013,0,199,-199
FRA,France,ERI,Eritrea,2014,0,169,-169
FRA,France,ERI,Eritrea,2015,0,397,-397
FRA,France,ERI,Eritrea,2016,0,513,-513
FRA,France,ERI,Eritrea,2017,0,869,-869
DEU,Germany,ERI,Eritrea,2008,285,464,-179
DEU,Germany,ERI,Eritrea,2009,252,649,-397
DEU,Germany,ERI,Eritrea,2010,294,868,-574
DEU,Germany,ERI,Eritrea,2011,253,933,-680
DEU,Germany,ERI,Eritrea,2012,289,833,-544
DEU,Germany,ERI,Eritrea,2013,389,3942,-3553
DEU,Germany,ERI,Eritrea,2014,868,14372,-13504
DEU,Germany,ERI,Eritrea,2015,1900,17796,-15896
DEU,Germany,ERI,Eritrea,2016,3285,12910,-9625
DEU,Germany,ERI,Eritrea,2017,2656,8409,-5753
HUN,Hungary,ERI,Eritrea,2008,0,5,-5
HUN,Hungary,ERI,Eritrea,2009,1,0,1
HUN,Hungary,ERI,Eritrea,2010,0,2,-2
HUN,Hungary,ERI,Eritrea,2011,0,5,-5
HUN,Hungary,ERI,Eritrea,2012,0,4,-4
HUN,Hungary,ERI,Eritrea,2013,0,1,-1
HUN,Hungary,ERI,Eritrea,2014,0,25,-25
HUN,Hungary,ERI,Eritrea,2015,0,9,-9
HUN,Hungary,ERI,Eritrea,2016,0,3,-3
HUN,Hungary,ERI,Eritrea,2017,0,3,-3
ISL,Iceland,ERI,Eritrea,2008,1,2,-1
ISL,Iceland,ERI,Eritrea,2009,0,1,-1
ISL,Iceland,ERI,Eritrea,2010,1,1,0
ISL,Iceland,ERI,Eritrea,2011,0,0,0
ISL,Iceland,ERI,Eritrea,2012,0,3,-3
ISL,Iceland,ERI,Eritrea,2013,0,3,-3
ISL,Iceland,ERI,Eritrea,2014,4,0,4
ISL,Iceland,ERI,Eritrea,2015,4,4,0
ISL,Iceland,ERI,Eritrea,2016,0,0,0
ISL,Iceland,ERI,Eritrea,2017,0,2,-2
ITA,Italy,ERI,Eritrea,2008,19,1210,-1191
ITA,Italy,ERI,Eritrea,2009,23,1586,-1563
ITA,Italy,ERI,Eritrea,2010,36,1106,-1070
ITA,Italy,ERI,Eritrea,2011,35,641,-606
ITA,Italy,ERI,Eritrea,2012,63,613,-550
ITA,Italy,ERI,Eritrea,2013,25,807,-782
ITA,Italy,ERI,Eritrea,2014,43,901,-858
ITA,Italy,ERI,Eritrea,2015,52,629,-577
ITA,Italy,ERI,Eritrea,2016,0,456,-456
ITA,Italy,ERI,Eritrea,2017,56,538,-482
JPN,Japan,ERI,Eritrea,2008,20,22,-2
JPN,Japan,ERI,Eritrea,2009,15,16,-1
JPN,Japan,ERI,Eritrea,2010,13,17,-4
JPN,Japan,ERI,Eritrea,2011,5,13,-8
JPN,Japan,ERI,Eritrea,2012,7,13,-6
JPN,Japan,ERI,Eritrea,2013,10,9,1
JPN,Japan,ERI,Eritrea,2014,11,14,-3
JPN,Japan,ERI,Eritrea,2015,10,14,-4
JPN,Japan,ERI,Eritrea,2016,6,12,-6
JPN,Japan,ERI,Eritrea,2017,10,21,-11
KOR,Korea,ERI,Eritrea,2008,1,0,1
KOR,Korea,ERI,Eritrea,2009,0,0,0
KOR,Korea,ERI,Eritrea,2010,0,0,0
KOR,Korea,ERI,Eritrea,2011,0,2,-2
KOR,Korea,ERI,Eritrea,2012,2,3,-1
KOR,Korea,ERI,Eritrea,2013,2,2,0
KOR,Korea,ERI,Eritrea,2014,3,1,2
KOR,Korea,ERI,Eritrea,2015,2,3,-1
KOR,Korea,ERI,Eritrea,2016,2,4,-2
KOR,Korea,ERI,Eritrea,2017,1,7,-6
LUX,Luxembourg,ERI,Eritrea,2008,0,4,-4
LUX,Luxembourg,ERI,Eritrea,2009,1,9,-8
LUX,Luxembourg,ERI,Eritrea,2010,4,11,-7
LUX,Luxembourg,ERI,Eritrea,2011,4,12,-8
LUX,Luxembourg,ERI,Eritrea,2012,0,10,-10
LUX,Luxembourg,ERI,Eritrea,2013,3,4,-1
LUX,Luxembourg,ERI,Eritrea,2014,1,39,-38
LUX,Luxembourg,ERI,Eritrea,2015,1,35,-34
LUX,Luxembourg,ERI,Eritrea,2016,5,98,-93
LUX,Luxembourg,ERI,Eritrea,2017,8,214,-206
MEX,Mexico,ERI,Eritrea,2012,0,1,-1
MEX,Mexico,ERI,Eritrea,2013,0,2,-2
MEX,Mexico,ERI,Eritrea,2014,0,0,0
MEX,Mexico,ERI,Eritrea,2015,0,1,-1
NLD,Netherlands,ERI,Eritrea,2008,23,31,-8
NLD,Netherlands,ERI,Eritrea,2009,14,41,-27
NLD,Netherlands,ERI,Eritrea,2010,18,43,-25
NLD,Netherlands,ERI,Eritrea,2011,17,53,-36
NLD,Netherlands,ERI,Eritrea,2012,19,41,-22
NLD,Netherlands,ERI,Eritrea,2013,15,76,-61
NLD,Netherlands,ERI,Eritrea,2014,19,2850,-2831
NLD,Netherlands,ERI,Eritrea,2015,37,5706,-5669
NLD,Netherlands,ERI,Eritrea,2016,37,5945,-5908
NLD,Netherlands,ERI,Eritrea,2017,100,4676,-4576
NZL,New Zealand,ERI,Eritrea,2008,0,123,-123
NZL,New Zealand,ERI,Eritrea,2009,0,27,-27
NZL,New Zealand,ERI,Eritrea,2010,1,17,-16
NZL,New Zealand,ERI,Eritrea,2011,0,3,-3
NZL,New Zealand,ERI,Eritrea,2012,1,16,-15
NZL,New Zealand,ERI,Eritrea,2013,0,27,-27
NZL,New Zealand,ERI,Eritrea,2014,0,29,-29
NZL,New Zealand,ERI,Eritrea,2015,1,14,-13
NZL,New Zealand,ERI,Eritrea,2016,0,15,-15
NZL,New Zealand,ERI,Eritrea,2017,0,5,-5
NOR,Norway,ERI,Eritrea,2008,8,778,-770
NOR,Norway,ERI,Eritrea,2009,16,1670,-1654
NOR,Norway,ERI,Eritrea,2010,21,1987,-1966
NOR,Norway,ERI,Eritrea,2011,46,1974,-1928
NOR,Norway,ERI,Eritrea,2012,58,2366,-2308
NOR,Norway,ERI,Eritrea,2013,73,2729,-2656
NOR,Norway,ERI,Eritrea,2014,85,2819,-2734
NOR,Norway,ERI,Eritrea,2015,93,3276,-3183
NOR,Norway,ERI,Eritrea,2016,92,2702,-2610
NOR,Norway,ERI,Eritrea,2017,85,2098,-2013
POL,Poland,ERI,Eritrea,2009,0,0,0
POL,Poland,ERI,Eritrea,2010,0,0,0
POL,Poland,ERI,Eritrea,2011,0,3,-3
POL,Poland,ERI,Eritrea,2012,0,0,0
POL,Poland,ERI,Eritrea,2013,0,1,-1
POL,Poland,ERI,Eritrea,2014,0,1,-1
POL,Poland,ERI,Eritrea,2015,0,1,-1
POL,Poland,ERI,Eritrea,2016,0,2,-2
POL,Poland,ERI,Eritrea,2017,0,4,-4
SVK,Slovak Republic,ERI,Eritrea,2008,1,0,1
SVK,Slovak Republic,ERI,Eritrea,2010,0,1,-1
SVK,Slovak Republic,ERI,Eritrea,2011,0,1,-1
ESP,Spain,ERI,Eritrea,2008,3,24,-21
ESP,Spain,ERI,Eritrea,2009,11,23,-12
ESP,Spain,ERI,Eritrea,2010,22,14,8
ESP,Spain,ERI,Eritrea,2011,10,6,4
ESP,Spain,ERI,Eritrea,2012,6,29,-23
ESP,Spain,ERI,Eritrea,2013,9,5,4
ESP,Spain,ERI,Eritrea,2014,12,7,5
ESP,Spain,ERI,Eritrea,2015,4,15,-11
ESP,Spain,ERI,Eritrea,2016,0,38,-38
ESP,Spain,ERI,Eritrea,2017,5,126,-121
SWE,Sweden,ERI,Eritrea,2008,16,1170,-1154
SWE,Sweden,ERI,Eritrea,2009,23,1398,-1375
SWE,Sweden,ERI,Eritrea,2010,18,1604,-1586
SWE,Sweden,ERI,Eritrea,2011,29,2128,-2099
SWE,Sweden,ERI,Eritrea,2012,73,2213,-2140
SWE,Sweden,ERI,Eritrea,2013,40,3338,-3298
SWE,Sweden,ERI,Eritrea,2014,70,5880,-5810
SWE,Sweden,ERI,Eritrea,2015,71,7558,-7487
SWE,Sweden,ERI,Eritrea,2016,23,7580,-7557
SWE,Sweden,ERI,Eritrea,2017,56,4752,-4696
CHE,Switzerland,ERI,Eritrea,2010,11,2147,-2136
CHE,Switzerland,ERI,Eritrea,2011,17,2394,-2377
CHE,Switzerland,ERI,Eritrea,2012,31,1129,-1098
CHE,Switzerland,ERI,Eritrea,2013,36,1518,-1482
CHE,Switzerland,ERI,Eritrea,2014,41,1817,-1776
CHE,Switzerland,ERI,Eritrea,2015,27,2171,-2144
CHE,Switzerland,ERI,Eritrea,2016,29,2585,-2556
CHE,Switzerland,ERI,Eritrea,2017,27,2885,-2858
TUR,Turkey,ERI,Eritrea,2010,0,16,-16
TUR,Turkey,ERI,Eritrea,2017,21,181,-160
USA,United States,ERI,Eritrea,2008,0,1270,-1270
USA,United States,ERI,Eritrea,2009,0,1928,-1928
USA,United States,ERI,Eritrea,2010,0,1656,-1656
USA,United States,ERI,Eritrea,2011,0,2102,-2102
USA,United States,ERI,Eritrea,2012,0,2643,-2643
USA,United States,ERI,Eritrea,2013,0,2138,-2138
USA,United States,ERI,Eritrea,2014,0,2002,-2002
USA,United States,ERI,Eritrea,2015,0,2220,-2220
USA,United States,ERI,Eritrea,2016,0,2267,-2267
USA,United States,ERI,Eritrea,2017,0,2449,-2449
CHL,Chile,ERI,Eritrea,2008,0,0,0
CHL,Chile,ERI,Eritrea,2009,0,0,0
CHL,Chile,ERI,Eritrea,2010,0,0,0
CHL,Chile,ERI,Eritrea,2011,0,0,0
CHL,Chile,ERI,Eritrea,2012,0,0,0
CHL,Chile,ERI,Eritrea,2013,0,0,0
CHL,Chile,ERI,Eritrea,2014,0,0,0
CHL,Chile,ERI,Eritrea,2015,0,0,0
CHL,Chile,ERI,Eritrea,2016,0,2,-2
EST,Estonia,ERI,Eritrea,2008,0,0,0
EST,Estonia,ERI,Eritrea,2009,0,0,0
EST,Estonia,ERI,Eritrea,2010,0,0,0
EST,Estonia,ERI,Eritrea,2011,0,0,0
EST,Estonia,ERI,Eritrea,2012,0,0,0
EST,Estonia,ERI,Eritrea,2013,0,0,0
EST,Estonia,ERI,Eritrea,2014,0,0,0
EST,Estonia,ERI,Eritrea,2015,0,0,0
EST,Estonia,ERI,Eritrea,2016,0,0,0
EST,Estonia,ERI,Eritrea,2017,0,0,0
SVN,Slovenia,ERI,Eritrea,2013,0,1,-1
SVN,Slovenia,ERI,Eritrea,2014,0,1,-1
SVN,Slovenia,ERI,Eritrea,2017,0,1,-1
AUS,Australia,ETH,Ethiopia,2008,68,476,-408
AUS,Australia,ETH,Ethiopia,2009,52,716,-664
AUS,Australia,ETH,Ethiopia,2010,50,800,-750
AUS,Australia,ETH,Ethiopia,2011,50,714,-664
AUS,Australia,ETH,Ethiopia,2012,80,781,-701
AUS,Australia,ETH,Ethiopia,2013,52,429,-377
AUS,Australia,ETH,Ethiopia,2014,71,659,-588
AUS,Australia,ETH,Ethiopia,2015,100,740,-640
AUS,Australia,ETH,Ethiopia,2016,100,680,-580
AUS,Australia,ETH,Ethiopia,2017,0,753,-753
AUT,Austria,ETH,Ethiopia,2008,38,98,-60
AUT,Austria,ETH,Ethiopia,2009,59,103,-44
AUT,Austria,ETH,Ethiopia,2010,48,80,-32
AUT,Austria,ETH,Ethiopia,2011,80,63,17
AUT,Austria,ETH,Ethiopia,2012,46,78,-32
AUT,Austria,ETH,Ethiopia,2013,41,63,-22
AUT,Austria,ETH,Ethiopia,2014,50,85,-35
AUT,Austria,ETH,Ethiopia,2015,44,108,-64
AUT,Austria,ETH,Ethiopia,2016,61,125,-64
AUT,Austria,ETH,Ethiopia,2017,50,80,-30
BEL,Belgium,ETH,Ethiopia,2008,0,160,-160
BEL,Belgium,ETH,Ethiopia,2009,0,177,-177
BEL,Belgium,ETH,Ethiopia,2010,100,183,-83
BEL,Belgium,ETH,Ethiopia,2011,0,181,-181
BEL,Belgium,ETH,Ethiopia,2012,149,201,-52
BEL,Belgium,ETH,Ethiopia,2013,136,165,-29
BEL,Belgium,ETH,Ethiopia,2014,138,178,-40
BEL,Belgium,ETH,Ethiopia,2015,125,179,-54
BEL,Belgium,ETH,Ethiopia,2016,119,170,-51
BEL,Belgium,ETH,Ethiopia,2017,87,185,-98
CAN,Canada,ETH,Ethiopia,2008,0,1611,-1611
CAN,Canada,ETH,Ethiopia,2009,0,1287,-1287
CAN,Canada,ETH,Ethiopia,2010,0,1865,-1865
CAN,Canada,ETH,Ethiopia,2011,0,2163,-2163
CAN,Canada,ETH,Ethiopia,2012,0,1859,-1859
CAN,Canada,ETH,Ethiopia,2013,0,1608,-1608
CAN,Canada,ETH,Ethiopia,2014,0,1339,-1339
CAN,Canada,ETH,Ethiopia,2015,0,1365,-1365
CAN,Canada,ETH,Ethiopia,2016,0,1940,-1940
CAN,Canada,ETH,Ethiopia,2017,0,1915,-1915
CZE,Czech Republic,ETH,Ethiopia,2008,1,13,-12
CZE,Czech Republic,ETH,Ethiopia,2009,0,14,-14
CZE,Czech Republic,ETH,Ethiopia,2010,0,21,-21
CZE,Czech Republic,ETH,Ethiopia,2011,0,12,-12
CZE,Czech Republic,ETH,Ethiopia,2012,10,16,-6
CZE,Czech Republic,ETH,Ethiopia,2013,17,10,7
CZE,Czech Republic,ETH,Ethiopia,2014,9,25,-16
CZE,Czech Republic,ETH,Ethiopia,2015,14,16,-2
CZE,Czech Republic,ETH,Ethiopia,2016,13,13,0
CZE,Czech Republic,ETH,Ethiopia,2017,12,20,-8
DNK,Denmark,ETH,Ethiopia,2008,14,82,-68
DNK,Denmark,ETH,Ethiopia,2009,25,102,-77
DNK,Denmark,ETH,Ethiopia,2010,27,60,-33
DNK,Denmark,ETH,Ethiopia,2011,15,80,-65
DNK,Denmark,ETH,Ethiopia,2012,21,90,-69
DNK,Denmark,ETH,Ethiopia,2013,28,80,-52
DNK,Denmark,ETH,Ethiopia,2014,32,69,-37
DNK,Denmark,ETH,Ethiopia,2015,45,100,-55
DNK,Denmark,ETH,Ethiopia,2016,78,81,-3
DNK,Denmark,ETH,Ethiopia,2017,44,72,-28
FIN,Finland,ETH,Ethiopia,2008,7,201,-194
FIN,Finland,ETH,Ethiopia,2009,6,113,-107
FIN,Finland,ETH,Ethiopia,2010,9,69,-60
FIN,Finland,ETH,Ethiopia,2011,6,106,-100
FIN,Finland,ETH,Ethiopia,2012,13,111,-98
FIN,Finland,ETH,Ethiopia,2013,13,98,-85
FIN,Finland,ETH,Ethiopia,2014,11,101,-90
FIN,Finland,ETH,Ethiopia,2015,19,65,-46
FIN,Finland,ETH,Ethiopia,2016,19,118,-99
FIN,Finland,ETH,Ethiopia,2017,16,63,-47
FRA,France,ETH,Ethiopia,2008,0,124,-124
FRA,France,ETH,Ethiopia,2009,0,144,-144
FRA,France,ETH,Ethiopia,2010,0,154,-154
FRA,France,ETH,Ethiopia,2011,0,136,-136
FRA,France,ETH,Ethiopia,2012,0,116,-116
FRA,France,ETH,Ethiopia,2013,0,137,-137
FRA,France,ETH,Ethiopia,2014,0,126,-126
FRA,France,ETH,Ethiopia,2015,0,128,-128
FRA,France,ETH,Ethiopia,2016,0,133,-133
FRA,France,ETH,Ethiopia,2017,0,373,-373
DEU,Germany,ETH,Ethiopia,2008,596,719,-123
DEU,Germany,ETH,Ethiopia,2009,634,789,-155
DEU,Germany,ETH,Ethiopia,2010,570,931,-361
DEU,Germany,ETH,Ethiopia,2011,436,1051,-615
DEU,Germany,ETH,Ethiopia,2012,497,1124,-627
DEU,Germany,ETH,Ethiopia,2013,580,1337,-757
DEU,Germany,ETH,Ethiopia,2014,688,1782,-1094
DEU,Germany,ETH,Ethiopia,2015,723,3341,-2618
DEU,Germany,ETH,Ethiopia,2016,1152,3101,-1949
DEU,Germany,ETH,Ethiopia,2017,1276,1511,-235
HUN,Hungary,ETH,Ethiopia,2008,2,22,-20
HUN,Hungary,ETH,Ethiopia,2009,2,24,-22
HUN,Hungary,ETH,Ethiopia,2010,0,29,-29
HUN,Hungary,ETH,Ethiopia,2011,7,15,-8
HUN,Hungary,ETH,Ethiopia,2012,1,34,-33
HUN,Hungary,ETH,Ethiopia,2013,0,8,-8
HUN,Hungary,ETH,Ethiopia,2014,6,20,-14
HUN,Hungary,ETH,Ethiopia,2015,1,18,-17
HUN,Hungary,ETH,Ethiopia,2016,2,42,-40
HUN,Hungary,ETH,Ethiopia,2017,0,46,-46
ISL,Iceland,ETH,Ethiopia,2008,5,10,-5
ISL,Iceland,ETH,Ethiopia,2009,9,4,5
ISL,Iceland,ETH,Ethiopia,2010,7,8,-1
ISL,Iceland,ETH,Ethiopia,2011,4,5,-1
ISL,Iceland,ETH,Ethiopia,2012,1,7,-6
ISL,Iceland,ETH,Ethiopia,2013,3,6,-3
ISL,Iceland,ETH,Ethiopia,2014,11,10,1
ISL,Iceland,ETH,Ethiopia,2015,4,6,-2
ISL,Iceland,ETH,Ethiopia,2016,3,8,-5
ISL,Iceland,ETH,Ethiopia,2017,7,10,-3
ITA,Italy,ETH,Ethiopia,2008,17,1009,-992
ITA,Italy,ETH,Ethiopia,2009,20,978,-958
ITA,Italy,ETH,Ethiopia,2010,33,830,-797
ITA,Italy,ETH,Ethiopia,2011,18,749,-731
ITA,Italy,ETH,Ethiopia,2012,53,837,-784
ITA,Italy,ETH,Ethiopia,2013,43,691,-648
ITA,Italy,ETH,Ethiopia,2014,54,541,-487
ITA,Italy,ETH,Ethiopia,2015,42,418,-376
ITA,Italy,ETH,Ethiopia,2016,0,352,-352
ITA,Italy,ETH,Ethiopia,2017,30,450,-420
JPN,Japan,ETH,Ethiopia,2008,125,155,-30
JPN,Japan,ETH,Ethiopia,2009,109,145,-36
JPN,Japan,ETH,Ethiopia,2010,176,190,-14
JPN,Japan,ETH,Ethiopia,2011,188,191,-3
JPN,Japan,ETH,Ethiopia,2012,217,246,-29
JPN,Japan,ETH,Ethiopia,2013,250,262,-12
JPN,Japan,ETH,Ethiopia,2014,203,253,-50
JPN,Japan,ETH,Ethiopia,2015,205,297,-92
JPN,Japan,ETH,Ethiopia,2016,223,238,-15
JPN,Japan,ETH,Ethiopia,2017,224,252,-28
KOR,Korea,ETH,Ethiopia,2008,17,34,-17
KOR,Korea,ETH,Ethiopia,2009,23,25,-2
KOR,Korea,ETH,Ethiopia,2010,30,52,-22
KOR,Korea,ETH,Ethiopia,2011,36,86,-50
KOR,Korea,ETH,Ethiopia,2012,54,170,-116
KOR,Korea,ETH,Ethiopia,2013,83,171,-88
KOR,Korea,ETH,Ethiopia,2014,91,130,-39
KOR,Korea,ETH,Ethiopia,2015,116,159,-43
KOR,Korea,ETH,Ethiopia,2016,92,206,-114
KOR,Korea,ETH,Ethiopia,2017,125,215,-90
LUX,Luxembourg,ETH,Ethiopia,2008,3,10,-7
LUX,Luxembourg,ETH,Ethiopia,2009,2,9,-7
LUX,Luxembourg,ETH,Ethiopia,2010,6,8,-2
LUX,Luxembourg,ETH,Ethiopia,2011,3,9,-6
LUX,Luxembourg,ETH,Ethiopia,2012,5,7,-2
LUX,Luxembourg,ETH,Ethiopia,2013,3,4,-1
LUX,Luxembourg,ETH,Ethiopia,2014,0,19,-19
LUX,Luxembourg,ETH,Ethiopia,2015,5,23,-18
LUX,Luxembourg,ETH,Ethiopia,2016,4,18,-14
LUX,Luxembourg,ETH,Ethiopia,2017,7,18,-11
MEX,Mexico,ETH,Ethiopia,2009,0,1,-1
MEX,Mexico,ETH,Ethiopia,2010,0,2,-2
MEX,Mexico,ETH,Ethiopia,2011,0,2,-2
MEX,Mexico,ETH,Ethiopia,2012,0,0,0
MEX,Mexico,ETH,Ethiopia,2013,0,2,-2
MEX,Mexico,ETH,Ethiopia,2014,0,2,-2
MEX,Mexico,ETH,Ethiopia,2015,0,2,-2
MEX,Mexico,ETH,Ethiopia,2016,0,2,-2
MEX,Mexico,ETH,Ethiopia,2017,0,1,-1
NLD,Netherlands,ETH,Ethiopia,2008,177,266,-89
NLD,Netherlands,ETH,Ethiopia,2009,122,274,-152
NLD,Netherlands,ETH,Ethiopia,2010,261,281,-20
NLD,Netherlands,ETH,Ethiopia,2011,198,237,-39
NLD,Netherlands,ETH,Ethiopia,2012,146,248,-102
NLD,Netherlands,ETH,Ethiopia,2013,281,244,37
NLD,Netherlands,ETH,Ethiopia,2014,184,230,-46
NLD,Netherlands,ETH,Ethiopia,2015,195,263,-68
NLD,Netherlands,ETH,Ethiopia,2016,217,358,-141
NLD,Netherlands,ETH,Ethiopia,2017,198,243,-45
NZL,New Zealand,ETH,Ethiopia,2008,1,70,-69
NZL,New Zealand,ETH,Ethiopia,2009,2,42,-40
NZL,New Zealand,ETH,Ethiopia,2010,0,73,-73
NZL,New Zealand,ETH,Ethiopia,2011,1,48,-47
NZL,New Zealand,ETH,Ethiopia,2012,1,73,-72
NZL,New Zealand,ETH,Ethiopia,2013,3,49,-46
NZL,New Zealand,ETH,Ethiopia,2014,3,56,-53
NZL,New Zealand,ETH,Ethiopia,2015,3,61,-58
NZL,New Zealand,ETH,Ethiopia,2016,5,37,-32
NZL,New Zealand,ETH,Ethiopia,2017,4,29,-25
NOR,Norway,ETH,Ethiopia,2008,64,425,-361
NOR,Norway,ETH,Ethiopia,2009,99,631,-532
NOR,Norway,ETH,Ethiopia,2010,91,479,-388
NOR,Norway,ETH,Ethiopia,2011,150,508,-358
NOR,Norway,ETH,Ethiopia,2012,98,540,-442
NOR,Norway,ETH,Ethiopia,2013,114,582,-468
NOR,Norway,ETH,Ethiopia,2014,100,544,-444
NOR,Norway,ETH,Ethiopia,2015,123,675,-552
NOR,Norway,ETH,Ethiopia,2016,126,568,-442
NOR,Norway,ETH,Ethiopia,2017,73,435,-362
POL,Poland,ETH,Ethiopia,2009,0,25,-25
POL,Poland,ETH,Ethiopia,2010,0,28,-28
POL,Poland,ETH,Ethiopia,2011,0,28,-28
POL,Poland,ETH,Ethiopia,2012,0,20,-20
POL,Poland,ETH,Ethiopia,2013,0,25,-25
POL,Poland,ETH,Ethiopia,2014,0,9,-9
POL,Poland,ETH,Ethiopia,2015,0,15,-15
POL,Poland,ETH,Ethiopia,2016,0,18,-18
POL,Poland,ETH,Ethiopia,2017,0,12,-12
SVK,Slovak Republic,ETH,Ethiopia,2008,0,1,-1
SVK,Slovak Republic,ETH,Ethiopia,2009,0,1,-1
SVK,Slovak Republic,ETH,Ethiopia,2010,1,1,0
SVK,Slovak Republic,ETH,Ethiopia,2011,0,2,-2
SVK,Slovak Republic,ETH,Ethiopia,2013,0,1,-1
ESP,Spain,ETH,Ethiopia,2008,30,276,-246
ESP,Spain,ETH,Ethiopia,2009,35,354,-319
ESP,Spain,ETH,Ethiopia,2010,46,245,-199
ESP,Spain,ETH,Ethiopia,2011,78,220,-142
ESP,Spain,ETH,Ethiopia,2012,32,190,-158
ESP,Spain,ETH,Ethiopia,2013,60,141,-81
ESP,Spain,ETH,Ethiopia,2014,57,98,-41
ESP,Spain,ETH,Ethiopia,2015,37,102,-65
ESP,Spain,ETH,Ethiopia,2016,20,62,-42
ESP,Spain,ETH,Ethiopia,2017,61,70,-9
SWE,Sweden,ETH,Ethiopia,2008,48,518,-470
SWE,Sweden,ETH,Ethiopia,2009,16,795,-779
SWE,Sweden,ETH,Ethiopia,2010,72,958,-886
SWE,Sweden,ETH,Ethiopia,2011,69,654,-585
SWE,Sweden,ETH,Ethiopia,2012,128,662,-534
SWE,Sweden,ETH,Ethiopia,2013,80,597,-517
SWE,Sweden,ETH,Ethiopia,2014,148,774,-626
SWE,Sweden,ETH,Ethiopia,2015,236,731,-495
SWE,Sweden,ETH,Ethiopia,2016,65,1260,-1195
SWE,Sweden,ETH,Ethiopia,2017,60,1518,-1458
CHE,Switzerland,ETH,Ethiopia,2010,28,322,-294
CHE,Switzerland,ETH,Ethiopia,2011,21,260,-239
CHE,Switzerland,ETH,Ethiopia,2012,23,237,-214
CHE,Switzerland,ETH,Ethiopia,2013,22,224,-202
CHE,Switzerland,ETH,Ethiopia,2014,31,206,-175
CHE,Switzerland,ETH,Ethiopia,2015,24,211,-187
CHE,Switzerland,ETH,Ethiopia,2016,28,198,-170
CHE,Switzerland,ETH,Ethiopia,2017,26,223,-197
TUR,Turkey,ETH,Ethiopia,2010,0,31,-31
TUR,Turkey,ETH,Ethiopia,2016,242,494,-252
TUR,Turkey,ETH,Ethiopia,2017,311,551,-240
GBR,United Kingdom,ETH,Ethiopia,2011,0,1000,-1000
USA,United States,ETH,Ethiopia,2008,0,12917,-12917
USA,United States,ETH,Ethiopia,2009,0,15462,-15462
USA,United States,ETH,Ethiopia,2010,0,14266,-14266
USA,United States,ETH,Ethiopia,2011,0,13793,-13793
USA,United States,ETH,Ethiopia,2012,0,14544,-14544
USA,United States,ETH,Ethiopia,2013,0,13097,-13097
USA,United States,ETH,Ethiopia,2014,0,12300,-12300
USA,United States,ETH,Ethiopia,2015,0,11394,-11394
USA,United States,ETH,Ethiopia,2016,0,13232,-13232
USA,United States,ETH,Ethiopia,2017,0,14637,-14637
CHL,Chile,ETH,Ethiopia,2008,0,1,-1
CHL,Chile,ETH,Ethiopia,2009,0,0,0
CHL,Chile,ETH,Ethiopia,2010,0,0,0
CHL,Chile,ETH,Ethiopia,2011,0,1,-1
CHL,Chile,ETH,Ethiopia,2012,0,0,0
CHL,Chile,ETH,Ethiopia,2013,0,4,-4
CHL,Chile,ETH,Ethiopia,2014,0,0,0
CHL,Chile,ETH,Ethiopia,2015,0,0,0
CHL,Chile,ETH,Ethiopia,2016,0,2,-2
EST,Estonia,ETH,Ethiopia,2008,0,2,-2
EST,Estonia,ETH,Ethiopia,2009,0,0,0
EST,Estonia,ETH,Ethiopia,2010,0,3,-3
EST,Estonia,ETH,Ethiopia,2011,0,1,-1
EST,Estonia,ETH,Ethiopia,2012,0,0,0
EST,Estonia,ETH,Ethiopia,2013,0,0,0
EST,Estonia,ETH,Ethiopia,2014,0,1,-1
EST,Estonia,ETH,Ethiopia,2015,0,2,-2
EST,Estonia,ETH,Ethiopia,2016,0,1,-1
EST,Estonia,ETH,Ethiopia,2017,0,3,-3
ISR,Israel,ETH,Ethiopia,2008,0,1582,-1582
ISR,Israel,ETH,Ethiopia,2009,0,239,-239
ISR,Israel,ETH,Ethiopia,2010,0,1655,-1655
ISR,Israel,ETH,Ethiopia,2011,0,2666,-2666
ISR,Israel,ETH,Ethiopia,2012,0,2432,-2432
ISR,Israel,ETH,Ethiopia,2013,0,1355,-1355
ISR,Israel,ETH,Ethiopia,2014,0,211,-211
ISR,Israel,ETH,Ethiopia,2015,0,91,-91
ISR,Israel,ETH,Ethiopia,2016,0,40,-40
ISR,Israel,ETH,Ethiopia,2017,0,37,-37
SVN,Slovenia,ETH,Ethiopia,2008,0,1,-1
SVN,Slovenia,ETH,Ethiopia,2009,0,8,-8
SVN,Slovenia,ETH,Ethiopia,2010,0,3,-3
SVN,Slovenia,ETH,Ethiopia,2011,1,1,0
SVN,Slovenia,ETH,Ethiopia,2012,0,3,-3
SVN,Slovenia,ETH,Ethiopia,2013,0,3,-3
SVN,Slovenia,ETH,Ethiopia,2014,0,2,-2
SVN,Slovenia,ETH,Ethiopia,2015,0,2,-2
SVN,Slovenia,ETH,Ethiopia,2016,0,1,-1
SVN,Slovenia,ETH,Ethiopia,2017,0,8,-8
AUS,Australia,FJI,Fiji,2008,247,1841,-1594
AUS,Australia,FJI,Fiji,2009,212,1863,-1651
AUS,Australia,FJI,Fiji,2010,212,1492,-1280
AUS,Australia,FJI,Fiji,2011,190,1351,-1161
AUS,Australia,FJI,Fiji,2012,184,1446,-1262
AUS,Australia,FJI,Fiji,2013,204,1223,-1019
AUS,Australia,FJI,Fiji,2014,216,1279,-1063
AUS,Australia,FJI,Fiji,2015,200,996,-796
AUS,Australia,FJI,Fiji,2016,200,904,-704
AUS,Australia,FJI,Fiji,2017,0,768,-768
AUT,Austria,FJI,Fiji,2008,1,3,-2
AUT,Austria,FJI,Fiji,2009,2,0,2
AUT,Austria,FJI,Fiji,2010,0,5,-5
AUT,Austria,FJI,Fiji,2011,0,1,-1
AUT,Austria,FJI,Fiji,2012,3,5,-2
AUT,Austria,FJI,Fiji,2013,0,0,0
AUT,Austria,FJI,Fiji,2014,1,1,0
AUT,Austria,FJI,Fiji,2015,2,1,1
AUT,Austria,FJI,Fiji,2016,0,7,-7
AUT,Austria,FJI,Fiji,2017,3,1,2
BEL,Belgium,FJI,Fiji,2008,0,2,-2
BEL,Belgium,FJI,Fiji,2009,0,3,-3
BEL,Belgium,FJI,Fiji,2010,0,3,-3
BEL,Belgium,FJI,Fiji,2012,0,3,-3
BEL,Belgium,FJI,Fiji,2013,4,3,1
BEL,Belgium,FJI,Fiji,2014,1,1,0
BEL,Belgium,FJI,Fiji,2015,3,4,-1
BEL,Belgium,FJI,Fiji,2016,5,2,3
BEL,Belgium,FJI,Fiji,2017,0,2,-2
CAN,Canada,FJI,Fiji,2008,0,321,-321
CAN,Canada,FJI,Fiji,2009,0,311,-311
CAN,Canada,FJI,Fiji,2010,0,398,-398
CAN,Canada,FJI,Fiji,2011,0,316,-316
CAN,Canada,FJI,Fiji,2012,0,270,-270
CAN,Canada,FJI,Fiji,2013,0,228,-228
CAN,Canada,FJI,Fiji,2014,0,254,-254
CAN,Canada,FJI,Fiji,2015,0,222,-222
CAN,Canada,FJI,Fiji,2016,0,190,-190
CAN,Canada,FJI,Fiji,2017,0,155,-155
CZE,Czech Republic,FJI,Fiji,2009,0,1,-1
CZE,Czech Republic,FJI,Fiji,2012,0,1,-1
CZE,Czech Republic,FJI,Fiji,2014,0,1,-1
CZE,Czech Republic,FJI,Fiji,2015,0,1,-1
DNK,Denmark,FJI,Fiji,2008,0,0,0
DNK,Denmark,FJI,Fiji,2009,1,0,1
DNK,Denmark,FJI,Fiji,2010,0,1,-1
DNK,Denmark,FJI,Fiji,2012,0,0,0
DNK,Denmark,FJI,Fiji,2013,2,2,0
DNK,Denmark,FJI,Fiji,2014,2,1,1
DNK,Denmark,FJI,Fiji,2015,0,4,-4
DNK,Denmark,FJI,Fiji,2016,0,1,-1
DNK,Denmark,FJI,Fiji,2017,0,3,-3
FIN,Finland,FJI,Fiji,2008,0,0,0
FIN,Finland,FJI,Fiji,2009,0,0,0
FIN,Finland,FJI,Fiji,2010,0,0,0
FIN,Finland,FJI,Fiji,2011,0,0,0
FIN,Finland,FJI,Fiji,2012,0,0,0
FIN,Finland,FJI,Fiji,2013,0,0,0
FIN,Finland,FJI,Fiji,2014,0,1,-1
FIN,Finland,FJI,Fiji,2015,0,1,-1
FIN,Finland,FJI,Fiji,2016,0,0,0
FIN,Finland,FJI,Fiji,2017,0,0,0
FRA,France,FJI,Fiji,2008,0,13,-13
FRA,France,FJI,Fiji,2009,0,27,-27
FRA,France,FJI,Fiji,2010,0,24,-24
FRA,France,FJI,Fiji,2011,0,27,-27
FRA,France,FJI,Fiji,2012,0,15,-15
FRA,France,FJI,Fiji,2013,0,18,-18
FRA,France,FJI,Fiji,2014,0,34,-34
FRA,France,FJI,Fiji,2015,0,47,-47
FRA,France,FJI,Fiji,2016,0,45,-45
FRA,France,FJI,Fiji,2017,0,31,-31
DEU,Germany,FJI,Fiji,2008,10,14,-4
DEU,Germany,FJI,Fiji,2009,12,30,-18
DEU,Germany,FJI,Fiji,2010,27,28,-1
DEU,Germany,FJI,Fiji,2011,10,32,-22
DEU,Germany,FJI,Fiji,2012,10,23,-13
DEU,Germany,FJI,Fiji,2013,20,21,-1
DEU,Germany,FJI,Fiji,2014,16,19,-3
DEU,Germany,FJI,Fiji,2015,40,22,18
DEU,Germany,FJI,Fiji,2016,10,12,-2
DEU,Germany,FJI,Fiji,2017,8,6,2
HUN,Hungary,FJI,Fiji,2008,0,1,-1
HUN,Hungary,FJI,Fiji,2009,0,0,0
HUN,Hungary,FJI,Fiji,2010,0,0,0
HUN,Hungary,FJI,Fiji,2011,0,0,0
HUN,Hungary,FJI,Fiji,2012,0,0,0
HUN,Hungary,FJI,Fiji,2013,0,0,0
HUN,Hungary,FJI,Fiji,2014,0,1,-1
HUN,Hungary,FJI,Fiji,2015,0,1,-1
HUN,Hungary,FJI,Fiji,2016,0,1,-1
HUN,Hungary,FJI,Fiji,2017,0,0,0
ISL,Iceland,FJI,Fiji,2008,0,0,0
ISL,Iceland,FJI,Fiji,2009,1,2,-1
ISL,Iceland,FJI,Fiji,2010,1,0,1
ISL,Iceland,FJI,Fiji,2011,0,0,0
ISL,Iceland,FJI,Fiji,2012,0,0,0
ISL,Iceland,FJI,Fiji,2013,0,0,0
ISL,Iceland,FJI,Fiji,2014,0,0,0
ISL,Iceland,FJI,Fiji,2015,0,0,0
ISL,Iceland,FJI,Fiji,2016,0,0,0
ISL,Iceland,FJI,Fiji,2017,0,0,0
ITA,Italy,FJI,Fiji,2008,0,3,-3
ITA,Italy,FJI,Fiji,2009,0,1,-1
ITA,Italy,FJI,Fiji,2010,3,4,-1
ITA,Italy,FJI,Fiji,2011,1,4,-3
ITA,Italy,FJI,Fiji,2012,0,0,0
ITA,Italy,FJI,Fiji,2013,0,8,-8
ITA,Italy,FJI,Fiji,2014,2,2,0
ITA,Italy,FJI,Fiji,2015,0,0,0
ITA,Italy,FJI,Fiji,2016,0,1,-1
JPN,Japan,FJI,Fiji,2008,90,104,-14
JPN,Japan,FJI,Fiji,2009,100,122,-22
JPN,Japan,FJI,Fiji,2010,98,111,-13
JPN,Japan,FJI,Fiji,2011,108,129,-21
JPN,Japan,FJI,Fiji,2012,155,154,1
JPN,Japan,FJI,Fiji,2013,113,141,-28
JPN,Japan,FJI,Fiji,2014,141,152,-11
JPN,Japan,FJI,Fiji,2015,159,167,-8
JPN,Japan,FJI,Fiji,2016,154,185,-31
JPN,Japan,FJI,Fiji,2017,167,198,-31
KOR,Korea,FJI,Fiji,2008,13,17,-4
KOR,Korea,FJI,Fiji,2009,11,21,-10
KOR,Korea,FJI,Fiji,2010,11,32,-21
KOR,Korea,FJI,Fiji,2011,17,22,-5
KOR,Korea,FJI,Fiji,2012,32,28,4
KOR,Korea,FJI,Fiji,2013,21,24,-3
KOR,Korea,FJI,Fiji,2014,12,19,-7
KOR,Korea,FJI,Fiji,2015,17,16,1
KOR,Korea,FJI,Fiji,2016,15,15,0
KOR,Korea,FJI,Fiji,2017,23,26,-3
LUX,Luxembourg,FJI,Fiji,2008,0,0,0
LUX,Luxembourg,FJI,Fiji,2009,0,0,0
LUX,Luxembourg,FJI,Fiji,2010,0,0,0
LUX,Luxembourg,FJI,Fiji,2011,0,0,0
LUX,Luxembourg,FJI,Fiji,2012,0,0,0
LUX,Luxembourg,FJI,Fiji,2013,0,0,0
LUX,Luxembourg,FJI,Fiji,2014,0,0,0
LUX,Luxembourg,FJI,Fiji,2015,0,0,0
LUX,Luxembourg,FJI,Fiji,2016,0,0,0
LUX,Luxembourg,FJI,Fiji,2017,0,0,0
MEX,Mexico,FJI,Fiji,2012,0,0,0
MEX,Mexico,FJI,Fiji,2013,0,0,0
MEX,Mexico,FJI,Fiji,2014,0,0,0
MEX,Mexico,FJI,Fiji,2015,0,1,-1
MEX,Mexico,FJI,Fiji,2016,0,2,-2
MEX,Mexico,FJI,Fiji,2017,0,1,-1
NLD,Netherlands,FJI,Fiji,2008,2,2,0
NLD,Netherlands,FJI,Fiji,2009,-1,1,-2
NLD,Netherlands,FJI,Fiji,2011,0,1,-1
NLD,Netherlands,FJI,Fiji,2012,4,8,-4
NLD,Netherlands,FJI,Fiji,2013,1,1,0
NLD,Netherlands,FJI,Fiji,2014,2,3,-1
NLD,Netherlands,FJI,Fiji,2015,2,3,-1
NLD,Netherlands,FJI,Fiji,2016,2,3,-1
NLD,Netherlands,FJI,Fiji,2017,-4,0,-4
NZL,New Zealand,FJI,Fiji,2008,315,3059,-2744
NZL,New Zealand,FJI,Fiji,2009,576,2717,-2141
NZL,New Zealand,FJI,Fiji,2010,724,1290,-566
NZL,New Zealand,FJI,Fiji,2011,607,1057,-450
NZL,New Zealand,FJI,Fiji,2012,470,1206,-736
NZL,New Zealand,FJI,Fiji,2013,392,1198,-806
NZL,New Zealand,FJI,Fiji,2014,332,1345,-1013
NZL,New Zealand,FJI,Fiji,2015,339,1407,-1068
NZL,New Zealand,FJI,Fiji,2016,292,1903,-1611
NZL,New Zealand,FJI,Fiji,2017,355,1685,-1330
NOR,Norway,FJI,Fiji,2008,0,7,-7
NOR,Norway,FJI,Fiji,2009,0,1,-1
NOR,Norway,FJI,Fiji,2010,2,1,1
NOR,Norway,FJI,Fiji,2011,1,0,1
NOR,Norway,FJI,Fiji,2012,0,2,-2
NOR,Norway,FJI,Fiji,2013,1,1,0
NOR,Norway,FJI,Fiji,2014,1,0,1
NOR,Norway,FJI,Fiji,2015,0,1,-1
NOR,Norway,FJI,Fiji,2016,1,0,1
NOR,Norway,FJI,Fiji,2017,0,0,0
POL,Poland,FJI,Fiji,2009,0,0,0
POL,Poland,FJI,Fiji,2010,0,0,0
POL,Poland,FJI,Fiji,2011,0,0,0
POL,Poland,FJI,Fiji,2012,0,0,0
POL,Poland,FJI,Fiji,2013,0,0,0
POL,Poland,FJI,Fiji,2014,0,0,0
POL,Poland,FJI,Fiji,2015,0,0,0
POL,Poland,FJI,Fiji,2016,0,1,-1
POL,Poland,FJI,Fiji,2017,0,1,-1
SVK,Slovak Republic,FJI,Fiji,2008,0,0,0
ESP,Spain,FJI,Fiji,2008,0,6,-6
ESP,Spain,FJI,Fiji,2009,2,0,2
ESP,Spain,FJI,Fiji,2010,3,0,3
ESP,Spain,FJI,Fiji,2011,0,0,0
ESP,Spain,FJI,Fiji,2012,0,1,-1
ESP,Spain,FJI,Fiji,2013,0,0,0
ESP,Spain,FJI,Fiji,2014,0,0,0
ESP,Spain,FJI,Fiji,2015,1,2,-1
ESP,Spain,FJI,Fiji,2016,0,3,-3
ESP,Spain,FJI,Fiji,2017,0,3,-3
SWE,Sweden,FJI,Fiji,2008,0,2,-2
SWE,Sweden,FJI,Fiji,2009,0,5,-5
SWE,Sweden,FJI,Fiji,2010,0,2,-2
SWE,Sweden,FJI,Fiji,2011,0,1,-1
SWE,Sweden,FJI,Fiji,2012,0,0,0
SWE,Sweden,FJI,Fiji,2013,0,1,-1
SWE,Sweden,FJI,Fiji,2014,1,1,0
SWE,Sweden,FJI,Fiji,2015,2,1,1
SWE,Sweden,FJI,Fiji,2016,0,3,-3
SWE,Sweden,FJI,Fiji,2017,0,0,0
CHE,Switzerland,FJI,Fiji,2010,0,2,-2
CHE,Switzerland,FJI,Fiji,2011,3,2,1
CHE,Switzerland,FJI,Fiji,2012,1,5,-4
CHE,Switzerland,FJI,Fiji,2013,1,5,-4
CHE,Switzerland,FJI,Fiji,2014,1,1,0
CHE,Switzerland,FJI,Fiji,2015,0,2,-2
CHE,Switzerland,FJI,Fiji,2016,3,4,-1
CHE,Switzerland,FJI,Fiji,2017,3,6,-3
USA,United States,FJI,Fiji,2008,0,1176,-1176
USA,United States,FJI,Fiji,2009,0,1194,-1194
USA,United States,FJI,Fiji,2010,0,1201,-1201
USA,United States,FJI,Fiji,2011,0,1041,-1041
USA,United States,FJI,Fiji,2012,0,853,-853
USA,United States,FJI,Fiji,2013,0,895,-895
USA,United States,FJI,Fiji,2014,0,802,-802
USA,United States,FJI,Fiji,2015,0,875,-875
USA,United States,FJI,Fiji,2016,0,866,-866
USA,United States,FJI,Fiji,2017,0,805,-805
CHL,Chile,FJI,Fiji,2008,0,0,0
CHL,Chile,FJI,Fiji,2009,0,2,-2
CHL,Chile,FJI,Fiji,2010,0,0,0
CHL,Chile,FJI,Fiji,2011,0,0,0
CHL,Chile,FJI,Fiji,2012,0,0,0
CHL,Chile,FJI,Fiji,2013,0,0,0
CHL,Chile,FJI,Fiji,2014,0,0,0
CHL,Chile,FJI,Fiji,2015,0,1,-1
CHL,Chile,FJI,Fiji,2016,0,0,0
EST,Estonia,FJI,Fiji,2008,0,0,0
EST,Estonia,FJI,Fiji,2009,0,0,0
EST,Estonia,FJI,Fiji,2010,0,0,0
EST,Estonia,FJI,Fiji,2011,0,0,0
EST,Estonia,FJI,Fiji,2012,0,0,0
EST,Estonia,FJI,Fiji,2013,0,0,0
EST,Estonia,FJI,Fiji,2014,0,0,0
EST,Estonia,FJI,Fiji,2015,0,0,0
EST,Estonia,FJI,Fiji,2016,0,0,0
EST,Estonia,FJI,Fiji,2017,0,0,0
SVN,Slovenia,FJI,Fiji,2013,0,7,-7
AUS,Australia,GAB,Gabon,2008,0,6,-6
AUS,Australia,GAB,Gabon,2009,0,0,0
AUS,Australia,GAB,Gabon,2010,0,0,0
AUS,Australia,GAB,Gabon,2011,0,0,0
AUS,Australia,GAB,Gabon,2012,0,0,0
AUS,Australia,GAB,Gabon,2013,0,1,-1
AUS,Australia,GAB,Gabon,2014,0,0,0
AUS,Australia,GAB,Gabon,2015,0,0,0
AUS,Australia,GAB,Gabon,2017,0,3,-3
AUT,Austria,GAB,Gabon,2008,0,1,-1
AUT,Austria,GAB,Gabon,2009,4,8,-4
AUT,Austria,GAB,Gabon,2010,4,8,-4
AUT,Austria,GAB,Gabon,2011,3,7,-4
AUT,Austria,GAB,Gabon,2012,3,6,-3
AUT,Austria,GAB,Gabon,2013,2,5,-3
AUT,Austria,GAB,Gabon,2014,3,5,-2
AUT,Austria,GAB,Gabon,2015,8,9,-1
AUT,Austria,GAB,Gabon,2016,2,9,-7
AUT,Austria,GAB,Gabon,2017,5,2,3
BEL,Belgium,GAB,Gabon,2008,0,39,-39
BEL,Belgium,GAB,Gabon,2009,0,38,-38
BEL,Belgium,GAB,Gabon,2010,33,27,6
BEL,Belgium,GAB,Gabon,2012,20,26,-6
BEL,Belgium,GAB,Gabon,2013,26,32,-6
BEL,Belgium,GAB,Gabon,2014,21,33,-12
BEL,Belgium,GAB,Gabon,2015,20,45,-25
BEL,Belgium,GAB,Gabon,2016,9,50,-41
BEL,Belgium,GAB,Gabon,2017,8,47,-39
CAN,Canada,GAB,Gabon,2008,0,86,-86
CAN,Canada,GAB,Gabon,2009,0,86,-86
CAN,Canada,GAB,Gabon,2010,0,64,-64
CAN,Canada,GAB,Gabon,2011,0,63,-63
CAN,Canada,GAB,Gabon,2012,0,74,-74
CAN,Canada,GAB,Gabon,2013,0,90,-90
CAN,Canada,GAB,Gabon,2014,0,68,-68
CAN,Canada,GAB,Gabon,2015,0,57,-57
CAN,Canada,GAB,Gabon,2016,0,50,-50
CAN,Canada,GAB,Gabon,2017,0,45,-45
CZE,Czech Republic,GAB,Gabon,2012,0,1,-1
CZE,Czech Republic,GAB,Gabon,2014,0,3,-3
DNK,Denmark,GAB,Gabon,2008,1,2,-1
DNK,Denmark,GAB,Gabon,2009,0,0,0
DNK,Denmark,GAB,Gabon,2010,1,2,-1
DNK,Denmark,GAB,Gabon,2012,1,0,1
DNK,Denmark,GAB,Gabon,2013,0,0,0
DNK,Denmark,GAB,Gabon,2014,0,1,-1
DNK,Denmark,GAB,Gabon,2015,0,0,0
DNK,Denmark,GAB,Gabon,2016,0,0,0
DNK,Denmark,GAB,Gabon,2017,0,1,-1
FIN,Finland,GAB,Gabon,2008,0,0,0
FIN,Finland,GAB,Gabon,2009,0,0,0
FIN,Finland,GAB,Gabon,2010,0,0,0
FIN,Finland,GAB,Gabon,2011,0,1,-1
FIN,Finland,GAB,Gabon,2012,0,0,0
FIN,Finland,GAB,Gabon,2013,0,0,0
FIN,Finland,GAB,Gabon,2014,0,0,0
FIN,Finland,GAB,Gabon,2015,0,1,-1
FIN,Finland,GAB,Gabon,2016,0,0,0
FIN,Finland,GAB,Gabon,2017,0,1,-1
FRA,France,GAB,Gabon,2008,0,648,-648
FRA,France,GAB,Gabon,2009,0,656,-656
FRA,France,GAB,Gabon,2010,0,712,-712
FRA,France,GAB,Gabon,2011,0,693,-693
FRA,France,GAB,Gabon,2012,0,754,-754
FRA,France,GAB,Gabon,2013,0,773,-773
FRA,France,GAB,Gabon,2014,0,795,-795
FRA,France,GAB,Gabon,2015,0,519,-519
FRA,France,GAB,Gabon,2016,0,576,-576
FRA,France,GAB,Gabon,2017,0,682,-682
DEU,Germany,GAB,Gabon,2008,47,51,-4
DEU,Germany,GAB,Gabon,2009,43,80,-37
DEU,Germany,GAB,Gabon,2010,34,38,-4
DEU,Germany,GAB,Gabon,2011,38,33,5
DEU,Germany,GAB,Gabon,2012,42,32,10
DEU,Germany,GAB,Gabon,2013,31,38,-7
DEU,Germany,GAB,Gabon,2014,36,37,-1
DEU,Germany,GAB,Gabon,2015,33,61,-28
DEU,Germany,GAB,Gabon,2016,44,70,-26
DEU,Germany,GAB,Gabon,2017,30,66,-36
HUN,Hungary,GAB,Gabon,2008,0,1,-1
HUN,Hungary,GAB,Gabon,2009,1,1,0
HUN,Hungary,GAB,Gabon,2010,1,0,1
HUN,Hungary,GAB,Gabon,2011,0,2,-2
HUN,Hungary,GAB,Gabon,2012,1,0,1
HUN,Hungary,GAB,Gabon,2013,0,0,0
HUN,Hungary,GAB,Gabon,2014,0,6,-6
HUN,Hungary,GAB,Gabon,2015,1,5,-4
HUN,Hungary,GAB,Gabon,2016,0,2,-2
HUN,Hungary,GAB,Gabon,2017,0,2,-2
ISL,Iceland,GAB,Gabon,2008,0,0,0
ISL,Iceland,GAB,Gabon,2009,0,1,-1
ISL,Iceland,GAB,Gabon,2010,0,0,0
ISL,Iceland,GAB,Gabon,2011,0,0,0
ISL,Iceland,GAB,Gabon,2012,0,1,-1
ISL,Iceland,GAB,Gabon,2016,0,0,0
ISL,Iceland,GAB,Gabon,2017,1,1,0
ITA,Italy,GAB,Gabon,2008,0,14,-14
ITA,Italy,GAB,Gabon,2009,0,25,-25
ITA,Italy,GAB,Gabon,2010,1,28,-27
ITA,Italy,GAB,Gabon,2011,1,9,-8
ITA,Italy,GAB,Gabon,2012,0,41,-41
ITA,Italy,GAB,Gabon,2013,0,41,-41
ITA,Italy,GAB,Gabon,2014,0,20,-20
ITA,Italy,GAB,Gabon,2015,2,58,-56
ITA,Italy,GAB,Gabon,2016,0,42,-42
ITA,Italy,GAB,Gabon,2017,0,60,-60
JPN,Japan,GAB,Gabon,2008,146,148,-2
JPN,Japan,GAB,Gabon,2009,33,31,2
JPN,Japan,GAB,Gabon,2010,89,93,-4
JPN,Japan,GAB,Gabon,2011,46,41,5
JPN,Japan,GAB,Gabon,2012,64,66,-2
JPN,Japan,GAB,Gabon,2013,129,132,-3
JPN,Japan,GAB,Gabon,2014,36,35,1
JPN,Japan,GAB,Gabon,2015,60,73,-13
JPN,Japan,GAB,Gabon,2016,31,35,-4
JPN,Japan,GAB,Gabon,2017,35,39,-4
KOR,Korea,GAB,Gabon,2008,5,14,-9
KOR,Korea,GAB,Gabon,2009,10,14,-4
KOR,Korea,GAB,Gabon,2010,7,19,-12
KOR,Korea,GAB,Gabon,2011,11,28,-17
KOR,Korea,GAB,Gabon,2012,17,16,1
KOR,Korea,GAB,Gabon,2013,9,13,-4
KOR,Korea,GAB,Gabon,2014,6,11,-5
KOR,Korea,GAB,Gabon,2015,11,11,0
KOR,Korea,GAB,Gabon,2016,12,15,-3
KOR,Korea,GAB,Gabon,2017,13,10,3
LUX,Luxembourg,GAB,Gabon,2008,0,3,-3
LUX,Luxembourg,GAB,Gabon,2009,1,2,-1
LUX,Luxembourg,GAB,Gabon,2010,0,0,0
LUX,Luxembourg,GAB,Gabon,2011,1,3,-2
LUX,Luxembourg,GAB,Gabon,2012,0,1,-1
LUX,Luxembourg,GAB,Gabon,2013,0,1,-1
LUX,Luxembourg,GAB,Gabon,2014,0,3,-3
LUX,Luxembourg,GAB,Gabon,2015,1,3,-2
LUX,Luxembourg,GAB,Gabon,2016,2,18,-16
LUX,Luxembourg,GAB,Gabon,2017,7,7,0
MEX,Mexico,GAB,Gabon,2012,0,0,0
MEX,Mexico,GAB,Gabon,2013,0,1,-1
MEX,Mexico,GAB,Gabon,2014,0,0,0
MEX,Mexico,GAB,Gabon,2016,0,1,-1
NLD,Netherlands,GAB,Gabon,2008,11,4,7
NLD,Netherlands,GAB,Gabon,2009,7,3,4
NLD,Netherlands,GAB,Gabon,2010,10,13,-3
NLD,Netherlands,GAB,Gabon,2011,2,1,1
NLD,Netherlands,GAB,Gabon,2012,2,1,1
NLD,Netherlands,GAB,Gabon,2013,5,7,-2
NLD,Netherlands,GAB,Gabon,2014,9,9,0
NLD,Netherlands,GAB,Gabon,2015,10,9,1
NLD,Netherlands,GAB,Gabon,2016,2,7,-5
NLD,Netherlands,GAB,Gabon,2017,7,2,5
NZL,New Zealand,GAB,Gabon,2010,0,1,-1
NZL,New Zealand,GAB,Gabon,2011,0,0,0
NOR,Norway,GAB,Gabon,2008,0,0,0
NOR,Norway,GAB,Gabon,2009,1,0,1
NOR,Norway,GAB,Gabon,2010,0,0,0
NOR,Norway,GAB,Gabon,2011,0,0,0
NOR,Norway,GAB,Gabon,2012,1,6,-5
NOR,Norway,GAB,Gabon,2013,1,3,-2
NOR,Norway,GAB,Gabon,2014,7,2,5
NOR,Norway,GAB,Gabon,2015,0,1,-1
NOR,Norway,GAB,Gabon,2016,1,2,-1
NOR,Norway,GAB,Gabon,2017,0,0,0
POL,Poland,GAB,Gabon,2009,0,1,-1
POL,Poland,GAB,Gabon,2010,0,1,-1
POL,Poland,GAB,Gabon,2011,0,0,0
POL,Poland,GAB,Gabon,2012,0,0,0
POL,Poland,GAB,Gabon,2013,0,1,-1
POL,Poland,GAB,Gabon,2014,0,2,-2
POL,Poland,GAB,Gabon,2015,0,0,0
POL,Poland,GAB,Gabon,2016,0,2,-2
POL,Poland,GAB,Gabon,2017,0,2,-2
SVK,Slovak Republic,GAB,Gabon,2008,0,0,0
ESP,Spain,GAB,Gabon,2008,13,17,-4
ESP,Spain,GAB,Gabon,2009,15,18,-3
ESP,Spain,GAB,Gabon,2010,16,49,-33
ESP,Spain,GAB,Gabon,2011,19,14,5
ESP,Spain,GAB,Gabon,2012,9,28,-19
ESP,Spain,GAB,Gabon,2013,19,23,-4
ESP,Spain,GAB,Gabon,2014,9,37,-28
ESP,Spain,GAB,Gabon,2015,12,29,-17
ESP,Spain,GAB,Gabon,2016,8,27,-19
ESP,Spain,GAB,Gabon,2017,26,27,-1
SWE,Sweden,GAB,Gabon,2008,0,3,-3
SWE,Sweden,GAB,Gabon,2009,0,0,0
SWE,Sweden,GAB,Gabon,2010,0,1,-1
SWE,Sweden,GAB,Gabon,2011,0,4,-4
SWE,Sweden,GAB,Gabon,2012,1,2,-1
SWE,Sweden,GAB,Gabon,2013,1,2,-1
SWE,Sweden,GAB,Gabon,2014,2,1,1
SWE,Sweden,GAB,Gabon,2015,0,1,-1
SWE,Sweden,GAB,Gabon,2016,0,2,-2
SWE,Sweden,GAB,Gabon,2017,0,3,-3
CHE,Switzerland,GAB,Gabon,2010,2,13,-11
CHE,Switzerland,GAB,Gabon,2011,9,24,-15
CHE,Switzerland,GAB,Gabon,2012,6,17,-11
CHE,Switzerland,GAB,Gabon,2013,13,27,-14
CHE,Switzerland,GAB,Gabon,2014,5,10,-5
CHE,Switzerland,GAB,Gabon,2015,15,15,0
CHE,Switzerland,GAB,Gabon,2016,7,14,-7
CHE,Switzerland,GAB,Gabon,2017,5,6,-1
USA,United States,GAB,Gabon,2008,0,82,-82
USA,United States,GAB,Gabon,2009,0,171,-171
USA,United States,GAB,Gabon,2010,0,138,-138
USA,United States,GAB,Gabon,2011,0,204,-204
USA,United States,GAB,Gabon,2012,0,197,-197
USA,United States,GAB,Gabon,2013,0,127,-127
USA,United States,GAB,Gabon,2014,0,167,-167
USA,United States,GAB,Gabon,2015,0,146,-146
USA,United States,GAB,Gabon,2016,0,165,-165
USA,United States,GAB,Gabon,2017,0,150,-150
CHL,Chile,GAB,Gabon,2008,0,1,-1
CHL,Chile,GAB,Gabon,2009,0,0,0
CHL,Chile,GAB,Gabon,2010,0,0,0
CHL,Chile,GAB,Gabon,2011,0,0,0
CHL,Chile,GAB,Gabon,2012,0,0,0
CHL,Chile,GAB,Gabon,2013,0,0,0
CHL,Chile,GAB,Gabon,2014,0,0,0
CHL,Chile,GAB,Gabon,2015,0,0,0
CHL,Chile,GAB,Gabon,2016,0,0,0
EST,Estonia,GAB,Gabon,2008,0,0,0
EST,Estonia,GAB,Gabon,2009,0,0,0
EST,Estonia,GAB,Gabon,2010,0,0,0
EST,Estonia,GAB,Gabon,2011,0,0,0
EST,Estonia,GAB,Gabon,2012,0,0,0
EST,Estonia,GAB,Gabon,2013,0,0,0
EST,Estonia,GAB,Gabon,2014,0,0,0
EST,Estonia,GAB,Gabon,2015,0,0,0
EST,Estonia,GAB,Gabon,2016,0,0,0
EST,Estonia,GAB,Gabon,2017,0,0,0
SVN,Slovenia,GAB,Gabon,2016,0,1,-1
AUS,Australia,GMB,Gambia,2008,0,4,-4
AUS,Australia,GMB,Gambia,2009,0,0,0
AUS,Australia,GMB,Gambia,2010,0,6,-6
AUS,Australia,GMB,Gambia,2011,0,1,-1
AUS,Australia,GMB,Gambia,2012,0,1,-1
AUS,Australia,GMB,Gambia,2013,0,3,-3
AUS,Australia,GMB,Gambia,2014,0,0,0
AUS,Australia,GMB,Gambia,2015,0,12,-12
AUS,Australia,GMB,Gambia,2017,0,0,0
AUT,Austria,GMB,Gambia,2008,118,109,9
AUT,Austria,GMB,Gambia,2009,141,155,-14
AUT,Austria,GMB,Gambia,2010,127,121,6
AUT,Austria,GMB,Gambia,2011,125,96,29
AUT,Austria,GMB,Gambia,2012,96,103,-7
AUT,Austria,GMB,Gambia,2013,73,110,-37
AUT,Austria,GMB,Gambia,2014,69,140,-71
AUT,Austria,GMB,Gambia,2015,83,192,-109
AUT,Austria,GMB,Gambia,2016,178,280,-102
AUT,Austria,GMB,Gambia,2017,164,134,30
BEL,Belgium,GMB,Gambia,2008,0,35,-35
BEL,Belgium,GMB,Gambia,2009,0,38,-38
BEL,Belgium,GMB,Gambia,2010,6,26,-20
BEL,Belgium,GMB,Gambia,2012,53,87,-34
BEL,Belgium,GMB,Gambia,2013,48,111,-63
BEL,Belgium,GMB,Gambia,2014,43,64,-21
BEL,Belgium,GMB,Gambia,2015,43,94,-51
BEL,Belgium,GMB,Gambia,2016,18,74,-56
BEL,Belgium,GMB,Gambia,2017,17,65,-48
CAN,Canada,GMB,Gambia,2008,0,25,-25
CAN,Canada,GMB,Gambia,2009,0,10,-10
CAN,Canada,GMB,Gambia,2010,0,37,-37
CAN,Canada,GMB,Gambia,2011,0,24,-24
CAN,Canada,GMB,Gambia,2012,0,18,-18
CAN,Canada,GMB,Gambia,2013,0,33,-33
CAN,Canada,GMB,Gambia,2014,0,36,-36
CAN,Canada,GMB,Gambia,2015,0,42,-42
CAN,Canada,GMB,Gambia,2016,0,50,-50
CAN,Canada,GMB,Gambia,2017,0,60,-60
CZE,Czech Republic,GMB,Gambia,2008,0,2,-2
CZE,Czech Republic,GMB,Gambia,2010,0,1,-1
CZE,Czech Republic,GMB,Gambia,2011,0,1,-1
CZE,Czech Republic,GMB,Gambia,2012,0,2,-2
CZE,Czech Republic,GMB,Gambia,2013,1,2,-1
CZE,Czech Republic,GMB,Gambia,2014,0,2,-2
CZE,Czech Republic,GMB,Gambia,2015,0,5,-5
CZE,Czech Republic,GMB,Gambia,2016,0,5,-5
DNK,Denmark,GMB,Gambia,2008,2,24,-22
DNK,Denmark,GMB,Gambia,2009,4,22,-18
DNK,Denmark,GMB,Gambia,2010,12,29,-17
DNK,Denmark,GMB,Gambia,2011,2,27,-25
DNK,Denmark,GMB,Gambia,2012,9,13,-4
DNK,Denmark,GMB,Gambia,2013,6,22,-16
DNK,Denmark,GMB,Gambia,2014,2,32,-30
DNK,Denmark,GMB,Gambia,2015,4,22,-18
DNK,Denmark,GMB,Gambia,2016,3,16,-13
DNK,Denmark,GMB,Gambia,2017,8,16,-8
FIN,Finland,GMB,Gambia,2008,5,52,-47
FIN,Finland,GMB,Gambia,2009,4,45,-41
FIN,Finland,GMB,Gambia,2010,3,46,-43
FIN,Finland,GMB,Gambia,2011,1,56,-55
FIN,Finland,GMB,Gambia,2012,4,48,-44
FIN,Finland,GMB,Gambia,2013,3,50,-47
FIN,Finland,GMB,Gambia,2014,7,88,-81
FIN,Finland,GMB,Gambia,2015,2,45,-43
FIN,Finland,GMB,Gambia,2016,6,67,-61
FIN,Finland,GMB,Gambia,2017,7,57,-50
FRA,France,GMB,Gambia,2008,0,104,-104
FRA,France,GMB,Gambia,2009,0,89,-89
FRA,France,GMB,Gambia,2010,0,101,-101
FRA,France,GMB,Gambia,2011,0,104,-104
FRA,France,GMB,Gambia,2012,0,118,-118
FRA,France,GMB,Gambia,2013,0,118,-118
FRA,France,GMB,Gambia,2014,0,142,-142
FRA,France,GMB,Gambia,2015,0,134,-134
FRA,France,GMB,Gambia,2016,0,132,-132
FRA,France,GMB,Gambia,2017,0,195,-195
DEU,Germany,GMB,Gambia,2008,201,337,-136
DEU,Germany,GMB,Gambia,2009,201,349,-148
DEU,Germany,GMB,Gambia,2010,232,387,-155
DEU,Germany,GMB,Gambia,2011,251,400,-149
DEU,Germany,GMB,Gambia,2012,271,592,-321
DEU,Germany,GMB,Gambia,2013,261,1029,-768
DEU,Germany,GMB,Gambia,2014,502,2441,-1939
DEU,Germany,GMB,Gambia,2015,917,5484,-4567
DEU,Germany,GMB,Gambia,2016,1846,5608,-3762
DEU,Germany,GMB,Gambia,2017,2132,3436,-1304
HUN,Hungary,GMB,Gambia,2008,0,1,-1
HUN,Hungary,GMB,Gambia,2009,0,3,-3
HUN,Hungary,GMB,Gambia,2010,0,1,-1
HUN,Hungary,GMB,Gambia,2011,0,1,-1
HUN,Hungary,GMB,Gambia,2012,0,1,-1
HUN,Hungary,GMB,Gambia,2013,1,0,1
HUN,Hungary,GMB,Gambia,2014,1,5,-4
HUN,Hungary,GMB,Gambia,2015,0,1,-1
HUN,Hungary,GMB,Gambia,2016,0,3,-3
HUN,Hungary,GMB,Gambia,2017,0,3,-3
ISL,Iceland,GMB,Gambia,2008,0,1,-1
ISL,Iceland,GMB,Gambia,2009,0,0,0
ISL,Iceland,GMB,Gambia,2010,0,1,-1
ISL,Iceland,GMB,Gambia,2011,1,2,-1
ISL,Iceland,GMB,Gambia,2012,0,2,-2
ISL,Iceland,GMB,Gambia,2013,1,2,-1
ISL,Iceland,GMB,Gambia,2014,2,3,-1
ISL,Iceland,GMB,Gambia,2015,0,1,-1
ISL,Iceland,GMB,Gambia,2016,0,3,-3
ISL,Iceland,GMB,Gambia,2017,2,1,1
ITA,Italy,GMB,Gambia,2008,3,72,-69
ITA,Italy,GMB,Gambia,2009,5,114,-109
ITA,Italy,GMB,Gambia,2010,2,153,-151
ITA,Italy,GMB,Gambia,2011,2,130,-128
ITA,Italy,GMB,Gambia,2012,3,273,-270
ITA,Italy,GMB,Gambia,2013,6,373,-367
ITA,Italy,GMB,Gambia,2014,9,1653,-1644
ITA,Italy,GMB,Gambia,2015,28,5108,-5080
ITA,Italy,GMB,Gambia,2016,0,6624,-6624
ITA,Italy,GMB,Gambia,2017,96,8688,-8592
JPN,Japan,GMB,Gambia,2008,38,37,1
JPN,Japan,GMB,Gambia,2009,12,12,0
JPN,Japan,GMB,Gambia,2010,26,27,-1
JPN,Japan,GMB,Gambia,2011,19,19,0
JPN,Japan,GMB,Gambia,2012,20,20,0
JPN,Japan,GMB,Gambia,2013,18,70,-52
JPN,Japan,GMB,Gambia,2014,17,17,0
JPN,Japan,GMB,Gambia,2015,23,24,-1
JPN,Japan,GMB,Gambia,2016,13,26,-13
JPN,Japan,GMB,Gambia,2017,14,20,-6
KOR,Korea,GMB,Gambia,2008,1,1,0
KOR,Korea,GMB,Gambia,2009,1,1,0
KOR,Korea,GMB,Gambia,2010,1,5,-4
KOR,Korea,GMB,Gambia,2011,0,0,0
KOR,Korea,GMB,Gambia,2012,4,5,-1
KOR,Korea,GMB,Gambia,2013,3,7,-4
KOR,Korea,GMB,Gambia,2014,2,9,-7
KOR,Korea,GMB,Gambia,2015,3,21,-18
KOR,Korea,GMB,Gambia,2016,9,18,-9
KOR,Korea,GMB,Gambia,2017,6,45,-39
LUX,Luxembourg,GMB,Gambia,2008,6,5,1
LUX,Luxembourg,GMB,Gambia,2009,2,5,-3
LUX,Luxembourg,GMB,Gambia,2010,3,3,0
LUX,Luxembourg,GMB,Gambia,2011,1,5,-4
LUX,Luxembourg,GMB,Gambia,2012,2,13,-11
LUX,Luxembourg,GMB,Gambia,2013,0,4,-4
LUX,Luxembourg,GMB,Gambia,2014,4,8,-4
LUX,Luxembourg,GMB,Gambia,2015,4,8,-4
LUX,Luxembourg,GMB,Gambia,2016,4,13,-9
LUX,Luxembourg,GMB,Gambia,2017,3,7,-4
MEX,Mexico,GMB,Gambia,2011,0,1,-1
MEX,Mexico,GMB,Gambia,2012,0,0,0
MEX,Mexico,GMB,Gambia,2013,0,0,0
MEX,Mexico,GMB,Gambia,2014,0,0,0
MEX,Mexico,GMB,Gambia,2017,0,3,-3
NLD,Netherlands,GMB,Gambia,2008,14,43,-29
NLD,Netherlands,GMB,Gambia,2009,8,41,-33
NLD,Netherlands,GMB,Gambia,2010,11,54,-43
NLD,Netherlands,GMB,Gambia,2011,5,50,-45
NLD,Netherlands,GMB,Gambia,2012,17,24,-7
NLD,Netherlands,GMB,Gambia,2013,9,33,-24
NLD,Netherlands,GMB,Gambia,2014,10,59,-49
NLD,Netherlands,GMB,Gambia,2015,6,70,-64
NLD,Netherlands,GMB,Gambia,2016,13,83,-70
NLD,Netherlands,GMB,Gambia,2017,18,83,-65
NZL,New Zealand,GMB,Gambia,2008,0,2,-2
NZL,New Zealand,GMB,Gambia,2009,0,1,-1
NZL,New Zealand,GMB,Gambia,2010,0,1,-1
NZL,New Zealand,GMB,Gambia,2011,1,1,0
NZL,New Zealand,GMB,Gambia,2013,0,1,-1
NZL,New Zealand,GMB,Gambia,2014,0,1,-1
NZL,New Zealand,GMB,Gambia,2016,0,1,-1
NOR,Norway,GMB,Gambia,2008,11,46,-35
NOR,Norway,GMB,Gambia,2009,14,49,-35
NOR,Norway,GMB,Gambia,2010,14,45,-31
NOR,Norway,GMB,Gambia,2011,15,36,-21
NOR,Norway,GMB,Gambia,2012,14,46,-32
NOR,Norway,GMB,Gambia,2013,10,33,-23
NOR,Norway,GMB,Gambia,2014,7,32,-25
NOR,Norway,GMB,Gambia,2015,15,42,-27
NOR,Norway,GMB,Gambia,2016,6,30,-24
NOR,Norway,GMB,Gambia,2017,8,31,-23
POL,Poland,GMB,Gambia,2009,0,23,-23
POL,Poland,GMB,Gambia,2010,0,19,-19
POL,Poland,GMB,Gambia,2011,0,14,-14
POL,Poland,GMB,Gambia,2012,0,25,-25
POL,Poland,GMB,Gambia,2013,0,17,-17
POL,Poland,GMB,Gambia,2014,0,6,-6
POL,Poland,GMB,Gambia,2015,0,11,-11
POL,Poland,GMB,Gambia,2016,0,14,-14
POL,Poland,GMB,Gambia,2017,0,7,-7
SVK,Slovak Republic,GMB,Gambia,2008,0,0,0
SVK,Slovak Republic,GMB,Gambia,2009,0,1,-1
SVK,Slovak Republic,GMB,Gambia,2010,0,1,-1
SVK,Slovak Republic,GMB,Gambia,2011,1,1,0
ESP,Spain,GMB,Gambia,2008,871,2552,-1681
ESP,Spain,GMB,Gambia,2009,1271,1731,-460
ESP,Spain,GMB,Gambia,2010,1574,1482,92
ESP,Spain,GMB,Gambia,2011,1847,1380,467
ESP,Spain,GMB,Gambia,2012,1669,1157,512
ESP,Spain,GMB,Gambia,2013,2027,1169,858
ESP,Spain,GMB,Gambia,2014,1391,1190,201
ESP,Spain,GMB,Gambia,2015,966,1160,-194
ESP,Spain,GMB,Gambia,2016,819,1271,-452
ESP,Spain,GMB,Gambia,2017,998,1304,-306
SWE,Sweden,GMB,Gambia,2008,16,247,-231
SWE,Sweden,GMB,Gambia,2009,9,281,-272
SWE,Sweden,GMB,Gambia,2010,20,290,-270
SWE,Sweden,GMB,Gambia,2011,21,218,-197
SWE,Sweden,GMB,Gambia,2012,26,260,-234
SWE,Sweden,GMB,Gambia,2013,23,254,-231
SWE,Sweden,GMB,Gambia,2014,20,234,-214
SWE,Sweden,GMB,Gambia,2015,37,184,-147
SWE,Sweden,GMB,Gambia,2016,16,194,-178
SWE,Sweden,GMB,Gambia,2017,34,198,-164
CHE,Switzerland,GMB,Gambia,2010,8,54,-46
CHE,Switzerland,GMB,Gambia,2011,19,41,-22
CHE,Switzerland,GMB,Gambia,2012,12,42,-30
CHE,Switzerland,GMB,Gambia,2013,9,33,-24
CHE,Switzerland,GMB,Gambia,2014,8,36,-28
CHE,Switzerland,GMB,Gambia,2015,9,46,-37
CHE,Switzerland,GMB,Gambia,2016,13,29,-16
CHE,Switzerland,GMB,Gambia,2017,11,47,-36
TUR,Turkey,GMB,Gambia,2010,0,4,-4
USA,United States,GMB,Gambia,2008,0,739,-739
USA,United States,GMB,Gambia,2009,0,978,-978
USA,United States,GMB,Gambia,2010,0,859,-859
USA,United States,GMB,Gambia,2011,0,972,-972
USA,United States,GMB,Gambia,2012,0,1159,-1159
USA,United States,GMB,Gambia,2013,0,1018,-1018
USA,United States,GMB,Gambia,2014,0,1111,-1111
USA,United States,GMB,Gambia,2015,0,1142,-1142
USA,United States,GMB,Gambia,2016,0,1247,-1247
USA,United States,GMB,Gambia,2017,0,1134,-1134
CHL,Chile,GMB,Gambia,2008,0,0,0
CHL,Chile,GMB,Gambia,2009,0,0,0
CHL,Chile,GMB,Gambia,2010,0,0,0
CHL,Chile,GMB,Gambia,2011,0,1,-1
CHL,Chile,GMB,Gambia,2012,0,0,0
CHL,Chile,GMB,Gambia,2013,0,0,0
CHL,Chile,GMB,Gambia,2014,0,0,0
CHL,Chile,GMB,Gambia,2015,0,0,0
CHL,Chile,GMB,Gambia,2016,0,0,0
EST,Estonia,GMB,Gambia,2008,0,0,0
EST,Estonia,GMB,Gambia,2009,0,0,0
EST,Estonia,GMB,Gambia,2010,0,0,0
EST,Estonia,GMB,Gambia,2011,0,0,0
EST,Estonia,GMB,Gambia,2012,0,0,0
EST,Estonia,GMB,Gambia,2013,0,1,-1
EST,Estonia,GMB,Gambia,2014,0,0,0
EST,Estonia,GMB,Gambia,2015,0,0,0
EST,Estonia,GMB,Gambia,2016,0,1,-1
EST,Estonia,GMB,Gambia,2017,0,0,0
SVN,Slovenia,GMB,Gambia,2009,0,1,-1
SVN,Slovenia,GMB,Gambia,2010,0,3,-3
SVN,Slovenia,GMB,Gambia,2011,0,4,-4
SVN,Slovenia,GMB,Gambia,2013,0,1,-1
SVN,Slovenia,GMB,Gambia,2015,0,2,-2
SVN,Slovenia,GMB,Gambia,2017,0,1,-1
AUS,Australia,GEO,Georgia,2008,7,10,-3
AUS,Australia,GEO,Georgia,2009,7,13,-6
AUS,Australia,GEO,Georgia,2010,6,19,-13
AUS,Australia,GEO,Georgia,2011,0,4,-4
AUS,Australia,GEO,Georgia,2012,0,10,-10
AUS,Australia,GEO,Georgia,2013,0,7,-7
AUS,Australia,GEO,Georgia,2014,6,12,-6
AUS,Australia,GEO,Georgia,2015,0,13,-13
AUS,Australia,GEO,Georgia,2016,0,11,-11
AUS,Australia,GEO,Georgia,2017,0,9,-9
AUT,Austria,GEO,Georgia,2008,395,513,-118
AUT,Austria,GEO,Georgia,2009,504,516,-12
AUT,Austria,GEO,Georgia,2010,511,341,170
AUT,Austria,GEO,Georgia,2011,363,323,40
AUT,Austria,GEO,Georgia,2012,346,405,-59
AUT,Austria,GEO,Georgia,2013,259,399,-140
AUT,Austria,GEO,Georgia,2014,269,515,-246
AUT,Austria,GEO,Georgia,2015,231,538,-307
AUT,Austria,GEO,Georgia,2016,328,499,-171
AUT,Austria,GEO,Georgia,2017,479,583,-104
BEL,Belgium,GEO,Georgia,2008,0,64,-64
BEL,Belgium,GEO,Georgia,2009,0,83,-83
BEL,Belgium,GEO,Georgia,2010,38,137,-99
BEL,Belgium,GEO,Georgia,2011,0,99,-99
BEL,Belgium,GEO,Georgia,2012,191,488,-297
BEL,Belgium,GEO,Georgia,2013,412,296,116
BEL,Belgium,GEO,Georgia,2014,356,252,104
BEL,Belgium,GEO,Georgia,2015,284,188,96
BEL,Belgium,GEO,Georgia,2016,164,150,14
BEL,Belgium,GEO,Georgia,2017,85,250,-165
CAN,Canada,GEO,Georgia,2008,0,112,-112
CAN,Canada,GEO,Georgia,2009,0,128,-128
CAN,Canada,GEO,Georgia,2010,0,126,-126
CAN,Canada,GEO,Georgia,2011,0,139,-139
CAN,Canada,GEO,Georgia,2012,0,148,-148
CAN,Canada,GEO,Georgia,2013,0,125,-125
CAN,Canada,GEO,Georgia,2014,0,102,-102
CAN,Canada,GEO,Georgia,2015,0,103,-103
CAN,Canada,GEO,Georgia,2016,0,120,-120
CAN,Canada,GEO,Georgia,2017,0,135,-135
CZE,Czech Republic,GEO,Georgia,2008,1,162,-161
CZE,Czech Republic,GEO,Georgia,2009,0,151,-151
CZE,Czech Republic,GEO,Georgia,2010,1,125,-124
CZE,Czech Republic,GEO,Georgia,2011,2,50,-48
CZE,Czech Republic,GEO,Georgia,2012,61,79,-18
CZE,Czech Republic,GEO,Georgia,2013,89,64,25
CZE,Czech Republic,GEO,Georgia,2014,75,126,-51
CZE,Czech Republic,GEO,Georgia,2015,83,85,-2
CZE,Czech Republic,GEO,Georgia,2016,64,73,-9
CZE,Czech Republic,GEO,Georgia,2017,52,108,-56
DNK,Denmark,GEO,Georgia,2008,5,11,-6
DNK,Denmark,GEO,Georgia,2009,6,12,-6
DNK,Denmark,GEO,Georgia,2010,8,11,-3
DNK,Denmark,GEO,Georgia,2011,8,11,-3
DNK,Denmark,GEO,Georgia,2012,7,4,3
DNK,Denmark,GEO,Georgia,2013,4,10,-6
DNK,Denmark,GEO,Georgia,2014,10,9,1
DNK,Denmark,GEO,Georgia,2015,4,6,-2
DNK,Denmark,GEO,Georgia,2016,7,17,-10
DNK,Denmark,GEO,Georgia,2017,14,24,-10
FIN,Finland,GEO,Georgia,2008,2,7,-5
FIN,Finland,GEO,Georgia,2009,1,4,-3
FIN,Finland,GEO,Georgia,2010,1,9,-8
FIN,Finland,GEO,Georgia,2011,0,11,-11
FIN,Finland,GEO,Georgia,2012,0,12,-12
FIN,Finland,GEO,Georgia,2013,0,14,-14
FIN,Finland,GEO,Georgia,2014,3,14,-11
FIN,Finland,GEO,Georgia,2015,0,8,-8
FIN,Finland,GEO,Georgia,2016,2,15,-13
FIN,Finland,GEO,Georgia,2017,1,17,-16
FRA,France,GEO,Georgia,2008,0,470,-470
FRA,France,GEO,Georgia,2009,0,468,-468
FRA,France,GEO,Georgia,2010,0,438,-438
FRA,France,GEO,Georgia,2011,0,449,-449
FRA,France,GEO,Georgia,2012,0,606,-606
FRA,France,GEO,Georgia,2013,0,711,-711
FRA,France,GEO,Georgia,2014,0,784,-784
FRA,France,GEO,Georgia,2015,0,891,-891
FRA,France,GEO,Georgia,2016,0,1062,-1062
FRA,France,GEO,Georgia,2017,0,954,-954
DEU,Germany,GEO,Georgia,2008,2015,1693,322
DEU,Germany,GEO,Georgia,2009,2026,2239,-213
DEU,Germany,GEO,Georgia,2010,2147,2377,-230
DEU,Germany,GEO,Georgia,2011,1681,2339,-658
DEU,Germany,GEO,Georgia,2012,1960,3466,-1506
DEU,Germany,GEO,Georgia,2013,2390,4481,-2091
DEU,Germany,GEO,Georgia,2014,3266,5604,-2338
DEU,Germany,GEO,Georgia,2015,3364,6472,-3108
DEU,Germany,GEO,Georgia,2016,4627,5006,-379
DEU,Germany,GEO,Georgia,2017,4785,5786,-1001
GRC,Greece,GEO,Georgia,2008,0,839,-839
GRC,Greece,GEO,Georgia,2009,0,963,-963
GRC,Greece,GEO,Georgia,2010,0,858,-858
GRC,Greece,GEO,Georgia,2011,0,693,-693
HUN,Hungary,GEO,Georgia,2008,3,45,-42
HUN,Hungary,GEO,Georgia,2009,4,50,-46
HUN,Hungary,GEO,Georgia,2010,2,45,-43
HUN,Hungary,GEO,Georgia,2011,10,30,-20
HUN,Hungary,GEO,Georgia,2012,2,37,-35
HUN,Hungary,GEO,Georgia,2013,4,71,-67
HUN,Hungary,GEO,Georgia,2014,3,72,-69
HUN,Hungary,GEO,Georgia,2015,5,78,-73
HUN,Hungary,GEO,Georgia,2016,5,115,-110
HUN,Hungary,GEO,Georgia,2017,0,123,-123
ISL,Iceland,GEO,Georgia,2008,5,0,5
ISL,Iceland,GEO,Georgia,2009,3,0,3
ISL,Iceland,GEO,Georgia,2010,0,0,0
ISL,Iceland,GEO,Georgia,2011,0,0,0
ISL,Iceland,GEO,Georgia,2012,0,0,0
ISL,Iceland,GEO,Georgia,2013,0,1,-1
ISL,Iceland,GEO,Georgia,2014,0,1,-1
ISL,Iceland,GEO,Georgia,2015,0,2,-2
ISL,Iceland,GEO,Georgia,2016,0,1,-1
ISL,Iceland,GEO,Georgia,2017,0,10,-10
ITA,Italy,GEO,Georgia,2008,5,509,-504
ITA,Italy,GEO,Georgia,2009,5,1165,-1160
ITA,Italy,GEO,Georgia,2010,31,4008,-3977
ITA,Italy,GEO,Georgia,2011,36,1772,-1736
ITA,Italy,GEO,Georgia,2012,68,1706,-1638
ITA,Italy,GEO,Georgia,2013,65,2294,-2229
ITA,Italy,GEO,Georgia,2014,131,1574,-1443
ITA,Italy,GEO,Georgia,2015,145,935,-790
ITA,Italy,GEO,Georgia,2016,0,737,-737
ITA,Italy,GEO,Georgia,2017,152,855,-703
JPN,Japan,GEO,Georgia,2008,43,50,-7
JPN,Japan,GEO,Georgia,2009,64,72,-8
JPN,Japan,GEO,Georgia,2010,138,135,3
JPN,Japan,GEO,Georgia,2011,39,46,-7
JPN,Japan,GEO,Georgia,2012,128,127,1
JPN,Japan,GEO,Georgia,2013,50,61,-11
JPN,Japan,GEO,Georgia,2014,91,89,2
JPN,Japan,GEO,Georgia,2015,79,86,-7
JPN,Japan,GEO,Georgia,2016,91,105,-14
JPN,Japan,GEO,Georgia,2017,143,140,3
KOR,Korea,GEO,Georgia,2008,14,22,-8
KOR,Korea,GEO,Georgia,2009,18,11,7
KOR,Korea,GEO,Georgia,2010,9,12,-3
KOR,Korea,GEO,Georgia,2011,7,5,2
KOR,Korea,GEO,Georgia,2012,6,9,-3
KOR,Korea,GEO,Georgia,2013,12,12,0
KOR,Korea,GEO,Georgia,2014,10,8,2
KOR,Korea,GEO,Georgia,2015,10,16,-6
KOR,Korea,GEO,Georgia,2016,13,12,1
KOR,Korea,GEO,Georgia,2017,10,16,-6
LUX,Luxembourg,GEO,Georgia,2008,1,3,-2
LUX,Luxembourg,GEO,Georgia,2009,2,3,-1
LUX,Luxembourg,GEO,Georgia,2010,3,4,-1
LUX,Luxembourg,GEO,Georgia,2011,0,5,-5
LUX,Luxembourg,GEO,Georgia,2012,0,8,-8
LUX,Luxembourg,GEO,Georgia,2013,2,14,-12
LUX,Luxembourg,GEO,Georgia,2014,4,13,-9
LUX,Luxembourg,GEO,Georgia,2015,5,15,-10
LUX,Luxembourg,GEO,Georgia,2016,14,28,-14
LUX,Luxembourg,GEO,Georgia,2017,27,23,4
MEX,Mexico,GEO,Georgia,2008,0,1,-1
MEX,Mexico,GEO,Georgia,2009,0,1,-1
MEX,Mexico,GEO,Georgia,2010,0,1,-1
MEX,Mexico,GEO,Georgia,2011,0,1,-1
MEX,Mexico,GEO,Georgia,2012,0,0,0
MEX,Mexico,GEO,Georgia,2013,0,3,-3
MEX,Mexico,GEO,Georgia,2014,0,2,-2
MEX,Mexico,GEO,Georgia,2015,0,1,-1
MEX,Mexico,GEO,Georgia,2016,0,2,-2
NLD,Netherlands,GEO,Georgia,2008,40,85,-45
NLD,Netherlands,GEO,Georgia,2009,55,129,-74
NLD,Netherlands,GEO,Georgia,2010,59,113,-54
NLD,Netherlands,GEO,Georgia,2011,52,91,-39
NLD,Netherlands,GEO,Georgia,2012,42,78,-36
NLD,Netherlands,GEO,Georgia,2013,66,102,-36
NLD,Netherlands,GEO,Georgia,2014,64,96,-32
NLD,Netherlands,GEO,Georgia,2015,77,93,-16
NLD,Netherlands,GEO,Georgia,2016,61,135,-74
NLD,Netherlands,GEO,Georgia,2017,72,128,-56
NZL,New Zealand,GEO,Georgia,2008,0,3,-3
NZL,New Zealand,GEO,Georgia,2009,1,4,-3
NZL,New Zealand,GEO,Georgia,2010,0,1,-1
NZL,New Zealand,GEO,Georgia,2011,3,1,2
NZL,New Zealand,GEO,Georgia,2012,0,3,-3
NZL,New Zealand,GEO,Georgia,2013,1,1,0
NZL,New Zealand,GEO,Georgia,2016,0,4,-4
NZL,New Zealand,GEO,Georgia,2017,1,2,-1
NOR,Norway,GEO,Georgia,2008,6,22,-16
NOR,Norway,GEO,Georgia,2009,3,11,-8
NOR,Norway,GEO,Georgia,2010,8,18,-10
NOR,Norway,GEO,Georgia,2011,14,29,-15
NOR,Norway,GEO,Georgia,2012,13,45,-32
NOR,Norway,GEO,Georgia,2013,26,39,-13
NOR,Norway,GEO,Georgia,2014,22,24,-2
NOR,Norway,GEO,Georgia,2015,21,22,-1
NOR,Norway,GEO,Georgia,2016,17,19,-2
NOR,Norway,GEO,Georgia,2017,12,20,-8
POL,Poland,GEO,Georgia,2008,0,142,-142
POL,Poland,GEO,Georgia,2009,0,173,-173
POL,Poland,GEO,Georgia,2010,0,186,-186
POL,Poland,GEO,Georgia,2011,0,222,-222
POL,Poland,GEO,Georgia,2012,0,254,-254
POL,Poland,GEO,Georgia,2013,0,209,-209
POL,Poland,GEO,Georgia,2014,0,180,-180
POL,Poland,GEO,Georgia,2015,0,494,-494
POL,Poland,GEO,Georgia,2016,0,614,-614
POL,Poland,GEO,Georgia,2017,0,653,-653
SVK,Slovak Republic,GEO,Georgia,2008,3,15,-12
SVK,Slovak Republic,GEO,Georgia,2009,5,23,-18
SVK,Slovak Republic,GEO,Georgia,2010,9,2,7
SVK,Slovak Republic,GEO,Georgia,2011,3,3,0
SVK,Slovak Republic,GEO,Georgia,2012,0,2,-2
SVK,Slovak Republic,GEO,Georgia,2013,0,3,-3
SVK,Slovak Republic,GEO,Georgia,2015,0,3,-3
SVK,Slovak Republic,GEO,Georgia,2017,0,3,-3
ESP,Spain,GEO,Georgia,2008,749,1851,-1102
ESP,Spain,GEO,Georgia,2009,1164,1013,151
ESP,Spain,GEO,Georgia,2010,976,933,43
ESP,Spain,GEO,Georgia,2011,1030,945,85
ESP,Spain,GEO,Georgia,2012,1065,805,260
ESP,Spain,GEO,Georgia,2013,1356,722,634
ESP,Spain,GEO,Georgia,2014,706,926,-220
ESP,Spain,GEO,Georgia,2015,559,1089,-530
ESP,Spain,GEO,Georgia,2016,524,1340,-816
ESP,Spain,GEO,Georgia,2017,641,1861,-1220
SWE,Sweden,GEO,Georgia,2008,12,56,-44
SWE,Sweden,GEO,Georgia,2009,6,92,-86
SWE,Sweden,GEO,Georgia,2010,6,123,-117
SWE,Sweden,GEO,Georgia,2011,17,118,-101
SWE,Sweden,GEO,Georgia,2012,17,118,-101
SWE,Sweden,GEO,Georgia,2013,21,102,-81
SWE,Sweden,GEO,Georgia,2014,29,72,-43
SWE,Sweden,GEO,Georgia,2015,45,81,-36
SWE,Sweden,GEO,Georgia,2016,37,105,-68
SWE,Sweden,GEO,Georgia,2017,28,219,-191
CHE,Switzerland,GEO,Georgia,2010,28,64,-36
CHE,Switzerland,GEO,Georgia,2011,22,59,-37
CHE,Switzerland,GEO,Georgia,2012,27,56,-29
CHE,Switzerland,GEO,Georgia,2013,34,67,-33
CHE,Switzerland,GEO,Georgia,2014,20,57,-37
CHE,Switzerland,GEO,Georgia,2015,23,53,-30
CHE,Switzerland,GEO,Georgia,2016,27,67,-40
CHE,Switzerland,GEO,Georgia,2017,29,57,-28
TUR,Turkey,GEO,Georgia,2010,0,334,-334
TUR,Turkey,GEO,Georgia,2016,4114,6630,-2516
TUR,Turkey,GEO,Georgia,2017,4569,8373,-3804
GBR,United Kingdom,GEO,Georgia,2015,0,1000,-1000
USA,United States,GEO,Georgia,2008,0,1620,-1620
USA,United States,GEO,Georgia,2009,0,1578,-1578
USA,United States,GEO,Georgia,2010,0,1518,-1518
USA,United States,GEO,Georgia,2011,0,1490,-1490
USA,United States,GEO,Georgia,2012,0,1341,-1341
USA,United States,GEO,Georgia,2013,0,1368,-1368
USA,United States,GEO,Georgia,2014,0,1240,-1240
USA,United States,GEO,Georgia,2015,0,1410,-1410
USA,United States,GEO,Georgia,2016,0,1635,-1635
USA,United States,GEO,Georgia,2017,0,1629,-1629
CHL,Chile,GEO,Georgia,2008,0,0,0
CHL,Chile,GEO,Georgia,2009,0,1,-1
CHL,Chile,GEO,Georgia,2010,0,0,0
CHL,Chile,GEO,Georgia,2011,0,3,-3
CHL,Chile,GEO,Georgia,2012,0,0,0
CHL,Chile,GEO,Georgia,2013,0,0,0
CHL,Chile,GEO,Georgia,2014,0,2,-2
CHL,Chile,GEO,Georgia,2015,0,0,0
CHL,Chile,GEO,Georgia,2016,0,3,-3
EST,Estonia,GEO,Georgia,2008,0,11,-11
EST,Estonia,GEO,Georgia,2009,0,34,-34
EST,Estonia,GEO,Georgia,2010,0,15,-15
EST,Estonia,GEO,Georgia,2011,0,23,-23
EST,Estonia,GEO,Georgia,2012,0,25,-25
EST,Estonia,GEO,Georgia,2013,0,44,-44
EST,Estonia,GEO,Georgia,2014,0,15,-15
EST,Estonia,GEO,Georgia,2015,0,88,-88
EST,Estonia,GEO,Georgia,2016,0,69,-69
EST,Estonia,GEO,Georgia,2017,0,93,-93
SVN,Slovenia,GEO,Georgia,2008,0,4,-4
SVN,Slovenia,GEO,Georgia,2009,0,1,-1
SVN,Slovenia,GEO,Georgia,2010,0,7,-7
SVN,Slovenia,GEO,Georgia,2011,2,10,-8
SVN,Slovenia,GEO,Georgia,2012,0,2,-2
SVN,Slovenia,GEO,Georgia,2013,0,3,-3
SVN,Slovenia,GEO,Georgia,2014,3,4,-1
SVN,Slovenia,GEO,Georgia,2015,0,7,-7
SVN,Slovenia,GEO,Georgia,2016,0,12,-12
SVN,Slovenia,GEO,Georgia,2017,0,7,-7
AUS,Australia,GHA,Ghana,2008,26,187,-161
AUS,Australia,GHA,Ghana,2009,24,172,-148
AUS,Australia,GHA,Ghana,2010,30,263,-233
AUS,Australia,GHA,Ghana,2011,38,204,-166
AUS,Australia,GHA,Ghana,2012,35,251,-216
AUS,Australia,GHA,Ghana,2013,42,256,-214
AUS,Australia,GHA,Ghana,2014,38,254,-216
AUS,Australia,GHA,Ghana,2015,0,231,-231
AUS,Australia,GHA,Ghana,2016,0,240,-240
AUS,Australia,GHA,Ghana,2017,0,235,-235
AUT,Austria,GHA,Ghana,2008,69,72,-3
AUT,Austria,GHA,Ghana,2009,73,69,4
AUT,Austria,GHA,Ghana,2010,56,66,-10
AUT,Austria,GHA,Ghana,2011,88,104,-16
AUT,Austria,GHA,Ghana,2012,60,99,-39
AUT,Austria,GHA,Ghana,2013,58,131,-73
AUT,Austria,GHA,Ghana,2014,66,141,-75
AUT,Austria,GHA,Ghana,2015,73,153,-80
AUT,Austria,GHA,Ghana,2016,88,155,-67
AUT,Austria,GHA,Ghana,2017,108,124,-16
BEL,Belgium,GHA,Ghana,2008,0,501,-501
BEL,Belgium,GHA,Ghana,2009,0,454,-454
BEL,Belgium,GHA,Ghana,2010,36,595,-559
BEL,Belgium,GHA,Ghana,2011,0,711,-711
BEL,Belgium,GHA,Ghana,2012,80,581,-501
BEL,Belgium,GHA,Ghana,2013,184,641,-457
BEL,Belgium,GHA,Ghana,2014,119,525,-406
BEL,Belgium,GHA,Ghana,2015,125,529,-404
BEL,Belgium,GHA,Ghana,2016,83,436,-353
BEL,Belgium,GHA,Ghana,2017,72,399,-327
CAN,Canada,GHA,Ghana,2008,0,629,-629
CAN,Canada,GHA,Ghana,2009,0,658,-658
CAN,Canada,GHA,Ghana,2010,0,802,-802
CAN,Canada,GHA,Ghana,2011,0,528,-528
CAN,Canada,GHA,Ghana,2012,0,531,-531
CAN,Canada,GHA,Ghana,2013,0,518,-518
CAN,Canada,GHA,Ghana,2014,0,518,-518
CAN,Canada,GHA,Ghana,2015,0,369,-369
CAN,Canada,GHA,Ghana,2016,0,485,-485
CAN,Canada,GHA,Ghana,2017,0,685,-685
CZE,Czech Republic,GHA,Ghana,2008,0,24,-24
CZE,Czech Republic,GHA,Ghana,2009,1,10,-9
CZE,Czech Republic,GHA,Ghana,2010,0,6,-6
CZE,Czech Republic,GHA,Ghana,2011,0,14,-14
CZE,Czech Republic,GHA,Ghana,2012,8,30,-22
CZE,Czech Republic,GHA,Ghana,2013,17,41,-24
CZE,Czech Republic,GHA,Ghana,2014,10,74,-64
CZE,Czech Republic,GHA,Ghana,2015,23,119,-96
CZE,Czech Republic,GHA,Ghana,2016,31,130,-99
CZE,Czech Republic,GHA,Ghana,2017,64,40,24
DNK,Denmark,GHA,Ghana,2008,40,87,-47
DNK,Denmark,GHA,Ghana,2009,53,80,-27
DNK,Denmark,GHA,Ghana,2010,72,124,-52
DNK,Denmark,GHA,Ghana,2011,66,89,-23
DNK,Denmark,GHA,Ghana,2012,77,89,-12
DNK,Denmark,GHA,Ghana,2013,90,129,-39
DNK,Denmark,GHA,Ghana,2014,73,105,-32
DNK,Denmark,GHA,Ghana,2015,86,153,-67
DNK,Denmark,GHA,Ghana,2016,83,101,-18
DNK,Denmark,GHA,Ghana,2017,118,119,-1
FIN,Finland,GHA,Ghana,2008,19,159,-140
FIN,Finland,GHA,Ghana,2009,15,76,-61
FIN,Finland,GHA,Ghana,2010,10,67,-57
FIN,Finland,GHA,Ghana,2011,3,72,-69
FIN,Finland,GHA,Ghana,2012,20,160,-140
FIN,Finland,GHA,Ghana,2013,13,136,-123
FIN,Finland,GHA,Ghana,2014,14,159,-145
FIN,Finland,GHA,Ghana,2015,9,140,-131
FIN,Finland,GHA,Ghana,2016,19,116,-97
FIN,Finland,GHA,Ghana,2017,18,116,-98
FRA,France,GHA,Ghana,2008,0,182,-182
FRA,France,GHA,Ghana,2009,0,181,-181
FRA,France,GHA,Ghana,2010,0,231,-231
FRA,France,GHA,Ghana,2011,0,210,-210
FRA,France,GHA,Ghana,2012,0,209,-209
FRA,France,GHA,Ghana,2013,0,260,-260
FRA,France,GHA,Ghana,2014,0,255,-255
FRA,France,GHA,Ghana,2015,0,214,-214
FRA,France,GHA,Ghana,2016,0,203,-203
FRA,France,GHA,Ghana,2017,0,199,-199
DEU,Germany,GHA,Ghana,2008,995,976,19
DEU,Germany,GHA,Ghana,2009,1117,1427,-310
DEU,Germany,GHA,Ghana,2010,1016,1521,-505
DEU,Germany,GHA,Ghana,2011,931,2016,-1085
DEU,Germany,GHA,Ghana,2012,1218,2356,-1138
DEU,Germany,GHA,Ghana,2013,1381,3014,-1633
DEU,Germany,GHA,Ghana,2014,1302,3544,-2242
DEU,Germany,GHA,Ghana,2015,1538,4983,-3445
DEU,Germany,GHA,Ghana,2016,1987,3890,-1903
DEU,Germany,GHA,Ghana,2017,2197,3785,-1588
HUN,Hungary,GHA,Ghana,2008,0,15,-15
HUN,Hungary,GHA,Ghana,2009,0,11,-11
HUN,Hungary,GHA,Ghana,2010,5,10,-5
HUN,Hungary,GHA,Ghana,2011,1,11,-10
HUN,Hungary,GHA,Ghana,2012,3,10,-7
HUN,Hungary,GHA,Ghana,2013,3,10,-7
HUN,Hungary,GHA,Ghana,2014,3,9,-6
HUN,Hungary,GHA,Ghana,2015,6,21,-15
HUN,Hungary,GHA,Ghana,2016,2,58,-56
HUN,Hungary,GHA,Ghana,2017,0,79,-79
ISL,Iceland,GHA,Ghana,2008,4,4,0
ISL,Iceland,GHA,Ghana,2009,3,5,-2
ISL,Iceland,GHA,Ghana,2010,4,5,-1
ISL,Iceland,GHA,Ghana,2011,1,4,-3
ISL,Iceland,GHA,Ghana,2012,1,10,-9
ISL,Iceland,GHA,Ghana,2013,4,7,-3
ISL,Iceland,GHA,Ghana,2014,8,12,-4
ISL,Iceland,GHA,Ghana,2015,3,10,-7
ISL,Iceland,GHA,Ghana,2016,8,19,-11
ISL,Iceland,GHA,Ghana,2017,9,38,-29
ITA,Italy,GHA,Ghana,2008,146,4440,-4294
ITA,Italy,GHA,Ghana,2009,178,3177,-2999
ITA,Italy,GHA,Ghana,2010,253,3627,-3374
ITA,Italy,GHA,Ghana,2011,208,3134,-2926
ITA,Italy,GHA,Ghana,2012,210,4007,-3797
ITA,Italy,GHA,Ghana,2013,233,3503,-3270
ITA,Italy,GHA,Ghana,2014,253,2353,-2100
ITA,Italy,GHA,Ghana,2015,245,2981,-2736
ITA,Italy,GHA,Ghana,2016,0,4094,-4094
ITA,Italy,GHA,Ghana,2017,236,5968,-5732
JPN,Japan,GHA,Ghana,2008,222,276,-54
JPN,Japan,GHA,Ghana,2009,141,223,-82
JPN,Japan,GHA,Ghana,2010,274,309,-35
JPN,Japan,GHA,Ghana,2011,248,278,-30
JPN,Japan,GHA,Ghana,2012,306,362,-56
JPN,Japan,GHA,Ghana,2013,276,336,-60
JPN,Japan,GHA,Ghana,2014,221,296,-75
JPN,Japan,GHA,Ghana,2015,208,298,-90
JPN,Japan,GHA,Ghana,2016,285,422,-137
JPN,Japan,GHA,Ghana,2017,225,311,-86
KOR,Korea,GHA,Ghana,2008,262,119,143
KOR,Korea,GHA,Ghana,2009,236,93,143
KOR,Korea,GHA,Ghana,2010,203,120,83
KOR,Korea,GHA,Ghana,2011,212,132,80
KOR,Korea,GHA,Ghana,2012,146,122,24
KOR,Korea,GHA,Ghana,2013,119,158,-39
KOR,Korea,GHA,Ghana,2014,108,173,-65
KOR,Korea,GHA,Ghana,2015,100,283,-183
KOR,Korea,GHA,Ghana,2016,138,294,-156
KOR,Korea,GHA,Ghana,2017,229,389,-160
LUX,Luxembourg,GHA,Ghana,2008,0,5,-5
LUX,Luxembourg,GHA,Ghana,2009,2,2,0
LUX,Luxembourg,GHA,Ghana,2010,3,0,3
LUX,Luxembourg,GHA,Ghana,2011,0,1,-1
LUX,Luxembourg,GHA,Ghana,2012,1,4,-3
LUX,Luxembourg,GHA,Ghana,2013,1,6,-5
LUX,Luxembourg,GHA,Ghana,2014,2,5,-3
LUX,Luxembourg,GHA,Ghana,2015,2,2,0
LUX,Luxembourg,GHA,Ghana,2016,3,7,-4
LUX,Luxembourg,GHA,Ghana,2017,2,3,-1
MEX,Mexico,GHA,Ghana,2008,0,2,-2
MEX,Mexico,GHA,Ghana,2009,0,2,-2
MEX,Mexico,GHA,Ghana,2010,0,3,-3
MEX,Mexico,GHA,Ghana,2011,0,7,-7
MEX,Mexico,GHA,Ghana,2012,0,4,-4
MEX,Mexico,GHA,Ghana,2013,0,6,-6
MEX,Mexico,GHA,Ghana,2014,0,3,-3
MEX,Mexico,GHA,Ghana,2015,0,3,-3
MEX,Mexico,GHA,Ghana,2016,0,4,-4
MEX,Mexico,GHA,Ghana,2017,0,4,-4
NLD,Netherlands,GHA,Ghana,2008,160,655,-495
NLD,Netherlands,GHA,Ghana,2009,120,984,-864
NLD,Netherlands,GHA,Ghana,2010,238,607,-369
NLD,Netherlands,GHA,Ghana,2011,225,602,-377
NLD,Netherlands,GHA,Ghana,2012,209,427,-218
NLD,Netherlands,GHA,Ghana,2013,224,450,-226
NLD,Netherlands,GHA,Ghana,2014,190,381,-191
NLD,Netherlands,GHA,Ghana,2015,166,392,-226
NLD,Netherlands,GHA,Ghana,2016,170,396,-226
NLD,Netherlands,GHA,Ghana,2017,180,471,-291
NZL,New Zealand,GHA,Ghana,2008,3,12,-9
NZL,New Zealand,GHA,Ghana,2009,4,14,-10
NZL,New Zealand,GHA,Ghana,2010,3,12,-9
NZL,New Zealand,GHA,Ghana,2011,6,19,-13
NZL,New Zealand,GHA,Ghana,2012,11,17,-6
NZL,New Zealand,GHA,Ghana,2013,6,21,-15
NZL,New Zealand,GHA,Ghana,2014,1,24,-23
NZL,New Zealand,GHA,Ghana,2015,6,22,-16
NZL,New Zealand,GHA,Ghana,2016,15,51,-36
NZL,New Zealand,GHA,Ghana,2017,23,31,-8
NOR,Norway,GHA,Ghana,2008,53,142,-89
NOR,Norway,GHA,Ghana,2009,73,112,-39
NOR,Norway,GHA,Ghana,2010,77,118,-41
NOR,Norway,GHA,Ghana,2011,118,121,-3
NOR,Norway,GHA,Ghana,2012,66,136,-70
NOR,Norway,GHA,Ghana,2013,46,142,-96
NOR,Norway,GHA,Ghana,2014,91,159,-68
NOR,Norway,GHA,Ghana,2015,101,156,-55
NOR,Norway,GHA,Ghana,2016,118,111,7
NOR,Norway,GHA,Ghana,2017,65,109,-44
POL,Poland,GHA,Ghana,2009,0,51,-51
POL,Poland,GHA,Ghana,2010,0,50,-50
POL,Poland,GHA,Ghana,2011,0,45,-45
POL,Poland,GHA,Ghana,2012,0,45,-45
POL,Poland,GHA,Ghana,2013,0,43,-43
POL,Poland,GHA,Ghana,2014,0,23,-23
POL,Poland,GHA,Ghana,2015,0,35,-35
POL,Poland,GHA,Ghana,2016,0,41,-41
POL,Poland,GHA,Ghana,2017,0,44,-44
SVK,Slovak Republic,GHA,Ghana,2008,1,1,0
SVK,Slovak Republic,GHA,Ghana,2009,0,1,-1
SVK,Slovak Republic,GHA,Ghana,2010,0,1,-1
SVK,Slovak Republic,GHA,Ghana,2012,0,2,-2
SVK,Slovak Republic,GHA,Ghana,2013,0,1,-1
SVK,Slovak Republic,GHA,Ghana,2016,0,1,-1
ESP,Spain,GHA,Ghana,2008,989,1912,-923
ESP,Spain,GHA,Ghana,2009,1372,1356,16
ESP,Spain,GHA,Ghana,2010,1614,1240,374
ESP,Spain,GHA,Ghana,2011,2108,1303,805
ESP,Spain,GHA,Ghana,2012,2068,1108,960
ESP,Spain,GHA,Ghana,2013,2061,1059,1002
ESP,Spain,GHA,Ghana,2014,1074,878,196
ESP,Spain,GHA,Ghana,2015,985,877,108
ESP,Spain,GHA,Ghana,2016,786,955,-169
ESP,Spain,GHA,Ghana,2017,924,1233,-309
SWE,Sweden,GHA,Ghana,2008,55,158,-103
SWE,Sweden,GHA,Ghana,2009,23,201,-178
SWE,Sweden,GHA,Ghana,2010,35,212,-177
SWE,Sweden,GHA,Ghana,2011,45,216,-171
SWE,Sweden,GHA,Ghana,2012,53,227,-174
SWE,Sweden,GHA,Ghana,2013,35,209,-174
SWE,Sweden,GHA,Ghana,2014,69,211,-142
SWE,Sweden,GHA,Ghana,2015,84,207,-123
SWE,Sweden,GHA,Ghana,2016,39,212,-173
SWE,Sweden,GHA,Ghana,2017,31,201,-170
CHE,Switzerland,GHA,Ghana,2010,31,92,-61
CHE,Switzerland,GHA,Ghana,2011,32,75,-43
CHE,Switzerland,GHA,Ghana,2012,31,84,-53
CHE,Switzerland,GHA,Ghana,2013,25,98,-73
CHE,Switzerland,GHA,Ghana,2014,40,68,-28
CHE,Switzerland,GHA,Ghana,2015,20,53,-33
CHE,Switzerland,GHA,Ghana,2016,32,80,-48
CHE,Switzerland,GHA,Ghana,2017,30,89,-59
TUR,Turkey,GHA,Ghana,2010,0,21,-21
TUR,Turkey,GHA,Ghana,2016,66,326,-260
TUR,Turkey,GHA,Ghana,2017,161,477,-316
GBR,United Kingdom,GHA,Ghana,2011,0,2000,-2000
GBR,United Kingdom,GHA,Ghana,2012,0,1000,-1000
GBR,United Kingdom,GHA,Ghana,2013,0,1000,-1000
GBR,United Kingdom,GHA,Ghana,2014,0,1000,-1000
GBR,United Kingdom,GHA,Ghana,2015,1000,2000,-1000
USA,United States,GHA,Ghana,2008,0,8195,-8195
USA,United States,GHA,Ghana,2009,0,8401,-8401
USA,United States,GHA,Ghana,2010,0,7429,-7429
USA,United States,GHA,Ghana,2011,0,8798,-8798
USA,United States,GHA,Ghana,2012,0,10592,-10592
USA,United States,GHA,Ghana,2013,0,10265,-10265
USA,United States,GHA,Ghana,2014,0,7115,-7115
USA,United States,GHA,Ghana,2015,0,6186,-6186
USA,United States,GHA,Ghana,2016,0,6949,-6949
USA,United States,GHA,Ghana,2017,0,8455,-8455
CHL,Chile,GHA,Ghana,2008,0,6,-6
CHL,Chile,GHA,Ghana,2009,0,0,0
CHL,Chile,GHA,Ghana,2010,0,7,-7
CHL,Chile,GHA,Ghana,2011,0,1,-1
CHL,Chile,GHA,Ghana,2012,0,4,-4
CHL,Chile,GHA,Ghana,2013,0,5,-5
CHL,Chile,GHA,Ghana,2014,0,4,-4
CHL,Chile,GHA,Ghana,2015,0,12,-12
CHL,Chile,GHA,Ghana,2016,0,5,-5
EST,Estonia,GHA,Ghana,2008,0,3,-3
EST,Estonia,GHA,Ghana,2009,0,0,0
EST,Estonia,GHA,Ghana,2010,0,0,0
EST,Estonia,GHA,Ghana,2011,0,0,0
EST,Estonia,GHA,Ghana,2012,0,0,0
EST,Estonia,GHA,Ghana,2013,0,1,-1
EST,Estonia,GHA,Ghana,2014,0,0,0
EST,Estonia,GHA,Ghana,2015,0,6,-6
EST,Estonia,GHA,Ghana,2016,0,4,-4
EST,Estonia,GHA,Ghana,2017,0,19,-19
SVN,Slovenia,GHA,Ghana,2008,0,2,-2
SVN,Slovenia,GHA,Ghana,2009,0,1,-1
SVN,Slovenia,GHA,Ghana,2010,0,2,-2
SVN,Slovenia,GHA,Ghana,2011,0,5,-5
SVN,Slovenia,GHA,Ghana,2012,0,1,-1
SVN,Slovenia,GHA,Ghana,2013,0,1,-1
SVN,Slovenia,GHA,Ghana,2015,0,4,-4
SVN,Slovenia,GHA,Ghana,2016,0,1,-1
SVN,Slovenia,GHA,Ghana,2017,0,6,-6
AUS,Australia,GRC,Greece,2008,0,123,-123
AUS,Australia,GRC,Greece,2009,0,148,-148
AUS,Australia,GRC,Greece,2010,0,123,-123
AUS,Australia,GRC,Greece,2011,0,124,-124
AUS,Australia,GRC,Greece,2012,0,296,-296
AUS,Australia,GRC,Greece,2013,0,531,-531
AUS,Australia,GRC,Greece,2014,0,604,-604
AUS,Australia,GRC,Greece,2015,0,490,-490
AUS,Australia,GRC,Greece,2016,0,399,-399
AUS,Australia,GRC,Greece,2017,0,410,-410
AUT,Austria,GRC,Greece,2008,0,364,-364
AUT,Austria,GRC,Greece,2009,0,430,-430
AUT,Austria,GRC,Greece,2010,0,519,-519
AUT,Austria,GRC,Greece,2011,0,813,-813
AUT,Austria,GRC,Greece,2012,0,1201,-1201
AUT,Austria,GRC,Greece,2013,0,1362,-1362
AUT,Austria,GRC,Greece,2014,0,1109,-1109
AUT,Austria,GRC,Greece,2015,0,1161,-1161
AUT,Austria,GRC,Greece,2016,0,1088,-1088
AUT,Austria,GRC,Greece,2017,0,1172,-1172
BEL,Belgium,GRC,Greece,2008,0,755,-755
BEL,Belgium,GRC,Greece,2009,0,725,-725
BEL,Belgium,GRC,Greece,2010,0,751,-751
BEL,Belgium,GRC,Greece,2011,0,1099,-1099
BEL,Belgium,GRC,Greece,2012,0,1510,-1510
BEL,Belgium,GRC,Greece,2013,0,1343,-1343
BEL,Belgium,GRC,Greece,2014,0,1203,-1203
BEL,Belgium,GRC,Greece,2015,0,1250,-1250
BEL,Belgium,GRC,Greece,2016,0,1132,-1132
BEL,Belgium,GRC,Greece,2017,0,1341,-1341
CAN,Canada,GRC,Greece,2008,0,106,-106
CAN,Canada,GRC,Greece,2009,0,118,-118
CAN,Canada,GRC,Greece,2010,0,101,-101
CAN,Canada,GRC,Greece,2011,0,102,-102
CAN,Canada,GRC,Greece,2012,0,146,-146
CAN,Canada,GRC,Greece,2013,0,299,-299
CAN,Canada,GRC,Greece,2014,0,373,-373
CAN,Canada,GRC,Greece,2015,0,477,-477
CAN,Canada,GRC,Greece,2016,0,435,-435
CAN,Canada,GRC,Greece,2017,0,410,-410
CZE,Czech Republic,GRC,Greece,2008,0,63,-63
CZE,Czech Republic,GRC,Greece,2009,0,42,-42
CZE,Czech Republic,GRC,Greece,2010,0,41,-41
CZE,Czech Republic,GRC,Greece,2011,0,49,-49
CZE,Czech Republic,GRC,Greece,2012,0,81,-81
CZE,Czech Republic,GRC,Greece,2013,0,119,-119
CZE,Czech Republic,GRC,Greece,2014,0,111,-111
CZE,Czech Republic,GRC,Greece,2015,0,96,-96
CZE,Czech Republic,GRC,Greece,2016,0,150,-150
CZE,Czech Republic,GRC,Greece,2017,0,179,-179
DNK,Denmark,GRC,Greece,2008,0,113,-113
DNK,Denmark,GRC,Greece,2009,0,135,-135
DNK,Denmark,GRC,Greece,2010,0,144,-144
DNK,Denmark,GRC,Greece,2011,0,258,-258
DNK,Denmark,GRC,Greece,2012,0,367,-367
DNK,Denmark,GRC,Greece,2013,0,437,-437
DNK,Denmark,GRC,Greece,2014,0,395,-395
DNK,Denmark,GRC,Greece,2015,0,420,-420
DNK,Denmark,GRC,Greece,2016,0,504,-504
DNK,Denmark,GRC,Greece,2017,0,481,-481
FIN,Finland,GRC,Greece,2008,0,51,-51
FIN,Finland,GRC,Greece,2009,0,35,-35
FIN,Finland,GRC,Greece,2010,0,51,-51
FIN,Finland,GRC,Greece,2011,0,85,-85
FIN,Finland,GRC,Greece,2012,0,117,-117
FIN,Finland,GRC,Greece,2013,0,125,-125
FIN,Finland,GRC,Greece,2014,0,145,-145
FIN,Finland,GRC,Greece,2015,0,119,-119
FIN,Finland,GRC,Greece,2016,0,262,-262
FIN,Finland,GRC,Greece,2017,0,231,-231
FRA,France,GRC,Greece,2008,0,0,0
FRA,France,GRC,Greece,2009,0,0,0
FRA,France,GRC,Greece,2010,0,0,0
FRA,France,GRC,Greece,2011,0,0,0
FRA,France,GRC,Greece,2012,0,0,0
FRA,France,GRC,Greece,2013,0,1035,-1035
FRA,France,GRC,Greece,2014,0,846,-846
FRA,France,GRC,Greece,2015,0,908,-908
FRA,France,GRC,Greece,2016,0,951,-951
FRA,France,GRC,Greece,2017,0,1169,-1169
DEU,Germany,GRC,Greece,2008,0,8266,-8266
DEU,Germany,GRC,Greece,2009,0,8574,-8574
DEU,Germany,GRC,Greece,2010,0,12256,-12256
DEU,Germany,GRC,Greece,2011,0,23043,-23043
DEU,Germany,GRC,Greece,2012,0,32660,-32660
DEU,Germany,GRC,Greece,2013,0,32088,-32088
DEU,Germany,GRC,Greece,2014,0,28752,-28752
DEU,Germany,GRC,Greece,2015,0,28256,-28256
DEU,Germany,GRC,Greece,2016,0,27120,-27120
DEU,Germany,GRC,Greece,2017,0,26128,-26128
HUN,Hungary,GRC,Greece,2008,0,50,-50
HUN,Hungary,GRC,Greece,2009,0,44,-44
HUN,Hungary,GRC,Greece,2010,0,39,-39
HUN,Hungary,GRC,Greece,2011,0,63,-63
HUN,Hungary,GRC,Greece,2012,0,64,-64
HUN,Hungary,GRC,Greece,2013,0,71,-71
HUN,Hungary,GRC,Greece,2014,0,62,-62
HUN,Hungary,GRC,Greece,2015,0,92,-92
HUN,Hungary,GRC,Greece,2016,0,97,-97
HUN,Hungary,GRC,Greece,2017,0,96,-96
ISL,Iceland,GRC,Greece,2008,0,4,-4
ISL,Iceland,GRC,Greece,2009,0,8,-8
ISL,Iceland,GRC,Greece,2010,0,5,-5
ISL,Iceland,GRC,Greece,2011,0,8,-8
ISL,Iceland,GRC,Greece,2012,0,5,-5
ISL,Iceland,GRC,Greece,2013,0,12,-12
ISL,Iceland,GRC,Greece,2014,0,10,-10
ISL,Iceland,GRC,Greece,2015,0,14,-14
ISL,Iceland,GRC,Greece,2016,0,30,-30
ISL,Iceland,GRC,Greece,2017,0,73,-73
ITA,Italy,GRC,Greece,2008,0,413,-413
ITA,Italy,GRC,Greece,2009,0,400,-400
ITA,Italy,GRC,Greece,2010,0,362,-362
ITA,Italy,GRC,Greece,2011,0,440,-440
ITA,Italy,GRC,Greece,2012,0,561,-561
ITA,Italy,GRC,Greece,2013,0,582,-582
ITA,Italy,GRC,Greece,2014,0,458,-458
ITA,Italy,GRC,Greece,2015,0,457,-457
ITA,Italy,GRC,Greece,2016,0,454,-454
ITA,Italy,GRC,Greece,2017,0,535,-535
JPN,Japan,GRC,Greece,2008,0,86,-86
JPN,Japan,GRC,Greece,2009,0,106,-106
JPN,Japan,GRC,Greece,2010,0,125,-125
JPN,Japan,GRC,Greece,2011,0,83,-83
JPN,Japan,GRC,Greece,2012,0,73,-73
JPN,Japan,GRC,Greece,2013,0,83,-83
JPN,Japan,GRC,Greece,2014,0,93,-93
JPN,Japan,GRC,Greece,2015,0,96,-96
JPN,Japan,GRC,Greece,2016,0,96,-96
JPN,Japan,GRC,Greece,2017,0,105,-105
KOR,Korea,GRC,Greece,2008,0,139,-139
KOR,Korea,GRC,Greece,2009,0,128,-128
KOR,Korea,GRC,Greece,2010,0,126,-126
KOR,Korea,GRC,Greece,2011,0,155,-155
KOR,Korea,GRC,Greece,2012,0,137,-137
KOR,Korea,GRC,Greece,2013,0,116,-116
KOR,Korea,GRC,Greece,2014,0,114,-114
KOR,Korea,GRC,Greece,2015,0,90,-90
KOR,Korea,GRC,Greece,2016,0,135,-135
KOR,Korea,GRC,Greece,2017,0,144,-144
LUX,Luxembourg,GRC,Greece,2008,0,94,-94
LUX,Luxembourg,GRC,Greece,2009,0,99,-99
LUX,Luxembourg,GRC,Greece,2010,0,122,-122
LUX,Luxembourg,GRC,Greece,2011,0,185,-185
LUX,Luxembourg,GRC,Greece,2012,0,276,-276
LUX,Luxembourg,GRC,Greece,2013,0,264,-264
LUX,Luxembourg,GRC,Greece,2014,0,289,-289
LUX,Luxembourg,GRC,Greece,2015,0,356,-356
LUX,Luxembourg,GRC,Greece,2016,0,436,-436
LUX,Luxembourg,GRC,Greece,2017,0,512,-512
MEX,Mexico,GRC,Greece,2008,0,8,-8
MEX,Mexico,GRC,Greece,2009,0,8,-8
MEX,Mexico,GRC,Greece,2010,0,15,-15
MEX,Mexico,GRC,Greece,2011,0,9,-9
MEX,Mexico,GRC,Greece,2012,0,19,-19
MEX,Mexico,GRC,Greece,2013,0,34,-34
MEX,Mexico,GRC,Greece,2014,0,16,-16
MEX,Mexico,GRC,Greece,2015,0,11,-11
MEX,Mexico,GRC,Greece,2016,0,17,-17
MEX,Mexico,GRC,Greece,2017,0,14,-14
NLD,Netherlands,GRC,Greece,2008,0,1394,-1394
NLD,Netherlands,GRC,Greece,2009,0,1373,-1373
NLD,Netherlands,GRC,Greece,2010,0,1831,-1831
NLD,Netherlands,GRC,Greece,2011,0,2651,-2651
NLD,Netherlands,GRC,Greece,2012,0,3319,-3319
NLD,Netherlands,GRC,Greece,2013,0,2947,-2947
NLD,Netherlands,GRC,Greece,2014,0,2558,-2558
NLD,Netherlands,GRC,Greece,2015,0,2806,-2806
NLD,Netherlands,GRC,Greece,2016,0,3061,-3061
NLD,Netherlands,GRC,Greece,2017,0,3628,-3628
NZL,New Zealand,GRC,Greece,2008,0,9,-9
NZL,New Zealand,GRC,Greece,2009,0,21,-21
NZL,New Zealand,GRC,Greece,2010,0,10,-10
NZL,New Zealand,GRC,Greece,2011,0,14,-14
NZL,New Zealand,GRC,Greece,2012,0,50,-50
NZL,New Zealand,GRC,Greece,2013,0,44,-44
NZL,New Zealand,GRC,Greece,2014,0,19,-19
NZL,New Zealand,GRC,Greece,2015,0,15,-15
NZL,New Zealand,GRC,Greece,2016,0,25,-25
NZL,New Zealand,GRC,Greece,2017,0,22,-22
NOR,Norway,GRC,Greece,2008,0,118,-118
NOR,Norway,GRC,Greece,2009,0,55,-55
NOR,Norway,GRC,Greece,2010,0,110,-110
NOR,Norway,GRC,Greece,2011,0,258,-258
NOR,Norway,GRC,Greece,2012,0,396,-396
NOR,Norway,GRC,Greece,2013,0,562,-562
NOR,Norway,GRC,Greece,2014,0,519,-519
NOR,Norway,GRC,Greece,2015,0,509,-509
NOR,Norway,GRC,Greece,2016,0,506,-506
NOR,Norway,GRC,Greece,2017,0,511,-511
POL,Poland,GRC,Greece,2008,0,63,-63
POL,Poland,GRC,Greece,2009,0,66,-66
POL,Poland,GRC,Greece,2010,0,68,-68
POL,Poland,GRC,Greece,2011,0,69,-69
POL,Poland,GRC,Greece,2012,0,106,-106
POL,Poland,GRC,Greece,2013,0,138,-138
POL,Poland,GRC,Greece,2014,0,138,-138
POL,Poland,GRC,Greece,2015,0,131,-131
POL,Poland,GRC,Greece,2016,0,141,-141
POL,Poland,GRC,Greece,2017,0,155,-155
SVK,Slovak Republic,GRC,Greece,2008,0,33,-33
SVK,Slovak Republic,GRC,Greece,2009,0,50,-50
SVK,Slovak Republic,GRC,Greece,2010,0,42,-42
SVK,Slovak Republic,GRC,Greece,2011,0,26,-26
SVK,Slovak Republic,GRC,Greece,2012,0,15,-15
SVK,Slovak Republic,GRC,Greece,2013,0,16,-16
SVK,Slovak Republic,GRC,Greece,2014,0,19,-19
SVK,Slovak Republic,GRC,Greece,2015,0,57,-57
SVK,Slovak Republic,GRC,Greece,2016,0,48,-48
SVK,Slovak Republic,GRC,Greece,2017,0,40,-40
ESP,Spain,GRC,Greece,2008,0,508,-508
ESP,Spain,GRC,Greece,2009,0,376,-376
ESP,Spain,GRC,Greece,2010,0,372,-372
ESP,Spain,GRC,Greece,2011,0,526,-526
ESP,Spain,GRC,Greece,2012,0,513,-513
ESP,Spain,GRC,Greece,2013,0,486,-486
ESP,Spain,GRC,Greece,2014,0,455,-455
ESP,Spain,GRC,Greece,2015,0,476,-476
ESP,Spain,GRC,Greece,2016,0,550,-550
ESP,Spain,GRC,Greece,2017,0,640,-640
SWE,Sweden,GRC,Greece,2008,0,640,-640
SWE,Sweden,GRC,Greece,2009,0,483,-483
SWE,Sweden,GRC,Greece,2010,0,520,-520
SWE,Sweden,GRC,Greece,2011,0,929,-929
SWE,Sweden,GRC,Greece,2012,0,1348,-1348
SWE,Sweden,GRC,Greece,2013,0,1378,-1378
SWE,Sweden,GRC,Greece,2014,0,1088,-1088
SWE,Sweden,GRC,Greece,2015,0,1117,-1117
SWE,Sweden,GRC,Greece,2016,0,1285,-1285
SWE,Sweden,GRC,Greece,2017,0,1381,-1381
CHE,Switzerland,GRC,Greece,2008,0,637,-637
CHE,Switzerland,GRC,Greece,2009,0,672,-672
CHE,Switzerland,GRC,Greece,2010,0,741,-741
CHE,Switzerland,GRC,Greece,2011,0,1084,-1084
CHE,Switzerland,GRC,Greece,2012,0,1613,-1613
CHE,Switzerland,GRC,Greece,2013,0,1675,-1675
CHE,Switzerland,GRC,Greece,2014,0,1422,-1422
CHE,Switzerland,GRC,Greece,2015,0,1530,-1530
CHE,Switzerland,GRC,Greece,2016,0,1580,-1580
CHE,Switzerland,GRC,Greece,2017,0,1670,-1670
TUR,Turkey,GRC,Greece,2010,0,522,-522
TUR,Turkey,GRC,Greece,2016,0,845,-845
TUR,Turkey,GRC,Greece,2017,0,641,-641
GBR,United Kingdom,GRC,Greece,2011,0,6000,-6000
GBR,United Kingdom,GRC,Greece,2012,0,6000,-6000
GBR,United Kingdom,GRC,Greece,2013,0,4000,-4000
GBR,United Kingdom,GRC,Greece,2014,0,4000,-4000
GBR,United Kingdom,GRC,Greece,2015,0,11000,-11000
GBR,United Kingdom,GRC,Greece,2016,0,5000,-5000
GBR,United Kingdom,GRC,Greece,2017,0,11000,-11000
USA,United States,GRC,Greece,2008,0,769,-769
USA,United States,GRC,Greece,2009,0,798,-798
USA,United States,GRC,Greece,2010,0,745,-745
USA,United States,GRC,Greece,2011,0,949,-949
USA,United States,GRC,Greece,2012,0,1054,-1054
USA,United States,GRC,Greece,2013,0,1361,-1361
USA,United States,GRC,Greece,2014,0,1235,-1235
USA,United States,GRC,Greece,2015,0,1211,-1211
USA,United States,GRC,Greece,2016,0,1451,-1451
USA,United States,GRC,Greece,2017,0,1314,-1314
CHL,Chile,GRC,Greece,2008,0,3,-3
CHL,Chile,GRC,Greece,2009,0,4,-4
CHL,Chile,GRC,Greece,2010,0,8,-8
CHL,Chile,GRC,Greece,2011,0,9,-9
CHL,Chile,GRC,Greece,2012,0,13,-13
CHL,Chile,GRC,Greece,2013,0,15,-15
CHL,Chile,GRC,Greece,2014,0,20,-20
CHL,Chile,GRC,Greece,2015,0,35,-35
CHL,Chile,GRC,Greece,2016,0,30,-30
EST,Estonia,GRC,Greece,2008,0,1,-1
EST,Estonia,GRC,Greece,2009,0,6,-6
EST,Estonia,GRC,Greece,2010,0,7,-7
EST,Estonia,GRC,Greece,2011,0,0,0
EST,Estonia,GRC,Greece,2012,0,1,-1
EST,Estonia,GRC,Greece,2013,0,2,-2
EST,Estonia,GRC,Greece,2014,0,1,-1
EST,Estonia,GRC,Greece,2015,0,20,-20
EST,Estonia,GRC,Greece,2016,0,32,-32
EST,Estonia,GRC,Greece,2017,0,52,-52
ISR,Israel,GRC,Greece,2008,0,1,-1
ISR,Israel,GRC,Greece,2009,0,9,-9
ISR,Israel,GRC,Greece,2010,0,6,-6
ISR,Israel,GRC,Greece,2011,0,8,-8
ISR,Israel,GRC,Greece,2012,0,10,-10
ISR,Israel,GRC,Greece,2013,0,7,-7
ISR,Israel,GRC,Greece,2014,0,15,-15
ISR,Israel,GRC,Greece,2015,0,24,-24
ISR,Israel,GRC,Greece,2016,0,20,-20
ISR,Israel,GRC,Greece,2017,0,9,-9
SVN,Slovenia,GRC,Greece,2008,0,10,-10
SVN,Slovenia,GRC,Greece,2009,0,10,-10
SVN,Slovenia,GRC,Greece,2011,0,22,-22
SVN,Slovenia,GRC,Greece,2012,0,32,-32
SVN,Slovenia,GRC,Greece,2013,0,29,-29
SVN,Slovenia,GRC,Greece,2014,0,29,-29
SVN,Slovenia,GRC,Greece,2015,0,35,-35
SVN,Slovenia,GRC,Greece,2016,0,44,-44
SVN,Slovenia,GRC,Greece,2017,0,58,-58
AUS,Australia,GRD,Grenada,2008,0,3,-3
AUS,Australia,GRD,Grenada,2009,0,1,-1
AUS,Australia,GRD,Grenada,2010,0,1,-1
AUS,Australia,GRD,Grenada,2011,0,0,0
AUS,Australia,GRD,Grenada,2012,0,3,-3
AUS,Australia,GRD,Grenada,2013,0,0,0
AUS,Australia,GRD,Grenada,2014,0,0,0
AUS,Australia,GRD,Grenada,2015,0,0,0
AUS,Australia,GRD,Grenada,2016,0,0,0
AUS,Australia,GRD,Grenada,2017,0,3,-3
AUT,Austria,GRD,Grenada,2008,1,1,0
AUT,Austria,GRD,Grenada,2009,1,2,-1
AUT,Austria,GRD,Grenada,2010,2,4,-2
AUT,Austria,GRD,Grenada,2011,1,1,0
AUT,Austria,GRD,Grenada,2012,0,2,-2
AUT,Austria,GRD,Grenada,2013,2,1,1
AUT,Austria,GRD,Grenada,2014,1,1,0
AUT,Austria,GRD,Grenada,2015,0,0,0
AUT,Austria,GRD,Grenada,2016,0,1,-1
AUT,Austria,GRD,Grenada,2017,0,2,-2
BEL,Belgium,GRD,Grenada,2010,0,0,0
BEL,Belgium,GRD,Grenada,2012,0,2,-2
BEL,Belgium,GRD,Grenada,2015,0,1,-1
CAN,Canada,GRD,Grenada,2008,0,284,-284
CAN,Canada,GRD,Grenada,2009,0,325,-325
CAN,Canada,GRD,Grenada,2010,0,208,-208
CAN,Canada,GRD,Grenada,2011,0,173,-173
CAN,Canada,GRD,Grenada,2012,0,142,-142
CAN,Canada,GRD,Grenada,2013,0,170,-170
CAN,Canada,GRD,Grenada,2014,0,137,-137
CAN,Canada,GRD,Grenada,2015,0,115,-115
CAN,Canada,GRD,Grenada,2016,0,110,-110
CAN,Canada,GRD,Grenada,2017,0,120,-120
DNK,Denmark,GRD,Grenada,2008,1,0,1
DNK,Denmark,GRD,Grenada,2009,0,0,0
DNK,Denmark,GRD,Grenada,2012,0,1,-1
DNK,Denmark,GRD,Grenada,2013,0,1,-1
DNK,Denmark,GRD,Grenada,2014,0,2,-2
DNK,Denmark,GRD,Grenada,2015,0,0,0
DNK,Denmark,GRD,Grenada,2016,0,1,-1
DNK,Denmark,GRD,Grenada,2017,1,0,1
FIN,Finland,GRD,Grenada,2008,0,0,0
FIN,Finland,GRD,Grenada,2009,0,0,0
FIN,Finland,GRD,Grenada,2010,0,0,0
FIN,Finland,GRD,Grenada,2011,0,0,0
FIN,Finland,GRD,Grenada,2012,0,0,0
FIN,Finland,GRD,Grenada,2013,0,0,0
FIN,Finland,GRD,Grenada,2014,0,0,0
FIN,Finland,GRD,Grenada,2015,0,0,0
FIN,Finland,GRD,Grenada,2016,0,0,0
FIN,Finland,GRD,Grenada,2017,0,0,0
FRA,France,GRD,Grenada,2008,0,0,0
FRA,France,GRD,Grenada,2009,0,2,-2
FRA,France,GRD,Grenada,2010,0,2,-2
FRA,France,GRD,Grenada,2011,0,4,-4
FRA,France,GRD,Grenada,2012,0,3,-3
FRA,France,GRD,Grenada,2013,0,1,-1
FRA,France,GRD,Grenada,2014,0,1,-1
FRA,France,GRD,Grenada,2015,0,1,-1
FRA,France,GRD,Grenada,2016,0,3,-3
FRA,France,GRD,Grenada,2017,0,1,-1
DEU,Germany,GRD,Grenada,2008,5,4,1
DEU,Germany,GRD,Grenada,2009,6,7,-1
DEU,Germany,GRD,Grenada,2010,7,4,3
DEU,Germany,GRD,Grenada,2011,4,9,-5
DEU,Germany,GRD,Grenada,2012,9,13,-4
DEU,Germany,GRD,Grenada,2013,3,7,-4
DEU,Germany,GRD,Grenada,2014,1,6,-5
DEU,Germany,GRD,Grenada,2015,1,10,-9
DEU,Germany,GRD,Grenada,2016,5,6,-1
DEU,Germany,GRD,Grenada,2017,5,2,3
HUN,Hungary,GRD,Grenada,2008,0,1,-1
HUN,Hungary,GRD,Grenada,2009,0,0,0
HUN,Hungary,GRD,Grenada,2010,0,0,0
HUN,Hungary,GRD,Grenada,2011,0,0,0
HUN,Hungary,GRD,Grenada,2012,0,0,0
HUN,Hungary,GRD,Grenada,2013,1,1,0
HUN,Hungary,GRD,Grenada,2014,0,0,0
HUN,Hungary,GRD,Grenada,2015,0,0,0
HUN,Hungary,GRD,Grenada,2016,0,0,0
HUN,Hungary,GRD,Grenada,2017,0,2,-2
ISL,Iceland,GRD,Grenada,2016,0,0,0
ISL,Iceland,GRD,Grenada,2017,0,0,0
ITA,Italy,GRD,Grenada,2008,0,8,-8
ITA,Italy,GRD,Grenada,2009,0,3,-3
ITA,Italy,GRD,Grenada,2010,0,3,-3
ITA,Italy,GRD,Grenada,2011,0,0,0
ITA,Italy,GRD,Grenada,2012,0,0,0
ITA,Italy,GRD,Grenada,2013,0,1,-1
ITA,Italy,GRD,Grenada,2015,0,0,0
JPN,Japan,GRD,Grenada,2008,5,4,1
JPN,Japan,GRD,Grenada,2009,4,4,0
JPN,Japan,GRD,Grenada,2010,17,17,0
JPN,Japan,GRD,Grenada,2011,6,6,0
JPN,Japan,GRD,Grenada,2012,5,5,0
JPN,Japan,GRD,Grenada,2013,11,11,0
JPN,Japan,GRD,Grenada,2014,9,10,-1
JPN,Japan,GRD,Grenada,2015,13,14,-1
JPN,Japan,GRD,Grenada,2016,8,8,0
JPN,Japan,GRD,Grenada,2017,9,8,1
KOR,Korea,GRD,Grenada,2008,0,0,0
KOR,Korea,GRD,Grenada,2009,0,0,0
KOR,Korea,GRD,Grenada,2010,0,0,0
KOR,Korea,GRD,Grenada,2011,0,0,0
KOR,Korea,GRD,Grenada,2012,2,4,-2
KOR,Korea,GRD,Grenada,2013,4,3,1
KOR,Korea,GRD,Grenada,2014,0,0,0
KOR,Korea,GRD,Grenada,2015,1,1,0
KOR,Korea,GRD,Grenada,2016,1,1,0
KOR,Korea,GRD,Grenada,2017,0,0,0
LUX,Luxembourg,GRD,Grenada,2008,0,0,0
LUX,Luxembourg,GRD,Grenada,2009,0,0,0
LUX,Luxembourg,GRD,Grenada,2010,0,0,0
LUX,Luxembourg,GRD,Grenada,2011,0,0,0
LUX,Luxembourg,GRD,Grenada,2012,0,0,0
LUX,Luxembourg,GRD,Grenada,2013,0,0,0
LUX,Luxembourg,GRD,Grenada,2014,0,0,0
LUX,Luxembourg,GRD,Grenada,2015,0,2,-2
LUX,Luxembourg,GRD,Grenada,2016,0,0,0
LUX,Luxembourg,GRD,Grenada,2017,0,0,0
MEX,Mexico,GRD,Grenada,2008,0,3,-3
MEX,Mexico,GRD,Grenada,2009,0,6,-6
MEX,Mexico,GRD,Grenada,2010,0,5,-5
MEX,Mexico,GRD,Grenada,2011,0,4,-4
MEX,Mexico,GRD,Grenada,2012,0,2,-2
MEX,Mexico,GRD,Grenada,2013,0,11,-11
MEX,Mexico,GRD,Grenada,2014,0,4,-4
MEX,Mexico,GRD,Grenada,2015,0,1,-1
MEX,Mexico,GRD,Grenada,2016,0,1,-1
NLD,Netherlands,GRD,Grenada,2008,1,0,1
NLD,Netherlands,GRD,Grenada,2012,0,2,-2
NLD,Netherlands,GRD,Grenada,2014,2,2,0
NLD,Netherlands,GRD,Grenada,2015,1,0,1
NLD,Netherlands,GRD,Grenada,2016,1,2,-1
NLD,Netherlands,GRD,Grenada,2017,1,2,-1
NZL,New Zealand,GRD,Grenada,2008,0,1,-1
NZL,New Zealand,GRD,Grenada,2014,0,3,-3
NZL,New Zealand,GRD,Grenada,2017,0,1,-1
NOR,Norway,GRD,Grenada,2008,0,4,-4
NOR,Norway,GRD,Grenada,2009,0,0,0
NOR,Norway,GRD,Grenada,2010,0,0,0
NOR,Norway,GRD,Grenada,2011,0,0,0
NOR,Norway,GRD,Grenada,2012,1,1,0
NOR,Norway,GRD,Grenada,2013,0,0,0
NOR,Norway,GRD,Grenada,2014,0,0,0
NOR,Norway,GRD,Grenada,2015,1,0,1
NOR,Norway,GRD,Grenada,2016,0,0,0
NOR,Norway,GRD,Grenada,2017,0,0,0
POL,Poland,GRD,Grenada,2009,0,1,-1
POL,Poland,GRD,Grenada,2010,0,0,0
POL,Poland,GRD,Grenada,2011,0,0,0
POL,Poland,GRD,Grenada,2012,0,0,0
POL,Poland,GRD,Grenada,2013,0,0,0
POL,Poland,GRD,Grenada,2014,0,0,0
POL,Poland,GRD,Grenada,2015,0,0,0
POL,Poland,GRD,Grenada,2016,0,0,0
POL,Poland,GRD,Grenada,2017,0,2,-2
SVK,Slovak Republic,GRD,Grenada,2008,0,1,-1
ESP,Spain,GRD,Grenada,2008,1,2,-1
ESP,Spain,GRD,Grenada,2009,0,0,0
ESP,Spain,GRD,Grenada,2010,0,1,-1
ESP,Spain,GRD,Grenada,2011,2,3,-1
ESP,Spain,GRD,Grenada,2012,1,2,-1
ESP,Spain,GRD,Grenada,2013,0,7,-7
ESP,Spain,GRD,Grenada,2014,1,1,0
ESP,Spain,GRD,Grenada,2015,1,4,-3
ESP,Spain,GRD,Grenada,2016,0,0,0
ESP,Spain,GRD,Grenada,2017,0,8,-8
SWE,Sweden,GRD,Grenada,2008,0,1,-1
SWE,Sweden,GRD,Grenada,2009,1,1,0
SWE,Sweden,GRD,Grenada,2010,0,1,-1
SWE,Sweden,GRD,Grenada,2011,2,0,2
SWE,Sweden,GRD,Grenada,2012,0,3,-3
SWE,Sweden,GRD,Grenada,2013,0,0,0
SWE,Sweden,GRD,Grenada,2014,0,0,0
SWE,Sweden,GRD,Grenada,2015,1,0,1
SWE,Sweden,GRD,Grenada,2016,0,0,0
SWE,Sweden,GRD,Grenada,2017,0,1,-1
CHE,Switzerland,GRD,Grenada,2010,1,0,1
CHE,Switzerland,GRD,Grenada,2011,0,0,0
CHE,Switzerland,GRD,Grenada,2012,2,1,1
CHE,Switzerland,GRD,Grenada,2013,1,1,0
CHE,Switzerland,GRD,Grenada,2015,1,0,1
CHE,Switzerland,GRD,Grenada,2016,0,2,-2
CHE,Switzerland,GRD,Grenada,2017,0,1,-1
USA,United States,GRD,Grenada,2008,0,784,-784
USA,United States,GRD,Grenada,2009,0,748,-748
USA,United States,GRD,Grenada,2010,0,664,-664
USA,United States,GRD,Grenada,2011,0,579,-579
USA,United States,GRD,Grenada,2012,0,671,-671
USA,United States,GRD,Grenada,2013,0,687,-687
USA,United States,GRD,Grenada,2014,0,633,-633
USA,United States,GRD,Grenada,2015,0,525,-525
USA,United States,GRD,Grenada,2016,0,585,-585
USA,United States,GRD,Grenada,2017,0,544,-544
CHL,Chile,GRD,Grenada,2008,0,0,0
CHL,Chile,GRD,Grenada,2009,0,1,-1
CHL,Chile,GRD,Grenada,2010,0,0,0
CHL,Chile,GRD,Grenada,2011,0,0,0
CHL,Chile,GRD,Grenada,2012,0,0,0
CHL,Chile,GRD,Grenada,2013,0,0,0
CHL,Chile,GRD,Grenada,2014,0,1,-1
CHL,Chile,GRD,Grenada,2015,0,1,-1
CHL,Chile,GRD,Grenada,2016,0,0,0
EST,Estonia,GRD,Grenada,2008,0,0,0
EST,Estonia,GRD,Grenada,2009,0,0,0
EST,Estonia,GRD,Grenada,2010,0,0,0
EST,Estonia,GRD,Grenada,2011,0,0,0
EST,Estonia,GRD,Grenada,2012,0,0,0
EST,Estonia,GRD,Grenada,2013,0,0,0
EST,Estonia,GRD,Grenada,2014,0,0,0
EST,Estonia,GRD,Grenada,2015,0,0,0
EST,Estonia,GRD,Grenada,2016,0,0,0
EST,Estonia,GRD,Grenada,2017,0,0,0
AUS,Australia,GUM,Guam,2009,0,0,0
AUS,Australia,GUM,Guam,2010,0,0,0
AUS,Australia,GUM,Guam,2011,0,0,0
AUS,Australia,GUM,Guam,2012,0,0,0
AUS,Australia,GUM,Guam,2013,0,0,0
AUS,Australia,GUM,Guam,2014,0,0,0
AUS,Australia,GUM,Guam,2015,0,0,0
AUS,Australia,GUM,Guam,2016,0,0,0
AUS,Australia,GUM,Guam,2017,0,0,0
AUT,Austria,GUM,Guam,2014,0,0,0
AUT,Austria,GUM,Guam,2015,0,0,0
AUT,Austria,GUM,Guam,2016,0,0,0
AUT,Austria,GUM,Guam,2017,0,0,0
BEL,Belgium,GUM,Guam,2010,0,0,0
CAN,Canada,GUM,Guam,2008,0,0,0
CAN,Canada,GUM,Guam,2009,0,0,0
CAN,Canada,GUM,Guam,2010,0,0,0
CAN,Canada,GUM,Guam,2011,0,0,0
CAN,Canada,GUM,Guam,2012,0,0,0
CAN,Canada,GUM,Guam,2013,0,0,0
CAN,Canada,GUM,Guam,2014,0,0,0
CAN,Canada,GUM,Guam,2015,0,0,0
CAN,Canada,GUM,Guam,2016,0,0,0
CAN,Canada,GUM,Guam,2017,0,0,0
DNK,Denmark,GUM,Guam,2015,0,0,0
DNK,Denmark,GUM,Guam,2016,0,0,0
FIN,Finland,GUM,Guam,2008,0,0,0
FIN,Finland,GUM,Guam,2009,0,0,0
FIN,Finland,GUM,Guam,2010,0,0,0
FIN,Finland,GUM,Guam,2011,0,0,0
FIN,Finland,GUM,Guam,2012,0,0,0
FIN,Finland,GUM,Guam,2013,0,0,0
FIN,Finland,GUM,Guam,2014,0,0,0
FIN,Finland,GUM,Guam,2015,0,0,0
FIN,Finland,GUM,Guam,2016,0,0,0
FIN,Finland,GUM,Guam,2017,0,0,0
FRA,France,GUM,Guam,2008,0,0,0
FRA,France,GUM,Guam,2009,0,0,0
FRA,France,GUM,Guam,2010,0,0,0
FRA,France,GUM,Guam,2011,0,0,0
FRA,France,GUM,Guam,2012,0,0,0
FRA,France,GUM,Guam,2013,0,0,0
FRA,France,GUM,Guam,2014,0,0,0
FRA,France,GUM,Guam,2015,0,0,0
FRA,France,GUM,Guam,2016,0,0,0
FRA,France,GUM,Guam,2017,0,0,0
HUN,Hungary,GUM,Guam,2008,0,0,0
HUN,Hungary,GUM,Guam,2009,0,0,0
HUN,Hungary,GUM,Guam,2010,0,0,0
HUN,Hungary,GUM,Guam,2011,0,0,0
HUN,Hungary,GUM,Guam,2012,0,0,0
HUN,Hungary,GUM,Guam,2013,0,0,0
HUN,Hungary,GUM,Guam,2014,0,0,0
HUN,Hungary,GUM,Guam,2015,0,0,0
HUN,Hungary,GUM,Guam,2016,0,0,0
HUN,Hungary,GUM,Guam,2017,0,0,0
ISL,Iceland,GUM,Guam,2016,0,0,0
ISL,Iceland,GUM,Guam,2017,0,0,0
JPN,Japan,GUM,Guam,2008,0,0,0
JPN,Japan,GUM,Guam,2009,0,0,0
JPN,Japan,GUM,Guam,2010,0,0,0
JPN,Japan,GUM,Guam,2011,0,0,0
JPN,Japan,GUM,Guam,2012,0,0,0
JPN,Japan,GUM,Guam,2013,0,0,0
JPN,Japan,GUM,Guam,2014,0,0,0
JPN,Japan,GUM,Guam,2015,0,0,0
JPN,Japan,GUM,Guam,2016,0,0,0
JPN,Japan,GUM,Guam,2017,0,0,0
KOR,Korea,GUM,Guam,2008,0,0,0
KOR,Korea,GUM,Guam,2009,0,0,0
KOR,Korea,GUM,Guam,2010,0,0,0
KOR,Korea,GUM,Guam,2011,0,0,0
KOR,Korea,GUM,Guam,2012,0,0,0
KOR,Korea,GUM,Guam,2013,0,0,0
KOR,Korea,GUM,Guam,2014,0,0,0
KOR,Korea,GUM,Guam,2015,0,0,0
KOR,Korea,GUM,Guam,2016,0,0,0
KOR,Korea,GUM,Guam,2017,0,0,0
LUX,Luxembourg,GUM,Guam,2008,0,0,0
LUX,Luxembourg,GUM,Guam,2009,0,0,0
LUX,Luxembourg,GUM,Guam,2010,0,0,0
LUX,Luxembourg,GUM,Guam,2011,0,0,0
LUX,Luxembourg,GUM,Guam,2012,0,0,0
LUX,Luxembourg,GUM,Guam,2013,0,0,0
LUX,Luxembourg,GUM,Guam,2014,0,0,0
LUX,Luxembourg,GUM,Guam,2015,0,0,0
LUX,Luxembourg,GUM,Guam,2016,0,0,0
LUX,Luxembourg,GUM,Guam,2017,0,0,0
MEX,Mexico,GUM,Guam,2012,0,0,0
MEX,Mexico,GUM,Guam,2013,0,0,0
MEX,Mexico,GUM,Guam,2014,0,0,0
NOR,Norway,GUM,Guam,2008,0,0,0
NOR,Norway,GUM,Guam,2009,0,0,0
NOR,Norway,GUM,Guam,2010,0,0,0
NOR,Norway,GUM,Guam,2011,0,0,0
NOR,Norway,GUM,Guam,2012,0,0,0
NOR,Norway,GUM,Guam,2013,0,0,0
NOR,Norway,GUM,Guam,2014,0,0,0
NOR,Norway,GUM,Guam,2015,0,0,0
NOR,Norway,GUM,Guam,2016,0,0,0
NOR,Norway,GUM,Guam,2017,0,0,0
POL,Poland,GUM,Guam,2009,0,0,0
POL,Poland,GUM,Guam,2010,0,0,0
POL,Poland,GUM,Guam,2011,0,0,0
POL,Poland,GUM,Guam,2012,0,0,0
POL,Poland,GUM,Guam,2013,0,0,0
POL,Poland,GUM,Guam,2014,0,0,0
POL,Poland,GUM,Guam,2015,0,0,0
POL,Poland,GUM,Guam,2016,0,0,0
POL,Poland,GUM,Guam,2017,0,0,0
ESP,Spain,GUM,Guam,2008,0,0,0
ESP,Spain,GUM,Guam,2009,0,0,0
ESP,Spain,GUM,Guam,2010,0,0,0
ESP,Spain,GUM,Guam,2011,0,0,0
ESP,Spain,GUM,Guam,2012,0,0,0
ESP,Spain,GUM,Guam,2013,0,0,0
SWE,Sweden,GUM,Guam,2008,0,0,0
SWE,Sweden,GUM,Guam,2009,0,0,0
SWE,Sweden,GUM,Guam,2010,0,0,0
SWE,Sweden,GUM,Guam,2011,0,0,0
SWE,Sweden,GUM,Guam,2012,0,0,0
SWE,Sweden,GUM,Guam,2013,0,0,0
SWE,Sweden,GUM,Guam,2014,0,0,0
SWE,Sweden,GUM,Guam,2015,0,0,0
USA,United States,GUM,Guam,2017,0,2,-2
CHL,Chile,GUM,Guam,2008,0,0,0
CHL,Chile,GUM,Guam,2009,0,0,0
CHL,Chile,GUM,Guam,2010,0,0,0
CHL,Chile,GUM,Guam,2011,0,0,0
CHL,Chile,GUM,Guam,2012,0,0,0
CHL,Chile,GUM,Guam,2013,0,0,0
CHL,Chile,GUM,Guam,2014,0,0,0
CHL,Chile,GUM,Guam,2015,0,0,0
CHL,Chile,GUM,Guam,2016,0,0,0
EST,Estonia,GUM,Guam,2017,0,0,0
AUS,Australia,GTM,Guatemala,2008,0,12,-12
AUS,Australia,GTM,Guatemala,2009,0,15,-15
AUS,Australia,GTM,Guatemala,2010,0,8,-8
AUS,Australia,GTM,Guatemala,2011,0,9,-9
AUS,Australia,GTM,Guatemala,2012,0,14,-14
AUS,Australia,GTM,Guatemala,2013,7,16,-9
AUS,Australia,GTM,Guatemala,2014,0,18,-18
AUS,Australia,GTM,Guatemala,2015,0,8,-8
AUS,Australia,GTM,Guatemala,2016,0,10,-10
AUS,Australia,GTM,Guatemala,2017,0,9,-9
AUT,Austria,GTM,Guatemala,2008,9,13,-4
AUT,Austria,GTM,Guatemala,2009,9,17,-8
AUT,Austria,GTM,Guatemala,2010,16,16,0
AUT,Austria,GTM,Guatemala,2011,14,24,-10
AUT,Austria,GTM,Guatemala,2012,11,33,-22
AUT,Austria,GTM,Guatemala,2013,15,28,-13
AUT,Austria,GTM,Guatemala,2014,17,32,-15
AUT,Austria,GTM,Guatemala,2015,15,30,-15
AUT,Austria,GTM,Guatemala,2016,19,15,4
AUT,Austria,GTM,Guatemala,2017,10,30,-20
BEL,Belgium,GTM,Guatemala,2008,0,21,-21
BEL,Belgium,GTM,Guatemala,2009,0,32,-32
BEL,Belgium,GTM,Guatemala,2010,11,27,-16
BEL,Belgium,GTM,Guatemala,2012,12,32,-20
BEL,Belgium,GTM,Guatemala,2013,15,23,-8
BEL,Belgium,GTM,Guatemala,2014,11,13,-2
BEL,Belgium,GTM,Guatemala,2015,11,9,2
BEL,Belgium,GTM,Guatemala,2016,6,18,-12
BEL,Belgium,GTM,Guatemala,2017,8,21,-13
CAN,Canada,GTM,Guatemala,2008,0,263,-263
CAN,Canada,GTM,Guatemala,2009,0,264,-264
CAN,Canada,GTM,Guatemala,2010,0,265,-265
CAN,Canada,GTM,Guatemala,2011,0,288,-288
CAN,Canada,GTM,Guatemala,2012,0,358,-358
CAN,Canada,GTM,Guatemala,2013,0,348,-348
CAN,Canada,GTM,Guatemala,2014,0,317,-317
CAN,Canada,GTM,Guatemala,2015,0,240,-240
CAN,Canada,GTM,Guatemala,2016,0,200,-200
CAN,Canada,GTM,Guatemala,2017,0,240,-240
CZE,Czech Republic,GTM,Guatemala,2008,0,4,-4
CZE,Czech Republic,GTM,Guatemala,2009,0,3,-3
CZE,Czech Republic,GTM,Guatemala,2010,0,1,-1
CZE,Czech Republic,GTM,Guatemala,2011,0,1,-1
CZE,Czech Republic,GTM,Guatemala,2012,3,3,0
CZE,Czech Republic,GTM,Guatemala,2013,3,3,0
CZE,Czech Republic,GTM,Guatemala,2014,1,4,-3
CZE,Czech Republic,GTM,Guatemala,2015,2,5,-3
CZE,Czech Republic,GTM,Guatemala,2016,4,2,2
CZE,Czech Republic,GTM,Guatemala,2017,3,9,-6
DNK,Denmark,GTM,Guatemala,2008,3,6,-3
DNK,Denmark,GTM,Guatemala,2009,1,16,-15
DNK,Denmark,GTM,Guatemala,2010,8,12,-4
DNK,Denmark,GTM,Guatemala,2011,8,6,2
DNK,Denmark,GTM,Guatemala,2012,5,8,-3
DNK,Denmark,GTM,Guatemala,2013,5,8,-3
DNK,Denmark,GTM,Guatemala,2014,5,5,0
DNK,Denmark,GTM,Guatemala,2015,4,4,0
DNK,Denmark,GTM,Guatemala,2016,7,1,6
DNK,Denmark,GTM,Guatemala,2017,6,10,-4
FIN,Finland,GTM,Guatemala,2008,0,8,-8
FIN,Finland,GTM,Guatemala,2009,0,5,-5
FIN,Finland,GTM,Guatemala,2010,0,3,-3
FIN,Finland,GTM,Guatemala,2011,0,2,-2
FIN,Finland,GTM,Guatemala,2012,0,1,-1
FIN,Finland,GTM,Guatemala,2013,0,7,-7
FIN,Finland,GTM,Guatemala,2014,1,2,-1
FIN,Finland,GTM,Guatemala,2015,0,2,-2
FIN,Finland,GTM,Guatemala,2016,1,5,-4
FIN,Finland,GTM,Guatemala,2017,0,1,-1
FRA,France,GTM,Guatemala,2008,0,34,-34
FRA,France,GTM,Guatemala,2009,0,26,-26
FRA,France,GTM,Guatemala,2010,0,33,-33
FRA,France,GTM,Guatemala,2011,0,27,-27
FRA,France,GTM,Guatemala,2012,0,32,-32
FRA,France,GTM,Guatemala,2013,0,39,-39
FRA,France,GTM,Guatemala,2014,0,44,-44
FRA,France,GTM,Guatemala,2015,0,41,-41
FRA,France,GTM,Guatemala,2016,0,35,-35
FRA,France,GTM,Guatemala,2017,0,35,-35
DEU,Germany,GTM,Guatemala,2008,113,125,-12
DEU,Germany,GTM,Guatemala,2009,101,118,-17
DEU,Germany,GTM,Guatemala,2010,104,110,-6
DEU,Germany,GTM,Guatemala,2011,61,129,-68
DEU,Germany,GTM,Guatemala,2012,71,163,-92
DEU,Germany,GTM,Guatemala,2013,85,127,-42
DEU,Germany,GTM,Guatemala,2014,76,155,-79
DEU,Germany,GTM,Guatemala,2015,120,155,-35
DEU,Germany,GTM,Guatemala,2016,75,152,-77
DEU,Germany,GTM,Guatemala,2017,67,177,-110
HUN,Hungary,GTM,Guatemala,2008,0,4,-4
HUN,Hungary,GTM,Guatemala,2009,0,0,0
HUN,Hungary,GTM,Guatemala,2010,0,2,-2
HUN,Hungary,GTM,Guatemala,2011,0,2,-2
HUN,Hungary,GTM,Guatemala,2012,0,1,-1
HUN,Hungary,GTM,Guatemala,2013,0,1,-1
HUN,Hungary,GTM,Guatemala,2014,0,2,-2
HUN,Hungary,GTM,Guatemala,2015,1,4,-3
HUN,Hungary,GTM,Guatemala,2016,0,5,-5
HUN,Hungary,GTM,Guatemala,2017,0,4,-4
ISL,Iceland,GTM,Guatemala,2008,0,2,-2
ISL,Iceland,GTM,Guatemala,2009,1,0,1
ISL,Iceland,GTM,Guatemala,2010,1,0,1
ISL,Iceland,GTM,Guatemala,2011,0,0,0
ISL,Iceland,GTM,Guatemala,2012,0,2,-2
ISL,Iceland,GTM,Guatemala,2013,0,1,-1
ISL,Iceland,GTM,Guatemala,2014,1,0,1
ISL,Iceland,GTM,Guatemala,2015,0,2,-2
ISL,Iceland,GTM,Guatemala,2016,0,0,0
ISL,Iceland,GTM,Guatemala,2017,3,0,3
ITA,Italy,GTM,Guatemala,2008,2,72,-70
ITA,Italy,GTM,Guatemala,2009,2,62,-60
ITA,Italy,GTM,Guatemala,2010,7,104,-97
ITA,Italy,GTM,Guatemala,2011,1,89,-88
ITA,Italy,GTM,Guatemala,2012,4,83,-79
ITA,Italy,GTM,Guatemala,2013,8,72,-64
ITA,Italy,GTM,Guatemala,2014,8,44,-36
ITA,Italy,GTM,Guatemala,2015,7,63,-56
ITA,Italy,GTM,Guatemala,2016,0,55,-55
ITA,Italy,GTM,Guatemala,2017,5,54,-49
JPN,Japan,GTM,Guatemala,2008,65,68,-3
JPN,Japan,GTM,Guatemala,2009,94,92,2
JPN,Japan,GTM,Guatemala,2010,99,104,-5
JPN,Japan,GTM,Guatemala,2011,89,94,-5
JPN,Japan,GTM,Guatemala,2012,89,90,-1
JPN,Japan,GTM,Guatemala,2013,66,69,-3
JPN,Japan,GTM,Guatemala,2014,57,64,-7
JPN,Japan,GTM,Guatemala,2015,54,61,-7
JPN,Japan,GTM,Guatemala,2016,64,71,-7
JPN,Japan,GTM,Guatemala,2017,56,66,-10
KOR,Korea,GTM,Guatemala,2008,18,31,-13
KOR,Korea,GTM,Guatemala,2009,19,56,-37
KOR,Korea,GTM,Guatemala,2010,23,37,-14
KOR,Korea,GTM,Guatemala,2011,34,38,-4
KOR,Korea,GTM,Guatemala,2012,20,30,-10
KOR,Korea,GTM,Guatemala,2013,39,36,3
KOR,Korea,GTM,Guatemala,2014,28,28,0
KOR,Korea,GTM,Guatemala,2015,31,19,12
KOR,Korea,GTM,Guatemala,2016,26,16,10
KOR,Korea,GTM,Guatemala,2017,21,19,2
LUX,Luxembourg,GTM,Guatemala,2008,0,2,-2
LUX,Luxembourg,GTM,Guatemala,2009,0,1,-1
LUX,Luxembourg,GTM,Guatemala,2010,0,1,-1
LUX,Luxembourg,GTM,Guatemala,2011,0,1,-1
LUX,Luxembourg,GTM,Guatemala,2012,0,1,-1
LUX,Luxembourg,GTM,Guatemala,2013,1,5,-4
LUX,Luxembourg,GTM,Guatemala,2014,2,5,-3
LUX,Luxembourg,GTM,Guatemala,2015,0,5,-5
LUX,Luxembourg,GTM,Guatemala,2016,3,4,-1
LUX,Luxembourg,GTM,Guatemala,2017,0,3,-3
MEX,Mexico,GTM,Guatemala,2008,0,1005,-1005
MEX,Mexico,GTM,Guatemala,2009,0,2080,-2080
MEX,Mexico,GTM,Guatemala,2010,0,1799,-1799
MEX,Mexico,GTM,Guatemala,2011,0,1271,-1271
MEX,Mexico,GTM,Guatemala,2012,0,479,-479
MEX,Mexico,GTM,Guatemala,2013,0,3139,-3139
MEX,Mexico,GTM,Guatemala,2014,0,2640,-2640
MEX,Mexico,GTM,Guatemala,2015,0,1609,-1609
MEX,Mexico,GTM,Guatemala,2016,0,1670,-1670
MEX,Mexico,GTM,Guatemala,2017,0,1784,-1784
NLD,Netherlands,GTM,Guatemala,2008,8,30,-22
NLD,Netherlands,GTM,Guatemala,2009,15,21,-6
NLD,Netherlands,GTM,Guatemala,2010,11,23,-12
NLD,Netherlands,GTM,Guatemala,2011,13,22,-9
NLD,Netherlands,GTM,Guatemala,2012,10,37,-27
NLD,Netherlands,GTM,Guatemala,2013,13,22,-9
NLD,Netherlands,GTM,Guatemala,2014,14,25,-11
NLD,Netherlands,GTM,Guatemala,2015,20,24,-4
NLD,Netherlands,GTM,Guatemala,2016,12,19,-7
NLD,Netherlands,GTM,Guatemala,2017,16,34,-18
NZL,New Zealand,GTM,Guatemala,2008,0,4,-4
NZL,New Zealand,GTM,Guatemala,2009,1,3,-2
NZL,New Zealand,GTM,Guatemala,2010,1,6,-5
NZL,New Zealand,GTM,Guatemala,2011,2,2,0
NZL,New Zealand,GTM,Guatemala,2012,2,2,0
NZL,New Zealand,GTM,Guatemala,2013,1,4,-3
NZL,New Zealand,GTM,Guatemala,2014,2,5,-3
NZL,New Zealand,GTM,Guatemala,2015,5,5,0
NZL,New Zealand,GTM,Guatemala,2016,1,1,0
NZL,New Zealand,GTM,Guatemala,2017,2,4,-2
NOR,Norway,GTM,Guatemala,2008,13,22,-9
NOR,Norway,GTM,Guatemala,2009,17,19,-2
NOR,Norway,GTM,Guatemala,2010,5,22,-17
NOR,Norway,GTM,Guatemala,2011,8,10,-2
NOR,Norway,GTM,Guatemala,2012,6,16,-10
NOR,Norway,GTM,Guatemala,2013,2,8,-6
NOR,Norway,GTM,Guatemala,2014,6,10,-4
NOR,Norway,GTM,Guatemala,2015,4,7,-3
NOR,Norway,GTM,Guatemala,2016,1,10,-9
NOR,Norway,GTM,Guatemala,2017,6,13,-7
POL,Poland,GTM,Guatemala,2009,0,5,-5
POL,Poland,GTM,Guatemala,2010,0,9,-9
POL,Poland,GTM,Guatemala,2011,0,10,-10
POL,Poland,GTM,Guatemala,2012,0,9,-9
POL,Poland,GTM,Guatemala,2013,0,14,-14
POL,Poland,GTM,Guatemala,2014,0,4,-4
POL,Poland,GTM,Guatemala,2015,0,10,-10
POL,Poland,GTM,Guatemala,2016,0,7,-7
POL,Poland,GTM,Guatemala,2017,0,10,-10
SVK,Slovak Republic,GTM,Guatemala,2008,0,4,-4
SVK,Slovak Republic,GTM,Guatemala,2010,0,1,-1
ESP,Spain,GTM,Guatemala,2008,307,962,-655
ESP,Spain,GTM,Guatemala,2009,379,666,-287
ESP,Spain,GTM,Guatemala,2010,350,739,-389
ESP,Spain,GTM,Guatemala,2011,333,753,-420
ESP,Spain,GTM,Guatemala,2012,423,628,-205
ESP,Spain,GTM,Guatemala,2013,521,552,-31
ESP,Spain,GTM,Guatemala,2014,272,726,-454
ESP,Spain,GTM,Guatemala,2015,193,817,-624
ESP,Spain,GTM,Guatemala,2016,225,998,-773
ESP,Spain,GTM,Guatemala,2017,352,1420,-1068
SWE,Sweden,GTM,Guatemala,2008,3,20,-17
SWE,Sweden,GTM,Guatemala,2009,0,20,-20
SWE,Sweden,GTM,Guatemala,2010,5,16,-11
SWE,Sweden,GTM,Guatemala,2011,4,7,-3
SWE,Sweden,GTM,Guatemala,2012,3,22,-19
SWE,Sweden,GTM,Guatemala,2013,2,8,-6
SWE,Sweden,GTM,Guatemala,2014,4,15,-11
SWE,Sweden,GTM,Guatemala,2015,10,14,-4
SWE,Sweden,GTM,Guatemala,2016,3,12,-9
SWE,Sweden,GTM,Guatemala,2017,5,16,-11
CHE,Switzerland,GTM,Guatemala,2010,12,32,-20
CHE,Switzerland,GTM,Guatemala,2011,13,40,-27
CHE,Switzerland,GTM,Guatemala,2012,17,40,-23
CHE,Switzerland,GTM,Guatemala,2013,21,29,-8
CHE,Switzerland,GTM,Guatemala,2014,17,27,-10
CHE,Switzerland,GTM,Guatemala,2015,11,32,-21
CHE,Switzerland,GTM,Guatemala,2016,6,29,-23
CHE,Switzerland,GTM,Guatemala,2017,10,39,-29
USA,United States,GTM,Guatemala,2008,0,16182,-16182
USA,United States,GTM,Guatemala,2009,0,12187,-12187
USA,United States,GTM,Guatemala,2010,0,10467,-10467
USA,United States,GTM,Guatemala,2011,0,11092,-11092
USA,United States,GTM,Guatemala,2012,0,10341,-10341
USA,United States,GTM,Guatemala,2013,0,10224,-10224
USA,United States,GTM,Guatemala,2014,0,10238,-10238
USA,United States,GTM,Guatemala,2015,0,11773,-11773
USA,United States,GTM,Guatemala,2016,0,13002,-13002
USA,United States,GTM,Guatemala,2017,0,13198,-13198
CHL,Chile,GTM,Guatemala,2008,0,56,-56
CHL,Chile,GTM,Guatemala,2009,0,48,-48
CHL,Chile,GTM,Guatemala,2010,0,65,-65
CHL,Chile,GTM,Guatemala,2011,0,80,-80
CHL,Chile,GTM,Guatemala,2012,0,110,-110
CHL,Chile,GTM,Guatemala,2013,0,106,-106
CHL,Chile,GTM,Guatemala,2014,0,57,-57
CHL,Chile,GTM,Guatemala,2015,0,72,-72
CHL,Chile,GTM,Guatemala,2016,0,70,-70
EST,Estonia,GTM,Guatemala,2008,0,0,0
EST,Estonia,GTM,Guatemala,2009,0,1,-1
EST,Estonia,GTM,Guatemala,2010,0,2,-2
EST,Estonia,GTM,Guatemala,2011,0,1,-1
EST,Estonia,GTM,Guatemala,2012,0,1,-1
EST,Estonia,GTM,Guatemala,2013,0,0,0
EST,Estonia,GTM,Guatemala,2014,0,1,-1
EST,Estonia,GTM,Guatemala,2015,0,1,-1
EST,Estonia,GTM,Guatemala,2016,0,2,-2
EST,Estonia,GTM,Guatemala,2017,0,0,0
AUS,Australia,GIN,Guinea,2008,0,20,-20
AUS,Australia,GIN,Guinea,2009,0,14,-14
AUS,Australia,GIN,Guinea,2010,0,51,-51
AUS,Australia,GIN,Guinea,2011,0,17,-17
AUS,Australia,GIN,Guinea,2012,0,38,-38
AUS,Australia,GIN,Guinea,2013,0,23,-23
AUS,Australia,GIN,Guinea,2014,0,23,-23
AUS,Australia,GIN,Guinea,2015,0,14,-14
AUS,Australia,GIN,Guinea,2016,0,20,-20
AUS,Australia,GIN,Guinea,2017,0,52,-52
AUT,Austria,GIN,Guinea,2008,24,45,-21
AUT,Austria,GIN,Guinea,2009,33,68,-35
AUT,Austria,GIN,Guinea,2010,38,48,-10
AUT,Austria,GIN,Guinea,2011,44,62,-18
AUT,Austria,GIN,Guinea,2012,54,55,-1
AUT,Austria,GIN,Guinea,2013,46,60,-14
AUT,Austria,GIN,Guinea,2014,30,44,-14
AUT,Austria,GIN,Guinea,2015,29,43,-14
AUT,Austria,GIN,Guinea,2016,23,66,-43
AUT,Austria,GIN,Guinea,2017,47,70,-23
BEL,Belgium,GIN,Guinea,2008,0,287,-287
BEL,Belgium,GIN,Guinea,2009,0,518,-518
BEL,Belgium,GIN,Guinea,2010,48,460,-412
BEL,Belgium,GIN,Guinea,2011,0,659,-659
BEL,Belgium,GIN,Guinea,2012,515,1894,-1379
BEL,Belgium,GIN,Guinea,2013,960,1582,-622
BEL,Belgium,GIN,Guinea,2014,818,1084,-266
BEL,Belgium,GIN,Guinea,2015,698,1215,-517
BEL,Belgium,GIN,Guinea,2016,279,1057,-778
BEL,Belgium,GIN,Guinea,2017,188,1166,-978
CAN,Canada,GIN,Guinea,2008,0,327,-327
CAN,Canada,GIN,Guinea,2009,0,347,-347
CAN,Canada,GIN,Guinea,2010,0,395,-395
CAN,Canada,GIN,Guinea,2011,0,352,-352
CAN,Canada,GIN,Guinea,2012,0,406,-406
CAN,Canada,GIN,Guinea,2013,0,462,-462
CAN,Canada,GIN,Guinea,2014,0,365,-365
CAN,Canada,GIN,Guinea,2015,0,244,-244
CAN,Canada,GIN,Guinea,2016,0,410,-410
CAN,Canada,GIN,Guinea,2017,0,380,-380
CZE,Czech Republic,GIN,Guinea,2008,0,6,-6
CZE,Czech Republic,GIN,Guinea,2009,0,5,-5
CZE,Czech Republic,GIN,Guinea,2010,0,2,-2
CZE,Czech Republic,GIN,Guinea,2011,0,2,-2
CZE,Czech Republic,GIN,Guinea,2012,2,4,-2
CZE,Czech Republic,GIN,Guinea,2013,3,8,-5
CZE,Czech Republic,GIN,Guinea,2014,6,11,-5
CZE,Czech Republic,GIN,Guinea,2015,7,6,1
CZE,Czech Republic,GIN,Guinea,2016,1,10,-9
CZE,Czech Republic,GIN,Guinea,2017,7,2,5
DNK,Denmark,GIN,Guinea,2008,0,2,-2
DNK,Denmark,GIN,Guinea,2009,1,3,-2
DNK,Denmark,GIN,Guinea,2010,0,4,-4
DNK,Denmark,GIN,Guinea,2011,2,5,-3
DNK,Denmark,GIN,Guinea,2012,0,2,-2
DNK,Denmark,GIN,Guinea,2013,0,5,-5
DNK,Denmark,GIN,Guinea,2014,2,8,-6
DNK,Denmark,GIN,Guinea,2015,3,1,2
DNK,Denmark,GIN,Guinea,2016,2,3,-1
DNK,Denmark,GIN,Guinea,2017,9,3,6
FIN,Finland,GIN,Guinea,2008,0,7,-7
FIN,Finland,GIN,Guinea,2009,0,6,-6
FIN,Finland,GIN,Guinea,2010,0,9,-9
FIN,Finland,GIN,Guinea,2011,0,5,-5
FIN,Finland,GIN,Guinea,2012,0,9,-9
FIN,Finland,GIN,Guinea,2013,0,10,-10
FIN,Finland,GIN,Guinea,2014,0,10,-10
FIN,Finland,GIN,Guinea,2015,0,10,-10
FIN,Finland,GIN,Guinea,2016,3,7,-4
FIN,Finland,GIN,Guinea,2017,1,10,-9
FRA,France,GIN,Guinea,2008,0,1506,-1506
FRA,France,GIN,Guinea,2009,0,1483,-1483
FRA,France,GIN,Guinea,2010,0,1647,-1647
FRA,France,GIN,Guinea,2011,0,1661,-1661
FRA,France,GIN,Guinea,2012,0,1937,-1937
FRA,France,GIN,Guinea,2013,0,2045,-2045
FRA,France,GIN,Guinea,2014,0,2391,-2391
FRA,France,GIN,Guinea,2015,0,2282,-2282
FRA,France,GIN,Guinea,2016,0,2535,-2535
FRA,France,GIN,Guinea,2017,0,2625,-2625
DEU,Germany,GIN,Guinea,2008,277,441,-164
DEU,Germany,GIN,Guinea,2009,297,496,-199
DEU,Germany,GIN,Guinea,2010,290,494,-204
DEU,Germany,GIN,Guinea,2011,291,555,-264
DEU,Germany,GIN,Guinea,2012,316,742,-426
DEU,Germany,GIN,Guinea,2013,436,1620,-1184
DEU,Germany,GIN,Guinea,2014,627,1743,-1116
DEU,Germany,GIN,Guinea,2015,718,2151,-1433
DEU,Germany,GIN,Guinea,2016,1182,3064,-1882
DEU,Germany,GIN,Guinea,2017,1827,4394,-2567
HUN,Hungary,GIN,Guinea,2008,0,0,0
HUN,Hungary,GIN,Guinea,2009,0,0,0
HUN,Hungary,GIN,Guinea,2010,0,1,-1
HUN,Hungary,GIN,Guinea,2011,0,0,0
HUN,Hungary,GIN,Guinea,2012,0,0,0
HUN,Hungary,GIN,Guinea,2013,1,2,-1
HUN,Hungary,GIN,Guinea,2014,0,2,-2
HUN,Hungary,GIN,Guinea,2015,0,3,-3
HUN,Hungary,GIN,Guinea,2016,1,14,-13
HUN,Hungary,GIN,Guinea,2017,0,17,-17
ISL,Iceland,GIN,Guinea,2008,0,1,-1
ISL,Iceland,GIN,Guinea,2009,0,2,-2
ISL,Iceland,GIN,Guinea,2010,0,2,-2
ISL,Iceland,GIN,Guinea,2011,0,1,-1
ISL,Iceland,GIN,Guinea,2012,0,2,-2
ISL,Iceland,GIN,Guinea,2013,0,1,-1
ISL,Iceland,GIN,Guinea,2014,0,0,0
ISL,Iceland,GIN,Guinea,2015,0,0,0
ISL,Iceland,GIN,Guinea,2016,1,1,0
ISL,Iceland,GIN,Guinea,2017,0,1,-1
ITA,Italy,GIN,Guinea,2008,14,375,-361
ITA,Italy,GIN,Guinea,2009,14,338,-324
ITA,Italy,GIN,Guinea,2010,12,391,-379
ITA,Italy,GIN,Guinea,2011,11,417,-406
ITA,Italy,GIN,Guinea,2012,21,533,-512
ITA,Italy,GIN,Guinea,2013,16,385,-369
ITA,Italy,GIN,Guinea,2014,19,441,-422
ITA,Italy,GIN,Guinea,2015,33,880,-847
ITA,Italy,GIN,Guinea,2016,0,2297,-2297
ITA,Italy,GIN,Guinea,2017,67,5396,-5329
JPN,Japan,GIN,Guinea,2008,25,30,-5
JPN,Japan,GIN,Guinea,2009,12,20,-8
JPN,Japan,GIN,Guinea,2010,9,15,-6
JPN,Japan,GIN,Guinea,2011,7,13,-6
JPN,Japan,GIN,Guinea,2012,31,43,-12
JPN,Japan,GIN,Guinea,2013,56,67,-11
JPN,Japan,GIN,Guinea,2014,17,32,-15
JPN,Japan,GIN,Guinea,2015,20,39,-19
JPN,Japan,GIN,Guinea,2016,35,66,-31
JPN,Japan,GIN,Guinea,2017,66,84,-18
KOR,Korea,GIN,Guinea,2008,7,8,-1
KOR,Korea,GIN,Guinea,2009,3,2,1
KOR,Korea,GIN,Guinea,2010,4,4,0
KOR,Korea,GIN,Guinea,2011,2,13,-11
KOR,Korea,GIN,Guinea,2012,14,21,-7
KOR,Korea,GIN,Guinea,2013,7,21,-14
KOR,Korea,GIN,Guinea,2014,10,21,-11
KOR,Korea,GIN,Guinea,2015,8,11,-3
KOR,Korea,GIN,Guinea,2016,7,39,-32
KOR,Korea,GIN,Guinea,2017,15,96,-81
LUX,Luxembourg,GIN,Guinea,2008,9,9,0
LUX,Luxembourg,GIN,Guinea,2009,1,11,-10
LUX,Luxembourg,GIN,Guinea,2010,3,7,-4
LUX,Luxembourg,GIN,Guinea,2011,2,7,-5
LUX,Luxembourg,GIN,Guinea,2012,1,16,-15
LUX,Luxembourg,GIN,Guinea,2013,7,12,-5
LUX,Luxembourg,GIN,Guinea,2014,3,27,-24
LUX,Luxembourg,GIN,Guinea,2015,8,28,-20
LUX,Luxembourg,GIN,Guinea,2016,6,65,-59
LUX,Luxembourg,GIN,Guinea,2017,14,37,-23
MEX,Mexico,GIN,Guinea,2008,0,4,-4
MEX,Mexico,GIN,Guinea,2009,0,48,-48
MEX,Mexico,GIN,Guinea,2010,0,4,-4
MEX,Mexico,GIN,Guinea,2011,0,4,-4
MEX,Mexico,GIN,Guinea,2012,0,4,-4
MEX,Mexico,GIN,Guinea,2013,0,13,-13
MEX,Mexico,GIN,Guinea,2014,0,9,-9
MEX,Mexico,GIN,Guinea,2015,0,15,-15
MEX,Mexico,GIN,Guinea,2016,0,9,-9
MEX,Mexico,GIN,Guinea,2017,0,7,-7
NLD,Netherlands,GIN,Guinea,2008,6,29,-23
NLD,Netherlands,GIN,Guinea,2009,6,39,-33
NLD,Netherlands,GIN,Guinea,2010,5,30,-25
NLD,Netherlands,GIN,Guinea,2011,20,31,-11
NLD,Netherlands,GIN,Guinea,2012,11,29,-18
NLD,Netherlands,GIN,Guinea,2013,5,48,-43
NLD,Netherlands,GIN,Guinea,2014,15,70,-55
NLD,Netherlands,GIN,Guinea,2015,13,81,-68
NLD,Netherlands,GIN,Guinea,2016,5,63,-58
NLD,Netherlands,GIN,Guinea,2017,15,73,-58
NZL,New Zealand,GIN,Guinea,2008,0,1,-1
NZL,New Zealand,GIN,Guinea,2009,0,2,-2
NZL,New Zealand,GIN,Guinea,2011,0,1,-1
NZL,New Zealand,GIN,Guinea,2012,0,0,0
NOR,Norway,GIN,Guinea,2008,0,8,-8
NOR,Norway,GIN,Guinea,2009,0,15,-15
NOR,Norway,GIN,Guinea,2010,3,18,-15
NOR,Norway,GIN,Guinea,2011,1,22,-21
NOR,Norway,GIN,Guinea,2012,1,14,-13
NOR,Norway,GIN,Guinea,2013,0,33,-33
NOR,Norway,GIN,Guinea,2014,1,5,-4
NOR,Norway,GIN,Guinea,2015,2,11,-9
NOR,Norway,GIN,Guinea,2016,6,9,-3
NOR,Norway,GIN,Guinea,2017,6,15,-9
POL,Poland,GIN,Guinea,2009,0,36,-36
POL,Poland,GIN,Guinea,2010,0,18,-18
POL,Poland,GIN,Guinea,2011,0,18,-18
POL,Poland,GIN,Guinea,2012,0,20,-20
POL,Poland,GIN,Guinea,2013,0,10,-10
POL,Poland,GIN,Guinea,2014,0,15,-15
POL,Poland,GIN,Guinea,2015,0,17,-17
POL,Poland,GIN,Guinea,2016,0,13,-13
POL,Poland,GIN,Guinea,2017,0,15,-15
PRT,Portugal,GIN,Guinea,2008,0,220,-220
PRT,Portugal,GIN,Guinea,2009,0,142,-142
PRT,Portugal,GIN,Guinea,2010,0,222,-222
PRT,Portugal,GIN,Guinea,2011,0,375,-375
PRT,Portugal,GIN,Guinea,2012,0,253,-253
PRT,Portugal,GIN,Guinea,2013,0,151,-151
PRT,Portugal,GIN,Guinea,2014,0,132,-132
PRT,Portugal,GIN,Guinea,2015,0,128,-128
PRT,Portugal,GIN,Guinea,2016,0,198,-198
PRT,Portugal,GIN,Guinea,2017,0,158,-158
SVK,Slovak Republic,GIN,Guinea,2008,1,0,1
SVK,Slovak Republic,GIN,Guinea,2010,0,2,-2
SVK,Slovak Republic,GIN,Guinea,2011,0,1,-1
ESP,Spain,GIN,Guinea,2008,761,1757,-996
ESP,Spain,GIN,Guinea,2009,1103,1268,-165
ESP,Spain,GIN,Guinea,2010,1209,892,317
ESP,Spain,GIN,Guinea,2011,1512,733,779
ESP,Spain,GIN,Guinea,2012,1268,673,595
ESP,Spain,GIN,Guinea,2013,1420,620,800
ESP,Spain,GIN,Guinea,2014,779,631,148
ESP,Spain,GIN,Guinea,2015,611,709,-98
ESP,Spain,GIN,Guinea,2016,587,797,-210
ESP,Spain,GIN,Guinea,2017,795,752,43
SWE,Sweden,GIN,Guinea,2008,0,31,-31
SWE,Sweden,GIN,Guinea,2009,0,47,-47
SWE,Sweden,GIN,Guinea,2010,2,38,-36
SWE,Sweden,GIN,Guinea,2011,0,41,-41
SWE,Sweden,GIN,Guinea,2012,3,52,-49
SWE,Sweden,GIN,Guinea,2013,0,43,-43
SWE,Sweden,GIN,Guinea,2014,2,43,-41
SWE,Sweden,GIN,Guinea,2015,2,30,-28
SWE,Sweden,GIN,Guinea,2016,0,42,-42
SWE,Sweden,GIN,Guinea,2017,4,36,-32
CHE,Switzerland,GIN,Guinea,2010,24,73,-49
CHE,Switzerland,GIN,Guinea,2011,23,62,-39
CHE,Switzerland,GIN,Guinea,2012,16,54,-38
CHE,Switzerland,GIN,Guinea,2013,20,48,-28
CHE,Switzerland,GIN,Guinea,2014,16,61,-45
CHE,Switzerland,GIN,Guinea,2015,9,69,-60
CHE,Switzerland,GIN,Guinea,2016,10,65,-55
CHE,Switzerland,GIN,Guinea,2017,13,75,-62
TUR,Turkey,GIN,Guinea,2010,0,9,-9
TUR,Turkey,GIN,Guinea,2017,45,255,-210
USA,United States,GIN,Guinea,2008,0,1735,-1735
USA,United States,GIN,Guinea,2009,0,1725,-1725
USA,United States,GIN,Guinea,2010,0,1379,-1379
USA,United States,GIN,Guinea,2011,0,1555,-1555
USA,United States,GIN,Guinea,2012,0,1656,-1656
USA,United States,GIN,Guinea,2013,0,1518,-1518
USA,United States,GIN,Guinea,2014,0,1375,-1375
USA,United States,GIN,Guinea,2015,0,1389,-1389
USA,United States,GIN,Guinea,2016,0,1501,-1501
USA,United States,GIN,Guinea,2017,0,1348,-1348
CHL,Chile,GIN,Guinea,2008,0,1,-1
CHL,Chile,GIN,Guinea,2009,0,1,-1
CHL,Chile,GIN,Guinea,2010,0,0,0
CHL,Chile,GIN,Guinea,2011,0,0,0
CHL,Chile,GIN,Guinea,2012,0,2,-2
CHL,Chile,GIN,Guinea,2013,0,1,-1
CHL,Chile,GIN,Guinea,2014,0,1,-1
CHL,Chile,GIN,Guinea,2015,0,3,-3
CHL,Chile,GIN,Guinea,2016,0,1,-1
EST,Estonia,GIN,Guinea,2008,0,0,0
EST,Estonia,GIN,Guinea,2009,0,0,0
EST,Estonia,GIN,Guinea,2010,0,0,0
EST,Estonia,GIN,Guinea,2011,0,0,0
EST,Estonia,GIN,Guinea,2012,0,1,-1
EST,Estonia,GIN,Guinea,2013,0,0,0
EST,Estonia,GIN,Guinea,2014,0,0,0
EST,Estonia,GIN,Guinea,2015,0,0,0
EST,Estonia,GIN,Guinea,2016,0,0,0
EST,Estonia,GIN,Guinea,2017,0,2,-2
AUS,Australia,GNB,Guinea-Bissau,2008,0,0,0
AUS,Australia,GNB,Guinea-Bissau,2009,0,0,0
AUS,Australia,GNB,Guinea-Bissau,2010,0,0,0
AUS,Australia,GNB,Guinea-Bissau,2011,0,1,-1
AUS,Australia,GNB,Guinea-Bissau,2012,0,0,0
AUS,Australia,GNB,Guinea-Bissau,2013,0,0,0
AUS,Australia,GNB,Guinea-Bissau,2014,0,0,0
AUS,Australia,GNB,Guinea-Bissau,2015,0,0,0
AUS,Australia,GNB,Guinea-Bissau,2017,0,3,-3
AUT,Austria,GNB,Guinea-Bissau,2008,23,20,3
AUT,Austria,GNB,Guinea-Bissau,2009,25,23,2
AUT,Austria,GNB,Guinea-Bissau,2010,21,19,2
AUT,Austria,GNB,Guinea-Bissau,2011,16,27,-11
AUT,Austria,GNB,Guinea-Bissau,2012,30,11,19
AUT,Austria,GNB,Guinea-Bissau,2013,12,23,-11
AUT,Austria,GNB,Guinea-Bissau,2014,11,9,2
AUT,Austria,GNB,Guinea-Bissau,2015,11,8,3
AUT,Austria,GNB,Guinea-Bissau,2016,7,9,-2
AUT,Austria,GNB,Guinea-Bissau,2017,5,6,-1
BEL,Belgium,GNB,Guinea-Bissau,2008,0,7,-7
BEL,Belgium,GNB,Guinea-Bissau,2009,0,3,-3
BEL,Belgium,GNB,Guinea-Bissau,2010,2,3,-1
BEL,Belgium,GNB,Guinea-Bissau,2012,14,25,-11
BEL,Belgium,GNB,Guinea-Bissau,2013,15,18,-3
BEL,Belgium,GNB,Guinea-Bissau,2014,13,9,4
BEL,Belgium,GNB,Guinea-Bissau,2015,11,11,0
BEL,Belgium,GNB,Guinea-Bissau,2016,1,13,-12
BEL,Belgium,GNB,Guinea-Bissau,2017,2,11,-9
CAN,Canada,GNB,Guinea-Bissau,2008,0,2,-2
CAN,Canada,GNB,Guinea-Bissau,2009,0,0,0
CAN,Canada,GNB,Guinea-Bissau,2010,0,2,-2
CAN,Canada,GNB,Guinea-Bissau,2011,0,2,-2
CAN,Canada,GNB,Guinea-Bissau,2012,0,4,-4
CAN,Canada,GNB,Guinea-Bissau,2013,0,0,0
CAN,Canada,GNB,Guinea-Bissau,2014,0,4,-4
CAN,Canada,GNB,Guinea-Bissau,2015,0,5,-5
CAN,Canada,GNB,Guinea-Bissau,2016,0,5,-5
CAN,Canada,GNB,Guinea-Bissau,2017,0,0,0
CZE,Czech Republic,GNB,Guinea-Bissau,2008,1,4,-3
CZE,Czech Republic,GNB,Guinea-Bissau,2009,0,1,-1
CZE,Czech Republic,GNB,Guinea-Bissau,2011,0,2,-2
DNK,Denmark,GNB,Guinea-Bissau,2008,0,2,-2
DNK,Denmark,GNB,Guinea-Bissau,2009,3,5,-2
DNK,Denmark,GNB,Guinea-Bissau,2010,1,5,-4
DNK,Denmark,GNB,Guinea-Bissau,2011,3,1,2
DNK,Denmark,GNB,Guinea-Bissau,2012,0,3,-3
DNK,Denmark,GNB,Guinea-Bissau,2013,0,5,-5
DNK,Denmark,GNB,Guinea-Bissau,2014,1,6,-5
DNK,Denmark,GNB,Guinea-Bissau,2015,0,3,-3
DNK,Denmark,GNB,Guinea-Bissau,2016,1,1,0
DNK,Denmark,GNB,Guinea-Bissau,2017,2,0,2
FIN,Finland,GNB,Guinea-Bissau,2008,0,0,0
FIN,Finland,GNB,Guinea-Bissau,2009,0,0,0
FIN,Finland,GNB,Guinea-Bissau,2010,0,1,-1
FIN,Finland,GNB,Guinea-Bissau,2011,0,0,0
FIN,Finland,GNB,Guinea-Bissau,2012,1,0,1
FIN,Finland,GNB,Guinea-Bissau,2013,0,1,-1
FIN,Finland,GNB,Guinea-Bissau,2014,0,1,-1
FIN,Finland,GNB,Guinea-Bissau,2015,0,1,-1
FIN,Finland,GNB,Guinea-Bissau,2016,0,0,0
FIN,Finland,GNB,Guinea-Bissau,2017,0,0,0
FRA,France,GNB,Guinea-Bissau,2008,0,117,-117
FRA,France,GNB,Guinea-Bissau,2009,0,104,-104
FRA,France,GNB,Guinea-Bissau,2010,0,127,-127
FRA,France,GNB,Guinea-Bissau,2011,0,110,-110
FRA,France,GNB,Guinea-Bissau,2012,0,180,-180
FRA,France,GNB,Guinea-Bissau,2013,0,127,-127
FRA,France,GNB,Guinea-Bissau,2014,0,212,-212
FRA,France,GNB,Guinea-Bissau,2015,0,224,-224
FRA,France,GNB,Guinea-Bissau,2016,0,203,-203
FRA,France,GNB,Guinea-Bissau,2017,0,170,-170
DEU,Germany,GNB,Guinea-Bissau,2008,38,67,-29
DEU,Germany,GNB,Guinea-Bissau,2009,61,65,-4
DEU,Germany,GNB,Guinea-Bissau,2010,48,60,-12
DEU,Germany,GNB,Guinea-Bissau,2011,44,75,-31
DEU,Germany,GNB,Guinea-Bissau,2012,50,148,-98
DEU,Germany,GNB,Guinea-Bissau,2013,81,299,-218
DEU,Germany,GNB,Guinea-Bissau,2014,182,442,-260
DEU,Germany,GNB,Guinea-Bissau,2015,287,715,-428
DEU,Germany,GNB,Guinea-Bissau,2016,462,672,-210
DEU,Germany,GNB,Guinea-Bissau,2017,561,460,101
HUN,Hungary,GNB,Guinea-Bissau,2008,0,0,0
HUN,Hungary,GNB,Guinea-Bissau,2009,0,0,0
HUN,Hungary,GNB,Guinea-Bissau,2010,0,0,0
HUN,Hungary,GNB,Guinea-Bissau,2011,0,0,0
HUN,Hungary,GNB,Guinea-Bissau,2012,0,0,0
HUN,Hungary,GNB,Guinea-Bissau,2013,0,1,-1
HUN,Hungary,GNB,Guinea-Bissau,2014,0,0,0
HUN,Hungary,GNB,Guinea-Bissau,2015,0,1,-1
HUN,Hungary,GNB,Guinea-Bissau,2016,0,0,0
HUN,Hungary,GNB,Guinea-Bissau,2017,0,0,0
ISL,Iceland,GNB,Guinea-Bissau,2008,0,0,0
ISL,Iceland,GNB,Guinea-Bissau,2009,0,0,0
ISL,Iceland,GNB,Guinea-Bissau,2010,0,0,0
ISL,Iceland,GNB,Guinea-Bissau,2011,0,0,0
ISL,Iceland,GNB,Guinea-Bissau,2012,0,0,0
ISL,Iceland,GNB,Guinea-Bissau,2013,0,0,0
ISL,Iceland,GNB,Guinea-Bissau,2014,0,0,0
ISL,Iceland,GNB,Guinea-Bissau,2015,0,0,0
ISL,Iceland,GNB,Guinea-Bissau,2016,0,1,-1
ISL,Iceland,GNB,Guinea-Bissau,2017,0,0,0
ITA,Italy,GNB,Guinea-Bissau,2008,0,30,-30
ITA,Italy,GNB,Guinea-Bissau,2009,0,71,-71
ITA,Italy,GNB,Guinea-Bissau,2010,2,53,-51
ITA,Italy,GNB,Guinea-Bissau,2011,1,42,-41
ITA,Italy,GNB,Guinea-Bissau,2012,5,115,-110
ITA,Italy,GNB,Guinea-Bissau,2013,1,108,-107
ITA,Italy,GNB,Guinea-Bissau,2014,6,146,-140
ITA,Italy,GNB,Guinea-Bissau,2015,8,336,-328
ITA,Italy,GNB,Guinea-Bissau,2016,0,501,-501
ITA,Italy,GNB,Guinea-Bissau,2017,11,815,-804
JPN,Japan,GNB,Guinea-Bissau,2008,12,13,-1
JPN,Japan,GNB,Guinea-Bissau,2009,10,10,0
JPN,Japan,GNB,Guinea-Bissau,2010,23,24,-1
JPN,Japan,GNB,Guinea-Bissau,2011,6,6,0
JPN,Japan,GNB,Guinea-Bissau,2012,4,4,0
JPN,Japan,GNB,Guinea-Bissau,2013,3,4,-1
JPN,Japan,GNB,Guinea-Bissau,2014,3,4,-1
JPN,Japan,GNB,Guinea-Bissau,2015,22,22,0
JPN,Japan,GNB,Guinea-Bissau,2016,10,11,-1
JPN,Japan,GNB,Guinea-Bissau,2017,8,10,-2
KOR,Korea,GNB,Guinea-Bissau,2008,0,1,-1
KOR,Korea,GNB,Guinea-Bissau,2009,0,1,-1
KOR,Korea,GNB,Guinea-Bissau,2010,0,1,-1
KOR,Korea,GNB,Guinea-Bissau,2011,0,0,0
KOR,Korea,GNB,Guinea-Bissau,2012,2,1,1
KOR,Korea,GNB,Guinea-Bissau,2013,0,0,0
KOR,Korea,GNB,Guinea-Bissau,2014,3,0,3
KOR,Korea,GNB,Guinea-Bissau,2015,0,2,-2
KOR,Korea,GNB,Guinea-Bissau,2016,0,2,-2
KOR,Korea,GNB,Guinea-Bissau,2017,1,7,-6
LUX,Luxembourg,GNB,Guinea-Bissau,2008,4,12,-8
LUX,Luxembourg,GNB,Guinea-Bissau,2009,0,22,-22
LUX,Luxembourg,GNB,Guinea-Bissau,2010,1,7,-6
LUX,Luxembourg,GNB,Guinea-Bissau,2011,2,31,-29
LUX,Luxembourg,GNB,Guinea-Bissau,2012,1,33,-32
LUX,Luxembourg,GNB,Guinea-Bissau,2013,5,33,-28
LUX,Luxembourg,GNB,Guinea-Bissau,2014,3,37,-34
LUX,Luxembourg,GNB,Guinea-Bissau,2015,5,34,-29
LUX,Luxembourg,GNB,Guinea-Bissau,2016,5,55,-50
LUX,Luxembourg,GNB,Guinea-Bissau,2017,3,45,-42
MEX,Mexico,GNB,Guinea-Bissau,2010,0,1,-1
MEX,Mexico,GNB,Guinea-Bissau,2011,0,1,-1
MEX,Mexico,GNB,Guinea-Bissau,2012,0,0,0
MEX,Mexico,GNB,Guinea-Bissau,2013,0,1,-1
MEX,Mexico,GNB,Guinea-Bissau,2014,0,1,-1
MEX,Mexico,GNB,Guinea-Bissau,2016,0,0,0
NLD,Netherlands,GNB,Guinea-Bissau,2008,0,3,-3
NLD,Netherlands,GNB,Guinea-Bissau,2009,2,2,0
NLD,Netherlands,GNB,Guinea-Bissau,2010,-2,2,-4
NLD,Netherlands,GNB,Guinea-Bissau,2011,4,3,1
NLD,Netherlands,GNB,Guinea-Bissau,2012,1,1,0
NLD,Netherlands,GNB,Guinea-Bissau,2013,2,7,-5
NLD,Netherlands,GNB,Guinea-Bissau,2014,2,4,-2
NLD,Netherlands,GNB,Guinea-Bissau,2015,2,4,-2
NLD,Netherlands,GNB,Guinea-Bissau,2016,6,7,-1
NLD,Netherlands,GNB,Guinea-Bissau,2017,1,4,-3
NZL,New Zealand,GNB,Guinea-Bissau,2012,0,0,0
NOR,Norway,GNB,Guinea-Bissau,2008,0,3,-3
NOR,Norway,GNB,Guinea-Bissau,2009,1,0,1
NOR,Norway,GNB,Guinea-Bissau,2010,0,1,-1
NOR,Norway,GNB,Guinea-Bissau,2011,0,2,-2
NOR,Norway,GNB,Guinea-Bissau,2012,0,2,-2
NOR,Norway,GNB,Guinea-Bissau,2013,1,5,-4
NOR,Norway,GNB,Guinea-Bissau,2014,0,0,0
NOR,Norway,GNB,Guinea-Bissau,2015,0,2,-2
NOR,Norway,GNB,Guinea-Bissau,2016,0,0,0
NOR,Norway,GNB,Guinea-Bissau,2017,0,0,0
POL,Poland,GNB,Guinea-Bissau,2009,0,4,-4
POL,Poland,GNB,Guinea-Bissau,2010,0,5,-5
POL,Poland,GNB,Guinea-Bissau,2011,0,4,-4
POL,Poland,GNB,Guinea-Bissau,2012,0,1,-1
POL,Poland,GNB,Guinea-Bissau,2013,0,0,0
POL,Poland,GNB,Guinea-Bissau,2014,0,0,0
POL,Poland,GNB,Guinea-Bissau,2015,0,1,-1
POL,Poland,GNB,Guinea-Bissau,2016,0,1,-1
POL,Poland,GNB,Guinea-Bissau,2017,0,2,-2
PRT,Portugal,GNB,Guinea-Bissau,2008,0,2455,-2455
PRT,Portugal,GNB,Guinea-Bissau,2009,0,1485,-1485
PRT,Portugal,GNB,Guinea-Bissau,2010,0,1567,-1567
PRT,Portugal,GNB,Guinea-Bissau,2011,0,1744,-1744
PRT,Portugal,GNB,Guinea-Bissau,2012,0,1620,-1620
PRT,Portugal,GNB,Guinea-Bissau,2013,0,1235,-1235
PRT,Portugal,GNB,Guinea-Bissau,2014,0,1239,-1239
PRT,Portugal,GNB,Guinea-Bissau,2015,0,1129,-1129
PRT,Portugal,GNB,Guinea-Bissau,2016,0,951,-951
PRT,Portugal,GNB,Guinea-Bissau,2017,0,1120,-1120
SVK,Slovak Republic,GNB,Guinea-Bissau,2008,0,0,0
ESP,Spain,GNB,Guinea-Bissau,2008,494,690,-196
ESP,Spain,GNB,Guinea-Bissau,2009,568,384,184
ESP,Spain,GNB,Guinea-Bissau,2010,545,275,270
ESP,Spain,GNB,Guinea-Bissau,2011,477,325,152
ESP,Spain,GNB,Guinea-Bissau,2012,418,355,63
ESP,Spain,GNB,Guinea-Bissau,2013,499,302,197
ESP,Spain,GNB,Guinea-Bissau,2014,314,309,5
ESP,Spain,GNB,Guinea-Bissau,2015,179,296,-117
ESP,Spain,GNB,Guinea-Bissau,2016,242,243,-1
ESP,Spain,GNB,Guinea-Bissau,2017,350,265,85
SWE,Sweden,GNB,Guinea-Bissau,2008,1,4,-3
SWE,Sweden,GNB,Guinea-Bissau,2009,1,5,-4
SWE,Sweden,GNB,Guinea-Bissau,2010,0,9,-9
SWE,Sweden,GNB,Guinea-Bissau,2011,0,3,-3
SWE,Sweden,GNB,Guinea-Bissau,2012,0,6,-6
SWE,Sweden,GNB,Guinea-Bissau,2013,1,4,-3
SWE,Sweden,GNB,Guinea-Bissau,2014,1,5,-4
SWE,Sweden,GNB,Guinea-Bissau,2015,0,5,-5
SWE,Sweden,GNB,Guinea-Bissau,2016,0,1,-1
SWE,Sweden,GNB,Guinea-Bissau,2017,1,2,-1
CHE,Switzerland,GNB,Guinea-Bissau,2010,1,5,-4
CHE,Switzerland,GNB,Guinea-Bissau,2011,1,13,-12
CHE,Switzerland,GNB,Guinea-Bissau,2012,4,11,-7
CHE,Switzerland,GNB,Guinea-Bissau,2013,2,8,-6
CHE,Switzerland,GNB,Guinea-Bissau,2014,1,7,-6
CHE,Switzerland,GNB,Guinea-Bissau,2015,0,5,-5
CHE,Switzerland,GNB,Guinea-Bissau,2016,0,7,-7
CHE,Switzerland,GNB,Guinea-Bissau,2017,0,13,-13
USA,United States,GNB,Guinea-Bissau,2008,0,17,-17
USA,United States,GNB,Guinea-Bissau,2009,0,20,-20
USA,United States,GNB,Guinea-Bissau,2010,0,30,-30
USA,United States,GNB,Guinea-Bissau,2011,0,29,-29
USA,United States,GNB,Guinea-Bissau,2012,0,47,-47
USA,United States,GNB,Guinea-Bissau,2013,0,43,-43
USA,United States,GNB,Guinea-Bissau,2014,0,30,-30
USA,United States,GNB,Guinea-Bissau,2015,0,39,-39
USA,United States,GNB,Guinea-Bissau,2016,0,37,-37
USA,United States,GNB,Guinea-Bissau,2017,0,48,-48
CHL,Chile,GNB,Guinea-Bissau,2008,0,0,0
CHL,Chile,GNB,Guinea-Bissau,2009,0,0,0
CHL,Chile,GNB,Guinea-Bissau,2010,0,0,0
CHL,Chile,GNB,Guinea-Bissau,2011,0,0,0
CHL,Chile,GNB,Guinea-Bissau,2012,0,0,0
CHL,Chile,GNB,Guinea-Bissau,2013,0,1,-1
CHL,Chile,GNB,Guinea-Bissau,2014,0,0,0
CHL,Chile,GNB,Guinea-Bissau,2015,0,1,-1
CHL,Chile,GNB,Guinea-Bissau,2016,0,0,0
EST,Estonia,GNB,Guinea-Bissau,2008,0,0,0
EST,Estonia,GNB,Guinea-Bissau,2009,0,0,0
EST,Estonia,GNB,Guinea-Bissau,2010,0,0,0
EST,Estonia,GNB,Guinea-Bissau,2011,0,0,0
EST,Estonia,GNB,Guinea-Bissau,2012,0,0,0
EST,Estonia,GNB,Guinea-Bissau,2013,0,0,0
EST,Estonia,GNB,Guinea-Bissau,2014,0,0,0
EST,Estonia,GNB,Guinea-Bissau,2015,0,0,0
EST,Estonia,GNB,Guinea-Bissau,2016,0,0,0
EST,Estonia,GNB,Guinea-Bissau,2017,0,0,0
SVN,Slovenia,GNB,Guinea-Bissau,2011,0,1,-1
SVN,Slovenia,GNB,Guinea-Bissau,2017,0,3,-3
AUS,Australia,GUY,Guyana,2008,0,2,-2
AUS,Australia,GUY,Guyana,2009,0,6,-6
AUS,Australia,GUY,Guyana,2010,0,2,-2
AUS,Australia,GUY,Guyana,2011,0,2,-2
AUS,Australia,GUY,Guyana,2012,0,6,-6
AUS,Australia,GUY,Guyana,2013,9,6,3
AUS,Australia,GUY,Guyana,2014,6,5,1
AUS,Australia,GUY,Guyana,2015,0,0,0
AUS,Australia,GUY,Guyana,2017,0,3,-3
AUT,Austria,GUY,Guyana,2008,1,0,1
AUT,Austria,GUY,Guyana,2009,1,1,0
AUT,Austria,GUY,Guyana,2010,0,2,-2
AUT,Austria,GUY,Guyana,2011,2,0,2
AUT,Austria,GUY,Guyana,2012,0,0,0
AUT,Austria,GUY,Guyana,2013,0,0,0
AUT,Austria,GUY,Guyana,2014,1,0,1
AUT,Austria,GUY,Guyana,2015,0,0,0
AUT,Austria,GUY,Guyana,2016,0,0,0
AUT,Austria,GUY,Guyana,2017,0,1,-1
BEL,Belgium,GUY,Guyana,2008,0,4,-4
BEL,Belgium,GUY,Guyana,2009,0,4,-4
BEL,Belgium,GUY,Guyana,2010,3,2,1
BEL,Belgium,GUY,Guyana,2012,2,4,-2
BEL,Belgium,GUY,Guyana,2013,1,2,-1
BEL,Belgium,GUY,Guyana,2014,0,7,-7
BEL,Belgium,GUY,Guyana,2015,3,6,-3
BEL,Belgium,GUY,Guyana,2016,1,4,-3
BEL,Belgium,GUY,Guyana,2017,2,2,0
CAN,Canada,GUY,Guyana,2008,0,1137,-1137
CAN,Canada,GUY,Guyana,2009,0,1180,-1180
CAN,Canada,GUY,Guyana,2010,0,953,-953
CAN,Canada,GUY,Guyana,2011,0,803,-803
CAN,Canada,GUY,Guyana,2012,0,671,-671
CAN,Canada,GUY,Guyana,2013,0,656,-656
CAN,Canada,GUY,Guyana,2014,0,784,-784
CAN,Canada,GUY,Guyana,2015,0,540,-540
CAN,Canada,GUY,Guyana,2016,0,515,-515
CAN,Canada,GUY,Guyana,2017,0,430,-430
CZE,Czech Republic,GUY,Guyana,2010,0,1,-1
DNK,Denmark,GUY,Guyana,2008,0,0,0
DNK,Denmark,GUY,Guyana,2009,0,0,0
DNK,Denmark,GUY,Guyana,2012,0,0,0
DNK,Denmark,GUY,Guyana,2013,0,0,0
DNK,Denmark,GUY,Guyana,2014,1,1,0
DNK,Denmark,GUY,Guyana,2015,0,0,0
DNK,Denmark,GUY,Guyana,2016,0,0,0
DNK,Denmark,GUY,Guyana,2017,0,1,-1
FIN,Finland,GUY,Guyana,2008,1,0,1
FIN,Finland,GUY,Guyana,2009,0,0,0
FIN,Finland,GUY,Guyana,2010,0,4,-4
FIN,Finland,GUY,Guyana,2011,0,1,-1
FIN,Finland,GUY,Guyana,2012,0,0,0
FIN,Finland,GUY,Guyana,2013,0,0,0
FIN,Finland,GUY,Guyana,2014,0,1,-1
FIN,Finland,GUY,Guyana,2015,1,1,0
FIN,Finland,GUY,Guyana,2016,0,0,0
FIN,Finland,GUY,Guyana,2017,1,0,1
FRA,France,GUY,Guyana,2008,0,119,-119
FRA,France,GUY,Guyana,2009,0,124,-124
FRA,France,GUY,Guyana,2010,0,194,-194
FRA,France,GUY,Guyana,2011,0,129,-129
FRA,France,GUY,Guyana,2012,0,161,-161
FRA,France,GUY,Guyana,2013,0,234,-234
FRA,France,GUY,Guyana,2014,0,184,-184
FRA,France,GUY,Guyana,2015,0,162,-162
FRA,France,GUY,Guyana,2016,0,146,-146
FRA,France,GUY,Guyana,2017,0,111,-111
DEU,Germany,GUY,Guyana,2008,9,6,3
DEU,Germany,GUY,Guyana,2009,6,7,-1
DEU,Germany,GUY,Guyana,2010,5,5,0
DEU,Germany,GUY,Guyana,2011,4,10,-6
DEU,Germany,GUY,Guyana,2012,6,5,1
DEU,Germany,GUY,Guyana,2013,7,8,-1
DEU,Germany,GUY,Guyana,2014,2,8,-6
DEU,Germany,GUY,Guyana,2015,10,7,3
DEU,Germany,GUY,Guyana,2016,8,11,-3
DEU,Germany,GUY,Guyana,2017,1,4,-3
HUN,Hungary,GUY,Guyana,2008,0,0,0
HUN,Hungary,GUY,Guyana,2009,0,0,0
HUN,Hungary,GUY,Guyana,2010,0,0,0
HUN,Hungary,GUY,Guyana,2011,0,0,0
HUN,Hungary,GUY,Guyana,2012,0,1,-1
HUN,Hungary,GUY,Guyana,2013,0,1,-1
HUN,Hungary,GUY,Guyana,2014,0,0,0
HUN,Hungary,GUY,Guyana,2015,0,1,-1
HUN,Hungary,GUY,Guyana,2016,0,0,0
HUN,Hungary,GUY,Guyana,2017,0,2,-2
ISL,Iceland,GUY,Guyana,2008,2,0,2
ISL,Iceland,GUY,Guyana,2009,0,0,0
ISL,Iceland,GUY,Guyana,2010,0,0,0
ISL,Iceland,GUY,Guyana,2011,0,0,0
ISL,Iceland,GUY,Guyana,2012,0,0,0
ISL,Iceland,GUY,Guyana,2013,0,0,0
ISL,Iceland,GUY,Guyana,2014,0,1,-1
ISL,Iceland,GUY,Guyana,2015,0,1,-1
ISL,Iceland,GUY,Guyana,2016,0,0,0
ISL,Iceland,GUY,Guyana,2017,0,0,0
ITA,Italy,GUY,Guyana,2008,0,5,-5
ITA,Italy,GUY,Guyana,2009,0,1,-1
ITA,Italy,GUY,Guyana,2010,0,2,-2
ITA,Italy,GUY,Guyana,2011,0,3,-3
ITA,Italy,GUY,Guyana,2012,0,4,-4
ITA,Italy,GUY,Guyana,2013,1,5,-4
ITA,Italy,GUY,Guyana,2014,0,6,-6
ITA,Italy,GUY,Guyana,2015,0,4,-4
ITA,Italy,GUY,Guyana,2016,0,4,-4
ITA,Italy,GUY,Guyana,2017,0,4,-4
JPN,Japan,GUY,Guyana,2008,11,11,0
JPN,Japan,GUY,Guyana,2009,7,6,1
JPN,Japan,GUY,Guyana,2010,14,15,-1
JPN,Japan,GUY,Guyana,2011,5,4,1
JPN,Japan,GUY,Guyana,2012,17,17,0
JPN,Japan,GUY,Guyana,2013,15,16,-1
JPN,Japan,GUY,Guyana,2014,16,18,-2
JPN,Japan,GUY,Guyana,2015,14,14,0
JPN,Japan,GUY,Guyana,2016,12,11,1
JPN,Japan,GUY,Guyana,2017,9,16,-7
KOR,Korea,GUY,Guyana,2008,1,1,0
KOR,Korea,GUY,Guyana,2009,0,0,0
KOR,Korea,GUY,Guyana,2010,0,2,-2
KOR,Korea,GUY,Guyana,2011,3,0,3
KOR,Korea,GUY,Guyana,2012,3,1,2
KOR,Korea,GUY,Guyana,2013,0,0,0
KOR,Korea,GUY,Guyana,2014,1,2,-1
KOR,Korea,GUY,Guyana,2015,1,0,1
KOR,Korea,GUY,Guyana,2016,3,2,1
KOR,Korea,GUY,Guyana,2017,1,3,-2
LUX,Luxembourg,GUY,Guyana,2008,0,0,0
LUX,Luxembourg,GUY,Guyana,2009,0,0,0
LUX,Luxembourg,GUY,Guyana,2010,0,0,0
LUX,Luxembourg,GUY,Guyana,2011,0,0,0
LUX,Luxembourg,GUY,Guyana,2012,0,0,0
LUX,Luxembourg,GUY,Guyana,2013,0,0,0
LUX,Luxembourg,GUY,Guyana,2014,0,0,0
LUX,Luxembourg,GUY,Guyana,2015,0,0,0
LUX,Luxembourg,GUY,Guyana,2016,0,0,0
LUX,Luxembourg,GUY,Guyana,2017,0,0,0
MEX,Mexico,GUY,Guyana,2008,0,1,-1
MEX,Mexico,GUY,Guyana,2009,0,1,-1
MEX,Mexico,GUY,Guyana,2012,0,2,-2
MEX,Mexico,GUY,Guyana,2013,0,0,0
MEX,Mexico,GUY,Guyana,2014,0,3,-3
MEX,Mexico,GUY,Guyana,2015,0,3,-3
MEX,Mexico,GUY,Guyana,2016,0,1,-1
NLD,Netherlands,GUY,Guyana,2008,7,18,-11
NLD,Netherlands,GUY,Guyana,2009,1,9,-8
NLD,Netherlands,GUY,Guyana,2010,5,10,-5
NLD,Netherlands,GUY,Guyana,2011,2,12,-10
NLD,Netherlands,GUY,Guyana,2012,7,15,-8
NLD,Netherlands,GUY,Guyana,2013,7,8,-1
NLD,Netherlands,GUY,Guyana,2014,7,9,-2
NLD,Netherlands,GUY,Guyana,2015,2,16,-14
NLD,Netherlands,GUY,Guyana,2016,5,11,-6
NLD,Netherlands,GUY,Guyana,2017,9,11,-2
NZL,New Zealand,GUY,Guyana,2008,0,4,-4
NZL,New Zealand,GUY,Guyana,2009,1,1,0
NZL,New Zealand,GUY,Guyana,2010,3,5,-2
NZL,New Zealand,GUY,Guyana,2011,1,3,-2
NZL,New Zealand,GUY,Guyana,2012,0,0,0
NZL,New Zealand,GUY,Guyana,2013,1,1,0
NZL,New Zealand,GUY,Guyana,2015,0,3,-3
NZL,New Zealand,GUY,Guyana,2016,0,5,-5
NZL,New Zealand,GUY,Guyana,2017,3,2,1
NOR,Norway,GUY,Guyana,2008,0,0,0
NOR,Norway,GUY,Guyana,2009,2,0,2
NOR,Norway,GUY,Guyana,2010,2,3,-1
NOR,Norway,GUY,Guyana,2011,0,0,0
NOR,Norway,GUY,Guyana,2012,0,5,-5
NOR,Norway,GUY,Guyana,2013,2,1,1
NOR,Norway,GUY,Guyana,2014,1,0,1
NOR,Norway,GUY,Guyana,2015,0,0,0
NOR,Norway,GUY,Guyana,2016,0,2,-2
NOR,Norway,GUY,Guyana,2017,0,2,-2
POL,Poland,GUY,Guyana,2009,0,0,0
POL,Poland,GUY,Guyana,2010,0,0,0
POL,Poland,GUY,Guyana,2011,0,1,-1
POL,Poland,GUY,Guyana,2012,0,1,-1
POL,Poland,GUY,Guyana,2013,0,2,-2
POL,Poland,GUY,Guyana,2014,0,1,-1
POL,Poland,GUY,Guyana,2015,0,0,0
POL,Poland,GUY,Guyana,2016,0,3,-3
POL,Poland,GUY,Guyana,2017,0,0,0
SVK,Slovak Republic,GUY,Guyana,2008,0,0,0
ESP,Spain,GUY,Guyana,2008,1,2,-1
ESP,Spain,GUY,Guyana,2009,2,3,-1
ESP,Spain,GUY,Guyana,2010,1,3,-2
ESP,Spain,GUY,Guyana,2011,3,3,0
ESP,Spain,GUY,Guyana,2012,1,6,-5
ESP,Spain,GUY,Guyana,2013,1,5,-4
ESP,Spain,GUY,Guyana,2014,3,3,0
ESP,Spain,GUY,Guyana,2015,4,3,1
ESP,Spain,GUY,Guyana,2016,1,4,-3
ESP,Spain,GUY,Guyana,2017,3,8,-5
SWE,Sweden,GUY,Guyana,2008,0,2,-2
SWE,Sweden,GUY,Guyana,2009,1,1,0
SWE,Sweden,GUY,Guyana,2010,0,0,0
SWE,Sweden,GUY,Guyana,2011,0,2,-2
SWE,Sweden,GUY,Guyana,2012,0,0,0
SWE,Sweden,GUY,Guyana,2013,0,3,-3
SWE,Sweden,GUY,Guyana,2014,0,0,0
SWE,Sweden,GUY,Guyana,2015,1,0,1
SWE,Sweden,GUY,Guyana,2016,0,1,-1
SWE,Sweden,GUY,Guyana,2017,2,1,1
CHE,Switzerland,GUY,Guyana,2010,3,1,2
CHE,Switzerland,GUY,Guyana,2011,3,0,3
CHE,Switzerland,GUY,Guyana,2012,0,2,-2
CHE,Switzerland,GUY,Guyana,2013,1,1,0
CHE,Switzerland,GUY,Guyana,2014,2,0,2
CHE,Switzerland,GUY,Guyana,2015,0,0,0
CHE,Switzerland,GUY,Guyana,2016,0,2,-2
CHE,Switzerland,GUY,Guyana,2017,0,2,-2
USA,United States,GUY,Guyana,2008,0,6823,-6823
USA,United States,GUY,Guyana,2009,0,6670,-6670
USA,United States,GUY,Guyana,2010,0,6749,-6749
USA,United States,GUY,Guyana,2011,0,6599,-6599
USA,United States,GUY,Guyana,2012,0,5683,-5683
USA,United States,GUY,Guyana,2013,0,5897,-5897
USA,United States,GUY,Guyana,2014,0,6267,-6267
USA,United States,GUY,Guyana,2015,0,5543,-5543
USA,United States,GUY,Guyana,2016,0,5771,-5771
USA,United States,GUY,Guyana,2017,0,5468,-5468
CHL,Chile,GUY,Guyana,2008,0,1,-1
CHL,Chile,GUY,Guyana,2009,0,0,0
CHL,Chile,GUY,Guyana,2010,0,1,-1
CHL,Chile,GUY,Guyana,2011,0,0,0
CHL,Chile,GUY,Guyana,2012,0,1,-1
CHL,Chile,GUY,Guyana,2013,0,1,-1
CHL,Chile,GUY,Guyana,2014,0,2,-2
CHL,Chile,GUY,Guyana,2015,0,0,0
CHL,Chile,GUY,Guyana,2016,0,0,0
EST,Estonia,GUY,Guyana,2008,0,0,0
EST,Estonia,GUY,Guyana,2009,0,0,0
EST,Estonia,GUY,Guyana,2010,0,0,0
EST,Estonia,GUY,Guyana,2011,0,0,0
EST,Estonia,GUY,Guyana,2012,0,0,0
EST,Estonia,GUY,Guyana,2013,0,0,0
EST,Estonia,GUY,Guyana,2014,0,0,0
EST,Estonia,GUY,Guyana,2015,0,0,0
EST,Estonia,GUY,Guyana,2016,0,0,0
EST,Estonia,GUY,Guyana,2017,0,0,0
AUS,Australia,HTI,Haiti,2008,0,0,0
AUS,Australia,HTI,Haiti,2009,0,1,-1
AUS,Australia,HTI,Haiti,2010,0,3,-3
AUS,Australia,HTI,Haiti,2011,0,0,0
AUS,Australia,HTI,Haiti,2012,0,0,0
AUS,Australia,HTI,Haiti,2013,0,4,-4
AUS,Australia,HTI,Haiti,2014,0,9,-9
AUS,Australia,HTI,Haiti,2015,0,0,0
AUS,Australia,HTI,Haiti,2017,0,3,-3
AUT,Austria,HTI,Haiti,2008,2,2,0
AUT,Austria,HTI,Haiti,2009,4,7,-3
AUT,Austria,HTI,Haiti,2010,0,18,-18
AUT,Austria,HTI,Haiti,2011,3,7,-4
AUT,Austria,HTI,Haiti,2012,2,7,-5
AUT,Austria,HTI,Haiti,2013,3,9,-6
AUT,Austria,HTI,Haiti,2014,1,0,1
AUT,Austria,HTI,Haiti,2015,3,2,1
AUT,Austria,HTI,Haiti,2016,0,3,-3
AUT,Austria,HTI,Haiti,2017,2,1,1
BEL,Belgium,HTI,Haiti,2008,0,55,-55
BEL,Belgium,HTI,Haiti,2009,0,58,-58
BEL,Belgium,HTI,Haiti,2010,23,84,-61
BEL,Belgium,HTI,Haiti,2012,32,37,-5
BEL,Belgium,HTI,Haiti,2013,39,39,0
BEL,Belgium,HTI,Haiti,2014,31,39,-8
BEL,Belgium,HTI,Haiti,2015,22,54,-32
BEL,Belgium,HTI,Haiti,2016,29,44,-15
BEL,Belgium,HTI,Haiti,2017,29,46,-17
CAN,Canada,HTI,Haiti,2008,0,2488,-2488
CAN,Canada,HTI,Haiti,2009,0,2079,-2079
CAN,Canada,HTI,Haiti,2010,0,4730,-4730
CAN,Canada,HTI,Haiti,2011,0,6469,-6469
CAN,Canada,HTI,Haiti,2012,0,5856,-5856
CAN,Canada,HTI,Haiti,2013,0,4147,-4147
CAN,Canada,HTI,Haiti,2014,0,3315,-3315
CAN,Canada,HTI,Haiti,2015,0,2727,-2727
CAN,Canada,HTI,Haiti,2016,0,2920,-2920
CAN,Canada,HTI,Haiti,2017,0,2330,-2330
CZE,Czech Republic,HTI,Haiti,2010,0,1,-1
CZE,Czech Republic,HTI,Haiti,2011,0,1,-1
CZE,Czech Republic,HTI,Haiti,2012,0,1,-1
CZE,Czech Republic,HTI,Haiti,2013,0,2,-2
CZE,Czech Republic,HTI,Haiti,2014,0,1,-1
DNK,Denmark,HTI,Haiti,2008,1,2,-1
DNK,Denmark,HTI,Haiti,2009,0,3,-3
DNK,Denmark,HTI,Haiti,2010,0,1,-1
DNK,Denmark,HTI,Haiti,2011,1,1,0
DNK,Denmark,HTI,Haiti,2012,0,1,-1
DNK,Denmark,HTI,Haiti,2013,2,1,1
DNK,Denmark,HTI,Haiti,2014,0,1,-1
DNK,Denmark,HTI,Haiti,2015,1,5,-4
DNK,Denmark,HTI,Haiti,2016,1,1,0
DNK,Denmark,HTI,Haiti,2017,1,3,-2
FIN,Finland,HTI,Haiti,2008,0,1,-1
FIN,Finland,HTI,Haiti,2009,0,3,-3
FIN,Finland,HTI,Haiti,2010,0,0,0
FIN,Finland,HTI,Haiti,2011,0,0,0
FIN,Finland,HTI,Haiti,2012,0,0,0
FIN,Finland,HTI,Haiti,2013,0,0,0
FIN,Finland,HTI,Haiti,2014,0,0,0
FIN,Finland,HTI,Haiti,2015,0,0,0
FIN,Finland,HTI,Haiti,2016,1,0,1
FIN,Finland,HTI,Haiti,2017,0,0,0
FRA,France,HTI,Haiti,2008,0,2230,-2230
FRA,France,HTI,Haiti,2009,0,2577,-2577
FRA,France,HTI,Haiti,2010,0,4762,-4762
FRA,France,HTI,Haiti,2011,0,3360,-3360
FRA,France,HTI,Haiti,2012,0,3177,-3177
FRA,France,HTI,Haiti,2013,0,3386,-3386
FRA,France,HTI,Haiti,2014,0,3202,-3202
FRA,France,HTI,Haiti,2015,0,3173,-3173
FRA,France,HTI,Haiti,2016,0,2625,-2625
FRA,France,HTI,Haiti,2017,0,2837,-2837
DEU,Germany,HTI,Haiti,2008,15,96,-81
DEU,Germany,HTI,Haiti,2009,31,55,-24
DEU,Germany,HTI,Haiti,2010,28,128,-100
DEU,Germany,HTI,Haiti,2011,23,95,-72
DEU,Germany,HTI,Haiti,2012,47,116,-69
DEU,Germany,HTI,Haiti,2013,71,132,-61
DEU,Germany,HTI,Haiti,2014,42,64,-22
DEU,Germany,HTI,Haiti,2015,33,53,-20
DEU,Germany,HTI,Haiti,2016,31,63,-32
DEU,Germany,HTI,Haiti,2017,24,49,-25
HUN,Hungary,HTI,Haiti,2008,0,1,-1
HUN,Hungary,HTI,Haiti,2009,0,0,0
HUN,Hungary,HTI,Haiti,2010,0,0,0
HUN,Hungary,HTI,Haiti,2011,0,0,0
HUN,Hungary,HTI,Haiti,2012,0,1,-1
HUN,Hungary,HTI,Haiti,2013,0,0,0
HUN,Hungary,HTI,Haiti,2014,0,0,0
HUN,Hungary,HTI,Haiti,2015,0,1,-1
HUN,Hungary,HTI,Haiti,2016,0,2,-2
HUN,Hungary,HTI,Haiti,2017,0,2,-2
ISL,Iceland,HTI,Haiti,2008,0,1,-1
ISL,Iceland,HTI,Haiti,2009,0,4,-4
ISL,Iceland,HTI,Haiti,2010,0,3,-3
ISL,Iceland,HTI,Haiti,2011,0,0,0
ISL,Iceland,HTI,Haiti,2012,0,7,-7
ISL,Iceland,HTI,Haiti,2013,1,0,1
ISL,Iceland,HTI,Haiti,2014,5,0,5
ISL,Iceland,HTI,Haiti,2015,0,0,0
ISL,Iceland,HTI,Haiti,2016,0,2,-2
ISL,Iceland,HTI,Haiti,2017,1,2,-1
ITA,Italy,HTI,Haiti,2008,0,27,-27
ITA,Italy,HTI,Haiti,2009,0,17,-17
ITA,Italy,HTI,Haiti,2010,1,59,-58
ITA,Italy,HTI,Haiti,2011,4,41,-37
ITA,Italy,HTI,Haiti,2012,2,34,-32
ITA,Italy,HTI,Haiti,2013,2,22,-20
ITA,Italy,HTI,Haiti,2014,3,45,-42
ITA,Italy,HTI,Haiti,2015,7,24,-17
ITA,Italy,HTI,Haiti,2016,0,37,-37
ITA,Italy,HTI,Haiti,2017,2,42,-40
JPN,Japan,HTI,Haiti,2008,23,22,1
JPN,Japan,HTI,Haiti,2009,24,24,0
JPN,Japan,HTI,Haiti,2010,30,35,-5
JPN,Japan,HTI,Haiti,2011,49,45,4
JPN,Japan,HTI,Haiti,2012,67,69,-2
JPN,Japan,HTI,Haiti,2013,28,34,-6
JPN,Japan,HTI,Haiti,2014,34,32,2
JPN,Japan,HTI,Haiti,2015,29,31,-2
JPN,Japan,HTI,Haiti,2016,17,23,-6
JPN,Japan,HTI,Haiti,2017,34,37,-3
KOR,Korea,HTI,Haiti,2008,0,1,-1
KOR,Korea,HTI,Haiti,2009,1,1,0
KOR,Korea,HTI,Haiti,2010,1,5,-4
KOR,Korea,HTI,Haiti,2011,1,5,-4
KOR,Korea,HTI,Haiti,2012,8,8,0
KOR,Korea,HTI,Haiti,2013,8,4,4
KOR,Korea,HTI,Haiti,2014,6,4,2
KOR,Korea,HTI,Haiti,2015,2,9,-7
KOR,Korea,HTI,Haiti,2016,7,8,-1
KOR,Korea,HTI,Haiti,2017,4,10,-6
LUX,Luxembourg,HTI,Haiti,2008,0,1,-1
LUX,Luxembourg,HTI,Haiti,2009,0,2,-2
LUX,Luxembourg,HTI,Haiti,2010,0,19,-19
LUX,Luxembourg,HTI,Haiti,2011,0,0,0
LUX,Luxembourg,HTI,Haiti,2012,0,2,-2
LUX,Luxembourg,HTI,Haiti,2013,0,3,-3
LUX,Luxembourg,HTI,Haiti,2014,0,3,-3
LUX,Luxembourg,HTI,Haiti,2015,1,3,-2
LUX,Luxembourg,HTI,Haiti,2016,0,0,0
LUX,Luxembourg,HTI,Haiti,2017,3,3,0
MEX,Mexico,HTI,Haiti,2008,0,28,-28
MEX,Mexico,HTI,Haiti,2009,0,46,-46
MEX,Mexico,HTI,Haiti,2010,0,73,-73
MEX,Mexico,HTI,Haiti,2011,0,106,-106
MEX,Mexico,HTI,Haiti,2012,0,53,-53
MEX,Mexico,HTI,Haiti,2013,0,123,-123
MEX,Mexico,HTI,Haiti,2014,0,130,-130
MEX,Mexico,HTI,Haiti,2015,0,97,-97
MEX,Mexico,HTI,Haiti,2016,0,131,-131
MEX,Mexico,HTI,Haiti,2017,0,137,-137
NLD,Netherlands,HTI,Haiti,2008,5,92,-87
NLD,Netherlands,HTI,Haiti,2009,2,63,-61
NLD,Netherlands,HTI,Haiti,2010,1,40,-39
NLD,Netherlands,HTI,Haiti,2011,3,3,0
NLD,Netherlands,HTI,Haiti,2012,3,2,1
NLD,Netherlands,HTI,Haiti,2013,5,9,-4
NLD,Netherlands,HTI,Haiti,2014,2,23,-21
NLD,Netherlands,HTI,Haiti,2015,5,11,-6
NLD,Netherlands,HTI,Haiti,2016,0,9,-9
NLD,Netherlands,HTI,Haiti,2017,2,16,-14
NZL,New Zealand,HTI,Haiti,2011,0,1,-1
NZL,New Zealand,HTI,Haiti,2012,0,0,0
NZL,New Zealand,HTI,Haiti,2016,0,1,-1
NOR,Norway,HTI,Haiti,2008,0,3,-3
NOR,Norway,HTI,Haiti,2009,0,2,-2
NOR,Norway,HTI,Haiti,2010,1,3,-2
NOR,Norway,HTI,Haiti,2011,0,1,-1
NOR,Norway,HTI,Haiti,2012,1,2,-1
NOR,Norway,HTI,Haiti,2013,2,4,-2
NOR,Norway,HTI,Haiti,2014,3,2,1
NOR,Norway,HTI,Haiti,2015,1,5,-4
NOR,Norway,HTI,Haiti,2016,0,1,-1
NOR,Norway,HTI,Haiti,2017,1,1,0
POL,Poland,HTI,Haiti,2009,0,1,-1
POL,Poland,HTI,Haiti,2010,0,1,-1
POL,Poland,HTI,Haiti,2011,0,2,-2
POL,Poland,HTI,Haiti,2012,0,13,-13
POL,Poland,HTI,Haiti,2013,0,11,-11
POL,Poland,HTI,Haiti,2014,0,10,-10
POL,Poland,HTI,Haiti,2015,0,9,-9
POL,Poland,HTI,Haiti,2016,0,1,-1
POL,Poland,HTI,Haiti,2017,0,3,-3
SVK,Slovak Republic,HTI,Haiti,2008,0,0,0
SVK,Slovak Republic,HTI,Haiti,2011,0,2,-2
SVK,Slovak Republic,HTI,Haiti,2012,0,1,-1
SVK,Slovak Republic,HTI,Haiti,2014,0,1,-1
SVK,Slovak Republic,HTI,Haiti,2016,0,1,-1
SVK,Slovak Republic,HTI,Haiti,2017,0,1,-1
ESP,Spain,HTI,Haiti,2008,9,64,-55
ESP,Spain,HTI,Haiti,2009,9,70,-61
ESP,Spain,HTI,Haiti,2010,12,62,-50
ESP,Spain,HTI,Haiti,2011,21,62,-41
ESP,Spain,HTI,Haiti,2012,26,68,-42
ESP,Spain,HTI,Haiti,2013,49,41,8
ESP,Spain,HTI,Haiti,2014,29,32,-3
ESP,Spain,HTI,Haiti,2015,20,39,-19
ESP,Spain,HTI,Haiti,2016,11,49,-38
ESP,Spain,HTI,Haiti,2017,19,60,-41
SWE,Sweden,HTI,Haiti,2008,1,3,-2
SWE,Sweden,HTI,Haiti,2009,1,3,-2
SWE,Sweden,HTI,Haiti,2010,1,7,-6
SWE,Sweden,HTI,Haiti,2011,2,2,0
SWE,Sweden,HTI,Haiti,2012,0,3,-3
SWE,Sweden,HTI,Haiti,2013,0,8,-8
SWE,Sweden,HTI,Haiti,2014,1,0,1
SWE,Sweden,HTI,Haiti,2015,0,1,-1
SWE,Sweden,HTI,Haiti,2016,0,3,-3
SWE,Sweden,HTI,Haiti,2017,0,0,0
CHE,Switzerland,HTI,Haiti,2010,12,75,-63
CHE,Switzerland,HTI,Haiti,2011,14,45,-31
CHE,Switzerland,HTI,Haiti,2012,7,36,-29
CHE,Switzerland,HTI,Haiti,2013,9,44,-35
CHE,Switzerland,HTI,Haiti,2014,7,19,-12
CHE,Switzerland,HTI,Haiti,2015,2,29,-27
CHE,Switzerland,HTI,Haiti,2016,7,31,-24
CHE,Switzerland,HTI,Haiti,2017,8,17,-9
TUR,Turkey,HTI,Haiti,2010,0,3,-3
USA,United States,HTI,Haiti,2008,0,26007,-26007
USA,United States,HTI,Haiti,2009,0,24280,-24280
USA,United States,HTI,Haiti,2010,0,22582,-22582
USA,United States,HTI,Haiti,2011,0,22111,-22111
USA,United States,HTI,Haiti,2012,0,22818,-22818
USA,United States,HTI,Haiti,2013,0,20351,-20351
USA,United States,HTI,Haiti,2014,0,15274,-15274
USA,United States,HTI,Haiti,2015,0,16967,-16967
USA,United States,HTI,Haiti,2016,0,23584,-23584
USA,United States,HTI,Haiti,2017,0,21824,-21824
CHL,Chile,HTI,Haiti,2008,0,111,-111
CHL,Chile,HTI,Haiti,2009,0,254,-254
CHL,Chile,HTI,Haiti,2010,0,474,-474
CHL,Chile,HTI,Haiti,2011,0,697,-697
CHL,Chile,HTI,Haiti,2012,0,1103,-1103
CHL,Chile,HTI,Haiti,2013,0,1215,-1215
CHL,Chile,HTI,Haiti,2014,0,2206,-2206
CHL,Chile,HTI,Haiti,2015,0,6363,-6363
CHL,Chile,HTI,Haiti,2016,0,23009,-23009
EST,Estonia,HTI,Haiti,2008,0,0,0
EST,Estonia,HTI,Haiti,2009,0,0,0
EST,Estonia,HTI,Haiti,2010,0,0,0
EST,Estonia,HTI,Haiti,2011,0,0,0
EST,Estonia,HTI,Haiti,2012,0,0,0
EST,Estonia,HTI,Haiti,2013,0,0,0
EST,Estonia,HTI,Haiti,2014,0,0,0
EST,Estonia,HTI,Haiti,2015,0,0,0
EST,Estonia,HTI,Haiti,2016,0,0,0
EST,Estonia,HTI,Haiti,2017,0,0,0
SVN,Slovenia,HTI,Haiti,2009,0,1,-1
SVN,Slovenia,HTI,Haiti,2011,0,1,-1
AUS,Australia,HND,Honduras,2008,0,7,-7
AUS,Australia,HND,Honduras,2009,0,5,-5
AUS,Australia,HND,Honduras,2010,0,4,-4
AUS,Australia,HND,Honduras,2011,0,5,-5
AUS,Australia,HND,Honduras,2012,0,2,-2
AUS,Australia,HND,Honduras,2013,0,11,-11
AUS,Australia,HND,Honduras,2014,0,6,-6
AUS,Australia,HND,Honduras,2015,0,8,-8
AUS,Australia,HND,Honduras,2017,0,3,-3
AUT,Austria,HND,Honduras,2008,10,9,1
AUT,Austria,HND,Honduras,2009,8,9,-1
AUT,Austria,HND,Honduras,2010,6,12,-6
AUT,Austria,HND,Honduras,2011,7,8,-1
AUT,Austria,HND,Honduras,2012,7,6,1
AUT,Austria,HND,Honduras,2013,3,9,-6
AUT,Austria,HND,Honduras,2014,6,8,-2
AUT,Austria,HND,Honduras,2015,7,11,-4
AUT,Austria,HND,Honduras,2016,11,16,-5
AUT,Austria,HND,Honduras,2017,7,6,1
BEL,Belgium,HND,Honduras,2008,0,20,-20
BEL,Belgium,HND,Honduras,2009,0,20,-20
BEL,Belgium,HND,Honduras,2010,1,24,-23
BEL,Belgium,HND,Honduras,2012,4,21,-17
BEL,Belgium,HND,Honduras,2013,13,24,-11
BEL,Belgium,HND,Honduras,2014,5,18,-13
BEL,Belgium,HND,Honduras,2015,7,18,-11
BEL,Belgium,HND,Honduras,2016,4,17,-13
BEL,Belgium,HND,Honduras,2017,5,36,-31
CAN,Canada,HND,Honduras,2008,0,185,-185
CAN,Canada,HND,Honduras,2009,0,169,-169
CAN,Canada,HND,Honduras,2010,0,385,-385
CAN,Canada,HND,Honduras,2011,0,538,-538
CAN,Canada,HND,Honduras,2012,0,436,-436
CAN,Canada,HND,Honduras,2013,0,350,-350
CAN,Canada,HND,Honduras,2014,0,402,-402
CAN,Canada,HND,Honduras,2015,0,422,-422
CAN,Canada,HND,Honduras,2016,0,360,-360
CAN,Canada,HND,Honduras,2017,0,385,-385
CZE,Czech Republic,HND,Honduras,2008,0,1,-1
CZE,Czech Republic,HND,Honduras,2009,0,5,-5
CZE,Czech Republic,HND,Honduras,2011,0,2,-2
CZE,Czech Republic,HND,Honduras,2012,1,5,-4
CZE,Czech Republic,HND,Honduras,2013,4,2,2
CZE,Czech Republic,HND,Honduras,2014,2,9,-7
CZE,Czech Republic,HND,Honduras,2015,2,2,0
CZE,Czech Republic,HND,Honduras,2016,1,6,-5
CZE,Czech Republic,HND,Honduras,2017,7,5,2
DNK,Denmark,HND,Honduras,2008,7,11,-4
DNK,Denmark,HND,Honduras,2009,3,6,-3
DNK,Denmark,HND,Honduras,2010,4,6,-2
DNK,Denmark,HND,Honduras,2011,5,8,-3
DNK,Denmark,HND,Honduras,2012,2,4,-2
DNK,Denmark,HND,Honduras,2013,3,7,-4
DNK,Denmark,HND,Honduras,2014,7,5,2
DNK,Denmark,HND,Honduras,2015,4,7,-3
DNK,Denmark,HND,Honduras,2016,4,10,-6
DNK,Denmark,HND,Honduras,2017,2,4,-2
FIN,Finland,HND,Honduras,2008,0,4,-4
FIN,Finland,HND,Honduras,2009,3,3,0
FIN,Finland,HND,Honduras,2010,0,0,0
FIN,Finland,HND,Honduras,2011,0,5,-5
FIN,Finland,HND,Honduras,2012,0,7,-7
FIN,Finland,HND,Honduras,2013,0,3,-3
FIN,Finland,HND,Honduras,2014,0,8,-8
FIN,Finland,HND,Honduras,2015,2,10,-8
FIN,Finland,HND,Honduras,2016,2,10,-8
FIN,Finland,HND,Honduras,2017,0,11,-11
FRA,France,HND,Honduras,2008,0,20,-20
FRA,France,HND,Honduras,2009,0,37,-37
FRA,France,HND,Honduras,2010,0,32,-32
FRA,France,HND,Honduras,2011,0,31,-31
FRA,France,HND,Honduras,2012,0,29,-29
FRA,France,HND,Honduras,2013,0,32,-32
FRA,France,HND,Honduras,2014,0,46,-46
FRA,France,HND,Honduras,2015,0,24,-24
FRA,France,HND,Honduras,2016,0,27,-27
FRA,France,HND,Honduras,2017,0,37,-37
DEU,Germany,HND,Honduras,2008,79,94,-15
DEU,Germany,HND,Honduras,2009,80,108,-28
DEU,Germany,HND,Honduras,2010,86,116,-30
DEU,Germany,HND,Honduras,2011,55,139,-84
DEU,Germany,HND,Honduras,2012,62,135,-73
DEU,Germany,HND,Honduras,2013,71,156,-85
DEU,Germany,HND,Honduras,2014,65,133,-68
DEU,Germany,HND,Honduras,2015,60,176,-116
DEU,Germany,HND,Honduras,2016,88,196,-108
DEU,Germany,HND,Honduras,2017,89,201,-112
HUN,Hungary,HND,Honduras,2008,1,1,0
HUN,Hungary,HND,Honduras,2009,0,2,-2
HUN,Hungary,HND,Honduras,2010,0,2,-2
HUN,Hungary,HND,Honduras,2011,0,3,-3
HUN,Hungary,HND,Honduras,2012,0,2,-2
HUN,Hungary,HND,Honduras,2013,0,0,0
HUN,Hungary,HND,Honduras,2014,0,1,-1
HUN,Hungary,HND,Honduras,2015,2,2,0
HUN,Hungary,HND,Honduras,2016,0,2,-2
HUN,Hungary,HND,Honduras,2017,0,1,-1
ISL,Iceland,HND,Honduras,2008,2,1,1
ISL,Iceland,HND,Honduras,2009,2,5,-3
ISL,Iceland,HND,Honduras,2010,0,0,0
ISL,Iceland,HND,Honduras,2011,2,3,-1
ISL,Iceland,HND,Honduras,2012,0,2,-2
ISL,Iceland,HND,Honduras,2013,0,3,-3
ISL,Iceland,HND,Honduras,2014,1,0,1
ISL,Iceland,HND,Honduras,2015,2,4,-2
ISL,Iceland,HND,Honduras,2016,1,8,-7
ISL,Iceland,HND,Honduras,2017,1,6,-5
ITA,Italy,HND,Honduras,2008,6,112,-106
ITA,Italy,HND,Honduras,2009,6,140,-134
ITA,Italy,HND,Honduras,2010,12,274,-262
ITA,Italy,HND,Honduras,2011,7,242,-235
ITA,Italy,HND,Honduras,2012,7,196,-189
ITA,Italy,HND,Honduras,2013,6,209,-203
ITA,Italy,HND,Honduras,2014,14,224,-210
ITA,Italy,HND,Honduras,2015,7,182,-175
ITA,Italy,HND,Honduras,2016,0,150,-150
ITA,Italy,HND,Honduras,2017,10,201,-191
JPN,Japan,HND,Honduras,2008,73,72,1
JPN,Japan,HND,Honduras,2009,60,69,-9
JPN,Japan,HND,Honduras,2010,21,27,-6
JPN,Japan,HND,Honduras,2011,47,45,2
JPN,Japan,HND,Honduras,2012,51,56,-5
JPN,Japan,HND,Honduras,2013,62,71,-9
JPN,Japan,HND,Honduras,2014,53,60,-7
JPN,Japan,HND,Honduras,2015,92,106,-14
JPN,Japan,HND,Honduras,2016,69,97,-28
JPN,Japan,HND,Honduras,2017,79,105,-26
KOR,Korea,HND,Honduras,2008,10,11,-1
KOR,Korea,HND,Honduras,2009,7,11,-4
KOR,Korea,HND,Honduras,2010,7,13,-6
KOR,Korea,HND,Honduras,2011,9,14,-5
KOR,Korea,HND,Honduras,2012,10,18,-8
KOR,Korea,HND,Honduras,2013,12,14,-2
KOR,Korea,HND,Honduras,2014,17,23,-6
KOR,Korea,HND,Honduras,2015,17,18,-1
KOR,Korea,HND,Honduras,2016,14,16,-2
KOR,Korea,HND,Honduras,2017,13,24,-11
LUX,Luxembourg,HND,Honduras,2008,0,1,-1
LUX,Luxembourg,HND,Honduras,2009,0,1,-1
LUX,Luxembourg,HND,Honduras,2010,0,0,0
LUX,Luxembourg,HND,Honduras,2011,0,1,-1
LUX,Luxembourg,HND,Honduras,2012,0,1,-1
LUX,Luxembourg,HND,Honduras,2013,1,2,-1
LUX,Luxembourg,HND,Honduras,2014,1,3,-2
LUX,Luxembourg,HND,Honduras,2015,0,3,-3
LUX,Luxembourg,HND,Honduras,2016,0,1,-1
LUX,Luxembourg,HND,Honduras,2017,0,0,0
MEX,Mexico,HND,Honduras,2008,0,765,-765
MEX,Mexico,HND,Honduras,2009,0,1406,-1406
MEX,Mexico,HND,Honduras,2010,0,1544,-1544
MEX,Mexico,HND,Honduras,2011,0,1026,-1026
MEX,Mexico,HND,Honduras,2012,0,410,-410
MEX,Mexico,HND,Honduras,2013,0,2409,-2409
MEX,Mexico,HND,Honduras,2014,0,2269,-2269
MEX,Mexico,HND,Honduras,2015,0,1798,-1798
MEX,Mexico,HND,Honduras,2016,0,2559,-2559
MEX,Mexico,HND,Honduras,2017,0,2453,-2453
NLD,Netherlands,HND,Honduras,2008,7,10,-3
NLD,Netherlands,HND,Honduras,2009,4,23,-19
NLD,Netherlands,HND,Honduras,2010,13,23,-10
NLD,Netherlands,HND,Honduras,2011,5,10,-5
NLD,Netherlands,HND,Honduras,2012,5,14,-9
NLD,Netherlands,HND,Honduras,2013,6,15,-9
NLD,Netherlands,HND,Honduras,2014,11,25,-14
NLD,Netherlands,HND,Honduras,2015,8,16,-8
NLD,Netherlands,HND,Honduras,2016,7,23,-16
NLD,Netherlands,HND,Honduras,2017,14,20,-6
NZL,New Zealand,HND,Honduras,2008,0,1,-1
NZL,New Zealand,HND,Honduras,2010,1,3,-2
NZL,New Zealand,HND,Honduras,2011,0,2,-2
NZL,New Zealand,HND,Honduras,2012,1,2,-1
NZL,New Zealand,HND,Honduras,2013,0,2,-2
NZL,New Zealand,HND,Honduras,2014,0,1,-1
NZL,New Zealand,HND,Honduras,2015,0,2,-2
NZL,New Zealand,HND,Honduras,2016,0,2,-2
NZL,New Zealand,HND,Honduras,2017,0,3,-3
NOR,Norway,HND,Honduras,2008,3,7,-4
NOR,Norway,HND,Honduras,2009,5,10,-5
NOR,Norway,HND,Honduras,2010,3,3,0
NOR,Norway,HND,Honduras,2011,4,3,1
NOR,Norway,HND,Honduras,2012,2,12,-10
NOR,Norway,HND,Honduras,2013,1,8,-7
NOR,Norway,HND,Honduras,2014,5,7,-2
NOR,Norway,HND,Honduras,2015,4,8,-4
NOR,Norway,HND,Honduras,2016,2,5,-3
NOR,Norway,HND,Honduras,2017,2,4,-2
POL,Poland,HND,Honduras,2009,0,2,-2
POL,Poland,HND,Honduras,2010,0,5,-5
POL,Poland,HND,Honduras,2011,0,9,-9
POL,Poland,HND,Honduras,2012,0,7,-7
POL,Poland,HND,Honduras,2013,0,6,-6
POL,Poland,HND,Honduras,2014,0,2,-2
POL,Poland,HND,Honduras,2015,0,4,-4
POL,Poland,HND,Honduras,2016,0,5,-5
POL,Poland,HND,Honduras,2017,0,11,-11
SVK,Slovak Republic,HND,Honduras,2008,1,0,1
SVK,Slovak Republic,HND,Honduras,2010,0,2,-2
SVK,Slovak Republic,HND,Honduras,2011,1,3,-2
SVK,Slovak Republic,HND,Honduras,2017,0,1,-1
ESP,Spain,HND,Honduras,2008,1320,4551,-3231
ESP,Spain,HND,Honduras,2009,1608,3695,-2087
ESP,Spain,HND,Honduras,2010,1715,4703,-2988
ESP,Spain,HND,Honduras,2011,1897,6261,-4364
ESP,Spain,HND,Honduras,2012,2455,5285,-2830
ESP,Spain,HND,Honduras,2013,3817,4342,-525
ESP,Spain,HND,Honduras,2014,2299,5681,-3382
ESP,Spain,HND,Honduras,2015,1548,7632,-6084
ESP,Spain,HND,Honduras,2016,1604,10895,-9291
ESP,Spain,HND,Honduras,2017,1797,18234,-16437
SWE,Sweden,HND,Honduras,2008,4,6,-2
SWE,Sweden,HND,Honduras,2009,1,20,-19
SWE,Sweden,HND,Honduras,2010,4,14,-10
SWE,Sweden,HND,Honduras,2011,9,29,-20
SWE,Sweden,HND,Honduras,2012,2,13,-11
SWE,Sweden,HND,Honduras,2013,4,12,-8
SWE,Sweden,HND,Honduras,2014,7,8,-1
SWE,Sweden,HND,Honduras,2015,6,5,1
SWE,Sweden,HND,Honduras,2016,2,20,-18
SWE,Sweden,HND,Honduras,2017,5,12,-7
CHE,Switzerland,HND,Honduras,2010,7,30,-23
CHE,Switzerland,HND,Honduras,2011,13,17,-4
CHE,Switzerland,HND,Honduras,2012,9,24,-15
CHE,Switzerland,HND,Honduras,2013,3,48,-45
CHE,Switzerland,HND,Honduras,2014,12,30,-18
CHE,Switzerland,HND,Honduras,2015,5,24,-19
CHE,Switzerland,HND,Honduras,2016,10,28,-18
CHE,Switzerland,HND,Honduras,2017,8,49,-41
TUR,Turkey,HND,Honduras,2010,0,3,-3
USA,United States,HND,Honduras,2008,0,6540,-6540
USA,United States,HND,Honduras,2009,0,6404,-6404
USA,United States,HND,Honduras,2010,0,6448,-6448
USA,United States,HND,Honduras,2011,0,6133,-6133
USA,United States,HND,Honduras,2012,0,6884,-6884
USA,United States,HND,Honduras,2013,0,8898,-8898
USA,United States,HND,Honduras,2014,0,8156,-8156
USA,United States,HND,Honduras,2015,0,9274,-9274
USA,United States,HND,Honduras,2016,0,13302,-13302
USA,United States,HND,Honduras,2017,0,11387,-11387
CHL,Chile,HND,Honduras,2008,0,51,-51
CHL,Chile,HND,Honduras,2009,0,91,-91
CHL,Chile,HND,Honduras,2010,0,68,-68
CHL,Chile,HND,Honduras,2011,0,69,-69
CHL,Chile,HND,Honduras,2012,0,76,-76
CHL,Chile,HND,Honduras,2013,0,93,-93
CHL,Chile,HND,Honduras,2014,0,94,-94
CHL,Chile,HND,Honduras,2015,0,92,-92
CHL,Chile,HND,Honduras,2016,0,99,-99
EST,Estonia,HND,Honduras,2008,0,0,0
EST,Estonia,HND,Honduras,2009,0,0,0
EST,Estonia,HND,Honduras,2010,0,0,0
EST,Estonia,HND,Honduras,2011,0,1,-1
EST,Estonia,HND,Honduras,2012,0,0,0
EST,Estonia,HND,Honduras,2013,0,0,0
EST,Estonia,HND,Honduras,2014,0,0,0
EST,Estonia,HND,Honduras,2015,0,0,0
EST,Estonia,HND,Honduras,2016,0,2,-2
EST,Estonia,HND,Honduras,2017,0,0,0
SVN,Slovenia,HND,Honduras,2010,0,3,-3
AUS,Australia,HKG,"Hong Kong, China",2008,1417,1806,-389
AUS,Australia,HKG,"Hong Kong, China",2009,990,1561,-571
AUS,Australia,HKG,"Hong Kong, China",2010,1178,805,373
AUS,Australia,HKG,"Hong Kong, China",2011,1181,806,375
AUS,Australia,HKG,"Hong Kong, China",2012,1034,860,174
AUS,Australia,HKG,"Hong Kong, China",2013,1022,1228,-206
AUS,Australia,HKG,"Hong Kong, China",2014,908,1300,-392
AUS,Australia,HKG,"Hong Kong, China",2015,800,1384,-584
AUS,Australia,HKG,"Hong Kong, China",2016,700,1716,-1016
AUS,Australia,HKG,"Hong Kong, China",2017,0,1803,-1803
AUT,Austria,HKG,"Hong Kong, China",2014,0,0,0
AUT,Austria,HKG,"Hong Kong, China",2015,0,0,0
AUT,Austria,HKG,"Hong Kong, China",2016,0,0,0
AUT,Austria,HKG,"Hong Kong, China",2017,0,0,0
BEL,Belgium,HKG,"Hong Kong, China",2010,0,0,0
CAN,Canada,HKG,"Hong Kong, China",2008,0,893,-893
CAN,Canada,HKG,"Hong Kong, China",2009,0,656,-656
CAN,Canada,HKG,"Hong Kong, China",2010,0,623,-623
CAN,Canada,HKG,"Hong Kong, China",2011,0,586,-586
CAN,Canada,HKG,"Hong Kong, China",2012,0,719,-719
CAN,Canada,HKG,"Hong Kong, China",2013,0,774,-774
CAN,Canada,HKG,"Hong Kong, China",2014,0,586,-586
CAN,Canada,HKG,"Hong Kong, China",2015,0,630,-630
CAN,Canada,HKG,"Hong Kong, China",2016,0,1210,-1210
CAN,Canada,HKG,"Hong Kong, China",2017,0,1270,-1270
DNK,Denmark,HKG,"Hong Kong, China",2015,0,0,0
DNK,Denmark,HKG,"Hong Kong, China",2016,0,0,0
FIN,Finland,HKG,"Hong Kong, China",2008,0,0,0
FIN,Finland,HKG,"Hong Kong, China",2009,0,0,0
FIN,Finland,HKG,"Hong Kong, China",2010,0,0,0
FIN,Finland,HKG,"Hong Kong, China",2011,0,0,0
FIN,Finland,HKG,"Hong Kong, China",2012,0,0,0
FIN,Finland,HKG,"Hong Kong, China",2013,0,0,0
FIN,Finland,HKG,"Hong Kong, China",2014,0,0,0
FIN,Finland,HKG,"Hong Kong, China",2015,0,0,0
FIN,Finland,HKG,"Hong Kong, China",2016,0,0,0
FIN,Finland,HKG,"Hong Kong, China",2017,0,0,0
FRA,France,HKG,"Hong Kong, China",2008,0,0,0
FRA,France,HKG,"Hong Kong, China",2009,0,0,0
FRA,France,HKG,"Hong Kong, China",2010,0,0,0
FRA,France,HKG,"Hong Kong, China",2011,0,0,0
FRA,France,HKG,"Hong Kong, China",2012,0,0,0
FRA,France,HKG,"Hong Kong, China",2013,0,0,0
FRA,France,HKG,"Hong Kong, China",2014,0,0,0
FRA,France,HKG,"Hong Kong, China",2015,0,0,0
FRA,France,HKG,"Hong Kong, China",2016,0,0,0
FRA,France,HKG,"Hong Kong, China",2017,0,0,0
HUN,Hungary,HKG,"Hong Kong, China",2008,0,0,0
HUN,Hungary,HKG,"Hong Kong, China",2009,0,0,0
HUN,Hungary,HKG,"Hong Kong, China",2010,0,0,0
HUN,Hungary,HKG,"Hong Kong, China",2011,0,0,0
HUN,Hungary,HKG,"Hong Kong, China",2012,0,0,0
HUN,Hungary,HKG,"Hong Kong, China",2013,0,0,0
HUN,Hungary,HKG,"Hong Kong, China",2014,0,0,0
HUN,Hungary,HKG,"Hong Kong, China",2015,0,0,0
HUN,Hungary,HKG,"Hong Kong, China",2016,0,0,0
HUN,Hungary,HKG,"Hong Kong, China",2017,0,0,0
ISL,Iceland,HKG,"Hong Kong, China",2008,0,0,0
ISL,Iceland,HKG,"Hong Kong, China",2009,0,0,0
ISL,Iceland,HKG,"Hong Kong, China",2010,0,0,0
ISL,Iceland,HKG,"Hong Kong, China",2011,0,0,0
ISL,Iceland,HKG,"Hong Kong, China",2012,0,0,0
ISL,Iceland,HKG,"Hong Kong, China",2013,0,0,0
ISL,Iceland,HKG,"Hong Kong, China",2014,0,0,0
ISL,Iceland,HKG,"Hong Kong, China",2015,0,0,0
ISL,Iceland,HKG,"Hong Kong, China",2016,0,0,0
ISL,Iceland,HKG,"Hong Kong, China",2017,0,0,0
JPN,Japan,HKG,"Hong Kong, China",2008,382,895,-513
JPN,Japan,HKG,"Hong Kong, China",2009,602,906,-304
JPN,Japan,HKG,"Hong Kong, China",2010,759,1097,-338
JPN,Japan,HKG,"Hong Kong, China",2011,778,629,149
JPN,Japan,HKG,"Hong Kong, China",2012,521,884,-363
JPN,Japan,HKG,"Hong Kong, China",2013,600,938,-338
JPN,Japan,HKG,"Hong Kong, China",2014,587,1051,-464
JPN,Japan,HKG,"Hong Kong, China",2015,649,1337,-688
JPN,Japan,HKG,"Hong Kong, China",2016,850,1564,-714
JPN,Japan,HKG,"Hong Kong, China",2017,1079,2293,-1214
KOR,Korea,HKG,"Hong Kong, China",2008,277,361,-84
KOR,Korea,HKG,"Hong Kong, China",2009,309,257,52
KOR,Korea,HKG,"Hong Kong, China",2010,317,301,16
KOR,Korea,HKG,"Hong Kong, China",2011,390,381,9
KOR,Korea,HKG,"Hong Kong, China",2012,528,481,47
KOR,Korea,HKG,"Hong Kong, China",2013,586,675,-89
KOR,Korea,HKG,"Hong Kong, China",2014,709,872,-163
KOR,Korea,HKG,"Hong Kong, China",2015,995,798,197
KOR,Korea,HKG,"Hong Kong, China",2016,970,974,-4
KOR,Korea,HKG,"Hong Kong, China",2017,997,860,137
LUX,Luxembourg,HKG,"Hong Kong, China",2008,0,0,0
LUX,Luxembourg,HKG,"Hong Kong, China",2009,0,0,0
LUX,Luxembourg,HKG,"Hong Kong, China",2010,0,1,-1
LUX,Luxembourg,HKG,"Hong Kong, China",2011,0,0,0
LUX,Luxembourg,HKG,"Hong Kong, China",2012,0,0,0
LUX,Luxembourg,HKG,"Hong Kong, China",2013,0,0,0
LUX,Luxembourg,HKG,"Hong Kong, China",2014,0,0,0
LUX,Luxembourg,HKG,"Hong Kong, China",2015,0,0,0
LUX,Luxembourg,HKG,"Hong Kong, China",2016,0,0,0
LUX,Luxembourg,HKG,"Hong Kong, China",2017,0,0,0
MEX,Mexico,HKG,"Hong Kong, China",2008,0,3,-3
MEX,Mexico,HKG,"Hong Kong, China",2009,0,4,-4
MEX,Mexico,HKG,"Hong Kong, China",2010,0,2,-2
MEX,Mexico,HKG,"Hong Kong, China",2012,0,2,-2
MEX,Mexico,HKG,"Hong Kong, China",2013,0,1,-1
MEX,Mexico,HKG,"Hong Kong, China",2014,0,1,-1
MEX,Mexico,HKG,"Hong Kong, China",2015,0,1,-1
MEX,Mexico,HKG,"Hong Kong, China",2016,0,1,-1
MEX,Mexico,HKG,"Hong Kong, China",2017,0,1,-1
NZL,New Zealand,HKG,"Hong Kong, China",2008,105,371,-266
NZL,New Zealand,HKG,"Hong Kong, China",2009,118,384,-266
NZL,New Zealand,HKG,"Hong Kong, China",2010,168,443,-275
NZL,New Zealand,HKG,"Hong Kong, China",2011,143,506,-363
NZL,New Zealand,HKG,"Hong Kong, China",2012,165,560,-395
NZL,New Zealand,HKG,"Hong Kong, China",2013,144,537,-393
NZL,New Zealand,HKG,"Hong Kong, China",2014,134,580,-446
NZL,New Zealand,HKG,"Hong Kong, China",2015,130,649,-519
NZL,New Zealand,HKG,"Hong Kong, China",2016,157,744,-587
NZL,New Zealand,HKG,"Hong Kong, China",2017,201,693,-492
NOR,Norway,HKG,"Hong Kong, China",2008,0,0,0
NOR,Norway,HKG,"Hong Kong, China",2009,0,0,0
NOR,Norway,HKG,"Hong Kong, China",2010,0,0,0
NOR,Norway,HKG,"Hong Kong, China",2011,0,0,0
NOR,Norway,HKG,"Hong Kong, China",2012,0,0,0
NOR,Norway,HKG,"Hong Kong, China",2013,0,0,0
NOR,Norway,HKG,"Hong Kong, China",2014,0,0,0
NOR,Norway,HKG,"Hong Kong, China",2015,0,0,0
NOR,Norway,HKG,"Hong Kong, China",2016,0,0,0
NOR,Norway,HKG,"Hong Kong, China",2017,0,0,0
POL,Poland,HKG,"Hong Kong, China",2008,0,0,0
POL,Poland,HKG,"Hong Kong, China",2009,0,2,-2
POL,Poland,HKG,"Hong Kong, China",2010,0,4,-4
POL,Poland,HKG,"Hong Kong, China",2011,0,15,-15
POL,Poland,HKG,"Hong Kong, China",2012,0,8,-8
POL,Poland,HKG,"Hong Kong, China",2013,0,0,0
POL,Poland,HKG,"Hong Kong, China",2014,0,2,-2
POL,Poland,HKG,"Hong Kong, China",2015,0,6,-6
POL,Poland,HKG,"Hong Kong, China",2016,0,5,-5
POL,Poland,HKG,"Hong Kong, China",2017,0,9,-9
SWE,Sweden,HKG,"Hong Kong, China",2008,0,0,0
SWE,Sweden,HKG,"Hong Kong, China",2009,0,0,0
SWE,Sweden,HKG,"Hong Kong, China",2010,0,0,0
SWE,Sweden,HKG,"Hong Kong, China",2011,0,0,0
SWE,Sweden,HKG,"Hong Kong, China",2012,0,0,0
SWE,Sweden,HKG,"Hong Kong, China",2013,0,0,0
SWE,Sweden,HKG,"Hong Kong, China",2014,0,0,0
SWE,Sweden,HKG,"Hong Kong, China",2015,0,0,0
GBR,United Kingdom,HKG,"Hong Kong, China",2010,0,3000,-3000
GBR,United Kingdom,HKG,"Hong Kong, China",2011,1000,2000,-1000
GBR,United Kingdom,HKG,"Hong Kong, China",2013,0,3000,-3000
GBR,United Kingdom,HKG,"Hong Kong, China",2016,0,5000,-5000
GBR,United Kingdom,HKG,"Hong Kong, China",2017,0,8000,-8000
USA,United States,HKG,"Hong Kong, China",2008,0,3373,-3373
USA,United States,HKG,"Hong Kong, China",2009,0,2651,-2651
USA,United States,HKG,"Hong Kong, China",2010,0,2432,-2432
USA,United States,HKG,"Hong Kong, China",2011,0,2306,-2306
USA,United States,HKG,"Hong Kong, China",2012,0,2104,-2104
USA,United States,HKG,"Hong Kong, China",2013,0,2226,-2226
USA,United States,HKG,"Hong Kong, China",2014,0,2278,-2278
USA,United States,HKG,"Hong Kong, China",2015,0,2085,-2085
USA,United States,HKG,"Hong Kong, China",2016,0,2510,-2510
USA,United States,HKG,"Hong Kong, China",2017,0,2415,-2415
CHL,Chile,HKG,"Hong Kong, China",2008,0,1,-1
CHL,Chile,HKG,"Hong Kong, China",2009,0,0,0
CHL,Chile,HKG,"Hong Kong, China",2010,0,9,-9
CHL,Chile,HKG,"Hong Kong, China",2011,0,16,-16
CHL,Chile,HKG,"Hong Kong, China",2012,0,9,-9
CHL,Chile,HKG,"Hong Kong, China",2013,0,14,-14
CHL,Chile,HKG,"Hong Kong, China",2014,0,6,-6
CHL,Chile,HKG,"Hong Kong, China",2015,0,2,-2
CHL,Chile,HKG,"Hong Kong, China",2016,0,1,-1
EST,Estonia,HKG,"Hong Kong, China",2017,0,0,0
SVN,Slovenia,HKG,"Hong Kong, China",2015,0,1,-1
SVN,Slovenia,HKG,"Hong Kong, China",2017,0,2,-2
AUS,Australia,IND,India,2008,1495,22725,-21230
AUS,Australia,IND,India,2009,1297,25280,-23983
AUS,Australia,IND,India,2010,1514,23477,-21963
AUS,Australia,IND,India,2011,1754,21855,-20101
AUS,Australia,IND,India,2012,1678,27830,-26152
AUS,Australia,IND,India,2013,1889,38123,-36234
AUS,Australia,IND,India,2014,2051,39642,-37591
AUS,Australia,IND,India,2015,2400,34710,-32310
AUS,Australia,IND,India,2016,2400,38552,-36152
AUS,Australia,IND,India,2017,0,40019,-40019
AUT,Austria,IND,India,2008,825,944,-119
AUT,Austria,IND,India,2009,839,986,-147
AUT,Austria,IND,India,2010,903,945,-42
AUT,Austria,IND,India,2011,737,1043,-306
AUT,Austria,IND,India,2012,688,1251,-563
AUT,Austria,IND,India,2013,724,1194,-470
AUT,Austria,IND,India,2014,760,1332,-572
AUT,Austria,IND,India,2015,764,1411,-647
AUT,Austria,IND,India,2016,938,1412,-474
AUT,Austria,IND,India,2017,976,1471,-495
BEL,Belgium,IND,India,2008,1158,2058,-900
BEL,Belgium,IND,India,2009,1293,1787,-494
BEL,Belgium,IND,India,2010,1331,2286,-955
BEL,Belgium,IND,India,2011,1441,2270,-829
BEL,Belgium,IND,India,2012,1643,2305,-662
BEL,Belgium,IND,India,2013,1710,2593,-883
BEL,Belgium,IND,India,2014,1227,1949,-722
BEL,Belgium,IND,India,2015,1248,2181,-933
BEL,Belgium,IND,India,2016,1276,2391,-1115
BEL,Belgium,IND,India,2017,1030,3066,-2036
CAN,Canada,IND,India,2008,0,28255,-28255
CAN,Canada,IND,India,2009,0,29448,-29448
CAN,Canada,IND,India,2010,0,34224,-34224
CAN,Canada,IND,India,2011,0,27485,-27485
CAN,Canada,IND,India,2012,0,30915,-30915
CAN,Canada,IND,India,2013,0,33078,-33078
CAN,Canada,IND,India,2014,0,38330,-38330
CAN,Canada,IND,India,2015,0,39525,-39525
CAN,Canada,IND,India,2016,0,39795,-39795
CAN,Canada,IND,India,2017,0,51655,-51655
CZE,Czech Republic,IND,India,2008,0,310,-310
CZE,Czech Republic,IND,India,2009,0,295,-295
CZE,Czech Republic,IND,India,2010,1,230,-229
CZE,Czech Republic,IND,India,2011,2,208,-206
CZE,Czech Republic,IND,India,2012,71,288,-217
CZE,Czech Republic,IND,India,2013,212,313,-101
CZE,Czech Republic,IND,India,2014,143,428,-285
CZE,Czech Republic,IND,India,2015,241,550,-309
CZE,Czech Republic,IND,India,2016,277,751,-474
CZE,Czech Republic,IND,India,2017,298,1001,-703
DNK,Denmark,IND,India,2008,1008,1020,-12
DNK,Denmark,IND,India,2009,1029,813,216
DNK,Denmark,IND,India,2010,990,913,77
DNK,Denmark,IND,India,2011,1221,1073,148
DNK,Denmark,IND,India,2012,1243,905,338
DNK,Denmark,IND,India,2013,1148,1128,20
DNK,Denmark,IND,India,2014,1164,1371,-207
DNK,Denmark,IND,India,2015,1056,1615,-559
DNK,Denmark,IND,India,2016,1399,1897,-498
DNK,Denmark,IND,India,2017,1788,1863,-75
FIN,Finland,IND,India,2008,269,623,-354
FIN,Finland,IND,India,2009,200,612,-412
FIN,Finland,IND,India,2010,166,486,-320
FIN,Finland,IND,India,2011,239,573,-334
FIN,Finland,IND,India,2012,296,572,-276
FIN,Finland,IND,India,2013,297,676,-379
FIN,Finland,IND,India,2014,398,826,-428
FIN,Finland,IND,India,2015,495,821,-326
FIN,Finland,IND,India,2016,514,676,-162
FIN,Finland,IND,India,2017,349,730,-381
FRA,France,IND,India,2008,0,1816,-1816
FRA,France,IND,India,2009,0,1880,-1880
FRA,France,IND,India,2010,0,1976,-1976
FRA,France,IND,India,2011,0,2136,-2136
FRA,France,IND,India,2012,0,2285,-2285
FRA,France,IND,India,2013,0,2505,-2505
FRA,France,IND,India,2014,0,2557,-2557
FRA,France,IND,India,2015,0,2705,-2705
FRA,France,IND,India,2016,0,2940,-2940
FRA,France,IND,India,2017,0,3332,-3332
DEU,Germany,IND,India,2008,9532,11403,-1871
DEU,Germany,IND,India,2009,10374,12009,-1635
DEU,Germany,IND,India,2010,9981,13187,-3206
DEU,Germany,IND,India,2011,9822,15352,-5530
DEU,Germany,IND,India,2012,11108,18063,-6955
DEU,Germany,IND,India,2013,12411,19455,-7044
DEU,Germany,IND,India,2014,13134,22374,-9240
DEU,Germany,IND,India,2015,15195,26113,-10918
DEU,Germany,IND,India,2016,17186,27683,-10497
DEU,Germany,IND,India,2017,15878,29535,-13657
GRC,Greece,IND,India,2008,0,647,-647
GRC,Greece,IND,India,2009,0,739,-739
GRC,Greece,IND,India,2010,0,588,-588
GRC,Greece,IND,India,2011,0,763,-763
HUN,Hungary,IND,India,2008,19,300,-281
HUN,Hungary,IND,India,2009,57,218,-161
HUN,Hungary,IND,India,2010,42,318,-276
HUN,Hungary,IND,India,2011,45,356,-311
HUN,Hungary,IND,India,2012,62,260,-198
HUN,Hungary,IND,India,2013,88,211,-123
HUN,Hungary,IND,India,2014,83,355,-272
HUN,Hungary,IND,India,2015,131,512,-381
HUN,Hungary,IND,India,2016,115,531,-416
HUN,Hungary,IND,India,2017,0,795,-795
ISL,Iceland,IND,India,2008,65,64,1
ISL,Iceland,IND,India,2009,44,17,27
ISL,Iceland,IND,India,2010,23,21,2
ISL,Iceland,IND,India,2011,8,16,-8
ISL,Iceland,IND,India,2012,4,19,-15
ISL,Iceland,IND,India,2013,16,23,-7
ISL,Iceland,IND,India,2014,13,20,-7
ISL,Iceland,IND,India,2015,12,17,-5
ISL,Iceland,IND,India,2016,15,26,-11
ISL,Iceland,IND,India,2017,12,17,-5
ITA,Italy,IND,India,2008,403,12469,-12066
ITA,Italy,IND,India,2009,476,12769,-12293
ITA,Italy,IND,India,2010,1011,15246,-14235
ITA,Italy,IND,India,2011,1058,13327,-12269
ITA,Italy,IND,India,2012,1285,11158,-9873
ITA,Italy,IND,India,2013,1485,10814,-9329
ITA,Italy,IND,India,2014,1666,11052,-9386
ITA,Italy,IND,India,2015,1491,11236,-9745
ITA,Italy,IND,India,2016,0,9980,-9980
ITA,Italy,IND,India,2017,1450,7723,-6273
JPN,Japan,IND,India,2008,3470,5744,-2274
JPN,Japan,IND,India,2009,3004,4559,-1555
JPN,Japan,IND,India,2010,3329,4854,-1525
JPN,Japan,IND,India,2011,3126,4673,-1547
JPN,Japan,IND,India,2012,3379,5632,-2253
JPN,Japan,IND,India,2013,3124,5605,-2481
JPN,Japan,IND,India,2014,3111,6886,-3775
JPN,Japan,IND,India,2015,3357,6850,-3493
JPN,Japan,IND,India,2016,3228,7009,-3781
JPN,Japan,IND,India,2017,3562,7920,-4358
KOR,Korea,IND,India,2008,2706,2161,545
KOR,Korea,IND,India,2009,2407,1788,619
KOR,Korea,IND,India,2010,2169,2287,-118
KOR,Korea,IND,India,2011,2530,2415,115
KOR,Korea,IND,India,2012,2395,2582,-187
KOR,Korea,IND,India,2013,2736,2858,-122
KOR,Korea,IND,India,2014,2818,3445,-627
KOR,Korea,IND,India,2015,3202,3060,142
KOR,Korea,IND,India,2016,3168,3208,-40
KOR,Korea,IND,India,2017,3396,3820,-424
LUX,Luxembourg,IND,India,2008,41,178,-137
LUX,Luxembourg,IND,India,2009,39,97,-58
LUX,Luxembourg,IND,India,2010,36,127,-91
LUX,Luxembourg,IND,India,2011,32,156,-124
LUX,Luxembourg,IND,India,2012,59,143,-84
LUX,Luxembourg,IND,India,2013,95,145,-50
LUX,Luxembourg,IND,India,2014,89,201,-112
LUX,Luxembourg,IND,India,2015,99,337,-238
LUX,Luxembourg,IND,India,2016,154,394,-240
LUX,Luxembourg,IND,India,2017,159,620,-461
MEX,Mexico,IND,India,2008,0,42,-42
MEX,Mexico,IND,India,2009,0,64,-64
MEX,Mexico,IND,India,2010,0,70,-70
MEX,Mexico,IND,India,2011,0,64,-64
MEX,Mexico,IND,India,2012,0,69,-69
MEX,Mexico,IND,India,2013,0,200,-200
MEX,Mexico,IND,India,2014,0,160,-160
MEX,Mexico,IND,India,2015,0,171,-171
MEX,Mexico,IND,India,2016,0,219,-219
MEX,Mexico,IND,India,2017,0,251,-251
NLD,Netherlands,IND,India,2008,1768,3454,-1686
NLD,Netherlands,IND,India,2009,2214,3069,-855
NLD,Netherlands,IND,India,2010,2286,3172,-886
NLD,Netherlands,IND,India,2011,2412,3783,-1371
NLD,Netherlands,IND,India,2012,2820,3956,-1136
NLD,Netherlands,IND,India,2013,2880,4480,-1600
NLD,Netherlands,IND,India,2014,2932,5051,-2119
NLD,Netherlands,IND,India,2015,3356,6137,-2781
NLD,Netherlands,IND,India,2016,3656,7248,-3592
NLD,Netherlands,IND,India,2017,3893,8629,-4736
NZL,New Zealand,IND,India,2008,719,6265,-5546
NZL,New Zealand,IND,India,2009,923,7060,-6137
NZL,New Zealand,IND,India,2010,1145,7849,-6704
NZL,New Zealand,IND,India,2011,1462,6640,-5178
NZL,New Zealand,IND,India,2012,1412,6891,-5479
NZL,New Zealand,IND,India,2013,1435,7143,-5708
NZL,New Zealand,IND,India,2014,1240,12230,-10990
NZL,New Zealand,IND,India,2015,1349,15477,-14128
NZL,New Zealand,IND,India,2016,1596,11069,-9473
NZL,New Zealand,IND,India,2017,2576,10067,-7491
NOR,Norway,IND,India,2008,307,1068,-761
NOR,Norway,IND,India,2009,487,773,-286
NOR,Norway,IND,India,2010,595,812,-217
NOR,Norway,IND,India,2011,568,1167,-599
NOR,Norway,IND,India,2012,570,1513,-943
NOR,Norway,IND,India,2013,719,1500,-781
NOR,Norway,IND,India,2014,829,1827,-998
NOR,Norway,IND,India,2015,1198,1656,-458
NOR,Norway,IND,India,2016,1260,1366,-106
NOR,Norway,IND,India,2017,889,1607,-718
POL,Poland,IND,India,2008,0,1031,-1031
POL,Poland,IND,India,2009,0,1137,-1137
POL,Poland,IND,India,2010,0,1201,-1201
POL,Poland,IND,India,2011,0,1077,-1077
POL,Poland,IND,India,2012,0,1151,-1151
POL,Poland,IND,India,2013,0,1214,-1214
POL,Poland,IND,India,2014,0,785,-785
POL,Poland,IND,India,2015,0,1881,-1881
POL,Poland,IND,India,2016,0,2813,-2813
POL,Poland,IND,India,2017,0,4135,-4135
PRT,Portugal,IND,India,2008,0,866,-866
PRT,Portugal,IND,India,2009,0,976,-976
PRT,Portugal,IND,India,2010,0,915,-915
PRT,Portugal,IND,India,2011,0,1107,-1107
PRT,Portugal,IND,India,2012,0,927,-927
PRT,Portugal,IND,India,2013,0,970,-970
PRT,Portugal,IND,India,2014,0,936,-936
PRT,Portugal,IND,India,2015,0,1121,-1121
PRT,Portugal,IND,India,2016,0,1024,-1024
PRT,Portugal,IND,India,2017,0,1801,-1801
SVK,Slovak Republic,IND,India,2008,34,4,30
SVK,Slovak Republic,IND,India,2009,25,7,18
SVK,Slovak Republic,IND,India,2010,30,8,22
SVK,Slovak Republic,IND,India,2011,1,3,-2
SVK,Slovak Republic,IND,India,2012,0,2,-2
SVK,Slovak Republic,IND,India,2013,0,8,-8
SVK,Slovak Republic,IND,India,2014,0,3,-3
SVK,Slovak Republic,IND,India,2015,0,7,-7
SVK,Slovak Republic,IND,India,2016,0,3,-3
SVK,Slovak Republic,IND,India,2017,0,3,-3
ESP,Spain,IND,India,2008,1473,5024,-3551
ESP,Spain,IND,India,2009,2378,4280,-1902
ESP,Spain,IND,India,2010,3015,3382,-367
ESP,Spain,IND,India,2011,3649,3649,0
ESP,Spain,IND,India,2012,3938,2932,1006
ESP,Spain,IND,India,2013,4485,2827,1658
ESP,Spain,IND,India,2014,2519,2893,-374
ESP,Spain,IND,India,2015,2007,2990,-983
ESP,Spain,IND,India,2016,2010,3792,-1782
ESP,Spain,IND,India,2017,2117,4758,-2641
SWE,Sweden,IND,India,2008,661,1548,-887
SWE,Sweden,IND,India,2009,595,1795,-1200
SWE,Sweden,IND,India,2010,673,2150,-1477
SWE,Sweden,IND,India,2011,921,1691,-770
SWE,Sweden,IND,India,2012,1228,2027,-799
SWE,Sweden,IND,India,2013,1235,2376,-1141
SWE,Sweden,IND,India,2014,1634,3004,-1370
SWE,Sweden,IND,India,2015,2194,3522,-1328
SWE,Sweden,IND,India,2016,1682,4161,-2479
SWE,Sweden,IND,India,2017,1659,5673,-4014
CHE,Switzerland,IND,India,2010,1575,2371,-796
CHE,Switzerland,IND,India,2011,1478,2410,-932
CHE,Switzerland,IND,India,2012,1628,2584,-956
CHE,Switzerland,IND,India,2013,1821,2524,-703
CHE,Switzerland,IND,India,2014,1705,2640,-935
CHE,Switzerland,IND,India,2015,1761,2862,-1101
CHE,Switzerland,IND,India,2016,2307,2912,-605
CHE,Switzerland,IND,India,2017,2127,3073,-946
TUR,Turkey,IND,India,2010,0,81,-81
TUR,Turkey,IND,India,2016,418,1769,-1351
TUR,Turkey,IND,India,2017,671,2210,-1539
GBR,United Kingdom,IND,India,2008,15000,48000,-33000
GBR,United Kingdom,IND,India,2009,15000,64000,-49000
GBR,United Kingdom,IND,India,2010,14000,68000,-54000
GBR,United Kingdom,IND,India,2011,22000,61000,-39000
GBR,United Kingdom,IND,India,2012,17000,36000,-19000
GBR,United Kingdom,IND,India,2013,14000,30000,-16000
GBR,United Kingdom,IND,India,2014,13000,46000,-33000
GBR,United Kingdom,IND,India,2015,13000,36000,-23000
GBR,United Kingdom,IND,India,2016,11000,35000,-24000
GBR,United Kingdom,IND,India,2017,8000,50000,-42000
USA,United States,IND,India,2008,0,63352,-63352
USA,United States,IND,India,2009,0,57304,-57304
USA,United States,IND,India,2010,0,69162,-69162
USA,United States,IND,India,2011,0,69013,-69013
USA,United States,IND,India,2012,0,66434,-66434
USA,United States,IND,India,2013,0,68458,-68458
USA,United States,IND,India,2014,0,77908,-77908
USA,United States,IND,India,2015,0,64116,-64116
USA,United States,IND,India,2016,0,64687,-64687
USA,United States,IND,India,2017,0,60394,-60394
CHL,Chile,IND,India,2008,0,161,-161
CHL,Chile,IND,India,2009,0,117,-117
CHL,Chile,IND,India,2010,0,142,-142
CHL,Chile,IND,India,2011,0,142,-142
CHL,Chile,IND,India,2012,0,175,-175
CHL,Chile,IND,India,2013,0,122,-122
CHL,Chile,IND,India,2014,0,135,-135
CHL,Chile,IND,India,2015,0,213,-213
CHL,Chile,IND,India,2016,0,239,-239
EST,Estonia,IND,India,2008,0,16,-16
EST,Estonia,IND,India,2009,0,14,-14
EST,Estonia,IND,India,2010,0,11,-11
EST,Estonia,IND,India,2011,0,20,-20
EST,Estonia,IND,India,2012,0,28,-28
EST,Estonia,IND,India,2013,0,47,-47
EST,Estonia,IND,India,2014,0,25,-25
EST,Estonia,IND,India,2015,0,80,-80
EST,Estonia,IND,India,2016,0,106,-106
EST,Estonia,IND,India,2017,0,132,-132
ISR,Israel,IND,India,2008,0,61,-61
ISR,Israel,IND,India,2009,0,30,-30
ISR,Israel,IND,India,2010,0,44,-44
ISR,Israel,IND,India,2011,0,35,-35
ISR,Israel,IND,India,2012,0,27,-27
ISR,Israel,IND,India,2013,0,44,-44
ISR,Israel,IND,India,2014,0,32,-32
ISR,Israel,IND,India,2015,0,47,-47
ISR,Israel,IND,India,2016,0,55,-55
ISR,Israel,IND,India,2017,0,56,-56
SVN,Slovenia,IND,India,2008,0,42,-42
SVN,Slovenia,IND,India,2009,0,22,-22
SVN,Slovenia,IND,India,2010,0,33,-33
SVN,Slovenia,IND,India,2011,2,35,-33
SVN,Slovenia,IND,India,2012,1,35,-34
SVN,Slovenia,IND,India,2013,1,23,-22
SVN,Slovenia,IND,India,2014,0,30,-30
SVN,Slovenia,IND,India,2015,3,35,-32
SVN,Slovenia,IND,India,2016,2,87,-85
SVN,Slovenia,IND,India,2017,9,82,-73
AUS,Australia,IDN,Indonesia,2008,179,3162,-2983
AUS,Australia,IDN,Indonesia,2009,183,2860,-2677
AUS,Australia,IDN,Indonesia,2010,219,2408,-2189
AUS,Australia,IDN,Indonesia,2011,305,2906,-2601
AUS,Australia,IDN,Indonesia,2012,296,2510,-2214
AUS,Australia,IDN,Indonesia,2013,293,2514,-2221
AUS,Australia,IDN,Indonesia,2014,326,2366,-2040
AUS,Australia,IDN,Indonesia,2015,300,2076,-1776
AUS,Australia,IDN,Indonesia,2016,300,2092,-1792
AUS,Australia,IDN,Indonesia,2017,0,1888,-1888
AUT,Austria,IDN,Indonesia,2008,43,70,-27
AUT,Austria,IDN,Indonesia,2009,68,126,-58
AUT,Austria,IDN,Indonesia,2010,79,93,-14
AUT,Austria,IDN,Indonesia,2011,63,113,-50
AUT,Austria,IDN,Indonesia,2012,79,119,-40
AUT,Austria,IDN,Indonesia,2013,91,104,-13
AUT,Austria,IDN,Indonesia,2014,84,115,-31
AUT,Austria,IDN,Indonesia,2015,67,158,-91
AUT,Austria,IDN,Indonesia,2016,92,125,-33
AUT,Austria,IDN,Indonesia,2017,78,121,-43
BEL,Belgium,IDN,Indonesia,2008,0,187,-187
BEL,Belgium,IDN,Indonesia,2009,0,156,-156
BEL,Belgium,IDN,Indonesia,2010,105,158,-53
BEL,Belgium,IDN,Indonesia,2011,111,172,-61
BEL,Belgium,IDN,Indonesia,2012,124,193,-69
BEL,Belgium,IDN,Indonesia,2013,121,169,-48
BEL,Belgium,IDN,Indonesia,2014,96,128,-32
BEL,Belgium,IDN,Indonesia,2015,91,164,-73
BEL,Belgium,IDN,Indonesia,2016,49,186,-137
BEL,Belgium,IDN,Indonesia,2017,58,195,-137
CAN,Canada,IDN,Indonesia,2008,0,661,-661
CAN,Canada,IDN,Indonesia,2009,0,504,-504
CAN,Canada,IDN,Indonesia,2010,0,712,-712
CAN,Canada,IDN,Indonesia,2011,0,390,-390
CAN,Canada,IDN,Indonesia,2012,0,395,-395
CAN,Canada,IDN,Indonesia,2013,0,386,-386
CAN,Canada,IDN,Indonesia,2014,0,416,-416
CAN,Canada,IDN,Indonesia,2015,0,377,-377
CAN,Canada,IDN,Indonesia,2016,0,445,-445
CAN,Canada,IDN,Indonesia,2017,0,500,-500
CZE,Czech Republic,IDN,Indonesia,2008,2,126,-124
CZE,Czech Republic,IDN,Indonesia,2009,0,26,-26
CZE,Czech Republic,IDN,Indonesia,2010,0,35,-35
CZE,Czech Republic,IDN,Indonesia,2011,0,23,-23
CZE,Czech Republic,IDN,Indonesia,2012,7,17,-10
CZE,Czech Republic,IDN,Indonesia,2013,31,31,0
CZE,Czech Republic,IDN,Indonesia,2014,20,35,-15
CZE,Czech Republic,IDN,Indonesia,2015,16,26,-10
CZE,Czech Republic,IDN,Indonesia,2016,24,54,-30
CZE,Czech Republic,IDN,Indonesia,2017,21,35,-14
DNK,Denmark,IDN,Indonesia,2008,39,52,-13
DNK,Denmark,IDN,Indonesia,2009,49,54,-5
DNK,Denmark,IDN,Indonesia,2010,44,51,-7
DNK,Denmark,IDN,Indonesia,2011,56,52,4
DNK,Denmark,IDN,Indonesia,2012,51,66,-15
DNK,Denmark,IDN,Indonesia,2013,55,66,-11
DNK,Denmark,IDN,Indonesia,2014,27,78,-51
DNK,Denmark,IDN,Indonesia,2015,49,67,-18
DNK,Denmark,IDN,Indonesia,2016,62,88,-26
DNK,Denmark,IDN,Indonesia,2017,43,88,-45
FIN,Finland,IDN,Indonesia,2008,5,17,-12
FIN,Finland,IDN,Indonesia,2009,7,40,-33
FIN,Finland,IDN,Indonesia,2010,5,28,-23
FIN,Finland,IDN,Indonesia,2011,4,29,-25
FIN,Finland,IDN,Indonesia,2012,11,41,-30
FIN,Finland,IDN,Indonesia,2013,4,41,-37
FIN,Finland,IDN,Indonesia,2014,7,59,-52
FIN,Finland,IDN,Indonesia,2015,13,38,-25
FIN,Finland,IDN,Indonesia,2016,10,66,-56
FIN,Finland,IDN,Indonesia,2017,3,63,-60
FRA,France,IDN,Indonesia,2008,0,159,-159
FRA,France,IDN,Indonesia,2009,0,229,-229
FRA,France,IDN,Indonesia,2010,0,241,-241
FRA,France,IDN,Indonesia,2011,0,228,-228
FRA,France,IDN,Indonesia,2012,0,229,-229
FRA,France,IDN,Indonesia,2013,0,266,-266
FRA,France,IDN,Indonesia,2014,0,272,-272
FRA,France,IDN,Indonesia,2015,0,250,-250
FRA,France,IDN,Indonesia,2016,0,248,-248
FRA,France,IDN,Indonesia,2017,0,190,-190
DEU,Germany,IDN,Indonesia,2008,1440,1557,-117
DEU,Germany,IDN,Indonesia,2009,1658,1776,-118
DEU,Germany,IDN,Indonesia,2010,1552,1759,-207
DEU,Germany,IDN,Indonesia,2011,1362,1951,-589
DEU,Germany,IDN,Indonesia,2012,1254,2242,-988
DEU,Germany,IDN,Indonesia,2013,1512,2765,-1253
DEU,Germany,IDN,Indonesia,2014,1557,2520,-963
DEU,Germany,IDN,Indonesia,2015,1633,2470,-837
DEU,Germany,IDN,Indonesia,2016,1722,2701,-979
DEU,Germany,IDN,Indonesia,2017,1532,2577,-1045
HUN,Hungary,IDN,Indonesia,2008,0,29,-29
HUN,Hungary,IDN,Indonesia,2009,1,40,-39
HUN,Hungary,IDN,Indonesia,2010,6,48,-42
HUN,Hungary,IDN,Indonesia,2011,7,44,-37
HUN,Hungary,IDN,Indonesia,2012,6,24,-18
HUN,Hungary,IDN,Indonesia,2013,2,39,-37
HUN,Hungary,IDN,Indonesia,2014,7,35,-28
HUN,Hungary,IDN,Indonesia,2015,3,48,-45
HUN,Hungary,IDN,Indonesia,2016,7,55,-48
HUN,Hungary,IDN,Indonesia,2017,0,94,-94
ISL,Iceland,IDN,Indonesia,2008,42,10,32
ISL,Iceland,IDN,Indonesia,2009,2,2,0
ISL,Iceland,IDN,Indonesia,2010,5,6,-1
ISL,Iceland,IDN,Indonesia,2011,5,13,-8
ISL,Iceland,IDN,Indonesia,2012,4,6,-2
ISL,Iceland,IDN,Indonesia,2013,0,5,-5
ISL,Iceland,IDN,Indonesia,2014,5,10,-5
ISL,Iceland,IDN,Indonesia,2015,2,7,-5
ISL,Iceland,IDN,Indonesia,2016,9,10,-1
ISL,Iceland,IDN,Indonesia,2017,8,12,-4
ITA,Italy,IDN,Indonesia,2008,3,153,-150
ITA,Italy,IDN,Indonesia,2009,4,251,-247
ITA,Italy,IDN,Indonesia,2010,30,200,-170
ITA,Italy,IDN,Indonesia,2011,26,218,-192
ITA,Italy,IDN,Indonesia,2012,44,265,-221
ITA,Italy,IDN,Indonesia,2013,22,230,-208
ITA,Italy,IDN,Indonesia,2014,30,212,-182
ITA,Italy,IDN,Indonesia,2015,37,218,-181
ITA,Italy,IDN,Indonesia,2016,0,189,-189
ITA,Italy,IDN,Indonesia,2017,43,168,-125
JPN,Japan,IDN,Indonesia,2008,7612,10069,-2457
JPN,Japan,IDN,Indonesia,2009,8053,7481,572
JPN,Japan,IDN,Indonesia,2010,8160,8297,-137
JPN,Japan,IDN,Indonesia,2011,7789,8351,-562
JPN,Japan,IDN,Indonesia,2012,7081,9282,-2201
JPN,Japan,IDN,Indonesia,2013,7270,9628,-2358
JPN,Japan,IDN,Indonesia,2014,7747,11757,-4010
JPN,Japan,IDN,Indonesia,2015,8441,14295,-5854
JPN,Japan,IDN,Indonesia,2016,10453,16846,-6393
JPN,Japan,IDN,Indonesia,2017,12823,19632,-6809
KOR,Korea,IDN,Indonesia,2008,5872,9654,-3782
KOR,Korea,IDN,Indonesia,2009,5309,3344,1965
KOR,Korea,IDN,Indonesia,2010,4232,5308,-1076
KOR,Korea,IDN,Indonesia,2011,6158,8053,-1895
KOR,Korea,IDN,Indonesia,2012,7894,8263,-369
KOR,Korea,IDN,Indonesia,2013,7864,11760,-3896
KOR,Korea,IDN,Indonesia,2014,5263,10506,-5243
KOR,Korea,IDN,Indonesia,2015,7111,8538,-1427
KOR,Korea,IDN,Indonesia,2016,9713,8956,757
KOR,Korea,IDN,Indonesia,2017,9066,6887,2179
LUX,Luxembourg,IDN,Indonesia,2008,1,5,-4
LUX,Luxembourg,IDN,Indonesia,2009,3,6,-3
LUX,Luxembourg,IDN,Indonesia,2010,5,10,-5
LUX,Luxembourg,IDN,Indonesia,2011,4,5,-1
LUX,Luxembourg,IDN,Indonesia,2012,3,1,2
LUX,Luxembourg,IDN,Indonesia,2013,1,5,-4
LUX,Luxembourg,IDN,Indonesia,2014,2,13,-11
LUX,Luxembourg,IDN,Indonesia,2015,1,4,-3
LUX,Luxembourg,IDN,Indonesia,2016,2,10,-8
LUX,Luxembourg,IDN,Indonesia,2017,2,8,-6
MEX,Mexico,IDN,Indonesia,2008,0,6,-6
MEX,Mexico,IDN,Indonesia,2009,0,5,-5
MEX,Mexico,IDN,Indonesia,2010,0,6,-6
MEX,Mexico,IDN,Indonesia,2011,0,10,-10
MEX,Mexico,IDN,Indonesia,2012,0,6,-6
MEX,Mexico,IDN,Indonesia,2013,0,48,-48
MEX,Mexico,IDN,Indonesia,2014,0,19,-19
MEX,Mexico,IDN,Indonesia,2015,0,12,-12
MEX,Mexico,IDN,Indonesia,2016,0,6,-6
MEX,Mexico,IDN,Indonesia,2017,0,13,-13
NLD,Netherlands,IDN,Indonesia,2008,887,1248,-361
NLD,Netherlands,IDN,Indonesia,2009,954,1110,-156
NLD,Netherlands,IDN,Indonesia,2010,910,1227,-317
NLD,Netherlands,IDN,Indonesia,2011,907,1310,-403
NLD,Netherlands,IDN,Indonesia,2012,941,1168,-227
NLD,Netherlands,IDN,Indonesia,2013,1016,1328,-312
NLD,Netherlands,IDN,Indonesia,2014,1003,1394,-391
NLD,Netherlands,IDN,Indonesia,2015,1053,1481,-428
NLD,Netherlands,IDN,Indonesia,2016,1170,1827,-657
NLD,Netherlands,IDN,Indonesia,2017,1387,1611,-224
NZL,New Zealand,IDN,Indonesia,2008,160,306,-146
NZL,New Zealand,IDN,Indonesia,2009,179,297,-118
NZL,New Zealand,IDN,Indonesia,2010,187,292,-105
NZL,New Zealand,IDN,Indonesia,2011,163,370,-207
NZL,New Zealand,IDN,Indonesia,2012,157,380,-223
NZL,New Zealand,IDN,Indonesia,2013,155,478,-323
NZL,New Zealand,IDN,Indonesia,2014,166,491,-325
NZL,New Zealand,IDN,Indonesia,2015,125,534,-409
NZL,New Zealand,IDN,Indonesia,2016,166,621,-455
NZL,New Zealand,IDN,Indonesia,2017,203,626,-423
NOR,Norway,IDN,Indonesia,2008,50,151,-101
NOR,Norway,IDN,Indonesia,2009,63,124,-61
NOR,Norway,IDN,Indonesia,2010,57,122,-65
NOR,Norway,IDN,Indonesia,2011,67,140,-73
NOR,Norway,IDN,Indonesia,2012,82,152,-70
NOR,Norway,IDN,Indonesia,2013,97,109,-12
NOR,Norway,IDN,Indonesia,2014,91,106,-15
NOR,Norway,IDN,Indonesia,2015,91,90,1
NOR,Norway,IDN,Indonesia,2016,94,92,2
NOR,Norway,IDN,Indonesia,2017,60,113,-53
POL,Poland,IDN,Indonesia,2009,0,53,-53
POL,Poland,IDN,Indonesia,2010,0,80,-80
POL,Poland,IDN,Indonesia,2011,0,62,-62
POL,Poland,IDN,Indonesia,2012,0,58,-58
POL,Poland,IDN,Indonesia,2013,0,80,-80
POL,Poland,IDN,Indonesia,2014,0,36,-36
POL,Poland,IDN,Indonesia,2015,0,102,-102
POL,Poland,IDN,Indonesia,2016,0,116,-116
POL,Poland,IDN,Indonesia,2017,0,106,-106
SVK,Slovak Republic,IDN,Indonesia,2008,16,1,15
SVK,Slovak Republic,IDN,Indonesia,2009,4,23,-19
SVK,Slovak Republic,IDN,Indonesia,2010,27,2,25
SVK,Slovak Republic,IDN,Indonesia,2011,14,2,12
SVK,Slovak Republic,IDN,Indonesia,2012,0,3,-3
SVK,Slovak Republic,IDN,Indonesia,2013,0,1,-1
SVK,Slovak Republic,IDN,Indonesia,2014,1,5,-4
SVK,Slovak Republic,IDN,Indonesia,2015,0,2,-2
SVK,Slovak Republic,IDN,Indonesia,2016,0,2,-2
SVK,Slovak Republic,IDN,Indonesia,2017,0,2,-2
ESP,Spain,IDN,Indonesia,2008,61,364,-303
ESP,Spain,IDN,Indonesia,2009,112,173,-61
ESP,Spain,IDN,Indonesia,2010,101,91,10
ESP,Spain,IDN,Indonesia,2011,103,113,-10
ESP,Spain,IDN,Indonesia,2012,93,120,-27
ESP,Spain,IDN,Indonesia,2013,106,119,-13
ESP,Spain,IDN,Indonesia,2014,52,148,-96
ESP,Spain,IDN,Indonesia,2015,55,160,-105
ESP,Spain,IDN,Indonesia,2016,64,218,-154
ESP,Spain,IDN,Indonesia,2017,121,210,-89
SWE,Sweden,IDN,Indonesia,2008,23,111,-88
SWE,Sweden,IDN,Indonesia,2009,19,127,-108
SWE,Sweden,IDN,Indonesia,2010,34,99,-65
SWE,Sweden,IDN,Indonesia,2011,53,87,-34
SWE,Sweden,IDN,Indonesia,2012,60,103,-43
SWE,Sweden,IDN,Indonesia,2013,40,96,-56
SWE,Sweden,IDN,Indonesia,2014,53,110,-57
SWE,Sweden,IDN,Indonesia,2015,67,124,-57
SWE,Sweden,IDN,Indonesia,2016,57,189,-132
SWE,Sweden,IDN,Indonesia,2017,43,153,-110
CHE,Switzerland,IDN,Indonesia,2010,163,195,-32
CHE,Switzerland,IDN,Indonesia,2011,159,233,-74
CHE,Switzerland,IDN,Indonesia,2012,136,226,-90
CHE,Switzerland,IDN,Indonesia,2013,183,307,-124
CHE,Switzerland,IDN,Indonesia,2014,197,221,-24
CHE,Switzerland,IDN,Indonesia,2015,187,248,-61
CHE,Switzerland,IDN,Indonesia,2016,191,266,-75
CHE,Switzerland,IDN,Indonesia,2017,199,248,-49
TUR,Turkey,IDN,Indonesia,2010,0,320,-320
TUR,Turkey,IDN,Indonesia,2016,602,1161,-559
TUR,Turkey,IDN,Indonesia,2017,715,1591,-876
GBR,United Kingdom,IDN,Indonesia,2011,0,1000,-1000
GBR,United Kingdom,IDN,Indonesia,2012,0,2000,-2000
GBR,United Kingdom,IDN,Indonesia,2013,0,3000,-3000
GBR,United Kingdom,IDN,Indonesia,2014,0,2000,-2000
GBR,United Kingdom,IDN,Indonesia,2015,1000,1000,0
USA,United States,IDN,Indonesia,2008,0,3606,-3606
USA,United States,IDN,Indonesia,2009,0,3679,-3679
USA,United States,IDN,Indonesia,2010,0,3032,-3032
USA,United States,IDN,Indonesia,2011,0,2856,-2856
USA,United States,IDN,Indonesia,2012,0,2603,-2603
USA,United States,IDN,Indonesia,2013,0,2731,-2731
USA,United States,IDN,Indonesia,2014,0,2139,-2139
USA,United States,IDN,Indonesia,2015,0,2084,-2084
USA,United States,IDN,Indonesia,2016,0,2129,-2129
USA,United States,IDN,Indonesia,2017,0,1914,-1914
CHL,Chile,IDN,Indonesia,2008,0,9,-9
CHL,Chile,IDN,Indonesia,2009,0,14,-14
CHL,Chile,IDN,Indonesia,2010,0,83,-83
CHL,Chile,IDN,Indonesia,2011,0,10,-10
CHL,Chile,IDN,Indonesia,2012,0,12,-12
CHL,Chile,IDN,Indonesia,2013,0,11,-11
CHL,Chile,IDN,Indonesia,2014,0,27,-27
CHL,Chile,IDN,Indonesia,2015,0,42,-42
CHL,Chile,IDN,Indonesia,2016,0,25,-25
EST,Estonia,IDN,Indonesia,2008,0,1,-1
EST,Estonia,IDN,Indonesia,2009,0,0,0
EST,Estonia,IDN,Indonesia,2010,0,1,-1
EST,Estonia,IDN,Indonesia,2011,0,2,-2
EST,Estonia,IDN,Indonesia,2012,0,2,-2
EST,Estonia,IDN,Indonesia,2013,0,1,-1
EST,Estonia,IDN,Indonesia,2014,0,0,0
EST,Estonia,IDN,Indonesia,2015,0,6,-6
EST,Estonia,IDN,Indonesia,2016,0,2,-2
EST,Estonia,IDN,Indonesia,2017,0,13,-13
SVN,Slovenia,IDN,Indonesia,2008,0,6,-6
SVN,Slovenia,IDN,Indonesia,2009,0,1,-1
SVN,Slovenia,IDN,Indonesia,2010,0,2,-2
SVN,Slovenia,IDN,Indonesia,2011,0,9,-9
SVN,Slovenia,IDN,Indonesia,2012,0,4,-4
SVN,Slovenia,IDN,Indonesia,2013,0,3,-3
SVN,Slovenia,IDN,Indonesia,2015,0,7,-7
SVN,Slovenia,IDN,Indonesia,2016,0,1,-1
SVN,Slovenia,IDN,Indonesia,2017,0,2,-2
AUS,Australia,IRN,Iran,2008,264,1153,-889
AUS,Australia,IRN,Iran,2009,254,2041,-1787
AUS,Australia,IRN,Iran,2010,248,1832,-1584
AUS,Australia,IRN,Iran,2011,264,2559,-2295
AUS,Australia,IRN,Iran,2012,277,3024,-2747
AUS,Australia,IRN,Iran,2013,310,3068,-2758
AUS,Australia,IRN,Iran,2014,397,2693,-2296
AUS,Australia,IRN,Iran,2015,500,3935,-3435
AUS,Australia,IRN,Iran,2016,500,2785,-2285
AUS,Australia,IRN,Iran,2017,0,2818,-2818
AUT,Austria,IRN,Iran,2008,1657,1701,-44
AUT,Austria,IRN,Iran,2009,1649,1872,-223
AUT,Austria,IRN,Iran,2010,1373,1627,-254
AUT,Austria,IRN,Iran,2011,1108,1349,-241
AUT,Austria,IRN,Iran,2012,1007,2409,-1402
AUT,Austria,IRN,Iran,2013,1679,2595,-916
AUT,Austria,IRN,Iran,2014,1982,2612,-630
AUT,Austria,IRN,Iran,2015,1399,4673,-3274
AUT,Austria,IRN,Iran,2016,2396,4678,-2282
AUT,Austria,IRN,Iran,2017,1726,1806,-80
BEL,Belgium,IRN,Iran,2008,0,242,-242
BEL,Belgium,IRN,Iran,2009,0,277,-277
BEL,Belgium,IRN,Iran,2010,119,350,-231
BEL,Belgium,IRN,Iran,2011,173,374,-201
BEL,Belgium,IRN,Iran,2012,238,644,-406
BEL,Belgium,IRN,Iran,2013,272,460,-188
BEL,Belgium,IRN,Iran,2014,283,338,-55
BEL,Belgium,IRN,Iran,2015,210,644,-434
BEL,Belgium,IRN,Iran,2016,123,437,-314
BEL,Belgium,IRN,Iran,2017,152,447,-295
CAN,Canada,IRN,Iran,2008,0,6474,-6474
CAN,Canada,IRN,Iran,2009,0,6580,-6580
CAN,Canada,IRN,Iran,2010,0,7477,-7477
CAN,Canada,IRN,Iran,2011,0,7479,-7479
CAN,Canada,IRN,Iran,2012,0,7525,-7525
CAN,Canada,IRN,Iran,2013,0,11288,-11288
CAN,Canada,IRN,Iran,2014,0,16772,-16772
CAN,Canada,IRN,Iran,2015,0,11668,-11668
CAN,Canada,IRN,Iran,2016,0,6485,-6485
CAN,Canada,IRN,Iran,2017,0,4735,-4735
CZE,Czech Republic,IRN,Iran,2008,0,54,-54
CZE,Czech Republic,IRN,Iran,2009,0,64,-64
CZE,Czech Republic,IRN,Iran,2010,0,79,-79
CZE,Czech Republic,IRN,Iran,2011,0,27,-27
CZE,Czech Republic,IRN,Iran,2012,11,35,-24
CZE,Czech Republic,IRN,Iran,2013,37,58,-21
CZE,Czech Republic,IRN,Iran,2014,20,63,-43
CZE,Czech Republic,IRN,Iran,2015,29,66,-37
CZE,Czech Republic,IRN,Iran,2016,29,73,-44
CZE,Czech Republic,IRN,Iran,2017,31,127,-96
DNK,Denmark,IRN,Iran,2008,70,210,-140
DNK,Denmark,IRN,Iran,2009,48,296,-248
DNK,Denmark,IRN,Iran,2010,85,461,-376
DNK,Denmark,IRN,Iran,2011,108,567,-459
DNK,Denmark,IRN,Iran,2012,107,592,-485
DNK,Denmark,IRN,Iran,2013,134,931,-797
DNK,Denmark,IRN,Iran,2014,221,939,-718
DNK,Denmark,IRN,Iran,2015,304,0,304
DNK,Denmark,IRN,Iran,2016,404,819,-415
DNK,Denmark,IRN,Iran,2017,381,1273,-892
FIN,Finland,IRN,Iran,2008,35,231,-196
FIN,Finland,IRN,Iran,2009,15,150,-135
FIN,Finland,IRN,Iran,2010,4,209,-205
FIN,Finland,IRN,Iran,2011,20,268,-248
FIN,Finland,IRN,Iran,2012,35,333,-298
FIN,Finland,IRN,Iran,2013,37,403,-366
FIN,Finland,IRN,Iran,2014,41,414,-373
FIN,Finland,IRN,Iran,2015,27,265,-238
FIN,Finland,IRN,Iran,2016,46,440,-394
FIN,Finland,IRN,Iran,2017,45,337,-292
FRA,France,IRN,Iran,2008,0,405,-405
FRA,France,IRN,Iran,2009,0,478,-478
FRA,France,IRN,Iran,2010,0,599,-599
FRA,France,IRN,Iran,2011,0,542,-542
FRA,France,IRN,Iran,2012,0,567,-567
FRA,France,IRN,Iran,2013,0,576,-576
FRA,France,IRN,Iran,2014,0,495,-495
FRA,France,IRN,Iran,2015,0,441,-441
FRA,France,IRN,Iran,2016,0,566,-566
FRA,France,IRN,Iran,2017,0,761,-761
DEU,Germany,IRN,Iran,2008,3189,3257,-68
DEU,Germany,IRN,Iran,2009,3510,3951,-441
DEU,Germany,IRN,Iran,2010,2861,5695,-2834
DEU,Germany,IRN,Iran,2011,2370,7175,-4805
DEU,Germany,IRN,Iran,2012,2579,8215,-5636
DEU,Germany,IRN,Iran,2013,2759,8250,-5491
DEU,Germany,IRN,Iran,2014,2628,7122,-4494
DEU,Germany,IRN,Iran,2015,3115,17187,-14072
DEU,Germany,IRN,Iran,2016,7269,23009,-15740
DEU,Germany,IRN,Iran,2017,4857,13676,-8819
HUN,Hungary,IRN,Iran,2008,59,476,-417
HUN,Hungary,IRN,Iran,2009,68,454,-386
HUN,Hungary,IRN,Iran,2010,134,403,-269
HUN,Hungary,IRN,Iran,2011,96,433,-337
HUN,Hungary,IRN,Iran,2012,74,351,-277
HUN,Hungary,IRN,Iran,2013,113,279,-166
HUN,Hungary,IRN,Iran,2014,145,349,-204
HUN,Hungary,IRN,Iran,2015,115,492,-377
HUN,Hungary,IRN,Iran,2016,121,623,-502
HUN,Hungary,IRN,Iran,2017,0,1009,-1009
ISL,Iceland,IRN,Iran,2008,6,5,1
ISL,Iceland,IRN,Iran,2009,6,3,3
ISL,Iceland,IRN,Iran,2010,0,6,-6
ISL,Iceland,IRN,Iran,2011,2,10,-8
ISL,Iceland,IRN,Iran,2012,1,11,-10
ISL,Iceland,IRN,Iran,2013,8,7,1
ISL,Iceland,IRN,Iran,2014,7,10,-3
ISL,Iceland,IRN,Iran,2015,7,16,-9
ISL,Iceland,IRN,Iran,2016,7,33,-26
ISL,Iceland,IRN,Iran,2017,4,10,-6
ITA,Italy,IRN,Iran,2008,12,483,-471
ITA,Italy,IRN,Iran,2009,14,611,-597
ITA,Italy,IRN,Iran,2010,12,744,-732
ITA,Italy,IRN,Iran,2011,31,940,-909
ITA,Italy,IRN,Iran,2012,40,1378,-1338
ITA,Italy,IRN,Iran,2013,29,1397,-1368
ITA,Italy,IRN,Iran,2014,58,1205,-1147
ITA,Italy,IRN,Iran,2015,61,1190,-1129
ITA,Italy,IRN,Iran,2016,0,1045,-1045
ITA,Italy,IRN,Iran,2017,62,1304,-1242
JPN,Japan,IRN,Iran,2008,286,450,-164
JPN,Japan,IRN,Iran,2009,293,450,-157
JPN,Japan,IRN,Iran,2010,334,449,-115
JPN,Japan,IRN,Iran,2011,241,360,-119
JPN,Japan,IRN,Iran,2012,268,384,-116
JPN,Japan,IRN,Iran,2013,199,273,-74
JPN,Japan,IRN,Iran,2014,209,334,-125
JPN,Japan,IRN,Iran,2015,298,448,-150
JPN,Japan,IRN,Iran,2016,306,475,-169
JPN,Japan,IRN,Iran,2017,303,439,-136
KOR,Korea,IRN,Iran,2008,335,242,93
KOR,Korea,IRN,Iran,2009,306,152,154
KOR,Korea,IRN,Iran,2010,182,217,-35
KOR,Korea,IRN,Iran,2011,192,229,-37
KOR,Korea,IRN,Iran,2012,257,211,46
KOR,Korea,IRN,Iran,2013,162,250,-88
KOR,Korea,IRN,Iran,2014,179,243,-64
KOR,Korea,IRN,Iran,2015,215,253,-38
KOR,Korea,IRN,Iran,2016,206,293,-87
KOR,Korea,IRN,Iran,2017,249,410,-161
LUX,Luxembourg,IRN,Iran,2008,8,30,-22
LUX,Luxembourg,IRN,Iran,2009,9,28,-19
LUX,Luxembourg,IRN,Iran,2010,8,50,-42
LUX,Luxembourg,IRN,Iran,2011,19,32,-13
LUX,Luxembourg,IRN,Iran,2012,15,48,-33
LUX,Luxembourg,IRN,Iran,2013,12,28,-16
LUX,Luxembourg,IRN,Iran,2014,15,22,-7
LUX,Luxembourg,IRN,Iran,2015,10,79,-69
LUX,Luxembourg,IRN,Iran,2016,19,55,-36
LUX,Luxembourg,IRN,Iran,2017,21,59,-38
MEX,Mexico,IRN,Iran,2008,0,12,-12
MEX,Mexico,IRN,Iran,2009,0,10,-10
MEX,Mexico,IRN,Iran,2010,0,12,-12
MEX,Mexico,IRN,Iran,2011,0,28,-28
MEX,Mexico,IRN,Iran,2012,0,15,-15
MEX,Mexico,IRN,Iran,2013,0,26,-26
MEX,Mexico,IRN,Iran,2014,0,20,-20
MEX,Mexico,IRN,Iran,2015,0,30,-30
MEX,Mexico,IRN,Iran,2016,0,16,-16
MEX,Mexico,IRN,Iran,2017,0,23,-23
NLD,Netherlands,IRN,Iran,2008,159,584,-425
NLD,Netherlands,IRN,Iran,2009,216,636,-420
NLD,Netherlands,IRN,Iran,2010,312,689,-377
NLD,Netherlands,IRN,Iran,2011,290,883,-593
NLD,Netherlands,IRN,Iran,2012,237,624,-387
NLD,Netherlands,IRN,Iran,2013,324,695,-371
NLD,Netherlands,IRN,Iran,2014,260,853,-593
NLD,Netherlands,IRN,Iran,2015,308,910,-602
NLD,Netherlands,IRN,Iran,2016,343,1851,-1508
NLD,Netherlands,IRN,Iran,2017,417,1481,-1064
NZL,New Zealand,IRN,Iran,2008,15,116,-101
NZL,New Zealand,IRN,Iran,2009,16,137,-121
NZL,New Zealand,IRN,Iran,2010,18,179,-161
NZL,New Zealand,IRN,Iran,2011,15,192,-177
NZL,New Zealand,IRN,Iran,2012,43,238,-195
NZL,New Zealand,IRN,Iran,2013,41,254,-213
NZL,New Zealand,IRN,Iran,2014,37,355,-318
NZL,New Zealand,IRN,Iran,2015,38,296,-258
NZL,New Zealand,IRN,Iran,2016,30,305,-275
NZL,New Zealand,IRN,Iran,2017,42,309,-267
NOR,Norway,IRN,Iran,2008,88,422,-334
NOR,Norway,IRN,Iran,2009,69,522,-453
NOR,Norway,IRN,Iran,2010,96,548,-452
NOR,Norway,IRN,Iran,2011,118,812,-694
NOR,Norway,IRN,Iran,2012,127,755,-628
NOR,Norway,IRN,Iran,2013,111,753,-642
NOR,Norway,IRN,Iran,2014,155,441,-286
NOR,Norway,IRN,Iran,2015,143,399,-256
NOR,Norway,IRN,Iran,2016,124,722,-598
NOR,Norway,IRN,Iran,2017,94,726,-632
POL,Poland,IRN,Iran,2008,0,68,-68
POL,Poland,IRN,Iran,2009,0,73,-73
POL,Poland,IRN,Iran,2010,0,111,-111
POL,Poland,IRN,Iran,2011,0,126,-126
POL,Poland,IRN,Iran,2012,0,132,-132
POL,Poland,IRN,Iran,2013,0,174,-174
POL,Poland,IRN,Iran,2014,0,89,-89
POL,Poland,IRN,Iran,2015,0,181,-181
POL,Poland,IRN,Iran,2016,0,197,-197
POL,Poland,IRN,Iran,2017,0,233,-233
SVK,Slovak Republic,IRN,Iran,2008,5,2,3
SVK,Slovak Republic,IRN,Iran,2009,4,3,1
SVK,Slovak Republic,IRN,Iran,2010,15,7,8
SVK,Slovak Republic,IRN,Iran,2011,10,1,9
SVK,Slovak Republic,IRN,Iran,2012,0,4,-4
SVK,Slovak Republic,IRN,Iran,2013,0,3,-3
SVK,Slovak Republic,IRN,Iran,2014,0,3,-3
SVK,Slovak Republic,IRN,Iran,2015,0,7,-7
SVK,Slovak Republic,IRN,Iran,2016,0,4,-4
SVK,Slovak Republic,IRN,Iran,2017,0,3,-3
ESP,Spain,IRN,Iran,2008,159,280,-121
ESP,Spain,IRN,Iran,2009,151,291,-140
ESP,Spain,IRN,Iran,2010,178,363,-185
ESP,Spain,IRN,Iran,2011,233,490,-257
ESP,Spain,IRN,Iran,2012,199,616,-417
ESP,Spain,IRN,Iran,2013,358,456,-98
ESP,Spain,IRN,Iran,2014,282,485,-203
ESP,Spain,IRN,Iran,2015,190,549,-359
ESP,Spain,IRN,Iran,2016,250,737,-487
ESP,Spain,IRN,Iran,2017,352,1478,-1126
SWE,Sweden,IRN,Iran,2008,287,1766,-1479
SWE,Sweden,IRN,Iran,2009,131,2416,-2285
SWE,Sweden,IRN,Iran,2010,256,2820,-2564
SWE,Sweden,IRN,Iran,2011,375,2168,-1793
SWE,Sweden,IRN,Iran,2012,515,2111,-1596
SWE,Sweden,IRN,Iran,2013,447,1988,-1541
SWE,Sweden,IRN,Iran,2014,657,1744,-1087
SWE,Sweden,IRN,Iran,2015,827,1334,-507
SWE,Sweden,IRN,Iran,2016,279,1702,-1423
SWE,Sweden,IRN,Iran,2017,271,2348,-2077
CHE,Switzerland,IRN,Iran,2010,140,522,-382
CHE,Switzerland,IRN,Iran,2011,161,524,-363
CHE,Switzerland,IRN,Iran,2012,125,467,-342
CHE,Switzerland,IRN,Iran,2013,157,437,-280
CHE,Switzerland,IRN,Iran,2014,155,386,-231
CHE,Switzerland,IRN,Iran,2015,164,440,-276
CHE,Switzerland,IRN,Iran,2016,172,439,-267
CHE,Switzerland,IRN,Iran,2017,178,485,-307
TUR,Turkey,IRN,Iran,2010,0,1539,-1539
TUR,Turkey,IRN,Iran,2016,5695,15539,-9844
TUR,Turkey,IRN,Iran,2017,5065,17794,-12729
GBR,United Kingdom,IRN,Iran,2009,0,4000,-4000
GBR,United Kingdom,IRN,Iran,2011,1000,2000,-1000
GBR,United Kingdom,IRN,Iran,2012,0,1000,-1000
GBR,United Kingdom,IRN,Iran,2014,0,1000,-1000
USA,United States,IRN,Iran,2008,0,13852,-13852
USA,United States,IRN,Iran,2009,0,18553,-18553
USA,United States,IRN,Iran,2010,0,14182,-14182
USA,United States,IRN,Iran,2011,0,14822,-14822
USA,United States,IRN,Iran,2012,0,12916,-12916
USA,United States,IRN,Iran,2013,0,12863,-12863
USA,United States,IRN,Iran,2014,0,11615,-11615
USA,United States,IRN,Iran,2015,0,13114,-13114
USA,United States,IRN,Iran,2016,0,13298,-13298
USA,United States,IRN,Iran,2017,0,13791,-13791
CHL,Chile,IRN,Iran,2008,0,6,-6
CHL,Chile,IRN,Iran,2009,0,5,-5
CHL,Chile,IRN,Iran,2010,0,2,-2
CHL,Chile,IRN,Iran,2011,0,6,-6
CHL,Chile,IRN,Iran,2012,0,7,-7
CHL,Chile,IRN,Iran,2013,0,20,-20
CHL,Chile,IRN,Iran,2014,0,21,-21
CHL,Chile,IRN,Iran,2015,0,29,-29
CHL,Chile,IRN,Iran,2016,0,20,-20
EST,Estonia,IRN,Iran,2008,0,3,-3
EST,Estonia,IRN,Iran,2009,0,2,-2
EST,Estonia,IRN,Iran,2010,0,2,-2
EST,Estonia,IRN,Iran,2011,0,5,-5
EST,Estonia,IRN,Iran,2012,0,5,-5
EST,Estonia,IRN,Iran,2013,0,10,-10
EST,Estonia,IRN,Iran,2014,0,5,-5
EST,Estonia,IRN,Iran,2015,0,22,-22
EST,Estonia,IRN,Iran,2016,0,25,-25
EST,Estonia,IRN,Iran,2017,0,33,-33
ISR,Israel,IRN,Iran,2008,0,48,-48
ISR,Israel,IRN,Iran,2009,0,45,-45
ISR,Israel,IRN,Iran,2010,0,39,-39
ISR,Israel,IRN,Iran,2011,0,46,-46
ISR,Israel,IRN,Iran,2012,0,37,-37
ISR,Israel,IRN,Iran,2013,0,82,-82
ISR,Israel,IRN,Iran,2014,0,27,-27
ISR,Israel,IRN,Iran,2015,0,35,-35
ISR,Israel,IRN,Iran,2016,0,34,-34
ISR,Israel,IRN,Iran,2017,0,18,-18
SVN,Slovenia,IRN,Iran,2008,0,4,-4
SVN,Slovenia,IRN,Iran,2009,0,5,-5
SVN,Slovenia,IRN,Iran,2010,0,4,-4
SVN,Slovenia,IRN,Iran,2011,0,13,-13
SVN,Slovenia,IRN,Iran,2012,1,14,-13
SVN,Slovenia,IRN,Iran,2013,0,5,-5
SVN,Slovenia,IRN,Iran,2014,2,7,-5
SVN,Slovenia,IRN,Iran,2015,3,22,-19
SVN,Slovenia,IRN,Iran,2016,0,9,-9
SVN,Slovenia,IRN,Iran,2017,0,29,-29
AUS,Australia,IRQ,Iraq,2008,259,2566,-2307
AUS,Australia,IRQ,Iraq,2009,344,4054,-3710
AUS,Australia,IRQ,Iraq,2010,373,2456,-2083
AUS,Australia,IRQ,Iraq,2011,344,2928,-2584
AUS,Australia,IRQ,Iraq,2012,419,1963,-1544
AUS,Australia,IRQ,Iraq,2013,429,3170,-2741
AUS,Australia,IRQ,Iraq,2014,316,3973,-3657
AUS,Australia,IRQ,Iraq,2015,200,3058,-2858
AUS,Australia,IRQ,Iraq,2016,300,3037,-2737
AUS,Australia,IRQ,Iraq,2017,0,9709,-9709
AUT,Austria,IRQ,Iraq,2008,111,433,-322
AUT,Austria,IRQ,Iraq,2009,109,384,-275
AUT,Austria,IRQ,Iraq,2010,136,330,-194
AUT,Austria,IRQ,Iraq,2011,129,399,-270
AUT,Austria,IRQ,Iraq,2012,171,461,-290
AUT,Austria,IRQ,Iraq,2013,148,425,-277
AUT,Austria,IRQ,Iraq,2014,129,812,-683
AUT,Austria,IRQ,Iraq,2015,374,10376,-10002
AUT,Austria,IRQ,Iraq,2016,1933,2653,-720
AUT,Austria,IRQ,Iraq,2017,1198,839,359
BEL,Belgium,IRQ,Iraq,2008,0,242,-242
BEL,Belgium,IRQ,Iraq,2009,0,359,-359
BEL,Belgium,IRQ,Iraq,2010,48,363,-315
BEL,Belgium,IRQ,Iraq,2011,0,587,-587
BEL,Belgium,IRQ,Iraq,2012,575,1106,-531
BEL,Belgium,IRQ,Iraq,2013,575,596,-21
BEL,Belgium,IRQ,Iraq,2014,332,1067,-735
BEL,Belgium,IRQ,Iraq,2015,310,8129,-7819
BEL,Belgium,IRQ,Iraq,2016,280,1364,-1084
BEL,Belgium,IRQ,Iraq,2017,682,1690,-1008
CAN,Canada,IRQ,Iraq,2008,0,3543,-3543
CAN,Canada,IRQ,Iraq,2009,0,5450,-5450
CAN,Canada,IRQ,Iraq,2010,0,5941,-5941
CAN,Canada,IRQ,Iraq,2011,0,6196,-6196
CAN,Canada,IRQ,Iraq,2012,0,4036,-4036
CAN,Canada,IRQ,Iraq,2013,0,4912,-4912
CAN,Canada,IRQ,Iraq,2014,0,3894,-3894
CAN,Canada,IRQ,Iraq,2015,0,3980,-3980
CAN,Canada,IRQ,Iraq,2016,0,2410,-2410
CAN,Canada,IRQ,Iraq,2017,0,4740,-4740
CZE,Czech Republic,IRQ,Iraq,2008,2,79,-77
CZE,Czech Republic,IRQ,Iraq,2009,0,27,-27
CZE,Czech Republic,IRQ,Iraq,2010,1,33,-32
CZE,Czech Republic,IRQ,Iraq,2011,1,18,-17
CZE,Czech Republic,IRQ,Iraq,2012,12,33,-21
CZE,Czech Republic,IRQ,Iraq,2013,29,28,1
CZE,Czech Republic,IRQ,Iraq,2014,22,43,-21
CZE,Czech Republic,IRQ,Iraq,2015,30,62,-32
CZE,Czech Republic,IRQ,Iraq,2016,62,115,-53
CZE,Czech Republic,IRQ,Iraq,2017,30,55,-25
DNK,Denmark,IRQ,Iraq,2008,214,394,-180
DNK,Denmark,IRQ,Iraq,2009,151,336,-185
DNK,Denmark,IRQ,Iraq,2010,154,245,-91
DNK,Denmark,IRQ,Iraq,2011,165,156,9
DNK,Denmark,IRQ,Iraq,2012,122,124,-2
DNK,Denmark,IRQ,Iraq,2013,121,147,-26
DNK,Denmark,IRQ,Iraq,2014,64,182,-118
DNK,Denmark,IRQ,Iraq,2015,54,129,-75
DNK,Denmark,IRQ,Iraq,2016,82,222,-140
DNK,Denmark,IRQ,Iraq,2017,67,268,-201
FIN,Finland,IRQ,Iraq,2008,16,520,-504
FIN,Finland,IRQ,Iraq,2009,33,907,-874
FIN,Finland,IRQ,Iraq,2010,28,1057,-1029
FIN,Finland,IRQ,Iraq,2011,17,719,-702
FIN,Finland,IRQ,Iraq,2012,50,584,-534
FIN,Finland,IRQ,Iraq,2013,30,910,-880
FIN,Finland,IRQ,Iraq,2014,37,776,-739
FIN,Finland,IRQ,Iraq,2015,31,754,-723
FIN,Finland,IRQ,Iraq,2016,58,3235,-3177
FIN,Finland,IRQ,Iraq,2017,65,2570,-2505
FRA,France,IRQ,Iraq,2008,0,324,-324
FRA,France,IRQ,Iraq,2009,0,619,-619
FRA,France,IRQ,Iraq,2010,0,362,-362
FRA,France,IRQ,Iraq,2011,0,303,-303
FRA,France,IRQ,Iraq,2012,0,283,-283
FRA,France,IRQ,Iraq,2013,0,245,-245
FRA,France,IRQ,Iraq,2014,0,405,-405
FRA,France,IRQ,Iraq,2015,0,1696,-1696
FRA,France,IRQ,Iraq,2016,0,1342,-1342
FRA,France,IRQ,Iraq,2017,0,1529,-1529
DEU,Germany,IRQ,Iraq,2008,3945,8923,-4978
DEU,Germany,IRQ,Iraq,2009,3705,13062,-9357
DEU,Germany,IRQ,Iraq,2010,3243,9496,-6253
DEU,Germany,IRQ,Iraq,2011,2961,7453,-4492
DEU,Germany,IRQ,Iraq,2012,3251,6654,-3403
DEU,Germany,IRQ,Iraq,2013,3002,5218,-2216
DEU,Germany,IRQ,Iraq,2014,2702,7140,-4438
DEU,Germany,IRQ,Iraq,2015,5120,64825,-59705
DEU,Germany,IRQ,Iraq,2016,20255,67978,-47723
DEU,Germany,IRQ,Iraq,2017,11328,27574,-16246
HUN,Hungary,IRQ,Iraq,2008,1,8,-7
HUN,Hungary,IRQ,Iraq,2009,0,17,-17
HUN,Hungary,IRQ,Iraq,2010,2,17,-15
HUN,Hungary,IRQ,Iraq,2011,7,20,-13
HUN,Hungary,IRQ,Iraq,2012,3,24,-21
HUN,Hungary,IRQ,Iraq,2013,3,18,-15
HUN,Hungary,IRQ,Iraq,2014,3,84,-81
HUN,Hungary,IRQ,Iraq,2015,7,185,-178
HUN,Hungary,IRQ,Iraq,2016,10,163,-153
HUN,Hungary,IRQ,Iraq,2017,0,299,-299
ISL,Iceland,IRQ,Iraq,2008,0,3,-3
ISL,Iceland,IRQ,Iraq,2009,3,1,2
ISL,Iceland,IRQ,Iraq,2010,0,1,-1
ISL,Iceland,IRQ,Iraq,2011,0,2,-2
ISL,Iceland,IRQ,Iraq,2012,0,5,-5
ISL,Iceland,IRQ,Iraq,2013,1,2,-1
ISL,Iceland,IRQ,Iraq,2014,0,0,0
ISL,Iceland,IRQ,Iraq,2015,2,3,-1
ISL,Iceland,IRQ,Iraq,2016,1,31,-30
ISL,Iceland,IRQ,Iraq,2017,1,52,-51
ITA,Italy,IRQ,Iraq,2008,6,389,-383
ITA,Italy,IRQ,Iraq,2009,6,422,-416
ITA,Italy,IRQ,Iraq,2010,26,414,-388
ITA,Italy,IRQ,Iraq,2011,4,283,-279
ITA,Italy,IRQ,Iraq,2012,20,297,-277
ITA,Italy,IRQ,Iraq,2013,5,420,-415
ITA,Italy,IRQ,Iraq,2014,22,397,-375
ITA,Italy,IRQ,Iraq,2015,47,444,-397
ITA,Italy,IRQ,Iraq,2016,0,768,-768
ITA,Italy,IRQ,Iraq,2017,44,1265,-1221
JPN,Japan,IRQ,Iraq,2008,433,437,-4
JPN,Japan,IRQ,Iraq,2009,233,234,-1
JPN,Japan,IRQ,Iraq,2010,335,349,-14
JPN,Japan,IRQ,Iraq,2011,303,321,-18
JPN,Japan,IRQ,Iraq,2012,365,369,-4
JPN,Japan,IRQ,Iraq,2013,377,391,-14
JPN,Japan,IRQ,Iraq,2014,152,174,-22
JPN,Japan,IRQ,Iraq,2015,239,244,-5
JPN,Japan,IRQ,Iraq,2016,207,229,-22
JPN,Japan,IRQ,Iraq,2017,264,278,-14
KOR,Korea,IRQ,Iraq,2008,86,95,-9
KOR,Korea,IRQ,Iraq,2009,82,74,8
KOR,Korea,IRQ,Iraq,2010,67,67,0
KOR,Korea,IRQ,Iraq,2011,70,68,2
KOR,Korea,IRQ,Iraq,2012,83,65,18
KOR,Korea,IRQ,Iraq,2013,78,92,-14
KOR,Korea,IRQ,Iraq,2014,90,120,-30
KOR,Korea,IRQ,Iraq,2015,112,124,-12
KOR,Korea,IRQ,Iraq,2016,97,90,7
KOR,Korea,IRQ,Iraq,2017,129,122,7
LUX,Luxembourg,IRQ,Iraq,2008,4,26,-22
LUX,Luxembourg,IRQ,Iraq,2009,7,43,-36
LUX,Luxembourg,IRQ,Iraq,2010,5,93,-88
LUX,Luxembourg,IRQ,Iraq,2011,21,35,-14
LUX,Luxembourg,IRQ,Iraq,2012,9,26,-17
LUX,Luxembourg,IRQ,Iraq,2013,15,36,-21
LUX,Luxembourg,IRQ,Iraq,2014,4,14,-10
LUX,Luxembourg,IRQ,Iraq,2015,5,508,-503
LUX,Luxembourg,IRQ,Iraq,2016,87,149,-62
LUX,Luxembourg,IRQ,Iraq,2017,32,95,-63
MEX,Mexico,IRQ,Iraq,2008,0,3,-3
MEX,Mexico,IRQ,Iraq,2009,0,2,-2
MEX,Mexico,IRQ,Iraq,2010,0,3,-3
MEX,Mexico,IRQ,Iraq,2011,0,6,-6
MEX,Mexico,IRQ,Iraq,2012,0,2,-2
MEX,Mexico,IRQ,Iraq,2013,0,7,-7
MEX,Mexico,IRQ,Iraq,2014,0,1,-1
MEX,Mexico,IRQ,Iraq,2015,0,1,-1
MEX,Mexico,IRQ,Iraq,2016,0,10,-10
MEX,Mexico,IRQ,Iraq,2017,0,6,-6
NLD,Netherlands,IRQ,Iraq,2008,49,772,-723
NLD,Netherlands,IRQ,Iraq,2009,101,977,-876
NLD,Netherlands,IRQ,Iraq,2010,149,923,-774
NLD,Netherlands,IRQ,Iraq,2011,230,702,-472
NLD,Netherlands,IRQ,Iraq,2012,238,679,-441
NLD,Netherlands,IRQ,Iraq,2013,131,829,-698
NLD,Netherlands,IRQ,Iraq,2014,86,658,-572
NLD,Netherlands,IRQ,Iraq,2015,78,598,-520
NLD,Netherlands,IRQ,Iraq,2016,89,2287,-2198
NLD,Netherlands,IRQ,Iraq,2017,253,1169,-916
NZL,New Zealand,IRQ,Iraq,2008,3,301,-298
NZL,New Zealand,IRQ,Iraq,2009,5,145,-140
NZL,New Zealand,IRQ,Iraq,2010,12,69,-57
NZL,New Zealand,IRQ,Iraq,2011,8,68,-60
NZL,New Zealand,IRQ,Iraq,2012,3,267,-264
NZL,New Zealand,IRQ,Iraq,2013,6,184,-178
NZL,New Zealand,IRQ,Iraq,2014,7,110,-103
NZL,New Zealand,IRQ,Iraq,2015,5,110,-105
NZL,New Zealand,IRQ,Iraq,2016,1,129,-128
NZL,New Zealand,IRQ,Iraq,2017,3,97,-94
NOR,Norway,IRQ,Iraq,2008,126,1197,-1071
NOR,Norway,IRQ,Iraq,2009,208,1191,-983
NOR,Norway,IRQ,Iraq,2010,141,875,-734
NOR,Norway,IRQ,Iraq,2011,175,638,-463
NOR,Norway,IRQ,Iraq,2012,163,387,-224
NOR,Norway,IRQ,Iraq,2013,170,279,-109
NOR,Norway,IRQ,Iraq,2014,118,207,-89
NOR,Norway,IRQ,Iraq,2015,95,246,-151
NOR,Norway,IRQ,Iraq,2016,89,396,-307
NOR,Norway,IRQ,Iraq,2017,67,741,-674
POL,Poland,IRQ,Iraq,2008,0,147,-147
POL,Poland,IRQ,Iraq,2009,0,159,-159
POL,Poland,IRQ,Iraq,2010,0,182,-182
POL,Poland,IRQ,Iraq,2011,0,218,-218
POL,Poland,IRQ,Iraq,2012,0,207,-207
POL,Poland,IRQ,Iraq,2013,0,212,-212
POL,Poland,IRQ,Iraq,2014,0,139,-139
POL,Poland,IRQ,Iraq,2015,0,487,-487
POL,Poland,IRQ,Iraq,2016,0,471,-471
POL,Poland,IRQ,Iraq,2017,0,732,-732
SVK,Slovak Republic,IRQ,Iraq,2008,20,1,19
SVK,Slovak Republic,IRQ,Iraq,2009,18,3,15
SVK,Slovak Republic,IRQ,Iraq,2010,12,3,9
SVK,Slovak Republic,IRQ,Iraq,2011,5,3,2
SVK,Slovak Republic,IRQ,Iraq,2012,0,1,-1
SVK,Slovak Republic,IRQ,Iraq,2013,0,2,-2
SVK,Slovak Republic,IRQ,Iraq,2015,0,3,-3
SVK,Slovak Republic,IRQ,Iraq,2016,35,150,-115
ESP,Spain,IRQ,Iraq,2008,89,139,-50
ESP,Spain,IRQ,Iraq,2009,89,72,17
ESP,Spain,IRQ,Iraq,2010,80,71,9
ESP,Spain,IRQ,Iraq,2011,73,90,-17
ESP,Spain,IRQ,Iraq,2012,71,129,-58
ESP,Spain,IRQ,Iraq,2013,67,135,-68
ESP,Spain,IRQ,Iraq,2014,51,182,-131
ESP,Spain,IRQ,Iraq,2015,71,240,-169
ESP,Spain,IRQ,Iraq,2016,76,280,-204
ESP,Spain,IRQ,Iraq,2017,120,338,-218
SWE,Sweden,IRQ,Iraq,2008,341,12103,-11762
SWE,Sweden,IRQ,Iraq,2009,252,8539,-8287
SWE,Sweden,IRQ,Iraq,2010,400,4534,-4134
SWE,Sweden,IRQ,Iraq,2011,462,4469,-4007
SWE,Sweden,IRQ,Iraq,2012,651,3579,-2928
SWE,Sweden,IRQ,Iraq,2013,589,2302,-1713
SWE,Sweden,IRQ,Iraq,2014,652,2405,-1753
SWE,Sweden,IRQ,Iraq,2015,844,2806,-1962
SWE,Sweden,IRQ,Iraq,2016,431,3399,-2968
SWE,Sweden,IRQ,Iraq,2017,401,6049,-5648
CHE,Switzerland,IRQ,Iraq,2010,37,482,-445
CHE,Switzerland,IRQ,Iraq,2011,68,372,-304
CHE,Switzerland,IRQ,Iraq,2012,76,387,-311
CHE,Switzerland,IRQ,Iraq,2013,83,470,-387
CHE,Switzerland,IRQ,Iraq,2014,63,445,-382
CHE,Switzerland,IRQ,Iraq,2015,53,341,-288
CHE,Switzerland,IRQ,Iraq,2016,50,395,-345
CHE,Switzerland,IRQ,Iraq,2017,42,530,-488
TUR,Turkey,IRQ,Iraq,2010,0,1165,-1165
TUR,Turkey,IRQ,Iraq,2016,16094,70865,-54771
TUR,Turkey,IRQ,Iraq,2017,28645,97054,-68409
GBR,United Kingdom,IRQ,Iraq,2011,0,2000,-2000
GBR,United Kingdom,IRQ,Iraq,2012,0,3000,-3000
GBR,United Kingdom,IRQ,Iraq,2013,0,3000,-3000
GBR,United Kingdom,IRQ,Iraq,2014,0,1000,-1000
GBR,United Kingdom,IRQ,Iraq,2015,0,1000,-1000
USA,United States,IRQ,Iraq,2008,0,4795,-4795
USA,United States,IRQ,Iraq,2009,0,12110,-12110
USA,United States,IRQ,Iraq,2010,0,19855,-19855
USA,United States,IRQ,Iraq,2011,0,21133,-21133
USA,United States,IRQ,Iraq,2012,0,20369,-20369
USA,United States,IRQ,Iraq,2013,0,9552,-9552
USA,United States,IRQ,Iraq,2014,0,19153,-19153
USA,United States,IRQ,Iraq,2015,0,21107,-21107
USA,United States,IRQ,Iraq,2016,0,18904,-18904
USA,United States,IRQ,Iraq,2017,0,14203,-14203
CHL,Chile,IRQ,Iraq,2008,0,0,0
CHL,Chile,IRQ,Iraq,2009,0,0,0
CHL,Chile,IRQ,Iraq,2010,0,2,-2
CHL,Chile,IRQ,Iraq,2011,0,2,-2
CHL,Chile,IRQ,Iraq,2012,0,1,-1
CHL,Chile,IRQ,Iraq,2013,0,2,-2
CHL,Chile,IRQ,Iraq,2014,0,0,0
CHL,Chile,IRQ,Iraq,2015,0,3,-3
CHL,Chile,IRQ,Iraq,2016,0,3,-3
EST,Estonia,IRQ,Iraq,2008,0,1,-1
EST,Estonia,IRQ,Iraq,2009,0,2,-2
EST,Estonia,IRQ,Iraq,2010,0,0,0
EST,Estonia,IRQ,Iraq,2011,0,2,-2
EST,Estonia,IRQ,Iraq,2012,0,0,0
EST,Estonia,IRQ,Iraq,2013,0,0,0
EST,Estonia,IRQ,Iraq,2014,0,0,0
EST,Estonia,IRQ,Iraq,2015,0,3,-3
EST,Estonia,IRQ,Iraq,2016,0,29,-29
EST,Estonia,IRQ,Iraq,2017,0,8,-8
ISR,Israel,IRQ,Iraq,2008,0,4,-4
ISR,Israel,IRQ,Iraq,2009,0,0,0
ISR,Israel,IRQ,Iraq,2010,0,5,-5
ISR,Israel,IRQ,Iraq,2011,0,2,-2
SVN,Slovenia,IRQ,Iraq,2008,0,1,-1
SVN,Slovenia,IRQ,Iraq,2009,0,2,-2
SVN,Slovenia,IRQ,Iraq,2010,0,1,-1
SVN,Slovenia,IRQ,Iraq,2012,0,1,-1
SVN,Slovenia,IRQ,Iraq,2013,0,6,-6
SVN,Slovenia,IRQ,Iraq,2014,0,3,-3
SVN,Slovenia,IRQ,Iraq,2015,0,2,-2
SVN,Slovenia,IRQ,Iraq,2016,0,2,-2
SVN,Slovenia,IRQ,Iraq,2017,0,9,-9
AUS,Australia,IRL,Ireland,2008,0,2034,-2034
AUS,Australia,IRL,Ireland,2009,0,2663,-2663
AUS,Australia,IRL,Ireland,2010,0,3031,-3031
AUS,Australia,IRL,Ireland,2011,0,3352,-3352
AUS,Australia,IRL,Ireland,2012,0,5034,-5034
AUS,Australia,IRL,Ireland,2013,0,5250,-5250
AUS,Australia,IRL,Ireland,2014,0,6263,-6263
AUS,Australia,IRL,Ireland,2015,0,6258,-6258
AUS,Australia,IRL,Ireland,2016,0,4925,-4925
AUS,Australia,IRL,Ireland,2017,0,3920,-3920
AUT,Austria,IRL,Ireland,2008,0,134,-134
AUT,Austria,IRL,Ireland,2009,0,127,-127
AUT,Austria,IRL,Ireland,2010,0,173,-173
AUT,Austria,IRL,Ireland,2011,0,222,-222
AUT,Austria,IRL,Ireland,2012,0,176,-176
AUT,Austria,IRL,Ireland,2013,0,223,-223
AUT,Austria,IRL,Ireland,2014,0,278,-278
AUT,Austria,IRL,Ireland,2015,0,252,-252
AUT,Austria,IRL,Ireland,2016,0,279,-279
AUT,Austria,IRL,Ireland,2017,0,282,-282
BEL,Belgium,IRL,Ireland,2008,0,365,-365
BEL,Belgium,IRL,Ireland,2009,0,369,-369
BEL,Belgium,IRL,Ireland,2010,0,426,-426
BEL,Belgium,IRL,Ireland,2011,0,437,-437
BEL,Belgium,IRL,Ireland,2012,0,426,-426
BEL,Belgium,IRL,Ireland,2013,0,411,-411
BEL,Belgium,IRL,Ireland,2014,0,356,-356
BEL,Belgium,IRL,Ireland,2015,0,379,-379
BEL,Belgium,IRL,Ireland,2016,0,351,-351
BEL,Belgium,IRL,Ireland,2017,0,346,-346
CAN,Canada,IRL,Ireland,2008,0,412,-412
CAN,Canada,IRL,Ireland,2009,0,395,-395
CAN,Canada,IRL,Ireland,2010,0,548,-548
CAN,Canada,IRL,Ireland,2011,0,524,-524
CAN,Canada,IRL,Ireland,2012,0,725,-725
CAN,Canada,IRL,Ireland,2013,0,1015,-1015
CAN,Canada,IRL,Ireland,2014,0,1977,-1977
CAN,Canada,IRL,Ireland,2015,0,2081,-2081
CAN,Canada,IRL,Ireland,2016,0,2220,-2220
CAN,Canada,IRL,Ireland,2017,0,1965,-1965
CZE,Czech Republic,IRL,Ireland,2008,0,115,-115
CZE,Czech Republic,IRL,Ireland,2009,0,49,-49
CZE,Czech Republic,IRL,Ireland,2010,0,30,-30
CZE,Czech Republic,IRL,Ireland,2011,0,25,-25
CZE,Czech Republic,IRL,Ireland,2012,0,25,-25
CZE,Czech Republic,IRL,Ireland,2013,0,45,-45
CZE,Czech Republic,IRL,Ireland,2014,0,42,-42
CZE,Czech Republic,IRL,Ireland,2015,0,30,-30
CZE,Czech Republic,IRL,Ireland,2016,0,30,-30
CZE,Czech Republic,IRL,Ireland,2017,0,51,-51
DNK,Denmark,IRL,Ireland,2008,0,91,-91
DNK,Denmark,IRL,Ireland,2009,0,89,-89
DNK,Denmark,IRL,Ireland,2010,0,105,-105
DNK,Denmark,IRL,Ireland,2011,0,122,-122
DNK,Denmark,IRL,Ireland,2012,0,114,-114
DNK,Denmark,IRL,Ireland,2013,0,141,-141
DNK,Denmark,IRL,Ireland,2014,0,166,-166
DNK,Denmark,IRL,Ireland,2015,0,223,-223
DNK,Denmark,IRL,Ireland,2016,0,211,-211
DNK,Denmark,IRL,Ireland,2017,0,331,-331
FIN,Finland,IRL,Ireland,2008,0,56,-56
FIN,Finland,IRL,Ireland,2009,0,38,-38
FIN,Finland,IRL,Ireland,2010,0,31,-31
FIN,Finland,IRL,Ireland,2011,0,49,-49
FIN,Finland,IRL,Ireland,2012,0,45,-45
FIN,Finland,IRL,Ireland,2013,0,46,-46
FIN,Finland,IRL,Ireland,2014,0,41,-41
FIN,Finland,IRL,Ireland,2015,0,60,-60
FIN,Finland,IRL,Ireland,2016,0,45,-45
FIN,Finland,IRL,Ireland,2017,0,44,-44
FRA,France,IRL,Ireland,2008,0,0,0
FRA,France,IRL,Ireland,2009,0,0,0
FRA,France,IRL,Ireland,2010,0,0,0
FRA,France,IRL,Ireland,2011,0,0,0
FRA,France,IRL,Ireland,2012,0,0,0
FRA,France,IRL,Ireland,2013,0,708,-708
FRA,France,IRL,Ireland,2014,0,866,-866
FRA,France,IRL,Ireland,2015,0,805,-805
FRA,France,IRL,Ireland,2016,0,962,-962
FRA,France,IRL,Ireland,2017,0,723,-723
DEU,Germany,IRL,Ireland,2008,0,1184,-1184
DEU,Germany,IRL,Ireland,2009,0,1279,-1279
DEU,Germany,IRL,Ireland,2010,0,1426,-1426
DEU,Germany,IRL,Ireland,2011,0,1760,-1760
DEU,Germany,IRL,Ireland,2012,0,1868,-1868
DEU,Germany,IRL,Ireland,2013,0,1796,-1796
DEU,Germany,IRL,Ireland,2014,0,2010,-2010
DEU,Germany,IRL,Ireland,2015,0,1941,-1941
DEU,Germany,IRL,Ireland,2016,0,2112,-2112
DEU,Germany,IRL,Ireland,2017,0,2167,-2167
HUN,Hungary,IRL,Ireland,2008,0,72,-72
HUN,Hungary,IRL,Ireland,2009,0,77,-77
HUN,Hungary,IRL,Ireland,2010,0,55,-55
HUN,Hungary,IRL,Ireland,2011,0,59,-59
HUN,Hungary,IRL,Ireland,2012,0,57,-57
HUN,Hungary,IRL,Ireland,2013,0,71,-71
HUN,Hungary,IRL,Ireland,2014,0,69,-69
HUN,Hungary,IRL,Ireland,2015,0,78,-78
HUN,Hungary,IRL,Ireland,2016,0,78,-78
HUN,Hungary,IRL,Ireland,2017,0,91,-91
ISL,Iceland,IRL,Ireland,2008,0,12,-12
ISL,Iceland,IRL,Ireland,2009,0,15,-15
ISL,Iceland,IRL,Ireland,2010,0,6,-6
ISL,Iceland,IRL,Ireland,2011,0,8,-8
ISL,Iceland,IRL,Ireland,2012,0,11,-11
ISL,Iceland,IRL,Ireland,2013,0,11,-11
ISL,Iceland,IRL,Ireland,2014,0,10,-10
ISL,Iceland,IRL,Ireland,2015,0,18,-18
ISL,Iceland,IRL,Ireland,2016,0,29,-29
ISL,Iceland,IRL,Ireland,2017,0,23,-23
ITA,Italy,IRL,Ireland,2008,0,286,-286
ITA,Italy,IRL,Ireland,2009,0,227,-227
ITA,Italy,IRL,Ireland,2010,0,194,-194
ITA,Italy,IRL,Ireland,2011,0,211,-211
ITA,Italy,IRL,Ireland,2012,0,177,-177
ITA,Italy,IRL,Ireland,2013,0,148,-148
ITA,Italy,IRL,Ireland,2014,0,143,-143
ITA,Italy,IRL,Ireland,2015,0,117,-117
ITA,Italy,IRL,Ireland,2016,0,186,-186
ITA,Italy,IRL,Ireland,2017,0,182,-182
JPN,Japan,IRL,Ireland,2008,0,354,-354
JPN,Japan,IRL,Ireland,2009,0,368,-368
JPN,Japan,IRL,Ireland,2010,0,345,-345
JPN,Japan,IRL,Ireland,2011,0,341,-341
JPN,Japan,IRL,Ireland,2012,0,374,-374
JPN,Japan,IRL,Ireland,2013,0,445,-445
JPN,Japan,IRL,Ireland,2014,0,351,-351
JPN,Japan,IRL,Ireland,2015,0,413,-413
JPN,Japan,IRL,Ireland,2016,0,383,-383
JPN,Japan,IRL,Ireland,2017,0,437,-437
KOR,Korea,IRL,Ireland,2008,0,218,-218
KOR,Korea,IRL,Ireland,2009,0,317,-317
KOR,Korea,IRL,Ireland,2010,0,373,-373
KOR,Korea,IRL,Ireland,2011,0,402,-402
KOR,Korea,IRL,Ireland,2012,0,336,-336
KOR,Korea,IRL,Ireland,2013,0,277,-277
KOR,Korea,IRL,Ireland,2014,0,199,-199
KOR,Korea,IRL,Ireland,2015,0,204,-204
KOR,Korea,IRL,Ireland,2016,0,176,-176
KOR,Korea,IRL,Ireland,2017,0,161,-161
LUX,Luxembourg,IRL,Ireland,2008,0,100,-100
LUX,Luxembourg,IRL,Ireland,2009,0,84,-84
LUX,Luxembourg,IRL,Ireland,2010,0,126,-126
LUX,Luxembourg,IRL,Ireland,2011,0,164,-164
LUX,Luxembourg,IRL,Ireland,2012,0,108,-108
LUX,Luxembourg,IRL,Ireland,2013,0,95,-95
LUX,Luxembourg,IRL,Ireland,2014,0,133,-133
LUX,Luxembourg,IRL,Ireland,2015,0,160,-160
LUX,Luxembourg,IRL,Ireland,2016,0,147,-147
LUX,Luxembourg,IRL,Ireland,2017,0,186,-186
MEX,Mexico,IRL,Ireland,2008,0,9,-9
MEX,Mexico,IRL,Ireland,2009,0,15,-15
MEX,Mexico,IRL,Ireland,2010,0,23,-23
MEX,Mexico,IRL,Ireland,2011,0,28,-28
MEX,Mexico,IRL,Ireland,2012,0,13,-13
MEX,Mexico,IRL,Ireland,2013,0,50,-50
MEX,Mexico,IRL,Ireland,2014,0,40,-40
MEX,Mexico,IRL,Ireland,2015,0,17,-17
MEX,Mexico,IRL,Ireland,2016,0,44,-44
MEX,Mexico,IRL,Ireland,2017,0,22,-22
NLD,Netherlands,IRL,Ireland,2008,0,477,-477
NLD,Netherlands,IRL,Ireland,2009,0,636,-636
NLD,Netherlands,IRL,Ireland,2010,0,684,-684
NLD,Netherlands,IRL,Ireland,2011,0,779,-779
NLD,Netherlands,IRL,Ireland,2012,0,647,-647
NLD,Netherlands,IRL,Ireland,2013,0,719,-719
NLD,Netherlands,IRL,Ireland,2014,0,849,-849
NLD,Netherlands,IRL,Ireland,2015,0,880,-880
NLD,Netherlands,IRL,Ireland,2016,0,1116,-1116
NLD,Netherlands,IRL,Ireland,2017,0,1292,-1292
NZL,New Zealand,IRL,Ireland,2008,0,1078,-1078
NZL,New Zealand,IRL,Ireland,2009,0,1440,-1440
NZL,New Zealand,IRL,Ireland,2010,0,1437,-1437
NZL,New Zealand,IRL,Ireland,2011,0,2087,-2087
NZL,New Zealand,IRL,Ireland,2012,0,1855,-1855
NZL,New Zealand,IRL,Ireland,2013,0,2199,-2199
NZL,New Zealand,IRL,Ireland,2014,0,1674,-1674
NZL,New Zealand,IRL,Ireland,2015,0,1448,-1448
NZL,New Zealand,IRL,Ireland,2016,0,1203,-1203
NZL,New Zealand,IRL,Ireland,2017,0,1299,-1299
NOR,Norway,IRL,Ireland,2008,0,88,-88
NOR,Norway,IRL,Ireland,2009,0,108,-108
NOR,Norway,IRL,Ireland,2010,0,145,-145
NOR,Norway,IRL,Ireland,2011,0,152,-152
NOR,Norway,IRL,Ireland,2012,0,156,-156
NOR,Norway,IRL,Ireland,2013,0,120,-120
NOR,Norway,IRL,Ireland,2014,0,98,-98
NOR,Norway,IRL,Ireland,2015,0,121,-121
NOR,Norway,IRL,Ireland,2016,0,73,-73
NOR,Norway,IRL,Ireland,2017,0,74,-74
POL,Poland,IRL,Ireland,2008,0,39,-39
POL,Poland,IRL,Ireland,2009,0,87,-87
POL,Poland,IRL,Ireland,2010,0,90,-90
POL,Poland,IRL,Ireland,2011,0,97,-97
POL,Poland,IRL,Ireland,2012,0,100,-100
POL,Poland,IRL,Ireland,2013,0,81,-81
POL,Poland,IRL,Ireland,2014,0,81,-81
POL,Poland,IRL,Ireland,2015,0,104,-104
POL,Poland,IRL,Ireland,2016,0,76,-76
POL,Poland,IRL,Ireland,2017,0,96,-96
SVK,Slovak Republic,IRL,Ireland,2008,0,19,-19
SVK,Slovak Republic,IRL,Ireland,2009,0,26,-26
SVK,Slovak Republic,IRL,Ireland,2010,0,23,-23
SVK,Slovak Republic,IRL,Ireland,2011,0,25,-25
SVK,Slovak Republic,IRL,Ireland,2012,0,10,-10
SVK,Slovak Republic,IRL,Ireland,2013,0,10,-10
SVK,Slovak Republic,IRL,Ireland,2014,0,7,-7
SVK,Slovak Republic,IRL,Ireland,2015,0,18,-18
SVK,Slovak Republic,IRL,Ireland,2016,0,10,-10
SVK,Slovak Republic,IRL,Ireland,2017,0,14,-14
ESP,Spain,IRL,Ireland,2008,0,1235,-1235
ESP,Spain,IRL,Ireland,2009,0,1320,-1320
ESP,Spain,IRL,Ireland,2010,0,1265,-1265
ESP,Spain,IRL,Ireland,2011,0,1344,-1344
ESP,Spain,IRL,Ireland,2012,0,1398,-1398
ESP,Spain,IRL,Ireland,2013,0,1318,-1318
ESP,Spain,IRL,Ireland,2014,0,1187,-1187
ESP,Spain,IRL,Ireland,2015,0,1238,-1238
ESP,Spain,IRL,Ireland,2016,0,1402,-1402
ESP,Spain,IRL,Ireland,2017,0,1722,-1722
SWE,Sweden,IRL,Ireland,2008,0,216,-216
SWE,Sweden,IRL,Ireland,2009,0,244,-244
SWE,Sweden,IRL,Ireland,2010,0,230,-230
SWE,Sweden,IRL,Ireland,2011,0,210,-210
SWE,Sweden,IRL,Ireland,2012,0,319,-319
SWE,Sweden,IRL,Ireland,2013,0,253,-253
SWE,Sweden,IRL,Ireland,2014,0,272,-272
SWE,Sweden,IRL,Ireland,2015,0,253,-253
SWE,Sweden,IRL,Ireland,2016,0,261,-261
SWE,Sweden,IRL,Ireland,2017,0,266,-266
CHE,Switzerland,IRL,Ireland,2008,0,451,-451
CHE,Switzerland,IRL,Ireland,2009,0,431,-431
CHE,Switzerland,IRL,Ireland,2010,0,521,-521
CHE,Switzerland,IRL,Ireland,2011,0,565,-565
CHE,Switzerland,IRL,Ireland,2012,0,475,-475
CHE,Switzerland,IRL,Ireland,2013,0,519,-519
CHE,Switzerland,IRL,Ireland,2014,0,544,-544
CHE,Switzerland,IRL,Ireland,2015,0,480,-480
CHE,Switzerland,IRL,Ireland,2016,0,447,-447
CHE,Switzerland,IRL,Ireland,2017,0,435,-435
TUR,Turkey,IRL,Ireland,2010,0,77,-77
USA,United States,IRL,Ireland,2008,0,1465,-1465
USA,United States,IRL,Ireland,2009,0,1637,-1637
USA,United States,IRL,Ireland,2010,0,1507,-1507
USA,United States,IRL,Ireland,2011,0,1371,-1371
USA,United States,IRL,Ireland,2012,0,1514,-1514
USA,United States,IRL,Ireland,2013,0,1626,-1626
USA,United States,IRL,Ireland,2014,0,1605,-1605
USA,United States,IRL,Ireland,2015,0,1607,-1607
USA,United States,IRL,Ireland,2016,0,1759,-1759
USA,United States,IRL,Ireland,2017,0,1485,-1485
CHL,Chile,IRL,Ireland,2008,0,9,-9
CHL,Chile,IRL,Ireland,2009,0,18,-18
CHL,Chile,IRL,Ireland,2010,0,15,-15
CHL,Chile,IRL,Ireland,2011,0,20,-20
CHL,Chile,IRL,Ireland,2012,0,25,-25
CHL,Chile,IRL,Ireland,2013,0,24,-24
CHL,Chile,IRL,Ireland,2014,0,18,-18
CHL,Chile,IRL,Ireland,2015,0,27,-27
CHL,Chile,IRL,Ireland,2016,0,27,-27
EST,Estonia,IRL,Ireland,2008,0,7,-7
EST,Estonia,IRL,Ireland,2009,0,8,-8
EST,Estonia,IRL,Ireland,2010,0,8,-8
EST,Estonia,IRL,Ireland,2011,0,2,-2
EST,Estonia,IRL,Ireland,2012,0,0,0
EST,Estonia,IRL,Ireland,2013,0,1,-1
EST,Estonia,IRL,Ireland,2014,0,0,0
EST,Estonia,IRL,Ireland,2015,0,17,-17
EST,Estonia,IRL,Ireland,2016,0,23,-23
EST,Estonia,IRL,Ireland,2017,0,19,-19
SVN,Slovenia,IRL,Ireland,2008,0,9,-9
SVN,Slovenia,IRL,Ireland,2010,0,1,-1
SVN,Slovenia,IRL,Ireland,2011,0,26,-26
SVN,Slovenia,IRL,Ireland,2012,0,13,-13
SVN,Slovenia,IRL,Ireland,2013,0,11,-11
SVN,Slovenia,IRL,Ireland,2014,0,26,-26
SVN,Slovenia,IRL,Ireland,2015,0,20,-20
SVN,Slovenia,IRL,Ireland,2016,0,31,-31
SVN,Slovenia,IRL,Ireland,2017,0,28,-28
CZE,Czech Republic,ISR,Israel,2008,0,117,-117
CZE,Czech Republic,ISR,Israel,2009,0,92,-92
CZE,Czech Republic,ISR,Israel,2010,0,63,-63
CZE,Czech Republic,ISR,Israel,2011,0,56,-56
CZE,Czech Republic,ISR,Israel,2012,0,70,-70
CZE,Czech Republic,ISR,Israel,2013,0,95,-95
CZE,Czech Republic,ISR,Israel,2014,0,122,-122
CZE,Czech Republic,ISR,Israel,2015,0,107,-107
CZE,Czech Republic,ISR,Israel,2016,0,169,-169
CZE,Czech Republic,ISR,Israel,2017,0,204,-204
DNK,Denmark,ISR,Israel,2008,0,47,-47
DNK,Denmark,ISR,Israel,2009,0,38,-38
DNK,Denmark,ISR,Israel,2010,0,41,-41
DNK,Denmark,ISR,Israel,2011,0,22,-22
DNK,Denmark,ISR,Israel,2012,0,27,-27
DNK,Denmark,ISR,Israel,2013,0,41,-41
DNK,Denmark,ISR,Israel,2014,0,40,-40
DNK,Denmark,ISR,Israel,2015,0,29,-29
DNK,Denmark,ISR,Israel,2016,0,44,-44
DNK,Denmark,ISR,Israel,2017,0,38,-38
FIN,Finland,ISR,Israel,2008,0,40,-40
FIN,Finland,ISR,Israel,2009,0,25,-25
FIN,Finland,ISR,Israel,2010,0,29,-29
FIN,Finland,ISR,Israel,2011,0,32,-32
FIN,Finland,ISR,Israel,2012,0,24,-24
FIN,Finland,ISR,Israel,2013,0,22,-22
FIN,Finland,ISR,Israel,2014,0,21,-21
FIN,Finland,ISR,Israel,2015,0,24,-24
FIN,Finland,ISR,Israel,2016,0,34,-34
FIN,Finland,ISR,Israel,2017,0,22,-22
ISL,Iceland,ISR,Israel,2008,0,1,-1
ISL,Iceland,ISR,Israel,2009,0,3,-3
ISL,Iceland,ISR,Israel,2010,0,3,-3
ISL,Iceland,ISR,Israel,2011,0,0,0
ISL,Iceland,ISR,Israel,2012,0,7,-7
ISL,Iceland,ISR,Israel,2013,0,2,-2
ISL,Iceland,ISR,Israel,2014,0,1,-1
ISL,Iceland,ISR,Israel,2015,0,3,-3
ISL,Iceland,ISR,Israel,2016,0,2,-2
ISL,Iceland,ISR,Israel,2017,0,1,-1
JPN,Japan,ISR,Israel,2008,0,314,-314
JPN,Japan,ISR,Israel,2009,0,181,-181
JPN,Japan,ISR,Israel,2010,0,283,-283
JPN,Japan,ISR,Israel,2011,0,121,-121
JPN,Japan,ISR,Israel,2012,0,208,-208
JPN,Japan,ISR,Israel,2013,0,138,-138
JPN,Japan,ISR,Israel,2014,0,235,-235
JPN,Japan,ISR,Israel,2015,0,192,-192
JPN,Japan,ISR,Israel,2016,0,239,-239
JPN,Japan,ISR,Israel,2017,0,209,-209
KOR,Korea,ISR,Israel,2008,0,54,-54
KOR,Korea,ISR,Israel,2009,0,51,-51
KOR,Korea,ISR,Israel,2010,0,54,-54
KOR,Korea,ISR,Israel,2011,0,61,-61
KOR,Korea,ISR,Israel,2012,0,39,-39
KOR,Korea,ISR,Israel,2013,0,48,-48
KOR,Korea,ISR,Israel,2014,0,49,-49
KOR,Korea,ISR,Israel,2015,0,60,-60
KOR,Korea,ISR,Israel,2016,0,44,-44
KOR,Korea,ISR,Israel,2017,0,39,-39
LUX,Luxembourg,ISR,Israel,2008,0,18,-18
LUX,Luxembourg,ISR,Israel,2009,0,14,-14
LUX,Luxembourg,ISR,Israel,2010,0,17,-17
LUX,Luxembourg,ISR,Israel,2011,0,11,-11
LUX,Luxembourg,ISR,Israel,2012,0,22,-22
LUX,Luxembourg,ISR,Israel,2013,0,33,-33
LUX,Luxembourg,ISR,Israel,2014,0,16,-16
LUX,Luxembourg,ISR,Israel,2015,0,11,-11
LUX,Luxembourg,ISR,Israel,2016,0,20,-20
LUX,Luxembourg,ISR,Israel,2017,0,17,-17
NZL,New Zealand,ISR,Israel,2008,0,69,-69
NZL,New Zealand,ISR,Israel,2009,0,52,-52
NZL,New Zealand,ISR,Israel,2010,0,53,-53
NZL,New Zealand,ISR,Israel,2011,0,61,-61
NZL,New Zealand,ISR,Israel,2012,0,56,-56
NZL,New Zealand,ISR,Israel,2013,0,69,-69
NZL,New Zealand,ISR,Israel,2014,0,95,-95
NZL,New Zealand,ISR,Israel,2015,0,120,-120
NZL,New Zealand,ISR,Israel,2016,0,116,-116
NZL,New Zealand,ISR,Israel,2017,0,148,-148
NOR,Norway,ISR,Israel,2008,0,30,-30
NOR,Norway,ISR,Israel,2009,0,42,-42
NOR,Norway,ISR,Israel,2010,0,21,-21
NOR,Norway,ISR,Israel,2011,0,33,-33
NOR,Norway,ISR,Israel,2012,0,36,-36
NOR,Norway,ISR,Israel,2013,0,30,-30
NOR,Norway,ISR,Israel,2014,0,23,-23
NOR,Norway,ISR,Israel,2015,0,21,-21
NOR,Norway,ISR,Israel,2016,0,20,-20
NOR,Norway,ISR,Israel,2017,0,27,-27
SVK,Slovak Republic,ISR,Israel,2008,0,2,-2
SVK,Slovak Republic,ISR,Israel,2009,0,2,-2
SVK,Slovak Republic,ISR,Israel,2010,0,4,-4
SVK,Slovak Republic,ISR,Israel,2011,0,2,-2
SVK,Slovak Republic,ISR,Israel,2012,0,1,-1
SVK,Slovak Republic,ISR,Israel,2014,0,2,-2
SVK,Slovak Republic,ISR,Israel,2015,0,4,-4
SVK,Slovak Republic,ISR,Israel,2016,0,1,-1
SVK,Slovak Republic,ISR,Israel,2017,0,3,-3
EST,Estonia,ISR,Israel,2008,0,10,-10
EST,Estonia,ISR,Israel,2009,0,12,-12
EST,Estonia,ISR,Israel,2010,0,12,-12
EST,Estonia,ISR,Israel,2011,0,22,-22
EST,Estonia,ISR,Israel,2012,0,14,-14
EST,Estonia,ISR,Israel,2013,0,13,-13
EST,Estonia,ISR,Israel,2014,0,25,-25
EST,Estonia,ISR,Israel,2015,0,21,-21
EST,Estonia,ISR,Israel,2016,0,26,-26
EST,Estonia,ISR,Israel,2017,0,19,-19
SVN,Slovenia,ISR,Israel,2008,0,20,-20
SVN,Slovenia,ISR,Israel,2009,0,10,-10
SVN,Slovenia,ISR,Israel,2010,0,7,-7
SVN,Slovenia,ISR,Israel,2011,0,7,-7
SVN,Slovenia,ISR,Israel,2012,0,7,-7
SVN,Slovenia,ISR,Israel,2013,0,5,-5
SVN,Slovenia,ISR,Israel,2014,0,6,-6
SVN,Slovenia,ISR,Israel,2015,0,16,-16
SVN,Slovenia,ISR,Israel,2016,0,10,-10
SVN,Slovenia,ISR,Israel,2017,0,13,-13
ISL,Iceland,ITA,Italy,2014,0,76,-76
AUS,Australia,JAM,Jamaica,2008,6,18,-12
AUS,Australia,JAM,Jamaica,2009,7,22,-15
AUS,Australia,JAM,Jamaica,2010,6,15,-9
AUS,Australia,JAM,Jamaica,2011,7,6,1
AUS,Australia,JAM,Jamaica,2012,8,13,-5
AUS,Australia,JAM,Jamaica,2013,8,30,-22
AUS,Australia,JAM,Jamaica,2014,6,43,-37
AUS,Australia,JAM,Jamaica,2015,0,26,-26
AUS,Australia,JAM,Jamaica,2016,0,27,-27
AUS,Australia,JAM,Jamaica,2017,0,13,-13
AUT,Austria,JAM,Jamaica,2008,6,11,-5
AUT,Austria,JAM,Jamaica,2009,7,8,-1
AUT,Austria,JAM,Jamaica,2010,6,14,-8
AUT,Austria,JAM,Jamaica,2011,6,12,-6
AUT,Austria,JAM,Jamaica,2012,7,6,1
AUT,Austria,JAM,Jamaica,2013,3,13,-10
AUT,Austria,JAM,Jamaica,2014,4,12,-8
AUT,Austria,JAM,Jamaica,2015,7,9,-2
AUT,Austria,JAM,Jamaica,2016,9,8,1
AUT,Austria,JAM,Jamaica,2017,5,15,-10
BEL,Belgium,JAM,Jamaica,2008,0,17,-17
BEL,Belgium,JAM,Jamaica,2009,0,23,-23
BEL,Belgium,JAM,Jamaica,2010,4,14,-10
BEL,Belgium,JAM,Jamaica,2012,9,13,-4
BEL,Belgium,JAM,Jamaica,2013,4,12,-8
BEL,Belgium,JAM,Jamaica,2014,4,17,-13
BEL,Belgium,JAM,Jamaica,2015,6,22,-16
BEL,Belgium,JAM,Jamaica,2016,3,15,-12
BEL,Belgium,JAM,Jamaica,2017,3,10,-7
CAN,Canada,JAM,Jamaica,2008,0,2334,-2334
CAN,Canada,JAM,Jamaica,2009,0,2456,-2456
CAN,Canada,JAM,Jamaica,2010,0,2321,-2321
CAN,Canada,JAM,Jamaica,2011,0,2059,-2059
CAN,Canada,JAM,Jamaica,2012,0,2173,-2173
CAN,Canada,JAM,Jamaica,2013,0,2480,-2480
CAN,Canada,JAM,Jamaica,2014,0,3050,-3050
CAN,Canada,JAM,Jamaica,2015,0,3426,-3426
CAN,Canada,JAM,Jamaica,2016,0,3560,-3560
CAN,Canada,JAM,Jamaica,2017,0,3830,-3830
CZE,Czech Republic,JAM,Jamaica,2008,0,1,-1
CZE,Czech Republic,JAM,Jamaica,2012,0,1,-1
CZE,Czech Republic,JAM,Jamaica,2013,0,1,-1
CZE,Czech Republic,JAM,Jamaica,2014,1,2,-1
CZE,Czech Republic,JAM,Jamaica,2015,0,2,-2
CZE,Czech Republic,JAM,Jamaica,2016,0,2,-2
DNK,Denmark,JAM,Jamaica,2008,2,5,-3
DNK,Denmark,JAM,Jamaica,2009,1,3,-2
DNK,Denmark,JAM,Jamaica,2010,1,6,-5
DNK,Denmark,JAM,Jamaica,2011,3,7,-4
DNK,Denmark,JAM,Jamaica,2012,1,5,-4
DNK,Denmark,JAM,Jamaica,2013,3,4,-1
DNK,Denmark,JAM,Jamaica,2014,4,2,2
DNK,Denmark,JAM,Jamaica,2015,2,4,-2
DNK,Denmark,JAM,Jamaica,2016,2,6,-4
DNK,Denmark,JAM,Jamaica,2017,5,2,3
FIN,Finland,JAM,Jamaica,2008,1,3,-2
FIN,Finland,JAM,Jamaica,2009,0,1,-1
FIN,Finland,JAM,Jamaica,2010,0,3,-3
FIN,Finland,JAM,Jamaica,2011,0,5,-5
FIN,Finland,JAM,Jamaica,2012,0,6,-6
FIN,Finland,JAM,Jamaica,2013,1,4,-3
FIN,Finland,JAM,Jamaica,2014,1,5,-4
FIN,Finland,JAM,Jamaica,2015,0,6,-6
FIN,Finland,JAM,Jamaica,2016,4,1,3
FIN,Finland,JAM,Jamaica,2017,0,4,-4
FRA,France,JAM,Jamaica,2008,0,32,-32
FRA,France,JAM,Jamaica,2009,0,31,-31
FRA,France,JAM,Jamaica,2010,0,37,-37
FRA,France,JAM,Jamaica,2011,0,51,-51
FRA,France,JAM,Jamaica,2012,0,47,-47
FRA,France,JAM,Jamaica,2013,0,29,-29
FRA,France,JAM,Jamaica,2014,0,43,-43
FRA,France,JAM,Jamaica,2015,0,68,-68
FRA,France,JAM,Jamaica,2016,0,89,-89
FRA,France,JAM,Jamaica,2017,0,77,-77
DEU,Germany,JAM,Jamaica,2008,100,73,27
DEU,Germany,JAM,Jamaica,2009,87,71,16
DEU,Germany,JAM,Jamaica,2010,81,102,-21
DEU,Germany,JAM,Jamaica,2011,64,93,-29
DEU,Germany,JAM,Jamaica,2012,53,84,-31
DEU,Germany,JAM,Jamaica,2013,72,84,-12
DEU,Germany,JAM,Jamaica,2014,61,97,-36
DEU,Germany,JAM,Jamaica,2015,62,108,-46
DEU,Germany,JAM,Jamaica,2016,75,104,-29
DEU,Germany,JAM,Jamaica,2017,75,188,-113
HUN,Hungary,JAM,Jamaica,2008,0,2,-2
HUN,Hungary,JAM,Jamaica,2009,1,2,-1
HUN,Hungary,JAM,Jamaica,2010,1,2,-1
HUN,Hungary,JAM,Jamaica,2011,0,4,-4
HUN,Hungary,JAM,Jamaica,2012,0,1,-1
HUN,Hungary,JAM,Jamaica,2013,0,4,-4
HUN,Hungary,JAM,Jamaica,2014,1,3,-2
HUN,Hungary,JAM,Jamaica,2015,0,0,0
HUN,Hungary,JAM,Jamaica,2016,0,2,-2
HUN,Hungary,JAM,Jamaica,2017,0,2,-2
ISL,Iceland,JAM,Jamaica,2008,1,1,0
ISL,Iceland,JAM,Jamaica,2009,1,1,0
ISL,Iceland,JAM,Jamaica,2010,1,1,0
ISL,Iceland,JAM,Jamaica,2011,0,1,-1
ISL,Iceland,JAM,Jamaica,2012,0,1,-1
ISL,Iceland,JAM,Jamaica,2013,0,0,0
ISL,Iceland,JAM,Jamaica,2014,2,2,0
ISL,Iceland,JAM,Jamaica,2015,1,2,-1
ISL,Iceland,JAM,Jamaica,2016,2,1,1
ISL,Iceland,JAM,Jamaica,2017,2,3,-1
ITA,Italy,JAM,Jamaica,2008,3,13,-10
ITA,Italy,JAM,Jamaica,2009,4,9,-5
ITA,Italy,JAM,Jamaica,2010,5,18,-13
ITA,Italy,JAM,Jamaica,2011,0,14,-14
ITA,Italy,JAM,Jamaica,2012,1,11,-10
ITA,Italy,JAM,Jamaica,2013,1,15,-14
ITA,Italy,JAM,Jamaica,2014,2,10,-8
ITA,Italy,JAM,Jamaica,2015,2,13,-11
ITA,Italy,JAM,Jamaica,2016,0,13,-13
ITA,Italy,JAM,Jamaica,2017,0,10,-10
JPN,Japan,JAM,Jamaica,2008,165,208,-43
JPN,Japan,JAM,Jamaica,2009,124,171,-47
JPN,Japan,JAM,Jamaica,2010,125,145,-20
JPN,Japan,JAM,Jamaica,2011,117,176,-59
JPN,Japan,JAM,Jamaica,2012,118,160,-42
JPN,Japan,JAM,Jamaica,2013,86,133,-47
JPN,Japan,JAM,Jamaica,2014,76,135,-59
JPN,Japan,JAM,Jamaica,2015,89,195,-106
JPN,Japan,JAM,Jamaica,2016,110,224,-114
JPN,Japan,JAM,Jamaica,2017,103,197,-94
KOR,Korea,JAM,Jamaica,2008,3,12,-9
KOR,Korea,JAM,Jamaica,2009,7,6,1
KOR,Korea,JAM,Jamaica,2010,4,7,-3
KOR,Korea,JAM,Jamaica,2011,8,6,2
KOR,Korea,JAM,Jamaica,2012,6,8,-2
KOR,Korea,JAM,Jamaica,2013,9,8,1
KOR,Korea,JAM,Jamaica,2014,8,13,-5
KOR,Korea,JAM,Jamaica,2015,14,13,1
KOR,Korea,JAM,Jamaica,2016,10,13,-3
KOR,Korea,JAM,Jamaica,2017,13,18,-5
LUX,Luxembourg,JAM,Jamaica,2008,0,3,-3
LUX,Luxembourg,JAM,Jamaica,2009,1,2,-1
LUX,Luxembourg,JAM,Jamaica,2010,0,1,-1
LUX,Luxembourg,JAM,Jamaica,2011,0,4,-4
LUX,Luxembourg,JAM,Jamaica,2012,0,2,-2
LUX,Luxembourg,JAM,Jamaica,2013,0,1,-1
LUX,Luxembourg,JAM,Jamaica,2014,4,1,3
LUX,Luxembourg,JAM,Jamaica,2015,0,2,-2
LUX,Luxembourg,JAM,Jamaica,2016,0,0,0
LUX,Luxembourg,JAM,Jamaica,2017,1,1,0
MEX,Mexico,JAM,Jamaica,2008,0,8,-8
MEX,Mexico,JAM,Jamaica,2009,0,14,-14
MEX,Mexico,JAM,Jamaica,2010,0,4,-4
MEX,Mexico,JAM,Jamaica,2011,0,5,-5
MEX,Mexico,JAM,Jamaica,2012,0,2,-2
MEX,Mexico,JAM,Jamaica,2013,0,12,-12
MEX,Mexico,JAM,Jamaica,2014,0,8,-8
MEX,Mexico,JAM,Jamaica,2015,0,7,-7
MEX,Mexico,JAM,Jamaica,2016,0,10,-10
MEX,Mexico,JAM,Jamaica,2017,0,12,-12
NLD,Netherlands,JAM,Jamaica,2008,6,11,-5
NLD,Netherlands,JAM,Jamaica,2009,11,26,-15
NLD,Netherlands,JAM,Jamaica,2010,15,22,-7
NLD,Netherlands,JAM,Jamaica,2011,2,27,-25
NLD,Netherlands,JAM,Jamaica,2012,7,39,-32
NLD,Netherlands,JAM,Jamaica,2013,5,27,-22
NLD,Netherlands,JAM,Jamaica,2014,13,40,-27
NLD,Netherlands,JAM,Jamaica,2015,12,74,-62
NLD,Netherlands,JAM,Jamaica,2016,14,74,-60
NLD,Netherlands,JAM,Jamaica,2017,12,34,-22
NZL,New Zealand,JAM,Jamaica,2008,1,3,-2
NZL,New Zealand,JAM,Jamaica,2009,1,4,-3
NZL,New Zealand,JAM,Jamaica,2010,3,3,0
NZL,New Zealand,JAM,Jamaica,2011,1,12,-11
NZL,New Zealand,JAM,Jamaica,2012,3,7,-4
NZL,New Zealand,JAM,Jamaica,2013,1,19,-18
NZL,New Zealand,JAM,Jamaica,2014,3,6,-3
NZL,New Zealand,JAM,Jamaica,2015,3,19,-16
NZL,New Zealand,JAM,Jamaica,2016,9,8,1
NZL,New Zealand,JAM,Jamaica,2017,4,13,-9
NOR,Norway,JAM,Jamaica,2008,3,6,-3
NOR,Norway,JAM,Jamaica,2009,3,7,-4
NOR,Norway,JAM,Jamaica,2010,1,9,-8
NOR,Norway,JAM,Jamaica,2011,9,12,-3
NOR,Norway,JAM,Jamaica,2012,5,7,-2
NOR,Norway,JAM,Jamaica,2013,3,4,-1
NOR,Norway,JAM,Jamaica,2014,6,1,5
NOR,Norway,JAM,Jamaica,2015,3,11,-8
NOR,Norway,JAM,Jamaica,2016,3,9,-6
NOR,Norway,JAM,Jamaica,2017,2,8,-6
POL,Poland,JAM,Jamaica,2009,0,5,-5
POL,Poland,JAM,Jamaica,2010,0,7,-7
POL,Poland,JAM,Jamaica,2011,0,10,-10
POL,Poland,JAM,Jamaica,2012,0,11,-11
POL,Poland,JAM,Jamaica,2013,0,9,-9
POL,Poland,JAM,Jamaica,2014,0,6,-6
POL,Poland,JAM,Jamaica,2015,0,8,-8
POL,Poland,JAM,Jamaica,2016,0,5,-5
POL,Poland,JAM,Jamaica,2017,0,7,-7
SVK,Slovak Republic,JAM,Jamaica,2008,0,1,-1
SVK,Slovak Republic,JAM,Jamaica,2009,0,4,-4
SVK,Slovak Republic,JAM,Jamaica,2010,0,1,-1
SVK,Slovak Republic,JAM,Jamaica,2011,0,1,-1
SVK,Slovak Republic,JAM,Jamaica,2013,0,1,-1
SVK,Slovak Republic,JAM,Jamaica,2014,0,1,-1
ESP,Spain,JAM,Jamaica,2008,1,20,-19
ESP,Spain,JAM,Jamaica,2009,2,18,-16
ESP,Spain,JAM,Jamaica,2010,9,1,8
ESP,Spain,JAM,Jamaica,2011,9,13,-4
ESP,Spain,JAM,Jamaica,2012,4,16,-12
ESP,Spain,JAM,Jamaica,2013,3,11,-8
ESP,Spain,JAM,Jamaica,2014,3,6,-3
ESP,Spain,JAM,Jamaica,2015,3,8,-5
ESP,Spain,JAM,Jamaica,2016,3,14,-11
ESP,Spain,JAM,Jamaica,2017,8,25,-17
SWE,Sweden,JAM,Jamaica,2008,8,13,-5
SWE,Sweden,JAM,Jamaica,2009,1,19,-18
SWE,Sweden,JAM,Jamaica,2010,1,15,-14
SWE,Sweden,JAM,Jamaica,2011,2,22,-20
SWE,Sweden,JAM,Jamaica,2012,7,29,-22
SWE,Sweden,JAM,Jamaica,2013,4,15,-11
SWE,Sweden,JAM,Jamaica,2014,8,23,-15
SWE,Sweden,JAM,Jamaica,2015,9,13,-4
SWE,Sweden,JAM,Jamaica,2016,4,16,-12
SWE,Sweden,JAM,Jamaica,2017,1,16,-15
CHE,Switzerland,JAM,Jamaica,2010,12,35,-23
CHE,Switzerland,JAM,Jamaica,2011,17,22,-5
CHE,Switzerland,JAM,Jamaica,2012,9,31,-22
CHE,Switzerland,JAM,Jamaica,2013,9,28,-19
CHE,Switzerland,JAM,Jamaica,2014,8,16,-8
CHE,Switzerland,JAM,Jamaica,2015,7,27,-20
CHE,Switzerland,JAM,Jamaica,2016,12,22,-10
CHE,Switzerland,JAM,Jamaica,2017,9,21,-12
GBR,United Kingdom,JAM,Jamaica,2012,0,1000,-1000
GBR,United Kingdom,JAM,Jamaica,2015,0,2000,-2000
USA,United States,JAM,Jamaica,2008,0,18477,-18477
USA,United States,JAM,Jamaica,2009,0,21783,-21783
USA,United States,JAM,Jamaica,2010,0,19825,-19825
USA,United States,JAM,Jamaica,2011,0,19662,-19662
USA,United States,JAM,Jamaica,2012,0,20705,-20705
USA,United States,JAM,Jamaica,2013,0,19400,-19400
USA,United States,JAM,Jamaica,2014,0,19026,-19026
USA,United States,JAM,Jamaica,2015,0,17642,-17642
USA,United States,JAM,Jamaica,2016,0,23350,-23350
USA,United States,JAM,Jamaica,2017,0,21905,-21905
CHL,Chile,JAM,Jamaica,2008,0,4,-4
CHL,Chile,JAM,Jamaica,2009,0,2,-2
CHL,Chile,JAM,Jamaica,2010,0,1,-1
CHL,Chile,JAM,Jamaica,2011,0,0,0
CHL,Chile,JAM,Jamaica,2012,0,0,0
CHL,Chile,JAM,Jamaica,2013,0,3,-3
CHL,Chile,JAM,Jamaica,2014,0,5,-5
CHL,Chile,JAM,Jamaica,2015,0,2,-2
CHL,Chile,JAM,Jamaica,2016,0,4,-4
EST,Estonia,JAM,Jamaica,2008,0,0,0
EST,Estonia,JAM,Jamaica,2009,0,0,0
EST,Estonia,JAM,Jamaica,2010,0,0,0
EST,Estonia,JAM,Jamaica,2011,0,0,0
EST,Estonia,JAM,Jamaica,2012,0,0,0
EST,Estonia,JAM,Jamaica,2013,0,0,0
EST,Estonia,JAM,Jamaica,2014,0,0,0
EST,Estonia,JAM,Jamaica,2015,0,1,-1
EST,Estonia,JAM,Jamaica,2016,0,0,0
EST,Estonia,JAM,Jamaica,2017,0,1,-1
SVN,Slovenia,JAM,Jamaica,2008,0,2,-2
SVN,Slovenia,JAM,Jamaica,2009,0,1,-1
SVN,Slovenia,JAM,Jamaica,2010,0,1,-1
SVN,Slovenia,JAM,Jamaica,2011,0,2,-2
SVN,Slovenia,JAM,Jamaica,2013,0,1,-1
SVN,Slovenia,JAM,Jamaica,2015,0,1,-1
SVN,Slovenia,JAM,Jamaica,2017,0,1,-1
AUS,Australia,JOR,Jordan,2008,81,257,-176
AUS,Australia,JOR,Jordan,2009,85,328,-243
AUS,Australia,JOR,Jordan,2010,99,297,-198
AUS,Australia,JOR,Jordan,2011,67,262,-195
AUS,Australia,JOR,Jordan,2012,92,337,-245
AUS,Australia,JOR,Jordan,2013,109,376,-267
AUS,Australia,JOR,Jordan,2014,123,424,-301
AUS,Australia,JOR,Jordan,2015,100,412,-312
AUS,Australia,JOR,Jordan,2016,100,436,-336
AUS,Australia,JOR,Jordan,2017,0,536,-536
AUT,Austria,JOR,Jordan,2008,38,49,-11
AUT,Austria,JOR,Jordan,2009,32,36,-4
AUT,Austria,JOR,Jordan,2010,38,31,7
AUT,Austria,JOR,Jordan,2011,27,43,-16
AUT,Austria,JOR,Jordan,2012,32,70,-38
AUT,Austria,JOR,Jordan,2013,33,58,-25
AUT,Austria,JOR,Jordan,2014,29,82,-53
AUT,Austria,JOR,Jordan,2015,43,65,-22
AUT,Austria,JOR,Jordan,2016,34,82,-48
AUT,Austria,JOR,Jordan,2017,39,97,-58
BEL,Belgium,JOR,Jordan,2008,0,56,-56
BEL,Belgium,JOR,Jordan,2009,0,71,-71
BEL,Belgium,JOR,Jordan,2010,29,68,-39
BEL,Belgium,JOR,Jordan,2012,38,63,-25
BEL,Belgium,JOR,Jordan,2013,41,81,-40
BEL,Belgium,JOR,Jordan,2014,40,62,-22
BEL,Belgium,JOR,Jordan,2015,29,60,-31
BEL,Belgium,JOR,Jordan,2016,31,72,-41
BEL,Belgium,JOR,Jordan,2017,14,62,-48
CAN,Canada,JOR,Jordan,2008,0,1579,-1579
CAN,Canada,JOR,Jordan,2009,0,1235,-1235
CAN,Canada,JOR,Jordan,2010,0,1831,-1831
CAN,Canada,JOR,Jordan,2011,0,1635,-1635
CAN,Canada,JOR,Jordan,2012,0,1206,-1206
CAN,Canada,JOR,Jordan,2013,0,1255,-1255
CAN,Canada,JOR,Jordan,2014,0,1158,-1158
CAN,Canada,JOR,Jordan,2015,0,1112,-1112
CAN,Canada,JOR,Jordan,2016,0,915,-915
CAN,Canada,JOR,Jordan,2017,0,785,-785
CZE,Czech Republic,JOR,Jordan,2008,0,26,-26
CZE,Czech Republic,JOR,Jordan,2009,0,9,-9
CZE,Czech Republic,JOR,Jordan,2010,2,21,-19
CZE,Czech Republic,JOR,Jordan,2011,1,17,-16
CZE,Czech Republic,JOR,Jordan,2012,2,13,-11
CZE,Czech Republic,JOR,Jordan,2013,10,8,2
CZE,Czech Republic,JOR,Jordan,2014,5,18,-13
CZE,Czech Republic,JOR,Jordan,2015,16,16,0
CZE,Czech Republic,JOR,Jordan,2016,14,18,-4
CZE,Czech Republic,JOR,Jordan,2017,21,29,-8
DNK,Denmark,JOR,Jordan,2008,9,15,-6
DNK,Denmark,JOR,Jordan,2009,3,26,-23
DNK,Denmark,JOR,Jordan,2010,8,26,-18
DNK,Denmark,JOR,Jordan,2011,11,20,-9
DNK,Denmark,JOR,Jordan,2012,10,16,-6
DNK,Denmark,JOR,Jordan,2013,7,38,-31
DNK,Denmark,JOR,Jordan,2014,7,39,-32
DNK,Denmark,JOR,Jordan,2015,11,34,-23
DNK,Denmark,JOR,Jordan,2016,18,38,-20
DNK,Denmark,JOR,Jordan,2017,15,39,-24
FIN,Finland,JOR,Jordan,2008,7,9,-2
FIN,Finland,JOR,Jordan,2009,10,11,-1
FIN,Finland,JOR,Jordan,2010,3,20,-17
FIN,Finland,JOR,Jordan,2011,2,18,-16
FIN,Finland,JOR,Jordan,2012,1,5,-4
FIN,Finland,JOR,Jordan,2013,2,9,-7
FIN,Finland,JOR,Jordan,2014,5,17,-12
FIN,Finland,JOR,Jordan,2015,4,10,-6
FIN,Finland,JOR,Jordan,2016,4,21,-17
FIN,Finland,JOR,Jordan,2017,5,29,-24
FRA,France,JOR,Jordan,2008,0,44,-44
FRA,France,JOR,Jordan,2009,0,48,-48
FRA,France,JOR,Jordan,2010,0,72,-72
FRA,France,JOR,Jordan,2011,0,55,-55
FRA,France,JOR,Jordan,2012,0,63,-63
FRA,France,JOR,Jordan,2013,0,60,-60
FRA,France,JOR,Jordan,2014,0,67,-67
FRA,France,JOR,Jordan,2015,0,68,-68
FRA,France,JOR,Jordan,2016,0,68,-68
FRA,France,JOR,Jordan,2017,0,72,-72
DEU,Germany,JOR,Jordan,2008,601,629,-28
DEU,Germany,JOR,Jordan,2009,769,804,-35
DEU,Germany,JOR,Jordan,2010,788,879,-91
DEU,Germany,JOR,Jordan,2011,694,1062,-368
DEU,Germany,JOR,Jordan,2012,719,1242,-523
DEU,Germany,JOR,Jordan,2013,853,1367,-514
DEU,Germany,JOR,Jordan,2014,845,1413,-568
DEU,Germany,JOR,Jordan,2015,844,1574,-730
DEU,Germany,JOR,Jordan,2016,1046,1689,-643
DEU,Germany,JOR,Jordan,2017,1052,1975,-923
HUN,Hungary,JOR,Jordan,2008,1,33,-32
HUN,Hungary,JOR,Jordan,2009,5,27,-22
HUN,Hungary,JOR,Jordan,2010,3,17,-14
HUN,Hungary,JOR,Jordan,2011,4,18,-14
HUN,Hungary,JOR,Jordan,2012,2,23,-21
HUN,Hungary,JOR,Jordan,2013,6,47,-41
HUN,Hungary,JOR,Jordan,2014,6,209,-203
HUN,Hungary,JOR,Jordan,2015,76,81,-5
HUN,Hungary,JOR,Jordan,2016,12,125,-113
HUN,Hungary,JOR,Jordan,2017,0,213,-213
ISL,Iceland,JOR,Jordan,2008,3,2,1
ISL,Iceland,JOR,Jordan,2009,1,0,1
ISL,Iceland,JOR,Jordan,2010,0,1,-1
ISL,Iceland,JOR,Jordan,2011,0,1,-1
ISL,Iceland,JOR,Jordan,2012,0,1,-1
ISL,Iceland,JOR,Jordan,2013,1,2,-1
ISL,Iceland,JOR,Jordan,2014,1,0,1
ISL,Iceland,JOR,Jordan,2015,0,0,0
ISL,Iceland,JOR,Jordan,2016,2,2,0
ISL,Iceland,JOR,Jordan,2017,2,2,0
ITA,Italy,JOR,Jordan,2008,9,136,-127
ITA,Italy,JOR,Jordan,2009,10,99,-89
ITA,Italy,JOR,Jordan,2010,4,124,-120
ITA,Italy,JOR,Jordan,2011,12,87,-75
ITA,Italy,JOR,Jordan,2012,18,103,-85
ITA,Italy,JOR,Jordan,2013,12,76,-64
ITA,Italy,JOR,Jordan,2014,4,97,-93
ITA,Italy,JOR,Jordan,2015,12,96,-84
ITA,Italy,JOR,Jordan,2016,0,93,-93
ITA,Italy,JOR,Jordan,2017,16,97,-81
JPN,Japan,JOR,Jordan,2008,179,186,-7
JPN,Japan,JOR,Jordan,2009,194,230,-36
JPN,Japan,JOR,Jordan,2010,269,275,-6
JPN,Japan,JOR,Jordan,2011,138,145,-7
JPN,Japan,JOR,Jordan,2012,166,173,-7
JPN,Japan,JOR,Jordan,2013,116,118,-2
JPN,Japan,JOR,Jordan,2014,245,268,-23
JPN,Japan,JOR,Jordan,2015,145,158,-13
JPN,Japan,JOR,Jordan,2016,180,199,-19
JPN,Japan,JOR,Jordan,2017,181,186,-5
KOR,Korea,JOR,Jordan,2008,72,100,-28
KOR,Korea,JOR,Jordan,2009,101,106,-5
KOR,Korea,JOR,Jordan,2010,106,147,-41
KOR,Korea,JOR,Jordan,2011,141,153,-12
KOR,Korea,JOR,Jordan,2012,222,182,40
KOR,Korea,JOR,Jordan,2013,135,95,40
KOR,Korea,JOR,Jordan,2014,154,137,17
KOR,Korea,JOR,Jordan,2015,132,91,41
KOR,Korea,JOR,Jordan,2016,127,115,12
KOR,Korea,JOR,Jordan,2017,110,86,24
LUX,Luxembourg,JOR,Jordan,2008,0,1,-1
LUX,Luxembourg,JOR,Jordan,2009,2,1,1
LUX,Luxembourg,JOR,Jordan,2010,2,2,0
LUX,Luxembourg,JOR,Jordan,2011,0,0,0
LUX,Luxembourg,JOR,Jordan,2012,0,2,-2
LUX,Luxembourg,JOR,Jordan,2013,1,0,1
LUX,Luxembourg,JOR,Jordan,2014,0,2,-2
LUX,Luxembourg,JOR,Jordan,2015,0,9,-9
LUX,Luxembourg,JOR,Jordan,2016,0,5,-5
LUX,Luxembourg,JOR,Jordan,2017,1,4,-3
MEX,Mexico,JOR,Jordan,2008,0,8,-8
MEX,Mexico,JOR,Jordan,2009,0,16,-16
MEX,Mexico,JOR,Jordan,2010,0,6,-6
MEX,Mexico,JOR,Jordan,2011,0,6,-6
MEX,Mexico,JOR,Jordan,2012,0,8,-8
MEX,Mexico,JOR,Jordan,2013,0,12,-12
MEX,Mexico,JOR,Jordan,2014,0,9,-9
MEX,Mexico,JOR,Jordan,2015,0,11,-11
MEX,Mexico,JOR,Jordan,2016,0,10,-10
MEX,Mexico,JOR,Jordan,2017,0,4,-4
NLD,Netherlands,JOR,Jordan,2008,16,37,-21
NLD,Netherlands,JOR,Jordan,2009,18,28,-10
NLD,Netherlands,JOR,Jordan,2010,18,24,-6
NLD,Netherlands,JOR,Jordan,2011,10,30,-20
NLD,Netherlands,JOR,Jordan,2012,27,40,-13
NLD,Netherlands,JOR,Jordan,2013,20,31,-11
NLD,Netherlands,JOR,Jordan,2014,16,55,-39
NLD,Netherlands,JOR,Jordan,2015,36,103,-67
NLD,Netherlands,JOR,Jordan,2016,21,94,-73
NLD,Netherlands,JOR,Jordan,2017,36,131,-95
NZL,New Zealand,JOR,Jordan,2008,3,69,-66
NZL,New Zealand,JOR,Jordan,2009,4,30,-26
NZL,New Zealand,JOR,Jordan,2010,8,44,-36
NZL,New Zealand,JOR,Jordan,2011,13,38,-25
NZL,New Zealand,JOR,Jordan,2012,10,43,-33
NZL,New Zealand,JOR,Jordan,2013,11,71,-60
NZL,New Zealand,JOR,Jordan,2014,5,67,-62
NZL,New Zealand,JOR,Jordan,2015,9,89,-80
NZL,New Zealand,JOR,Jordan,2016,11,90,-79
NZL,New Zealand,JOR,Jordan,2017,11,99,-88
NOR,Norway,JOR,Jordan,2008,8,29,-21
NOR,Norway,JOR,Jordan,2009,9,43,-34
NOR,Norway,JOR,Jordan,2010,6,17,-11
NOR,Norway,JOR,Jordan,2011,10,32,-22
NOR,Norway,JOR,Jordan,2012,13,26,-13
NOR,Norway,JOR,Jordan,2013,19,29,-10
NOR,Norway,JOR,Jordan,2014,12,34,-22
NOR,Norway,JOR,Jordan,2015,8,32,-24
NOR,Norway,JOR,Jordan,2016,22,38,-16
NOR,Norway,JOR,Jordan,2017,12,29,-17
POL,Poland,JOR,Jordan,2008,0,41,-41
POL,Poland,JOR,Jordan,2009,0,45,-45
POL,Poland,JOR,Jordan,2010,0,42,-42
POL,Poland,JOR,Jordan,2011,0,56,-56
POL,Poland,JOR,Jordan,2012,0,41,-41
POL,Poland,JOR,Jordan,2013,0,65,-65
POL,Poland,JOR,Jordan,2014,0,37,-37
POL,Poland,JOR,Jordan,2015,0,85,-85
POL,Poland,JOR,Jordan,2016,0,103,-103
POL,Poland,JOR,Jordan,2017,0,105,-105
SVK,Slovak Republic,JOR,Jordan,2008,2,4,-2
SVK,Slovak Republic,JOR,Jordan,2009,1,2,-1
SVK,Slovak Republic,JOR,Jordan,2010,2,3,-1
SVK,Slovak Republic,JOR,Jordan,2011,2,2,0
SVK,Slovak Republic,JOR,Jordan,2012,0,1,-1
SVK,Slovak Republic,JOR,Jordan,2013,0,5,-5
SVK,Slovak Republic,JOR,Jordan,2014,1,1,0
SVK,Slovak Republic,JOR,Jordan,2015,0,1,-1
SVK,Slovak Republic,JOR,Jordan,2016,0,1,-1
ESP,Spain,JOR,Jordan,2008,94,101,-7
ESP,Spain,JOR,Jordan,2009,77,102,-25
ESP,Spain,JOR,Jordan,2010,75,119,-44
ESP,Spain,JOR,Jordan,2011,105,135,-30
ESP,Spain,JOR,Jordan,2012,42,123,-81
ESP,Spain,JOR,Jordan,2013,60,168,-108
ESP,Spain,JOR,Jordan,2014,78,190,-112
ESP,Spain,JOR,Jordan,2015,83,185,-102
ESP,Spain,JOR,Jordan,2016,83,173,-90
ESP,Spain,JOR,Jordan,2017,113,207,-94
SWE,Sweden,JOR,Jordan,2008,28,253,-225
SWE,Sweden,JOR,Jordan,2009,13,277,-264
SWE,Sweden,JOR,Jordan,2010,22,249,-227
SWE,Sweden,JOR,Jordan,2011,28,283,-255
SWE,Sweden,JOR,Jordan,2012,46,291,-245
SWE,Sweden,JOR,Jordan,2013,45,226,-181
SWE,Sweden,JOR,Jordan,2014,64,328,-264
SWE,Sweden,JOR,Jordan,2015,88,272,-184
SWE,Sweden,JOR,Jordan,2016,51,289,-238
SWE,Sweden,JOR,Jordan,2017,61,282,-221
CHE,Switzerland,JOR,Jordan,2010,43,53,-10
CHE,Switzerland,JOR,Jordan,2011,24,65,-41
CHE,Switzerland,JOR,Jordan,2012,21,52,-31
CHE,Switzerland,JOR,Jordan,2013,32,52,-20
CHE,Switzerland,JOR,Jordan,2014,29,50,-21
CHE,Switzerland,JOR,Jordan,2015,36,69,-33
CHE,Switzerland,JOR,Jordan,2016,37,51,-14
CHE,Switzerland,JOR,Jordan,2017,35,70,-35
TUR,Turkey,JOR,Jordan,2010,0,113,-113
TUR,Turkey,JOR,Jordan,2016,425,1744,-1319
TUR,Turkey,JOR,Jordan,2017,959,2930,-1971
GBR,United Kingdom,JOR,Jordan,2011,0,2000,-2000
GBR,United Kingdom,JOR,Jordan,2014,0,1000,-1000
USA,United States,JOR,Jordan,2008,0,3936,-3936
USA,United States,JOR,Jordan,2009,0,4282,-4282
USA,United States,JOR,Jordan,2010,0,3868,-3868
USA,United States,JOR,Jordan,2011,0,3876,-3876
USA,United States,JOR,Jordan,2012,0,4099,-4099
USA,United States,JOR,Jordan,2013,0,4188,-4188
USA,United States,JOR,Jordan,2014,0,5187,-5187
USA,United States,JOR,Jordan,2015,0,4664,-4664
USA,United States,JOR,Jordan,2016,0,5269,-5269
USA,United States,JOR,Jordan,2017,0,5264,-5264
CHL,Chile,JOR,Jordan,2008,0,1,-1
CHL,Chile,JOR,Jordan,2009,0,6,-6
CHL,Chile,JOR,Jordan,2010,0,10,-10
CHL,Chile,JOR,Jordan,2011,0,3,-3
CHL,Chile,JOR,Jordan,2012,0,15,-15
CHL,Chile,JOR,Jordan,2013,0,7,-7
CHL,Chile,JOR,Jordan,2014,0,7,-7
CHL,Chile,JOR,Jordan,2015,0,14,-14
CHL,Chile,JOR,Jordan,2016,0,11,-11
EST,Estonia,JOR,Jordan,2008,0,0,0
EST,Estonia,JOR,Jordan,2009,0,1,-1
EST,Estonia,JOR,Jordan,2010,0,0,0
EST,Estonia,JOR,Jordan,2011,0,1,-1
EST,Estonia,JOR,Jordan,2012,0,3,-3
EST,Estonia,JOR,Jordan,2013,0,1,-1
EST,Estonia,JOR,Jordan,2014,0,1,-1
EST,Estonia,JOR,Jordan,2015,0,4,-4
EST,Estonia,JOR,Jordan,2016,0,5,-5
EST,Estonia,JOR,Jordan,2017,0,9,-9
SVN,Slovenia,JOR,Jordan,2008,0,3,-3
SVN,Slovenia,JOR,Jordan,2010,0,1,-1
SVN,Slovenia,JOR,Jordan,2011,0,1,-1
SVN,Slovenia,JOR,Jordan,2012,1,2,-1
SVN,Slovenia,JOR,Jordan,2013,0,3,-3
SVN,Slovenia,JOR,Jordan,2014,1,1,0
SVN,Slovenia,JOR,Jordan,2016,0,5,-5
SVN,Slovenia,JOR,Jordan,2017,0,6,-6
AUS,Australia,KAZ,Kazakhstan,2008,8,62,-54
AUS,Australia,KAZ,Kazakhstan,2009,13,102,-89
AUS,Australia,KAZ,Kazakhstan,2010,9,49,-40
AUS,Australia,KAZ,Kazakhstan,2011,7,61,-54
AUS,Australia,KAZ,Kazakhstan,2012,11,77,-66
AUS,Australia,KAZ,Kazakhstan,2013,12,110,-98
AUS,Australia,KAZ,Kazakhstan,2014,15,70,-55
AUS,Australia,KAZ,Kazakhstan,2015,0,113,-113
AUS,Australia,KAZ,Kazakhstan,2016,0,101,-101
AUS,Australia,KAZ,Kazakhstan,2017,0,84,-84
AUT,Austria,KAZ,Kazakhstan,2008,30,51,-21
AUT,Austria,KAZ,Kazakhstan,2009,32,100,-68
AUT,Austria,KAZ,Kazakhstan,2010,64,112,-48
AUT,Austria,KAZ,Kazakhstan,2011,57,137,-80
AUT,Austria,KAZ,Kazakhstan,2012,82,202,-120
AUT,Austria,KAZ,Kazakhstan,2013,96,286,-190
AUT,Austria,KAZ,Kazakhstan,2014,139,298,-159
AUT,Austria,KAZ,Kazakhstan,2015,151,324,-173
AUT,Austria,KAZ,Kazakhstan,2016,161,261,-100
AUT,Austria,KAZ,Kazakhstan,2017,203,276,-73
BEL,Belgium,KAZ,Kazakhstan,2008,0,63,-63
BEL,Belgium,KAZ,Kazakhstan,2009,0,67,-67
BEL,Belgium,KAZ,Kazakhstan,2010,18,84,-66
BEL,Belgium,KAZ,Kazakhstan,2012,148,242,-94
BEL,Belgium,KAZ,Kazakhstan,2013,235,109,126
BEL,Belgium,KAZ,Kazakhstan,2014,113,63,50
BEL,Belgium,KAZ,Kazakhstan,2015,77,43,34
BEL,Belgium,KAZ,Kazakhstan,2016,23,43,-20
BEL,Belgium,KAZ,Kazakhstan,2017,21,72,-51
CAN,Canada,KAZ,Kazakhstan,2008,0,394,-394
CAN,Canada,KAZ,Kazakhstan,2009,0,431,-431
CAN,Canada,KAZ,Kazakhstan,2010,0,377,-377
CAN,Canada,KAZ,Kazakhstan,2011,0,381,-381
CAN,Canada,KAZ,Kazakhstan,2012,0,462,-462
CAN,Canada,KAZ,Kazakhstan,2013,0,347,-347
CAN,Canada,KAZ,Kazakhstan,2014,0,293,-293
CAN,Canada,KAZ,Kazakhstan,2015,0,327,-327
CAN,Canada,KAZ,Kazakhstan,2016,0,400,-400
CAN,Canada,KAZ,Kazakhstan,2017,0,335,-335
CZE,Czech Republic,KAZ,Kazakhstan,2008,4,706,-702
CZE,Czech Republic,KAZ,Kazakhstan,2009,3,780,-777
CZE,Czech Republic,KAZ,Kazakhstan,2010,4,716,-712
CZE,Czech Republic,KAZ,Kazakhstan,2011,2,516,-514
CZE,Czech Republic,KAZ,Kazakhstan,2012,285,642,-357
CZE,Czech Republic,KAZ,Kazakhstan,2013,633,618,15
CZE,Czech Republic,KAZ,Kazakhstan,2014,344,1018,-674
CZE,Czech Republic,KAZ,Kazakhstan,2015,399,689,-290
CZE,Czech Republic,KAZ,Kazakhstan,2016,474,612,-138
CZE,Czech Republic,KAZ,Kazakhstan,2017,437,623,-186
DNK,Denmark,KAZ,Kazakhstan,2008,8,3,5
DNK,Denmark,KAZ,Kazakhstan,2009,6,6,0
DNK,Denmark,KAZ,Kazakhstan,2010,4,16,-12
DNK,Denmark,KAZ,Kazakhstan,2011,1,14,-13
DNK,Denmark,KAZ,Kazakhstan,2012,6,25,-19
DNK,Denmark,KAZ,Kazakhstan,2013,20,11,9
DNK,Denmark,KAZ,Kazakhstan,2014,12,19,-7
DNK,Denmark,KAZ,Kazakhstan,2015,8,16,-8
DNK,Denmark,KAZ,Kazakhstan,2016,22,21,1
DNK,Denmark,KAZ,Kazakhstan,2017,28,21,7
FIN,Finland,KAZ,Kazakhstan,2008,2,34,-32
FIN,Finland,KAZ,Kazakhstan,2009,4,15,-11
FIN,Finland,KAZ,Kazakhstan,2010,2,10,-8
FIN,Finland,KAZ,Kazakhstan,2011,1,22,-21
FIN,Finland,KAZ,Kazakhstan,2012,4,22,-18
FIN,Finland,KAZ,Kazakhstan,2013,7,26,-19
FIN,Finland,KAZ,Kazakhstan,2014,3,33,-30
FIN,Finland,KAZ,Kazakhstan,2015,2,37,-35
FIN,Finland,KAZ,Kazakhstan,2016,5,36,-31
FIN,Finland,KAZ,Kazakhstan,2017,7,24,-17
FRA,France,KAZ,Kazakhstan,2008,0,111,-111
FRA,France,KAZ,Kazakhstan,2009,0,86,-86
FRA,France,KAZ,Kazakhstan,2010,0,116,-116
FRA,France,KAZ,Kazakhstan,2011,0,100,-100
FRA,France,KAZ,Kazakhstan,2012,0,140,-140
FRA,France,KAZ,Kazakhstan,2013,0,165,-165
FRA,France,KAZ,Kazakhstan,2014,0,177,-177
FRA,France,KAZ,Kazakhstan,2015,0,151,-151
FRA,France,KAZ,Kazakhstan,2016,0,159,-159
FRA,France,KAZ,Kazakhstan,2017,0,157,-157
DEU,Germany,KAZ,Kazakhstan,2008,1525,1883,-358
DEU,Germany,KAZ,Kazakhstan,2009,1306,1820,-514
DEU,Germany,KAZ,Kazakhstan,2010,1200,1637,-437
DEU,Germany,KAZ,Kazakhstan,2011,1085,1717,-632
DEU,Germany,KAZ,Kazakhstan,2012,1043,1728,-685
DEU,Germany,KAZ,Kazakhstan,2013,1133,2034,-901
DEU,Germany,KAZ,Kazakhstan,2014,1204,2557,-1353
DEU,Germany,KAZ,Kazakhstan,2015,1091,2126,-1035
DEU,Germany,KAZ,Kazakhstan,2016,911,2456,-1545
DEU,Germany,KAZ,Kazakhstan,2017,935,2339,-1404
HUN,Hungary,KAZ,Kazakhstan,2008,1,46,-45
HUN,Hungary,KAZ,Kazakhstan,2009,6,49,-43
HUN,Hungary,KAZ,Kazakhstan,2010,3,69,-66
HUN,Hungary,KAZ,Kazakhstan,2011,14,54,-40
HUN,Hungary,KAZ,Kazakhstan,2012,8,91,-83
HUN,Hungary,KAZ,Kazakhstan,2013,5,121,-116
HUN,Hungary,KAZ,Kazakhstan,2014,3,186,-183
HUN,Hungary,KAZ,Kazakhstan,2015,32,141,-109
HUN,Hungary,KAZ,Kazakhstan,2016,26,161,-135
HUN,Hungary,KAZ,Kazakhstan,2017,0,224,-224
ISL,Iceland,KAZ,Kazakhstan,2008,1,2,-1
ISL,Iceland,KAZ,Kazakhstan,2009,1,1,0
ISL,Iceland,KAZ,Kazakhstan,2010,1,1,0
ISL,Iceland,KAZ,Kazakhstan,2011,0,0,0
ISL,Iceland,KAZ,Kazakhstan,2012,1,0,1
ISL,Iceland,KAZ,Kazakhstan,2013,0,1,-1
ISL,Iceland,KAZ,Kazakhstan,2014,0,0,0
ISL,Iceland,KAZ,Kazakhstan,2015,1,2,-1
ISL,Iceland,KAZ,Kazakhstan,2016,0,5,-5
ISL,Iceland,KAZ,Kazakhstan,2017,0,1,-1
ITA,Italy,KAZ,Kazakhstan,2008,14,211,-197
ITA,Italy,KAZ,Kazakhstan,2009,15,191,-176
ITA,Italy,KAZ,Kazakhstan,2010,29,198,-169
ITA,Italy,KAZ,Kazakhstan,2011,87,196,-109
ITA,Italy,KAZ,Kazakhstan,2012,19,191,-172
ITA,Italy,KAZ,Kazakhstan,2013,18,217,-199
ITA,Italy,KAZ,Kazakhstan,2014,41,174,-133
ITA,Italy,KAZ,Kazakhstan,2015,30,179,-149
ITA,Italy,KAZ,Kazakhstan,2016,0,184,-184
ITA,Italy,KAZ,Kazakhstan,2017,44,146,-102
JPN,Japan,KAZ,Kazakhstan,2008,271,287,-16
JPN,Japan,KAZ,Kazakhstan,2009,184,203,-19
JPN,Japan,KAZ,Kazakhstan,2010,263,275,-12
JPN,Japan,KAZ,Kazakhstan,2011,158,177,-19
JPN,Japan,KAZ,Kazakhstan,2012,211,227,-16
JPN,Japan,KAZ,Kazakhstan,2013,220,253,-33
JPN,Japan,KAZ,Kazakhstan,2014,154,202,-48
JPN,Japan,KAZ,Kazakhstan,2015,213,286,-73
JPN,Japan,KAZ,Kazakhstan,2016,327,416,-89
JPN,Japan,KAZ,Kazakhstan,2017,245,299,-54
KOR,Korea,KAZ,Kazakhstan,2008,679,459,220
KOR,Korea,KAZ,Kazakhstan,2009,750,489,261
KOR,Korea,KAZ,Kazakhstan,2010,615,755,-140
KOR,Korea,KAZ,Kazakhstan,2011,687,774,-87
KOR,Korea,KAZ,Kazakhstan,2012,750,1098,-348
KOR,Korea,KAZ,Kazakhstan,2013,925,1130,-205
KOR,Korea,KAZ,Kazakhstan,2014,968,1431,-463
KOR,Korea,KAZ,Kazakhstan,2015,1239,3534,-2295
KOR,Korea,KAZ,Kazakhstan,2016,2707,7711,-5004
KOR,Korea,KAZ,Kazakhstan,2017,3886,13356,-9470
LUX,Luxembourg,KAZ,Kazakhstan,2008,3,4,-1
LUX,Luxembourg,KAZ,Kazakhstan,2009,5,5,0
LUX,Luxembourg,KAZ,Kazakhstan,2010,0,6,-6
LUX,Luxembourg,KAZ,Kazakhstan,2011,3,7,-4
LUX,Luxembourg,KAZ,Kazakhstan,2012,2,1,1
LUX,Luxembourg,KAZ,Kazakhstan,2013,5,16,-11
LUX,Luxembourg,KAZ,Kazakhstan,2014,5,7,-2
LUX,Luxembourg,KAZ,Kazakhstan,2015,7,4,3
LUX,Luxembourg,KAZ,Kazakhstan,2016,5,13,-8
LUX,Luxembourg,KAZ,Kazakhstan,2017,6,15,-9
MEX,Mexico,KAZ,Kazakhstan,2010,0,2,-2
MEX,Mexico,KAZ,Kazakhstan,2011,0,1,-1
MEX,Mexico,KAZ,Kazakhstan,2012,0,3,-3
MEX,Mexico,KAZ,Kazakhstan,2013,0,7,-7
MEX,Mexico,KAZ,Kazakhstan,2014,0,3,-3
MEX,Mexico,KAZ,Kazakhstan,2015,0,3,-3
MEX,Mexico,KAZ,Kazakhstan,2016,0,1,-1
MEX,Mexico,KAZ,Kazakhstan,2017,0,7,-7
NLD,Netherlands,KAZ,Kazakhstan,2008,46,74,-28
NLD,Netherlands,KAZ,Kazakhstan,2009,33,68,-35
NLD,Netherlands,KAZ,Kazakhstan,2010,59,126,-67
NLD,Netherlands,KAZ,Kazakhstan,2011,66,107,-41
NLD,Netherlands,KAZ,Kazakhstan,2012,67,91,-24
NLD,Netherlands,KAZ,Kazakhstan,2013,88,93,-5
NLD,Netherlands,KAZ,Kazakhstan,2014,56,120,-64
NLD,Netherlands,KAZ,Kazakhstan,2015,78,130,-52
NLD,Netherlands,KAZ,Kazakhstan,2016,74,150,-76
NLD,Netherlands,KAZ,Kazakhstan,2017,68,159,-91
NZL,New Zealand,KAZ,Kazakhstan,2008,1,21,-20
NZL,New Zealand,KAZ,Kazakhstan,2009,10,27,-17
NZL,New Zealand,KAZ,Kazakhstan,2010,9,30,-21
NZL,New Zealand,KAZ,Kazakhstan,2011,9,25,-16
NZL,New Zealand,KAZ,Kazakhstan,2012,12,19,-7
NZL,New Zealand,KAZ,Kazakhstan,2013,9,36,-27
NZL,New Zealand,KAZ,Kazakhstan,2014,11,28,-17
NZL,New Zealand,KAZ,Kazakhstan,2015,3,29,-26
NZL,New Zealand,KAZ,Kazakhstan,2016,4,49,-45
NZL,New Zealand,KAZ,Kazakhstan,2017,3,87,-84
NOR,Norway,KAZ,Kazakhstan,2008,6,23,-17
NOR,Norway,KAZ,Kazakhstan,2009,10,45,-35
NOR,Norway,KAZ,Kazakhstan,2010,23,37,-14
NOR,Norway,KAZ,Kazakhstan,2011,32,41,-9
NOR,Norway,KAZ,Kazakhstan,2012,19,56,-37
NOR,Norway,KAZ,Kazakhstan,2013,23,53,-30
NOR,Norway,KAZ,Kazakhstan,2014,27,47,-20
NOR,Norway,KAZ,Kazakhstan,2015,20,23,-3
NOR,Norway,KAZ,Kazakhstan,2016,37,23,14
NOR,Norway,KAZ,Kazakhstan,2017,20,28,-8
POL,Poland,KAZ,Kazakhstan,2008,0,442,-442
POL,Poland,KAZ,Kazakhstan,2009,0,447,-447
POL,Poland,KAZ,Kazakhstan,2010,0,398,-398
POL,Poland,KAZ,Kazakhstan,2011,0,348,-348
POL,Poland,KAZ,Kazakhstan,2012,0,309,-309
POL,Poland,KAZ,Kazakhstan,2013,0,349,-349
POL,Poland,KAZ,Kazakhstan,2014,0,247,-247
POL,Poland,KAZ,Kazakhstan,2015,0,455,-455
POL,Poland,KAZ,Kazakhstan,2016,0,512,-512
POL,Poland,KAZ,Kazakhstan,2017,0,462,-462
SVK,Slovak Republic,KAZ,Kazakhstan,2008,6,1,5
SVK,Slovak Republic,KAZ,Kazakhstan,2009,3,3,0
SVK,Slovak Republic,KAZ,Kazakhstan,2010,2,2,0
SVK,Slovak Republic,KAZ,Kazakhstan,2011,1,3,-2
SVK,Slovak Republic,KAZ,Kazakhstan,2013,0,1,-1
SVK,Slovak Republic,KAZ,Kazakhstan,2014,0,3,-3
SVK,Slovak Republic,KAZ,Kazakhstan,2015,0,4,-4
SVK,Slovak Republic,KAZ,Kazakhstan,2016,0,2,-2
SVK,Slovak Republic,KAZ,Kazakhstan,2017,0,3,-3
ESP,Spain,KAZ,Kazakhstan,2008,57,155,-98
ESP,Spain,KAZ,Kazakhstan,2009,70,191,-121
ESP,Spain,KAZ,Kazakhstan,2010,62,188,-126
ESP,Spain,KAZ,Kazakhstan,2011,91,223,-132
ESP,Spain,KAZ,Kazakhstan,2012,87,262,-175
ESP,Spain,KAZ,Kazakhstan,2013,118,259,-141
ESP,Spain,KAZ,Kazakhstan,2014,118,353,-235
ESP,Spain,KAZ,Kazakhstan,2015,103,358,-255
ESP,Spain,KAZ,Kazakhstan,2016,131,374,-243
ESP,Spain,KAZ,Kazakhstan,2017,189,424,-235
SWE,Sweden,KAZ,Kazakhstan,2008,5,48,-43
SWE,Sweden,KAZ,Kazakhstan,2009,1,80,-79
SWE,Sweden,KAZ,Kazakhstan,2010,10,128,-118
SWE,Sweden,KAZ,Kazakhstan,2011,5,136,-131
SWE,Sweden,KAZ,Kazakhstan,2012,15,149,-134
SWE,Sweden,KAZ,Kazakhstan,2013,20,172,-152
SWE,Sweden,KAZ,Kazakhstan,2014,20,128,-108
SWE,Sweden,KAZ,Kazakhstan,2015,33,128,-95
SWE,Sweden,KAZ,Kazakhstan,2016,30,157,-127
SWE,Sweden,KAZ,Kazakhstan,2017,24,100,-76
CHE,Switzerland,KAZ,Kazakhstan,2010,127,249,-122
CHE,Switzerland,KAZ,Kazakhstan,2011,159,211,-52
CHE,Switzerland,KAZ,Kazakhstan,2012,163,207,-44
CHE,Switzerland,KAZ,Kazakhstan,2013,134,189,-55
CHE,Switzerland,KAZ,Kazakhstan,2014,132,194,-62
CHE,Switzerland,KAZ,Kazakhstan,2015,137,201,-64
CHE,Switzerland,KAZ,Kazakhstan,2016,148,145,3
CHE,Switzerland,KAZ,Kazakhstan,2017,116,149,-33
TUR,Turkey,KAZ,Kazakhstan,2010,0,1365,-1365
TUR,Turkey,KAZ,Kazakhstan,2016,2296,3644,-1348
TUR,Turkey,KAZ,Kazakhstan,2017,3604,4318,-714
GBR,United Kingdom,KAZ,Kazakhstan,2011,0,2000,-2000
GBR,United Kingdom,KAZ,Kazakhstan,2013,0,1000,-1000
GBR,United Kingdom,KAZ,Kazakhstan,2014,1000,2000,-1000
GBR,United Kingdom,KAZ,Kazakhstan,2015,0,1000,-1000
USA,United States,KAZ,Kazakhstan,2008,0,1630,-1630
USA,United States,KAZ,Kazakhstan,2009,0,1562,-1562
USA,United States,KAZ,Kazakhstan,2010,0,1282,-1282
USA,United States,KAZ,Kazakhstan,2011,0,1235,-1235
USA,United States,KAZ,Kazakhstan,2012,0,1202,-1202
USA,United States,KAZ,Kazakhstan,2013,0,1241,-1241
USA,United States,KAZ,Kazakhstan,2014,0,1221,-1221
USA,United States,KAZ,Kazakhstan,2015,0,1201,-1201
USA,United States,KAZ,Kazakhstan,2016,0,1310,-1310
USA,United States,KAZ,Kazakhstan,2017,0,1377,-1377
CHL,Chile,KAZ,Kazakhstan,2008,0,0,0
CHL,Chile,KAZ,Kazakhstan,2009,0,2,-2
CHL,Chile,KAZ,Kazakhstan,2010,0,1,-1
CHL,Chile,KAZ,Kazakhstan,2011,0,0,0
CHL,Chile,KAZ,Kazakhstan,2012,0,3,-3
CHL,Chile,KAZ,Kazakhstan,2013,0,1,-1
CHL,Chile,KAZ,Kazakhstan,2014,0,0,0
CHL,Chile,KAZ,Kazakhstan,2015,0,1,-1
CHL,Chile,KAZ,Kazakhstan,2016,0,3,-3
EST,Estonia,KAZ,Kazakhstan,2008,0,5,-5
EST,Estonia,KAZ,Kazakhstan,2009,0,5,-5
EST,Estonia,KAZ,Kazakhstan,2010,0,2,-2
EST,Estonia,KAZ,Kazakhstan,2011,0,12,-12
EST,Estonia,KAZ,Kazakhstan,2012,0,18,-18
EST,Estonia,KAZ,Kazakhstan,2013,0,16,-16
EST,Estonia,KAZ,Kazakhstan,2014,0,6,-6
EST,Estonia,KAZ,Kazakhstan,2015,0,28,-28
EST,Estonia,KAZ,Kazakhstan,2016,0,35,-35
EST,Estonia,KAZ,Kazakhstan,2017,0,28,-28
SVN,Slovenia,KAZ,Kazakhstan,2008,0,26,-26
SVN,Slovenia,KAZ,Kazakhstan,2009,0,8,-8
SVN,Slovenia,KAZ,Kazakhstan,2010,0,17,-17
SVN,Slovenia,KAZ,Kazakhstan,2011,1,9,-8
SVN,Slovenia,KAZ,Kazakhstan,2012,0,26,-26
SVN,Slovenia,KAZ,Kazakhstan,2013,0,26,-26
SVN,Slovenia,KAZ,Kazakhstan,2014,0,33,-33
SVN,Slovenia,KAZ,Kazakhstan,2015,0,26,-26
SVN,Slovenia,KAZ,Kazakhstan,2016,1,32,-31
SVN,Slovenia,KAZ,Kazakhstan,2017,0,25,-25
AUS,Australia,KEN,Kenya,2008,83,418,-335
AUS,Australia,KEN,Kenya,2009,77,487,-410
AUS,Australia,KEN,Kenya,2010,88,407,-319
AUS,Australia,KEN,Kenya,2011,110,510,-400
AUS,Australia,KEN,Kenya,2012,125,554,-429
AUS,Australia,KEN,Kenya,2013,119,532,-413
AUS,Australia,KEN,Kenya,2014,130,397,-267
AUS,Australia,KEN,Kenya,2015,100,883,-783
AUS,Australia,KEN,Kenya,2016,100,629,-529
AUS,Australia,KEN,Kenya,2017,0,560,-560
AUT,Austria,KEN,Kenya,2008,67,124,-57
AUT,Austria,KEN,Kenya,2009,62,123,-61
AUT,Austria,KEN,Kenya,2010,81,131,-50
AUT,Austria,KEN,Kenya,2011,85,129,-44
AUT,Austria,KEN,Kenya,2012,70,114,-44
AUT,Austria,KEN,Kenya,2013,57,75,-18
AUT,Austria,KEN,Kenya,2014,43,88,-45
AUT,Austria,KEN,Kenya,2015,60,99,-39
AUT,Austria,KEN,Kenya,2016,46,109,-63
AUT,Austria,KEN,Kenya,2017,50,82,-32
BEL,Belgium,KEN,Kenya,2008,0,76,-76
BEL,Belgium,KEN,Kenya,2009,0,90,-90
BEL,Belgium,KEN,Kenya,2010,40,100,-60
BEL,Belgium,KEN,Kenya,2011,0,98,-98
BEL,Belgium,KEN,Kenya,2012,80,101,-21
BEL,Belgium,KEN,Kenya,2013,83,92,-9
BEL,Belgium,KEN,Kenya,2014,79,100,-21
BEL,Belgium,KEN,Kenya,2015,67,82,-15
BEL,Belgium,KEN,Kenya,2016,36,111,-75
BEL,Belgium,KEN,Kenya,2017,40,103,-63
CAN,Canada,KEN,Kenya,2008,0,453,-453
CAN,Canada,KEN,Kenya,2009,0,489,-489
CAN,Canada,KEN,Kenya,2010,0,507,-507
CAN,Canada,KEN,Kenya,2011,0,585,-585
CAN,Canada,KEN,Kenya,2012,0,718,-718
CAN,Canada,KEN,Kenya,2013,0,664,-664
CAN,Canada,KEN,Kenya,2014,0,455,-455
CAN,Canada,KEN,Kenya,2015,0,383,-383
CAN,Canada,KEN,Kenya,2016,0,480,-480
CAN,Canada,KEN,Kenya,2017,0,465,-465
CZE,Czech Republic,KEN,Kenya,2008,0,5,-5
CZE,Czech Republic,KEN,Kenya,2009,1,5,-4
CZE,Czech Republic,KEN,Kenya,2010,0,6,-6
CZE,Czech Republic,KEN,Kenya,2011,0,5,-5
CZE,Czech Republic,KEN,Kenya,2012,3,8,-5
CZE,Czech Republic,KEN,Kenya,2013,5,4,1
CZE,Czech Republic,KEN,Kenya,2014,5,21,-16
CZE,Czech Republic,KEN,Kenya,2015,9,13,-4
CZE,Czech Republic,KEN,Kenya,2016,7,14,-7
CZE,Czech Republic,KEN,Kenya,2017,0,17,-17
DNK,Denmark,KEN,Kenya,2008,16,81,-65
DNK,Denmark,KEN,Kenya,2009,18,64,-46
DNK,Denmark,KEN,Kenya,2010,38,69,-31
DNK,Denmark,KEN,Kenya,2011,20,72,-52
DNK,Denmark,KEN,Kenya,2012,33,70,-37
DNK,Denmark,KEN,Kenya,2013,38,101,-63
DNK,Denmark,KEN,Kenya,2014,44,95,-51
DNK,Denmark,KEN,Kenya,2015,57,73,-16
DNK,Denmark,KEN,Kenya,2016,68,96,-28
DNK,Denmark,KEN,Kenya,2017,43,85,-42
FIN,Finland,KEN,Kenya,2008,10,112,-102
FIN,Finland,KEN,Kenya,2009,12,75,-63
FIN,Finland,KEN,Kenya,2010,6,60,-54
FIN,Finland,KEN,Kenya,2011,5,70,-65
FIN,Finland,KEN,Kenya,2012,14,93,-79
FIN,Finland,KEN,Kenya,2013,15,131,-116
FIN,Finland,KEN,Kenya,2014,9,91,-82
FIN,Finland,KEN,Kenya,2015,8,97,-89
FIN,Finland,KEN,Kenya,2016,14,79,-65
FIN,Finland,KEN,Kenya,2017,13,60,-47
FRA,France,KEN,Kenya,2008,0,80,-80
FRA,France,KEN,Kenya,2009,0,69,-69
FRA,France,KEN,Kenya,2010,0,68,-68
FRA,France,KEN,Kenya,2011,0,63,-63
FRA,France,KEN,Kenya,2012,0,87,-87
FRA,France,KEN,Kenya,2013,0,71,-71
FRA,France,KEN,Kenya,2014,0,94,-94
FRA,France,KEN,Kenya,2015,0,91,-91
FRA,France,KEN,Kenya,2016,0,83,-83
FRA,France,KEN,Kenya,2017,0,69,-69
DEU,Germany,KEN,Kenya,2008,750,1255,-505
DEU,Germany,KEN,Kenya,2009,787,1462,-675
DEU,Germany,KEN,Kenya,2010,813,1502,-689
DEU,Germany,KEN,Kenya,2011,685,1030,-345
DEU,Germany,KEN,Kenya,2012,545,1034,-489
DEU,Germany,KEN,Kenya,2013,472,876,-404
DEU,Germany,KEN,Kenya,2014,422,867,-445
DEU,Germany,KEN,Kenya,2015,464,877,-413
DEU,Germany,KEN,Kenya,2016,503,991,-488
DEU,Germany,KEN,Kenya,2017,436,1092,-656
HUN,Hungary,KEN,Kenya,2008,1,13,-12
HUN,Hungary,KEN,Kenya,2009,0,24,-24
HUN,Hungary,KEN,Kenya,2010,1,19,-18
HUN,Hungary,KEN,Kenya,2011,7,15,-8
HUN,Hungary,KEN,Kenya,2012,1,25,-24
HUN,Hungary,KEN,Kenya,2013,5,18,-13
HUN,Hungary,KEN,Kenya,2014,1,14,-13
HUN,Hungary,KEN,Kenya,2015,4,20,-16
HUN,Hungary,KEN,Kenya,2016,8,46,-38
HUN,Hungary,KEN,Kenya,2017,0,60,-60
ISL,Iceland,KEN,Kenya,2008,11,9,2
ISL,Iceland,KEN,Kenya,2009,4,5,-1
ISL,Iceland,KEN,Kenya,2010,11,17,-6
ISL,Iceland,KEN,Kenya,2011,8,17,-9
ISL,Iceland,KEN,Kenya,2012,3,23,-20
ISL,Iceland,KEN,Kenya,2013,3,23,-20
ISL,Iceland,KEN,Kenya,2014,43,25,18
ISL,Iceland,KEN,Kenya,2015,15,19,-4
ISL,Iceland,KEN,Kenya,2016,17,19,-2
ISL,Iceland,KEN,Kenya,2017,18,15,3
ITA,Italy,KEN,Kenya,2008,14,180,-166
ITA,Italy,KEN,Kenya,2009,16,232,-216
ITA,Italy,KEN,Kenya,2010,24,270,-246
ITA,Italy,KEN,Kenya,2011,24,205,-181
ITA,Italy,KEN,Kenya,2012,26,226,-200
ITA,Italy,KEN,Kenya,2013,20,208,-188
ITA,Italy,KEN,Kenya,2014,32,191,-159
ITA,Italy,KEN,Kenya,2015,23,193,-170
ITA,Italy,KEN,Kenya,2016,0,167,-167
ITA,Italy,KEN,Kenya,2017,30,176,-146
JPN,Japan,KEN,Kenya,2008,358,400,-42
JPN,Japan,KEN,Kenya,2009,243,274,-31
JPN,Japan,KEN,Kenya,2010,316,348,-32
JPN,Japan,KEN,Kenya,2011,302,338,-36
JPN,Japan,KEN,Kenya,2012,353,357,-4
JPN,Japan,KEN,Kenya,2013,368,394,-26
JPN,Japan,KEN,Kenya,2014,262,376,-114
JPN,Japan,KEN,Kenya,2015,387,483,-96
JPN,Japan,KEN,Kenya,2016,344,415,-71
JPN,Japan,KEN,Kenya,2017,303,358,-55
KOR,Korea,KEN,Kenya,2008,32,49,-17
KOR,Korea,KEN,Kenya,2009,47,50,-3
KOR,Korea,KEN,Kenya,2010,68,85,-17
KOR,Korea,KEN,Kenya,2011,57,70,-13
KOR,Korea,KEN,Kenya,2012,66,90,-24
KOR,Korea,KEN,Kenya,2013,75,89,-14
KOR,Korea,KEN,Kenya,2014,79,97,-18
KOR,Korea,KEN,Kenya,2015,65,111,-46
KOR,Korea,KEN,Kenya,2016,74,112,-38
KOR,Korea,KEN,Kenya,2017,104,118,-14
LUX,Luxembourg,KEN,Kenya,2008,2,0,2
LUX,Luxembourg,KEN,Kenya,2009,0,6,-6
LUX,Luxembourg,KEN,Kenya,2010,1,7,-6
LUX,Luxembourg,KEN,Kenya,2011,2,1,1
LUX,Luxembourg,KEN,Kenya,2012,2,4,-2
LUX,Luxembourg,KEN,Kenya,2013,6,3,3
LUX,Luxembourg,KEN,Kenya,2014,1,2,-1
LUX,Luxembourg,KEN,Kenya,2015,2,6,-4
LUX,Luxembourg,KEN,Kenya,2016,0,5,-5
LUX,Luxembourg,KEN,Kenya,2017,3,15,-12
MEX,Mexico,KEN,Kenya,2008,0,5,-5
MEX,Mexico,KEN,Kenya,2009,0,9,-9
MEX,Mexico,KEN,Kenya,2010,0,6,-6
MEX,Mexico,KEN,Kenya,2011,0,5,-5
MEX,Mexico,KEN,Kenya,2012,0,2,-2
MEX,Mexico,KEN,Kenya,2013,0,41,-41
MEX,Mexico,KEN,Kenya,2014,0,23,-23
MEX,Mexico,KEN,Kenya,2015,0,18,-18
MEX,Mexico,KEN,Kenya,2016,0,19,-19
MEX,Mexico,KEN,Kenya,2017,0,13,-13
NLD,Netherlands,KEN,Kenya,2008,102,188,-86
NLD,Netherlands,KEN,Kenya,2009,70,194,-124
NLD,Netherlands,KEN,Kenya,2010,124,180,-56
NLD,Netherlands,KEN,Kenya,2011,124,200,-76
NLD,Netherlands,KEN,Kenya,2012,108,150,-42
NLD,Netherlands,KEN,Kenya,2013,138,167,-29
NLD,Netherlands,KEN,Kenya,2014,92,153,-61
NLD,Netherlands,KEN,Kenya,2015,107,165,-58
NLD,Netherlands,KEN,Kenya,2016,118,188,-70
NLD,Netherlands,KEN,Kenya,2017,114,190,-76
NZL,New Zealand,KEN,Kenya,2008,10,49,-39
NZL,New Zealand,KEN,Kenya,2009,20,58,-38
NZL,New Zealand,KEN,Kenya,2010,6,34,-28
NZL,New Zealand,KEN,Kenya,2011,15,29,-14
NZL,New Zealand,KEN,Kenya,2012,20,46,-26
NZL,New Zealand,KEN,Kenya,2013,22,28,-6
NZL,New Zealand,KEN,Kenya,2014,9,35,-26
NZL,New Zealand,KEN,Kenya,2015,8,60,-52
NZL,New Zealand,KEN,Kenya,2016,10,61,-51
NZL,New Zealand,KEN,Kenya,2017,14,65,-51
NOR,Norway,KEN,Kenya,2008,26,114,-88
NOR,Norway,KEN,Kenya,2009,28,92,-64
NOR,Norway,KEN,Kenya,2010,40,93,-53
NOR,Norway,KEN,Kenya,2011,47,95,-48
NOR,Norway,KEN,Kenya,2012,52,92,-40
NOR,Norway,KEN,Kenya,2013,37,102,-65
NOR,Norway,KEN,Kenya,2014,42,123,-81
NOR,Norway,KEN,Kenya,2015,39,121,-82
NOR,Norway,KEN,Kenya,2016,45,101,-56
NOR,Norway,KEN,Kenya,2017,31,84,-53
POL,Poland,KEN,Kenya,2008,0,77,-77
POL,Poland,KEN,Kenya,2009,0,74,-74
POL,Poland,KEN,Kenya,2010,0,65,-65
POL,Poland,KEN,Kenya,2011,0,68,-68
POL,Poland,KEN,Kenya,2012,0,67,-67
POL,Poland,KEN,Kenya,2013,0,94,-94
POL,Poland,KEN,Kenya,2014,0,38,-38
POL,Poland,KEN,Kenya,2015,0,57,-57
POL,Poland,KEN,Kenya,2016,0,56,-56
POL,Poland,KEN,Kenya,2017,0,46,-46
SVK,Slovak Republic,KEN,Kenya,2008,3,1,2
SVK,Slovak Republic,KEN,Kenya,2009,0,3,-3
SVK,Slovak Republic,KEN,Kenya,2010,0,2,-2
SVK,Slovak Republic,KEN,Kenya,2012,0,1,-1
SVK,Slovak Republic,KEN,Kenya,2013,0,2,-2
SVK,Slovak Republic,KEN,Kenya,2016,0,1,-1
ESP,Spain,KEN,Kenya,2008,27,153,-126
ESP,Spain,KEN,Kenya,2009,37,157,-120
ESP,Spain,KEN,Kenya,2010,43,133,-90
ESP,Spain,KEN,Kenya,2011,47,154,-107
ESP,Spain,KEN,Kenya,2012,44,104,-60
ESP,Spain,KEN,Kenya,2013,40,70,-30
ESP,Spain,KEN,Kenya,2014,37,78,-41
ESP,Spain,KEN,Kenya,2015,28,66,-38
ESP,Spain,KEN,Kenya,2016,20,109,-89
ESP,Spain,KEN,Kenya,2017,47,127,-80
SWE,Sweden,KEN,Kenya,2008,11,137,-126
SWE,Sweden,KEN,Kenya,2009,15,163,-148
SWE,Sweden,KEN,Kenya,2010,24,161,-137
SWE,Sweden,KEN,Kenya,2011,20,200,-180
SWE,Sweden,KEN,Kenya,2012,35,197,-162
SWE,Sweden,KEN,Kenya,2013,28,206,-178
SWE,Sweden,KEN,Kenya,2014,26,235,-209
SWE,Sweden,KEN,Kenya,2015,50,193,-143
SWE,Sweden,KEN,Kenya,2016,21,175,-154
SWE,Sweden,KEN,Kenya,2017,24,225,-201
CHE,Switzerland,KEN,Kenya,2010,60,130,-70
CHE,Switzerland,KEN,Kenya,2011,81,122,-41
CHE,Switzerland,KEN,Kenya,2012,63,131,-68
CHE,Switzerland,KEN,Kenya,2013,65,111,-46
CHE,Switzerland,KEN,Kenya,2014,44,151,-107
CHE,Switzerland,KEN,Kenya,2015,55,122,-67
CHE,Switzerland,KEN,Kenya,2016,47,133,-86
CHE,Switzerland,KEN,Kenya,2017,69,111,-42
TUR,Turkey,KEN,Kenya,2010,0,26,-26
TUR,Turkey,KEN,Kenya,2016,101,106,-5
TUR,Turkey,KEN,Kenya,2017,0,0,0
GBR,United Kingdom,KEN,Kenya,2008,0,1000,-1000
GBR,United Kingdom,KEN,Kenya,2011,0,1000,-1000
GBR,United Kingdom,KEN,Kenya,2015,0,2000,-2000
USA,United States,KEN,Kenya,2008,0,6998,-6998
USA,United States,KEN,Kenya,2009,0,9880,-9880
USA,United States,KEN,Kenya,2010,0,7421,-7421
USA,United States,KEN,Kenya,2011,0,7762,-7762
USA,United States,KEN,Kenya,2012,0,7043,-7043
USA,United States,KEN,Kenya,2013,0,6123,-6123
USA,United States,KEN,Kenya,2014,0,5884,-5884
USA,United States,KEN,Kenya,2015,0,5602,-5602
USA,United States,KEN,Kenya,2016,0,6274,-6274
USA,United States,KEN,Kenya,2017,0,6957,-6957
CHL,Chile,KEN,Kenya,2008,0,2,-2
CHL,Chile,KEN,Kenya,2009,0,0,0
CHL,Chile,KEN,Kenya,2010,0,3,-3
CHL,Chile,KEN,Kenya,2011,0,4,-4
CHL,Chile,KEN,Kenya,2012,0,3,-3
CHL,Chile,KEN,Kenya,2013,0,1,-1
CHL,Chile,KEN,Kenya,2014,0,2,-2
CHL,Chile,KEN,Kenya,2015,0,7,-7
CHL,Chile,KEN,Kenya,2016,0,5,-5
EST,Estonia,KEN,Kenya,2008,0,1,-1
EST,Estonia,KEN,Kenya,2009,0,1,-1
EST,Estonia,KEN,Kenya,2010,0,0,0
EST,Estonia,KEN,Kenya,2011,0,0,0
EST,Estonia,KEN,Kenya,2012,0,0,0
EST,Estonia,KEN,Kenya,2013,0,1,-1
EST,Estonia,KEN,Kenya,2014,0,1,-1
EST,Estonia,KEN,Kenya,2015,0,1,-1
EST,Estonia,KEN,Kenya,2016,0,4,-4
EST,Estonia,KEN,Kenya,2017,0,7,-7
SVN,Slovenia,KEN,Kenya,2008,0,1,-1
SVN,Slovenia,KEN,Kenya,2009,0,2,-2
SVN,Slovenia,KEN,Kenya,2010,0,2,-2
SVN,Slovenia,KEN,Kenya,2011,0,3,-3
SVN,Slovenia,KEN,Kenya,2013,0,1,-1
SVN,Slovenia,KEN,Kenya,2017,0,4,-4
AUS,Australia,KIR,Kiribati,2008,0,7,-7
AUS,Australia,KIR,Kiribati,2009,7,9,-2
AUS,Australia,KIR,Kiribati,2010,0,21,-21
AUS,Australia,KIR,Kiribati,2011,0,6,-6
AUS,Australia,KIR,Kiribati,2012,0,3,-3
AUS,Australia,KIR,Kiribati,2013,0,6,-6
AUS,Australia,KIR,Kiribati,2014,0,6,-6
AUS,Australia,KIR,Kiribati,2015,0,21,-21
AUS,Australia,KIR,Kiribati,2016,0,34,-34
AUS,Australia,KIR,Kiribati,2017,0,52,-52
AUT,Austria,KIR,Kiribati,2008,0,0,0
AUT,Austria,KIR,Kiribati,2009,0,0,0
AUT,Austria,KIR,Kiribati,2010,0,0,0
AUT,Austria,KIR,Kiribati,2011,0,0,0
AUT,Austria,KIR,Kiribati,2012,0,0,0
AUT,Austria,KIR,Kiribati,2013,0,0,0
AUT,Austria,KIR,Kiribati,2014,0,0,0
AUT,Austria,KIR,Kiribati,2015,0,0,0
AUT,Austria,KIR,Kiribati,2016,0,0,0
AUT,Austria,KIR,Kiribati,2017,0,0,0
BEL,Belgium,KIR,Kiribati,2010,0,0,0
CAN,Canada,KIR,Kiribati,2008,0,1,-1
CAN,Canada,KIR,Kiribati,2009,0,1,-1
CAN,Canada,KIR,Kiribati,2010,0,0,0
CAN,Canada,KIR,Kiribati,2011,0,0,0
CAN,Canada,KIR,Kiribati,2012,0,2,-2
CAN,Canada,KIR,Kiribati,2013,0,0,0
CAN,Canada,KIR,Kiribati,2014,0,0,0
CAN,Canada,KIR,Kiribati,2015,0,0,0
CAN,Canada,KIR,Kiribati,2016,0,0,0
CAN,Canada,KIR,Kiribati,2017,0,0,0
DNK,Denmark,KIR,Kiribati,2008,0,0,0
DNK,Denmark,KIR,Kiribati,2009,0,0,0
DNK,Denmark,KIR,Kiribati,2012,0,0,0
DNK,Denmark,KIR,Kiribati,2013,0,0,0
DNK,Denmark,KIR,Kiribati,2014,0,0,0
DNK,Denmark,KIR,Kiribati,2015,0,0,0
DNK,Denmark,KIR,Kiribati,2016,0,0,0
DNK,Denmark,KIR,Kiribati,2017,0,0,0
FIN,Finland,KIR,Kiribati,2008,0,0,0
FIN,Finland,KIR,Kiribati,2009,0,0,0
FIN,Finland,KIR,Kiribati,2010,0,0,0
FIN,Finland,KIR,Kiribati,2011,0,0,0
FIN,Finland,KIR,Kiribati,2012,0,0,0
FIN,Finland,KIR,Kiribati,2013,0,0,0
FIN,Finland,KIR,Kiribati,2014,0,0,0
FIN,Finland,KIR,Kiribati,2015,0,0,0
FIN,Finland,KIR,Kiribati,2016,0,0,0
FIN,Finland,KIR,Kiribati,2017,0,0,0
FRA,France,KIR,Kiribati,2008,0,2,-2
FRA,France,KIR,Kiribati,2009,0,0,0
FRA,France,KIR,Kiribati,2010,0,0,0
FRA,France,KIR,Kiribati,2011,0,0,0
FRA,France,KIR,Kiribati,2012,0,0,0
FRA,France,KIR,Kiribati,2013,0,1,-1
FRA,France,KIR,Kiribati,2014,0,1,-1
FRA,France,KIR,Kiribati,2015,0,0,0
FRA,France,KIR,Kiribati,2016,0,0,0
FRA,France,KIR,Kiribati,2017,0,1,-1
DEU,Germany,KIR,Kiribati,2008,0,326,-326
DEU,Germany,KIR,Kiribati,2009,325,269,56
DEU,Germany,KIR,Kiribati,2010,238,232,6
DEU,Germany,KIR,Kiribati,2011,224,222,2
DEU,Germany,KIR,Kiribati,2012,148,223,-75
DEU,Germany,KIR,Kiribati,2013,167,173,-6
DEU,Germany,KIR,Kiribati,2014,146,175,-29
DEU,Germany,KIR,Kiribati,2015,131,146,-15
DEU,Germany,KIR,Kiribati,2016,175,173,2
DEU,Germany,KIR,Kiribati,2017,122,143,-21
HUN,Hungary,KIR,Kiribati,2008,0,0,0
HUN,Hungary,KIR,Kiribati,2009,0,0,0
HUN,Hungary,KIR,Kiribati,2010,0,0,0
HUN,Hungary,KIR,Kiribati,2011,0,0,0
HUN,Hungary,KIR,Kiribati,2012,0,0,0
HUN,Hungary,KIR,Kiribati,2013,0,0,0
HUN,Hungary,KIR,Kiribati,2014,0,0,0
HUN,Hungary,KIR,Kiribati,2015,0,0,0
HUN,Hungary,KIR,Kiribati,2016,0,0,0
HUN,Hungary,KIR,Kiribati,2017,0,0,0
ISL,Iceland,KIR,Kiribati,2016,0,0,0
ISL,Iceland,KIR,Kiribati,2017,0,0,0
ITA,Italy,KIR,Kiribati,2008,0,0,0
ITA,Italy,KIR,Kiribati,2009,0,2,-2
ITA,Italy,KIR,Kiribati,2010,0,0,0
ITA,Italy,KIR,Kiribati,2011,0,0,0
ITA,Italy,KIR,Kiribati,2012,0,1,-1
ITA,Italy,KIR,Kiribati,2013,0,0,0
ITA,Italy,KIR,Kiribati,2014,0,1,-1
ITA,Italy,KIR,Kiribati,2015,0,100,-100
JPN,Japan,KIR,Kiribati,2008,28,23,5
JPN,Japan,KIR,Kiribati,2009,32,32,0
JPN,Japan,KIR,Kiribati,2010,44,44,0
JPN,Japan,KIR,Kiribati,2011,37,38,-1
JPN,Japan,KIR,Kiribati,2012,37,37,0
JPN,Japan,KIR,Kiribati,2013,37,36,1
JPN,Japan,KIR,Kiribati,2014,46,46,0
JPN,Japan,KIR,Kiribati,2015,49,51,-2
JPN,Japan,KIR,Kiribati,2016,28,37,-9
JPN,Japan,KIR,Kiribati,2017,52,55,-3
KOR,Korea,KIR,Kiribati,2008,1,2,-1
KOR,Korea,KIR,Kiribati,2009,3,0,3
KOR,Korea,KIR,Kiribati,2010,2,0,2
KOR,Korea,KIR,Kiribati,2011,2,2,0
KOR,Korea,KIR,Kiribati,2012,3,3,0
KOR,Korea,KIR,Kiribati,2013,2,0,2
KOR,Korea,KIR,Kiribati,2014,2,5,-3
KOR,Korea,KIR,Kiribati,2015,2,1,1
KOR,Korea,KIR,Kiribati,2016,0,2,-2
KOR,Korea,KIR,Kiribati,2017,1,7,-6
LUX,Luxembourg,KIR,Kiribati,2008,0,0,0
LUX,Luxembourg,KIR,Kiribati,2009,0,0,0
LUX,Luxembourg,KIR,Kiribati,2010,0,0,0
LUX,Luxembourg,KIR,Kiribati,2011,0,0,0
LUX,Luxembourg,KIR,Kiribati,2012,0,0,0
LUX,Luxembourg,KIR,Kiribati,2013,0,0,0
LUX,Luxembourg,KIR,Kiribati,2014,0,0,0
LUX,Luxembourg,KIR,Kiribati,2015,0,0,0
LUX,Luxembourg,KIR,Kiribati,2016,0,0,0
LUX,Luxembourg,KIR,Kiribati,2017,0,0,0
MEX,Mexico,KIR,Kiribati,2012,0,0,0
MEX,Mexico,KIR,Kiribati,2013,0,0,0
MEX,Mexico,KIR,Kiribati,2014,0,0,0
NLD,Netherlands,KIR,Kiribati,2013,1,1,0
NLD,Netherlands,KIR,Kiribati,2015,0,3,-3
NLD,Netherlands,KIR,Kiribati,2016,3,0,3
NZL,New Zealand,KIR,Kiribati,2008,26,51,-25
NZL,New Zealand,KIR,Kiribati,2009,56,67,-11
NZL,New Zealand,KIR,Kiribati,2010,43,31,12
NZL,New Zealand,KIR,Kiribati,2011,32,66,-34
NZL,New Zealand,KIR,Kiribati,2012,19,39,-20
NZL,New Zealand,KIR,Kiribati,2013,13,72,-59
NZL,New Zealand,KIR,Kiribati,2014,22,49,-27
NZL,New Zealand,KIR,Kiribati,2015,28,93,-65
NZL,New Zealand,KIR,Kiribati,2016,29,67,-38
NZL,New Zealand,KIR,Kiribati,2017,38,98,-60
NOR,Norway,KIR,Kiribati,2008,0,0,0
NOR,Norway,KIR,Kiribati,2009,0,0,0
NOR,Norway,KIR,Kiribati,2010,0,0,0
NOR,Norway,KIR,Kiribati,2011,0,0,0
NOR,Norway,KIR,Kiribati,2012,0,0,0
NOR,Norway,KIR,Kiribati,2013,0,0,0
NOR,Norway,KIR,Kiribati,2014,0,0,0
NOR,Norway,KIR,Kiribati,2015,0,0,0
NOR,Norway,KIR,Kiribati,2016,0,0,0
NOR,Norway,KIR,Kiribati,2017,0,0,0
POL,Poland,KIR,Kiribati,2009,0,0,0
POL,Poland,KIR,Kiribati,2010,0,0,0
POL,Poland,KIR,Kiribati,2011,0,1,-1
POL,Poland,KIR,Kiribati,2012,0,0,0
POL,Poland,KIR,Kiribati,2013,0,1,-1
POL,Poland,KIR,Kiribati,2014,0,0,0
POL,Poland,KIR,Kiribati,2015,0,0,0
POL,Poland,KIR,Kiribati,2016,0,0,0
POL,Poland,KIR,Kiribati,2017,0,0,0
SVK,Slovak Republic,KIR,Kiribati,2008,0,1,-1
SVK,Slovak Republic,KIR,Kiribati,2010,0,1,-1
ESP,Spain,KIR,Kiribati,2008,0,0,0
ESP,Spain,KIR,Kiribati,2009,0,0,0
ESP,Spain,KIR,Kiribati,2010,0,0,0
ESP,Spain,KIR,Kiribati,2011,0,0,0
ESP,Spain,KIR,Kiribati,2012,0,0,0
ESP,Spain,KIR,Kiribati,2013,0,1,-1
ESP,Spain,KIR,Kiribati,2014,0,0,0
ESP,Spain,KIR,Kiribati,2015,1,1,0
ESP,Spain,KIR,Kiribati,2016,0,1,-1
ESP,Spain,KIR,Kiribati,2017,0,1,-1
SWE,Sweden,KIR,Kiribati,2008,1,0,1
SWE,Sweden,KIR,Kiribati,2009,0,0,0
SWE,Sweden,KIR,Kiribati,2010,0,0,0
SWE,Sweden,KIR,Kiribati,2011,0,0,0
SWE,Sweden,KIR,Kiribati,2012,0,0,0
SWE,Sweden,KIR,Kiribati,2013,0,0,0
SWE,Sweden,KIR,Kiribati,2014,0,0,0
SWE,Sweden,KIR,Kiribati,2015,1,0,1
SWE,Sweden,KIR,Kiribati,2016,0,1,-1
SWE,Sweden,KIR,Kiribati,2017,0,0,0
CHE,Switzerland,KIR,Kiribati,2010,0,1,-1
CHE,Switzerland,KIR,Kiribati,2011,0,0,0
CHE,Switzerland,KIR,Kiribati,2012,0,1,-1
CHE,Switzerland,KIR,Kiribati,2013,0,0,0
CHE,Switzerland,KIR,Kiribati,2014,1,0,1
CHE,Switzerland,KIR,Kiribati,2015,0,0,0
CHE,Switzerland,KIR,Kiribati,2016,0,0,0
CHE,Switzerland,KIR,Kiribati,2017,0,0,0
USA,United States,KIR,Kiribati,2008,0,4,-4
USA,United States,KIR,Kiribati,2009,0,10,-10
USA,United States,KIR,Kiribati,2010,0,6,-6
USA,United States,KIR,Kiribati,2011,0,2,-2
USA,United States,KIR,Kiribati,2012,0,6,-6
USA,United States,KIR,Kiribati,2013,0,3,-3
USA,United States,KIR,Kiribati,2014,0,6,-6
USA,United States,KIR,Kiribati,2015,0,4,-4
USA,United States,KIR,Kiribati,2016,0,9,-9
USA,United States,KIR,Kiribati,2017,0,2,-2
CHL,Chile,KIR,Kiribati,2008,0,0,0
CHL,Chile,KIR,Kiribati,2009,0,0,0
CHL,Chile,KIR,Kiribati,2010,0,0,0
CHL,Chile,KIR,Kiribati,2011,0,0,0
CHL,Chile,KIR,Kiribati,2012,0,0,0
CHL,Chile,KIR,Kiribati,2013,0,4,-4
CHL,Chile,KIR,Kiribati,2014,0,0,0
CHL,Chile,KIR,Kiribati,2015,0,0,0
CHL,Chile,KIR,Kiribati,2016,0,0,0
EST,Estonia,KIR,Kiribati,2008,0,0,0
EST,Estonia,KIR,Kiribati,2009,0,0,0
EST,Estonia,KIR,Kiribati,2010,0,0,0
EST,Estonia,KIR,Kiribati,2011,0,0,0
EST,Estonia,KIR,Kiribati,2012,0,0,0
EST,Estonia,KIR,Kiribati,2013,0,0,0
EST,Estonia,KIR,Kiribati,2014,0,0,0
EST,Estonia,KIR,Kiribati,2015,0,0,0
EST,Estonia,KIR,Kiribati,2016,0,0,0
EST,Estonia,KIR,Kiribati,2017,0,0,0
AUS,Australia,KWT,Kuwait,2008,77,8,69
AUS,Australia,KWT,Kuwait,2009,63,7,56
AUS,Australia,KWT,Kuwait,2010,62,9,53
AUS,Australia,KWT,Kuwait,2011,53,8,45
AUS,Australia,KWT,Kuwait,2012,61,13,48
AUS,Australia,KWT,Kuwait,2013,70,6,64
AUS,Australia,KWT,Kuwait,2014,61,11,50
AUS,Australia,KWT,Kuwait,2015,100,9,91
AUS,Australia,KWT,Kuwait,2016,100,12,88
AUS,Australia,KWT,Kuwait,2017,0,9,-9
AUT,Austria,KWT,Kuwait,2008,5,2,3
AUT,Austria,KWT,Kuwait,2009,2,1,1
AUT,Austria,KWT,Kuwait,2010,2,2,0
AUT,Austria,KWT,Kuwait,2011,0,4,-4
AUT,Austria,KWT,Kuwait,2012,1,7,-6
AUT,Austria,KWT,Kuwait,2013,5,12,-7
AUT,Austria,KWT,Kuwait,2014,8,11,-3
AUT,Austria,KWT,Kuwait,2015,7,24,-17
AUT,Austria,KWT,Kuwait,2016,12,25,-13
AUT,Austria,KWT,Kuwait,2017,7,7,0
BEL,Belgium,KWT,Kuwait,2008,0,7,-7
BEL,Belgium,KWT,Kuwait,2009,0,0,0
BEL,Belgium,KWT,Kuwait,2010,6,3,3
BEL,Belgium,KWT,Kuwait,2012,1,2,-1
BEL,Belgium,KWT,Kuwait,2013,6,6,0
BEL,Belgium,KWT,Kuwait,2014,1,10,-9
BEL,Belgium,KWT,Kuwait,2015,3,6,-3
BEL,Belgium,KWT,Kuwait,2016,8,5,3
BEL,Belgium,KWT,Kuwait,2017,5,7,-2
CAN,Canada,KWT,Kuwait,2008,0,53,-53
CAN,Canada,KWT,Kuwait,2009,0,68,-68
CAN,Canada,KWT,Kuwait,2010,0,67,-67
CAN,Canada,KWT,Kuwait,2011,0,58,-58
CAN,Canada,KWT,Kuwait,2012,0,73,-73
CAN,Canada,KWT,Kuwait,2013,0,48,-48
CAN,Canada,KWT,Kuwait,2014,0,49,-49
CAN,Canada,KWT,Kuwait,2015,0,20,-20
CAN,Canada,KWT,Kuwait,2016,0,45,-45
CAN,Canada,KWT,Kuwait,2017,0,25,-25
CZE,Czech Republic,KWT,Kuwait,2008,0,19,-19
CZE,Czech Republic,KWT,Kuwait,2009,0,7,-7
CZE,Czech Republic,KWT,Kuwait,2012,2,1,1
CZE,Czech Republic,KWT,Kuwait,2013,2,4,-2
CZE,Czech Republic,KWT,Kuwait,2014,1,2,-1
CZE,Czech Republic,KWT,Kuwait,2015,2,4,-2
CZE,Czech Republic,KWT,Kuwait,2016,1,1,0
CZE,Czech Republic,KWT,Kuwait,2017,2,4,-2
DNK,Denmark,KWT,Kuwait,2008,0,1,-1
DNK,Denmark,KWT,Kuwait,2009,1,1,0
DNK,Denmark,KWT,Kuwait,2010,0,1,-1
DNK,Denmark,KWT,Kuwait,2012,1,3,-2
DNK,Denmark,KWT,Kuwait,2013,0,1,-1
DNK,Denmark,KWT,Kuwait,2014,0,2,-2
DNK,Denmark,KWT,Kuwait,2015,0,2,-2
DNK,Denmark,KWT,Kuwait,2016,0,1,-1
DNK,Denmark,KWT,Kuwait,2017,0,0,0
FIN,Finland,KWT,Kuwait,2008,0,0,0
FIN,Finland,KWT,Kuwait,2009,0,1,-1
FIN,Finland,KWT,Kuwait,2010,0,0,0
FIN,Finland,KWT,Kuwait,2011,0,1,-1
FIN,Finland,KWT,Kuwait,2012,0,0,0
FIN,Finland,KWT,Kuwait,2013,1,0,1
FIN,Finland,KWT,Kuwait,2014,0,1,-1
FIN,Finland,KWT,Kuwait,2015,0,0,0
FIN,Finland,KWT,Kuwait,2016,0,1,-1
FIN,Finland,KWT,Kuwait,2017,0,0,0
FRA,France,KWT,Kuwait,2008,0,25,-25
FRA,France,KWT,Kuwait,2009,0,10,-10
FRA,France,KWT,Kuwait,2010,0,12,-12
FRA,France,KWT,Kuwait,2011,0,11,-11
FRA,France,KWT,Kuwait,2012,0,17,-17
FRA,France,KWT,Kuwait,2013,0,16,-16
FRA,France,KWT,Kuwait,2014,0,18,-18
FRA,France,KWT,Kuwait,2015,0,20,-20
FRA,France,KWT,Kuwait,2016,0,26,-26
FRA,France,KWT,Kuwait,2017,0,37,-37
DEU,Germany,KWT,Kuwait,2008,117,94,23
DEU,Germany,KWT,Kuwait,2009,115,153,-38
DEU,Germany,KWT,Kuwait,2010,164,174,-10
DEU,Germany,KWT,Kuwait,2011,102,131,-29
DEU,Germany,KWT,Kuwait,2012,154,217,-63
DEU,Germany,KWT,Kuwait,2013,381,541,-160
DEU,Germany,KWT,Kuwait,2014,729,1421,-692
DEU,Germany,KWT,Kuwait,2015,1338,2093,-755
DEU,Germany,KWT,Kuwait,2016,2913,2840,73
DEU,Germany,KWT,Kuwait,2017,1173,994,179
HUN,Hungary,KWT,Kuwait,2008,0,0,0
HUN,Hungary,KWT,Kuwait,2009,0,10,-10
HUN,Hungary,KWT,Kuwait,2010,0,4,-4
HUN,Hungary,KWT,Kuwait,2011,0,12,-12
HUN,Hungary,KWT,Kuwait,2012,1,7,-6
HUN,Hungary,KWT,Kuwait,2013,0,6,-6
HUN,Hungary,KWT,Kuwait,2014,0,18,-18
HUN,Hungary,KWT,Kuwait,2015,0,1,-1
HUN,Hungary,KWT,Kuwait,2016,7,9,-2
HUN,Hungary,KWT,Kuwait,2017,0,25,-25
ISL,Iceland,KWT,Kuwait,2008,0,0,0
ISL,Iceland,KWT,Kuwait,2009,0,0,0
ISL,Iceland,KWT,Kuwait,2010,0,0,0
ISL,Iceland,KWT,Kuwait,2011,0,0,0
ISL,Iceland,KWT,Kuwait,2012,0,0,0
ISL,Iceland,KWT,Kuwait,2016,0,0,0
ISL,Iceland,KWT,Kuwait,2017,0,0,0
ITA,Italy,KWT,Kuwait,2008,0,14,-14
ITA,Italy,KWT,Kuwait,2009,0,8,-8
ITA,Italy,KWT,Kuwait,2010,1,1,0
ITA,Italy,KWT,Kuwait,2011,0,3,-3
ITA,Italy,KWT,Kuwait,2012,0,3,-3
ITA,Italy,KWT,Kuwait,2013,2,9,-7
ITA,Italy,KWT,Kuwait,2014,1,10,-9
ITA,Italy,KWT,Kuwait,2015,1,13,-12
ITA,Italy,KWT,Kuwait,2016,0,14,-14
ITA,Italy,KWT,Kuwait,2017,1,11,-10
JPN,Japan,KWT,Kuwait,2008,124,133,-9
JPN,Japan,KWT,Kuwait,2009,85,86,-1
JPN,Japan,KWT,Kuwait,2010,86,92,-6
JPN,Japan,KWT,Kuwait,2011,24,36,-12
JPN,Japan,KWT,Kuwait,2012,197,190,7
JPN,Japan,KWT,Kuwait,2013,76,87,-11
JPN,Japan,KWT,Kuwait,2014,117,118,-1
JPN,Japan,KWT,Kuwait,2015,71,66,5
JPN,Japan,KWT,Kuwait,2016,107,111,-4
JPN,Japan,KWT,Kuwait,2017,39,61,-22
KOR,Korea,KWT,Kuwait,2008,2,10,-8
KOR,Korea,KWT,Kuwait,2009,9,1,8
KOR,Korea,KWT,Kuwait,2010,2,8,-6
KOR,Korea,KWT,Kuwait,2011,22,5,17
KOR,Korea,KWT,Kuwait,2012,15,8,7
KOR,Korea,KWT,Kuwait,2013,4,8,-4
KOR,Korea,KWT,Kuwait,2014,20,12,8
KOR,Korea,KWT,Kuwait,2015,15,9,6
KOR,Korea,KWT,Kuwait,2016,11,16,-5
KOR,Korea,KWT,Kuwait,2017,40,13,27
LUX,Luxembourg,KWT,Kuwait,2008,0,0,0
LUX,Luxembourg,KWT,Kuwait,2009,0,0,0
LUX,Luxembourg,KWT,Kuwait,2010,0,0,0
LUX,Luxembourg,KWT,Kuwait,2011,0,2,-2
LUX,Luxembourg,KWT,Kuwait,2012,0,0,0
LUX,Luxembourg,KWT,Kuwait,2013,0,0,0
LUX,Luxembourg,KWT,Kuwait,2014,0,1,-1
LUX,Luxembourg,KWT,Kuwait,2015,0,0,0
LUX,Luxembourg,KWT,Kuwait,2016,0,0,0
LUX,Luxembourg,KWT,Kuwait,2017,0,3,-3
MEX,Mexico,KWT,Kuwait,2008,0,1,-1
MEX,Mexico,KWT,Kuwait,2012,0,0,0
MEX,Mexico,KWT,Kuwait,2013,0,0,0
MEX,Mexico,KWT,Kuwait,2014,0,0,0
NLD,Netherlands,KWT,Kuwait,2008,2,0,2
NLD,Netherlands,KWT,Kuwait,2009,2,5,-3
NLD,Netherlands,KWT,Kuwait,2010,3,4,-1
NLD,Netherlands,KWT,Kuwait,2011,5,13,-8
NLD,Netherlands,KWT,Kuwait,2012,6,14,-8
NLD,Netherlands,KWT,Kuwait,2013,9,40,-31
NLD,Netherlands,KWT,Kuwait,2014,13,47,-34
NLD,Netherlands,KWT,Kuwait,2015,31,22,9
NLD,Netherlands,KWT,Kuwait,2016,30,10,20
NLD,Netherlands,KWT,Kuwait,2017,16,23,-7
NZL,New Zealand,KWT,Kuwait,2008,1,2,-1
NZL,New Zealand,KWT,Kuwait,2009,1,3,-2
NZL,New Zealand,KWT,Kuwait,2010,1,44,-43
NZL,New Zealand,KWT,Kuwait,2011,1,80,-79
NZL,New Zealand,KWT,Kuwait,2012,1,73,-72
NZL,New Zealand,KWT,Kuwait,2013,11,30,-19
NZL,New Zealand,KWT,Kuwait,2014,2,16,-14
NZL,New Zealand,KWT,Kuwait,2015,5,31,-26
NZL,New Zealand,KWT,Kuwait,2016,8,23,-15
NZL,New Zealand,KWT,Kuwait,2017,13,8,5
NOR,Norway,KWT,Kuwait,2008,0,9,-9
NOR,Norway,KWT,Kuwait,2009,1,1,0
NOR,Norway,KWT,Kuwait,2010,0,2,-2
NOR,Norway,KWT,Kuwait,2011,0,1,-1
NOR,Norway,KWT,Kuwait,2012,0,2,-2
NOR,Norway,KWT,Kuwait,2013,0,1,-1
NOR,Norway,KWT,Kuwait,2014,0,3,-3
NOR,Norway,KWT,Kuwait,2015,0,1,-1
NOR,Norway,KWT,Kuwait,2016,0,1,-1
NOR,Norway,KWT,Kuwait,2017,3,5,-2
POL,Poland,KWT,Kuwait,2009,0,1,-1
POL,Poland,KWT,Kuwait,2010,0,1,-1
POL,Poland,KWT,Kuwait,2011,0,1,-1
POL,Poland,KWT,Kuwait,2012,0,5,-5
POL,Poland,KWT,Kuwait,2013,0,3,-3
POL,Poland,KWT,Kuwait,2014,0,3,-3
POL,Poland,KWT,Kuwait,2015,0,5,-5
POL,Poland,KWT,Kuwait,2016,0,2,-2
POL,Poland,KWT,Kuwait,2017,0,54,-54
SVK,Slovak Republic,KWT,Kuwait,2008,2,8,-6
SVK,Slovak Republic,KWT,Kuwait,2009,9,2,7
SVK,Slovak Republic,KWT,Kuwait,2010,8,1,7
SVK,Slovak Republic,KWT,Kuwait,2011,1,4,-3
SVK,Slovak Republic,KWT,Kuwait,2012,1,1,0
SVK,Slovak Republic,KWT,Kuwait,2014,0,1,-1
SVK,Slovak Republic,KWT,Kuwait,2015,0,1,-1
SVK,Slovak Republic,KWT,Kuwait,2017,0,1,-1
ESP,Spain,KWT,Kuwait,2008,4,8,-4
ESP,Spain,KWT,Kuwait,2009,6,15,-9
ESP,Spain,KWT,Kuwait,2010,5,13,-8
ESP,Spain,KWT,Kuwait,2011,5,26,-21
ESP,Spain,KWT,Kuwait,2012,3,27,-24
ESP,Spain,KWT,Kuwait,2013,15,32,-17
ESP,Spain,KWT,Kuwait,2014,16,58,-42
ESP,Spain,KWT,Kuwait,2015,5,43,-38
ESP,Spain,KWT,Kuwait,2016,17,40,-23
ESP,Spain,KWT,Kuwait,2017,32,57,-25
SWE,Sweden,KWT,Kuwait,2008,2,1,1
SWE,Sweden,KWT,Kuwait,2009,1,2,-1
SWE,Sweden,KWT,Kuwait,2010,1,0,1
SWE,Sweden,KWT,Kuwait,2011,0,4,-4
SWE,Sweden,KWT,Kuwait,2012,2,7,-5
SWE,Sweden,KWT,Kuwait,2013,1,9,-8
SWE,Sweden,KWT,Kuwait,2014,2,16,-14
SWE,Sweden,KWT,Kuwait,2015,1,4,-3
SWE,Sweden,KWT,Kuwait,2016,2,3,-1
SWE,Sweden,KWT,Kuwait,2017,0,26,-26
CHE,Switzerland,KWT,Kuwait,2010,12,8,4
CHE,Switzerland,KWT,Kuwait,2011,8,9,-1
CHE,Switzerland,KWT,Kuwait,2012,11,10,1
CHE,Switzerland,KWT,Kuwait,2013,5,14,-9
CHE,Switzerland,KWT,Kuwait,2014,12,14,-2
CHE,Switzerland,KWT,Kuwait,2015,6,5,1
CHE,Switzerland,KWT,Kuwait,2016,3,8,-5
CHE,Switzerland,KWT,Kuwait,2017,14,5,9
TUR,Turkey,KWT,Kuwait,2010,0,9,-9
TUR,Turkey,KWT,Kuwait,2016,93,200,-107
TUR,Turkey,KWT,Kuwait,2017,122,369,-247
GBR,United Kingdom,KWT,Kuwait,2011,0,1000,-1000
GBR,United Kingdom,KWT,Kuwait,2012,0,1000,-1000
GBR,United Kingdom,KWT,Kuwait,2013,0,1000,-1000
GBR,United Kingdom,KWT,Kuwait,2014,0,2000,-2000
GBR,United Kingdom,KWT,Kuwait,2015,0,1000,-1000
USA,United States,KWT,Kuwait,2008,0,1104,-1104
USA,United States,KWT,Kuwait,2009,0,1124,-1124
USA,United States,KWT,Kuwait,2010,0,1037,-1037
USA,United States,KWT,Kuwait,2011,0,973,-973
USA,United States,KWT,Kuwait,2012,0,1044,-1044
USA,United States,KWT,Kuwait,2013,0,937,-937
USA,United States,KWT,Kuwait,2014,0,1057,-1057
USA,United States,KWT,Kuwait,2015,0,1055,-1055
USA,United States,KWT,Kuwait,2016,0,1186,-1186
USA,United States,KWT,Kuwait,2017,0,1177,-1177
CHL,Chile,KWT,Kuwait,2008,0,0,0
CHL,Chile,KWT,Kuwait,2009,0,0,0
CHL,Chile,KWT,Kuwait,2010,0,0,0
CHL,Chile,KWT,Kuwait,2011,0,0,0
CHL,Chile,KWT,Kuwait,2012,0,0,0
CHL,Chile,KWT,Kuwait,2013,0,0,0
CHL,Chile,KWT,Kuwait,2014,0,0,0
CHL,Chile,KWT,Kuwait,2015,0,0,0
CHL,Chile,KWT,Kuwait,2016,0,0,0
EST,Estonia,KWT,Kuwait,2008,0,0,0
EST,Estonia,KWT,Kuwait,2009,0,0,0
EST,Estonia,KWT,Kuwait,2010,0,0,0
EST,Estonia,KWT,Kuwait,2011,0,0,0
EST,Estonia,KWT,Kuwait,2012,0,0,0
EST,Estonia,KWT,Kuwait,2013,0,1,-1
EST,Estonia,KWT,Kuwait,2014,0,0,0
EST,Estonia,KWT,Kuwait,2015,0,0,0
EST,Estonia,KWT,Kuwait,2016,0,0,0
EST,Estonia,KWT,Kuwait,2017,0,0,0
SVN,Slovenia,KWT,Kuwait,2017,0,1,-1
AUS,Australia,KGZ,Kyrgyzstan,2008,0,33,-33
AUS,Australia,KGZ,Kyrgyzstan,2009,5,27,-22
AUS,Australia,KGZ,Kyrgyzstan,2010,0,32,-32
AUS,Australia,KGZ,Kyrgyzstan,2011,5,23,-18
AUS,Australia,KGZ,Kyrgyzstan,2012,5,18,-13
AUS,Australia,KGZ,Kyrgyzstan,2013,11,23,-12
AUS,Australia,KGZ,Kyrgyzstan,2014,7,14,-7
AUS,Australia,KGZ,Kyrgyzstan,2015,0,17,-17
AUS,Australia,KGZ,Kyrgyzstan,2016,0,22,-22
AUS,Australia,KGZ,Kyrgyzstan,2017,0,21,-21
AUT,Austria,KGZ,Kyrgyzstan,2008,49,95,-46
AUT,Austria,KGZ,Kyrgyzstan,2009,62,71,-9
AUT,Austria,KGZ,Kyrgyzstan,2010,50,128,-78
AUT,Austria,KGZ,Kyrgyzstan,2011,78,109,-31
AUT,Austria,KGZ,Kyrgyzstan,2012,59,112,-53
AUT,Austria,KGZ,Kyrgyzstan,2013,63,98,-35
AUT,Austria,KGZ,Kyrgyzstan,2014,52,61,-9
AUT,Austria,KGZ,Kyrgyzstan,2015,55,85,-30
AUT,Austria,KGZ,Kyrgyzstan,2016,45,95,-50
AUT,Austria,KGZ,Kyrgyzstan,2017,62,103,-41
BEL,Belgium,KGZ,Kyrgyzstan,2008,0,37,-37
BEL,Belgium,KGZ,Kyrgyzstan,2009,0,35,-35
BEL,Belgium,KGZ,Kyrgyzstan,2010,8,35,-27
BEL,Belgium,KGZ,Kyrgyzstan,2012,47,105,-58
BEL,Belgium,KGZ,Kyrgyzstan,2013,97,45,52
BEL,Belgium,KGZ,Kyrgyzstan,2014,74,33,41
BEL,Belgium,KGZ,Kyrgyzstan,2015,53,29,24
BEL,Belgium,KGZ,Kyrgyzstan,2016,22,27,-5
BEL,Belgium,KGZ,Kyrgyzstan,2017,18,37,-19
CAN,Canada,KGZ,Kyrgyzstan,2008,0,167,-167
CAN,Canada,KGZ,Kyrgyzstan,2009,0,173,-173
CAN,Canada,KGZ,Kyrgyzstan,2010,0,157,-157
CAN,Canada,KGZ,Kyrgyzstan,2011,0,159,-159
CAN,Canada,KGZ,Kyrgyzstan,2012,0,278,-278
CAN,Canada,KGZ,Kyrgyzstan,2013,0,123,-123
CAN,Canada,KGZ,Kyrgyzstan,2014,0,126,-126
CAN,Canada,KGZ,Kyrgyzstan,2015,0,132,-132
CAN,Canada,KGZ,Kyrgyzstan,2016,0,250,-250
CAN,Canada,KGZ,Kyrgyzstan,2017,0,135,-135
CZE,Czech Republic,KGZ,Kyrgyzstan,2008,1,81,-80
CZE,Czech Republic,KGZ,Kyrgyzstan,2009,0,84,-84
CZE,Czech Republic,KGZ,Kyrgyzstan,2010,1,64,-63
CZE,Czech Republic,KGZ,Kyrgyzstan,2011,1,48,-47
CZE,Czech Republic,KGZ,Kyrgyzstan,2012,35,68,-33
CZE,Czech Republic,KGZ,Kyrgyzstan,2013,78,51,27
CZE,Czech Republic,KGZ,Kyrgyzstan,2014,31,77,-46
CZE,Czech Republic,KGZ,Kyrgyzstan,2015,48,44,4
CZE,Czech Republic,KGZ,Kyrgyzstan,2016,22,70,-48
CZE,Czech Republic,KGZ,Kyrgyzstan,2017,32,125,-93
DNK,Denmark,KGZ,Kyrgyzstan,2008,1,5,-4
DNK,Denmark,KGZ,Kyrgyzstan,2009,3,3,0
DNK,Denmark,KGZ,Kyrgyzstan,2010,1,4,-3
DNK,Denmark,KGZ,Kyrgyzstan,2011,1,5,-4
DNK,Denmark,KGZ,Kyrgyzstan,2012,3,6,-3
DNK,Denmark,KGZ,Kyrgyzstan,2013,1,2,-1
DNK,Denmark,KGZ,Kyrgyzstan,2014,1,4,-3
DNK,Denmark,KGZ,Kyrgyzstan,2015,1,3,-2
DNK,Denmark,KGZ,Kyrgyzstan,2016,5,9,-4
DNK,Denmark,KGZ,Kyrgyzstan,2017,1,1,0
FIN,Finland,KGZ,Kyrgyzstan,2008,2,20,-18
FIN,Finland,KGZ,Kyrgyzstan,2009,2,18,-16
FIN,Finland,KGZ,Kyrgyzstan,2010,1,19,-18
FIN,Finland,KGZ,Kyrgyzstan,2011,1,6,-5
FIN,Finland,KGZ,Kyrgyzstan,2012,3,10,-7
FIN,Finland,KGZ,Kyrgyzstan,2013,0,6,-6
FIN,Finland,KGZ,Kyrgyzstan,2014,1,5,-4
FIN,Finland,KGZ,Kyrgyzstan,2015,1,15,-14
FIN,Finland,KGZ,Kyrgyzstan,2016,4,1,3
FIN,Finland,KGZ,Kyrgyzstan,2017,1,24,-23
FRA,France,KGZ,Kyrgyzstan,2008,0,58,-58
FRA,France,KGZ,Kyrgyzstan,2009,0,53,-53
FRA,France,KGZ,Kyrgyzstan,2010,0,47,-47
FRA,France,KGZ,Kyrgyzstan,2011,0,49,-49
FRA,France,KGZ,Kyrgyzstan,2012,0,57,-57
FRA,France,KGZ,Kyrgyzstan,2013,0,78,-78
FRA,France,KGZ,Kyrgyzstan,2014,0,70,-70
FRA,France,KGZ,Kyrgyzstan,2015,0,57,-57
FRA,France,KGZ,Kyrgyzstan,2016,0,63,-63
FRA,France,KGZ,Kyrgyzstan,2017,0,63,-63
DEU,Germany,KGZ,Kyrgyzstan,2008,673,708,-35
DEU,Germany,KGZ,Kyrgyzstan,2009,591,599,-8
DEU,Germany,KGZ,Kyrgyzstan,2010,399,620,-221
DEU,Germany,KGZ,Kyrgyzstan,2011,391,707,-316
DEU,Germany,KGZ,Kyrgyzstan,2012,465,613,-148
DEU,Germany,KGZ,Kyrgyzstan,2013,200,622,-422
DEU,Germany,KGZ,Kyrgyzstan,2014,422,618,-196
DEU,Germany,KGZ,Kyrgyzstan,2015,453,660,-207
DEU,Germany,KGZ,Kyrgyzstan,2016,437,639,-202
DEU,Germany,KGZ,Kyrgyzstan,2017,442,839,-397
HUN,Hungary,KGZ,Kyrgyzstan,2008,0,17,-17
HUN,Hungary,KGZ,Kyrgyzstan,2009,0,10,-10
HUN,Hungary,KGZ,Kyrgyzstan,2010,0,18,-18
HUN,Hungary,KGZ,Kyrgyzstan,2011,0,23,-23
HUN,Hungary,KGZ,Kyrgyzstan,2012,0,16,-16
HUN,Hungary,KGZ,Kyrgyzstan,2013,0,7,-7
HUN,Hungary,KGZ,Kyrgyzstan,2014,1,23,-22
HUN,Hungary,KGZ,Kyrgyzstan,2015,1,26,-25
HUN,Hungary,KGZ,Kyrgyzstan,2016,0,15,-15
HUN,Hungary,KGZ,Kyrgyzstan,2017,0,47,-47
ISL,Iceland,KGZ,Kyrgyzstan,2008,0,1,-1
ISL,Iceland,KGZ,Kyrgyzstan,2009,0,0,0
ISL,Iceland,KGZ,Kyrgyzstan,2010,1,1,0
ISL,Iceland,KGZ,Kyrgyzstan,2011,1,0,1
ISL,Iceland,KGZ,Kyrgyzstan,2012,0,0,0
ISL,Iceland,KGZ,Kyrgyzstan,2013,2,2,0
ISL,Iceland,KGZ,Kyrgyzstan,2014,0,0,0
ISL,Iceland,KGZ,Kyrgyzstan,2015,2,2,0
ISL,Iceland,KGZ,Kyrgyzstan,2016,1,1,0
ISL,Iceland,KGZ,Kyrgyzstan,2017,0,0,0
ITA,Italy,KGZ,Kyrgyzstan,2008,3,96,-93
ITA,Italy,KGZ,Kyrgyzstan,2009,4,110,-106
ITA,Italy,KGZ,Kyrgyzstan,2010,1,281,-280
ITA,Italy,KGZ,Kyrgyzstan,2011,0,177,-177
ITA,Italy,KGZ,Kyrgyzstan,2012,11,172,-161
ITA,Italy,KGZ,Kyrgyzstan,2013,5,161,-156
ITA,Italy,KGZ,Kyrgyzstan,2014,5,75,-70
ITA,Italy,KGZ,Kyrgyzstan,2015,6,100,-94
ITA,Italy,KGZ,Kyrgyzstan,2016,0,84,-84
ITA,Italy,KGZ,Kyrgyzstan,2017,18,133,-115
JPN,Japan,KGZ,Kyrgyzstan,2008,204,250,-46
JPN,Japan,KGZ,Kyrgyzstan,2009,216,227,-11
JPN,Japan,KGZ,Kyrgyzstan,2010,156,171,-15
JPN,Japan,KGZ,Kyrgyzstan,2011,174,185,-11
JPN,Japan,KGZ,Kyrgyzstan,2012,171,206,-35
JPN,Japan,KGZ,Kyrgyzstan,2013,205,248,-43
JPN,Japan,KGZ,Kyrgyzstan,2014,217,269,-52
JPN,Japan,KGZ,Kyrgyzstan,2015,221,299,-78
JPN,Japan,KGZ,Kyrgyzstan,2016,265,324,-59
JPN,Japan,KGZ,Kyrgyzstan,2017,268,336,-68
KOR,Korea,KGZ,Kyrgyzstan,2008,998,874,124
KOR,Korea,KGZ,Kyrgyzstan,2009,714,585,129
KOR,Korea,KGZ,Kyrgyzstan,2010,607,817,-210
KOR,Korea,KGZ,Kyrgyzstan,2011,626,656,-30
KOR,Korea,KGZ,Kyrgyzstan,2012,636,772,-136
KOR,Korea,KGZ,Kyrgyzstan,2013,765,897,-132
KOR,Korea,KGZ,Kyrgyzstan,2014,787,1003,-216
KOR,Korea,KGZ,Kyrgyzstan,2015,813,1385,-572
KOR,Korea,KGZ,Kyrgyzstan,2016,1053,1759,-706
KOR,Korea,KGZ,Kyrgyzstan,2017,1238,1688,-450
LUX,Luxembourg,KGZ,Kyrgyzstan,2008,0,0,0
LUX,Luxembourg,KGZ,Kyrgyzstan,2009,0,2,-2
LUX,Luxembourg,KGZ,Kyrgyzstan,2010,0,1,-1
LUX,Luxembourg,KGZ,Kyrgyzstan,2011,1,2,-1
LUX,Luxembourg,KGZ,Kyrgyzstan,2012,1,1,0
LUX,Luxembourg,KGZ,Kyrgyzstan,2013,3,1,2
LUX,Luxembourg,KGZ,Kyrgyzstan,2014,2,4,-2
LUX,Luxembourg,KGZ,Kyrgyzstan,2015,3,2,1
LUX,Luxembourg,KGZ,Kyrgyzstan,2016,2,4,-2
LUX,Luxembourg,KGZ,Kyrgyzstan,2017,1,4,-3
MEX,Mexico,KGZ,Kyrgyzstan,2008,0,2,-2
MEX,Mexico,KGZ,Kyrgyzstan,2009,0,2,-2
MEX,Mexico,KGZ,Kyrgyzstan,2010,0,2,-2
MEX,Mexico,KGZ,Kyrgyzstan,2011,0,1,-1
MEX,Mexico,KGZ,Kyrgyzstan,2012,0,0,0
MEX,Mexico,KGZ,Kyrgyzstan,2013,0,3,-3
MEX,Mexico,KGZ,Kyrgyzstan,2014,0,2,-2
MEX,Mexico,KGZ,Kyrgyzstan,2017,0,1,-1
NLD,Netherlands,KGZ,Kyrgyzstan,2009,7,16,-9
NLD,Netherlands,KGZ,Kyrgyzstan,2010,6,10,-4
NLD,Netherlands,KGZ,Kyrgyzstan,2013,6,25,-19
NLD,Netherlands,KGZ,Kyrgyzstan,2014,11,21,-10
NLD,Netherlands,KGZ,Kyrgyzstan,2015,13,32,-19
NLD,Netherlands,KGZ,Kyrgyzstan,2016,20,17,3
NLD,Netherlands,KGZ,Kyrgyzstan,2017,12,24,-12
NZL,New Zealand,KGZ,Kyrgyzstan,2008,0,4,-4
NZL,New Zealand,KGZ,Kyrgyzstan,2009,1,1,0
NZL,New Zealand,KGZ,Kyrgyzstan,2010,0,2,-2
NZL,New Zealand,KGZ,Kyrgyzstan,2011,0,7,-7
NZL,New Zealand,KGZ,Kyrgyzstan,2012,1,2,-1
NZL,New Zealand,KGZ,Kyrgyzstan,2013,1,8,-7
NZL,New Zealand,KGZ,Kyrgyzstan,2014,0,4,-4
NZL,New Zealand,KGZ,Kyrgyzstan,2015,4,2,2
NZL,New Zealand,KGZ,Kyrgyzstan,2016,0,5,-5
NZL,New Zealand,KGZ,Kyrgyzstan,2017,0,13,-13
NOR,Norway,KGZ,Kyrgyzstan,2008,3,16,-13
NOR,Norway,KGZ,Kyrgyzstan,2009,1,9,-8
NOR,Norway,KGZ,Kyrgyzstan,2010,0,12,-12
NOR,Norway,KGZ,Kyrgyzstan,2011,2,8,-6
NOR,Norway,KGZ,Kyrgyzstan,2012,10,15,-5
NOR,Norway,KGZ,Kyrgyzstan,2013,9,33,-24
NOR,Norway,KGZ,Kyrgyzstan,2014,22,18,4
NOR,Norway,KGZ,Kyrgyzstan,2015,4,19,-15
NOR,Norway,KGZ,Kyrgyzstan,2016,7,18,-11
NOR,Norway,KGZ,Kyrgyzstan,2017,4,13,-9
POL,Poland,KGZ,Kyrgyzstan,2008,0,30,-30
POL,Poland,KGZ,Kyrgyzstan,2009,0,37,-37
POL,Poland,KGZ,Kyrgyzstan,2010,0,45,-45
POL,Poland,KGZ,Kyrgyzstan,2011,0,42,-42
POL,Poland,KGZ,Kyrgyzstan,2012,0,28,-28
POL,Poland,KGZ,Kyrgyzstan,2013,0,34,-34
POL,Poland,KGZ,Kyrgyzstan,2014,0,24,-24
POL,Poland,KGZ,Kyrgyzstan,2015,0,69,-69
POL,Poland,KGZ,Kyrgyzstan,2016,0,119,-119
POL,Poland,KGZ,Kyrgyzstan,2017,0,168,-168
SVK,Slovak Republic,KGZ,Kyrgyzstan,2008,5,15,-10
SVK,Slovak Republic,KGZ,Kyrgyzstan,2009,5,13,-8
SVK,Slovak Republic,KGZ,Kyrgyzstan,2010,0,7,-7
SVK,Slovak Republic,KGZ,Kyrgyzstan,2011,1,2,-1
SVK,Slovak Republic,KGZ,Kyrgyzstan,2016,0,2,-2
ESP,Spain,KGZ,Kyrgyzstan,2008,12,38,-26
ESP,Spain,KGZ,Kyrgyzstan,2009,12,38,-26
ESP,Spain,KGZ,Kyrgyzstan,2010,18,40,-22
ESP,Spain,KGZ,Kyrgyzstan,2011,15,24,-9
ESP,Spain,KGZ,Kyrgyzstan,2012,6,23,-17
ESP,Spain,KGZ,Kyrgyzstan,2013,12,33,-21
ESP,Spain,KGZ,Kyrgyzstan,2014,1,41,-40
ESP,Spain,KGZ,Kyrgyzstan,2015,15,32,-17
ESP,Spain,KGZ,Kyrgyzstan,2016,9,35,-26
ESP,Spain,KGZ,Kyrgyzstan,2017,34,51,-17
SWE,Sweden,KGZ,Kyrgyzstan,2008,3,41,-38
SWE,Sweden,KGZ,Kyrgyzstan,2009,2,47,-45
SWE,Sweden,KGZ,Kyrgyzstan,2010,4,50,-46
SWE,Sweden,KGZ,Kyrgyzstan,2011,11,97,-86
SWE,Sweden,KGZ,Kyrgyzstan,2012,12,127,-115
SWE,Sweden,KGZ,Kyrgyzstan,2013,9,129,-120
SWE,Sweden,KGZ,Kyrgyzstan,2014,24,84,-60
SWE,Sweden,KGZ,Kyrgyzstan,2015,24,75,-51
SWE,Sweden,KGZ,Kyrgyzstan,2016,14,63,-49
SWE,Sweden,KGZ,Kyrgyzstan,2017,7,86,-79
CHE,Switzerland,KGZ,Kyrgyzstan,2010,13,18,-5
CHE,Switzerland,KGZ,Kyrgyzstan,2011,8,28,-20
CHE,Switzerland,KGZ,Kyrgyzstan,2012,11,13,-2
CHE,Switzerland,KGZ,Kyrgyzstan,2013,7,20,-13
CHE,Switzerland,KGZ,Kyrgyzstan,2014,7,34,-27
CHE,Switzerland,KGZ,Kyrgyzstan,2015,11,29,-18
CHE,Switzerland,KGZ,Kyrgyzstan,2016,11,22,-11
CHE,Switzerland,KGZ,Kyrgyzstan,2017,12,24,-12
TUR,Turkey,KGZ,Kyrgyzstan,2010,0,1046,-1046
TUR,Turkey,KGZ,Kyrgyzstan,2016,2745,6012,-3267
TUR,Turkey,KGZ,Kyrgyzstan,2017,4596,8982,-4386
USA,United States,KGZ,Kyrgyzstan,2008,0,632,-632
USA,United States,KGZ,Kyrgyzstan,2009,0,574,-574
USA,United States,KGZ,Kyrgyzstan,2010,0,507,-507
USA,United States,KGZ,Kyrgyzstan,2011,0,542,-542
USA,United States,KGZ,Kyrgyzstan,2012,0,648,-648
USA,United States,KGZ,Kyrgyzstan,2013,0,652,-652
USA,United States,KGZ,Kyrgyzstan,2014,0,707,-707
USA,United States,KGZ,Kyrgyzstan,2015,0,790,-790
USA,United States,KGZ,Kyrgyzstan,2016,0,847,-847
USA,United States,KGZ,Kyrgyzstan,2017,0,715,-715
CHL,Chile,KGZ,Kyrgyzstan,2008,0,1,-1
CHL,Chile,KGZ,Kyrgyzstan,2009,0,0,0
CHL,Chile,KGZ,Kyrgyzstan,2010,0,0,0
CHL,Chile,KGZ,Kyrgyzstan,2011,0,3,-3
CHL,Chile,KGZ,Kyrgyzstan,2012,0,0,0
CHL,Chile,KGZ,Kyrgyzstan,2013,0,0,0
CHL,Chile,KGZ,Kyrgyzstan,2014,0,0,0
CHL,Chile,KGZ,Kyrgyzstan,2015,0,0,0
CHL,Chile,KGZ,Kyrgyzstan,2016,0,0,0
EST,Estonia,KGZ,Kyrgyzstan,2008,0,3,-3
EST,Estonia,KGZ,Kyrgyzstan,2009,0,1,-1
EST,Estonia,KGZ,Kyrgyzstan,2010,0,0,0
EST,Estonia,KGZ,Kyrgyzstan,2011,0,3,-3
EST,Estonia,KGZ,Kyrgyzstan,2012,0,1,-1
EST,Estonia,KGZ,Kyrgyzstan,2013,0,0,0
EST,Estonia,KGZ,Kyrgyzstan,2014,0,0,0
EST,Estonia,KGZ,Kyrgyzstan,2015,0,5,-5
EST,Estonia,KGZ,Kyrgyzstan,2016,0,5,-5
EST,Estonia,KGZ,Kyrgyzstan,2017,0,6,-6
SVN,Slovenia,KGZ,Kyrgyzstan,2008,0,2,-2
SVN,Slovenia,KGZ,Kyrgyzstan,2009,0,1,-1
SVN,Slovenia,KGZ,Kyrgyzstan,2010,0,1,-1
SVN,Slovenia,KGZ,Kyrgyzstan,2012,0,6,-6
SVN,Slovenia,KGZ,Kyrgyzstan,2013,0,3,-3
SVN,Slovenia,KGZ,Kyrgyzstan,2014,0,3,-3
SVN,Slovenia,KGZ,Kyrgyzstan,2015,0,1,-1
SVN,Slovenia,KGZ,Kyrgyzstan,2016,0,1,-1
SVN,Slovenia,KGZ,Kyrgyzstan,2017,0,2,-2
AUS,Australia,LAO,Laos,2008,49,91,-42
AUS,Australia,LAO,Laos,2009,36,86,-50
AUS,Australia,LAO,Laos,2010,43,69,-26
AUS,Australia,LAO,Laos,2011,46,302,-256
AUS,Australia,LAO,Laos,2012,39,142,-103
AUS,Australia,LAO,Laos,2013,46,79,-33
AUS,Australia,LAO,Laos,2014,34,88,-54
AUS,Australia,LAO,Laos,2015,0,61,-61
AUS,Australia,LAO,Laos,2016,0,85,-85
AUS,Australia,LAO,Laos,2017,0,55,-55
AUT,Austria,LAO,Laos,2008,1,2,-1
AUT,Austria,LAO,Laos,2009,1,2,-1
AUT,Austria,LAO,Laos,2010,3,6,-3
AUT,Austria,LAO,Laos,2011,4,2,2
AUT,Austria,LAO,Laos,2012,2,5,-3
AUT,Austria,LAO,Laos,2013,4,3,1
AUT,Austria,LAO,Laos,2014,0,3,-3
AUT,Austria,LAO,Laos,2015,4,5,-1
AUT,Austria,LAO,Laos,2016,2,4,-2
AUT,Austria,LAO,Laos,2017,0,4,-4
BEL,Belgium,LAO,Laos,2008,0,15,-15
BEL,Belgium,LAO,Laos,2009,0,14,-14
BEL,Belgium,LAO,Laos,2010,4,9,-5
BEL,Belgium,LAO,Laos,2012,9,13,-4
BEL,Belgium,LAO,Laos,2013,5,10,-5
BEL,Belgium,LAO,Laos,2014,3,6,-3
BEL,Belgium,LAO,Laos,2015,2,9,-7
BEL,Belgium,LAO,Laos,2016,4,9,-5
BEL,Belgium,LAO,Laos,2017,3,6,-3
CAN,Canada,LAO,Laos,2008,0,32,-32
CAN,Canada,LAO,Laos,2009,0,39,-39
CAN,Canada,LAO,Laos,2010,0,54,-54
CAN,Canada,LAO,Laos,2011,0,22,-22
CAN,Canada,LAO,Laos,2012,0,25,-25
CAN,Canada,LAO,Laos,2013,0,15,-15
CAN,Canada,LAO,Laos,2014,0,28,-28
CAN,Canada,LAO,Laos,2015,0,19,-19
CAN,Canada,LAO,Laos,2016,0,20,-20
CAN,Canada,LAO,Laos,2017,0,25,-25
CZE,Czech Republic,LAO,Laos,2008,0,2,-2
CZE,Czech Republic,LAO,Laos,2009,0,6,-6
CZE,Czech Republic,LAO,Laos,2010,0,1,-1
CZE,Czech Republic,LAO,Laos,2012,1,7,-6
CZE,Czech Republic,LAO,Laos,2013,2,1,1
DNK,Denmark,LAO,Laos,2008,0,2,-2
DNK,Denmark,LAO,Laos,2009,7,2,5
DNK,Denmark,LAO,Laos,2010,0,1,-1
DNK,Denmark,LAO,Laos,2012,0,4,-4
DNK,Denmark,LAO,Laos,2013,1,4,-3
DNK,Denmark,LAO,Laos,2014,2,6,-4
DNK,Denmark,LAO,Laos,2015,0,0,0
DNK,Denmark,LAO,Laos,2016,2,3,-1
DNK,Denmark,LAO,Laos,2017,2,1,1
FIN,Finland,LAO,Laos,2008,0,3,-3
FIN,Finland,LAO,Laos,2009,0,4,-4
FIN,Finland,LAO,Laos,2010,0,3,-3
FIN,Finland,LAO,Laos,2011,0,5,-5
FIN,Finland,LAO,Laos,2012,0,4,-4
FIN,Finland,LAO,Laos,2013,0,6,-6
FIN,Finland,LAO,Laos,2014,0,4,-4
FIN,Finland,LAO,Laos,2015,0,2,-2
FIN,Finland,LAO,Laos,2016,0,2,-2
FIN,Finland,LAO,Laos,2017,0,5,-5
FRA,France,LAO,Laos,2008,0,118,-118
FRA,France,LAO,Laos,2009,0,115,-115
FRA,France,LAO,Laos,2010,0,90,-90
FRA,France,LAO,Laos,2011,0,107,-107
FRA,France,LAO,Laos,2012,0,120,-120
FRA,France,LAO,Laos,2013,0,139,-139
FRA,France,LAO,Laos,2014,0,123,-123
FRA,France,LAO,Laos,2015,0,105,-105
FRA,France,LAO,Laos,2016,0,100,-100
FRA,France,LAO,Laos,2017,0,106,-106
DEU,Germany,LAO,Laos,2008,43,28,15
DEU,Germany,LAO,Laos,2009,45,56,-11
DEU,Germany,LAO,Laos,2010,52,51,1
DEU,Germany,LAO,Laos,2011,27,62,-35
DEU,Germany,LAO,Laos,2012,35,58,-23
DEU,Germany,LAO,Laos,2013,53,41,12
DEU,Germany,LAO,Laos,2014,21,42,-21
DEU,Germany,LAO,Laos,2015,37,52,-15
DEU,Germany,LAO,Laos,2016,23,43,-20
DEU,Germany,LAO,Laos,2017,20,34,-14
HUN,Hungary,LAO,Laos,2008,0,1,-1
HUN,Hungary,LAO,Laos,2009,0,1,-1
HUN,Hungary,LAO,Laos,2010,0,1,-1
HUN,Hungary,LAO,Laos,2011,0,2,-2
HUN,Hungary,LAO,Laos,2012,0,1,-1
HUN,Hungary,LAO,Laos,2013,0,1,-1
HUN,Hungary,LAO,Laos,2014,0,11,-11
HUN,Hungary,LAO,Laos,2015,0,14,-14
HUN,Hungary,LAO,Laos,2016,1,11,-10
HUN,Hungary,LAO,Laos,2017,0,25,-25
ISL,Iceland,LAO,Laos,2008,0,1,-1
ISL,Iceland,LAO,Laos,2009,1,0,1
ISL,Iceland,LAO,Laos,2010,0,0,0
ISL,Iceland,LAO,Laos,2011,0,0,0
ISL,Iceland,LAO,Laos,2012,0,0,0
ISL,Iceland,LAO,Laos,2014,0,1,-1
ISL,Iceland,LAO,Laos,2016,0,0,0
ISL,Iceland,LAO,Laos,2017,0,0,0
ITA,Italy,LAO,Laos,2008,3,8,-5
ITA,Italy,LAO,Laos,2009,4,5,-1
ITA,Italy,LAO,Laos,2010,0,1,-1
ITA,Italy,LAO,Laos,2011,1,3,-2
ITA,Italy,LAO,Laos,2012,0,13,-13
ITA,Italy,LAO,Laos,2013,1,6,-5
ITA,Italy,LAO,Laos,2014,1,5,-4
ITA,Italy,LAO,Laos,2015,1,4,-3
ITA,Italy,LAO,Laos,2016,0,6,-6
ITA,Italy,LAO,Laos,2017,0,1,-1
JPN,Japan,LAO,Laos,2008,722,859,-137
JPN,Japan,LAO,Laos,2009,747,858,-111
JPN,Japan,LAO,Laos,2010,812,855,-43
JPN,Japan,LAO,Laos,2011,744,764,-20
JPN,Japan,LAO,Laos,2012,773,847,-74
JPN,Japan,LAO,Laos,2013,791,895,-104
JPN,Japan,LAO,Laos,2014,662,733,-71
JPN,Japan,LAO,Laos,2015,1068,1154,-86
JPN,Japan,LAO,Laos,2016,1058,1203,-145
JPN,Japan,LAO,Laos,2017,1182,1316,-134
KOR,Korea,LAO,Laos,2008,53,65,-12
KOR,Korea,LAO,Laos,2009,39,65,-26
KOR,Korea,LAO,Laos,2010,56,117,-61
KOR,Korea,LAO,Laos,2011,98,242,-144
KOR,Korea,LAO,Laos,2012,123,231,-108
KOR,Korea,LAO,Laos,2013,141,271,-130
KOR,Korea,LAO,Laos,2014,152,267,-115
KOR,Korea,LAO,Laos,2015,200,225,-25
KOR,Korea,LAO,Laos,2016,155,216,-61
KOR,Korea,LAO,Laos,2017,201,252,-51
LUX,Luxembourg,LAO,Laos,2008,0,1,-1
LUX,Luxembourg,LAO,Laos,2009,0,2,-2
LUX,Luxembourg,LAO,Laos,2010,0,0,0
LUX,Luxembourg,LAO,Laos,2011,0,0,0
LUX,Luxembourg,LAO,Laos,2012,2,2,0
LUX,Luxembourg,LAO,Laos,2013,1,5,-4
LUX,Luxembourg,LAO,Laos,2014,5,4,1
LUX,Luxembourg,LAO,Laos,2015,4,2,2
LUX,Luxembourg,LAO,Laos,2016,1,0,1
LUX,Luxembourg,LAO,Laos,2017,0,1,-1
MEX,Mexico,LAO,Laos,2012,0,0,0
MEX,Mexico,LAO,Laos,2013,0,0,0
MEX,Mexico,LAO,Laos,2014,0,0,0
NLD,Netherlands,LAO,Laos,2008,2,7,-5
NLD,Netherlands,LAO,Laos,2009,0,8,-8
NLD,Netherlands,LAO,Laos,2010,4,7,-3
NLD,Netherlands,LAO,Laos,2011,1,4,-3
NLD,Netherlands,LAO,Laos,2012,1,7,-6
NLD,Netherlands,LAO,Laos,2013,2,5,-3
NLD,Netherlands,LAO,Laos,2014,2,4,-2
NLD,Netherlands,LAO,Laos,2015,2,3,-1
NLD,Netherlands,LAO,Laos,2016,1,6,-5
NLD,Netherlands,LAO,Laos,2017,1,4,-3
NZL,New Zealand,LAO,Laos,2008,3,33,-30
NZL,New Zealand,LAO,Laos,2009,19,22,-3
NZL,New Zealand,LAO,Laos,2010,24,21,3
NZL,New Zealand,LAO,Laos,2011,9,19,-10
NZL,New Zealand,LAO,Laos,2012,22,36,-14
NZL,New Zealand,LAO,Laos,2013,12,52,-40
NZL,New Zealand,LAO,Laos,2014,27,55,-28
NZL,New Zealand,LAO,Laos,2015,19,62,-43
NZL,New Zealand,LAO,Laos,2016,26,39,-13
NZL,New Zealand,LAO,Laos,2017,21,70,-49
NOR,Norway,LAO,Laos,2008,4,11,-7
NOR,Norway,LAO,Laos,2009,5,8,-3
NOR,Norway,LAO,Laos,2010,2,6,-4
NOR,Norway,LAO,Laos,2011,5,9,-4
NOR,Norway,LAO,Laos,2012,3,9,-6
NOR,Norway,LAO,Laos,2013,2,2,0
NOR,Norway,LAO,Laos,2014,2,3,-1
NOR,Norway,LAO,Laos,2015,3,3,0
NOR,Norway,LAO,Laos,2016,0,7,-7
NOR,Norway,LAO,Laos,2017,1,8,-7
POL,Poland,LAO,Laos,2009,0,3,-3
POL,Poland,LAO,Laos,2010,0,4,-4
POL,Poland,LAO,Laos,2011,0,1,-1
POL,Poland,LAO,Laos,2012,0,3,-3
POL,Poland,LAO,Laos,2013,0,1,-1
POL,Poland,LAO,Laos,2014,0,1,-1
POL,Poland,LAO,Laos,2015,0,3,-3
POL,Poland,LAO,Laos,2016,0,1,-1
POL,Poland,LAO,Laos,2017,0,1,-1
SVK,Slovak Republic,LAO,Laos,2008,1,1,0
SVK,Slovak Republic,LAO,Laos,2009,0,6,-6
SVK,Slovak Republic,LAO,Laos,2011,4,3,1
SVK,Slovak Republic,LAO,Laos,2012,0,1,-1
ESP,Spain,LAO,Laos,2008,0,5,-5
ESP,Spain,LAO,Laos,2009,2,0,2
ESP,Spain,LAO,Laos,2010,0,0,0
ESP,Spain,LAO,Laos,2011,1,3,-2
ESP,Spain,LAO,Laos,2012,1,2,-1
ESP,Spain,LAO,Laos,2013,0,1,-1
ESP,Spain,LAO,Laos,2014,1,4,-3
ESP,Spain,LAO,Laos,2015,0,5,-5
ESP,Spain,LAO,Laos,2016,0,7,-7
ESP,Spain,LAO,Laos,2017,0,2,-2
SWE,Sweden,LAO,Laos,2008,6,18,-12
SWE,Sweden,LAO,Laos,2009,2,9,-7
SWE,Sweden,LAO,Laos,2010,2,17,-15
SWE,Sweden,LAO,Laos,2011,2,14,-12
SWE,Sweden,LAO,Laos,2012,5,12,-7
SWE,Sweden,LAO,Laos,2013,3,10,-7
SWE,Sweden,LAO,Laos,2014,3,8,-5
SWE,Sweden,LAO,Laos,2015,15,9,6
SWE,Sweden,LAO,Laos,2016,0,8,-8
SWE,Sweden,LAO,Laos,2017,2,8,-6
CHE,Switzerland,LAO,Laos,2010,2,15,-13
CHE,Switzerland,LAO,Laos,2011,9,6,3
CHE,Switzerland,LAO,Laos,2012,2,5,-3
CHE,Switzerland,LAO,Laos,2013,5,12,-7
CHE,Switzerland,LAO,Laos,2014,5,13,-8
CHE,Switzerland,LAO,Laos,2015,4,8,-4
CHE,Switzerland,LAO,Laos,2016,6,12,-6
CHE,Switzerland,LAO,Laos,2017,7,26,-19
USA,United States,LAO,Laos,2008,0,2198,-2198
USA,United States,LAO,Laos,2009,0,1688,-1688
USA,United States,LAO,Laos,2010,0,1200,-1200
USA,United States,LAO,Laos,2011,0,956,-956
USA,United States,LAO,Laos,2012,0,949,-949
USA,United States,LAO,Laos,2013,0,923,-923
USA,United States,LAO,Laos,2014,0,806,-806
USA,United States,LAO,Laos,2015,0,917,-917
USA,United States,LAO,Laos,2016,0,856,-856
USA,United States,LAO,Laos,2017,0,685,-685
CHL,Chile,LAO,Laos,2008,0,0,0
CHL,Chile,LAO,Laos,2009,0,0,0
CHL,Chile,LAO,Laos,2010,0,0,0
CHL,Chile,LAO,Laos,2011,0,0,0
CHL,Chile,LAO,Laos,2012,0,0,0
CHL,Chile,LAO,Laos,2013,0,1,-1
CHL,Chile,LAO,Laos,2014,0,0,0
CHL,Chile,LAO,Laos,2015,0,0,0
CHL,Chile,LAO,Laos,2016,0,0,0
EST,Estonia,LAO,Laos,2008,0,1,-1
EST,Estonia,LAO,Laos,2009,0,0,0
EST,Estonia,LAO,Laos,2010,0,0,0
EST,Estonia,LAO,Laos,2011,0,0,0
EST,Estonia,LAO,Laos,2012,0,0,0
EST,Estonia,LAO,Laos,2013,0,0,0
EST,Estonia,LAO,Laos,2014,0,0,0
EST,Estonia,LAO,Laos,2015,0,0,0
EST,Estonia,LAO,Laos,2016,0,0,0
EST,Estonia,LAO,Laos,2017,0,0,0
SVN,Slovenia,LAO,Laos,2009,0,1,-1
SVN,Slovenia,LAO,Laos,2010,0,1,-1
SVN,Slovenia,LAO,Laos,2017,0,1,-1
AUS,Australia,LVA,Latvia,2011,0,44,-44
AUS,Australia,LVA,Latvia,2012,0,70,-70
AUS,Australia,LVA,Latvia,2013,0,47,-47
AUS,Australia,LVA,Latvia,2016,0,54,-54
AUT,Austria,LVA,Latvia,2011,0,303,-303
AUT,Austria,LVA,Latvia,2012,0,360,-360
AUT,Austria,LVA,Latvia,2013,0,286,-286
AUT,Austria,LVA,Latvia,2016,0,187,-187
BEL,Belgium,LVA,Latvia,2011,0,439,-439
BEL,Belgium,LVA,Latvia,2012,0,352,-352
BEL,Belgium,LVA,Latvia,2013,0,274,-274
BEL,Belgium,LVA,Latvia,2016,0,190,-190
CAN,Canada,LVA,Latvia,2011,0,103,-103
CAN,Canada,LVA,Latvia,2012,0,199,-199
CAN,Canada,LVA,Latvia,2013,0,215,-215
CAN,Canada,LVA,Latvia,2016,0,135,-135
CZE,Czech Republic,LVA,Latvia,2011,0,48,-48
CZE,Czech Republic,LVA,Latvia,2012,0,45,-45
CZE,Czech Republic,LVA,Latvia,2013,0,64,-64
CZE,Czech Republic,LVA,Latvia,2016,0,37,-37
DNK,Denmark,LVA,Latvia,2011,0,814,-814
DNK,Denmark,LVA,Latvia,2012,0,676,-676
DNK,Denmark,LVA,Latvia,2013,0,682,-682
DNK,Denmark,LVA,Latvia,2016,0,503,-503
FIN,Finland,LVA,Latvia,2011,0,219,-219
FIN,Finland,LVA,Latvia,2012,0,178,-178
FIN,Finland,LVA,Latvia,2013,0,198,-198
FIN,Finland,LVA,Latvia,2016,0,195,-195
FRA,France,LVA,Latvia,2011,0,0,0
FRA,France,LVA,Latvia,2012,0,0,0
FRA,France,LVA,Latvia,2013,0,337,-337
FRA,France,LVA,Latvia,2016,0,190,-190
DEU,Germany,LVA,Latvia,2011,0,10034,-10034
DEU,Germany,LVA,Latvia,2012,0,9212,-9212
DEU,Germany,LVA,Latvia,2016,0,6529,-6529
HUN,Hungary,LVA,Latvia,2011,0,21,-21
HUN,Hungary,LVA,Latvia,2012,0,23,-23
HUN,Hungary,LVA,Latvia,2013,0,27,-27
HUN,Hungary,LVA,Latvia,2016,0,13,-13
ISL,Iceland,LVA,Latvia,2011,0,95,-95
ISL,Iceland,LVA,Latvia,2012,0,59,-59
ISL,Iceland,LVA,Latvia,2013,0,91,-91
ISL,Iceland,LVA,Latvia,2016,0,155,-155
ITA,Italy,LVA,Latvia,2011,0,321,-321
ITA,Italy,LVA,Latvia,2012,0,272,-272
ITA,Italy,LVA,Latvia,2013,0,190,-190
ITA,Italy,LVA,Latvia,2016,0,171,-171
JPN,Japan,LVA,Latvia,2008,0,104,-104
JPN,Japan,LVA,Latvia,2009,0,71,-71
JPN,Japan,LVA,Latvia,2010,0,210,-210
JPN,Japan,LVA,Latvia,2011,0,49,-49
JPN,Japan,LVA,Latvia,2012,0,132,-132
JPN,Japan,LVA,Latvia,2013,0,54,-54
JPN,Japan,LVA,Latvia,2016,0,246,-246
KOR,Korea,LVA,Latvia,2011,0,10,-10
KOR,Korea,LVA,Latvia,2012,0,16,-16
KOR,Korea,LVA,Latvia,2013,0,10,-10
KOR,Korea,LVA,Latvia,2016,0,25,-25
LUX,Luxembourg,LVA,Latvia,2008,0,53,-53
LUX,Luxembourg,LVA,Latvia,2011,0,85,-85
LUX,Luxembourg,LVA,Latvia,2012,0,59,-59
LUX,Luxembourg,LVA,Latvia,2013,0,72,-72
LUX,Luxembourg,LVA,Latvia,2016,0,65,-65
MEX,Mexico,LVA,Latvia,2011,0,3,-3
MEX,Mexico,LVA,Latvia,2012,0,3,-3
MEX,Mexico,LVA,Latvia,2013,0,14,-14
MEX,Mexico,LVA,Latvia,2016,0,13,-13
NLD,Netherlands,LVA,Latvia,2011,0,1059,-1059
NLD,Netherlands,LVA,Latvia,2012,0,1181,-1181
NLD,Netherlands,LVA,Latvia,2013,0,918,-918
NLD,Netherlands,LVA,Latvia,2016,0,1009,-1009
NZL,New Zealand,LVA,Latvia,2008,0,6,-6
NZL,New Zealand,LVA,Latvia,2009,0,14,-14
NZL,New Zealand,LVA,Latvia,2010,0,25,-25
NZL,New Zealand,LVA,Latvia,2011,0,35,-35
NZL,New Zealand,LVA,Latvia,2012,0,46,-46
NZL,New Zealand,LVA,Latvia,2013,0,34,-34
NZL,New Zealand,LVA,Latvia,2016,0,77,-77
NOR,Norway,LVA,Latvia,2011,0,2116,-2116
NOR,Norway,LVA,Latvia,2012,0,1655,-1655
NOR,Norway,LVA,Latvia,2013,0,1349,-1349
NOR,Norway,LVA,Latvia,2016,0,711,-711
POL,Poland,LVA,Latvia,2011,0,79,-79
POL,Poland,LVA,Latvia,2012,0,83,-83
POL,Poland,LVA,Latvia,2016,0,89,-89
SVK,Slovak Republic,LVA,Latvia,2008,0,10,-10
SVK,Slovak Republic,LVA,Latvia,2009,0,11,-11
SVK,Slovak Republic,LVA,Latvia,2010,0,31,-31
SVK,Slovak Republic,LVA,Latvia,2011,0,15,-15
SVK,Slovak Republic,LVA,Latvia,2012,0,16,-16
SVK,Slovak Republic,LVA,Latvia,2013,0,9,-9
SVK,Slovak Republic,LVA,Latvia,2016,0,19,-19
ESP,Spain,LVA,Latvia,2011,0,556,-556
ESP,Spain,LVA,Latvia,2012,0,524,-524
ESP,Spain,LVA,Latvia,2013,0,454,-454
ESP,Spain,LVA,Latvia,2016,0,410,-410
SWE,Sweden,LVA,Latvia,2011,0,795,-795
SWE,Sweden,LVA,Latvia,2012,0,698,-698
SWE,Sweden,LVA,Latvia,2013,0,599,-599
SWE,Sweden,LVA,Latvia,2016,0,858,-858
CHE,Switzerland,LVA,Latvia,2011,0,322,-322
CHE,Switzerland,LVA,Latvia,2012,0,319,-319
CHE,Switzerland,LVA,Latvia,2013,0,266,-266
CHE,Switzerland,LVA,Latvia,2016,0,289,-289
GBR,United Kingdom,LVA,Latvia,2011,0,6000,-6000
GBR,United Kingdom,LVA,Latvia,2012,0,4000,-4000
GBR,United Kingdom,LVA,Latvia,2013,0,5000,-5000
USA,United States,LVA,Latvia,2011,0,426,-426
USA,United States,LVA,Latvia,2012,0,436,-436
USA,United States,LVA,Latvia,2013,0,424,-424
USA,United States,LVA,Latvia,2016,0,391,-391
CHL,Chile,LVA,Latvia,2008,0,2,-2
CHL,Chile,LVA,Latvia,2009,0,3,-3
CHL,Chile,LVA,Latvia,2010,0,2,-2
CHL,Chile,LVA,Latvia,2011,0,6,-6
CHL,Chile,LVA,Latvia,2012,0,6,-6
CHL,Chile,LVA,Latvia,2013,0,11,-11
CHL,Chile,LVA,Latvia,2016,0,2,-2
EST,Estonia,LVA,Latvia,2011,0,14,-14
EST,Estonia,LVA,Latvia,2012,0,13,-13
EST,Estonia,LVA,Latvia,2013,0,33,-33
EST,Estonia,LVA,Latvia,2016,0,429,-429
SVN,Slovenia,LVA,Latvia,2008,0,10,-10
SVN,Slovenia,LVA,Latvia,2009,0,19,-19
SVN,Slovenia,LVA,Latvia,2011,0,21,-21
SVN,Slovenia,LVA,Latvia,2012,0,26,-26
SVN,Slovenia,LVA,Latvia,2013,0,32,-32
SVN,Slovenia,LVA,Latvia,2016,0,25,-25
AUS,Australia,LBN,Lebanon,2008,636,1607,-971
AUS,Australia,LBN,Lebanon,2009,794,1407,-613
AUS,Australia,LBN,Lebanon,2010,736,1157,-421
AUS,Australia,LBN,Lebanon,2011,688,1042,-354
AUS,Australia,LBN,Lebanon,2012,522,1451,-929
AUS,Australia,LBN,Lebanon,2013,509,983,-474
AUS,Australia,LBN,Lebanon,2014,490,1128,-638
AUS,Australia,LBN,Lebanon,2015,500,1159,-659
AUS,Australia,LBN,Lebanon,2016,500,983,-483
AUS,Australia,LBN,Lebanon,2017,0,1169,-1169
AUT,Austria,LBN,Lebanon,2008,54,85,-31
AUT,Austria,LBN,Lebanon,2009,52,48,4
AUT,Austria,LBN,Lebanon,2010,58,54,4
AUT,Austria,LBN,Lebanon,2011,49,63,-14
AUT,Austria,LBN,Lebanon,2012,41,61,-20
AUT,Austria,LBN,Lebanon,2013,46,68,-22
AUT,Austria,LBN,Lebanon,2014,32,87,-55
AUT,Austria,LBN,Lebanon,2015,22,166,-144
AUT,Austria,LBN,Lebanon,2016,92,137,-45
AUT,Austria,LBN,Lebanon,2017,62,84,-22
BEL,Belgium,LBN,Lebanon,2008,0,227,-227
BEL,Belgium,LBN,Lebanon,2009,0,262,-262
BEL,Belgium,LBN,Lebanon,2010,52,230,-178
BEL,Belgium,LBN,Lebanon,2011,0,204,-204
BEL,Belgium,LBN,Lebanon,2012,118,229,-111
BEL,Belgium,LBN,Lebanon,2013,151,229,-78
BEL,Belgium,LBN,Lebanon,2014,125,241,-116
BEL,Belgium,LBN,Lebanon,2015,88,302,-214
BEL,Belgium,LBN,Lebanon,2016,83,300,-217
BEL,Belgium,LBN,Lebanon,2017,97,238,-141
CAN,Canada,LBN,Lebanon,2008,0,3563,-3563
CAN,Canada,LBN,Lebanon,2009,0,3078,-3078
CAN,Canada,LBN,Lebanon,2010,0,3432,-3432
CAN,Canada,LBN,Lebanon,2011,0,3070,-3070
CAN,Canada,LBN,Lebanon,2012,0,1614,-1614
CAN,Canada,LBN,Lebanon,2013,0,2175,-2175
CAN,Canada,LBN,Lebanon,2014,0,2224,-2224
CAN,Canada,LBN,Lebanon,2015,0,2135,-2135
CAN,Canada,LBN,Lebanon,2016,0,1935,-1935
CAN,Canada,LBN,Lebanon,2017,0,1365,-1365
CZE,Czech Republic,LBN,Lebanon,2008,2,17,-15
CZE,Czech Republic,LBN,Lebanon,2009,1,27,-26
CZE,Czech Republic,LBN,Lebanon,2010,3,16,-13
CZE,Czech Republic,LBN,Lebanon,2011,0,8,-8
CZE,Czech Republic,LBN,Lebanon,2012,6,16,-10
CZE,Czech Republic,LBN,Lebanon,2013,14,14,0
CZE,Czech Republic,LBN,Lebanon,2014,11,26,-15
CZE,Czech Republic,LBN,Lebanon,2015,15,20,-5
CZE,Czech Republic,LBN,Lebanon,2016,11,21,-10
CZE,Czech Republic,LBN,Lebanon,2017,13,35,-22
DNK,Denmark,LBN,Lebanon,2008,27,46,-19
DNK,Denmark,LBN,Lebanon,2009,30,68,-38
DNK,Denmark,LBN,Lebanon,2010,22,56,-34
DNK,Denmark,LBN,Lebanon,2011,31,37,-6
DNK,Denmark,LBN,Lebanon,2012,25,40,-15
DNK,Denmark,LBN,Lebanon,2013,19,56,-37
DNK,Denmark,LBN,Lebanon,2014,19,81,-62
DNK,Denmark,LBN,Lebanon,2015,17,58,-41
DNK,Denmark,LBN,Lebanon,2016,21,54,-33
DNK,Denmark,LBN,Lebanon,2017,48,63,-15
FIN,Finland,LBN,Lebanon,2008,3,23,-20
FIN,Finland,LBN,Lebanon,2009,3,11,-8
FIN,Finland,LBN,Lebanon,2010,2,7,-5
FIN,Finland,LBN,Lebanon,2011,2,10,-8
FIN,Finland,LBN,Lebanon,2012,1,16,-15
FIN,Finland,LBN,Lebanon,2013,2,8,-6
FIN,Finland,LBN,Lebanon,2014,3,12,-9
FIN,Finland,LBN,Lebanon,2015,2,18,-16
FIN,Finland,LBN,Lebanon,2016,3,21,-18
FIN,Finland,LBN,Lebanon,2017,7,23,-16
FRA,France,LBN,Lebanon,2008,0,1415,-1415
FRA,France,LBN,Lebanon,2009,0,1093,-1093
FRA,France,LBN,Lebanon,2010,0,962,-962
FRA,France,LBN,Lebanon,2011,0,993,-993
FRA,France,LBN,Lebanon,2012,0,1011,-1011
FRA,France,LBN,Lebanon,2013,0,939,-939
FRA,France,LBN,Lebanon,2014,0,1041,-1041
FRA,France,LBN,Lebanon,2015,0,643,-643
FRA,France,LBN,Lebanon,2016,0,651,-651
FRA,France,LBN,Lebanon,2017,0,666,-666
DEU,Germany,LBN,Lebanon,2008,1846,2340,-494
DEU,Germany,LBN,Lebanon,2009,2180,2310,-130
DEU,Germany,LBN,Lebanon,2010,1855,2118,-263
DEU,Germany,LBN,Lebanon,2011,1619,2139,-520
DEU,Germany,LBN,Lebanon,2012,1441,2135,-694
DEU,Germany,LBN,Lebanon,2013,1351,2114,-763
DEU,Germany,LBN,Lebanon,2014,1088,2498,-1410
DEU,Germany,LBN,Lebanon,2015,1188,5592,-4404
DEU,Germany,LBN,Lebanon,2016,2834,4885,-2051
DEU,Germany,LBN,Lebanon,2017,1930,2875,-945
HUN,Hungary,LBN,Lebanon,2008,2,16,-14
HUN,Hungary,LBN,Lebanon,2009,1,15,-14
HUN,Hungary,LBN,Lebanon,2010,3,17,-14
HUN,Hungary,LBN,Lebanon,2011,2,12,-10
HUN,Hungary,LBN,Lebanon,2012,2,13,-11
HUN,Hungary,LBN,Lebanon,2013,2,24,-22
HUN,Hungary,LBN,Lebanon,2014,4,29,-25
HUN,Hungary,LBN,Lebanon,2015,5,37,-32
HUN,Hungary,LBN,Lebanon,2016,3,39,-36
HUN,Hungary,LBN,Lebanon,2017,0,48,-48
ISL,Iceland,LBN,Lebanon,2008,3,4,-1
ISL,Iceland,LBN,Lebanon,2009,2,2,0
ISL,Iceland,LBN,Lebanon,2010,1,0,1
ISL,Iceland,LBN,Lebanon,2011,0,0,0
ISL,Iceland,LBN,Lebanon,2012,0,0,0
ISL,Iceland,LBN,Lebanon,2013,0,2,-2
ISL,Iceland,LBN,Lebanon,2014,1,1,0
ISL,Iceland,LBN,Lebanon,2015,0,2,-2
ISL,Iceland,LBN,Lebanon,2016,1,1,0
ISL,Iceland,LBN,Lebanon,2017,0,2,-2
ITA,Italy,LBN,Lebanon,2008,17,404,-387
ITA,Italy,LBN,Lebanon,2009,19,334,-315
ITA,Italy,LBN,Lebanon,2010,40,314,-274
ITA,Italy,LBN,Lebanon,2011,38,284,-246
ITA,Italy,LBN,Lebanon,2012,27,286,-259
ITA,Italy,LBN,Lebanon,2013,26,344,-318
ITA,Italy,LBN,Lebanon,2014,34,296,-262
ITA,Italy,LBN,Lebanon,2015,36,304,-268
ITA,Italy,LBN,Lebanon,2016,0,316,-316
ITA,Italy,LBN,Lebanon,2017,20,340,-320
JPN,Japan,LBN,Lebanon,2008,29,35,-6
JPN,Japan,LBN,Lebanon,2009,26,36,-10
JPN,Japan,LBN,Lebanon,2010,48,53,-5
JPN,Japan,LBN,Lebanon,2011,27,29,-2
JPN,Japan,LBN,Lebanon,2012,34,44,-10
JPN,Japan,LBN,Lebanon,2013,30,44,-14
JPN,Japan,LBN,Lebanon,2014,18,29,-11
JPN,Japan,LBN,Lebanon,2015,42,48,-6
JPN,Japan,LBN,Lebanon,2016,45,62,-17
JPN,Japan,LBN,Lebanon,2017,43,60,-17
KOR,Korea,LBN,Lebanon,2008,5,7,-2
KOR,Korea,LBN,Lebanon,2009,14,8,6
KOR,Korea,LBN,Lebanon,2010,8,10,-2
KOR,Korea,LBN,Lebanon,2011,15,12,3
KOR,Korea,LBN,Lebanon,2012,9,7,2
KOR,Korea,LBN,Lebanon,2013,7,12,-5
KOR,Korea,LBN,Lebanon,2014,16,12,4
KOR,Korea,LBN,Lebanon,2015,14,7,7
KOR,Korea,LBN,Lebanon,2016,6,12,-6
KOR,Korea,LBN,Lebanon,2017,10,7,3
LUX,Luxembourg,LBN,Lebanon,2008,4,7,-3
LUX,Luxembourg,LBN,Lebanon,2009,3,8,-5
LUX,Luxembourg,LBN,Lebanon,2010,2,0,2
LUX,Luxembourg,LBN,Lebanon,2011,0,9,-9
LUX,Luxembourg,LBN,Lebanon,2012,3,9,-6
LUX,Luxembourg,LBN,Lebanon,2013,4,15,-11
LUX,Luxembourg,LBN,Lebanon,2014,6,10,-4
LUX,Luxembourg,LBN,Lebanon,2015,4,16,-12
LUX,Luxembourg,LBN,Lebanon,2016,12,11,1
LUX,Luxembourg,LBN,Lebanon,2017,7,30,-23
MEX,Mexico,LBN,Lebanon,2008,0,28,-28
MEX,Mexico,LBN,Lebanon,2009,0,40,-40
MEX,Mexico,LBN,Lebanon,2010,0,52,-52
MEX,Mexico,LBN,Lebanon,2011,0,39,-39
MEX,Mexico,LBN,Lebanon,2012,0,18,-18
MEX,Mexico,LBN,Lebanon,2013,0,94,-94
MEX,Mexico,LBN,Lebanon,2014,0,27,-27
MEX,Mexico,LBN,Lebanon,2015,0,35,-35
MEX,Mexico,LBN,Lebanon,2016,0,30,-30
MEX,Mexico,LBN,Lebanon,2017,0,26,-26
NLD,Netherlands,LBN,Lebanon,2008,29,57,-28
NLD,Netherlands,LBN,Lebanon,2009,30,51,-21
NLD,Netherlands,LBN,Lebanon,2010,20,49,-29
NLD,Netherlands,LBN,Lebanon,2011,20,54,-34
NLD,Netherlands,LBN,Lebanon,2012,23,45,-22
NLD,Netherlands,LBN,Lebanon,2013,20,64,-44
NLD,Netherlands,LBN,Lebanon,2014,44,61,-17
NLD,Netherlands,LBN,Lebanon,2015,13,124,-111
NLD,Netherlands,LBN,Lebanon,2016,44,161,-117
NLD,Netherlands,LBN,Lebanon,2017,42,167,-125
NZL,New Zealand,LBN,Lebanon,2008,1,9,-8
NZL,New Zealand,LBN,Lebanon,2009,14,19,-5
NZL,New Zealand,LBN,Lebanon,2010,1,6,-5
NZL,New Zealand,LBN,Lebanon,2011,3,11,-8
NZL,New Zealand,LBN,Lebanon,2012,2,13,-11
NZL,New Zealand,LBN,Lebanon,2013,2,17,-15
NZL,New Zealand,LBN,Lebanon,2014,2,16,-14
NZL,New Zealand,LBN,Lebanon,2015,0,20,-20
NZL,New Zealand,LBN,Lebanon,2016,3,24,-21
NZL,New Zealand,LBN,Lebanon,2017,2,27,-25
NOR,Norway,LBN,Lebanon,2008,13,34,-21
NOR,Norway,LBN,Lebanon,2009,14,37,-23
NOR,Norway,LBN,Lebanon,2010,13,31,-18
NOR,Norway,LBN,Lebanon,2011,13,37,-24
NOR,Norway,LBN,Lebanon,2012,13,21,-8
NOR,Norway,LBN,Lebanon,2013,14,27,-13
NOR,Norway,LBN,Lebanon,2014,4,37,-33
NOR,Norway,LBN,Lebanon,2015,9,35,-26
NOR,Norway,LBN,Lebanon,2016,7,52,-45
NOR,Norway,LBN,Lebanon,2017,5,41,-36
POL,Poland,LBN,Lebanon,2008,0,48,-48
POL,Poland,LBN,Lebanon,2009,0,52,-52
POL,Poland,LBN,Lebanon,2010,0,51,-51
POL,Poland,LBN,Lebanon,2011,0,58,-58
POL,Poland,LBN,Lebanon,2012,0,70,-70
POL,Poland,LBN,Lebanon,2013,0,70,-70
POL,Poland,LBN,Lebanon,2014,0,27,-27
POL,Poland,LBN,Lebanon,2015,0,106,-106
POL,Poland,LBN,Lebanon,2016,0,110,-110
POL,Poland,LBN,Lebanon,2017,0,145,-145
SVK,Slovak Republic,LBN,Lebanon,2008,3,4,-1
SVK,Slovak Republic,LBN,Lebanon,2009,5,4,1
SVK,Slovak Republic,LBN,Lebanon,2010,3,5,-2
SVK,Slovak Republic,LBN,Lebanon,2011,1,5,-4
SVK,Slovak Republic,LBN,Lebanon,2012,0,1,-1
SVK,Slovak Republic,LBN,Lebanon,2013,0,6,-6
SVK,Slovak Republic,LBN,Lebanon,2014,0,6,-6
SVK,Slovak Republic,LBN,Lebanon,2015,0,8,-8
SVK,Slovak Republic,LBN,Lebanon,2016,0,1,-1
SVK,Slovak Republic,LBN,Lebanon,2017,0,3,-3
ESP,Spain,LBN,Lebanon,2008,107,157,-50
ESP,Spain,LBN,Lebanon,2009,120,118,2
ESP,Spain,LBN,Lebanon,2010,110,99,11
ESP,Spain,LBN,Lebanon,2011,78,169,-91
ESP,Spain,LBN,Lebanon,2012,80,183,-103
ESP,Spain,LBN,Lebanon,2013,126,265,-139
ESP,Spain,LBN,Lebanon,2014,77,333,-256
ESP,Spain,LBN,Lebanon,2015,81,288,-207
ESP,Spain,LBN,Lebanon,2016,169,359,-190
ESP,Spain,LBN,Lebanon,2017,230,386,-156
SWE,Sweden,LBN,Lebanon,2008,61,387,-326
SWE,Sweden,LBN,Lebanon,2009,44,411,-367
SWE,Sweden,LBN,Lebanon,2010,52,421,-369
SWE,Sweden,LBN,Lebanon,2011,101,348,-247
SWE,Sweden,LBN,Lebanon,2012,79,380,-301
SWE,Sweden,LBN,Lebanon,2013,60,423,-363
SWE,Sweden,LBN,Lebanon,2014,89,422,-333
SWE,Sweden,LBN,Lebanon,2015,96,434,-338
SWE,Sweden,LBN,Lebanon,2016,62,409,-347
SWE,Sweden,LBN,Lebanon,2017,66,401,-335
CHE,Switzerland,LBN,Lebanon,2010,108,209,-101
CHE,Switzerland,LBN,Lebanon,2011,102,193,-91
CHE,Switzerland,LBN,Lebanon,2012,71,193,-122
CHE,Switzerland,LBN,Lebanon,2013,94,232,-138
CHE,Switzerland,LBN,Lebanon,2014,74,216,-142
CHE,Switzerland,LBN,Lebanon,2015,97,236,-139
CHE,Switzerland,LBN,Lebanon,2016,114,235,-121
CHE,Switzerland,LBN,Lebanon,2017,93,237,-144
TUR,Turkey,LBN,Lebanon,2010,0,28,-28
TUR,Turkey,LBN,Lebanon,2016,181,596,-415
TUR,Turkey,LBN,Lebanon,2017,291,778,-487
GBR,United Kingdom,LBN,Lebanon,2014,0,1000,-1000
USA,United States,LBN,Lebanon,2008,0,4254,-4254
USA,United States,LBN,Lebanon,2009,0,3831,-3831
USA,United States,LBN,Lebanon,2010,0,3487,-3487
USA,United States,LBN,Lebanon,2011,0,3295,-3295
USA,United States,LBN,Lebanon,2012,0,2879,-2879
USA,United States,LBN,Lebanon,2013,0,2783,-2783
USA,United States,LBN,Lebanon,2014,0,3245,-3245
USA,United States,LBN,Lebanon,2015,0,2813,-2813
USA,United States,LBN,Lebanon,2016,0,2971,-2971
USA,United States,LBN,Lebanon,2017,0,2818,-2818
CHL,Chile,LBN,Lebanon,2008,0,11,-11
CHL,Chile,LBN,Lebanon,2009,0,13,-13
CHL,Chile,LBN,Lebanon,2010,0,5,-5
CHL,Chile,LBN,Lebanon,2011,0,10,-10
CHL,Chile,LBN,Lebanon,2012,0,10,-10
CHL,Chile,LBN,Lebanon,2013,0,14,-14
CHL,Chile,LBN,Lebanon,2014,0,6,-6
CHL,Chile,LBN,Lebanon,2015,0,7,-7
CHL,Chile,LBN,Lebanon,2016,0,18,-18
EST,Estonia,LBN,Lebanon,2008,0,0,0
EST,Estonia,LBN,Lebanon,2009,0,1,-1
EST,Estonia,LBN,Lebanon,2010,0,1,-1
EST,Estonia,LBN,Lebanon,2011,0,1,-1
EST,Estonia,LBN,Lebanon,2012,0,0,0
EST,Estonia,LBN,Lebanon,2013,0,0,0
EST,Estonia,LBN,Lebanon,2014,0,2,-2
EST,Estonia,LBN,Lebanon,2015,0,1,-1
EST,Estonia,LBN,Lebanon,2016,0,1,-1
EST,Estonia,LBN,Lebanon,2017,0,0,0
SVN,Slovenia,LBN,Lebanon,2008,0,1,-1
SVN,Slovenia,LBN,Lebanon,2009,0,4,-4
SVN,Slovenia,LBN,Lebanon,2011,0,3,-3
SVN,Slovenia,LBN,Lebanon,2013,0,1,-1
SVN,Slovenia,LBN,Lebanon,2014,0,1,-1
SVN,Slovenia,LBN,Lebanon,2015,0,2,-2
SVN,Slovenia,LBN,Lebanon,2016,0,3,-3
SVN,Slovenia,LBN,Lebanon,2017,0,3,-3
AUS,Australia,LSO,Lesotho,2008,0,2,-2
AUS,Australia,LSO,Lesotho,2009,0,0,0
AUS,Australia,LSO,Lesotho,2010,0,6,-6
AUS,Australia,LSO,Lesotho,2011,0,7,-7
AUS,Australia,LSO,Lesotho,2012,0,0,0
AUS,Australia,LSO,Lesotho,2013,0,1,-1
AUS,Australia,LSO,Lesotho,2014,0,0,0
AUS,Australia,LSO,Lesotho,2015,0,0,0
AUS,Australia,LSO,Lesotho,2016,0,0,0
AUS,Australia,LSO,Lesotho,2017,0,3,-3
AUT,Austria,LSO,Lesotho,2008,0,0,0
AUT,Austria,LSO,Lesotho,2009,0,0,0
AUT,Austria,LSO,Lesotho,2010,1,0,1
AUT,Austria,LSO,Lesotho,2011,0,0,0
AUT,Austria,LSO,Lesotho,2012,0,2,-2
AUT,Austria,LSO,Lesotho,2013,2,3,-1
AUT,Austria,LSO,Lesotho,2014,1,0,1
AUT,Austria,LSO,Lesotho,2015,1,3,-2
AUT,Austria,LSO,Lesotho,2016,3,2,1
AUT,Austria,LSO,Lesotho,2017,1,2,-1
BEL,Belgium,LSO,Lesotho,2008,0,3,-3
BEL,Belgium,LSO,Lesotho,2009,0,5,-5
BEL,Belgium,LSO,Lesotho,2010,0,0,0
BEL,Belgium,LSO,Lesotho,2013,2,4,-2
BEL,Belgium,LSO,Lesotho,2014,1,2,-1
BEL,Belgium,LSO,Lesotho,2017,0,2,-2
CAN,Canada,LSO,Lesotho,2008,0,1,-1
CAN,Canada,LSO,Lesotho,2009,0,8,-8
CAN,Canada,LSO,Lesotho,2010,0,7,-7
CAN,Canada,LSO,Lesotho,2011,0,1,-1
CAN,Canada,LSO,Lesotho,2012,0,0,0
CAN,Canada,LSO,Lesotho,2013,0,6,-6
CAN,Canada,LSO,Lesotho,2014,0,2,-2
CAN,Canada,LSO,Lesotho,2015,0,0,0
CAN,Canada,LSO,Lesotho,2016,0,10,-10
CAN,Canada,LSO,Lesotho,2017,0,0,0
DNK,Denmark,LSO,Lesotho,2008,0,1,-1
DNK,Denmark,LSO,Lesotho,2009,1,0,1
DNK,Denmark,LSO,Lesotho,2011,1,2,-1
DNK,Denmark,LSO,Lesotho,2012,0,0,0
DNK,Denmark,LSO,Lesotho,2013,0,0,0
DNK,Denmark,LSO,Lesotho,2014,0,1,-1
DNK,Denmark,LSO,Lesotho,2015,0,1,-1
DNK,Denmark,LSO,Lesotho,2016,0,0,0
DNK,Denmark,LSO,Lesotho,2017,0,2,-2
FIN,Finland,LSO,Lesotho,2008,0,0,0
FIN,Finland,LSO,Lesotho,2009,0,0,0
FIN,Finland,LSO,Lesotho,2010,0,0,0
FIN,Finland,LSO,Lesotho,2011,0,0,0
FIN,Finland,LSO,Lesotho,2012,0,0,0
FIN,Finland,LSO,Lesotho,2013,0,0,0
FIN,Finland,LSO,Lesotho,2014,0,0,0
FIN,Finland,LSO,Lesotho,2015,0,0,0
FIN,Finland,LSO,Lesotho,2016,0,0,0
FIN,Finland,LSO,Lesotho,2017,0,0,0
FRA,France,LSO,Lesotho,2008,0,0,0
FRA,France,LSO,Lesotho,2009,0,8,-8
FRA,France,LSO,Lesotho,2010,0,6,-6
FRA,France,LSO,Lesotho,2011,0,1,-1
FRA,France,LSO,Lesotho,2012,0,0,0
FRA,France,LSO,Lesotho,2013,0,1,-1
FRA,France,LSO,Lesotho,2014,0,0,0
FRA,France,LSO,Lesotho,2015,0,1,-1
FRA,France,LSO,Lesotho,2016,0,1,-1
FRA,France,LSO,Lesotho,2017,0,0,0
DEU,Germany,LSO,Lesotho,2008,14,12,2
DEU,Germany,LSO,Lesotho,2009,19,11,8
DEU,Germany,LSO,Lesotho,2010,9,7,2
DEU,Germany,LSO,Lesotho,2011,6,12,-6
DEU,Germany,LSO,Lesotho,2012,3,4,-1
DEU,Germany,LSO,Lesotho,2013,11,9,2
DEU,Germany,LSO,Lesotho,2014,2,5,-3
DEU,Germany,LSO,Lesotho,2015,3,13,-10
DEU,Germany,LSO,Lesotho,2016,6,1,5
DEU,Germany,LSO,Lesotho,2017,5,12,-7
HUN,Hungary,LSO,Lesotho,2008,0,0,0
HUN,Hungary,LSO,Lesotho,2009,0,0,0
HUN,Hungary,LSO,Lesotho,2010,0,1,-1
HUN,Hungary,LSO,Lesotho,2011,0,1,-1
HUN,Hungary,LSO,Lesotho,2012,0,1,-1
HUN,Hungary,LSO,Lesotho,2013,0,0,0
HUN,Hungary,LSO,Lesotho,2014,0,0,0
HUN,Hungary,LSO,Lesotho,2015,0,1,-1
HUN,Hungary,LSO,Lesotho,2016,0,1,-1
HUN,Hungary,LSO,Lesotho,2017,0,0,0
ISL,Iceland,LSO,Lesotho,2008,0,0,0
ISL,Iceland,LSO,Lesotho,2009,0,0,0
ISL,Iceland,LSO,Lesotho,2010,0,0,0
ISL,Iceland,LSO,Lesotho,2011,0,0,0
ISL,Iceland,LSO,Lesotho,2012,0,0,0
ISL,Iceland,LSO,Lesotho,2013,0,0,0
ISL,Iceland,LSO,Lesotho,2014,0,0,0
ISL,Iceland,LSO,Lesotho,2015,0,0,0
ISL,Iceland,LSO,Lesotho,2016,2,2,0
ISL,Iceland,LSO,Lesotho,2017,2,2,0
ITA,Italy,LSO,Lesotho,2008,0,2,-2
ITA,Italy,LSO,Lesotho,2009,0,3,-3
ITA,Italy,LSO,Lesotho,2010,1,3,-2
ITA,Italy,LSO,Lesotho,2011,1,0,1
ITA,Italy,LSO,Lesotho,2012,0,0,0
ITA,Italy,LSO,Lesotho,2013,0,5,-5
ITA,Italy,LSO,Lesotho,2014,0,0,0
ITA,Italy,LSO,Lesotho,2015,0,0,0
ITA,Italy,LSO,Lesotho,2016,0,0,0
ITA,Italy,LSO,Lesotho,2017,0,2,-2
JPN,Japan,LSO,Lesotho,2008,21,23,-2
JPN,Japan,LSO,Lesotho,2009,21,19,2
JPN,Japan,LSO,Lesotho,2010,26,31,-5
JPN,Japan,LSO,Lesotho,2011,17,17,0
JPN,Japan,LSO,Lesotho,2012,25,25,0
JPN,Japan,LSO,Lesotho,2013,27,27,0
JPN,Japan,LSO,Lesotho,2014,28,29,-1
JPN,Japan,LSO,Lesotho,2015,29,27,2
JPN,Japan,LSO,Lesotho,2016,27,39,-12
JPN,Japan,LSO,Lesotho,2017,25,27,-2
KOR,Korea,LSO,Lesotho,2008,0,1,-1
KOR,Korea,LSO,Lesotho,2009,0,0,0
KOR,Korea,LSO,Lesotho,2010,1,2,-1
KOR,Korea,LSO,Lesotho,2011,0,0,0
KOR,Korea,LSO,Lesotho,2012,1,0,1
KOR,Korea,LSO,Lesotho,2013,1,5,-4
KOR,Korea,LSO,Lesotho,2014,0,4,-4
KOR,Korea,LSO,Lesotho,2015,4,2,2
KOR,Korea,LSO,Lesotho,2016,1,1,0
KOR,Korea,LSO,Lesotho,2017,1,1,0
LUX,Luxembourg,LSO,Lesotho,2008,0,0,0
LUX,Luxembourg,LSO,Lesotho,2009,0,0,0
LUX,Luxembourg,LSO,Lesotho,2010,0,0,0
LUX,Luxembourg,LSO,Lesotho,2011,0,0,0
LUX,Luxembourg,LSO,Lesotho,2012,0,0,0
LUX,Luxembourg,LSO,Lesotho,2013,0,0,0
LUX,Luxembourg,LSO,Lesotho,2014,0,0,0
LUX,Luxembourg,LSO,Lesotho,2015,0,0,0
LUX,Luxembourg,LSO,Lesotho,2016,0,0,0
LUX,Luxembourg,LSO,Lesotho,2017,0,0,0
MEX,Mexico,LSO,Lesotho,2012,0,0,0
MEX,Mexico,LSO,Lesotho,2013,0,0,0
MEX,Mexico,LSO,Lesotho,2014,0,0,0
NLD,Netherlands,LSO,Lesotho,2008,1,6,-5
NLD,Netherlands,LSO,Lesotho,2009,3,2,1
NLD,Netherlands,LSO,Lesotho,2010,2,11,-9
NLD,Netherlands,LSO,Lesotho,2011,1,7,-6
NLD,Netherlands,LSO,Lesotho,2012,2,9,-7
NLD,Netherlands,LSO,Lesotho,2013,4,6,-2
NLD,Netherlands,LSO,Lesotho,2014,0,8,-8
NLD,Netherlands,LSO,Lesotho,2015,0,6,-6
NLD,Netherlands,LSO,Lesotho,2016,4,2,2
NLD,Netherlands,LSO,Lesotho,2017,2,5,-3
NZL,New Zealand,LSO,Lesotho,2012,0,3,-3
NZL,New Zealand,LSO,Lesotho,2017,0,1,-1
NOR,Norway,LSO,Lesotho,2008,0,0,0
NOR,Norway,LSO,Lesotho,2009,3,0,3
NOR,Norway,LSO,Lesotho,2010,0,0,0
NOR,Norway,LSO,Lesotho,2011,1,1,0
NOR,Norway,LSO,Lesotho,2012,0,0,0
NOR,Norway,LSO,Lesotho,2013,1,1,0
NOR,Norway,LSO,Lesotho,2014,0,3,-3
NOR,Norway,LSO,Lesotho,2015,3,2,1
NOR,Norway,LSO,Lesotho,2016,3,1,2
NOR,Norway,LSO,Lesotho,2017,0,0,0
POL,Poland,LSO,Lesotho,2009,0,0,0
POL,Poland,LSO,Lesotho,2010,0,1,-1
POL,Poland,LSO,Lesotho,2011,0,0,0
POL,Poland,LSO,Lesotho,2012,0,0,0
POL,Poland,LSO,Lesotho,2013,0,0,0
POL,Poland,LSO,Lesotho,2014,0,0,0
POL,Poland,LSO,Lesotho,2015,0,0,0
POL,Poland,LSO,Lesotho,2016,0,0,0
POL,Poland,LSO,Lesotho,2017,0,1,-1
SVK,Slovak Republic,LSO,Lesotho,2008,0,0,0
SVK,Slovak Republic,LSO,Lesotho,2010,0,1,-1
SVK,Slovak Republic,LSO,Lesotho,2014,0,2,-2
ESP,Spain,LSO,Lesotho,2008,0,1,-1
ESP,Spain,LSO,Lesotho,2009,2,4,-2
ESP,Spain,LSO,Lesotho,2010,1,2,-1
ESP,Spain,LSO,Lesotho,2011,0,0,0
ESP,Spain,LSO,Lesotho,2012,0,0,0
ESP,Spain,LSO,Lesotho,2013,0,2,-2
ESP,Spain,LSO,Lesotho,2014,1,1,0
ESP,Spain,LSO,Lesotho,2015,0,0,0
ESP,Spain,LSO,Lesotho,2016,0,2,-2
ESP,Spain,LSO,Lesotho,2017,0,1,-1
SWE,Sweden,LSO,Lesotho,2008,0,0,0
SWE,Sweden,LSO,Lesotho,2009,0,3,-3
SWE,Sweden,LSO,Lesotho,2010,0,1,-1
SWE,Sweden,LSO,Lesotho,2011,0,3,-3
SWE,Sweden,LSO,Lesotho,2012,1,5,-4
SWE,Sweden,LSO,Lesotho,2013,0,3,-3
SWE,Sweden,LSO,Lesotho,2014,0,0,0
SWE,Sweden,LSO,Lesotho,2015,2,0,2
SWE,Sweden,LSO,Lesotho,2016,0,1,-1
SWE,Sweden,LSO,Lesotho,2017,0,1,-1
CHE,Switzerland,LSO,Lesotho,2010,1,1,0
CHE,Switzerland,LSO,Lesotho,2011,2,5,-3
CHE,Switzerland,LSO,Lesotho,2012,2,4,-2
CHE,Switzerland,LSO,Lesotho,2013,0,1,-1
CHE,Switzerland,LSO,Lesotho,2014,1,0,1
CHE,Switzerland,LSO,Lesotho,2015,0,3,-3
CHE,Switzerland,LSO,Lesotho,2016,2,0,2
CHE,Switzerland,LSO,Lesotho,2017,0,0,0
TUR,Turkey,LSO,Lesotho,2010,0,1,-1
USA,United States,LSO,Lesotho,2008,0,16,-16
USA,United States,LSO,Lesotho,2009,0,14,-14
USA,United States,LSO,Lesotho,2010,0,23,-23
USA,United States,LSO,Lesotho,2011,0,25,-25
USA,United States,LSO,Lesotho,2012,0,17,-17
USA,United States,LSO,Lesotho,2013,0,20,-20
USA,United States,LSO,Lesotho,2014,0,13,-13
USA,United States,LSO,Lesotho,2015,0,23,-23
USA,United States,LSO,Lesotho,2016,0,19,-19
USA,United States,LSO,Lesotho,2017,0,24,-24
CHL,Chile,LSO,Lesotho,2008,0,0,0
CHL,Chile,LSO,Lesotho,2009,0,0,0
CHL,Chile,LSO,Lesotho,2010,0,0,0
CHL,Chile,LSO,Lesotho,2011,0,0,0
CHL,Chile,LSO,Lesotho,2012,0,0,0
CHL,Chile,LSO,Lesotho,2013,0,0,0
CHL,Chile,LSO,Lesotho,2014,0,0,0
CHL,Chile,LSO,Lesotho,2015,0,0,0
CHL,Chile,LSO,Lesotho,2016,0,1,-1
EST,Estonia,LSO,Lesotho,2008,0,0,0
EST,Estonia,LSO,Lesotho,2009,0,0,0
EST,Estonia,LSO,Lesotho,2010,0,0,0
EST,Estonia,LSO,Lesotho,2011,0,0,0
EST,Estonia,LSO,Lesotho,2012,0,0,0
EST,Estonia,LSO,Lesotho,2013,0,0,0
EST,Estonia,LSO,Lesotho,2014,0,0,0
EST,Estonia,LSO,Lesotho,2015,0,0,0
EST,Estonia,LSO,Lesotho,2016,0,0,0
EST,Estonia,LSO,Lesotho,2017,0,0,0
AUS,Australia,LBR,Liberia,2008,12,380,-368
AUS,Australia,LBR,Liberia,2009,7,414,-407
AUS,Australia,LBR,Liberia,2010,10,474,-464
AUS,Australia,LBR,Liberia,2011,8,144,-136
AUS,Australia,LBR,Liberia,2012,11,174,-163
AUS,Australia,LBR,Liberia,2013,12,100,-88
AUS,Australia,LBR,Liberia,2014,8,164,-156
AUS,Australia,LBR,Liberia,2015,0,112,-112
AUS,Australia,LBR,Liberia,2016,0,83,-83
AUS,Australia,LBR,Liberia,2017,0,160,-160
AUT,Austria,LBR,Liberia,2008,52,32,20
AUT,Austria,LBR,Liberia,2009,55,34,21
AUT,Austria,LBR,Liberia,2010,44,33,11
AUT,Austria,LBR,Liberia,2011,30,38,-8
AUT,Austria,LBR,Liberia,2012,23,29,-6
AUT,Austria,LBR,Liberia,2013,27,32,-5
AUT,Austria,LBR,Liberia,2014,25,36,-11
AUT,Austria,LBR,Liberia,2015,15,28,-13
AUT,Austria,LBR,Liberia,2016,20,26,-6
AUT,Austria,LBR,Liberia,2017,30,13,17
BEL,Belgium,LBR,Liberia,2008,0,23,-23
BEL,Belgium,LBR,Liberia,2009,0,17,-17
BEL,Belgium,LBR,Liberia,2010,4,14,-10
BEL,Belgium,LBR,Liberia,2012,14,47,-33
BEL,Belgium,LBR,Liberia,2013,44,35,9
BEL,Belgium,LBR,Liberia,2014,19,30,-11
BEL,Belgium,LBR,Liberia,2015,34,28,6
BEL,Belgium,LBR,Liberia,2016,20,19,1
BEL,Belgium,LBR,Liberia,2017,11,10,1
CAN,Canada,LBR,Liberia,2008,0,74,-74
CAN,Canada,LBR,Liberia,2009,0,94,-94
CAN,Canada,LBR,Liberia,2010,0,162,-162
CAN,Canada,LBR,Liberia,2011,0,106,-106
CAN,Canada,LBR,Liberia,2012,0,58,-58
CAN,Canada,LBR,Liberia,2013,0,39,-39
CAN,Canada,LBR,Liberia,2014,0,60,-60
CAN,Canada,LBR,Liberia,2015,0,155,-155
CAN,Canada,LBR,Liberia,2016,0,155,-155
CAN,Canada,LBR,Liberia,2017,0,55,-55
DNK,Denmark,LBR,Liberia,2008,0,1,-1
DNK,Denmark,LBR,Liberia,2009,3,13,-10
DNK,Denmark,LBR,Liberia,2010,2,19,-17
DNK,Denmark,LBR,Liberia,2011,3,4,-1
DNK,Denmark,LBR,Liberia,2012,2,4,-2
DNK,Denmark,LBR,Liberia,2013,1,5,-4
DNK,Denmark,LBR,Liberia,2014,3,2,1
DNK,Denmark,LBR,Liberia,2015,2,2,0
DNK,Denmark,LBR,Liberia,2016,2,3,-1
DNK,Denmark,LBR,Liberia,2017,3,0,3
FIN,Finland,LBR,Liberia,2008,1,11,-10
FIN,Finland,LBR,Liberia,2009,0,4,-4
FIN,Finland,LBR,Liberia,2010,0,0,0
FIN,Finland,LBR,Liberia,2011,0,1,-1
FIN,Finland,LBR,Liberia,2012,1,2,-1
FIN,Finland,LBR,Liberia,2013,0,1,-1
FIN,Finland,LBR,Liberia,2014,0,4,-4
FIN,Finland,LBR,Liberia,2015,0,1,-1
FIN,Finland,LBR,Liberia,2016,0,3,-3
FIN,Finland,LBR,Liberia,2017,0,1,-1
FRA,France,LBR,Liberia,2008,0,29,-29
FRA,France,LBR,Liberia,2009,0,28,-28
FRA,France,LBR,Liberia,2010,0,23,-23
FRA,France,LBR,Liberia,2011,0,24,-24
FRA,France,LBR,Liberia,2012,0,24,-24
FRA,France,LBR,Liberia,2013,0,14,-14
FRA,France,LBR,Liberia,2014,0,12,-12
FRA,France,LBR,Liberia,2015,0,16,-16
FRA,France,LBR,Liberia,2016,0,20,-20
FRA,France,LBR,Liberia,2017,0,21,-21
DEU,Germany,LBR,Liberia,2008,188,109,79
DEU,Germany,LBR,Liberia,2009,164,89,75
DEU,Germany,LBR,Liberia,2010,104,77,27
DEU,Germany,LBR,Liberia,2011,54,75,-21
DEU,Germany,LBR,Liberia,2012,73,100,-27
DEU,Germany,LBR,Liberia,2013,60,94,-34
DEU,Germany,LBR,Liberia,2014,58,154,-96
DEU,Germany,LBR,Liberia,2015,69,173,-104
DEU,Germany,LBR,Liberia,2016,95,193,-98
DEU,Germany,LBR,Liberia,2017,98,245,-147
HUN,Hungary,LBR,Liberia,2008,1,4,-3
HUN,Hungary,LBR,Liberia,2009,1,0,1
HUN,Hungary,LBR,Liberia,2010,0,0,0
HUN,Hungary,LBR,Liberia,2011,0,9,-9
HUN,Hungary,LBR,Liberia,2012,1,8,-7
HUN,Hungary,LBR,Liberia,2013,0,5,-5
HUN,Hungary,LBR,Liberia,2014,0,0,0
HUN,Hungary,LBR,Liberia,2015,0,0,0
HUN,Hungary,LBR,Liberia,2016,3,5,-2
HUN,Hungary,LBR,Liberia,2017,0,3,-3
ISL,Iceland,LBR,Liberia,2008,0,1,-1
ISL,Iceland,LBR,Liberia,2009,1,0,1
ISL,Iceland,LBR,Liberia,2010,0,1,-1
ISL,Iceland,LBR,Liberia,2011,0,1,-1
ISL,Iceland,LBR,Liberia,2012,0,1,-1
ISL,Iceland,LBR,Liberia,2013,0,0,0
ISL,Iceland,LBR,Liberia,2014,2,0,2
ISL,Iceland,LBR,Liberia,2015,0,0,0
ISL,Iceland,LBR,Liberia,2016,0,1,-1
ISL,Iceland,LBR,Liberia,2017,0,2,-2
ITA,Italy,LBR,Liberia,2008,9,283,-274
ITA,Italy,LBR,Liberia,2009,10,196,-186
ITA,Italy,LBR,Liberia,2010,4,170,-166
ITA,Italy,LBR,Liberia,2011,2,122,-120
ITA,Italy,LBR,Liberia,2012,14,120,-106
ITA,Italy,LBR,Liberia,2013,2,91,-89
ITA,Italy,LBR,Liberia,2014,5,63,-58
ITA,Italy,LBR,Liberia,2015,6,47,-41
ITA,Italy,LBR,Liberia,2016,0,115,-115
ITA,Italy,LBR,Liberia,2017,2,241,-239
JPN,Japan,LBR,Liberia,2008,38,37,1
JPN,Japan,LBR,Liberia,2009,31,34,-3
JPN,Japan,LBR,Liberia,2010,49,49,0
JPN,Japan,LBR,Liberia,2011,31,35,-4
JPN,Japan,LBR,Liberia,2012,88,86,2
JPN,Japan,LBR,Liberia,2013,60,66,-6
JPN,Japan,LBR,Liberia,2014,22,21,1
JPN,Japan,LBR,Liberia,2015,41,40,1
JPN,Japan,LBR,Liberia,2016,58,62,-4
JPN,Japan,LBR,Liberia,2017,73,77,-4
KOR,Korea,LBR,Liberia,2008,19,17,2
KOR,Korea,LBR,Liberia,2009,19,5,14
KOR,Korea,LBR,Liberia,2010,22,22,0
KOR,Korea,LBR,Liberia,2011,20,43,-23
KOR,Korea,LBR,Liberia,2012,24,29,-5
KOR,Korea,LBR,Liberia,2013,21,40,-19
KOR,Korea,LBR,Liberia,2014,16,61,-45
KOR,Korea,LBR,Liberia,2015,29,110,-81
KOR,Korea,LBR,Liberia,2016,60,136,-76
KOR,Korea,LBR,Liberia,2017,68,165,-97
LUX,Luxembourg,LBR,Liberia,2008,5,2,3
LUX,Luxembourg,LBR,Liberia,2009,3,3,0
LUX,Luxembourg,LBR,Liberia,2010,1,3,-2
LUX,Luxembourg,LBR,Liberia,2011,3,1,2
LUX,Luxembourg,LBR,Liberia,2012,0,2,-2
LUX,Luxembourg,LBR,Liberia,2013,1,2,-1
LUX,Luxembourg,LBR,Liberia,2014,0,4,-4
LUX,Luxembourg,LBR,Liberia,2015,2,0,2
LUX,Luxembourg,LBR,Liberia,2016,0,1,-1
LUX,Luxembourg,LBR,Liberia,2017,2,1,1
MEX,Mexico,LBR,Liberia,2012,0,0,0
MEX,Mexico,LBR,Liberia,2013,0,0,0
MEX,Mexico,LBR,Liberia,2014,0,0,0
MEX,Mexico,LBR,Liberia,2015,0,1,-1
MEX,Mexico,LBR,Liberia,2016,0,1,-1
NLD,Netherlands,LBR,Liberia,2008,-2,20,-22
NLD,Netherlands,LBR,Liberia,2009,15,29,-14
NLD,Netherlands,LBR,Liberia,2010,14,22,-8
NLD,Netherlands,LBR,Liberia,2011,7,9,-2
NLD,Netherlands,LBR,Liberia,2012,12,10,2
NLD,Netherlands,LBR,Liberia,2013,2,17,-15
NLD,Netherlands,LBR,Liberia,2014,13,14,-1
NLD,Netherlands,LBR,Liberia,2015,12,16,-4
NLD,Netherlands,LBR,Liberia,2016,7,13,-6
NLD,Netherlands,LBR,Liberia,2017,11,15,-4
NZL,New Zealand,LBR,Liberia,2008,1,3,-2
NZL,New Zealand,LBR,Liberia,2010,0,0,0
NZL,New Zealand,LBR,Liberia,2012,0,1,-1
NZL,New Zealand,LBR,Liberia,2014,0,4,-4
NZL,New Zealand,LBR,Liberia,2015,0,1,-1
NZL,New Zealand,LBR,Liberia,2016,0,1,-1
NOR,Norway,LBR,Liberia,2008,14,35,-21
NOR,Norway,LBR,Liberia,2009,7,30,-23
NOR,Norway,LBR,Liberia,2010,10,23,-13
NOR,Norway,LBR,Liberia,2011,6,21,-15
NOR,Norway,LBR,Liberia,2012,13,15,-2
NOR,Norway,LBR,Liberia,2013,10,19,-9
NOR,Norway,LBR,Liberia,2014,9,10,-1
NOR,Norway,LBR,Liberia,2015,8,18,-10
NOR,Norway,LBR,Liberia,2016,5,11,-6
NOR,Norway,LBR,Liberia,2017,3,14,-11
POL,Poland,LBR,Liberia,2009,0,1,-1
POL,Poland,LBR,Liberia,2010,0,2,-2
POL,Poland,LBR,Liberia,2011,0,2,-2
POL,Poland,LBR,Liberia,2012,0,3,-3
POL,Poland,LBR,Liberia,2013,0,2,-2
POL,Poland,LBR,Liberia,2014,0,1,-1
POL,Poland,LBR,Liberia,2015,0,2,-2
POL,Poland,LBR,Liberia,2016,0,2,-2
POL,Poland,LBR,Liberia,2017,0,1,-1
SVK,Slovak Republic,LBR,Liberia,2008,0,1,-1
ESP,Spain,LBR,Liberia,2008,40,32,8
ESP,Spain,LBR,Liberia,2009,44,32,12
ESP,Spain,LBR,Liberia,2010,36,25,11
ESP,Spain,LBR,Liberia,2011,29,20,9
ESP,Spain,LBR,Liberia,2012,23,28,-5
ESP,Spain,LBR,Liberia,2013,19,23,-4
ESP,Spain,LBR,Liberia,2014,13,13,0
ESP,Spain,LBR,Liberia,2015,16,16,0
ESP,Spain,LBR,Liberia,2016,7,22,-15
ESP,Spain,LBR,Liberia,2017,14,12,2
SWE,Sweden,LBR,Liberia,2008,3,29,-26
SWE,Sweden,LBR,Liberia,2009,2,23,-21
SWE,Sweden,LBR,Liberia,2010,2,41,-39
SWE,Sweden,LBR,Liberia,2011,4,28,-24
SWE,Sweden,LBR,Liberia,2012,2,29,-27
SWE,Sweden,LBR,Liberia,2013,6,24,-18
SWE,Sweden,LBR,Liberia,2014,6,19,-13
SWE,Sweden,LBR,Liberia,2015,2,10,-8
SWE,Sweden,LBR,Liberia,2016,3,17,-14
SWE,Sweden,LBR,Liberia,2017,9,26,-17
CHE,Switzerland,LBR,Liberia,2010,1,8,-7
CHE,Switzerland,LBR,Liberia,2011,1,12,-11
CHE,Switzerland,LBR,Liberia,2012,4,9,-5
CHE,Switzerland,LBR,Liberia,2013,5,8,-3
CHE,Switzerland,LBR,Liberia,2014,1,2,-1
CHE,Switzerland,LBR,Liberia,2015,1,5,-4
CHE,Switzerland,LBR,Liberia,2016,0,8,-8
CHE,Switzerland,LBR,Liberia,2017,2,1,1
GBR,United Kingdom,LBR,Liberia,2014,0,1000,-1000
USA,United States,LBR,Liberia,2008,0,7193,-7193
USA,United States,LBR,Liberia,2009,0,7641,-7641
USA,United States,LBR,Liberia,2010,0,4837,-4837
USA,United States,LBR,Liberia,2011,0,4151,-4151
USA,United States,LBR,Liberia,2012,0,4109,-4109
USA,United States,LBR,Liberia,2013,0,3334,-3334
USA,United States,LBR,Liberia,2014,0,3874,-3874
USA,United States,LBR,Liberia,2015,0,3795,-3795
USA,United States,LBR,Liberia,2016,0,3619,-3619
USA,United States,LBR,Liberia,2017,0,4155,-4155
CHL,Chile,LBR,Liberia,2008,0,0,0
CHL,Chile,LBR,Liberia,2009,0,0,0
CHL,Chile,LBR,Liberia,2010,0,0,0
CHL,Chile,LBR,Liberia,2011,0,0,0
CHL,Chile,LBR,Liberia,2012,0,0,0
CHL,Chile,LBR,Liberia,2013,0,1,-1
CHL,Chile,LBR,Liberia,2014,0,0,0
CHL,Chile,LBR,Liberia,2015,0,0,0
CHL,Chile,LBR,Liberia,2016,0,0,0
EST,Estonia,LBR,Liberia,2008,0,0,0
EST,Estonia,LBR,Liberia,2009,0,0,0
EST,Estonia,LBR,Liberia,2010,0,0,0
EST,Estonia,LBR,Liberia,2011,0,0,0
EST,Estonia,LBR,Liberia,2012,0,0,0
EST,Estonia,LBR,Liberia,2013,0,0,0
EST,Estonia,LBR,Liberia,2014,0,0,0
EST,Estonia,LBR,Liberia,2015,0,0,0
EST,Estonia,LBR,Liberia,2016,0,1,-1
EST,Estonia,LBR,Liberia,2017,0,0,0
SVN,Slovenia,LBR,Liberia,2009,0,2,-2
SVN,Slovenia,LBR,Liberia,2015,0,1,-1
AUS,Australia,LBY,Libya,2008,12,7,5
AUS,Australia,LBY,Libya,2009,9,13,-4
AUS,Australia,LBY,Libya,2010,6,6,0
AUS,Australia,LBY,Libya,2011,18,8,10
AUS,Australia,LBY,Libya,2012,10,23,-13
AUS,Australia,LBY,Libya,2013,18,16,2
AUS,Australia,LBY,Libya,2014,13,26,-13
AUS,Australia,LBY,Libya,2015,0,17,-17
AUS,Australia,LBY,Libya,2016,0,31,-31
AUS,Australia,LBY,Libya,2017,0,34,-34
AUT,Austria,LBY,Libya,2008,70,30,40
AUT,Austria,LBY,Libya,2009,33,68,-35
AUT,Austria,LBY,Libya,2010,58,65,-7
AUT,Austria,LBY,Libya,2011,55,78,-23
AUT,Austria,LBY,Libya,2012,43,65,-22
AUT,Austria,LBY,Libya,2013,60,117,-57
AUT,Austria,LBY,Libya,2014,147,356,-209
AUT,Austria,LBY,Libya,2015,175,188,-13
AUT,Austria,LBY,Libya,2016,139,176,-37
AUT,Austria,LBY,Libya,2017,150,151,-1
BEL,Belgium,LBY,Libya,2008,0,31,-31
BEL,Belgium,LBY,Libya,2009,0,20,-20
BEL,Belgium,LBY,Libya,2010,27,17,10
BEL,Belgium,LBY,Libya,2012,20,17,3
BEL,Belgium,LBY,Libya,2013,32,22,10
BEL,Belgium,LBY,Libya,2014,21,49,-28
BEL,Belgium,LBY,Libya,2015,13,76,-63
BEL,Belgium,LBY,Libya,2016,8,49,-41
BEL,Belgium,LBY,Libya,2017,8,52,-44
CAN,Canada,LBY,Libya,2008,0,306,-306
CAN,Canada,LBY,Libya,2009,0,282,-282
CAN,Canada,LBY,Libya,2010,0,384,-384
CAN,Canada,LBY,Libya,2011,0,352,-352
CAN,Canada,LBY,Libya,2012,0,299,-299
CAN,Canada,LBY,Libya,2013,0,255,-255
CAN,Canada,LBY,Libya,2014,0,298,-298
CAN,Canada,LBY,Libya,2015,0,244,-244
CAN,Canada,LBY,Libya,2016,0,300,-300
CAN,Canada,LBY,Libya,2017,0,500,-500
CZE,Czech Republic,LBY,Libya,2008,0,60,-60
CZE,Czech Republic,LBY,Libya,2009,0,66,-66
CZE,Czech Republic,LBY,Libya,2010,0,64,-64
CZE,Czech Republic,LBY,Libya,2011,0,14,-14
CZE,Czech Republic,LBY,Libya,2012,9,22,-13
CZE,Czech Republic,LBY,Libya,2013,24,29,-5
CZE,Czech Republic,LBY,Libya,2014,13,28,-15
CZE,Czech Republic,LBY,Libya,2015,7,16,-9
CZE,Czech Republic,LBY,Libya,2016,13,17,-4
CZE,Czech Republic,LBY,Libya,2017,12,9,3
DNK,Denmark,LBY,Libya,2008,5,3,2
DNK,Denmark,LBY,Libya,2009,7,5,2
DNK,Denmark,LBY,Libya,2010,0,3,-3
DNK,Denmark,LBY,Libya,2011,3,13,-10
DNK,Denmark,LBY,Libya,2012,1,14,-13
DNK,Denmark,LBY,Libya,2013,3,3,0
DNK,Denmark,LBY,Libya,2014,1,3,-2
DNK,Denmark,LBY,Libya,2015,0,0,0
DNK,Denmark,LBY,Libya,2016,2,3,-1
DNK,Denmark,LBY,Libya,2017,5,3,2
FIN,Finland,LBY,Libya,2008,10,5,5
FIN,Finland,LBY,Libya,2009,6,7,-1
FIN,Finland,LBY,Libya,2010,4,6,-2
FIN,Finland,LBY,Libya,2011,0,3,-3
FIN,Finland,LBY,Libya,2012,1,6,-5
FIN,Finland,LBY,Libya,2013,3,6,-3
FIN,Finland,LBY,Libya,2014,2,17,-15
FIN,Finland,LBY,Libya,2015,1,19,-18
FIN,Finland,LBY,Libya,2016,5,20,-15
FIN,Finland,LBY,Libya,2017,4,1,3
FRA,France,LBY,Libya,2008,0,72,-72
FRA,France,LBY,Libya,2009,0,93,-93
FRA,France,LBY,Libya,2010,0,107,-107
FRA,France,LBY,Libya,2011,0,63,-63
FRA,France,LBY,Libya,2012,0,202,-202
FRA,France,LBY,Libya,2013,0,311,-311
FRA,France,LBY,Libya,2014,0,186,-186
FRA,France,LBY,Libya,2015,0,136,-136
FRA,France,LBY,Libya,2016,0,153,-153
FRA,France,LBY,Libya,2017,0,179,-179
DEU,Germany,LBY,Libya,2008,616,691,-75
DEU,Germany,LBY,Libya,2009,683,674,9
DEU,Germany,LBY,Libya,2010,635,902,-267
DEU,Germany,LBY,Libya,2011,633,948,-315
DEU,Germany,LBY,Libya,2012,910,1920,-1010
DEU,Germany,LBY,Libya,2013,1755,4432,-2677
DEU,Germany,LBY,Libya,2014,2257,4256,-1999
DEU,Germany,LBY,Libya,2015,1965,2621,-656
DEU,Germany,LBY,Libya,2016,1577,2316,-739
DEU,Germany,LBY,Libya,2017,1708,2366,-658
HUN,Hungary,LBY,Libya,2008,4,25,-21
HUN,Hungary,LBY,Libya,2009,1,26,-25
HUN,Hungary,LBY,Libya,2010,5,23,-18
HUN,Hungary,LBY,Libya,2011,8,28,-20
HUN,Hungary,LBY,Libya,2012,0,47,-47
HUN,Hungary,LBY,Libya,2013,8,120,-112
HUN,Hungary,LBY,Libya,2014,11,74,-63
HUN,Hungary,LBY,Libya,2015,13,57,-44
HUN,Hungary,LBY,Libya,2016,26,58,-32
HUN,Hungary,LBY,Libya,2017,0,70,-70
ISL,Iceland,LBY,Libya,2008,0,0,0
ISL,Iceland,LBY,Libya,2009,0,1,-1
ISL,Iceland,LBY,Libya,2010,0,0,0
ISL,Iceland,LBY,Libya,2011,0,0,0
ISL,Iceland,LBY,Libya,2012,0,0,0
ISL,Iceland,LBY,Libya,2013,0,1,-1
ISL,Iceland,LBY,Libya,2014,0,0,0
ISL,Iceland,LBY,Libya,2015,0,1,-1
ISL,Iceland,LBY,Libya,2016,0,2,-2
ISL,Iceland,LBY,Libya,2017,1,0,1
ITA,Italy,LBY,Libya,2008,2,75,-73
ITA,Italy,LBY,Libya,2009,2,66,-64
ITA,Italy,LBY,Libya,2010,4,108,-104
ITA,Italy,LBY,Libya,2011,9,258,-249
ITA,Italy,LBY,Libya,2012,20,283,-263
ITA,Italy,LBY,Libya,2013,12,326,-314
ITA,Italy,LBY,Libya,2014,12,292,-280
ITA,Italy,LBY,Libya,2015,24,296,-272
ITA,Italy,LBY,Libya,2016,0,304,-304
ITA,Italy,LBY,Libya,2017,15,402,-387
JPN,Japan,LBY,Libya,2008,37,43,-6
JPN,Japan,LBY,Libya,2009,31,20,11
JPN,Japan,LBY,Libya,2010,13,46,-33
JPN,Japan,LBY,Libya,2011,12,42,-30
JPN,Japan,LBY,Libya,2012,60,57,3
JPN,Japan,LBY,Libya,2013,80,115,-35
JPN,Japan,LBY,Libya,2014,31,42,-11
JPN,Japan,LBY,Libya,2015,5,5,0
JPN,Japan,LBY,Libya,2016,8,5,3
JPN,Japan,LBY,Libya,2017,10,18,-8
KOR,Korea,LBY,Libya,2008,24,38,-14
KOR,Korea,LBY,Libya,2009,60,62,-2
KOR,Korea,LBY,Libya,2010,77,66,11
KOR,Korea,LBY,Libya,2011,63,52,11
KOR,Korea,LBY,Libya,2012,106,179,-73
KOR,Korea,LBY,Libya,2013,158,193,-35
KOR,Korea,LBY,Libya,2014,187,169,18
KOR,Korea,LBY,Libya,2015,196,123,73
KOR,Korea,LBY,Libya,2016,137,89,48
KOR,Korea,LBY,Libya,2017,112,93,19
LUX,Luxembourg,LBY,Libya,2008,0,0,0
LUX,Luxembourg,LBY,Libya,2009,0,0,0
LUX,Luxembourg,LBY,Libya,2010,0,14,-14
LUX,Luxembourg,LBY,Libya,2011,0,1,-1
LUX,Luxembourg,LBY,Libya,2012,0,9,-9
LUX,Luxembourg,LBY,Libya,2013,3,14,-11
LUX,Luxembourg,LBY,Libya,2014,9,7,2
LUX,Luxembourg,LBY,Libya,2015,6,4,2
LUX,Luxembourg,LBY,Libya,2016,3,4,-1
LUX,Luxembourg,LBY,Libya,2017,6,12,-6
MEX,Mexico,LBY,Libya,2009,0,1,-1
MEX,Mexico,LBY,Libya,2010,0,1,-1
MEX,Mexico,LBY,Libya,2011,0,1,-1
MEX,Mexico,LBY,Libya,2012,0,0,0
MEX,Mexico,LBY,Libya,2013,0,3,-3
MEX,Mexico,LBY,Libya,2014,0,2,-2
MEX,Mexico,LBY,Libya,2015,0,1,-1
MEX,Mexico,LBY,Libya,2016,0,1,-1
NLD,Netherlands,LBY,Libya,2008,42,16,26
NLD,Netherlands,LBY,Libya,2009,11,24,-13
NLD,Netherlands,LBY,Libya,2010,16,17,-1
NLD,Netherlands,LBY,Libya,2011,22,32,-10
NLD,Netherlands,LBY,Libya,2012,23,20,3
NLD,Netherlands,LBY,Libya,2013,21,26,-5
NLD,Netherlands,LBY,Libya,2014,22,53,-31
NLD,Netherlands,LBY,Libya,2015,6,57,-51
NLD,Netherlands,LBY,Libya,2016,32,48,-16
NLD,Netherlands,LBY,Libya,2017,15,48,-33
NZL,New Zealand,LBY,Libya,2008,0,0,0
NZL,New Zealand,LBY,Libya,2010,0,4,-4
NZL,New Zealand,LBY,Libya,2011,1,3,-2
NZL,New Zealand,LBY,Libya,2012,2,3,-1
NZL,New Zealand,LBY,Libya,2013,0,12,-12
NZL,New Zealand,LBY,Libya,2014,7,11,-4
NZL,New Zealand,LBY,Libya,2015,6,2,4
NZL,New Zealand,LBY,Libya,2016,0,9,-9
NZL,New Zealand,LBY,Libya,2017,0,4,-4
NOR,Norway,LBY,Libya,2008,0,20,-20
NOR,Norway,LBY,Libya,2009,4,8,-4
NOR,Norway,LBY,Libya,2010,9,14,-5
NOR,Norway,LBY,Libya,2011,6,34,-28
NOR,Norway,LBY,Libya,2012,28,23,5
NOR,Norway,LBY,Libya,2013,10,16,-6
NOR,Norway,LBY,Libya,2014,7,8,-1
NOR,Norway,LBY,Libya,2015,5,31,-26
NOR,Norway,LBY,Libya,2016,12,23,-11
NOR,Norway,LBY,Libya,2017,6,25,-19
POL,Poland,LBY,Libya,2008,0,57,-57
POL,Poland,LBY,Libya,2009,0,63,-63
POL,Poland,LBY,Libya,2010,0,56,-56
POL,Poland,LBY,Libya,2011,0,55,-55
POL,Poland,LBY,Libya,2012,0,52,-52
POL,Poland,LBY,Libya,2013,0,71,-71
POL,Poland,LBY,Libya,2014,0,95,-95
POL,Poland,LBY,Libya,2015,0,271,-271
POL,Poland,LBY,Libya,2016,0,222,-222
POL,Poland,LBY,Libya,2017,0,168,-168
SVK,Slovak Republic,LBY,Libya,2008,12,47,-35
SVK,Slovak Republic,LBY,Libya,2009,21,99,-78
SVK,Slovak Republic,LBY,Libya,2010,8,103,-95
SVK,Slovak Republic,LBY,Libya,2011,4,2,2
SVK,Slovak Republic,LBY,Libya,2013,0,2,-2
SVK,Slovak Republic,LBY,Libya,2014,0,2,-2
SVK,Slovak Republic,LBY,Libya,2015,0,5,-5
SVK,Slovak Republic,LBY,Libya,2016,0,1,-1
SVK,Slovak Republic,LBY,Libya,2017,0,17,-17
ESP,Spain,LBY,Libya,2008,42,33,9
ESP,Spain,LBY,Libya,2009,37,44,-7
ESP,Spain,LBY,Libya,2010,31,60,-29
ESP,Spain,LBY,Libya,2011,54,115,-61
ESP,Spain,LBY,Libya,2012,34,79,-45
ESP,Spain,LBY,Libya,2013,47,152,-105
ESP,Spain,LBY,Libya,2014,39,286,-247
ESP,Spain,LBY,Libya,2015,69,367,-298
ESP,Spain,LBY,Libya,2016,102,207,-105
ESP,Spain,LBY,Libya,2017,159,244,-85
SWE,Sweden,LBY,Libya,2008,13,117,-104
SWE,Sweden,LBY,Libya,2009,11,145,-134
SWE,Sweden,LBY,Libya,2010,6,126,-120
SWE,Sweden,LBY,Libya,2011,28,215,-187
SWE,Sweden,LBY,Libya,2012,61,124,-63
SWE,Sweden,LBY,Libya,2013,36,91,-55
SWE,Sweden,LBY,Libya,2014,50,88,-38
SWE,Sweden,LBY,Libya,2015,52,107,-55
SWE,Sweden,LBY,Libya,2016,23,143,-120
SWE,Sweden,LBY,Libya,2017,9,71,-62
CHE,Switzerland,LBY,Libya,2010,28,16,12
CHE,Switzerland,LBY,Libya,2011,13,25,-12
CHE,Switzerland,LBY,Libya,2012,49,30,19
CHE,Switzerland,LBY,Libya,2013,27,27,0
CHE,Switzerland,LBY,Libya,2014,19,36,-17
CHE,Switzerland,LBY,Libya,2015,11,49,-38
CHE,Switzerland,LBY,Libya,2016,11,29,-18
CHE,Switzerland,LBY,Libya,2017,11,39,-28
TUR,Turkey,LBY,Libya,2010,0,34,-34
TUR,Turkey,LBY,Libya,2016,5197,4344,853
TUR,Turkey,LBY,Libya,2017,3032,6029,-2997
GBR,United Kingdom,LBY,Libya,2012,0,3000,-3000
GBR,United Kingdom,LBY,Libya,2013,0,6000,-6000
GBR,United Kingdom,LBY,Libya,2014,0,2000,-2000
USA,United States,LBY,Libya,2008,0,285,-285
USA,United States,LBY,Libya,2009,0,296,-296
USA,United States,LBY,Libya,2010,0,355,-355
USA,United States,LBY,Libya,2011,0,357,-357
USA,United States,LBY,Libya,2012,0,315,-315
USA,United States,LBY,Libya,2013,0,376,-376
USA,United States,LBY,Libya,2014,0,524,-524
USA,United States,LBY,Libya,2015,0,734,-734
USA,United States,LBY,Libya,2016,0,642,-642
USA,United States,LBY,Libya,2017,0,780,-780
CHL,Chile,LBY,Libya,2008,0,0,0
CHL,Chile,LBY,Libya,2009,0,0,0
CHL,Chile,LBY,Libya,2010,0,1,-1
CHL,Chile,LBY,Libya,2011,0,0,0
CHL,Chile,LBY,Libya,2012,0,0,0
CHL,Chile,LBY,Libya,2013,0,1,-1
CHL,Chile,LBY,Libya,2014,0,0,0
CHL,Chile,LBY,Libya,2015,0,1,-1
CHL,Chile,LBY,Libya,2016,0,1,-1
EST,Estonia,LBY,Libya,2008,0,0,0
EST,Estonia,LBY,Libya,2009,0,0,0
EST,Estonia,LBY,Libya,2010,0,0,0
EST,Estonia,LBY,Libya,2011,0,0,0
EST,Estonia,LBY,Libya,2012,0,0,0
EST,Estonia,LBY,Libya,2013,0,0,0
EST,Estonia,LBY,Libya,2014,0,0,0
EST,Estonia,LBY,Libya,2015,0,0,0
EST,Estonia,LBY,Libya,2016,0,0,0
EST,Estonia,LBY,Libya,2017,0,0,0
SVN,Slovenia,LBY,Libya,2008,0,1,-1
SVN,Slovenia,LBY,Libya,2009,0,1,-1
SVN,Slovenia,LBY,Libya,2011,0,28,-28
SVN,Slovenia,LBY,Libya,2013,0,2,-2
SVN,Slovenia,LBY,Libya,2014,0,12,-12
SVN,Slovenia,LBY,Libya,2015,0,6,-6
SVN,Slovenia,LBY,Libya,2016,0,15,-15
SVN,Slovenia,LBY,Libya,2017,1,7,-6
AUS,Australia,LIE,Liechtenstein,2008,0,1,-1
AUS,Australia,LIE,Liechtenstein,2009,0,2,-2
AUS,Australia,LIE,Liechtenstein,2010,0,0,0
AUS,Australia,LIE,Liechtenstein,2011,0,0,0
AUS,Australia,LIE,Liechtenstein,2012,0,2,-2
AUS,Australia,LIE,Liechtenstein,2013,0,1,-1
AUS,Australia,LIE,Liechtenstein,2014,0,0,0
AUS,Australia,LIE,Liechtenstein,2015,0,0,0
AUS,Australia,LIE,Liechtenstein,2016,0,0,0
AUS,Australia,LIE,Liechtenstein,2017,0,0,0
AUT,Austria,LIE,Liechtenstein,2008,15,24,-9
AUT,Austria,LIE,Liechtenstein,2009,15,29,-14
AUT,Austria,LIE,Liechtenstein,2010,10,22,-12
AUT,Austria,LIE,Liechtenstein,2011,14,12,2
AUT,Austria,LIE,Liechtenstein,2012,17,19,-2
AUT,Austria,LIE,Liechtenstein,2013,29,24,5
AUT,Austria,LIE,Liechtenstein,2014,12,26,-14
AUT,Austria,LIE,Liechtenstein,2015,19,36,-17
AUT,Austria,LIE,Liechtenstein,2016,11,32,-21
AUT,Austria,LIE,Liechtenstein,2017,18,28,-10
BEL,Belgium,LIE,Liechtenstein,2008,0,1,-1
BEL,Belgium,LIE,Liechtenstein,2009,0,5,-5
BEL,Belgium,LIE,Liechtenstein,2010,1,1,0
BEL,Belgium,LIE,Liechtenstein,2012,6,3,3
BEL,Belgium,LIE,Liechtenstein,2014,3,1,2
BEL,Belgium,LIE,Liechtenstein,2015,2,1,1
BEL,Belgium,LIE,Liechtenstein,2016,0,2,-2
BEL,Belgium,LIE,Liechtenstein,2017,0,3,-3
CAN,Canada,LIE,Liechtenstein,2008,0,1,-1
CAN,Canada,LIE,Liechtenstein,2009,0,1,-1
CAN,Canada,LIE,Liechtenstein,2010,0,0,0
CAN,Canada,LIE,Liechtenstein,2011,0,2,-2
CAN,Canada,LIE,Liechtenstein,2012,0,1,-1
CAN,Canada,LIE,Liechtenstein,2013,0,0,0
CAN,Canada,LIE,Liechtenstein,2014,0,0,0
CAN,Canada,LIE,Liechtenstein,2015,0,0,0
CAN,Canada,LIE,Liechtenstein,2016,0,0,0
CAN,Canada,LIE,Liechtenstein,2017,0,0,0
CZE,Czech Republic,LIE,Liechtenstein,2010,0,4,-4
DNK,Denmark,LIE,Liechtenstein,2008,3,0,3
DNK,Denmark,LIE,Liechtenstein,2009,1,0,1
DNK,Denmark,LIE,Liechtenstein,2010,7,1,6
DNK,Denmark,LIE,Liechtenstein,2012,0,1,-1
DNK,Denmark,LIE,Liechtenstein,2013,2,0,2
DNK,Denmark,LIE,Liechtenstein,2014,1,2,-1
DNK,Denmark,LIE,Liechtenstein,2015,3,2,1
DNK,Denmark,LIE,Liechtenstein,2016,0,1,-1
DNK,Denmark,LIE,Liechtenstein,2017,1,3,-2
FIN,Finland,LIE,Liechtenstein,2008,0,0,0
FIN,Finland,LIE,Liechtenstein,2009,0,0,0
FIN,Finland,LIE,Liechtenstein,2010,0,0,0
FIN,Finland,LIE,Liechtenstein,2011,0,0,0
FIN,Finland,LIE,Liechtenstein,2012,0,1,-1
FIN,Finland,LIE,Liechtenstein,2013,0,0,0
FIN,Finland,LIE,Liechtenstein,2014,1,1,0
FIN,Finland,LIE,Liechtenstein,2015,0,0,0
FIN,Finland,LIE,Liechtenstein,2016,0,0,0
FIN,Finland,LIE,Liechtenstein,2017,0,0,0
FRA,France,LIE,Liechtenstein,2008,0,0,0
FRA,France,LIE,Liechtenstein,2009,0,0,0
FRA,France,LIE,Liechtenstein,2010,0,0,0
FRA,France,LIE,Liechtenstein,2011,0,0,0
FRA,France,LIE,Liechtenstein,2012,0,0,0
FRA,France,LIE,Liechtenstein,2013,0,0,0
FRA,France,LIE,Liechtenstein,2014,0,0,0
FRA,France,LIE,Liechtenstein,2015,0,0,0
FRA,France,LIE,Liechtenstein,2016,0,0,0
FRA,France,LIE,Liechtenstein,2017,0,0,0
DEU,Germany,LIE,Liechtenstein,2008,22,22,0
DEU,Germany,LIE,Liechtenstein,2009,29,23,6
DEU,Germany,LIE,Liechtenstein,2010,17,38,-21
DEU,Germany,LIE,Liechtenstein,2011,16,30,-14
DEU,Germany,LIE,Liechtenstein,2012,22,33,-11
DEU,Germany,LIE,Liechtenstein,2013,20,38,-18
DEU,Germany,LIE,Liechtenstein,2014,24,32,-8
DEU,Germany,LIE,Liechtenstein,2015,35,40,-5
DEU,Germany,LIE,Liechtenstein,2016,20,24,-4
DEU,Germany,LIE,Liechtenstein,2017,28,38,-10
HUN,Hungary,LIE,Liechtenstein,2008,0,0,0
HUN,Hungary,LIE,Liechtenstein,2009,0,0,0
HUN,Hungary,LIE,Liechtenstein,2010,0,0,0
HUN,Hungary,LIE,Liechtenstein,2011,0,0,0
HUN,Hungary,LIE,Liechtenstein,2012,0,1,-1
HUN,Hungary,LIE,Liechtenstein,2013,0,2,-2
HUN,Hungary,LIE,Liechtenstein,2014,0,0,0
HUN,Hungary,LIE,Liechtenstein,2015,0,3,-3
HUN,Hungary,LIE,Liechtenstein,2016,0,0,0
HUN,Hungary,LIE,Liechtenstein,2017,0,0,0
ISL,Iceland,LIE,Liechtenstein,2008,0,0,0
ISL,Iceland,LIE,Liechtenstein,2009,0,0,0
ISL,Iceland,LIE,Liechtenstein,2010,0,0,0
ISL,Iceland,LIE,Liechtenstein,2011,0,0,0
ISL,Iceland,LIE,Liechtenstein,2012,0,0,0
ISL,Iceland,LIE,Liechtenstein,2013,0,1,-1
ISL,Iceland,LIE,Liechtenstein,2014,0,1,-1
ISL,Iceland,LIE,Liechtenstein,2015,0,0,0
ISL,Iceland,LIE,Liechtenstein,2016,1,0,1
ISL,Iceland,LIE,Liechtenstein,2017,0,0,0
ITA,Italy,LIE,Liechtenstein,2008,0,14,-14
ITA,Italy,LIE,Liechtenstein,2009,0,7,-7
ITA,Italy,LIE,Liechtenstein,2010,2,7,-5
ITA,Italy,LIE,Liechtenstein,2011,1,1,0
ITA,Italy,LIE,Liechtenstein,2012,0,6,-6
ITA,Italy,LIE,Liechtenstein,2013,0,2,-2
ITA,Italy,LIE,Liechtenstein,2015,0,247,-247
ITA,Italy,LIE,Liechtenstein,2016,0,8,-8
ITA,Italy,LIE,Liechtenstein,2017,10,4,6
JPN,Japan,LIE,Liechtenstein,2008,1,3,-2
JPN,Japan,LIE,Liechtenstein,2009,4,0,4
JPN,Japan,LIE,Liechtenstein,2010,1,1,0
JPN,Japan,LIE,Liechtenstein,2011,4,3,1
JPN,Japan,LIE,Liechtenstein,2012,5,7,-2
JPN,Japan,LIE,Liechtenstein,2013,2,3,-1
JPN,Japan,LIE,Liechtenstein,2014,5,3,2
JPN,Japan,LIE,Liechtenstein,2015,3,5,-2
JPN,Japan,LIE,Liechtenstein,2016,3,3,0
JPN,Japan,LIE,Liechtenstein,2017,4,3,1
KOR,Korea,LIE,Liechtenstein,2008,1,0,1
KOR,Korea,LIE,Liechtenstein,2009,0,0,0
KOR,Korea,LIE,Liechtenstein,2010,1,0,1
KOR,Korea,LIE,Liechtenstein,2011,1,0,1
KOR,Korea,LIE,Liechtenstein,2012,0,0,0
KOR,Korea,LIE,Liechtenstein,2013,0,0,0
KOR,Korea,LIE,Liechtenstein,2014,0,0,0
KOR,Korea,LIE,Liechtenstein,2015,1,2,-1
KOR,Korea,LIE,Liechtenstein,2016,0,0,0
KOR,Korea,LIE,Liechtenstein,2017,2,1,1
LUX,Luxembourg,LIE,Liechtenstein,2008,0,1,-1
LUX,Luxembourg,LIE,Liechtenstein,2009,0,0,0
LUX,Luxembourg,LIE,Liechtenstein,2010,0,0,0
LUX,Luxembourg,LIE,Liechtenstein,2011,0,1,-1
LUX,Luxembourg,LIE,Liechtenstein,2012,1,1,0
LUX,Luxembourg,LIE,Liechtenstein,2013,0,0,0
LUX,Luxembourg,LIE,Liechtenstein,2014,1,0,1
LUX,Luxembourg,LIE,Liechtenstein,2015,0,0,0
LUX,Luxembourg,LIE,Liechtenstein,2016,0,1,-1
LUX,Luxembourg,LIE,Liechtenstein,2017,0,0,0
MEX,Mexico,LIE,Liechtenstein,2011,0,1,-1
MEX,Mexico,LIE,Liechtenstein,2012,0,1,-1
MEX,Mexico,LIE,Liechtenstein,2013,0,1,-1
MEX,Mexico,LIE,Liechtenstein,2014,0,1,-1
MEX,Mexico,LIE,Liechtenstein,2015,0,1,-1
MEX,Mexico,LIE,Liechtenstein,2016,0,1,-1
MEX,Mexico,LIE,Liechtenstein,2017,0,1,-1
NLD,Netherlands,LIE,Liechtenstein,2008,0,2,-2
NLD,Netherlands,LIE,Liechtenstein,2009,2,5,-3
NLD,Netherlands,LIE,Liechtenstein,2010,2,2,0
NLD,Netherlands,LIE,Liechtenstein,2011,3,2,1
NLD,Netherlands,LIE,Liechtenstein,2012,5,1,4
NLD,Netherlands,LIE,Liechtenstein,2013,0,1,-1
NLD,Netherlands,LIE,Liechtenstein,2014,2,2,0
NLD,Netherlands,LIE,Liechtenstein,2015,4,3,1
NLD,Netherlands,LIE,Liechtenstein,2016,2,6,-4
NLD,Netherlands,LIE,Liechtenstein,2017,3,3,0
NZL,New Zealand,LIE,Liechtenstein,2008,0,0,0
NZL,New Zealand,LIE,Liechtenstein,2009,0,1,-1
NZL,New Zealand,LIE,Liechtenstein,2010,0,1,-1
NZL,New Zealand,LIE,Liechtenstein,2012,0,0,0
NZL,New Zealand,LIE,Liechtenstein,2016,0,1,-1
NOR,Norway,LIE,Liechtenstein,2008,3,0,3
NOR,Norway,LIE,Liechtenstein,2009,0,1,-1
NOR,Norway,LIE,Liechtenstein,2010,1,2,-1
NOR,Norway,LIE,Liechtenstein,2011,1,0,1
NOR,Norway,LIE,Liechtenstein,2012,1,0,1
NOR,Norway,LIE,Liechtenstein,2013,1,0,1
NOR,Norway,LIE,Liechtenstein,2014,0,0,0
NOR,Norway,LIE,Liechtenstein,2015,0,0,0
NOR,Norway,LIE,Liechtenstein,2016,0,1,-1
NOR,Norway,LIE,Liechtenstein,2017,0,0,0
POL,Poland,LIE,Liechtenstein,2009,0,0,0
POL,Poland,LIE,Liechtenstein,2010,0,0,0
POL,Poland,LIE,Liechtenstein,2011,0,0,0
POL,Poland,LIE,Liechtenstein,2012,0,0,0
POL,Poland,LIE,Liechtenstein,2013,0,0,0
POL,Poland,LIE,Liechtenstein,2014,0,0,0
POL,Poland,LIE,Liechtenstein,2015,0,1,-1
POL,Poland,LIE,Liechtenstein,2016,0,1,-1
POL,Poland,LIE,Liechtenstein,2017,0,0,0
SVK,Slovak Republic,LIE,Liechtenstein,2008,0,0,0
SVK,Slovak Republic,LIE,Liechtenstein,2010,0,1,-1
ESP,Spain,LIE,Liechtenstein,2008,3,7,-4
ESP,Spain,LIE,Liechtenstein,2009,1,0,1
ESP,Spain,LIE,Liechtenstein,2010,9,6,3
ESP,Spain,LIE,Liechtenstein,2011,8,0,8
ESP,Spain,LIE,Liechtenstein,2012,0,6,-6
ESP,Spain,LIE,Liechtenstein,2013,0,2,-2
ESP,Spain,LIE,Liechtenstein,2014,3,7,-4
ESP,Spain,LIE,Liechtenstein,2015,2,4,-2
ESP,Spain,LIE,Liechtenstein,2016,1,3,-2
ESP,Spain,LIE,Liechtenstein,2017,1,7,-6
SWE,Sweden,LIE,Liechtenstein,2008,0,1,-1
SWE,Sweden,LIE,Liechtenstein,2009,0,2,-2
SWE,Sweden,LIE,Liechtenstein,2010,1,2,-1
SWE,Sweden,LIE,Liechtenstein,2011,0,3,-3
SWE,Sweden,LIE,Liechtenstein,2012,1,0,1
SWE,Sweden,LIE,Liechtenstein,2013,0,2,-2
SWE,Sweden,LIE,Liechtenstein,2014,1,2,-1
SWE,Sweden,LIE,Liechtenstein,2015,4,0,4
SWE,Sweden,LIE,Liechtenstein,2016,1,1,0
SWE,Sweden,LIE,Liechtenstein,2017,1,1,0
CHE,Switzerland,LIE,Liechtenstein,2008,76,118,-42
CHE,Switzerland,LIE,Liechtenstein,2009,88,116,-28
CHE,Switzerland,LIE,Liechtenstein,2010,83,118,-35
CHE,Switzerland,LIE,Liechtenstein,2011,79,100,-21
CHE,Switzerland,LIE,Liechtenstein,2012,61,107,-46
CHE,Switzerland,LIE,Liechtenstein,2013,71,138,-67
CHE,Switzerland,LIE,Liechtenstein,2014,70,103,-33
CHE,Switzerland,LIE,Liechtenstein,2015,66,110,-44
CHE,Switzerland,LIE,Liechtenstein,2016,69,108,-39
CHE,Switzerland,LIE,Liechtenstein,2017,73,82,-9
USA,United States,LIE,Liechtenstein,2010,0,3,-3
USA,United States,LIE,Liechtenstein,2011,0,3,-3
CHL,Chile,LIE,Liechtenstein,2008,0,1,-1
CHL,Chile,LIE,Liechtenstein,2009,0,0,0
CHL,Chile,LIE,Liechtenstein,2010,0,0,0
CHL,Chile,LIE,Liechtenstein,2011,0,0,0
CHL,Chile,LIE,Liechtenstein,2012,0,0,0
CHL,Chile,LIE,Liechtenstein,2013,0,0,0
CHL,Chile,LIE,Liechtenstein,2014,0,0,0
CHL,Chile,LIE,Liechtenstein,2015,0,0,0
CHL,Chile,LIE,Liechtenstein,2016,0,0,0
EST,Estonia,LIE,Liechtenstein,2008,0,0,0
EST,Estonia,LIE,Liechtenstein,2009,0,0,0
EST,Estonia,LIE,Liechtenstein,2010,0,0,0
EST,Estonia,LIE,Liechtenstein,2011,0,0,0
EST,Estonia,LIE,Liechtenstein,2012,0,0,0
EST,Estonia,LIE,Liechtenstein,2013,0,0,0
EST,Estonia,LIE,Liechtenstein,2014,0,0,0
EST,Estonia,LIE,Liechtenstein,2015,0,0,0
EST,Estonia,LIE,Liechtenstein,2016,0,0,0
EST,Estonia,LIE,Liechtenstein,2017,0,0,0
SVN,Slovenia,LIE,Liechtenstein,2008,0,3,-3
SVN,Slovenia,LIE,Liechtenstein,2009,0,1,-1
SVN,Slovenia,LIE,Liechtenstein,2014,0,3,-3
AUS,Australia,LTU,Lithuania,2008,16,35,-19
AUS,Australia,LTU,Lithuania,2009,15,36,-21
AUS,Australia,LTU,Lithuania,2010,5,59,-54
AUS,Australia,LTU,Lithuania,2011,6,42,-36
AUS,Australia,LTU,Lithuania,2012,10,79,-69
AUS,Australia,LTU,Lithuania,2013,9,67,-58
AUS,Australia,LTU,Lithuania,2014,9,65,-56
AUS,Australia,LTU,Lithuania,2015,0,75,-75
AUS,Australia,LTU,Lithuania,2016,0,71,-71
AUS,Australia,LTU,Lithuania,2017,0,79,-79
AUT,Austria,LTU,Lithuania,2008,145,188,-43
AUT,Austria,LTU,Lithuania,2009,146,224,-78
AUT,Austria,LTU,Lithuania,2010,159,276,-117
AUT,Austria,LTU,Lithuania,2011,189,313,-124
AUT,Austria,LTU,Lithuania,2012,178,292,-114
AUT,Austria,LTU,Lithuania,2013,175,260,-85
AUT,Austria,LTU,Lithuania,2014,186,252,-66
AUT,Austria,LTU,Lithuania,2015,173,258,-85
AUT,Austria,LTU,Lithuania,2016,176,247,-71
AUT,Austria,LTU,Lithuania,2017,185,281,-96
BEL,Belgium,LTU,Lithuania,2008,140,326,-186
BEL,Belgium,LTU,Lithuania,2009,169,312,-143
BEL,Belgium,LTU,Lithuania,2010,208,416,-208
BEL,Belgium,LTU,Lithuania,2011,197,408,-211
BEL,Belgium,LTU,Lithuania,2012,215,443,-228
BEL,Belgium,LTU,Lithuania,2013,258,362,-104
BEL,Belgium,LTU,Lithuania,2014,228,252,-24
BEL,Belgium,LTU,Lithuania,2015,183,249,-66
BEL,Belgium,LTU,Lithuania,2016,114,230,-116
BEL,Belgium,LTU,Lithuania,2017,97,333,-236
CAN,Canada,LTU,Lithuania,2008,0,109,-109
CAN,Canada,LTU,Lithuania,2009,0,63,-63
CAN,Canada,LTU,Lithuania,2010,0,57,-57
CAN,Canada,LTU,Lithuania,2011,0,52,-52
CAN,Canada,LTU,Lithuania,2012,0,77,-77
CAN,Canada,LTU,Lithuania,2013,0,145,-145
CAN,Canada,LTU,Lithuania,2014,0,154,-154
CAN,Canada,LTU,Lithuania,2015,0,133,-133
CAN,Canada,LTU,Lithuania,2016,0,190,-190
CAN,Canada,LTU,Lithuania,2017,0,140,-140
CZE,Czech Republic,LTU,Lithuania,2008,6,50,-44
CZE,Czech Republic,LTU,Lithuania,2009,16,50,-34
CZE,Czech Republic,LTU,Lithuania,2010,30,38,-8
CZE,Czech Republic,LTU,Lithuania,2011,6,30,-24
CZE,Czech Republic,LTU,Lithuania,2012,3,56,-53
CZE,Czech Republic,LTU,Lithuania,2013,8,48,-40
CZE,Czech Republic,LTU,Lithuania,2014,6,47,-41
CZE,Czech Republic,LTU,Lithuania,2015,14,36,-22
CZE,Czech Republic,LTU,Lithuania,2016,8,39,-31
CZE,Czech Republic,LTU,Lithuania,2017,16,49,-33
DNK,Denmark,LTU,Lithuania,2008,602,1086,-484
DNK,Denmark,LTU,Lithuania,2009,559,1265,-706
DNK,Denmark,LTU,Lithuania,2010,615,1486,-871
DNK,Denmark,LTU,Lithuania,2011,741,1576,-835
DNK,Denmark,LTU,Lithuania,2012,965,1509,-544
DNK,Denmark,LTU,Lithuania,2013,936,1448,-512
DNK,Denmark,LTU,Lithuania,2014,1070,1471,-401
DNK,Denmark,LTU,Lithuania,2015,979,1505,-526
DNK,Denmark,LTU,Lithuania,2016,1357,1692,-335
DNK,Denmark,LTU,Lithuania,2017,1375,1917,-542
FIN,Finland,LTU,Lithuania,2008,18,94,-76
FIN,Finland,LTU,Lithuania,2009,32,66,-34
FIN,Finland,LTU,Lithuania,2010,16,143,-127
FIN,Finland,LTU,Lithuania,2011,14,121,-107
FIN,Finland,LTU,Lithuania,2012,42,175,-133
FIN,Finland,LTU,Lithuania,2013,27,164,-137
FIN,Finland,LTU,Lithuania,2014,42,154,-112
FIN,Finland,LTU,Lithuania,2015,35,160,-125
FIN,Finland,LTU,Lithuania,2016,38,131,-93
FIN,Finland,LTU,Lithuania,2017,62,180,-118
FRA,France,LTU,Lithuania,2008,0,0,0
FRA,France,LTU,Lithuania,2009,0,0,0
FRA,France,LTU,Lithuania,2010,0,0,0
FRA,France,LTU,Lithuania,2011,0,0,0
FRA,France,LTU,Lithuania,2012,0,0,0
FRA,France,LTU,Lithuania,2013,0,263,-263
FRA,France,LTU,Lithuania,2014,0,305,-305
FRA,France,LTU,Lithuania,2015,0,214,-214
FRA,France,LTU,Lithuania,2016,0,210,-210
FRA,France,LTU,Lithuania,2017,0,229,-229
DEU,Germany,LTU,Lithuania,2008,3152,3453,-301
DEU,Germany,LTU,Lithuania,2009,3282,4647,-1365
DEU,Germany,LTU,Lithuania,2010,3797,6134,-2337
DEU,Germany,LTU,Lithuania,2011,4862,10075,-5213
DEU,Germany,LTU,Lithuania,2012,5340,10226,-4886
DEU,Germany,LTU,Lithuania,2013,5988,9271,-3283
DEU,Germany,LTU,Lithuania,2014,6311,8584,-2273
DEU,Germany,LTU,Lithuania,2015,5822,9798,-3976
DEU,Germany,LTU,Lithuania,2016,6778,9595,-2817
DEU,Germany,LTU,Lithuania,2017,6090,10209,-4119
HUN,Hungary,LTU,Lithuania,2008,6,15,-9
HUN,Hungary,LTU,Lithuania,2009,4,15,-11
HUN,Hungary,LTU,Lithuania,2010,3,27,-24
HUN,Hungary,LTU,Lithuania,2011,0,25,-25
HUN,Hungary,LTU,Lithuania,2012,1,24,-23
HUN,Hungary,LTU,Lithuania,2013,10,33,-23
HUN,Hungary,LTU,Lithuania,2014,7,34,-27
HUN,Hungary,LTU,Lithuania,2015,11,29,-18
HUN,Hungary,LTU,Lithuania,2016,18,42,-24
HUN,Hungary,LTU,Lithuania,2017,0,33,-33
ISL,Iceland,LTU,Lithuania,2008,222,427,-205
ISL,Iceland,LTU,Lithuania,2009,387,236,151
ISL,Iceland,LTU,Lithuania,2010,197,252,-55
ISL,Iceland,LTU,Lithuania,2011,205,173,32
ISL,Iceland,LTU,Lithuania,2012,180,143,37
ISL,Iceland,LTU,Lithuania,2013,120,166,-46
ISL,Iceland,LTU,Lithuania,2014,149,177,-28
ISL,Iceland,LTU,Lithuania,2015,142,273,-131
ISL,Iceland,LTU,Lithuania,2016,197,674,-477
ISL,Iceland,LTU,Lithuania,2017,248,1295,-1047
ITA,Italy,LTU,Lithuania,2008,35,720,-685
ITA,Italy,LTU,Lithuania,2009,42,611,-569
ITA,Italy,LTU,Lithuania,2010,47,529,-482
ITA,Italy,LTU,Lithuania,2011,44,492,-448
ITA,Italy,LTU,Lithuania,2012,63,438,-375
ITA,Italy,LTU,Lithuania,2013,67,368,-301
ITA,Italy,LTU,Lithuania,2014,72,284,-212
ITA,Italy,LTU,Lithuania,2015,84,247,-163
ITA,Italy,LTU,Lithuania,2016,0,247,-247
ITA,Italy,LTU,Lithuania,2017,58,281,-223
JPN,Japan,LTU,Lithuania,2008,71,74,-3
JPN,Japan,LTU,Lithuania,2009,144,160,-16
JPN,Japan,LTU,Lithuania,2010,177,177,0
JPN,Japan,LTU,Lithuania,2011,92,95,-3
JPN,Japan,LTU,Lithuania,2012,126,146,-20
JPN,Japan,LTU,Lithuania,2013,100,110,-10
JPN,Japan,LTU,Lithuania,2014,117,138,-21
JPN,Japan,LTU,Lithuania,2015,141,457,-316
JPN,Japan,LTU,Lithuania,2016,154,243,-89
JPN,Japan,LTU,Lithuania,2017,193,183,10
KOR,Korea,LTU,Lithuania,2008,15,14,1
KOR,Korea,LTU,Lithuania,2009,26,25,1
KOR,Korea,LTU,Lithuania,2010,42,57,-15
KOR,Korea,LTU,Lithuania,2011,44,37,7
KOR,Korea,LTU,Lithuania,2012,54,52,2
KOR,Korea,LTU,Lithuania,2013,59,57,2
KOR,Korea,LTU,Lithuania,2014,46,53,-7
KOR,Korea,LTU,Lithuania,2015,57,50,7
KOR,Korea,LTU,Lithuania,2016,52,54,-2
KOR,Korea,LTU,Lithuania,2017,57,43,14
LUX,Luxembourg,LTU,Lithuania,2008,29,89,-60
LUX,Luxembourg,LTU,Lithuania,2009,16,66,-50
LUX,Luxembourg,LTU,Lithuania,2010,21,61,-40
LUX,Luxembourg,LTU,Lithuania,2011,23,81,-58
LUX,Luxembourg,LTU,Lithuania,2012,36,61,-25
LUX,Luxembourg,LTU,Lithuania,2013,41,69,-28
LUX,Luxembourg,LTU,Lithuania,2014,35,98,-63
LUX,Luxembourg,LTU,Lithuania,2015,26,139,-113
LUX,Luxembourg,LTU,Lithuania,2016,96,109,-13
LUX,Luxembourg,LTU,Lithuania,2017,47,83,-36
MEX,Mexico,LTU,Lithuania,2008,0,1,-1
MEX,Mexico,LTU,Lithuania,2009,0,2,-2
MEX,Mexico,LTU,Lithuania,2010,0,7,-7
MEX,Mexico,LTU,Lithuania,2011,0,10,-10
MEX,Mexico,LTU,Lithuania,2012,0,4,-4
MEX,Mexico,LTU,Lithuania,2013,0,22,-22
MEX,Mexico,LTU,Lithuania,2014,0,9,-9
MEX,Mexico,LTU,Lithuania,2015,0,12,-12
MEX,Mexico,LTU,Lithuania,2016,0,10,-10
MEX,Mexico,LTU,Lithuania,2017,0,10,-10
NLD,Netherlands,LTU,Lithuania,2008,193,491,-298
NLD,Netherlands,LTU,Lithuania,2009,263,640,-377
NLD,Netherlands,LTU,Lithuania,2010,334,1087,-753
NLD,Netherlands,LTU,Lithuania,2011,491,1316,-825
NLD,Netherlands,LTU,Lithuania,2012,718,1196,-478
NLD,Netherlands,LTU,Lithuania,2013,907,1254,-347
NLD,Netherlands,LTU,Lithuania,2014,844,1109,-265
NLD,Netherlands,LTU,Lithuania,2015,754,1124,-370
NLD,Netherlands,LTU,Lithuania,2016,754,1225,-471
NLD,Netherlands,LTU,Lithuania,2017,780,1568,-788
NZL,New Zealand,LTU,Lithuania,2008,5,10,-5
NZL,New Zealand,LTU,Lithuania,2009,3,10,-7
NZL,New Zealand,LTU,Lithuania,2010,5,10,-5
NZL,New Zealand,LTU,Lithuania,2011,3,10,-7
NZL,New Zealand,LTU,Lithuania,2012,2,16,-14
NZL,New Zealand,LTU,Lithuania,2013,8,19,-11
NZL,New Zealand,LTU,Lithuania,2014,4,17,-13
NZL,New Zealand,LTU,Lithuania,2015,3,17,-14
NZL,New Zealand,LTU,Lithuania,2016,5,10,-5
NZL,New Zealand,LTU,Lithuania,2017,7,93,-86
NOR,Norway,LTU,Lithuania,2008,465,2851,-2386
NOR,Norway,LTU,Lithuania,2009,567,3196,-2629
NOR,Norway,LTU,Lithuania,2010,785,6552,-5767
NOR,Norway,LTU,Lithuania,2011,468,7743,-7275
NOR,Norway,LTU,Lithuania,2012,563,6600,-6037
NOR,Norway,LTU,Lithuania,2013,1172,5573,-4401
NOR,Norway,LTU,Lithuania,2014,1413,4444,-3031
NOR,Norway,LTU,Lithuania,2015,1897,3309,-1412
NOR,Norway,LTU,Lithuania,2016,2445,2522,-77
NOR,Norway,LTU,Lithuania,2017,2197,2742,-545
POL,Poland,LTU,Lithuania,2008,0,162,-162
POL,Poland,LTU,Lithuania,2009,0,191,-191
POL,Poland,LTU,Lithuania,2010,0,212,-212
POL,Poland,LTU,Lithuania,2011,0,188,-188
POL,Poland,LTU,Lithuania,2012,0,213,-213
POL,Poland,LTU,Lithuania,2013,0,243,-243
POL,Poland,LTU,Lithuania,2014,0,242,-242
POL,Poland,LTU,Lithuania,2015,0,249,-249
POL,Poland,LTU,Lithuania,2016,0,259,-259
POL,Poland,LTU,Lithuania,2017,0,248,-248
SVK,Slovak Republic,LTU,Lithuania,2008,7,13,-6
SVK,Slovak Republic,LTU,Lithuania,2009,1,17,-16
SVK,Slovak Republic,LTU,Lithuania,2010,2,11,-9
SVK,Slovak Republic,LTU,Lithuania,2011,3,19,-16
SVK,Slovak Republic,LTU,Lithuania,2012,0,11,-11
SVK,Slovak Republic,LTU,Lithuania,2013,3,9,-6
SVK,Slovak Republic,LTU,Lithuania,2014,0,10,-10
SVK,Slovak Republic,LTU,Lithuania,2015,0,19,-19
SVK,Slovak Republic,LTU,Lithuania,2016,1,11,-10
SVK,Slovak Republic,LTU,Lithuania,2017,0,15,-15
ESP,Spain,LTU,Lithuania,2008,1356,1111,245
ESP,Spain,LTU,Lithuania,2009,1702,1156,546
ESP,Spain,LTU,Lithuania,2010,1536,1307,229
ESP,Spain,LTU,Lithuania,2011,1269,1085,184
ESP,Spain,LTU,Lithuania,2012,1394,864,530
ESP,Spain,LTU,Lithuania,2013,1554,793,761
ESP,Spain,LTU,Lithuania,2014,1602,724,878
ESP,Spain,LTU,Lithuania,2015,1313,828,485
ESP,Spain,LTU,Lithuania,2016,1071,1024,47
ESP,Spain,LTU,Lithuania,2017,1434,1327,107
SWE,Sweden,LTU,Lithuania,2008,160,915,-755
SWE,Sweden,LTU,Lithuania,2009,123,1214,-1091
SWE,Sweden,LTU,Lithuania,2010,182,1370,-1188
SWE,Sweden,LTU,Lithuania,2011,226,1349,-1123
SWE,Sweden,LTU,Lithuania,2012,371,1356,-985
SWE,Sweden,LTU,Lithuania,2013,339,1155,-816
SWE,Sweden,LTU,Lithuania,2014,351,1251,-900
SWE,Sweden,LTU,Lithuania,2015,381,1243,-862
SWE,Sweden,LTU,Lithuania,2016,393,1390,-997
SWE,Sweden,LTU,Lithuania,2017,337,1700,-1363
CHE,Switzerland,LTU,Lithuania,2008,41,137,-96
CHE,Switzerland,LTU,Lithuania,2009,44,152,-108
CHE,Switzerland,LTU,Lithuania,2010,65,188,-123
CHE,Switzerland,LTU,Lithuania,2011,79,296,-217
CHE,Switzerland,LTU,Lithuania,2012,81,258,-177
CHE,Switzerland,LTU,Lithuania,2013,104,236,-132
CHE,Switzerland,LTU,Lithuania,2014,96,335,-239
CHE,Switzerland,LTU,Lithuania,2015,107,309,-202
CHE,Switzerland,LTU,Lithuania,2016,117,352,-235
CHE,Switzerland,LTU,Lithuania,2017,119,363,-244
TUR,Turkey,LTU,Lithuania,2010,0,52,-52
TUR,Turkey,LTU,Lithuania,2016,156,127,29
TUR,Turkey,LTU,Lithuania,2017,105,126,-21
GBR,United Kingdom,LTU,Lithuania,2010,0,13000,-13000
GBR,United Kingdom,LTU,Lithuania,2011,3000,17000,-14000
GBR,United Kingdom,LTU,Lithuania,2012,2000,9000,-7000
GBR,United Kingdom,LTU,Lithuania,2013,3000,11000,-8000
GBR,United Kingdom,LTU,Lithuania,2014,2000,14000,-12000
GBR,United Kingdom,LTU,Lithuania,2015,1000,7000,-6000
GBR,United Kingdom,LTU,Lithuania,2016,7000,7000,0
GBR,United Kingdom,LTU,Lithuania,2017,0,8000,-8000
USA,United States,LTU,Lithuania,2008,0,967,-967
USA,United States,LTU,Lithuania,2009,0,1069,-1069
USA,United States,LTU,Lithuania,2010,0,985,-985
USA,United States,LTU,Lithuania,2011,0,936,-936
USA,United States,LTU,Lithuania,2012,0,924,-924
USA,United States,LTU,Lithuania,2013,0,854,-854
USA,United States,LTU,Lithuania,2014,0,747,-747
USA,United States,LTU,Lithuania,2015,0,750,-750
USA,United States,LTU,Lithuania,2016,0,735,-735
USA,United States,LTU,Lithuania,2017,0,645,-645
CHL,Chile,LTU,Lithuania,2008,0,4,-4
CHL,Chile,LTU,Lithuania,2009,0,25,-25
CHL,Chile,LTU,Lithuania,2010,0,3,-3
CHL,Chile,LTU,Lithuania,2011,0,15,-15
CHL,Chile,LTU,Lithuania,2012,0,8,-8
CHL,Chile,LTU,Lithuania,2013,0,8,-8
CHL,Chile,LTU,Lithuania,2014,0,5,-5
CHL,Chile,LTU,Lithuania,2015,0,6,-6
CHL,Chile,LTU,Lithuania,2016,0,2,-2
EST,Estonia,LTU,Lithuania,2008,0,70,-70
EST,Estonia,LTU,Lithuania,2009,0,53,-53
EST,Estonia,LTU,Lithuania,2010,0,17,-17
EST,Estonia,LTU,Lithuania,2011,0,0,0
EST,Estonia,LTU,Lithuania,2012,0,3,-3
EST,Estonia,LTU,Lithuania,2013,0,8,-8
EST,Estonia,LTU,Lithuania,2014,0,17,-17
EST,Estonia,LTU,Lithuania,2015,0,129,-129
EST,Estonia,LTU,Lithuania,2016,0,165,-165
EST,Estonia,LTU,Lithuania,2017,0,183,-183
SVN,Slovenia,LTU,Lithuania,2008,0,1,-1
SVN,Slovenia,LTU,Lithuania,2009,0,45,-45
SVN,Slovenia,LTU,Lithuania,2011,2,52,-50
SVN,Slovenia,LTU,Lithuania,2012,1,65,-64
SVN,Slovenia,LTU,Lithuania,2013,0,66,-66
SVN,Slovenia,LTU,Lithuania,2014,0,55,-55
SVN,Slovenia,LTU,Lithuania,2015,0,54,-54
SVN,Slovenia,LTU,Lithuania,2016,0,57,-57
SVN,Slovenia,LTU,Lithuania,2017,0,46,-46
AUS,Australia,MAC,Macau,2008,21,41,-20
AUS,Australia,MAC,Macau,2009,14,46,-32
AUS,Australia,MAC,Macau,2010,23,23,0
AUS,Australia,MAC,Macau,2011,21,25,-4
AUS,Australia,MAC,Macau,2012,27,21,6
AUS,Australia,MAC,Macau,2013,27,44,-17
AUS,Australia,MAC,Macau,2014,18,63,-45
AUS,Australia,MAC,Macau,2015,0,58,-58
AUS,Australia,MAC,Macau,2016,0,69,-69
AUS,Australia,MAC,Macau,2017,0,61,-61
AUT,Austria,MAC,Macau,2014,0,0,0
AUT,Austria,MAC,Macau,2015,0,0,0
AUT,Austria,MAC,Macau,2016,0,0,0
AUT,Austria,MAC,Macau,2017,0,0,0
BEL,Belgium,MAC,Macau,2010,0,0,0
CAN,Canada,MAC,Macau,2008,0,12,-12
CAN,Canada,MAC,Macau,2009,0,21,-21
CAN,Canada,MAC,Macau,2010,0,21,-21
CAN,Canada,MAC,Macau,2011,0,13,-13
CAN,Canada,MAC,Macau,2012,0,33,-33
CAN,Canada,MAC,Macau,2013,0,29,-29
CAN,Canada,MAC,Macau,2014,0,37,-37
CAN,Canada,MAC,Macau,2015,0,21,-21
CAN,Canada,MAC,Macau,2016,0,25,-25
CAN,Canada,MAC,Macau,2017,0,30,-30
DNK,Denmark,MAC,Macau,2015,0,0,0
DNK,Denmark,MAC,Macau,2016,0,0,0
FIN,Finland,MAC,Macau,2008,0,0,0
FIN,Finland,MAC,Macau,2009,0,0,0
FIN,Finland,MAC,Macau,2010,0,0,0
FIN,Finland,MAC,Macau,2011,0,0,0
FIN,Finland,MAC,Macau,2012,0,0,0
FIN,Finland,MAC,Macau,2013,0,0,0
FIN,Finland,MAC,Macau,2014,0,0,0
FIN,Finland,MAC,Macau,2015,0,0,0
FIN,Finland,MAC,Macau,2016,0,0,0
FIN,Finland,MAC,Macau,2017,0,0,0
FRA,France,MAC,Macau,2008,0,0,0
FRA,France,MAC,Macau,2009,0,0,0
FRA,France,MAC,Macau,2010,0,0,0
FRA,France,MAC,Macau,2011,0,0,0
FRA,France,MAC,Macau,2012,0,0,0
FRA,France,MAC,Macau,2013,0,0,0
FRA,France,MAC,Macau,2014,0,0,0
FRA,France,MAC,Macau,2015,0,0,0
FRA,France,MAC,Macau,2016,0,0,0
FRA,France,MAC,Macau,2017,0,0,0
HUN,Hungary,MAC,Macau,2008,0,0,0
HUN,Hungary,MAC,Macau,2009,0,0,0
HUN,Hungary,MAC,Macau,2010,0,0,0
HUN,Hungary,MAC,Macau,2011,0,0,0
HUN,Hungary,MAC,Macau,2012,0,0,0
HUN,Hungary,MAC,Macau,2013,0,0,0
HUN,Hungary,MAC,Macau,2014,0,0,0
HUN,Hungary,MAC,Macau,2015,0,0,0
HUN,Hungary,MAC,Macau,2016,0,0,0
HUN,Hungary,MAC,Macau,2017,0,0,0
ISL,Iceland,MAC,Macau,2016,0,0,0
ISL,Iceland,MAC,Macau,2017,0,0,0
JPN,Japan,MAC,Macau,2008,0,0,0
JPN,Japan,MAC,Macau,2009,0,0,0
JPN,Japan,MAC,Macau,2010,0,0,0
JPN,Japan,MAC,Macau,2011,0,0,0
JPN,Japan,MAC,Macau,2012,0,0,0
JPN,Japan,MAC,Macau,2013,0,0,0
JPN,Japan,MAC,Macau,2014,0,0,0
JPN,Japan,MAC,Macau,2015,0,0,0
JPN,Japan,MAC,Macau,2016,0,0,0
JPN,Japan,MAC,Macau,2017,0,0,0
KOR,Korea,MAC,Macau,2008,12,12,0
KOR,Korea,MAC,Macau,2009,8,9,-1
KOR,Korea,MAC,Macau,2010,4,8,-4
KOR,Korea,MAC,Macau,2011,14,13,1
KOR,Korea,MAC,Macau,2012,13,17,-4
KOR,Korea,MAC,Macau,2013,19,26,-7
KOR,Korea,MAC,Macau,2014,28,38,-10
KOR,Korea,MAC,Macau,2015,49,32,17
KOR,Korea,MAC,Macau,2016,46,40,6
KOR,Korea,MAC,Macau,2017,50,49,1
LUX,Luxembourg,MAC,Macau,2008,0,0,0
LUX,Luxembourg,MAC,Macau,2009,0,0,0
LUX,Luxembourg,MAC,Macau,2010,0,0,0
LUX,Luxembourg,MAC,Macau,2011,0,0,0
LUX,Luxembourg,MAC,Macau,2012,0,0,0
LUX,Luxembourg,MAC,Macau,2013,0,0,0
LUX,Luxembourg,MAC,Macau,2014,0,0,0
LUX,Luxembourg,MAC,Macau,2015,0,0,0
LUX,Luxembourg,MAC,Macau,2016,0,0,0
LUX,Luxembourg,MAC,Macau,2017,0,0,0
MEX,Mexico,MAC,Macau,2008,0,2,-2
MEX,Mexico,MAC,Macau,2009,0,3,-3
MEX,Mexico,MAC,Macau,2012,0,0,0
MEX,Mexico,MAC,Macau,2013,0,0,0
MEX,Mexico,MAC,Macau,2014,0,0,0
NZL,New Zealand,MAC,Macau,2008,1,6,-5
NZL,New Zealand,MAC,Macau,2009,1,7,-6
NZL,New Zealand,MAC,Macau,2010,0,11,-11
NZL,New Zealand,MAC,Macau,2011,1,14,-13
NZL,New Zealand,MAC,Macau,2012,2,18,-16
NZL,New Zealand,MAC,Macau,2013,0,13,-13
NZL,New Zealand,MAC,Macau,2014,1,21,-20
NZL,New Zealand,MAC,Macau,2015,4,21,-17
NZL,New Zealand,MAC,Macau,2016,3,42,-39
NZL,New Zealand,MAC,Macau,2017,10,21,-11
NOR,Norway,MAC,Macau,2008,0,0,0
NOR,Norway,MAC,Macau,2009,0,0,0
NOR,Norway,MAC,Macau,2010,23,0,23
NOR,Norway,MAC,Macau,2011,0,0,0
NOR,Norway,MAC,Macau,2012,0,0,0
NOR,Norway,MAC,Macau,2013,0,0,0
NOR,Norway,MAC,Macau,2014,0,0,0
NOR,Norway,MAC,Macau,2015,0,0,0
NOR,Norway,MAC,Macau,2016,0,0,0
NOR,Norway,MAC,Macau,2017,0,0,0
POL,Poland,MAC,Macau,2009,0,0,0
POL,Poland,MAC,Macau,2010,0,0,0
POL,Poland,MAC,Macau,2011,0,0,0
POL,Poland,MAC,Macau,2012,0,0,0
POL,Poland,MAC,Macau,2013,0,0,0
POL,Poland,MAC,Macau,2014,0,0,0
POL,Poland,MAC,Macau,2015,0,0,0
POL,Poland,MAC,Macau,2016,0,1,-1
POL,Poland,MAC,Macau,2017,0,2,-2
SWE,Sweden,MAC,Macau,2010,0,0,0
SWE,Sweden,MAC,Macau,2011,0,0,0
SWE,Sweden,MAC,Macau,2012,0,0,0
SWE,Sweden,MAC,Macau,2013,0,0,0
SWE,Sweden,MAC,Macau,2014,0,0,0
SWE,Sweden,MAC,Macau,2015,0,0,0
CHE,Switzerland,MAC,Macau,2014,11,9,2
CHE,Switzerland,MAC,Macau,2015,0,0,0
CHE,Switzerland,MAC,Macau,2017,0,0,0
USA,United States,MAC,Macau,2008,0,205,-205
USA,United States,MAC,Macau,2009,0,158,-158
USA,United States,MAC,Macau,2010,0,143,-143
USA,United States,MAC,Macau,2011,0,130,-130
USA,United States,MAC,Macau,2012,0,120,-120
USA,United States,MAC,Macau,2013,0,106,-106
USA,United States,MAC,Macau,2014,0,105,-105
USA,United States,MAC,Macau,2015,0,99,-99
USA,United States,MAC,Macau,2016,0,109,-109
USA,United States,MAC,Macau,2017,0,109,-109
CHL,Chile,MAC,Macau,2008,0,0,0
CHL,Chile,MAC,Macau,2009,0,0,0
CHL,Chile,MAC,Macau,2010,0,0,0
CHL,Chile,MAC,Macau,2011,0,0,0
CHL,Chile,MAC,Macau,2012,0,0,0
CHL,Chile,MAC,Macau,2013,0,0,0
CHL,Chile,MAC,Macau,2014,0,1,-1
CHL,Chile,MAC,Macau,2015,0,0,0
CHL,Chile,MAC,Macau,2016,0,3,-3
EST,Estonia,MAC,Macau,2017,0,0,0
AUS,Australia,MKD,North Macedonia,2008,285,394,-109
AUS,Australia,MKD,North Macedonia,2009,247,360,-113
AUS,Australia,MKD,North Macedonia,2010,206,313,-107
AUS,Australia,MKD,North Macedonia,2011,253,269,-16
AUS,Australia,MKD,North Macedonia,2012,236,213,23
AUS,Australia,MKD,North Macedonia,2013,312,298,14
AUS,Australia,MKD,North Macedonia,2014,292,298,-6
AUS,Australia,MKD,North Macedonia,2015,300,221,79
AUS,Australia,MKD,North Macedonia,2016,200,266,-66
AUS,Australia,MKD,North Macedonia,2017,0,269,-269
AUT,Austria,MKD,North Macedonia,2008,530,1035,-505
AUT,Austria,MKD,North Macedonia,2009,632,925,-293
AUT,Austria,MKD,North Macedonia,2010,918,1432,-514
AUT,Austria,MKD,North Macedonia,2011,900,1131,-231
AUT,Austria,MKD,North Macedonia,2012,811,1300,-489
AUT,Austria,MKD,North Macedonia,2013,765,1457,-692
AUT,Austria,MKD,North Macedonia,2014,746,1459,-713
AUT,Austria,MKD,North Macedonia,2015,829,1658,-829
AUT,Austria,MKD,North Macedonia,2016,819,1509,-690
AUT,Austria,MKD,North Macedonia,2017,805,1551,-746
BEL,Belgium,MKD,North Macedonia,2008,0,305,-305
BEL,Belgium,MKD,North Macedonia,2009,0,364,-364
BEL,Belgium,MKD,North Macedonia,2010,72,551,-479
BEL,Belgium,MKD,North Macedonia,2011,0,416,-416
BEL,Belgium,MKD,North Macedonia,2012,707,733,-26
BEL,Belgium,MKD,North Macedonia,2013,679,411,268
BEL,Belgium,MKD,North Macedonia,2014,632,407,225
BEL,Belgium,MKD,North Macedonia,2015,469,398,71
BEL,Belgium,MKD,North Macedonia,2016,175,319,-144
BEL,Belgium,MKD,North Macedonia,2017,160,384,-224
CAN,Canada,MKD,North Macedonia,2008,0,191,-191
CAN,Canada,MKD,North Macedonia,2009,0,198,-198
CAN,Canada,MKD,North Macedonia,2010,0,188,-188
CAN,Canada,MKD,North Macedonia,2011,0,130,-130
CAN,Canada,MKD,North Macedonia,2012,0,126,-126
CAN,Canada,MKD,North Macedonia,2013,0,112,-112
CAN,Canada,MKD,North Macedonia,2014,0,117,-117
CAN,Canada,MKD,North Macedonia,2015,0,221,-221
CAN,Canada,MKD,North Macedonia,2016,0,135,-135
CAN,Canada,MKD,North Macedonia,2017,0,90,-90
CZE,Czech Republic,MKD,North Macedonia,2008,2,579,-577
CZE,Czech Republic,MKD,North Macedonia,2009,2,247,-245
CZE,Czech Republic,MKD,North Macedonia,2010,3,124,-121
CZE,Czech Republic,MKD,North Macedonia,2011,0,74,-74
CZE,Czech Republic,MKD,North Macedonia,2012,70,126,-56
CZE,Czech Republic,MKD,North Macedonia,2013,113,78,35
CZE,Czech Republic,MKD,North Macedonia,2014,66,153,-87
CZE,Czech Republic,MKD,North Macedonia,2015,69,124,-55
CZE,Czech Republic,MKD,North Macedonia,2016,72,162,-90
CZE,Czech Republic,MKD,North Macedonia,2017,118,212,-94
DNK,Denmark,MKD,North Macedonia,2008,11,70,-59
DNK,Denmark,MKD,North Macedonia,2009,15,81,-66
DNK,Denmark,MKD,North Macedonia,2010,17,70,-53
DNK,Denmark,MKD,North Macedonia,2011,15,66,-51
DNK,Denmark,MKD,North Macedonia,2012,10,54,-44
DNK,Denmark,MKD,North Macedonia,2013,24,100,-76
DNK,Denmark,MKD,North Macedonia,2014,15,85,-70
DNK,Denmark,MKD,North Macedonia,2015,12,0,12
DNK,Denmark,MKD,North Macedonia,2016,11,115,-104
DNK,Denmark,MKD,North Macedonia,2017,29,130,-101
FIN,Finland,MKD,North Macedonia,2008,0,37,-37
FIN,Finland,MKD,North Macedonia,2009,2,20,-18
FIN,Finland,MKD,North Macedonia,2010,0,14,-14
FIN,Finland,MKD,North Macedonia,2011,3,21,-18
FIN,Finland,MKD,North Macedonia,2012,2,15,-13
FIN,Finland,MKD,North Macedonia,2013,3,33,-30
FIN,Finland,MKD,North Macedonia,2014,2,19,-17
FIN,Finland,MKD,North Macedonia,2015,4,14,-10
FIN,Finland,MKD,North Macedonia,2016,3,20,-17
FIN,Finland,MKD,North Macedonia,2017,0,17,-17
FRA,France,MKD,North Macedonia,2008,0,172,-172
FRA,France,MKD,North Macedonia,2009,0,186,-186
FRA,France,MKD,North Macedonia,2010,0,158,-158
FRA,France,MKD,North Macedonia,2011,0,158,-158
FRA,France,MKD,North Macedonia,2012,0,193,-193
FRA,France,MKD,North Macedonia,2013,0,212,-212
FRA,France,MKD,North Macedonia,2014,0,213,-213
FRA,France,MKD,North Macedonia,2015,0,200,-200
FRA,France,MKD,North Macedonia,2016,0,211,-211
FRA,France,MKD,North Macedonia,2017,0,260,-260
DEU,Germany,MKD,North Macedonia,2008,2225,2308,-83
DEU,Germany,MKD,North Macedonia,2009,2063,2399,-336
DEU,Germany,MKD,North Macedonia,2010,3900,7585,-3685
DEU,Germany,MKD,North Macedonia,2011,5184,5679,-495
DEU,Germany,MKD,North Macedonia,2012,5980,11331,-5351
DEU,Germany,MKD,North Macedonia,2013,8656,14387,-5731
DEU,Germany,MKD,North Macedonia,2014,9521,15634,-6113
DEU,Germany,MKD,North Macedonia,2015,12344,24776,-12432
DEU,Germany,MKD,North Macedonia,2016,17468,14342,3126
DEU,Germany,MKD,North Macedonia,2017,12222,18235,-6013
HUN,Hungary,MKD,North Macedonia,2008,1,47,-46
HUN,Hungary,MKD,North Macedonia,2009,3,37,-34
HUN,Hungary,MKD,North Macedonia,2010,9,49,-40
HUN,Hungary,MKD,North Macedonia,2011,9,32,-23
HUN,Hungary,MKD,North Macedonia,2012,5,39,-34
HUN,Hungary,MKD,North Macedonia,2013,8,50,-42
HUN,Hungary,MKD,North Macedonia,2014,5,68,-63
HUN,Hungary,MKD,North Macedonia,2015,15,111,-96
HUN,Hungary,MKD,North Macedonia,2016,22,93,-71
HUN,Hungary,MKD,North Macedonia,2017,0,132,-132
ISL,Iceland,MKD,North Macedonia,2008,2,8,-6
ISL,Iceland,MKD,North Macedonia,2009,5,5,0
ISL,Iceland,MKD,North Macedonia,2010,2,1,1
ISL,Iceland,MKD,North Macedonia,2011,1,0,1
ISL,Iceland,MKD,North Macedonia,2012,0,3,-3
ISL,Iceland,MKD,North Macedonia,2013,1,9,-8
ISL,Iceland,MKD,North Macedonia,2014,5,6,-1
ISL,Iceland,MKD,North Macedonia,2015,0,4,-4
ISL,Iceland,MKD,North Macedonia,2016,2,7,-5
ISL,Iceland,MKD,North Macedonia,2017,0,6,-6
ITA,Italy,MKD,North Macedonia,2017,541,1835,-1294
JPN,Japan,MKD,North Macedonia,2008,55,59,-4
JPN,Japan,MKD,North Macedonia,2009,40,43,-3
JPN,Japan,MKD,North Macedonia,2010,37,40,-3
JPN,Japan,MKD,North Macedonia,2011,67,68,-1
JPN,Japan,MKD,North Macedonia,2012,47,48,-1
JPN,Japan,MKD,North Macedonia,2013,82,86,-4
JPN,Japan,MKD,North Macedonia,2014,31,28,3
JPN,Japan,MKD,North Macedonia,2015,41,40,1
JPN,Japan,MKD,North Macedonia,2016,22,31,-9
JPN,Japan,MKD,North Macedonia,2017,22,23,-1
KOR,Korea,MKD,North Macedonia,2008,0,0,0
KOR,Korea,MKD,North Macedonia,2009,4,5,-1
KOR,Korea,MKD,North Macedonia,2010,8,6,2
KOR,Korea,MKD,North Macedonia,2011,6,5,1
KOR,Korea,MKD,North Macedonia,2012,5,8,-3
KOR,Korea,MKD,North Macedonia,2013,5,2,3
KOR,Korea,MKD,North Macedonia,2014,3,6,-3
KOR,Korea,MKD,North Macedonia,2015,5,5,0
KOR,Korea,MKD,North Macedonia,2016,10,7,3
KOR,Korea,MKD,North Macedonia,2017,6,7,-1
LUX,Luxembourg,MKD,North Macedonia,2008,19,26,-7
LUX,Luxembourg,MKD,North Macedonia,2009,4,15,-11
LUX,Luxembourg,MKD,North Macedonia,2010,0,25,-25
LUX,Luxembourg,MKD,North Macedonia,2011,7,356,-349
LUX,Luxembourg,MKD,North Macedonia,2012,228,82,146
LUX,Luxembourg,MKD,North Macedonia,2013,52,42,10
LUX,Luxembourg,MKD,North Macedonia,2014,37,42,-5
LUX,Luxembourg,MKD,North Macedonia,2015,52,44,8
LUX,Luxembourg,MKD,North Macedonia,2016,20,69,-49
LUX,Luxembourg,MKD,North Macedonia,2017,34,39,-5
MEX,Mexico,MKD,North Macedonia,2008,0,1,-1
MEX,Mexico,MKD,North Macedonia,2009,0,2,-2
MEX,Mexico,MKD,North Macedonia,2010,0,2,-2
MEX,Mexico,MKD,North Macedonia,2012,0,2,-2
MEX,Mexico,MKD,North Macedonia,2013,0,7,-7
MEX,Mexico,MKD,North Macedonia,2014,0,3,-3
MEX,Mexico,MKD,North Macedonia,2015,0,3,-3
MEX,Mexico,MKD,North Macedonia,2016,0,5,-5
MEX,Mexico,MKD,North Macedonia,2017,0,1,-1
NLD,Netherlands,MKD,North Macedonia,2009,54,115,-61
NLD,Netherlands,MKD,North Macedonia,2010,63,86,-23
NLD,Netherlands,MKD,North Macedonia,2011,38,128,-90
NLD,Netherlands,MKD,North Macedonia,2012,71,112,-41
NLD,Netherlands,MKD,North Macedonia,2013,66,122,-56
NLD,Netherlands,MKD,North Macedonia,2014,71,147,-76
NLD,Netherlands,MKD,North Macedonia,2015,63,146,-83
NLD,Netherlands,MKD,North Macedonia,2016,39,182,-143
NLD,Netherlands,MKD,North Macedonia,2017,71,167,-96
NZL,New Zealand,MKD,North Macedonia,2008,3,27,-24
NZL,New Zealand,MKD,North Macedonia,2009,6,17,-11
NZL,New Zealand,MKD,North Macedonia,2010,6,6,0
NZL,New Zealand,MKD,North Macedonia,2011,4,8,-4
NZL,New Zealand,MKD,North Macedonia,2012,7,23,-16
NZL,New Zealand,MKD,North Macedonia,2013,7,18,-11
NZL,New Zealand,MKD,North Macedonia,2014,0,17,-17
NZL,New Zealand,MKD,North Macedonia,2015,1,12,-11
NZL,New Zealand,MKD,North Macedonia,2016,2,20,-18
NZL,New Zealand,MKD,North Macedonia,2017,4,33,-29
NOR,Norway,MKD,North Macedonia,2008,10,67,-57
NOR,Norway,MKD,North Macedonia,2009,17,62,-45
NOR,Norway,MKD,North Macedonia,2010,6,72,-66
NOR,Norway,MKD,North Macedonia,2011,27,82,-55
NOR,Norway,MKD,North Macedonia,2012,24,76,-52
NOR,Norway,MKD,North Macedonia,2013,22,75,-53
NOR,Norway,MKD,North Macedonia,2014,18,61,-43
NOR,Norway,MKD,North Macedonia,2015,19,95,-76
NOR,Norway,MKD,North Macedonia,2016,24,108,-84
NOR,Norway,MKD,North Macedonia,2017,19,88,-69
POL,Poland,MKD,North Macedonia,2008,0,58,-58
POL,Poland,MKD,North Macedonia,2009,0,41,-41
POL,Poland,MKD,North Macedonia,2010,0,41,-41
POL,Poland,MKD,North Macedonia,2011,0,33,-33
POL,Poland,MKD,North Macedonia,2012,0,40,-40
POL,Poland,MKD,North Macedonia,2013,0,40,-40
POL,Poland,MKD,North Macedonia,2014,0,22,-22
POL,Poland,MKD,North Macedonia,2015,0,0,0
POL,Poland,MKD,North Macedonia,2016,0,0,0
POL,Poland,MKD,North Macedonia,2017,0,0,0
SVK,Slovak Republic,MKD,North Macedonia,2008,15,20,-5
SVK,Slovak Republic,MKD,North Macedonia,2009,23,16,7
SVK,Slovak Republic,MKD,North Macedonia,2010,20,14,6
SVK,Slovak Republic,MKD,North Macedonia,2011,11,14,-3
SVK,Slovak Republic,MKD,North Macedonia,2012,0,10,-10
SVK,Slovak Republic,MKD,North Macedonia,2013,1,16,-15
SVK,Slovak Republic,MKD,North Macedonia,2014,1,18,-17
SVK,Slovak Republic,MKD,North Macedonia,2015,0,18,-18
SVK,Slovak Republic,MKD,North Macedonia,2016,0,9,-9
SVK,Slovak Republic,MKD,North Macedonia,2017,0,17,-17
ESP,Spain,MKD,North Macedonia,2008,0,0,0
ESP,Spain,MKD,North Macedonia,2009,0,0,0
ESP,Spain,MKD,North Macedonia,2010,0,0,0
ESP,Spain,MKD,North Macedonia,2011,0,0,0
ESP,Spain,MKD,North Macedonia,2012,0,0,0
ESP,Spain,MKD,North Macedonia,2013,0,0,0
ESP,Spain,MKD,North Macedonia,2014,0,0,0
ESP,Spain,MKD,North Macedonia,2015,0,0,0
ESP,Spain,MKD,North Macedonia,2016,0,0,0
SWE,Sweden,MKD,North Macedonia,2008,29,304,-275
SWE,Sweden,MKD,North Macedonia,2009,30,255,-225
SWE,Sweden,MKD,North Macedonia,2010,21,252,-231
SWE,Sweden,MKD,North Macedonia,2011,49,305,-256
SWE,Sweden,MKD,North Macedonia,2012,53,346,-293
SWE,Sweden,MKD,North Macedonia,2013,44,267,-223
SWE,Sweden,MKD,North Macedonia,2014,54,310,-256
SWE,Sweden,MKD,North Macedonia,2015,56,348,-292
SWE,Sweden,MKD,North Macedonia,2016,39,428,-389
SWE,Sweden,MKD,North Macedonia,2017,29,511,-482
CHE,Switzerland,MKD,North Macedonia,2010,312,1158,-846
CHE,Switzerland,MKD,North Macedonia,2011,321,1243,-922
CHE,Switzerland,MKD,North Macedonia,2012,302,1328,-1026
CHE,Switzerland,MKD,North Macedonia,2013,311,1385,-1074
CHE,Switzerland,MKD,North Macedonia,2014,266,1392,-1126
CHE,Switzerland,MKD,North Macedonia,2015,226,1536,-1310
CHE,Switzerland,MKD,North Macedonia,2016,221,1735,-1514
CHE,Switzerland,MKD,North Macedonia,2017,240,1797,-1557
TUR,Turkey,MKD,North Macedonia,2010,0,153,-153
USA,United States,MKD,North Macedonia,2008,0,1107,-1107
USA,United States,MKD,North Macedonia,2009,0,1128,-1128
USA,United States,MKD,North Macedonia,2010,0,963,-963
USA,United States,MKD,North Macedonia,2011,0,1078,-1078
USA,United States,MKD,North Macedonia,2012,0,906,-906
USA,United States,MKD,North Macedonia,2013,0,895,-895
USA,United States,MKD,North Macedonia,2014,0,960,-960
USA,United States,MKD,North Macedonia,2015,0,1060,-1060
USA,United States,MKD,North Macedonia,2016,0,1262,-1262
USA,United States,MKD,North Macedonia,2017,0,1027,-1027
CHL,Chile,MKD,North Macedonia,2008,0,3,-3
CHL,Chile,MKD,North Macedonia,2009,0,0,0
CHL,Chile,MKD,North Macedonia,2010,0,2,-2
CHL,Chile,MKD,North Macedonia,2011,0,2,-2
CHL,Chile,MKD,North Macedonia,2012,0,2,-2
CHL,Chile,MKD,North Macedonia,2013,0,0,0
CHL,Chile,MKD,North Macedonia,2014,0,0,0
CHL,Chile,MKD,North Macedonia,2015,0,2,-2
CHL,Chile,MKD,North Macedonia,2016,0,1,-1
EST,Estonia,MKD,North Macedonia,2008,0,0,0
EST,Estonia,MKD,North Macedonia,2009,0,0,0
EST,Estonia,MKD,North Macedonia,2010,0,1,-1
EST,Estonia,MKD,North Macedonia,2011,0,1,-1
EST,Estonia,MKD,North Macedonia,2012,0,0,0
EST,Estonia,MKD,North Macedonia,2013,0,1,-1
EST,Estonia,MKD,North Macedonia,2014,0,1,-1
EST,Estonia,MKD,North Macedonia,2015,0,1,-1
EST,Estonia,MKD,North Macedonia,2016,0,4,-4
EST,Estonia,MKD,North Macedonia,2017,0,6,-6
SVN,Slovenia,MKD,North Macedonia,2008,806,4952,-4146
SVN,Slovenia,MKD,North Macedonia,2009,1720,2165,-445
SVN,Slovenia,MKD,North Macedonia,2010,1359,1038,321
SVN,Slovenia,MKD,North Macedonia,2011,152,1220,-1068
SVN,Slovenia,MKD,North Macedonia,2012,77,770,-693
SVN,Slovenia,MKD,North Macedonia,2013,49,585,-536
SVN,Slovenia,MKD,North Macedonia,2014,75,577,-502
SVN,Slovenia,MKD,North Macedonia,2015,106,1000,-894
SVN,Slovenia,MKD,North Macedonia,2016,128,870,-742
SVN,Slovenia,MKD,North Macedonia,2017,135,1689,-1554
AUS,Australia,MDG,Madagascar,2008,0,3,-3
AUS,Australia,MDG,Madagascar,2009,0,0,0
AUS,Australia,MDG,Madagascar,2010,0,1,-1
AUS,Australia,MDG,Madagascar,2011,0,7,-7
AUS,Australia,MDG,Madagascar,2012,0,2,-2
AUS,Australia,MDG,Madagascar,2013,0,1,-1
AUS,Australia,MDG,Madagascar,2014,0,0,0
AUS,Australia,MDG,Madagascar,2015,0,0,0
AUS,Australia,MDG,Madagascar,2016,0,10,-10
AUS,Australia,MDG,Madagascar,2017,0,3,-3
AUT,Austria,MDG,Madagascar,2008,4,12,-8
AUT,Austria,MDG,Madagascar,2009,8,10,-2
AUT,Austria,MDG,Madagascar,2010,6,14,-8
AUT,Austria,MDG,Madagascar,2011,13,20,-7
AUT,Austria,MDG,Madagascar,2012,13,15,-2
AUT,Austria,MDG,Madagascar,2013,9,18,-9
AUT,Austria,MDG,Madagascar,2014,11,22,-11
AUT,Austria,MDG,Madagascar,2015,12,13,-1
AUT,Austria,MDG,Madagascar,2016,10,15,-5
AUT,Austria,MDG,Madagascar,2017,12,13,-1
BEL,Belgium,MDG,Madagascar,2008,0,112,-112
BEL,Belgium,MDG,Madagascar,2009,0,100,-100
BEL,Belgium,MDG,Madagascar,2010,26,107,-81
BEL,Belgium,MDG,Madagascar,2011,0,94,-94
BEL,Belgium,MDG,Madagascar,2012,40,97,-57
BEL,Belgium,MDG,Madagascar,2013,41,81,-40
BEL,Belgium,MDG,Madagascar,2014,39,78,-39
BEL,Belgium,MDG,Madagascar,2015,29,87,-58
BEL,Belgium,MDG,Madagascar,2016,15,96,-81
BEL,Belgium,MDG,Madagascar,2017,25,98,-73
CAN,Canada,MDG,Madagascar,2008,0,118,-118
CAN,Canada,MDG,Madagascar,2009,0,169,-169
CAN,Canada,MDG,Madagascar,2010,0,178,-178
CAN,Canada,MDG,Madagascar,2011,0,148,-148
CAN,Canada,MDG,Madagascar,2012,0,165,-165
CAN,Canada,MDG,Madagascar,2013,0,229,-229
CAN,Canada,MDG,Madagascar,2014,0,112,-112
CAN,Canada,MDG,Madagascar,2015,0,115,-115
CAN,Canada,MDG,Madagascar,2016,0,140,-140
CAN,Canada,MDG,Madagascar,2017,0,120,-120
CZE,Czech Republic,MDG,Madagascar,2008,0,4,-4
CZE,Czech Republic,MDG,Madagascar,2009,0,3,-3
CZE,Czech Republic,MDG,Madagascar,2010,0,1,-1
CZE,Czech Republic,MDG,Madagascar,2014,2,2,0
DNK,Denmark,MDG,Madagascar,2008,1,4,-3
DNK,Denmark,MDG,Madagascar,2009,0,3,-3
DNK,Denmark,MDG,Madagascar,2010,1,1,0
DNK,Denmark,MDG,Madagascar,2012,0,1,-1
DNK,Denmark,MDG,Madagascar,2013,3,0,3
DNK,Denmark,MDG,Madagascar,2014,2,1,1
DNK,Denmark,MDG,Madagascar,2015,0,0,0
DNK,Denmark,MDG,Madagascar,2016,3,4,-1
DNK,Denmark,MDG,Madagascar,2017,2,2,0
FIN,Finland,MDG,Madagascar,2008,0,0,0
FIN,Finland,MDG,Madagascar,2009,0,3,-3
FIN,Finland,MDG,Madagascar,2010,0,2,-2
FIN,Finland,MDG,Madagascar,2011,0,3,-3
FIN,Finland,MDG,Madagascar,2012,1,0,1
FIN,Finland,MDG,Madagascar,2013,2,2,0
FIN,Finland,MDG,Madagascar,2014,0,1,-1
FIN,Finland,MDG,Madagascar,2015,2,1,1
FIN,Finland,MDG,Madagascar,2016,0,5,-5
FIN,Finland,MDG,Madagascar,2017,0,3,-3
FRA,France,MDG,Madagascar,2008,0,2096,-2096
FRA,France,MDG,Madagascar,2009,0,2221,-2221
FRA,France,MDG,Madagascar,2010,0,2322,-2322
FRA,France,MDG,Madagascar,2011,0,2083,-2083
FRA,France,MDG,Madagascar,2012,0,2123,-2123
FRA,France,MDG,Madagascar,2013,0,2180,-2180
FRA,France,MDG,Madagascar,2014,0,2416,-2416
FRA,France,MDG,Madagascar,2015,0,1929,-1929
FRA,France,MDG,Madagascar,2016,0,1889,-1889
FRA,France,MDG,Madagascar,2017,0,1898,-1898
DEU,Germany,MDG,Madagascar,2008,96,133,-37
DEU,Germany,MDG,Madagascar,2009,96,133,-37
DEU,Germany,MDG,Madagascar,2010,99,124,-25
DEU,Germany,MDG,Madagascar,2011,76,190,-114
DEU,Germany,MDG,Madagascar,2012,92,211,-119
DEU,Germany,MDG,Madagascar,2013,94,208,-114
DEU,Germany,MDG,Madagascar,2014,92,250,-158
DEU,Germany,MDG,Madagascar,2015,116,371,-255
DEU,Germany,MDG,Madagascar,2016,125,482,-357
DEU,Germany,MDG,Madagascar,2017,143,583,-440
HUN,Hungary,MDG,Madagascar,2008,0,3,-3
HUN,Hungary,MDG,Madagascar,2009,0,1,-1
HUN,Hungary,MDG,Madagascar,2010,0,0,0
HUN,Hungary,MDG,Madagascar,2011,0,4,-4
HUN,Hungary,MDG,Madagascar,2012,0,1,-1
HUN,Hungary,MDG,Madagascar,2013,0,0,0
HUN,Hungary,MDG,Madagascar,2014,0,2,-2
HUN,Hungary,MDG,Madagascar,2015,0,2,-2
HUN,Hungary,MDG,Madagascar,2016,0,3,-3
HUN,Hungary,MDG,Madagascar,2017,0,1,-1
ISL,Iceland,MDG,Madagascar,2008,0,0,0
ISL,Iceland,MDG,Madagascar,2009,0,1,-1
ISL,Iceland,MDG,Madagascar,2010,1,0,1
ISL,Iceland,MDG,Madagascar,2011,0,0,0
ISL,Iceland,MDG,Madagascar,2012,0,0,0
ISL,Iceland,MDG,Madagascar,2013,0,0,0
ISL,Iceland,MDG,Madagascar,2014,0,0,0
ISL,Iceland,MDG,Madagascar,2015,0,0,0
ISL,Iceland,MDG,Madagascar,2016,0,0,0
ISL,Iceland,MDG,Madagascar,2017,0,0,0
ITA,Italy,MDG,Madagascar,2008,22,105,-83
ITA,Italy,MDG,Madagascar,2009,19,142,-123
ITA,Italy,MDG,Madagascar,2010,17,167,-150
ITA,Italy,MDG,Madagascar,2011,10,126,-116
ITA,Italy,MDG,Madagascar,2012,10,117,-107
ITA,Italy,MDG,Madagascar,2013,10,114,-104
ITA,Italy,MDG,Madagascar,2014,9,99,-90
ITA,Italy,MDG,Madagascar,2015,13,129,-116
ITA,Italy,MDG,Madagascar,2016,0,107,-107
ITA,Italy,MDG,Madagascar,2017,24,110,-86
JPN,Japan,MDG,Madagascar,2008,146,166,-20
JPN,Japan,MDG,Madagascar,2009,61,69,-8
JPN,Japan,MDG,Madagascar,2010,26,31,-5
JPN,Japan,MDG,Madagascar,2011,20,20,0
JPN,Japan,MDG,Madagascar,2012,17,37,-20
JPN,Japan,MDG,Madagascar,2013,35,39,-4
JPN,Japan,MDG,Madagascar,2014,29,36,-7
JPN,Japan,MDG,Madagascar,2015,45,49,-4
JPN,Japan,MDG,Madagascar,2016,71,89,-18
JPN,Japan,MDG,Madagascar,2017,124,147,-23
KOR,Korea,MDG,Madagascar,2008,1,0,1
KOR,Korea,MDG,Madagascar,2009,1,1,0
KOR,Korea,MDG,Madagascar,2010,0,3,-3
KOR,Korea,MDG,Madagascar,2011,1,6,-5
KOR,Korea,MDG,Madagascar,2012,5,3,2
KOR,Korea,MDG,Madagascar,2013,4,6,-2
KOR,Korea,MDG,Madagascar,2014,7,12,-5
KOR,Korea,MDG,Madagascar,2015,5,10,-5
KOR,Korea,MDG,Madagascar,2016,9,15,-6
KOR,Korea,MDG,Madagascar,2017,9,8,1
LUX,Luxembourg,MDG,Madagascar,2008,2,7,-5
LUX,Luxembourg,MDG,Madagascar,2009,0,7,-7
LUX,Luxembourg,MDG,Madagascar,2010,1,6,-5
LUX,Luxembourg,MDG,Madagascar,2011,1,2,-1
LUX,Luxembourg,MDG,Madagascar,2012,2,2,0
LUX,Luxembourg,MDG,Madagascar,2013,1,3,-2
LUX,Luxembourg,MDG,Madagascar,2014,3,11,-8
LUX,Luxembourg,MDG,Madagascar,2015,3,8,-5
LUX,Luxembourg,MDG,Madagascar,2016,1,7,-6
LUX,Luxembourg,MDG,Madagascar,2017,1,9,-8
MEX,Mexico,MDG,Madagascar,2008,0,1,-1
MEX,Mexico,MDG,Madagascar,2012,0,0,0
MEX,Mexico,MDG,Madagascar,2013,0,1,-1
MEX,Mexico,MDG,Madagascar,2014,0,0,0
NLD,Netherlands,MDG,Madagascar,2008,2,1,1
NLD,Netherlands,MDG,Madagascar,2009,0,1,-1
NLD,Netherlands,MDG,Madagascar,2010,0,3,-3
NLD,Netherlands,MDG,Madagascar,2011,3,9,-6
NLD,Netherlands,MDG,Madagascar,2012,6,5,1
NLD,Netherlands,MDG,Madagascar,2013,5,10,-5
NLD,Netherlands,MDG,Madagascar,2014,3,12,-9
NLD,Netherlands,MDG,Madagascar,2015,6,8,-2
NLD,Netherlands,MDG,Madagascar,2016,4,12,-8
NLD,Netherlands,MDG,Madagascar,2017,4,12,-8
NZL,New Zealand,MDG,Madagascar,2010,0,1,-1
NZL,New Zealand,MDG,Madagascar,2012,0,2,-2
NZL,New Zealand,MDG,Madagascar,2013,0,1,-1
NZL,New Zealand,MDG,Madagascar,2015,1,1,0
NZL,New Zealand,MDG,Madagascar,2017,0,2,-2
NOR,Norway,MDG,Madagascar,2008,12,12,0
NOR,Norway,MDG,Madagascar,2009,11,18,-7
NOR,Norway,MDG,Madagascar,2010,0,21,-21
NOR,Norway,MDG,Madagascar,2011,17,10,7
NOR,Norway,MDG,Madagascar,2012,13,22,-9
NOR,Norway,MDG,Madagascar,2013,12,18,-6
NOR,Norway,MDG,Madagascar,2014,13,15,-2
NOR,Norway,MDG,Madagascar,2015,10,10,0
NOR,Norway,MDG,Madagascar,2016,12,19,-7
NOR,Norway,MDG,Madagascar,2017,13,13,0
POL,Poland,MDG,Madagascar,2009,0,9,-9
POL,Poland,MDG,Madagascar,2010,0,2,-2
POL,Poland,MDG,Madagascar,2011,0,5,-5
POL,Poland,MDG,Madagascar,2012,0,7,-7
POL,Poland,MDG,Madagascar,2013,0,6,-6
POL,Poland,MDG,Madagascar,2014,0,2,-2
POL,Poland,MDG,Madagascar,2015,0,4,-4
POL,Poland,MDG,Madagascar,2016,0,4,-4
POL,Poland,MDG,Madagascar,2017,0,8,-8
SVK,Slovak Republic,MDG,Madagascar,2008,0,0,0
SVK,Slovak Republic,MDG,Madagascar,2011,0,1,-1
SVK,Slovak Republic,MDG,Madagascar,2013,0,3,-3
ESP,Spain,MDG,Madagascar,2008,8,18,-10
ESP,Spain,MDG,Madagascar,2009,7,17,-10
ESP,Spain,MDG,Madagascar,2010,7,14,-7
ESP,Spain,MDG,Madagascar,2011,5,23,-18
ESP,Spain,MDG,Madagascar,2012,2,29,-27
ESP,Spain,MDG,Madagascar,2013,3,26,-23
ESP,Spain,MDG,Madagascar,2014,4,25,-21
ESP,Spain,MDG,Madagascar,2015,8,21,-13
ESP,Spain,MDG,Madagascar,2016,3,37,-34
ESP,Spain,MDG,Madagascar,2017,9,30,-21
SWE,Sweden,MDG,Madagascar,2008,0,1,-1
SWE,Sweden,MDG,Madagascar,2009,0,2,-2
SWE,Sweden,MDG,Madagascar,2010,0,3,-3
SWE,Sweden,MDG,Madagascar,2011,1,0,1
SWE,Sweden,MDG,Madagascar,2012,0,4,-4
SWE,Sweden,MDG,Madagascar,2013,1,4,-3
SWE,Sweden,MDG,Madagascar,2014,0,2,-2
SWE,Sweden,MDG,Madagascar,2015,0,3,-3
SWE,Sweden,MDG,Madagascar,2016,0,5,-5
SWE,Sweden,MDG,Madagascar,2017,5,0,5
CHE,Switzerland,MDG,Madagascar,2010,23,69,-46
CHE,Switzerland,MDG,Madagascar,2011,38,83,-45
CHE,Switzerland,MDG,Madagascar,2012,30,64,-34
CHE,Switzerland,MDG,Madagascar,2013,21,72,-51
CHE,Switzerland,MDG,Madagascar,2014,30,56,-26
CHE,Switzerland,MDG,Madagascar,2015,18,60,-42
CHE,Switzerland,MDG,Madagascar,2016,19,59,-40
CHE,Switzerland,MDG,Madagascar,2017,22,52,-30
TUR,Turkey,MDG,Madagascar,2010,0,9,-9
USA,United States,MDG,Madagascar,2008,0,77,-77
USA,United States,MDG,Madagascar,2009,0,71,-71
USA,United States,MDG,Madagascar,2010,0,80,-80
USA,United States,MDG,Madagascar,2011,0,83,-83
USA,United States,MDG,Madagascar,2012,0,79,-79
USA,United States,MDG,Madagascar,2013,0,95,-95
USA,United States,MDG,Madagascar,2014,0,86,-86
USA,United States,MDG,Madagascar,2015,0,72,-72
USA,United States,MDG,Madagascar,2016,0,88,-88
USA,United States,MDG,Madagascar,2017,0,60,-60
CHL,Chile,MDG,Madagascar,2008,0,0,0
CHL,Chile,MDG,Madagascar,2009,0,0,0
CHL,Chile,MDG,Madagascar,2010,0,0,0
CHL,Chile,MDG,Madagascar,2011,0,2,-2
CHL,Chile,MDG,Madagascar,2012,0,0,0
CHL,Chile,MDG,Madagascar,2013,0,1,-1
CHL,Chile,MDG,Madagascar,2014,0,1,-1
CHL,Chile,MDG,Madagascar,2015,0,0,0
CHL,Chile,MDG,Madagascar,2016,0,0,0
EST,Estonia,MDG,Madagascar,2008,0,0,0
EST,Estonia,MDG,Madagascar,2009,0,0,0
EST,Estonia,MDG,Madagascar,2010,0,0,0
EST,Estonia,MDG,Madagascar,2011,0,0,0
EST,Estonia,MDG,Madagascar,2012,0,0,0
EST,Estonia,MDG,Madagascar,2013,0,0,0
EST,Estonia,MDG,Madagascar,2014,0,0,0
EST,Estonia,MDG,Madagascar,2015,0,0,0
EST,Estonia,MDG,Madagascar,2016,0,0,0
EST,Estonia,MDG,Madagascar,2017,0,0,0
SVN,Slovenia,MDG,Madagascar,2009,0,1,-1
SVN,Slovenia,MDG,Madagascar,2010,0,1,-1
SVN,Slovenia,MDG,Madagascar,2011,0,1,-1
SVN,Slovenia,MDG,Madagascar,2015,0,4,-4
SVN,Slovenia,MDG,Madagascar,2017,0,1,-1
AUS,Australia,MWI,Malawi,2008,8,9,-1
AUS,Australia,MWI,Malawi,2009,0,23,-23
AUS,Australia,MWI,Malawi,2010,6,19,-13
AUS,Australia,MWI,Malawi,2011,6,24,-18
AUS,Australia,MWI,Malawi,2012,7,25,-18
AUS,Australia,MWI,Malawi,2013,11,22,-11
AUS,Australia,MWI,Malawi,2014,5,29,-24
AUS,Australia,MWI,Malawi,2015,0,19,-19
AUS,Australia,MWI,Malawi,2016,0,13,-13
AUS,Australia,MWI,Malawi,2017,0,12,-12
AUT,Austria,MWI,Malawi,2008,1,2,-1
AUT,Austria,MWI,Malawi,2009,2,4,-2
AUT,Austria,MWI,Malawi,2010,3,2,1
AUT,Austria,MWI,Malawi,2011,2,4,-2
AUT,Austria,MWI,Malawi,2012,1,7,-6
AUT,Austria,MWI,Malawi,2013,3,6,-3
AUT,Austria,MWI,Malawi,2014,3,9,-6
AUT,Austria,MWI,Malawi,2015,8,8,0
AUT,Austria,MWI,Malawi,2016,4,5,-1
AUT,Austria,MWI,Malawi,2017,5,6,-1
BEL,Belgium,MWI,Malawi,2008,0,8,-8
BEL,Belgium,MWI,Malawi,2009,0,6,-6
BEL,Belgium,MWI,Malawi,2010,8,4,4
BEL,Belgium,MWI,Malawi,2012,5,12,-7
BEL,Belgium,MWI,Malawi,2013,1,13,-12
BEL,Belgium,MWI,Malawi,2014,3,3,0
BEL,Belgium,MWI,Malawi,2015,14,4,10
BEL,Belgium,MWI,Malawi,2016,1,6,-5
BEL,Belgium,MWI,Malawi,2017,2,7,-5
CAN,Canada,MWI,Malawi,2008,0,5,-5
CAN,Canada,MWI,Malawi,2009,0,10,-10
CAN,Canada,MWI,Malawi,2010,0,28,-28
CAN,Canada,MWI,Malawi,2011,0,16,-16
CAN,Canada,MWI,Malawi,2012,0,9,-9
CAN,Canada,MWI,Malawi,2013,0,10,-10
CAN,Canada,MWI,Malawi,2014,0,20,-20
CAN,Canada,MWI,Malawi,2015,0,23,-23
CAN,Canada,MWI,Malawi,2016,0,20,-20
CAN,Canada,MWI,Malawi,2017,0,20,-20
CZE,Czech Republic,MWI,Malawi,2012,0,1,-1
CZE,Czech Republic,MWI,Malawi,2013,0,1,-1
CZE,Czech Republic,MWI,Malawi,2015,0,3,-3
CZE,Czech Republic,MWI,Malawi,2016,0,1,-1
DNK,Denmark,MWI,Malawi,2008,4,4,0
DNK,Denmark,MWI,Malawi,2009,2,5,-3
DNK,Denmark,MWI,Malawi,2010,0,3,-3
DNK,Denmark,MWI,Malawi,2011,2,2,0
DNK,Denmark,MWI,Malawi,2012,2,2,0
DNK,Denmark,MWI,Malawi,2013,0,1,-1
DNK,Denmark,MWI,Malawi,2014,0,2,-2
DNK,Denmark,MWI,Malawi,2015,1,0,1
DNK,Denmark,MWI,Malawi,2016,2,2,0
DNK,Denmark,MWI,Malawi,2017,1,1,0
FIN,Finland,MWI,Malawi,2008,0,1,-1
FIN,Finland,MWI,Malawi,2009,0,1,-1
FIN,Finland,MWI,Malawi,2010,1,0,1
FIN,Finland,MWI,Malawi,2011,0,4,-4
FIN,Finland,MWI,Malawi,2012,0,5,-5
FIN,Finland,MWI,Malawi,2013,0,3,-3
FIN,Finland,MWI,Malawi,2014,0,0,0
FIN,Finland,MWI,Malawi,2015,0,1,-1
FIN,Finland,MWI,Malawi,2016,0,0,0
FIN,Finland,MWI,Malawi,2017,0,1,-1
FRA,France,MWI,Malawi,2008,0,2,-2
FRA,France,MWI,Malawi,2009,0,2,-2
FRA,France,MWI,Malawi,2010,0,2,-2
FRA,France,MWI,Malawi,2011,0,1,-1
FRA,France,MWI,Malawi,2012,0,0,0
FRA,France,MWI,Malawi,2013,0,5,-5
FRA,France,MWI,Malawi,2014,0,4,-4
FRA,France,MWI,Malawi,2015,0,2,-2
FRA,France,MWI,Malawi,2016,0,3,-3
FRA,France,MWI,Malawi,2017,0,2,-2
DEU,Germany,MWI,Malawi,2008,28,34,-6
DEU,Germany,MWI,Malawi,2009,36,36,0
DEU,Germany,MWI,Malawi,2010,34,39,-5
DEU,Germany,MWI,Malawi,2011,34,34,0
DEU,Germany,MWI,Malawi,2012,29,32,-3
DEU,Germany,MWI,Malawi,2013,29,31,-2
DEU,Germany,MWI,Malawi,2014,31,33,-2
DEU,Germany,MWI,Malawi,2015,28,43,-15
DEU,Germany,MWI,Malawi,2016,9,23,-14
DEU,Germany,MWI,Malawi,2017,21,38,-17
HUN,Hungary,MWI,Malawi,2008,0,1,-1
HUN,Hungary,MWI,Malawi,2009,0,3,-3
HUN,Hungary,MWI,Malawi,2010,0,1,-1
HUN,Hungary,MWI,Malawi,2011,0,0,0
HUN,Hungary,MWI,Malawi,2012,0,0,0
HUN,Hungary,MWI,Malawi,2013,0,1,-1
HUN,Hungary,MWI,Malawi,2014,0,0,0
HUN,Hungary,MWI,Malawi,2015,0,0,0
HUN,Hungary,MWI,Malawi,2016,1,2,-1
HUN,Hungary,MWI,Malawi,2017,0,1,-1
ISL,Iceland,MWI,Malawi,2008,0,0,0
ISL,Iceland,MWI,Malawi,2009,0,0,0
ISL,Iceland,MWI,Malawi,2010,0,0,0
ISL,Iceland,MWI,Malawi,2011,0,0,0
ISL,Iceland,MWI,Malawi,2012,0,1,-1
ISL,Iceland,MWI,Malawi,2013,3,4,-1
ISL,Iceland,MWI,Malawi,2014,8,8,0
ISL,Iceland,MWI,Malawi,2015,7,7,0
ISL,Iceland,MWI,Malawi,2016,5,4,1
ISL,Iceland,MWI,Malawi,2017,5,4,1
ITA,Italy,MWI,Malawi,2008,1,4,-3
ITA,Italy,MWI,Malawi,2009,1,6,-5
ITA,Italy,MWI,Malawi,2010,0,3,-3
ITA,Italy,MWI,Malawi,2011,1,10,-9
ITA,Italy,MWI,Malawi,2012,1,2,-1
ITA,Italy,MWI,Malawi,2013,0,3,-3
ITA,Italy,MWI,Malawi,2014,0,2,-2
ITA,Italy,MWI,Malawi,2015,2,5,-3
ITA,Italy,MWI,Malawi,2016,0,9,-9
ITA,Italy,MWI,Malawi,2017,1,7,-6
JPN,Japan,MWI,Malawi,2008,146,151,-5
JPN,Japan,MWI,Malawi,2009,125,135,-10
JPN,Japan,MWI,Malawi,2010,14,155,-141
JPN,Japan,MWI,Malawi,2011,154,164,-10
JPN,Japan,MWI,Malawi,2012,203,200,3
JPN,Japan,MWI,Malawi,2013,207,215,-8
JPN,Japan,MWI,Malawi,2014,127,137,-10
JPN,Japan,MWI,Malawi,2015,196,205,-9
JPN,Japan,MWI,Malawi,2016,160,198,-38
JPN,Japan,MWI,Malawi,2017,149,161,-12
KOR,Korea,MWI,Malawi,2008,1,0,1
KOR,Korea,MWI,Malawi,2009,3,3,0
KOR,Korea,MWI,Malawi,2010,2,3,-1
KOR,Korea,MWI,Malawi,2011,5,7,-2
KOR,Korea,MWI,Malawi,2012,10,15,-5
KOR,Korea,MWI,Malawi,2013,6,13,-7
KOR,Korea,MWI,Malawi,2014,11,6,5
KOR,Korea,MWI,Malawi,2015,8,14,-6
KOR,Korea,MWI,Malawi,2016,7,10,-3
KOR,Korea,MWI,Malawi,2017,26,17,9
LUX,Luxembourg,MWI,Malawi,2008,0,0,0
LUX,Luxembourg,MWI,Malawi,2009,0,0,0
LUX,Luxembourg,MWI,Malawi,2010,0,1,-1
LUX,Luxembourg,MWI,Malawi,2011,0,2,-2
LUX,Luxembourg,MWI,Malawi,2012,1,0,1
LUX,Luxembourg,MWI,Malawi,2013,0,0,0
LUX,Luxembourg,MWI,Malawi,2014,0,0,0
LUX,Luxembourg,MWI,Malawi,2015,0,0,0
LUX,Luxembourg,MWI,Malawi,2016,0,1,-1
LUX,Luxembourg,MWI,Malawi,2017,0,0,0
MEX,Mexico,MWI,Malawi,2012,0,0,0
MEX,Mexico,MWI,Malawi,2013,0,0,0
MEX,Mexico,MWI,Malawi,2014,0,0,0
NLD,Netherlands,MWI,Malawi,2008,12,14,-2
NLD,Netherlands,MWI,Malawi,2009,4,14,-10
NLD,Netherlands,MWI,Malawi,2010,20,15,5
NLD,Netherlands,MWI,Malawi,2011,9,11,-2
NLD,Netherlands,MWI,Malawi,2012,10,13,-3
NLD,Netherlands,MWI,Malawi,2013,10,11,-1
NLD,Netherlands,MWI,Malawi,2014,8,9,-1
NLD,Netherlands,MWI,Malawi,2015,16,16,0
NLD,Netherlands,MWI,Malawi,2016,4,14,-10
NLD,Netherlands,MWI,Malawi,2017,12,22,-10
NZL,New Zealand,MWI,Malawi,2008,5,12,-7
NZL,New Zealand,MWI,Malawi,2009,1,9,-8
NZL,New Zealand,MWI,Malawi,2010,2,2,0
NZL,New Zealand,MWI,Malawi,2011,6,2,4
NZL,New Zealand,MWI,Malawi,2012,5,10,-5
NZL,New Zealand,MWI,Malawi,2013,1,4,-3
NZL,New Zealand,MWI,Malawi,2014,0,5,-5
NZL,New Zealand,MWI,Malawi,2015,5,6,-1
NZL,New Zealand,MWI,Malawi,2016,1,6,-5
NZL,New Zealand,MWI,Malawi,2017,1,3,-2
NOR,Norway,MWI,Malawi,2008,26,20,6
NOR,Norway,MWI,Malawi,2009,19,21,-2
NOR,Norway,MWI,Malawi,2010,18,15,3
NOR,Norway,MWI,Malawi,2011,18,23,-5
NOR,Norway,MWI,Malawi,2012,16,15,1
NOR,Norway,MWI,Malawi,2013,14,25,-11
NOR,Norway,MWI,Malawi,2014,22,27,-5
NOR,Norway,MWI,Malawi,2015,25,20,5
NOR,Norway,MWI,Malawi,2016,15,12,3
NOR,Norway,MWI,Malawi,2017,11,9,2
POL,Poland,MWI,Malawi,2009,0,1,-1
POL,Poland,MWI,Malawi,2010,0,0,0
POL,Poland,MWI,Malawi,2011,0,4,-4
POL,Poland,MWI,Malawi,2012,0,4,-4
POL,Poland,MWI,Malawi,2013,0,4,-4
POL,Poland,MWI,Malawi,2014,0,0,0
POL,Poland,MWI,Malawi,2015,0,1,-1
POL,Poland,MWI,Malawi,2016,0,1,-1
POL,Poland,MWI,Malawi,2017,0,2,-2
SVK,Slovak Republic,MWI,Malawi,2008,0,1,-1
SVK,Slovak Republic,MWI,Malawi,2009,0,2,-2
SVK,Slovak Republic,MWI,Malawi,2010,0,1,-1
ESP,Spain,MWI,Malawi,2008,1,4,-3
ESP,Spain,MWI,Malawi,2009,2,2,0
ESP,Spain,MWI,Malawi,2010,0,3,-3
ESP,Spain,MWI,Malawi,2011,1,15,-14
ESP,Spain,MWI,Malawi,2012,0,12,-12
ESP,Spain,MWI,Malawi,2013,7,7,0
ESP,Spain,MWI,Malawi,2014,3,5,-2
ESP,Spain,MWI,Malawi,2015,0,5,-5
ESP,Spain,MWI,Malawi,2016,2,4,-2
ESP,Spain,MWI,Malawi,2017,4,7,-3
SWE,Sweden,MWI,Malawi,2008,2,5,-3
SWE,Sweden,MWI,Malawi,2009,1,3,-2
SWE,Sweden,MWI,Malawi,2010,0,1,-1
SWE,Sweden,MWI,Malawi,2011,6,2,4
SWE,Sweden,MWI,Malawi,2012,2,8,-6
SWE,Sweden,MWI,Malawi,2013,2,1,1
SWE,Sweden,MWI,Malawi,2014,1,3,-2
SWE,Sweden,MWI,Malawi,2015,3,1,2
SWE,Sweden,MWI,Malawi,2016,8,8,0
SWE,Sweden,MWI,Malawi,2017,1,6,-5
CHE,Switzerland,MWI,Malawi,2010,2,7,-5
CHE,Switzerland,MWI,Malawi,2011,5,4,1
CHE,Switzerland,MWI,Malawi,2012,3,4,-1
CHE,Switzerland,MWI,Malawi,2013,1,4,-3
CHE,Switzerland,MWI,Malawi,2014,3,1,2
CHE,Switzerland,MWI,Malawi,2015,2,5,-3
CHE,Switzerland,MWI,Malawi,2016,2,10,-8
CHE,Switzerland,MWI,Malawi,2017,2,9,-7
TUR,Turkey,MWI,Malawi,2010,0,8,-8
USA,United States,MWI,Malawi,2008,0,133,-133
USA,United States,MWI,Malawi,2009,0,164,-164
USA,United States,MWI,Malawi,2010,0,164,-164
USA,United States,MWI,Malawi,2011,0,123,-123
USA,United States,MWI,Malawi,2012,0,192,-192
USA,United States,MWI,Malawi,2013,0,159,-159
USA,United States,MWI,Malawi,2014,0,172,-172
USA,United States,MWI,Malawi,2015,0,160,-160
USA,United States,MWI,Malawi,2016,0,205,-205
USA,United States,MWI,Malawi,2017,0,228,-228
CHL,Chile,MWI,Malawi,2008,0,0,0
CHL,Chile,MWI,Malawi,2009,0,0,0
CHL,Chile,MWI,Malawi,2010,0,0,0
CHL,Chile,MWI,Malawi,2011,0,0,0
CHL,Chile,MWI,Malawi,2012,0,0,0
CHL,Chile,MWI,Malawi,2013,0,0,0
CHL,Chile,MWI,Malawi,2014,0,0,0
CHL,Chile,MWI,Malawi,2015,0,0,0
CHL,Chile,MWI,Malawi,2016,0,0,0
EST,Estonia,MWI,Malawi,2008,0,0,0
EST,Estonia,MWI,Malawi,2009,0,0,0
EST,Estonia,MWI,Malawi,2010,0,0,0
EST,Estonia,MWI,Malawi,2011,0,0,0
EST,Estonia,MWI,Malawi,2012,0,0,0
EST,Estonia,MWI,Malawi,2013,0,0,0
EST,Estonia,MWI,Malawi,2014,0,0,0
EST,Estonia,MWI,Malawi,2015,0,0,0
EST,Estonia,MWI,Malawi,2016,0,0,0
EST,Estonia,MWI,Malawi,2017,0,0,0
SVN,Slovenia,MWI,Malawi,2017,0,1,-1
AUS,Australia,MYS,Malaysia,2008,603,5117,-4514
AUS,Australia,MYS,Malaysia,2009,507,5382,-4875
AUS,Australia,MYS,Malaysia,2010,511,4920,-4409
AUS,Australia,MYS,Malaysia,2011,611,4946,-4335
AUS,Australia,MYS,Malaysia,2012,536,5374,-4838
AUS,Australia,MYS,Malaysia,2013,570,5615,-5045
AUS,Australia,MYS,Malaysia,2014,620,4465,-3845
AUS,Australia,MYS,Malaysia,2015,600,4041,-3441
AUS,Australia,MYS,Malaysia,2016,600,4128,-3528
AUS,Australia,MYS,Malaysia,2017,0,4238,-4238
AUT,Austria,MYS,Malaysia,2008,40,22,18
AUT,Austria,MYS,Malaysia,2009,34,20,14
AUT,Austria,MYS,Malaysia,2010,12,34,-22
AUT,Austria,MYS,Malaysia,2011,40,56,-16
AUT,Austria,MYS,Malaysia,2012,28,48,-20
AUT,Austria,MYS,Malaysia,2013,43,43,0
AUT,Austria,MYS,Malaysia,2014,28,45,-17
AUT,Austria,MYS,Malaysia,2015,35,40,-5
AUT,Austria,MYS,Malaysia,2016,40,60,-20
AUT,Austria,MYS,Malaysia,2017,44,56,-12
BEL,Belgium,MYS,Malaysia,2008,0,67,-67
BEL,Belgium,MYS,Malaysia,2009,0,54,-54
BEL,Belgium,MYS,Malaysia,2010,28,72,-44
BEL,Belgium,MYS,Malaysia,2012,55,69,-14
BEL,Belgium,MYS,Malaysia,2013,62,66,-4
BEL,Belgium,MYS,Malaysia,2014,30,39,-9
BEL,Belgium,MYS,Malaysia,2015,45,41,4
BEL,Belgium,MYS,Malaysia,2016,27,56,-29
BEL,Belgium,MYS,Malaysia,2017,24,63,-39
CAN,Canada,MYS,Malaysia,2008,0,658,-658
CAN,Canada,MYS,Malaysia,2009,0,640,-640
CAN,Canada,MYS,Malaysia,2010,0,799,-799
CAN,Canada,MYS,Malaysia,2011,0,409,-409
CAN,Canada,MYS,Malaysia,2012,0,356,-356
CAN,Canada,MYS,Malaysia,2013,0,204,-204
CAN,Canada,MYS,Malaysia,2014,0,336,-336
CAN,Canada,MYS,Malaysia,2015,0,332,-332
CAN,Canada,MYS,Malaysia,2016,0,365,-365
CAN,Canada,MYS,Malaysia,2017,0,360,-360
CZE,Czech Republic,MYS,Malaysia,2008,0,116,-116
CZE,Czech Republic,MYS,Malaysia,2009,0,95,-95
CZE,Czech Republic,MYS,Malaysia,2010,0,82,-82
CZE,Czech Republic,MYS,Malaysia,2011,0,70,-70
CZE,Czech Republic,MYS,Malaysia,2012,68,98,-30
CZE,Czech Republic,MYS,Malaysia,2013,92,32,60
CZE,Czech Republic,MYS,Malaysia,2014,91,60,31
CZE,Czech Republic,MYS,Malaysia,2015,78,43,35
CZE,Czech Republic,MYS,Malaysia,2016,91,55,36
CZE,Czech Republic,MYS,Malaysia,2017,100,58,42
DNK,Denmark,MYS,Malaysia,2008,18,56,-38
DNK,Denmark,MYS,Malaysia,2009,30,52,-22
DNK,Denmark,MYS,Malaysia,2010,31,32,-1
DNK,Denmark,MYS,Malaysia,2011,51,54,-3
DNK,Denmark,MYS,Malaysia,2012,43,60,-17
DNK,Denmark,MYS,Malaysia,2013,63,65,-2
DNK,Denmark,MYS,Malaysia,2014,60,42,18
DNK,Denmark,MYS,Malaysia,2015,48,46,2
DNK,Denmark,MYS,Malaysia,2016,63,60,3
DNK,Denmark,MYS,Malaysia,2017,54,40,14
FIN,Finland,MYS,Malaysia,2008,5,29,-24
FIN,Finland,MYS,Malaysia,2009,13,30,-17
FIN,Finland,MYS,Malaysia,2010,7,19,-12
FIN,Finland,MYS,Malaysia,2011,6,19,-13
FIN,Finland,MYS,Malaysia,2012,9,25,-16
FIN,Finland,MYS,Malaysia,2013,19,21,-2
FIN,Finland,MYS,Malaysia,2014,11,28,-17
FIN,Finland,MYS,Malaysia,2015,10,18,-8
FIN,Finland,MYS,Malaysia,2016,18,26,-8
FIN,Finland,MYS,Malaysia,2017,3,34,-31
FRA,France,MYS,Malaysia,2008,0,100,-100
FRA,France,MYS,Malaysia,2009,0,103,-103
FRA,France,MYS,Malaysia,2010,0,116,-116
FRA,France,MYS,Malaysia,2011,0,129,-129
FRA,France,MYS,Malaysia,2012,0,191,-191
FRA,France,MYS,Malaysia,2013,0,111,-111
FRA,France,MYS,Malaysia,2014,0,148,-148
FRA,France,MYS,Malaysia,2015,0,113,-113
FRA,France,MYS,Malaysia,2016,0,115,-115
FRA,France,MYS,Malaysia,2017,0,108,-108
DEU,Germany,MYS,Malaysia,2008,674,827,-153
DEU,Germany,MYS,Malaysia,2009,654,696,-42
DEU,Germany,MYS,Malaysia,2010,742,618,124
DEU,Germany,MYS,Malaysia,2011,643,701,-58
DEU,Germany,MYS,Malaysia,2012,525,652,-127
DEU,Germany,MYS,Malaysia,2013,564,716,-152
DEU,Germany,MYS,Malaysia,2014,608,794,-186
DEU,Germany,MYS,Malaysia,2015,656,793,-137
DEU,Germany,MYS,Malaysia,2016,527,902,-375
DEU,Germany,MYS,Malaysia,2017,548,901,-353
HUN,Hungary,MYS,Malaysia,2008,2,32,-30
HUN,Hungary,MYS,Malaysia,2009,3,16,-13
HUN,Hungary,MYS,Malaysia,2010,3,36,-33
HUN,Hungary,MYS,Malaysia,2011,2,34,-32
HUN,Hungary,MYS,Malaysia,2012,5,10,-5
HUN,Hungary,MYS,Malaysia,2013,6,11,-5
HUN,Hungary,MYS,Malaysia,2014,6,24,-18
HUN,Hungary,MYS,Malaysia,2015,4,19,-15
HUN,Hungary,MYS,Malaysia,2016,3,28,-25
HUN,Hungary,MYS,Malaysia,2017,0,41,-41
ISL,Iceland,MYS,Malaysia,2008,1,2,-1
ISL,Iceland,MYS,Malaysia,2009,3,2,1
ISL,Iceland,MYS,Malaysia,2010,1,4,-3
ISL,Iceland,MYS,Malaysia,2011,1,0,1
ISL,Iceland,MYS,Malaysia,2012,0,3,-3
ISL,Iceland,MYS,Malaysia,2013,3,0,3
ISL,Iceland,MYS,Malaysia,2014,0,2,-2
ISL,Iceland,MYS,Malaysia,2015,0,0,0
ISL,Iceland,MYS,Malaysia,2016,0,1,-1
ISL,Iceland,MYS,Malaysia,2017,0,4,-4
ITA,Italy,MYS,Malaysia,2008,12,37,-25
ITA,Italy,MYS,Malaysia,2009,14,30,-16
ITA,Italy,MYS,Malaysia,2010,17,37,-20
ITA,Italy,MYS,Malaysia,2011,4,31,-27
ITA,Italy,MYS,Malaysia,2012,13,66,-53
ITA,Italy,MYS,Malaysia,2013,8,72,-64
ITA,Italy,MYS,Malaysia,2014,14,40,-26
ITA,Italy,MYS,Malaysia,2015,8,78,-70
ITA,Italy,MYS,Malaysia,2016,0,79,-79
ITA,Italy,MYS,Malaysia,2017,20,124,-104
JPN,Japan,MYS,Malaysia,2008,1967,2640,-673
JPN,Japan,MYS,Malaysia,2009,1921,2320,-399
JPN,Japan,MYS,Malaysia,2010,1874,2318,-444
JPN,Japan,MYS,Malaysia,2011,1900,2170,-270
JPN,Japan,MYS,Malaysia,2012,2256,2504,-248
JPN,Japan,MYS,Malaysia,2013,1670,2126,-456
JPN,Japan,MYS,Malaysia,2014,1690,2164,-474
JPN,Japan,MYS,Malaysia,2015,1702,2284,-582
JPN,Japan,MYS,Malaysia,2016,2004,2476,-472
JPN,Japan,MYS,Malaysia,2017,2015,2689,-674
KOR,Korea,MYS,Malaysia,2008,349,436,-87
KOR,Korea,MYS,Malaysia,2009,365,432,-67
KOR,Korea,MYS,Malaysia,2010,437,581,-144
KOR,Korea,MYS,Malaysia,2011,690,594,96
KOR,Korea,MYS,Malaysia,2012,959,715,244
KOR,Korea,MYS,Malaysia,2013,710,963,-253
KOR,Korea,MYS,Malaysia,2014,948,1184,-236
KOR,Korea,MYS,Malaysia,2015,1197,1285,-88
KOR,Korea,MYS,Malaysia,2016,1344,1521,-177
KOR,Korea,MYS,Malaysia,2017,2027,3798,-1771
LUX,Luxembourg,MYS,Malaysia,2008,0,8,-8
LUX,Luxembourg,MYS,Malaysia,2009,2,2,0
LUX,Luxembourg,MYS,Malaysia,2010,1,1,0
LUX,Luxembourg,MYS,Malaysia,2011,0,7,-7
LUX,Luxembourg,MYS,Malaysia,2012,2,4,-2
LUX,Luxembourg,MYS,Malaysia,2013,4,7,-3
LUX,Luxembourg,MYS,Malaysia,2014,5,7,-2
LUX,Luxembourg,MYS,Malaysia,2015,1,3,-2
LUX,Luxembourg,MYS,Malaysia,2016,5,13,-8
LUX,Luxembourg,MYS,Malaysia,2017,2,20,-18
MEX,Mexico,MYS,Malaysia,2008,0,4,-4
MEX,Mexico,MYS,Malaysia,2009,0,4,-4
MEX,Mexico,MYS,Malaysia,2010,0,12,-12
MEX,Mexico,MYS,Malaysia,2011,0,6,-6
MEX,Mexico,MYS,Malaysia,2012,0,0,0
MEX,Mexico,MYS,Malaysia,2013,0,15,-15
MEX,Mexico,MYS,Malaysia,2014,0,5,-5
MEX,Mexico,MYS,Malaysia,2015,0,3,-3
MEX,Mexico,MYS,Malaysia,2016,0,3,-3
MEX,Mexico,MYS,Malaysia,2017,0,6,-6
NLD,Netherlands,MYS,Malaysia,2008,186,235,-49
NLD,Netherlands,MYS,Malaysia,2009,169,216,-47
NLD,Netherlands,MYS,Malaysia,2010,307,255,52
NLD,Netherlands,MYS,Malaysia,2011,204,198,6
NLD,Netherlands,MYS,Malaysia,2012,182,249,-67
NLD,Netherlands,MYS,Malaysia,2013,190,233,-43
NLD,Netherlands,MYS,Malaysia,2014,214,237,-23
NLD,Netherlands,MYS,Malaysia,2015,192,250,-58
NLD,Netherlands,MYS,Malaysia,2016,182,230,-48
NLD,Netherlands,MYS,Malaysia,2017,188,228,-40
NZL,New Zealand,MYS,Malaysia,2008,704,1346,-642
NZL,New Zealand,MYS,Malaysia,2009,755,1238,-483
NZL,New Zealand,MYS,Malaysia,2010,907,1282,-375
NZL,New Zealand,MYS,Malaysia,2011,913,1336,-423
NZL,New Zealand,MYS,Malaysia,2012,750,1098,-348
NZL,New Zealand,MYS,Malaysia,2013,557,913,-356
NZL,New Zealand,MYS,Malaysia,2014,476,949,-473
NZL,New Zealand,MYS,Malaysia,2015,446,1085,-639
NZL,New Zealand,MYS,Malaysia,2016,325,1241,-916
NZL,New Zealand,MYS,Malaysia,2017,448,1304,-856
NOR,Norway,MYS,Malaysia,2008,9,64,-55
NOR,Norway,MYS,Malaysia,2009,33,80,-47
NOR,Norway,MYS,Malaysia,2010,39,53,-14
NOR,Norway,MYS,Malaysia,2011,63,107,-44
NOR,Norway,MYS,Malaysia,2012,65,105,-40
NOR,Norway,MYS,Malaysia,2013,49,84,-35
NOR,Norway,MYS,Malaysia,2014,62,70,-8
NOR,Norway,MYS,Malaysia,2015,50,66,-16
NOR,Norway,MYS,Malaysia,2016,60,61,-1
NOR,Norway,MYS,Malaysia,2017,29,43,-14
POL,Poland,MYS,Malaysia,2008,0,48,-48
POL,Poland,MYS,Malaysia,2009,0,90,-90
POL,Poland,MYS,Malaysia,2010,0,116,-116
POL,Poland,MYS,Malaysia,2011,0,154,-154
POL,Poland,MYS,Malaysia,2012,0,157,-157
POL,Poland,MYS,Malaysia,2013,0,199,-199
POL,Poland,MYS,Malaysia,2014,0,156,-156
POL,Poland,MYS,Malaysia,2015,0,143,-143
POL,Poland,MYS,Malaysia,2016,0,39,-39
POL,Poland,MYS,Malaysia,2017,0,93,-93
SVK,Slovak Republic,MYS,Malaysia,2008,2,1,1
SVK,Slovak Republic,MYS,Malaysia,2009,5,1,4
SVK,Slovak Republic,MYS,Malaysia,2010,38,1,37
SVK,Slovak Republic,MYS,Malaysia,2011,4,1,3
SVK,Slovak Republic,MYS,Malaysia,2012,0,2,-2
SVK,Slovak Republic,MYS,Malaysia,2015,0,1,-1
ESP,Spain,MYS,Malaysia,2008,28,52,-24
ESP,Spain,MYS,Malaysia,2009,33,49,-16
ESP,Spain,MYS,Malaysia,2010,29,34,-5
ESP,Spain,MYS,Malaysia,2011,30,80,-50
ESP,Spain,MYS,Malaysia,2012,40,60,-20
ESP,Spain,MYS,Malaysia,2013,36,49,-13
ESP,Spain,MYS,Malaysia,2014,21,66,-45
ESP,Spain,MYS,Malaysia,2015,15,49,-34
ESP,Spain,MYS,Malaysia,2016,42,66,-24
ESP,Spain,MYS,Malaysia,2017,77,81,-4
SWE,Sweden,MYS,Malaysia,2008,31,78,-47
SWE,Sweden,MYS,Malaysia,2009,25,67,-42
SWE,Sweden,MYS,Malaysia,2010,46,46,0
SWE,Sweden,MYS,Malaysia,2011,36,60,-24
SWE,Sweden,MYS,Malaysia,2012,34,56,-22
SWE,Sweden,MYS,Malaysia,2013,36,68,-32
SWE,Sweden,MYS,Malaysia,2014,30,69,-39
SWE,Sweden,MYS,Malaysia,2015,71,51,20
SWE,Sweden,MYS,Malaysia,2016,40,60,-20
SWE,Sweden,MYS,Malaysia,2017,33,61,-28
CHE,Switzerland,MYS,Malaysia,2010,199,259,-60
CHE,Switzerland,MYS,Malaysia,2011,219,251,-32
CHE,Switzerland,MYS,Malaysia,2012,204,261,-57
CHE,Switzerland,MYS,Malaysia,2013,201,189,12
CHE,Switzerland,MYS,Malaysia,2014,169,212,-43
CHE,Switzerland,MYS,Malaysia,2015,171,185,-14
CHE,Switzerland,MYS,Malaysia,2016,113,206,-93
CHE,Switzerland,MYS,Malaysia,2017,176,202,-26
TUR,Turkey,MYS,Malaysia,2010,0,7,-7
TUR,Turkey,MYS,Malaysia,2016,146,139,7
TUR,Turkey,MYS,Malaysia,2017,109,279,-170
GBR,United Kingdom,MYS,Malaysia,2008,2000,11000,-9000
GBR,United Kingdom,MYS,Malaysia,2009,3000,7000,-4000
GBR,United Kingdom,MYS,Malaysia,2010,2000,9000,-7000
GBR,United Kingdom,MYS,Malaysia,2011,4000,4000,0
GBR,United Kingdom,MYS,Malaysia,2012,4000,6000,-2000
GBR,United Kingdom,MYS,Malaysia,2013,4000,9000,-5000
GBR,United Kingdom,MYS,Malaysia,2014,2000,6000,-4000
GBR,United Kingdom,MYS,Malaysia,2015,4000,8000,-4000
USA,United States,MYS,Malaysia,2008,0,1945,-1945
USA,United States,MYS,Malaysia,2009,0,2014,-2014
USA,United States,MYS,Malaysia,2010,0,1714,-1714
USA,United States,MYS,Malaysia,2011,0,2273,-2273
USA,United States,MYS,Malaysia,2012,0,2605,-2605
USA,United States,MYS,Malaysia,2013,0,2477,-2477
USA,United States,MYS,Malaysia,2014,0,2622,-2622
USA,United States,MYS,Malaysia,2015,0,2749,-2749
USA,United States,MYS,Malaysia,2016,0,3382,-3382
USA,United States,MYS,Malaysia,2017,0,4109,-4109
CHL,Chile,MYS,Malaysia,2008,0,5,-5
CHL,Chile,MYS,Malaysia,2009,0,5,-5
CHL,Chile,MYS,Malaysia,2010,0,3,-3
CHL,Chile,MYS,Malaysia,2011,0,4,-4
CHL,Chile,MYS,Malaysia,2012,0,4,-4
CHL,Chile,MYS,Malaysia,2013,0,6,-6
CHL,Chile,MYS,Malaysia,2014,0,10,-10
CHL,Chile,MYS,Malaysia,2015,0,12,-12
CHL,Chile,MYS,Malaysia,2016,0,4,-4
EST,Estonia,MYS,Malaysia,2008,0,3,-3
EST,Estonia,MYS,Malaysia,2009,0,0,0
EST,Estonia,MYS,Malaysia,2010,0,0,0
EST,Estonia,MYS,Malaysia,2011,0,0,0
EST,Estonia,MYS,Malaysia,2012,0,1,-1
EST,Estonia,MYS,Malaysia,2013,0,5,-5
EST,Estonia,MYS,Malaysia,2014,0,0,0
EST,Estonia,MYS,Malaysia,2015,0,3,-3
EST,Estonia,MYS,Malaysia,2016,0,2,-2
EST,Estonia,MYS,Malaysia,2017,0,4,-4
SVN,Slovenia,MYS,Malaysia,2009,0,3,-3
SVN,Slovenia,MYS,Malaysia,2010,0,7,-7
SVN,Slovenia,MYS,Malaysia,2011,0,3,-3
SVN,Slovenia,MYS,Malaysia,2012,0,2,-2
SVN,Slovenia,MYS,Malaysia,2013,0,3,-3
SVN,Slovenia,MYS,Malaysia,2014,0,1,-1
SVN,Slovenia,MYS,Malaysia,2015,0,2,-2
SVN,Slovenia,MYS,Malaysia,2016,0,1,-1
SVN,Slovenia,MYS,Malaysia,2017,0,3,-3
AUS,Australia,MDV,Maldives,2008,7,35,-28
AUS,Australia,MDV,Maldives,2009,0,26,-26
AUS,Australia,MDV,Maldives,2010,6,43,-37
AUS,Australia,MDV,Maldives,2011,7,17,-10
AUS,Australia,MDV,Maldives,2012,0,24,-24
AUS,Australia,MDV,Maldives,2013,0,44,-44
AUS,Australia,MDV,Maldives,2014,5,32,-27
AUS,Australia,MDV,Maldives,2015,0,38,-38
AUS,Australia,MDV,Maldives,2016,0,38,-38
AUS,Australia,MDV,Maldives,2017,0,35,-35
AUT,Austria,MDV,Maldives,2008,1,1,0
AUT,Austria,MDV,Maldives,2009,1,0,1
AUT,Austria,MDV,Maldives,2010,0,0,0
AUT,Austria,MDV,Maldives,2011,0,1,-1
AUT,Austria,MDV,Maldives,2012,0,0,0
AUT,Austria,MDV,Maldives,2013,0,2,-2
AUT,Austria,MDV,Maldives,2014,0,1,-1
AUT,Austria,MDV,Maldives,2015,2,2,0
AUT,Austria,MDV,Maldives,2016,1,1,0
AUT,Austria,MDV,Maldives,2017,1,2,-1
BEL,Belgium,MDV,Maldives,2008,0,1,-1
BEL,Belgium,MDV,Maldives,2009,0,0,0
BEL,Belgium,MDV,Maldives,2010,0,0,0
BEL,Belgium,MDV,Maldives,2016,0,1,-1
BEL,Belgium,MDV,Maldives,2017,0,2,-2
CAN,Canada,MDV,Maldives,2008,0,1,-1
CAN,Canada,MDV,Maldives,2009,0,7,-7
CAN,Canada,MDV,Maldives,2010,0,4,-4
CAN,Canada,MDV,Maldives,2011,0,3,-3
CAN,Canada,MDV,Maldives,2012,0,1,-1
CAN,Canada,MDV,Maldives,2013,0,1,-1
CAN,Canada,MDV,Maldives,2014,0,0,0
CAN,Canada,MDV,Maldives,2015,0,0,0
CAN,Canada,MDV,Maldives,2016,0,0,0
CAN,Canada,MDV,Maldives,2017,0,0,0
DNK,Denmark,MDV,Maldives,2008,0,0,0
DNK,Denmark,MDV,Maldives,2009,0,1,-1
DNK,Denmark,MDV,Maldives,2010,1,1,0
DNK,Denmark,MDV,Maldives,2012,1,0,1
DNK,Denmark,MDV,Maldives,2013,1,3,-2
DNK,Denmark,MDV,Maldives,2014,0,0,0
DNK,Denmark,MDV,Maldives,2015,1,1,0
DNK,Denmark,MDV,Maldives,2016,1,3,-2
DNK,Denmark,MDV,Maldives,2017,0,1,-1
FIN,Finland,MDV,Maldives,2008,0,0,0
FIN,Finland,MDV,Maldives,2009,0,0,0
FIN,Finland,MDV,Maldives,2010,1,0,1
FIN,Finland,MDV,Maldives,2011,0,0,0
FIN,Finland,MDV,Maldives,2012,0,0,0
FIN,Finland,MDV,Maldives,2013,0,1,-1
FIN,Finland,MDV,Maldives,2014,0,0,0
FIN,Finland,MDV,Maldives,2015,0,1,-1
FIN,Finland,MDV,Maldives,2016,1,0,1
FIN,Finland,MDV,Maldives,2017,0,0,0
FRA,France,MDV,Maldives,2008,0,0,0
FRA,France,MDV,Maldives,2009,0,1,-1
FRA,France,MDV,Maldives,2010,0,2,-2
FRA,France,MDV,Maldives,2011,0,2,-2
FRA,France,MDV,Maldives,2012,0,2,-2
FRA,France,MDV,Maldives,2013,0,0,0
FRA,France,MDV,Maldives,2014,0,2,-2
FRA,France,MDV,Maldives,2015,0,1,-1
FRA,France,MDV,Maldives,2016,0,2,-2
FRA,France,MDV,Maldives,2017,0,2,-2
DEU,Germany,MDV,Maldives,2008,6,6,0
DEU,Germany,MDV,Maldives,2009,6,5,1
DEU,Germany,MDV,Maldives,2010,4,14,-10
DEU,Germany,MDV,Maldives,2011,4,2,2
DEU,Germany,MDV,Maldives,2012,2,3,-1
DEU,Germany,MDV,Maldives,2013,4,11,-7
DEU,Germany,MDV,Maldives,2014,2,11,-9
DEU,Germany,MDV,Maldives,2015,4,13,-9
DEU,Germany,MDV,Maldives,2016,6,14,-8
DEU,Germany,MDV,Maldives,2017,6,7,-1
HUN,Hungary,MDV,Maldives,2008,0,1,-1
HUN,Hungary,MDV,Maldives,2009,0,0,0
HUN,Hungary,MDV,Maldives,2010,0,1,-1
HUN,Hungary,MDV,Maldives,2011,0,0,0
HUN,Hungary,MDV,Maldives,2012,0,0,0
HUN,Hungary,MDV,Maldives,2013,0,0,0
HUN,Hungary,MDV,Maldives,2014,0,0,0
HUN,Hungary,MDV,Maldives,2015,0,0,0
HUN,Hungary,MDV,Maldives,2016,0,1,-1
HUN,Hungary,MDV,Maldives,2017,0,0,0
ISL,Iceland,MDV,Maldives,2016,0,0,0
ISL,Iceland,MDV,Maldives,2017,0,0,0
ITA,Italy,MDV,Maldives,2008,0,2,-2
ITA,Italy,MDV,Maldives,2009,0,4,-4
ITA,Italy,MDV,Maldives,2010,0,2,-2
ITA,Italy,MDV,Maldives,2011,0,3,-3
ITA,Italy,MDV,Maldives,2012,0,3,-3
ITA,Italy,MDV,Maldives,2013,0,0,0
ITA,Italy,MDV,Maldives,2015,1,2,-1
ITA,Italy,MDV,Maldives,2016,0,3,-3
ITA,Italy,MDV,Maldives,2017,0,3,-3
JPN,Japan,MDV,Maldives,2008,46,53,-7
JPN,Japan,MDV,Maldives,2009,73,80,-7
JPN,Japan,MDV,Maldives,2010,58,60,-2
JPN,Japan,MDV,Maldives,2011,65,68,-3
JPN,Japan,MDV,Maldives,2012,76,77,-1
JPN,Japan,MDV,Maldives,2013,63,76,-13
JPN,Japan,MDV,Maldives,2014,92,89,3
JPN,Japan,MDV,Maldives,2015,85,97,-12
JPN,Japan,MDV,Maldives,2016,81,85,-4
JPN,Japan,MDV,Maldives,2017,81,85,-4
KOR,Korea,MDV,Maldives,2008,2,0,2
KOR,Korea,MDV,Maldives,2009,0,1,-1
KOR,Korea,MDV,Maldives,2010,2,1,1
KOR,Korea,MDV,Maldives,2011,2,2,0
KOR,Korea,MDV,Maldives,2012,1,2,-1
KOR,Korea,MDV,Maldives,2013,1,3,-2
KOR,Korea,MDV,Maldives,2014,3,2,1
KOR,Korea,MDV,Maldives,2015,2,3,-1
KOR,Korea,MDV,Maldives,2016,4,2,2
KOR,Korea,MDV,Maldives,2017,5,5,0
LUX,Luxembourg,MDV,Maldives,2008,0,0,0
LUX,Luxembourg,MDV,Maldives,2009,0,0,0
LUX,Luxembourg,MDV,Maldives,2010,0,0,0
LUX,Luxembourg,MDV,Maldives,2011,0,0,0
LUX,Luxembourg,MDV,Maldives,2012,0,0,0
LUX,Luxembourg,MDV,Maldives,2013,0,0,0
LUX,Luxembourg,MDV,Maldives,2014,0,0,0
LUX,Luxembourg,MDV,Maldives,2015,0,0,0
LUX,Luxembourg,MDV,Maldives,2016,0,0,0
LUX,Luxembourg,MDV,Maldives,2017,0,0,0
MEX,Mexico,MDV,Maldives,2012,0,0,0
MEX,Mexico,MDV,Maldives,2013,0,0,0
MEX,Mexico,MDV,Maldives,2014,0,0,0
NLD,Netherlands,MDV,Maldives,2008,0,2,-2
NLD,Netherlands,MDV,Maldives,2013,0,1,-1
NLD,Netherlands,MDV,Maldives,2014,1,2,-1
NLD,Netherlands,MDV,Maldives,2015,1,2,-1
NLD,Netherlands,MDV,Maldives,2016,0,7,-7
NLD,Netherlands,MDV,Maldives,2017,2,3,-1
NZL,New Zealand,MDV,Maldives,2008,13,20,-7
NZL,New Zealand,MDV,Maldives,2009,27,27,0
NZL,New Zealand,MDV,Maldives,2010,8,39,-31
NZL,New Zealand,MDV,Maldives,2011,19,13,6
NZL,New Zealand,MDV,Maldives,2012,15,16,-1
NZL,New Zealand,MDV,Maldives,2013,21,15,6
NZL,New Zealand,MDV,Maldives,2014,4,18,-14
NZL,New Zealand,MDV,Maldives,2015,7,11,-4
NZL,New Zealand,MDV,Maldives,2016,8,13,-5
NZL,New Zealand,MDV,Maldives,2017,5,15,-10
NOR,Norway,MDV,Maldives,2008,3,0,3
NOR,Norway,MDV,Maldives,2009,1,1,0
NOR,Norway,MDV,Maldives,2010,1,3,-2
NOR,Norway,MDV,Maldives,2011,0,2,-2
NOR,Norway,MDV,Maldives,2012,1,3,-2
NOR,Norway,MDV,Maldives,2013,2,1,1
NOR,Norway,MDV,Maldives,2014,4,0,4
NOR,Norway,MDV,Maldives,2015,1,3,-2
NOR,Norway,MDV,Maldives,2016,2,0,2
NOR,Norway,MDV,Maldives,2017,1,1,0
POL,Poland,MDV,Maldives,2009,0,0,0
POL,Poland,MDV,Maldives,2010,0,0,0
POL,Poland,MDV,Maldives,2011,0,0,0
POL,Poland,MDV,Maldives,2012,0,0,0
POL,Poland,MDV,Maldives,2013,0,0,0
POL,Poland,MDV,Maldives,2014,0,0,0
POL,Poland,MDV,Maldives,2015,0,0,0
POL,Poland,MDV,Maldives,2016,0,0,0
POL,Poland,MDV,Maldives,2017,0,0,0
SVK,Slovak Republic,MDV,Maldives,2008,0,0,0
SVK,Slovak Republic,MDV,Maldives,2013,0,1,-1
ESP,Spain,MDV,Maldives,2008,0,0,0
ESP,Spain,MDV,Maldives,2009,1,1,0
ESP,Spain,MDV,Maldives,2010,1,1,0
ESP,Spain,MDV,Maldives,2011,0,1,-1
ESP,Spain,MDV,Maldives,2012,0,1,-1
ESP,Spain,MDV,Maldives,2013,0,4,-4
ESP,Spain,MDV,Maldives,2014,0,3,-3
ESP,Spain,MDV,Maldives,2015,0,3,-3
ESP,Spain,MDV,Maldives,2016,0,3,-3
ESP,Spain,MDV,Maldives,2017,2,3,-1
SWE,Sweden,MDV,Maldives,2008,0,1,-1
SWE,Sweden,MDV,Maldives,2009,0,0,0
SWE,Sweden,MDV,Maldives,2010,0,1,-1
SWE,Sweden,MDV,Maldives,2011,0,0,0
SWE,Sweden,MDV,Maldives,2012,2,3,-1
SWE,Sweden,MDV,Maldives,2013,0,3,-3
SWE,Sweden,MDV,Maldives,2014,0,2,-2
SWE,Sweden,MDV,Maldives,2015,2,4,-2
SWE,Sweden,MDV,Maldives,2016,0,2,-2
SWE,Sweden,MDV,Maldives,2017,2,1,1
CHE,Switzerland,MDV,Maldives,2010,2,2,0
CHE,Switzerland,MDV,Maldives,2011,2,1,1
CHE,Switzerland,MDV,Maldives,2012,2,10,-8
CHE,Switzerland,MDV,Maldives,2013,3,3,0
CHE,Switzerland,MDV,Maldives,2014,4,5,-1
CHE,Switzerland,MDV,Maldives,2015,2,4,-2
CHE,Switzerland,MDV,Maldives,2016,4,3,1
CHE,Switzerland,MDV,Maldives,2017,1,7,-6
USA,United States,MDV,Maldives,2008,0,2,-2
USA,United States,MDV,Maldives,2009,0,6,-6
USA,United States,MDV,Maldives,2010,0,5,-5
USA,United States,MDV,Maldives,2011,0,3,-3
USA,United States,MDV,Maldives,2012,0,3,-3
USA,United States,MDV,Maldives,2013,0,5,-5
USA,United States,MDV,Maldives,2014,0,13,-13
USA,United States,MDV,Maldives,2015,0,8,-8
USA,United States,MDV,Maldives,2016,0,11,-11
USA,United States,MDV,Maldives,2017,0,5,-5
CHL,Chile,MDV,Maldives,2008,0,0,0
CHL,Chile,MDV,Maldives,2009,0,0,0
CHL,Chile,MDV,Maldives,2010,0,0,0
CHL,Chile,MDV,Maldives,2011,0,0,0
CHL,Chile,MDV,Maldives,2012,0,0,0
CHL,Chile,MDV,Maldives,2013,0,0,0
CHL,Chile,MDV,Maldives,2014,0,0,0
CHL,Chile,MDV,Maldives,2015,0,0,0
CHL,Chile,MDV,Maldives,2016,0,0,0
EST,Estonia,MDV,Maldives,2008,0,1,-1
EST,Estonia,MDV,Maldives,2009,0,0,0
EST,Estonia,MDV,Maldives,2010,0,0,0
EST,Estonia,MDV,Maldives,2011,0,0,0
EST,Estonia,MDV,Maldives,2012,0,0,0
EST,Estonia,MDV,Maldives,2013,0,0,0
EST,Estonia,MDV,Maldives,2014,0,0,0
EST,Estonia,MDV,Maldives,2015,0,0,0
EST,Estonia,MDV,Maldives,2016,0,0,0
EST,Estonia,MDV,Maldives,2017,0,0,0
SVN,Slovenia,MDV,Maldives,2016,0,1,-1
SVN,Slovenia,MDV,Maldives,2017,0,7,-7
AUS,Australia,MLI,Mali,2008,0,2,-2
AUS,Australia,MLI,Mali,2009,0,0,0
AUS,Australia,MLI,Mali,2010,0,3,-3
AUS,Australia,MLI,Mali,2011,0,2,-2
AUS,Australia,MLI,Mali,2012,0,4,-4
AUS,Australia,MLI,Mali,2013,0,9,-9
AUS,Australia,MLI,Mali,2014,0,6,-6
AUS,Australia,MLI,Mali,2015,0,0,0
AUS,Australia,MLI,Mali,2016,0,0,0
AUS,Australia,MLI,Mali,2017,0,5,-5
AUT,Austria,MLI,Mali,2008,12,11,1
AUT,Austria,MLI,Mali,2009,13,17,-4
AUT,Austria,MLI,Mali,2010,15,23,-8
AUT,Austria,MLI,Mali,2011,18,27,-9
AUT,Austria,MLI,Mali,2012,24,29,-5
AUT,Austria,MLI,Mali,2013,14,26,-12
AUT,Austria,MLI,Mali,2014,18,20,-2
AUT,Austria,MLI,Mali,2015,25,27,-2
AUT,Austria,MLI,Mali,2016,26,36,-10
AUT,Austria,MLI,Mali,2017,18,15,3
BEL,Belgium,MLI,Mali,2008,0,70,-70
BEL,Belgium,MLI,Mali,2009,0,81,-81
BEL,Belgium,MLI,Mali,2010,30,53,-23
BEL,Belgium,MLI,Mali,2012,46,182,-136
BEL,Belgium,MLI,Mali,2013,86,183,-97
BEL,Belgium,MLI,Mali,2014,82,78,4
BEL,Belgium,MLI,Mali,2015,64,68,-4
BEL,Belgium,MLI,Mali,2016,38,65,-27
BEL,Belgium,MLI,Mali,2017,18,63,-45
CAN,Canada,MLI,Mali,2008,0,154,-154
CAN,Canada,MLI,Mali,2009,0,164,-164
CAN,Canada,MLI,Mali,2010,0,170,-170
CAN,Canada,MLI,Mali,2011,0,155,-155
CAN,Canada,MLI,Mali,2012,0,191,-191
CAN,Canada,MLI,Mali,2013,0,190,-190
CAN,Canada,MLI,Mali,2014,0,195,-195
CAN,Canada,MLI,Mali,2015,0,190,-190
CAN,Canada,MLI,Mali,2016,0,205,-205
CAN,Canada,MLI,Mali,2017,0,180,-180
CZE,Czech Republic,MLI,Mali,2008,0,4,-4
CZE,Czech Republic,MLI,Mali,2009,0,1,-1
CZE,Czech Republic,MLI,Mali,2011,0,2,-2
CZE,Czech Republic,MLI,Mali,2012,1,1,0
CZE,Czech Republic,MLI,Mali,2014,0,1,-1
CZE,Czech Republic,MLI,Mali,2015,0,2,-2
CZE,Czech Republic,MLI,Mali,2016,0,18,-18
CZE,Czech Republic,MLI,Mali,2017,0,2,-2
DNK,Denmark,MLI,Mali,2008,1,1,0
DNK,Denmark,MLI,Mali,2009,0,0,0
DNK,Denmark,MLI,Mali,2010,2,3,-1
DNK,Denmark,MLI,Mali,2012,2,1,1
DNK,Denmark,MLI,Mali,2013,0,0,0
DNK,Denmark,MLI,Mali,2014,0,0,0
DNK,Denmark,MLI,Mali,2015,0,0,0
DNK,Denmark,MLI,Mali,2016,0,0,0
DNK,Denmark,MLI,Mali,2017,0,0,0
FIN,Finland,MLI,Mali,2008,0,0,0
FIN,Finland,MLI,Mali,2009,0,0,0
FIN,Finland,MLI,Mali,2010,0,1,-1
FIN,Finland,MLI,Mali,2011,0,1,-1
FIN,Finland,MLI,Mali,2012,0,2,-2
FIN,Finland,MLI,Mali,2013,0,1,-1
FIN,Finland,MLI,Mali,2014,0,9,-9
FIN,Finland,MLI,Mali,2015,0,9,-9
FIN,Finland,MLI,Mali,2016,0,2,-2
FIN,Finland,MLI,Mali,2017,0,3,-3
FRA,France,MLI,Mali,2008,0,4721,-4721
FRA,France,MLI,Mali,2009,0,5684,-5684
FRA,France,MLI,Mali,2010,0,4925,-4925
FRA,France,MLI,Mali,2011,0,4635,-4635
FRA,France,MLI,Mali,2012,0,3550,-3550
FRA,France,MLI,Mali,2013,0,3891,-3891
FRA,France,MLI,Mali,2014,0,4080,-4080
FRA,France,MLI,Mali,2015,0,3539,-3539
FRA,France,MLI,Mali,2016,0,3803,-3803
FRA,France,MLI,Mali,2017,0,3688,-3688
DEU,Germany,MLI,Mali,2008,86,57,29
DEU,Germany,MLI,Mali,2009,68,77,-9
DEU,Germany,MLI,Mali,2010,73,118,-45
DEU,Germany,MLI,Mali,2011,77,100,-23
DEU,Germany,MLI,Mali,2012,69,301,-232
DEU,Germany,MLI,Mali,2013,173,774,-601
DEU,Germany,MLI,Mali,2014,357,739,-382
DEU,Germany,MLI,Mali,2015,414,1411,-997
DEU,Germany,MLI,Mali,2016,810,1414,-604
DEU,Germany,MLI,Mali,2017,1073,632,441
HUN,Hungary,MLI,Mali,2008,0,0,0
HUN,Hungary,MLI,Mali,2009,0,1,-1
HUN,Hungary,MLI,Mali,2010,1,1,0
HUN,Hungary,MLI,Mali,2011,0,0,0
HUN,Hungary,MLI,Mali,2012,0,4,-4
HUN,Hungary,MLI,Mali,2013,0,2,-2
HUN,Hungary,MLI,Mali,2014,0,1,-1
HUN,Hungary,MLI,Mali,2015,0,3,-3
HUN,Hungary,MLI,Mali,2016,0,3,-3
HUN,Hungary,MLI,Mali,2017,0,2,-2
ISL,Iceland,MLI,Mali,2008,0,1,-1
ISL,Iceland,MLI,Mali,2009,0,0,0
ISL,Iceland,MLI,Mali,2010,0,0,0
ISL,Iceland,MLI,Mali,2011,0,0,0
ISL,Iceland,MLI,Mali,2012,0,0,0
ISL,Iceland,MLI,Mali,2013,0,0,0
ISL,Iceland,MLI,Mali,2014,0,0,0
ISL,Iceland,MLI,Mali,2015,0,2,-2
ISL,Iceland,MLI,Mali,2016,0,0,0
ISL,Iceland,MLI,Mali,2017,0,1,-1
ITA,Italy,MLI,Mali,2008,11,137,-126
ITA,Italy,MLI,Mali,2009,12,140,-128
ITA,Italy,MLI,Mali,2010,1,193,-192
ITA,Italy,MLI,Mali,2011,10,216,-206
ITA,Italy,MLI,Mali,2012,9,1472,-1463
ITA,Italy,MLI,Mali,2013,23,1308,-1285
ITA,Italy,MLI,Mali,2014,28,2035,-2007
ITA,Italy,MLI,Mali,2015,51,4772,-4721
ITA,Italy,MLI,Mali,2016,0,5211,-5211
ITA,Italy,MLI,Mali,2017,82,6810,-6728
JPN,Japan,MLI,Mali,2008,63,67,-4
JPN,Japan,MLI,Mali,2009,39,43,-4
JPN,Japan,MLI,Mali,2010,39,42,-3
JPN,Japan,MLI,Mali,2011,39,43,-4
JPN,Japan,MLI,Mali,2012,29,35,-6
JPN,Japan,MLI,Mali,2013,51,64,-13
JPN,Japan,MLI,Mali,2014,46,49,-3
JPN,Japan,MLI,Mali,2015,39,55,-16
JPN,Japan,MLI,Mali,2016,39,58,-19
JPN,Japan,MLI,Mali,2017,47,68,-21
KOR,Korea,MLI,Mali,2008,0,0,0
KOR,Korea,MLI,Mali,2009,5,2,3
KOR,Korea,MLI,Mali,2010,0,3,-3
KOR,Korea,MLI,Mali,2011,5,6,-1
KOR,Korea,MLI,Mali,2012,10,7,3
KOR,Korea,MLI,Mali,2013,0,5,-5
KOR,Korea,MLI,Mali,2014,3,7,-4
KOR,Korea,MLI,Mali,2015,6,5,1
KOR,Korea,MLI,Mali,2016,5,88,-83
KOR,Korea,MLI,Mali,2017,15,73,-58
LUX,Luxembourg,MLI,Mali,2008,1,2,-1
LUX,Luxembourg,MLI,Mali,2009,1,1,0
LUX,Luxembourg,MLI,Mali,2010,0,3,-3
LUX,Luxembourg,MLI,Mali,2011,0,1,-1
LUX,Luxembourg,MLI,Mali,2012,1,1,0
LUX,Luxembourg,MLI,Mali,2013,1,7,-6
LUX,Luxembourg,MLI,Mali,2014,1,2,-1
LUX,Luxembourg,MLI,Mali,2015,2,12,-10
LUX,Luxembourg,MLI,Mali,2016,3,7,-4
LUX,Luxembourg,MLI,Mali,2017,4,2,2
MEX,Mexico,MLI,Mali,2009,0,1,-1
MEX,Mexico,MLI,Mali,2010,0,1,-1
MEX,Mexico,MLI,Mali,2011,0,1,-1
MEX,Mexico,MLI,Mali,2012,0,0,0
MEX,Mexico,MLI,Mali,2013,0,2,-2
MEX,Mexico,MLI,Mali,2014,0,4,-4
MEX,Mexico,MLI,Mali,2015,0,1,-1
MEX,Mexico,MLI,Mali,2017,0,4,-4
NLD,Netherlands,MLI,Mali,2008,2,5,-3
NLD,Netherlands,MLI,Mali,2009,1,10,-9
NLD,Netherlands,MLI,Mali,2010,11,1,10
NLD,Netherlands,MLI,Mali,2011,5,3,2
NLD,Netherlands,MLI,Mali,2012,0,6,-6
NLD,Netherlands,MLI,Mali,2013,3,8,-5
NLD,Netherlands,MLI,Mali,2014,2,5,-3
NLD,Netherlands,MLI,Mali,2015,1,12,-11
NLD,Netherlands,MLI,Mali,2016,4,3,1
NLD,Netherlands,MLI,Mali,2017,6,10,-4
NZL,New Zealand,MLI,Mali,2008,0,0,0
NZL,New Zealand,MLI,Mali,2016,0,1,-1
NOR,Norway,MLI,Mali,2008,4,3,1
NOR,Norway,MLI,Mali,2009,4,2,2
NOR,Norway,MLI,Mali,2010,0,2,-2
NOR,Norway,MLI,Mali,2011,2,1,1
NOR,Norway,MLI,Mali,2012,0,4,-4
NOR,Norway,MLI,Mali,2013,0,4,-4
NOR,Norway,MLI,Mali,2014,0,3,-3
NOR,Norway,MLI,Mali,2015,3,7,-4
NOR,Norway,MLI,Mali,2016,0,0,0
NOR,Norway,MLI,Mali,2017,2,1,1
POL,Poland,MLI,Mali,2009,0,13,-13
POL,Poland,MLI,Mali,2010,0,4,-4
POL,Poland,MLI,Mali,2011,0,18,-18
POL,Poland,MLI,Mali,2012,0,6,-6
POL,Poland,MLI,Mali,2013,0,8,-8
POL,Poland,MLI,Mali,2014,0,7,-7
POL,Poland,MLI,Mali,2015,0,6,-6
POL,Poland,MLI,Mali,2016,0,5,-5
POL,Poland,MLI,Mali,2017,0,2,-2
SVK,Slovak Republic,MLI,Mali,2008,0,1,-1
ESP,Spain,MLI,Mali,2008,1446,3504,-2058
ESP,Spain,MLI,Mali,2009,1833,2099,-266
ESP,Spain,MLI,Mali,2010,2277,1312,965
ESP,Spain,MLI,Mali,2011,2993,1087,1906
ESP,Spain,MLI,Mali,2012,2827,1072,1755
ESP,Spain,MLI,Mali,2013,3021,1162,1859
ESP,Spain,MLI,Mali,2014,1725,1245,480
ESP,Spain,MLI,Mali,2015,1273,1150,123
ESP,Spain,MLI,Mali,2016,1220,1166,54
ESP,Spain,MLI,Mali,2017,1375,1115,260
SWE,Sweden,MLI,Mali,2008,0,15,-15
SWE,Sweden,MLI,Mali,2009,1,13,-12
SWE,Sweden,MLI,Mali,2010,1,5,-4
SWE,Sweden,MLI,Mali,2011,2,4,-2
SWE,Sweden,MLI,Mali,2012,1,10,-9
SWE,Sweden,MLI,Mali,2013,3,15,-12
SWE,Sweden,MLI,Mali,2014,2,12,-10
SWE,Sweden,MLI,Mali,2015,2,8,-6
SWE,Sweden,MLI,Mali,2016,2,6,-4
SWE,Sweden,MLI,Mali,2017,0,9,-9
CHE,Switzerland,MLI,Mali,2010,2,19,-17
CHE,Switzerland,MLI,Mali,2011,7,24,-17
CHE,Switzerland,MLI,Mali,2012,4,13,-9
CHE,Switzerland,MLI,Mali,2013,0,21,-21
CHE,Switzerland,MLI,Mali,2014,7,20,-13
CHE,Switzerland,MLI,Mali,2015,7,22,-15
CHE,Switzerland,MLI,Mali,2016,3,22,-19
CHE,Switzerland,MLI,Mali,2017,9,15,-6
TUR,Turkey,MLI,Mali,2010,0,15,-15
TUR,Turkey,MLI,Mali,2016,103,140,-37
TUR,Turkey,MLI,Mali,2017,0,0,0
USA,United States,MLI,Mali,2008,0,523,-523
USA,United States,MLI,Mali,2009,0,576,-576
USA,United States,MLI,Mali,2010,0,528,-528
USA,United States,MLI,Mali,2011,0,629,-629
USA,United States,MLI,Mali,2012,0,734,-734
USA,United States,MLI,Mali,2013,0,667,-667
USA,United States,MLI,Mali,2014,0,604,-604
USA,United States,MLI,Mali,2015,0,587,-587
USA,United States,MLI,Mali,2016,0,598,-598
USA,United States,MLI,Mali,2017,0,544,-544
CHL,Chile,MLI,Mali,2008,0,0,0
CHL,Chile,MLI,Mali,2009,0,0,0
CHL,Chile,MLI,Mali,2010,0,0,0
CHL,Chile,MLI,Mali,2011,0,1,-1
CHL,Chile,MLI,Mali,2012,0,0,0
CHL,Chile,MLI,Mali,2013,0,0,0
CHL,Chile,MLI,Mali,2014,0,6,-6
CHL,Chile,MLI,Mali,2015,0,1,-1
CHL,Chile,MLI,Mali,2016,0,0,0
EST,Estonia,MLI,Mali,2008,0,0,0
EST,Estonia,MLI,Mali,2009,0,0,0
EST,Estonia,MLI,Mali,2010,0,0,0
EST,Estonia,MLI,Mali,2011,0,0,0
EST,Estonia,MLI,Mali,2012,0,0,0
EST,Estonia,MLI,Mali,2013,0,0,0
EST,Estonia,MLI,Mali,2014,0,0,0
EST,Estonia,MLI,Mali,2015,0,0,0
EST,Estonia,MLI,Mali,2016,0,0,0
EST,Estonia,MLI,Mali,2017,0,1,-1
SVN,Slovenia,MLI,Mali,2013,0,1,-1
SVN,Slovenia,MLI,Mali,2017,0,1,-1
AUS,Australia,MLT,Malta,2008,74,116,-42
AUS,Australia,MLT,Malta,2009,105,75,30
AUS,Australia,MLT,Malta,2010,95,50,45
AUS,Australia,MLT,Malta,2011,85,57,28
AUS,Australia,MLT,Malta,2012,61,57,4
AUS,Australia,MLT,Malta,2013,103,60,43
AUS,Australia,MLT,Malta,2014,91,34,57
AUS,Australia,MLT,Malta,2015,100,47,53
AUS,Australia,MLT,Malta,2016,100,42,58
AUS,Australia,MLT,Malta,2017,0,25,-25
AUT,Austria,MLT,Malta,2008,6,15,-9
AUT,Austria,MLT,Malta,2009,11,12,-1
AUT,Austria,MLT,Malta,2010,4,7,-3
AUT,Austria,MLT,Malta,2011,6,12,-6
AUT,Austria,MLT,Malta,2012,9,11,-2
AUT,Austria,MLT,Malta,2013,9,4,5
AUT,Austria,MLT,Malta,2014,9,11,-2
AUT,Austria,MLT,Malta,2015,6,7,-1
AUT,Austria,MLT,Malta,2016,8,10,-2
AUT,Austria,MLT,Malta,2017,7,20,-13
BEL,Belgium,MLT,Malta,2008,0,87,-87
BEL,Belgium,MLT,Malta,2009,0,54,-54
BEL,Belgium,MLT,Malta,2010,26,74,-48
BEL,Belgium,MLT,Malta,2012,45,50,-5
BEL,Belgium,MLT,Malta,2013,48,51,-3
BEL,Belgium,MLT,Malta,2014,24,35,-11
BEL,Belgium,MLT,Malta,2015,34,32,2
BEL,Belgium,MLT,Malta,2016,29,34,-5
BEL,Belgium,MLT,Malta,2017,20,58,-38
CAN,Canada,MLT,Malta,2008,0,21,-21
CAN,Canada,MLT,Malta,2009,0,18,-18
CAN,Canada,MLT,Malta,2010,0,17,-17
CAN,Canada,MLT,Malta,2011,0,8,-8
CAN,Canada,MLT,Malta,2012,0,9,-9
CAN,Canada,MLT,Malta,2013,0,4,-4
CAN,Canada,MLT,Malta,2014,0,9,-9
CAN,Canada,MLT,Malta,2015,0,10,-10
CAN,Canada,MLT,Malta,2016,0,5,-5
CAN,Canada,MLT,Malta,2017,0,10,-10
CZE,Czech Republic,MLT,Malta,2009,1,3,-2
CZE,Czech Republic,MLT,Malta,2012,0,1,-1
CZE,Czech Republic,MLT,Malta,2013,1,5,-4
CZE,Czech Republic,MLT,Malta,2014,0,2,-2
CZE,Czech Republic,MLT,Malta,2015,0,3,-3
CZE,Czech Republic,MLT,Malta,2016,0,1,-1
CZE,Czech Republic,MLT,Malta,2017,0,3,-3
DNK,Denmark,MLT,Malta,2008,3,8,-5
DNK,Denmark,MLT,Malta,2009,6,9,-3
DNK,Denmark,MLT,Malta,2010,10,7,3
DNK,Denmark,MLT,Malta,2011,9,5,4
DNK,Denmark,MLT,Malta,2012,6,6,0
DNK,Denmark,MLT,Malta,2013,8,9,-1
DNK,Denmark,MLT,Malta,2014,8,11,-3
DNK,Denmark,MLT,Malta,2015,9,8,1
DNK,Denmark,MLT,Malta,2016,12,10,2
DNK,Denmark,MLT,Malta,2017,7,13,-6
FIN,Finland,MLT,Malta,2008,0,5,-5
FIN,Finland,MLT,Malta,2009,2,0,2
FIN,Finland,MLT,Malta,2010,1,0,1
FIN,Finland,MLT,Malta,2011,0,1,-1
FIN,Finland,MLT,Malta,2012,1,3,-2
FIN,Finland,MLT,Malta,2013,1,1,0
FIN,Finland,MLT,Malta,2014,0,6,-6
FIN,Finland,MLT,Malta,2015,2,2,0
FIN,Finland,MLT,Malta,2016,0,0,0
FIN,Finland,MLT,Malta,2017,1,2,-1
FRA,France,MLT,Malta,2008,0,0,0
FRA,France,MLT,Malta,2009,0,0,0
FRA,France,MLT,Malta,2010,0,0,0
FRA,France,MLT,Malta,2011,0,0,0
FRA,France,MLT,Malta,2012,0,0,0
FRA,France,MLT,Malta,2013,0,18,-18
FRA,France,MLT,Malta,2014,0,10,-10
FRA,France,MLT,Malta,2015,0,0,0
FRA,France,MLT,Malta,2016,0,39,-39
FRA,France,MLT,Malta,2017,0,6,-6
DEU,Germany,MLT,Malta,2008,57,66,-9
DEU,Germany,MLT,Malta,2009,55,68,-13
DEU,Germany,MLT,Malta,2010,48,51,-3
DEU,Germany,MLT,Malta,2011,57,103,-46
DEU,Germany,MLT,Malta,2012,66,94,-28
DEU,Germany,MLT,Malta,2013,72,102,-30
DEU,Germany,MLT,Malta,2014,69,92,-23
DEU,Germany,MLT,Malta,2015,75,95,-20
DEU,Germany,MLT,Malta,2016,79,90,-11
DEU,Germany,MLT,Malta,2017,66,105,-39
HUN,Hungary,MLT,Malta,2008,0,5,-5
HUN,Hungary,MLT,Malta,2009,1,6,-5
HUN,Hungary,MLT,Malta,2010,0,6,-6
HUN,Hungary,MLT,Malta,2011,0,10,-10
HUN,Hungary,MLT,Malta,2012,0,7,-7
HUN,Hungary,MLT,Malta,2013,0,7,-7
HUN,Hungary,MLT,Malta,2014,2,16,-14
HUN,Hungary,MLT,Malta,2015,6,8,-2
HUN,Hungary,MLT,Malta,2016,7,7,0
HUN,Hungary,MLT,Malta,2017,0,14,-14
ISL,Iceland,MLT,Malta,2008,0,0,0
ISL,Iceland,MLT,Malta,2009,2,0,2
ISL,Iceland,MLT,Malta,2010,0,1,-1
ISL,Iceland,MLT,Malta,2011,1,0,1
ISL,Iceland,MLT,Malta,2012,1,1,0
ISL,Iceland,MLT,Malta,2013,0,1,-1
ISL,Iceland,MLT,Malta,2014,0,8,-8
ISL,Iceland,MLT,Malta,2015,7,2,5
ISL,Iceland,MLT,Malta,2016,1,0,1
ISL,Iceland,MLT,Malta,2017,1,2,-1
ITA,Italy,MLT,Malta,2008,9,77,-68
ITA,Italy,MLT,Malta,2009,12,55,-43
ITA,Italy,MLT,Malta,2010,10,62,-52
ITA,Italy,MLT,Malta,2011,11,61,-50
ITA,Italy,MLT,Malta,2012,8,31,-23
ITA,Italy,MLT,Malta,2013,18,35,-17
ITA,Italy,MLT,Malta,2014,16,42,-26
ITA,Italy,MLT,Malta,2015,27,35,-8
ITA,Italy,MLT,Malta,2016,0,37,-37
ITA,Italy,MLT,Malta,2017,15,39,-24
JPN,Japan,MLT,Malta,2008,5,6,-1
JPN,Japan,MLT,Malta,2009,9,11,-2
JPN,Japan,MLT,Malta,2010,5,6,-1
JPN,Japan,MLT,Malta,2011,6,3,3
JPN,Japan,MLT,Malta,2012,2,4,-2
JPN,Japan,MLT,Malta,2013,4,3,1
JPN,Japan,MLT,Malta,2014,4,9,-5
JPN,Japan,MLT,Malta,2015,4,3,1
JPN,Japan,MLT,Malta,2016,4,6,-2
JPN,Japan,MLT,Malta,2017,3,4,-1
KOR,Korea,MLT,Malta,2008,1,0,1
KOR,Korea,MLT,Malta,2009,0,0,0
KOR,Korea,MLT,Malta,2010,0,1,-1
KOR,Korea,MLT,Malta,2011,4,1,3
KOR,Korea,MLT,Malta,2012,3,6,-3
KOR,Korea,MLT,Malta,2013,0,1,-1
KOR,Korea,MLT,Malta,2014,0,0,0
KOR,Korea,MLT,Malta,2015,1,1,0
KOR,Korea,MLT,Malta,2016,0,1,-1
KOR,Korea,MLT,Malta,2017,5,2,3
LUX,Luxembourg,MLT,Malta,2008,26,30,-4
LUX,Luxembourg,MLT,Malta,2009,26,32,-6
LUX,Luxembourg,MLT,Malta,2010,14,34,-20
LUX,Luxembourg,MLT,Malta,2011,15,21,-6
LUX,Luxembourg,MLT,Malta,2012,12,18,-6
LUX,Luxembourg,MLT,Malta,2013,42,23,19
LUX,Luxembourg,MLT,Malta,2014,17,26,-9
LUX,Luxembourg,MLT,Malta,2015,14,24,-10
LUX,Luxembourg,MLT,Malta,2016,15,24,-9
LUX,Luxembourg,MLT,Malta,2017,15,17,-2
MEX,Mexico,MLT,Malta,2011,0,3,-3
MEX,Mexico,MLT,Malta,2012,0,1,-1
MEX,Mexico,MLT,Malta,2013,0,0,0
MEX,Mexico,MLT,Malta,2014,0,3,-3
MEX,Mexico,MLT,Malta,2015,0,2,-2
NLD,Netherlands,MLT,Malta,2008,11,33,-22
NLD,Netherlands,MLT,Malta,2009,25,28,-3
NLD,Netherlands,MLT,Malta,2010,21,41,-20
NLD,Netherlands,MLT,Malta,2011,33,40,-7
NLD,Netherlands,MLT,Malta,2012,31,36,-5
NLD,Netherlands,MLT,Malta,2013,29,44,-15
NLD,Netherlands,MLT,Malta,2014,36,37,-1
NLD,Netherlands,MLT,Malta,2015,38,46,-8
NLD,Netherlands,MLT,Malta,2016,39,67,-28
NLD,Netherlands,MLT,Malta,2017,35,73,-38
NZL,New Zealand,MLT,Malta,2009,2,5,-3
NZL,New Zealand,MLT,Malta,2010,2,9,-7
NZL,New Zealand,MLT,Malta,2011,0,1,-1
NZL,New Zealand,MLT,Malta,2012,1,3,-2
NZL,New Zealand,MLT,Malta,2013,3,5,-2
NZL,New Zealand,MLT,Malta,2014,2,3,-1
NZL,New Zealand,MLT,Malta,2015,2,4,-2
NZL,New Zealand,MLT,Malta,2016,0,9,-9
NZL,New Zealand,MLT,Malta,2017,5,8,-3
NOR,Norway,MLT,Malta,2008,0,4,-4
NOR,Norway,MLT,Malta,2009,2,2,0
NOR,Norway,MLT,Malta,2010,2,10,-8
NOR,Norway,MLT,Malta,2011,2,4,-2
NOR,Norway,MLT,Malta,2012,3,4,-1
NOR,Norway,MLT,Malta,2013,2,10,-8
NOR,Norway,MLT,Malta,2014,2,8,-6
NOR,Norway,MLT,Malta,2015,5,7,-2
NOR,Norway,MLT,Malta,2016,1,3,-2
NOR,Norway,MLT,Malta,2017,5,3,2
POL,Poland,MLT,Malta,2008,0,3,-3
POL,Poland,MLT,Malta,2009,0,3,-3
POL,Poland,MLT,Malta,2010,0,0,0
POL,Poland,MLT,Malta,2011,0,5,-5
POL,Poland,MLT,Malta,2012,0,2,-2
POL,Poland,MLT,Malta,2013,0,5,-5
POL,Poland,MLT,Malta,2014,0,5,-5
POL,Poland,MLT,Malta,2015,0,2,-2
POL,Poland,MLT,Malta,2016,0,8,-8
POL,Poland,MLT,Malta,2017,0,5,-5
SVK,Slovak Republic,MLT,Malta,2008,0,2,-2
SVK,Slovak Republic,MLT,Malta,2009,0,1,-1
SVK,Slovak Republic,MLT,Malta,2010,1,4,-3
SVK,Slovak Republic,MLT,Malta,2011,0,1,-1
SVK,Slovak Republic,MLT,Malta,2012,0,1,-1
SVK,Slovak Republic,MLT,Malta,2013,0,1,-1
SVK,Slovak Republic,MLT,Malta,2014,0,4,-4
SVK,Slovak Republic,MLT,Malta,2015,0,2,-2
SVK,Slovak Republic,MLT,Malta,2016,0,2,-2
SVK,Slovak Republic,MLT,Malta,2017,0,1,-1
ESP,Spain,MLT,Malta,2008,4,34,-30
ESP,Spain,MLT,Malta,2009,18,27,-9
ESP,Spain,MLT,Malta,2010,26,28,-2
ESP,Spain,MLT,Malta,2011,9,46,-37
ESP,Spain,MLT,Malta,2012,6,27,-21
ESP,Spain,MLT,Malta,2013,11,15,-4
ESP,Spain,MLT,Malta,2014,9,26,-17
ESP,Spain,MLT,Malta,2015,7,19,-12
ESP,Spain,MLT,Malta,2016,5,28,-23
ESP,Spain,MLT,Malta,2017,25,49,-24
SWE,Sweden,MLT,Malta,2008,2,11,-9
SWE,Sweden,MLT,Malta,2009,3,19,-16
SWE,Sweden,MLT,Malta,2010,8,13,-5
SWE,Sweden,MLT,Malta,2011,11,19,-8
SWE,Sweden,MLT,Malta,2012,5,14,-9
SWE,Sweden,MLT,Malta,2013,6,12,-6
SWE,Sweden,MLT,Malta,2014,7,13,-6
SWE,Sweden,MLT,Malta,2015,3,17,-14
SWE,Sweden,MLT,Malta,2016,9,19,-10
SWE,Sweden,MLT,Malta,2017,3,11,-8
CHE,Switzerland,MLT,Malta,2008,10,29,-19
CHE,Switzerland,MLT,Malta,2009,14,26,-12
CHE,Switzerland,MLT,Malta,2010,13,29,-16
CHE,Switzerland,MLT,Malta,2011,16,21,-5
CHE,Switzerland,MLT,Malta,2012,14,26,-12
CHE,Switzerland,MLT,Malta,2013,16,24,-8
CHE,Switzerland,MLT,Malta,2014,14,12,2
CHE,Switzerland,MLT,Malta,2015,8,17,-9
CHE,Switzerland,MLT,Malta,2016,12,32,-20
CHE,Switzerland,MLT,Malta,2017,16,50,-34
GBR,United Kingdom,MLT,Malta,2014,0,2000,-2000
USA,United States,MLT,Malta,2008,0,66,-66
USA,United States,MLT,Malta,2009,0,58,-58
USA,United States,MLT,Malta,2010,0,74,-74
USA,United States,MLT,Malta,2011,0,51,-51
USA,United States,MLT,Malta,2012,0,62,-62
USA,United States,MLT,Malta,2013,0,43,-43
USA,United States,MLT,Malta,2014,0,39,-39
USA,United States,MLT,Malta,2015,0,58,-58
USA,United States,MLT,Malta,2016,0,65,-65
USA,United States,MLT,Malta,2017,0,75,-75
CHL,Chile,MLT,Malta,2008,0,0,0
CHL,Chile,MLT,Malta,2009,0,0,0
CHL,Chile,MLT,Malta,2010,0,0,0
CHL,Chile,MLT,Malta,2011,0,0,0
CHL,Chile,MLT,Malta,2012,0,2,-2
CHL,Chile,MLT,Malta,2013,0,1,-1
CHL,Chile,MLT,Malta,2014,0,0,0
CHL,Chile,MLT,Malta,2015,0,0,0
CHL,Chile,MLT,Malta,2016,0,1,-1
EST,Estonia,MLT,Malta,2008,0,0,0
EST,Estonia,MLT,Malta,2009,0,0,0
EST,Estonia,MLT,Malta,2010,0,0,0
EST,Estonia,MLT,Malta,2011,0,0,0
EST,Estonia,MLT,Malta,2012,0,0,0
EST,Estonia,MLT,Malta,2013,0,0,0
EST,Estonia,MLT,Malta,2014,0,0,0
EST,Estonia,MLT,Malta,2015,0,1,-1
EST,Estonia,MLT,Malta,2016,0,1,-1
EST,Estonia,MLT,Malta,2017,0,4,-4
SVN,Slovenia,MLT,Malta,2008,0,1,-1
SVN,Slovenia,MLT,Malta,2009,0,1,-1
SVN,Slovenia,MLT,Malta,2011,0,2,-2
SVN,Slovenia,MLT,Malta,2012,0,3,-3
SVN,Slovenia,MLT,Malta,2014,0,2,-2
SVN,Slovenia,MLT,Malta,2015,0,1,-1
SVN,Slovenia,MLT,Malta,2016,0,1,-1
SVN,Slovenia,MLT,Malta,2017,0,1,-1
AUS,Australia,MHL,Marshall Islands,2008,0,0,0
AUS,Australia,MHL,Marshall Islands,2009,0,0,0
AUS,Australia,MHL,Marshall Islands,2010,0,0,0
AUS,Australia,MHL,Marshall Islands,2011,0,1,-1
AUS,Australia,MHL,Marshall Islands,2012,0,0,0
AUS,Australia,MHL,Marshall Islands,2013,0,0,0
AUS,Australia,MHL,Marshall Islands,2014,0,0,0
AUS,Australia,MHL,Marshall Islands,2015,0,0,0
AUS,Australia,MHL,Marshall Islands,2017,0,0,0
AUT,Austria,MHL,Marshall Islands,2008,0,0,0
AUT,Austria,MHL,Marshall Islands,2009,1,0,1
AUT,Austria,MHL,Marshall Islands,2010,0,0,0
AUT,Austria,MHL,Marshall Islands,2011,0,0,0
AUT,Austria,MHL,Marshall Islands,2012,0,0,0
AUT,Austria,MHL,Marshall Islands,2013,0,0,0
AUT,Austria,MHL,Marshall Islands,2014,0,0,0
AUT,Austria,MHL,Marshall Islands,2015,0,0,0
AUT,Austria,MHL,Marshall Islands,2016,0,0,0
AUT,Austria,MHL,Marshall Islands,2017,0,0,0
BEL,Belgium,MHL,Marshall Islands,2010,0,0,0
CAN,Canada,MHL,Marshall Islands,2008,0,0,0
CAN,Canada,MHL,Marshall Islands,2009,0,0,0
CAN,Canada,MHL,Marshall Islands,2010,0,0,0
CAN,Canada,MHL,Marshall Islands,2011,0,0,0
CAN,Canada,MHL,Marshall Islands,2012,0,0,0
CAN,Canada,MHL,Marshall Islands,2013,0,0,0
CAN,Canada,MHL,Marshall Islands,2014,0,0,0
CAN,Canada,MHL,Marshall Islands,2015,0,0,0
CAN,Canada,MHL,Marshall Islands,2016,0,0,0
CAN,Canada,MHL,Marshall Islands,2017,0,0,0
DNK,Denmark,MHL,Marshall Islands,2013,0,0,0
DNK,Denmark,MHL,Marshall Islands,2014,0,0,0
DNK,Denmark,MHL,Marshall Islands,2015,0,0,0
DNK,Denmark,MHL,Marshall Islands,2016,0,0,0
DNK,Denmark,MHL,Marshall Islands,2017,0,0,0
FIN,Finland,MHL,Marshall Islands,2008,0,0,0
FIN,Finland,MHL,Marshall Islands,2009,0,0,0
FIN,Finland,MHL,Marshall Islands,2010,0,0,0
FIN,Finland,MHL,Marshall Islands,2011,0,0,0
FIN,Finland,MHL,Marshall Islands,2012,0,0,0
FIN,Finland,MHL,Marshall Islands,2013,0,0,0
FIN,Finland,MHL,Marshall Islands,2014,0,0,0
FIN,Finland,MHL,Marshall Islands,2015,0,0,0
FIN,Finland,MHL,Marshall Islands,2016,0,0,0
FIN,Finland,MHL,Marshall Islands,2017,0,0,0
FRA,France,MHL,Marshall Islands,2008,0,0,0
FRA,France,MHL,Marshall Islands,2009,0,0,0
FRA,France,MHL,Marshall Islands,2010,0,0,0
FRA,France,MHL,Marshall Islands,2011,0,1,-1
FRA,France,MHL,Marshall Islands,2012,0,0,0
FRA,France,MHL,Marshall Islands,2013,0,0,0
FRA,France,MHL,Marshall Islands,2014,0,0,0
FRA,France,MHL,Marshall Islands,2015,0,2,-2
FRA,France,MHL,Marshall Islands,2016,0,0,0
FRA,France,MHL,Marshall Islands,2017,0,5,-5
DEU,Germany,MHL,Marshall Islands,2008,0,0,0
DEU,Germany,MHL,Marshall Islands,2009,1,0,1
DEU,Germany,MHL,Marshall Islands,2010,1,0,1
DEU,Germany,MHL,Marshall Islands,2011,0,0,0
DEU,Germany,MHL,Marshall Islands,2012,0,1,-1
DEU,Germany,MHL,Marshall Islands,2013,0,0,0
DEU,Germany,MHL,Marshall Islands,2014,0,1,-1
DEU,Germany,MHL,Marshall Islands,2015,0,0,0
DEU,Germany,MHL,Marshall Islands,2016,1,2,-1
DEU,Germany,MHL,Marshall Islands,2017,0,0,0
HUN,Hungary,MHL,Marshall Islands,2008,0,0,0
HUN,Hungary,MHL,Marshall Islands,2009,0,0,0
HUN,Hungary,MHL,Marshall Islands,2010,0,0,0
HUN,Hungary,MHL,Marshall Islands,2011,0,0,0
HUN,Hungary,MHL,Marshall Islands,2012,0,0,0
HUN,Hungary,MHL,Marshall Islands,2013,0,0,0
HUN,Hungary,MHL,Marshall Islands,2014,0,0,0
HUN,Hungary,MHL,Marshall Islands,2015,0,0,0
HUN,Hungary,MHL,Marshall Islands,2016,0,0,0
HUN,Hungary,MHL,Marshall Islands,2017,0,0,0
ISL,Iceland,MHL,Marshall Islands,2016,0,0,0
ISL,Iceland,MHL,Marshall Islands,2017,0,0,0
ITA,Italy,MHL,Marshall Islands,2008,0,3,-3
ITA,Italy,MHL,Marshall Islands,2009,0,3,-3
ITA,Italy,MHL,Marshall Islands,2010,0,0,0
ITA,Italy,MHL,Marshall Islands,2011,0,1,-1
ITA,Italy,MHL,Marshall Islands,2012,0,1,-1
ITA,Italy,MHL,Marshall Islands,2013,0,1,-1
ITA,Italy,MHL,Marshall Islands,2014,2,1,1
ITA,Italy,MHL,Marshall Islands,2015,0,0,0
ITA,Italy,MHL,Marshall Islands,2016,0,0,0
ITA,Italy,MHL,Marshall Islands,2017,0,0,0
JPN,Japan,MHL,Marshall Islands,2008,31,34,-3
JPN,Japan,MHL,Marshall Islands,2009,30,29,1
JPN,Japan,MHL,Marshall Islands,2010,4,37,-33
JPN,Japan,MHL,Marshall Islands,2011,21,22,-1
JPN,Japan,MHL,Marshall Islands,2012,50,56,-6
JPN,Japan,MHL,Marshall Islands,2013,55,54,1
JPN,Japan,MHL,Marshall Islands,2014,59,57,2
JPN,Japan,MHL,Marshall Islands,2015,79,80,-1
JPN,Japan,MHL,Marshall Islands,2016,57,61,-4
JPN,Japan,MHL,Marshall Islands,2017,49,56,-7
KOR,Korea,MHL,Marshall Islands,2008,0,0,0
KOR,Korea,MHL,Marshall Islands,2009,1,1,0
KOR,Korea,MHL,Marshall Islands,2010,1,0,1
KOR,Korea,MHL,Marshall Islands,2011,1,4,-3
KOR,Korea,MHL,Marshall Islands,2012,2,11,-9
KOR,Korea,MHL,Marshall Islands,2013,3,2,1
KOR,Korea,MHL,Marshall Islands,2014,4,0,4
KOR,Korea,MHL,Marshall Islands,2015,3,1,2
KOR,Korea,MHL,Marshall Islands,2016,1,2,-1
KOR,Korea,MHL,Marshall Islands,2017,1,1,0
LUX,Luxembourg,MHL,Marshall Islands,2008,0,0,0
LUX,Luxembourg,MHL,Marshall Islands,2009,0,0,0
LUX,Luxembourg,MHL,Marshall Islands,2010,0,0,0
LUX,Luxembourg,MHL,Marshall Islands,2011,0,0,0
LUX,Luxembourg,MHL,Marshall Islands,2012,0,0,0
LUX,Luxembourg,MHL,Marshall Islands,2013,0,0,0
LUX,Luxembourg,MHL,Marshall Islands,2014,0,0,0
LUX,Luxembourg,MHL,Marshall Islands,2015,0,0,0
LUX,Luxembourg,MHL,Marshall Islands,2016,0,0,0
LUX,Luxembourg,MHL,Marshall Islands,2017,0,0,0
MEX,Mexico,MHL,Marshall Islands,2012,0,0,0
MEX,Mexico,MHL,Marshall Islands,2013,0,0,0
MEX,Mexico,MHL,Marshall Islands,2014,0,0,0
NZL,New Zealand,MHL,Marshall Islands,2008,0,3,-3
NZL,New Zealand,MHL,Marshall Islands,2009,2,0,2
NZL,New Zealand,MHL,Marshall Islands,2010,0,1,-1
NZL,New Zealand,MHL,Marshall Islands,2011,2,1,1
NZL,New Zealand,MHL,Marshall Islands,2012,1,3,-2
NZL,New Zealand,MHL,Marshall Islands,2015,0,2,-2
NZL,New Zealand,MHL,Marshall Islands,2016,2,2,0
NZL,New Zealand,MHL,Marshall Islands,2017,3,1,2
NOR,Norway,MHL,Marshall Islands,2008,0,0,0
NOR,Norway,MHL,Marshall Islands,2009,0,0,0
NOR,Norway,MHL,Marshall Islands,2010,0,0,0
NOR,Norway,MHL,Marshall Islands,2011,0,1,-1
NOR,Norway,MHL,Marshall Islands,2012,0,0,0
NOR,Norway,MHL,Marshall Islands,2013,0,0,0
NOR,Norway,MHL,Marshall Islands,2014,0,0,0
NOR,Norway,MHL,Marshall Islands,2015,0,0,0
NOR,Norway,MHL,Marshall Islands,2016,0,1,-1
NOR,Norway,MHL,Marshall Islands,2017,0,0,0
POL,Poland,MHL,Marshall Islands,2009,0,0,0
POL,Poland,MHL,Marshall Islands,2010,0,0,0
POL,Poland,MHL,Marshall Islands,2011,0,0,0
POL,Poland,MHL,Marshall Islands,2012,0,0,0
POL,Poland,MHL,Marshall Islands,2013,0,0,0
POL,Poland,MHL,Marshall Islands,2014,0,0,0
POL,Poland,MHL,Marshall Islands,2015,0,0,0
POL,Poland,MHL,Marshall Islands,2016,0,0,0
POL,Poland,MHL,Marshall Islands,2017,0,0,0
SVK,Slovak Republic,MHL,Marshall Islands,2008,0,1,-1
ESP,Spain,MHL,Marshall Islands,2008,0,0,0
ESP,Spain,MHL,Marshall Islands,2009,0,0,0
ESP,Spain,MHL,Marshall Islands,2010,1,0,1
ESP,Spain,MHL,Marshall Islands,2011,0,0,0
ESP,Spain,MHL,Marshall Islands,2012,0,0,0
ESP,Spain,MHL,Marshall Islands,2013,0,1,-1
ESP,Spain,MHL,Marshall Islands,2014,0,0,0
ESP,Spain,MHL,Marshall Islands,2015,0,0,0
ESP,Spain,MHL,Marshall Islands,2016,0,0,0
SWE,Sweden,MHL,Marshall Islands,2008,0,0,0
SWE,Sweden,MHL,Marshall Islands,2009,0,0,0
SWE,Sweden,MHL,Marshall Islands,2010,0,0,0
SWE,Sweden,MHL,Marshall Islands,2011,0,0,0
SWE,Sweden,MHL,Marshall Islands,2012,0,0,0
SWE,Sweden,MHL,Marshall Islands,2013,0,0,0
SWE,Sweden,MHL,Marshall Islands,2014,0,0,0
SWE,Sweden,MHL,Marshall Islands,2015,0,0,0
CHE,Switzerland,MHL,Marshall Islands,2010,0,0,0
CHE,Switzerland,MHL,Marshall Islands,2011,0,0,0
CHE,Switzerland,MHL,Marshall Islands,2012,0,0,0
CHE,Switzerland,MHL,Marshall Islands,2013,0,0,0
USA,United States,MHL,Marshall Islands,2008,0,39,-39
USA,United States,MHL,Marshall Islands,2009,0,48,-48
USA,United States,MHL,Marshall Islands,2010,0,37,-37
USA,United States,MHL,Marshall Islands,2011,0,38,-38
USA,United States,MHL,Marshall Islands,2012,0,50,-50
USA,United States,MHL,Marshall Islands,2013,0,46,-46
USA,United States,MHL,Marshall Islands,2014,0,56,-56
USA,United States,MHL,Marshall Islands,2015,0,32,-32
USA,United States,MHL,Marshall Islands,2016,0,32,-32
USA,United States,MHL,Marshall Islands,2017,0,23,-23
CHL,Chile,MHL,Marshall Islands,2008,0,0,0
CHL,Chile,MHL,Marshall Islands,2009,0,0,0
CHL,Chile,MHL,Marshall Islands,2010,0,0,0
CHL,Chile,MHL,Marshall Islands,2011,0,0,0
CHL,Chile,MHL,Marshall Islands,2012,0,0,0
CHL,Chile,MHL,Marshall Islands,2013,0,0,0
CHL,Chile,MHL,Marshall Islands,2014,0,0,0
CHL,Chile,MHL,Marshall Islands,2015,0,0,0
CHL,Chile,MHL,Marshall Islands,2016,0,0,0
EST,Estonia,MHL,Marshall Islands,2008,0,0,0
EST,Estonia,MHL,Marshall Islands,2009,0,0,0
EST,Estonia,MHL,Marshall Islands,2010,0,0,0
EST,Estonia,MHL,Marshall Islands,2011,0,0,0
EST,Estonia,MHL,Marshall Islands,2012,0,0,0
EST,Estonia,MHL,Marshall Islands,2013,0,0,0
EST,Estonia,MHL,Marshall Islands,2014,0,0,0
EST,Estonia,MHL,Marshall Islands,2015,0,0,0
EST,Estonia,MHL,Marshall Islands,2016,0,0,0
EST,Estonia,MHL,Marshall Islands,2017,0,0,0
AUS,Australia,MRT,Mauritania,2008,0,89,-89
AUS,Australia,MRT,Mauritania,2009,0,1,-1
AUS,Australia,MRT,Mauritania,2010,0,1,-1
AUS,Australia,MRT,Mauritania,2011,0,0,0
AUS,Australia,MRT,Mauritania,2012,0,1,-1
AUS,Australia,MRT,Mauritania,2013,0,0,0
AUS,Australia,MRT,Mauritania,2014,0,0,0
AUS,Australia,MRT,Mauritania,2015,0,0,0
AUS,Australia,MRT,Mauritania,2016,0,0,0
AUS,Australia,MRT,Mauritania,2017,0,3,-3
AUT,Austria,MRT,Mauritania,2008,8,3,5
AUT,Austria,MRT,Mauritania,2009,2,7,-5
AUT,Austria,MRT,Mauritania,2010,7,7,0
AUT,Austria,MRT,Mauritania,2011,7,5,2
AUT,Austria,MRT,Mauritania,2012,4,8,-4
AUT,Austria,MRT,Mauritania,2013,4,6,-2
AUT,Austria,MRT,Mauritania,2014,5,4,1
AUT,Austria,MRT,Mauritania,2015,5,6,-1
AUT,Austria,MRT,Mauritania,2016,4,5,-1
AUT,Austria,MRT,Mauritania,2017,5,9,-4
BEL,Belgium,MRT,Mauritania,2008,0,33,-33
BEL,Belgium,MRT,Mauritania,2009,0,36,-36
BEL,Belgium,MRT,Mauritania,2010,7,38,-31
BEL,Belgium,MRT,Mauritania,2012,51,197,-146
BEL,Belgium,MRT,Mauritania,2013,118,166,-48
BEL,Belgium,MRT,Mauritania,2014,139,109,30
BEL,Belgium,MRT,Mauritania,2015,107,145,-38
BEL,Belgium,MRT,Mauritania,2016,52,92,-40
BEL,Belgium,MRT,Mauritania,2017,27,111,-84
CAN,Canada,MRT,Mauritania,2008,0,112,-112
CAN,Canada,MRT,Mauritania,2009,0,83,-83
CAN,Canada,MRT,Mauritania,2010,0,74,-74
CAN,Canada,MRT,Mauritania,2011,0,54,-54
CAN,Canada,MRT,Mauritania,2012,0,77,-77
CAN,Canada,MRT,Mauritania,2013,0,57,-57
CAN,Canada,MRT,Mauritania,2014,0,84,-84
CAN,Canada,MRT,Mauritania,2015,0,104,-104
CAN,Canada,MRT,Mauritania,2016,0,55,-55
CAN,Canada,MRT,Mauritania,2017,0,70,-70
CZE,Czech Republic,MRT,Mauritania,2010,0,1,-1
DNK,Denmark,MRT,Mauritania,2008,1,0,1
DNK,Denmark,MRT,Mauritania,2009,0,0,0
DNK,Denmark,MRT,Mauritania,2012,0,0,0
DNK,Denmark,MRT,Mauritania,2013,0,1,-1
DNK,Denmark,MRT,Mauritania,2014,0,2,-2
DNK,Denmark,MRT,Mauritania,2015,0,0,0
DNK,Denmark,MRT,Mauritania,2016,0,0,0
DNK,Denmark,MRT,Mauritania,2017,0,0,0
FIN,Finland,MRT,Mauritania,2008,0,1,-1
FIN,Finland,MRT,Mauritania,2009,0,0,0
FIN,Finland,MRT,Mauritania,2010,0,0,0
FIN,Finland,MRT,Mauritania,2011,0,12,-12
FIN,Finland,MRT,Mauritania,2012,0,1,-1
FIN,Finland,MRT,Mauritania,2013,0,0,0
FIN,Finland,MRT,Mauritania,2014,0,6,-6
FIN,Finland,MRT,Mauritania,2015,0,2,-2
FIN,Finland,MRT,Mauritania,2016,0,1,-1
FIN,Finland,MRT,Mauritania,2017,0,1,-1
FRA,France,MRT,Mauritania,2008,0,886,-886
FRA,France,MRT,Mauritania,2009,0,1000,-1000
FRA,France,MRT,Mauritania,2010,0,954,-954
FRA,France,MRT,Mauritania,2011,0,963,-963
FRA,France,MRT,Mauritania,2012,0,932,-932
FRA,France,MRT,Mauritania,2013,0,870,-870
FRA,France,MRT,Mauritania,2014,0,767,-767
FRA,France,MRT,Mauritania,2015,0,599,-599
FRA,France,MRT,Mauritania,2016,0,679,-679
FRA,France,MRT,Mauritania,2017,0,694,-694
DEU,Germany,MRT,Mauritania,2008,79,61,18
DEU,Germany,MRT,Mauritania,2009,99,76,23
DEU,Germany,MRT,Mauritania,2010,70,82,-12
DEU,Germany,MRT,Mauritania,2011,59,58,1
DEU,Germany,MRT,Mauritania,2012,54,82,-28
DEU,Germany,MRT,Mauritania,2013,54,184,-130
DEU,Germany,MRT,Mauritania,2014,93,158,-65
DEU,Germany,MRT,Mauritania,2015,111,246,-135
DEU,Germany,MRT,Mauritania,2016,159,215,-56
DEU,Germany,MRT,Mauritania,2017,130,127,3
HUN,Hungary,MRT,Mauritania,2008,0,2,-2
HUN,Hungary,MRT,Mauritania,2009,0,0,0
HUN,Hungary,MRT,Mauritania,2010,0,0,0
HUN,Hungary,MRT,Mauritania,2011,0,0,0
HUN,Hungary,MRT,Mauritania,2012,0,1,-1
HUN,Hungary,MRT,Mauritania,2013,0,0,0
HUN,Hungary,MRT,Mauritania,2014,0,2,-2
HUN,Hungary,MRT,Mauritania,2015,0,1,-1
HUN,Hungary,MRT,Mauritania,2016,0,0,0
HUN,Hungary,MRT,Mauritania,2017,0,0,0
ISL,Iceland,MRT,Mauritania,2008,0,0,0
ISL,Iceland,MRT,Mauritania,2009,0,0,0
ISL,Iceland,MRT,Mauritania,2010,0,0,0
ISL,Iceland,MRT,Mauritania,2011,0,0,0
ISL,Iceland,MRT,Mauritania,2012,0,0,0
ISL,Iceland,MRT,Mauritania,2013,0,0,0
ISL,Iceland,MRT,Mauritania,2014,0,0,0
ISL,Iceland,MRT,Mauritania,2015,0,1,-1
ISL,Iceland,MRT,Mauritania,2016,0,0,0
ISL,Iceland,MRT,Mauritania,2017,0,0,0
ITA,Italy,MRT,Mauritania,2008,3,52,-49
ITA,Italy,MRT,Mauritania,2009,3,58,-55
ITA,Italy,MRT,Mauritania,2010,2,103,-101
ITA,Italy,MRT,Mauritania,2011,1,56,-55
ITA,Italy,MRT,Mauritania,2012,2,90,-88
ITA,Italy,MRT,Mauritania,2013,3,96,-93
ITA,Italy,MRT,Mauritania,2014,8,57,-49
ITA,Italy,MRT,Mauritania,2015,3,76,-73
ITA,Italy,MRT,Mauritania,2016,0,75,-75
ITA,Italy,MRT,Mauritania,2017,3,73,-70
JPN,Japan,MRT,Mauritania,2008,45,43,2
JPN,Japan,MRT,Mauritania,2009,11,12,-1
JPN,Japan,MRT,Mauritania,2010,18,19,-1
JPN,Japan,MRT,Mauritania,2011,23,30,-7
JPN,Japan,MRT,Mauritania,2012,27,28,-1
JPN,Japan,MRT,Mauritania,2013,32,34,-2
JPN,Japan,MRT,Mauritania,2014,24,23,1
JPN,Japan,MRT,Mauritania,2015,22,27,-5
JPN,Japan,MRT,Mauritania,2016,28,37,-9
JPN,Japan,MRT,Mauritania,2017,26,30,-4
KOR,Korea,MRT,Mauritania,2008,0,2,-2
KOR,Korea,MRT,Mauritania,2009,0,1,-1
KOR,Korea,MRT,Mauritania,2010,0,1,-1
KOR,Korea,MRT,Mauritania,2011,1,2,-1
KOR,Korea,MRT,Mauritania,2012,9,6,3
KOR,Korea,MRT,Mauritania,2013,1,3,-2
KOR,Korea,MRT,Mauritania,2014,3,6,-3
KOR,Korea,MRT,Mauritania,2015,2,2,0
KOR,Korea,MRT,Mauritania,2016,2,4,-2
KOR,Korea,MRT,Mauritania,2017,3,4,-1
LUX,Luxembourg,MRT,Mauritania,2008,0,0,0
LUX,Luxembourg,MRT,Mauritania,2009,0,2,-2
LUX,Luxembourg,MRT,Mauritania,2010,0,2,-2
LUX,Luxembourg,MRT,Mauritania,2011,3,0,3
LUX,Luxembourg,MRT,Mauritania,2012,0,0,0
LUX,Luxembourg,MRT,Mauritania,2013,0,4,-4
LUX,Luxembourg,MRT,Mauritania,2014,1,0,1
LUX,Luxembourg,MRT,Mauritania,2015,2,0,2
LUX,Luxembourg,MRT,Mauritania,2016,1,1,0
LUX,Luxembourg,MRT,Mauritania,2017,1,1,0
MEX,Mexico,MRT,Mauritania,2012,0,0,0
MEX,Mexico,MRT,Mauritania,2013,0,0,0
MEX,Mexico,MRT,Mauritania,2014,0,0,0
MEX,Mexico,MRT,Mauritania,2017,0,1,-1
NLD,Netherlands,MRT,Mauritania,2008,0,2,-2
NLD,Netherlands,MRT,Mauritania,2010,2,2,0
NLD,Netherlands,MRT,Mauritania,2011,-1,2,-3
NLD,Netherlands,MRT,Mauritania,2012,0,1,-1
NLD,Netherlands,MRT,Mauritania,2013,3,3,0
NLD,Netherlands,MRT,Mauritania,2014,0,5,-5
NLD,Netherlands,MRT,Mauritania,2015,3,5,-2
NLD,Netherlands,MRT,Mauritania,2016,2,4,-2
NLD,Netherlands,MRT,Mauritania,2017,0,2,-2
NZL,New Zealand,MRT,Mauritania,2015,0,1,-1
NOR,Norway,MRT,Mauritania,2008,0,3,-3
NOR,Norway,MRT,Mauritania,2009,3,4,-1
NOR,Norway,MRT,Mauritania,2010,0,2,-2
NOR,Norway,MRT,Mauritania,2011,4,3,1
NOR,Norway,MRT,Mauritania,2012,0,2,-2
NOR,Norway,MRT,Mauritania,2013,2,7,-5
NOR,Norway,MRT,Mauritania,2014,2,2,0
NOR,Norway,MRT,Mauritania,2015,3,2,1
NOR,Norway,MRT,Mauritania,2016,0,8,-8
NOR,Norway,MRT,Mauritania,2017,0,8,-8
POL,Poland,MRT,Mauritania,2009,0,4,-4
POL,Poland,MRT,Mauritania,2010,0,2,-2
POL,Poland,MRT,Mauritania,2011,0,3,-3
POL,Poland,MRT,Mauritania,2012,0,3,-3
POL,Poland,MRT,Mauritania,2013,0,1,-1
POL,Poland,MRT,Mauritania,2014,0,0,0
POL,Poland,MRT,Mauritania,2015,0,2,-2
POL,Poland,MRT,Mauritania,2016,0,0,0
POL,Poland,MRT,Mauritania,2017,0,0,0
SVK,Slovak Republic,MRT,Mauritania,2008,0,0,0
ESP,Spain,MRT,Mauritania,2008,593,1612,-1019
ESP,Spain,MRT,Mauritania,2009,952,869,83
ESP,Spain,MRT,Mauritania,2010,1116,672,444
ESP,Spain,MRT,Mauritania,2011,1306,622,684
ESP,Spain,MRT,Mauritania,2012,1350,489,861
ESP,Spain,MRT,Mauritania,2013,1116,489,627
ESP,Spain,MRT,Mauritania,2014,725,549,176
ESP,Spain,MRT,Mauritania,2015,724,690,34
ESP,Spain,MRT,Mauritania,2016,480,720,-240
ESP,Spain,MRT,Mauritania,2017,773,455,318
SWE,Sweden,MRT,Mauritania,2008,0,0,0
SWE,Sweden,MRT,Mauritania,2009,0,4,-4
SWE,Sweden,MRT,Mauritania,2010,0,3,-3
SWE,Sweden,MRT,Mauritania,2011,0,6,-6
SWE,Sweden,MRT,Mauritania,2012,0,3,-3
SWE,Sweden,MRT,Mauritania,2013,1,9,-8
SWE,Sweden,MRT,Mauritania,2014,0,3,-3
SWE,Sweden,MRT,Mauritania,2015,1,5,-4
SWE,Sweden,MRT,Mauritania,2016,0,0,0
SWE,Sweden,MRT,Mauritania,2017,0,1,-1
CHE,Switzerland,MRT,Mauritania,2010,3,1,2
CHE,Switzerland,MRT,Mauritania,2011,5,4,1
CHE,Switzerland,MRT,Mauritania,2012,0,5,-5
CHE,Switzerland,MRT,Mauritania,2013,1,5,-4
CHE,Switzerland,MRT,Mauritania,2014,1,6,-5
CHE,Switzerland,MRT,Mauritania,2015,4,4,0
CHE,Switzerland,MRT,Mauritania,2016,0,5,-5
CHE,Switzerland,MRT,Mauritania,2017,0,11,-11
TUR,Turkey,MRT,Mauritania,2010,0,6,-6
USA,United States,MRT,Mauritania,2008,0,844,-844
USA,United States,MRT,Mauritania,2009,0,597,-597
USA,United States,MRT,Mauritania,2010,0,495,-495
USA,United States,MRT,Mauritania,2011,0,393,-393
USA,United States,MRT,Mauritania,2012,0,410,-410
USA,United States,MRT,Mauritania,2013,0,354,-354
USA,United States,MRT,Mauritania,2014,0,320,-320
USA,United States,MRT,Mauritania,2015,0,298,-298
USA,United States,MRT,Mauritania,2016,0,317,-317
USA,United States,MRT,Mauritania,2017,0,287,-287
CHL,Chile,MRT,Mauritania,2008,0,0,0
CHL,Chile,MRT,Mauritania,2009,0,0,0
CHL,Chile,MRT,Mauritania,2010,0,0,0
CHL,Chile,MRT,Mauritania,2011,0,0,0
CHL,Chile,MRT,Mauritania,2012,0,0,0
CHL,Chile,MRT,Mauritania,2013,0,0,0
CHL,Chile,MRT,Mauritania,2014,0,0,0
CHL,Chile,MRT,Mauritania,2015,0,1,-1
CHL,Chile,MRT,Mauritania,2016,0,0,0
EST,Estonia,MRT,Mauritania,2008,0,0,0
EST,Estonia,MRT,Mauritania,2009,0,0,0
EST,Estonia,MRT,Mauritania,2010,0,0,0
EST,Estonia,MRT,Mauritania,2011,0,0,0
EST,Estonia,MRT,Mauritania,2012,0,0,0
EST,Estonia,MRT,Mauritania,2013,0,0,0
EST,Estonia,MRT,Mauritania,2014,0,0,0
EST,Estonia,MRT,Mauritania,2015,0,0,0
EST,Estonia,MRT,Mauritania,2016,0,0,0
EST,Estonia,MRT,Mauritania,2017,0,0,0
AUS,Australia,MUS,Mauritius,2008,70,680,-610
AUS,Australia,MUS,Mauritius,2009,82,778,-696
AUS,Australia,MUS,Mauritius,2010,75,568,-493
AUS,Australia,MUS,Mauritius,2011,95,774,-679
AUS,Australia,MUS,Mauritius,2012,73,886,-813
AUS,Australia,MUS,Mauritius,2013,78,1133,-1055
AUS,Australia,MUS,Mauritius,2014,101,967,-866
AUS,Australia,MUS,Mauritius,2015,100,756,-656
AUS,Australia,MUS,Mauritius,2016,100,611,-511
AUS,Australia,MUS,Mauritius,2017,0,495,-495
AUT,Austria,MUS,Mauritius,2008,3,13,-10
AUT,Austria,MUS,Mauritius,2009,6,8,-2
AUT,Austria,MUS,Mauritius,2010,9,2,7
AUT,Austria,MUS,Mauritius,2011,6,9,-3
AUT,Austria,MUS,Mauritius,2012,6,7,-1
AUT,Austria,MUS,Mauritius,2013,3,8,-5
AUT,Austria,MUS,Mauritius,2014,5,8,-3
AUT,Austria,MUS,Mauritius,2015,3,3,0
AUT,Austria,MUS,Mauritius,2016,2,8,-6
AUT,Austria,MUS,Mauritius,2017,5,5,0
BEL,Belgium,MUS,Mauritius,2008,0,78,-78
BEL,Belgium,MUS,Mauritius,2009,0,99,-99
BEL,Belgium,MUS,Mauritius,2010,29,107,-78
BEL,Belgium,MUS,Mauritius,2011,0,106,-106
BEL,Belgium,MUS,Mauritius,2012,29,104,-75
BEL,Belgium,MUS,Mauritius,2013,36,112,-76
BEL,Belgium,MUS,Mauritius,2014,33,77,-44
BEL,Belgium,MUS,Mauritius,2015,26,68,-42
BEL,Belgium,MUS,Mauritius,2016,37,74,-37
BEL,Belgium,MUS,Mauritius,2017,24,34,-10
CAN,Canada,MUS,Mauritius,2008,0,714,-714
CAN,Canada,MUS,Mauritius,2009,0,872,-872
CAN,Canada,MUS,Mauritius,2010,0,1455,-1455
CAN,Canada,MUS,Mauritius,2011,0,1146,-1146
CAN,Canada,MUS,Mauritius,2012,0,798,-798
CAN,Canada,MUS,Mauritius,2013,0,1203,-1203
CAN,Canada,MUS,Mauritius,2014,0,419,-419
CAN,Canada,MUS,Mauritius,2015,0,718,-718
CAN,Canada,MUS,Mauritius,2016,0,550,-550
CAN,Canada,MUS,Mauritius,2017,0,725,-725
CZE,Czech Republic,MUS,Mauritius,2008,0,1,-1
CZE,Czech Republic,MUS,Mauritius,2009,0,5,-5
CZE,Czech Republic,MUS,Mauritius,2010,0,1,-1
CZE,Czech Republic,MUS,Mauritius,2011,0,3,-3
CZE,Czech Republic,MUS,Mauritius,2012,3,1,2
CZE,Czech Republic,MUS,Mauritius,2013,1,1,0
CZE,Czech Republic,MUS,Mauritius,2014,2,7,-5
CZE,Czech Republic,MUS,Mauritius,2015,4,1,3
CZE,Czech Republic,MUS,Mauritius,2016,0,9,-9
CZE,Czech Republic,MUS,Mauritius,2017,0,10,-10
DNK,Denmark,MUS,Mauritius,2008,0,9,-9
DNK,Denmark,MUS,Mauritius,2009,0,4,-4
DNK,Denmark,MUS,Mauritius,2010,2,3,-1
DNK,Denmark,MUS,Mauritius,2011,1,3,-2
DNK,Denmark,MUS,Mauritius,2012,4,2,2
DNK,Denmark,MUS,Mauritius,2013,1,7,-6
DNK,Denmark,MUS,Mauritius,2014,2,6,-4
DNK,Denmark,MUS,Mauritius,2015,2,4,-2
DNK,Denmark,MUS,Mauritius,2016,7,8,-1
DNK,Denmark,MUS,Mauritius,2017,3,5,-2
FIN,Finland,MUS,Mauritius,2008,0,0,0
FIN,Finland,MUS,Mauritius,2009,0,0,0
FIN,Finland,MUS,Mauritius,2010,0,3,-3
FIN,Finland,MUS,Mauritius,2011,0,0,0
FIN,Finland,MUS,Mauritius,2012,0,3,-3
FIN,Finland,MUS,Mauritius,2013,0,2,-2
FIN,Finland,MUS,Mauritius,2014,0,4,-4
FIN,Finland,MUS,Mauritius,2015,0,2,-2
FIN,Finland,MUS,Mauritius,2016,1,2,-1
FIN,Finland,MUS,Mauritius,2017,0,0,0
FRA,France,MUS,Mauritius,2008,0,776,-776
FRA,France,MUS,Mauritius,2009,0,797,-797
FRA,France,MUS,Mauritius,2010,0,807,-807
FRA,France,MUS,Mauritius,2011,0,931,-931
FRA,France,MUS,Mauritius,2012,0,858,-858
FRA,France,MUS,Mauritius,2013,0,842,-842
FRA,France,MUS,Mauritius,2014,0,969,-969
FRA,France,MUS,Mauritius,2015,0,857,-857
FRA,France,MUS,Mauritius,2016,0,930,-930
FRA,France,MUS,Mauritius,2017,0,884,-884
DEU,Germany,MUS,Mauritius,2008,50,49,1
DEU,Germany,MUS,Mauritius,2009,55,55,0
DEU,Germany,MUS,Mauritius,2010,53,70,-17
DEU,Germany,MUS,Mauritius,2011,41,79,-38
DEU,Germany,MUS,Mauritius,2012,55,109,-54
DEU,Germany,MUS,Mauritius,2013,44,86,-42
DEU,Germany,MUS,Mauritius,2014,52,110,-58
DEU,Germany,MUS,Mauritius,2015,55,132,-77
DEU,Germany,MUS,Mauritius,2016,64,138,-74
DEU,Germany,MUS,Mauritius,2017,56,176,-120
HUN,Hungary,MUS,Mauritius,2008,0,8,-8
HUN,Hungary,MUS,Mauritius,2009,0,5,-5
HUN,Hungary,MUS,Mauritius,2010,0,11,-11
HUN,Hungary,MUS,Mauritius,2011,0,11,-11
HUN,Hungary,MUS,Mauritius,2012,1,16,-15
HUN,Hungary,MUS,Mauritius,2013,2,13,-11
HUN,Hungary,MUS,Mauritius,2014,6,6,0
HUN,Hungary,MUS,Mauritius,2015,2,12,-10
HUN,Hungary,MUS,Mauritius,2016,2,3,-1
HUN,Hungary,MUS,Mauritius,2017,0,13,-13
ISL,Iceland,MUS,Mauritius,2008,2,0,2
ISL,Iceland,MUS,Mauritius,2009,0,1,-1
ISL,Iceland,MUS,Mauritius,2010,1,0,1
ISL,Iceland,MUS,Mauritius,2011,0,0,0
ISL,Iceland,MUS,Mauritius,2012,0,0,0
ISL,Iceland,MUS,Mauritius,2013,0,0,0
ISL,Iceland,MUS,Mauritius,2014,0,0,0
ISL,Iceland,MUS,Mauritius,2015,0,0,0
ISL,Iceland,MUS,Mauritius,2016,0,1,-1
ISL,Iceland,MUS,Mauritius,2017,0,1,-1
ITA,Italy,MUS,Mauritius,2008,11,162,-151
ITA,Italy,MUS,Mauritius,2009,12,239,-227
ITA,Italy,MUS,Mauritius,2010,13,397,-384
ITA,Italy,MUS,Mauritius,2011,19,329,-310
ITA,Italy,MUS,Mauritius,2012,21,290,-269
ITA,Italy,MUS,Mauritius,2013,40,319,-279
ITA,Italy,MUS,Mauritius,2014,33,227,-194
ITA,Italy,MUS,Mauritius,2015,26,134,-108
ITA,Italy,MUS,Mauritius,2016,0,110,-110
ITA,Italy,MUS,Mauritius,2017,27,134,-107
JPN,Japan,MUS,Mauritius,2008,25,26,-1
JPN,Japan,MUS,Mauritius,2009,24,16,8
JPN,Japan,MUS,Mauritius,2010,20,27,-7
JPN,Japan,MUS,Mauritius,2011,24,25,-1
JPN,Japan,MUS,Mauritius,2012,36,49,-13
JPN,Japan,MUS,Mauritius,2013,56,52,4
JPN,Japan,MUS,Mauritius,2014,23,32,-9
JPN,Japan,MUS,Mauritius,2015,28,31,-3
JPN,Japan,MUS,Mauritius,2016,20,23,-3
JPN,Japan,MUS,Mauritius,2017,23,33,-10
KOR,Korea,MUS,Mauritius,2008,2,2,0
KOR,Korea,MUS,Mauritius,2009,3,2,1
KOR,Korea,MUS,Mauritius,2010,1,2,-1
KOR,Korea,MUS,Mauritius,2011,1,2,-1
KOR,Korea,MUS,Mauritius,2012,2,7,-5
KOR,Korea,MUS,Mauritius,2013,1,3,-2
KOR,Korea,MUS,Mauritius,2014,4,7,-3
KOR,Korea,MUS,Mauritius,2015,2,1,1
KOR,Korea,MUS,Mauritius,2016,4,10,-6
KOR,Korea,MUS,Mauritius,2017,10,6,4
LUX,Luxembourg,MUS,Mauritius,2008,3,33,-30
LUX,Luxembourg,MUS,Mauritius,2009,13,14,-1
LUX,Luxembourg,MUS,Mauritius,2010,4,13,-9
LUX,Luxembourg,MUS,Mauritius,2011,3,11,-8
LUX,Luxembourg,MUS,Mauritius,2012,3,8,-5
LUX,Luxembourg,MUS,Mauritius,2013,1,11,-10
LUX,Luxembourg,MUS,Mauritius,2014,9,17,-8
LUX,Luxembourg,MUS,Mauritius,2015,5,26,-21
LUX,Luxembourg,MUS,Mauritius,2016,2,54,-52
LUX,Luxembourg,MUS,Mauritius,2017,11,41,-30
MEX,Mexico,MUS,Mauritius,2010,0,1,-1
MEX,Mexico,MUS,Mauritius,2012,0,0,0
MEX,Mexico,MUS,Mauritius,2013,0,0,0
MEX,Mexico,MUS,Mauritius,2014,0,0,0
MEX,Mexico,MUS,Mauritius,2017,0,3,-3
NLD,Netherlands,MUS,Mauritius,2008,6,16,-10
NLD,Netherlands,MUS,Mauritius,2009,9,13,-4
NLD,Netherlands,MUS,Mauritius,2010,9,10,-1
NLD,Netherlands,MUS,Mauritius,2011,4,6,-2
NLD,Netherlands,MUS,Mauritius,2012,10,12,-2
NLD,Netherlands,MUS,Mauritius,2013,8,11,-3
NLD,Netherlands,MUS,Mauritius,2014,7,15,-8
NLD,Netherlands,MUS,Mauritius,2015,11,16,-5
NLD,Netherlands,MUS,Mauritius,2016,8,13,-5
NLD,Netherlands,MUS,Mauritius,2017,9,21,-12
NZL,New Zealand,MUS,Mauritius,2008,5,34,-29
NZL,New Zealand,MUS,Mauritius,2009,3,46,-43
NZL,New Zealand,MUS,Mauritius,2010,7,13,-6
NZL,New Zealand,MUS,Mauritius,2011,14,22,-8
NZL,New Zealand,MUS,Mauritius,2012,3,16,-13
NZL,New Zealand,MUS,Mauritius,2013,8,17,-9
NZL,New Zealand,MUS,Mauritius,2014,2,24,-22
NZL,New Zealand,MUS,Mauritius,2015,9,26,-17
NZL,New Zealand,MUS,Mauritius,2016,1,51,-50
NZL,New Zealand,MUS,Mauritius,2017,7,51,-44
NOR,Norway,MUS,Mauritius,2008,3,5,-2
NOR,Norway,MUS,Mauritius,2009,0,8,-8
NOR,Norway,MUS,Mauritius,2010,0,4,-4
NOR,Norway,MUS,Mauritius,2011,0,6,-6
NOR,Norway,MUS,Mauritius,2012,0,5,-5
NOR,Norway,MUS,Mauritius,2013,0,4,-4
NOR,Norway,MUS,Mauritius,2014,2,5,-3
NOR,Norway,MUS,Mauritius,2015,3,4,-1
NOR,Norway,MUS,Mauritius,2016,4,0,4
NOR,Norway,MUS,Mauritius,2017,5,0,5
POL,Poland,MUS,Mauritius,2009,0,8,-8
POL,Poland,MUS,Mauritius,2010,0,7,-7
POL,Poland,MUS,Mauritius,2011,0,18,-18
POL,Poland,MUS,Mauritius,2012,0,17,-17
POL,Poland,MUS,Mauritius,2013,0,14,-14
POL,Poland,MUS,Mauritius,2014,0,9,-9
POL,Poland,MUS,Mauritius,2015,0,20,-20
POL,Poland,MUS,Mauritius,2016,0,17,-17
POL,Poland,MUS,Mauritius,2017,0,10,-10
SVK,Slovak Republic,MUS,Mauritius,2008,0,0,0
SVK,Slovak Republic,MUS,Mauritius,2009,0,1,-1
SVK,Slovak Republic,MUS,Mauritius,2010,0,2,-2
SVK,Slovak Republic,MUS,Mauritius,2011,1,1,0
SVK,Slovak Republic,MUS,Mauritius,2015,0,1,-1
ESP,Spain,MUS,Mauritius,2008,2,11,-9
ESP,Spain,MUS,Mauritius,2009,0,17,-17
ESP,Spain,MUS,Mauritius,2010,9,9,0
ESP,Spain,MUS,Mauritius,2011,3,12,-9
ESP,Spain,MUS,Mauritius,2012,6,16,-10
ESP,Spain,MUS,Mauritius,2013,5,15,-10
ESP,Spain,MUS,Mauritius,2014,2,13,-11
ESP,Spain,MUS,Mauritius,2015,1,17,-16
ESP,Spain,MUS,Mauritius,2016,2,24,-22
ESP,Spain,MUS,Mauritius,2017,9,19,-10
SWE,Sweden,MUS,Mauritius,2008,2,10,-8
SWE,Sweden,MUS,Mauritius,2009,6,8,-2
SWE,Sweden,MUS,Mauritius,2010,0,8,-8
SWE,Sweden,MUS,Mauritius,2011,5,7,-2
SWE,Sweden,MUS,Mauritius,2012,1,12,-11
SWE,Sweden,MUS,Mauritius,2013,7,4,3
SWE,Sweden,MUS,Mauritius,2014,1,4,-3
SWE,Sweden,MUS,Mauritius,2015,3,4,-1
SWE,Sweden,MUS,Mauritius,2016,1,8,-7
SWE,Sweden,MUS,Mauritius,2017,1,9,-8
CHE,Switzerland,MUS,Mauritius,2010,35,73,-38
CHE,Switzerland,MUS,Mauritius,2011,28,85,-57
CHE,Switzerland,MUS,Mauritius,2012,25,84,-59
CHE,Switzerland,MUS,Mauritius,2013,36,77,-41
CHE,Switzerland,MUS,Mauritius,2014,31,71,-40
CHE,Switzerland,MUS,Mauritius,2015,24,73,-49
CHE,Switzerland,MUS,Mauritius,2016,44,58,-14
CHE,Switzerland,MUS,Mauritius,2017,34,73,-39
TUR,Turkey,MUS,Mauritius,2010,0,2,-2
GBR,United Kingdom,MUS,Mauritius,2011,1000,2000,-1000
GBR,United Kingdom,MUS,Mauritius,2012,1000,1000,0
GBR,United Kingdom,MUS,Mauritius,2015,1000,1000,0
USA,United States,MUS,Mauritius,2008,0,83,-83
USA,United States,MUS,Mauritius,2009,0,110,-110
USA,United States,MUS,Mauritius,2010,0,84,-84
USA,United States,MUS,Mauritius,2011,0,101,-101
USA,United States,MUS,Mauritius,2012,0,77,-77
USA,United States,MUS,Mauritius,2013,0,83,-83
USA,United States,MUS,Mauritius,2014,0,81,-81
USA,United States,MUS,Mauritius,2015,0,96,-96
USA,United States,MUS,Mauritius,2016,0,110,-110
USA,United States,MUS,Mauritius,2017,0,96,-96
CHL,Chile,MUS,Mauritius,2008,0,0,0
CHL,Chile,MUS,Mauritius,2009,0,2,-2
CHL,Chile,MUS,Mauritius,2010,0,0,0
CHL,Chile,MUS,Mauritius,2011,0,1,-1
CHL,Chile,MUS,Mauritius,2012,0,1,-1
CHL,Chile,MUS,Mauritius,2013,0,0,0
CHL,Chile,MUS,Mauritius,2014,0,0,0
CHL,Chile,MUS,Mauritius,2015,0,1,-1
CHL,Chile,MUS,Mauritius,2016,0,0,0
EST,Estonia,MUS,Mauritius,2008,0,0,0
EST,Estonia,MUS,Mauritius,2009,0,0,0
EST,Estonia,MUS,Mauritius,2010,0,0,0
EST,Estonia,MUS,Mauritius,2011,0,0,0
EST,Estonia,MUS,Mauritius,2012,0,0,0
EST,Estonia,MUS,Mauritius,2013,0,0,0
EST,Estonia,MUS,Mauritius,2014,0,1,-1
EST,Estonia,MUS,Mauritius,2015,0,0,0
EST,Estonia,MUS,Mauritius,2016,0,0,0
EST,Estonia,MUS,Mauritius,2017,0,7,-7
SVN,Slovenia,MUS,Mauritius,2009,0,1,-1
SVN,Slovenia,MUS,Mauritius,2010,0,1,-1
SVN,Slovenia,MUS,Mauritius,2011,0,1,-1
SVN,Slovenia,MUS,Mauritius,2013,0,1,-1
SVN,Slovenia,MUS,Mauritius,2016,0,1,-1
ISL,Iceland,MEX,Mexico,2011,0,12,-12
LUX,Luxembourg,MEX,Mexico,2008,0,28,-28
LUX,Luxembourg,MEX,Mexico,2009,0,31,-31
LUX,Luxembourg,MEX,Mexico,2010,0,19,-19
LUX,Luxembourg,MEX,Mexico,2011,0,22,-22
LUX,Luxembourg,MEX,Mexico,2016,0,41,-41
LUX,Luxembourg,MEX,Mexico,2017,0,37,-37
AUS,Australia,FSM,Micronesia,2008,0,2,-2
AUS,Australia,FSM,Micronesia,2009,0,0,0
AUS,Australia,FSM,Micronesia,2010,0,1,-1
AUS,Australia,FSM,Micronesia,2011,0,0,0
AUS,Australia,FSM,Micronesia,2012,0,0,0
AUS,Australia,FSM,Micronesia,2013,0,0,0
AUS,Australia,FSM,Micronesia,2014,0,0,0
AUS,Australia,FSM,Micronesia,2015,0,0,0
AUS,Australia,FSM,Micronesia,2016,0,0,0
AUS,Australia,FSM,Micronesia,2017,0,3,-3
AUT,Austria,FSM,Micronesia,2008,0,0,0
AUT,Austria,FSM,Micronesia,2009,0,0,0
AUT,Austria,FSM,Micronesia,2010,0,0,0
AUT,Austria,FSM,Micronesia,2011,0,0,0
AUT,Austria,FSM,Micronesia,2012,0,0,0
AUT,Austria,FSM,Micronesia,2013,0,0,0
AUT,Austria,FSM,Micronesia,2014,0,0,0
AUT,Austria,FSM,Micronesia,2015,0,0,0
AUT,Austria,FSM,Micronesia,2016,0,0,0
AUT,Austria,FSM,Micronesia,2017,0,0,0
BEL,Belgium,FSM,Micronesia,2010,0,0,0
BEL,Belgium,FSM,Micronesia,2017,0,3,-3
CAN,Canada,FSM,Micronesia,2008,0,0,0
CAN,Canada,FSM,Micronesia,2009,0,0,0
CAN,Canada,FSM,Micronesia,2010,0,0,0
CAN,Canada,FSM,Micronesia,2011,0,0,0
CAN,Canada,FSM,Micronesia,2012,0,0,0
CAN,Canada,FSM,Micronesia,2013,0,1,-1
CAN,Canada,FSM,Micronesia,2014,0,0,0
CAN,Canada,FSM,Micronesia,2015,0,0,0
CAN,Canada,FSM,Micronesia,2016,0,0,0
CAN,Canada,FSM,Micronesia,2017,0,0,0
DNK,Denmark,FSM,Micronesia,2015,0,0,0
DNK,Denmark,FSM,Micronesia,2016,0,0,0
DNK,Denmark,FSM,Micronesia,2017,0,0,0
FIN,Finland,FSM,Micronesia,2008,0,0,0
FIN,Finland,FSM,Micronesia,2009,0,0,0
FIN,Finland,FSM,Micronesia,2010,0,0,0
FIN,Finland,FSM,Micronesia,2011,0,0,0
FIN,Finland,FSM,Micronesia,2012,0,0,0
FIN,Finland,FSM,Micronesia,2013,0,0,0
FIN,Finland,FSM,Micronesia,2014,0,0,0
FIN,Finland,FSM,Micronesia,2015,0,0,0
FIN,Finland,FSM,Micronesia,2016,0,0,0
FIN,Finland,FSM,Micronesia,2017,0,0,0
FRA,France,FSM,Micronesia,2008,0,0,0
FRA,France,FSM,Micronesia,2009,0,0,0
FRA,France,FSM,Micronesia,2010,0,0,0
FRA,France,FSM,Micronesia,2011,0,0,0
FRA,France,FSM,Micronesia,2012,0,0,0
FRA,France,FSM,Micronesia,2013,0,0,0
FRA,France,FSM,Micronesia,2014,0,0,0
FRA,France,FSM,Micronesia,2015,0,0,0
FRA,France,FSM,Micronesia,2016,0,0,0
FRA,France,FSM,Micronesia,2017,0,0,0
DEU,Germany,FSM,Micronesia,2008,0,0,0
DEU,Germany,FSM,Micronesia,2009,0,0,0
DEU,Germany,FSM,Micronesia,2010,0,0,0
DEU,Germany,FSM,Micronesia,2011,0,1,-1
DEU,Germany,FSM,Micronesia,2012,1,1,0
DEU,Germany,FSM,Micronesia,2013,0,1,-1
DEU,Germany,FSM,Micronesia,2014,0,3,-3
DEU,Germany,FSM,Micronesia,2015,0,1,-1
DEU,Germany,FSM,Micronesia,2016,0,0,0
DEU,Germany,FSM,Micronesia,2017,0,1,-1
HUN,Hungary,FSM,Micronesia,2008,0,0,0
HUN,Hungary,FSM,Micronesia,2009,0,0,0
HUN,Hungary,FSM,Micronesia,2010,0,0,0
HUN,Hungary,FSM,Micronesia,2011,0,0,0
HUN,Hungary,FSM,Micronesia,2012,0,0,0
HUN,Hungary,FSM,Micronesia,2013,0,0,0
HUN,Hungary,FSM,Micronesia,2014,0,0,0
HUN,Hungary,FSM,Micronesia,2015,0,0,0
HUN,Hungary,FSM,Micronesia,2016,0,0,0
HUN,Hungary,FSM,Micronesia,2017,0,0,0
ISL,Iceland,FSM,Micronesia,2016,0,0,0
ISL,Iceland,FSM,Micronesia,2017,0,0,0
ITA,Italy,FSM,Micronesia,2008,0,6,-6
ITA,Italy,FSM,Micronesia,2009,0,7,-7
ITA,Italy,FSM,Micronesia,2010,0,3,-3
ITA,Italy,FSM,Micronesia,2011,0,2,-2
JPN,Japan,FSM,Micronesia,2008,55,59,-4
JPN,Japan,FSM,Micronesia,2009,63,69,-6
JPN,Japan,FSM,Micronesia,2010,5,58,-53
JPN,Japan,FSM,Micronesia,2011,32,31,1
JPN,Japan,FSM,Micronesia,2012,58,69,-11
JPN,Japan,FSM,Micronesia,2013,63,73,-10
JPN,Japan,FSM,Micronesia,2014,67,74,-7
JPN,Japan,FSM,Micronesia,2015,80,86,-6
JPN,Japan,FSM,Micronesia,2016,77,80,-3
JPN,Japan,FSM,Micronesia,2017,75,92,-17
KOR,Korea,FSM,Micronesia,2008,1,3,-2
KOR,Korea,FSM,Micronesia,2009,5,3,2
KOR,Korea,FSM,Micronesia,2010,1,3,-2
KOR,Korea,FSM,Micronesia,2011,1,3,-2
KOR,Korea,FSM,Micronesia,2012,3,1,2
KOR,Korea,FSM,Micronesia,2013,1,4,-3
KOR,Korea,FSM,Micronesia,2014,4,2,2
KOR,Korea,FSM,Micronesia,2015,1,4,-3
KOR,Korea,FSM,Micronesia,2016,3,2,1
KOR,Korea,FSM,Micronesia,2017,0,3,-3
LUX,Luxembourg,FSM,Micronesia,2008,0,0,0
LUX,Luxembourg,FSM,Micronesia,2009,0,0,0
LUX,Luxembourg,FSM,Micronesia,2010,0,0,0
LUX,Luxembourg,FSM,Micronesia,2011,0,0,0
LUX,Luxembourg,FSM,Micronesia,2012,0,0,0
LUX,Luxembourg,FSM,Micronesia,2013,0,0,0
LUX,Luxembourg,FSM,Micronesia,2014,0,0,0
LUX,Luxembourg,FSM,Micronesia,2015,0,0,0
LUX,Luxembourg,FSM,Micronesia,2016,0,0,0
LUX,Luxembourg,FSM,Micronesia,2017,0,0,0
MEX,Mexico,FSM,Micronesia,2010,0,1,-1
MEX,Mexico,FSM,Micronesia,2012,0,0,0
MEX,Mexico,FSM,Micronesia,2013,0,0,0
MEX,Mexico,FSM,Micronesia,2014,0,0,0
NZL,New Zealand,FSM,Micronesia,2008,0,2,-2
NZL,New Zealand,FSM,Micronesia,2009,0,1,-1
NZL,New Zealand,FSM,Micronesia,2010,0,1,-1
NZL,New Zealand,FSM,Micronesia,2013,1,1,0
NZL,New Zealand,FSM,Micronesia,2015,1,1,0
NZL,New Zealand,FSM,Micronesia,2016,0,1,-1
NZL,New Zealand,FSM,Micronesia,2017,0,1,-1
NOR,Norway,FSM,Micronesia,2008,0,0,0
NOR,Norway,FSM,Micronesia,2009,0,0,0
NOR,Norway,FSM,Micronesia,2010,0,0,0
NOR,Norway,FSM,Micronesia,2011,0,0,0
NOR,Norway,FSM,Micronesia,2012,0,0,0
NOR,Norway,FSM,Micronesia,2013,0,0,0
NOR,Norway,FSM,Micronesia,2014,0,0,0
NOR,Norway,FSM,Micronesia,2015,0,0,0
NOR,Norway,FSM,Micronesia,2016,0,0,0
NOR,Norway,FSM,Micronesia,2017,0,0,0
POL,Poland,FSM,Micronesia,2009,0,0,0
POL,Poland,FSM,Micronesia,2010,0,0,0
POL,Poland,FSM,Micronesia,2011,0,0,0
POL,Poland,FSM,Micronesia,2012,0,0,0
POL,Poland,FSM,Micronesia,2013,0,0,0
POL,Poland,FSM,Micronesia,2014,0,0,0
POL,Poland,FSM,Micronesia,2015,0,0,0
POL,Poland,FSM,Micronesia,2016,0,0,0
POL,Poland,FSM,Micronesia,2017,0,0,0
SVK,Slovak Republic,FSM,Micronesia,2008,0,0,0
ESP,Spain,FSM,Micronesia,2008,1,2,-1
ESP,Spain,FSM,Micronesia,2009,1,5,-4
ESP,Spain,FSM,Micronesia,2010,2,3,-1
ESP,Spain,FSM,Micronesia,2011,1,4,-3
ESP,Spain,FSM,Micronesia,2012,0,7,-7
ESP,Spain,FSM,Micronesia,2013,1,0,1
ESP,Spain,FSM,Micronesia,2014,1,8,-7
ESP,Spain,FSM,Micronesia,2015,0,1,-1
ESP,Spain,FSM,Micronesia,2016,0,2,-2
ESP,Spain,FSM,Micronesia,2017,0,2,-2
SWE,Sweden,FSM,Micronesia,2008,0,0,0
SWE,Sweden,FSM,Micronesia,2009,0,0,0
SWE,Sweden,FSM,Micronesia,2010,0,0,0
SWE,Sweden,FSM,Micronesia,2011,0,0,0
SWE,Sweden,FSM,Micronesia,2012,0,0,0
SWE,Sweden,FSM,Micronesia,2013,0,0,0
SWE,Sweden,FSM,Micronesia,2014,0,0,0
SWE,Sweden,FSM,Micronesia,2015,0,0,0
SWE,Sweden,FSM,Micronesia,2016,0,0,0
SWE,Sweden,FSM,Micronesia,2017,0,0,0
CHE,Switzerland,FSM,Micronesia,2010,0,0,0
CHE,Switzerland,FSM,Micronesia,2011,0,0,0
CHE,Switzerland,FSM,Micronesia,2012,0,0,0
CHE,Switzerland,FSM,Micronesia,2013,0,0,0
USA,United States,FSM,Micronesia,2008,0,13,-13
USA,United States,FSM,Micronesia,2009,0,16,-16
USA,United States,FSM,Micronesia,2010,0,10,-10
USA,United States,FSM,Micronesia,2011,0,9,-9
USA,United States,FSM,Micronesia,2012,0,13,-13
USA,United States,FSM,Micronesia,2013,0,4,-4
USA,United States,FSM,Micronesia,2014,0,5,-5
USA,United States,FSM,Micronesia,2015,0,6,-6
USA,United States,FSM,Micronesia,2016,0,11,-11
USA,United States,FSM,Micronesia,2017,0,6,-6
CHL,Chile,FSM,Micronesia,2008,0,0,0
CHL,Chile,FSM,Micronesia,2009,0,0,0
CHL,Chile,FSM,Micronesia,2010,0,0,0
CHL,Chile,FSM,Micronesia,2011,0,0,0
CHL,Chile,FSM,Micronesia,2012,0,0,0
CHL,Chile,FSM,Micronesia,2013,0,0,0
CHL,Chile,FSM,Micronesia,2014,0,0,0
CHL,Chile,FSM,Micronesia,2015,0,0,0
CHL,Chile,FSM,Micronesia,2016,0,0,0
EST,Estonia,FSM,Micronesia,2008,0,0,0
EST,Estonia,FSM,Micronesia,2009,0,0,0
EST,Estonia,FSM,Micronesia,2010,0,0,0
EST,Estonia,FSM,Micronesia,2011,0,0,0
EST,Estonia,FSM,Micronesia,2012,0,0,0
EST,Estonia,FSM,Micronesia,2013,0,0,0
EST,Estonia,FSM,Micronesia,2014,0,0,0
EST,Estonia,FSM,Micronesia,2015,0,0,0
EST,Estonia,FSM,Micronesia,2016,0,0,0
EST,Estonia,FSM,Micronesia,2017,0,0,0
AUS,Australia,MDA,Moldova,2008,0,44,-44
AUS,Australia,MDA,Moldova,2009,0,24,-24
AUS,Australia,MDA,Moldova,2010,5,28,-23
AUS,Australia,MDA,Moldova,2011,6,39,-33
AUS,Australia,MDA,Moldova,2012,0,45,-45
AUS,Australia,MDA,Moldova,2013,8,28,-20
AUS,Australia,MDA,Moldova,2014,12,23,-11
AUS,Australia,MDA,Moldova,2015,0,30,-30
AUS,Australia,MDA,Moldova,2016,0,30,-30
AUS,Australia,MDA,Moldova,2017,0,27,-27
AUT,Austria,MDA,Moldova,2008,189,235,-46
AUT,Austria,MDA,Moldova,2009,255,234,21
AUT,Austria,MDA,Moldova,2010,222,153,69
AUT,Austria,MDA,Moldova,2011,135,128,7
AUT,Austria,MDA,Moldova,2012,81,149,-68
AUT,Austria,MDA,Moldova,2013,110,148,-38
AUT,Austria,MDA,Moldova,2014,73,177,-104
AUT,Austria,MDA,Moldova,2015,97,187,-90
AUT,Austria,MDA,Moldova,2016,100,192,-92
AUT,Austria,MDA,Moldova,2017,108,178,-70
BEL,Belgium,MDA,Moldova,2008,0,144,-144
BEL,Belgium,MDA,Moldova,2009,0,156,-156
BEL,Belgium,MDA,Moldova,2010,44,257,-213
BEL,Belgium,MDA,Moldova,2011,0,201,-201
BEL,Belgium,MDA,Moldova,2012,65,208,-143
BEL,Belgium,MDA,Moldova,2013,72,149,-77
BEL,Belgium,MDA,Moldova,2014,42,140,-98
BEL,Belgium,MDA,Moldova,2015,36,148,-112
BEL,Belgium,MDA,Moldova,2016,24,143,-119
BEL,Belgium,MDA,Moldova,2017,21,245,-224
CAN,Canada,MDA,Moldova,2008,0,1127,-1127
CAN,Canada,MDA,Moldova,2009,0,1535,-1535
CAN,Canada,MDA,Moldova,2010,0,1988,-1988
CAN,Canada,MDA,Moldova,2011,0,1367,-1367
CAN,Canada,MDA,Moldova,2012,0,1416,-1416
CAN,Canada,MDA,Moldova,2013,0,1232,-1232
CAN,Canada,MDA,Moldova,2014,0,941,-941
CAN,Canada,MDA,Moldova,2015,0,929,-929
CAN,Canada,MDA,Moldova,2016,0,1090,-1090
CAN,Canada,MDA,Moldova,2017,0,685,-685
CZE,Czech Republic,MDA,Moldova,2008,6,3319,-3313
CZE,Czech Republic,MDA,Moldova,2009,0,1338,-1338
CZE,Czech Republic,MDA,Moldova,2010,1,354,-353
CZE,Czech Republic,MDA,Moldova,2011,9,161,-152
CZE,Czech Republic,MDA,Moldova,2012,792,388,404
CZE,Czech Republic,MDA,Moldova,2013,707,205,502
CZE,Czech Republic,MDA,Moldova,2014,434,327,107
CZE,Czech Republic,MDA,Moldova,2015,273,267,6
CZE,Czech Republic,MDA,Moldova,2016,138,412,-274
CZE,Czech Republic,MDA,Moldova,2017,209,500,-291
DNK,Denmark,MDA,Moldova,2008,15,55,-40
DNK,Denmark,MDA,Moldova,2009,33,40,-7
DNK,Denmark,MDA,Moldova,2010,26,29,-3
DNK,Denmark,MDA,Moldova,2011,28,50,-22
DNK,Denmark,MDA,Moldova,2012,15,38,-23
DNK,Denmark,MDA,Moldova,2013,20,21,-1
DNK,Denmark,MDA,Moldova,2014,21,23,-2
DNK,Denmark,MDA,Moldova,2015,11,0,11
DNK,Denmark,MDA,Moldova,2016,13,26,-13
DNK,Denmark,MDA,Moldova,2017,18,45,-27
FIN,Finland,MDA,Moldova,2008,0,18,-18
FIN,Finland,MDA,Moldova,2009,2,10,-8
FIN,Finland,MDA,Moldova,2010,1,12,-11
FIN,Finland,MDA,Moldova,2011,1,9,-8
FIN,Finland,MDA,Moldova,2012,2,11,-9
FIN,Finland,MDA,Moldova,2013,1,13,-12
FIN,Finland,MDA,Moldova,2014,2,18,-16
FIN,Finland,MDA,Moldova,2015,4,13,-9
FIN,Finland,MDA,Moldova,2016,1,14,-13
FIN,Finland,MDA,Moldova,2017,5,34,-29
FRA,France,MDA,Moldova,2008,0,447,-447
FRA,France,MDA,Moldova,2009,0,468,-468
FRA,France,MDA,Moldova,2010,0,407,-407
FRA,France,MDA,Moldova,2011,0,340,-340
FRA,France,MDA,Moldova,2012,0,350,-350
FRA,France,MDA,Moldova,2013,0,419,-419
FRA,France,MDA,Moldova,2014,0,342,-342
FRA,France,MDA,Moldova,2015,0,291,-291
FRA,France,MDA,Moldova,2016,0,316,-316
FRA,France,MDA,Moldova,2017,0,259,-259
DEU,Germany,MDA,Moldova,2008,521,699,-178
DEU,Germany,MDA,Moldova,2009,549,749,-200
DEU,Germany,MDA,Moldova,2010,538,776,-238
DEU,Germany,MDA,Moldova,2011,519,895,-376
DEU,Germany,MDA,Moldova,2012,494,897,-403
DEU,Germany,MDA,Moldova,2013,586,1039,-453
DEU,Germany,MDA,Moldova,2014,703,1799,-1096
DEU,Germany,MDA,Moldova,2015,1121,3477,-2356
DEU,Germany,MDA,Moldova,2016,3235,5869,-2634
DEU,Germany,MDA,Moldova,2017,3326,4543,-1217
HUN,Hungary,MDA,Moldova,2008,5,140,-135
HUN,Hungary,MDA,Moldova,2009,17,59,-42
HUN,Hungary,MDA,Moldova,2010,8,54,-46
HUN,Hungary,MDA,Moldova,2011,4,34,-30
HUN,Hungary,MDA,Moldova,2012,6,64,-58
HUN,Hungary,MDA,Moldova,2013,16,36,-20
HUN,Hungary,MDA,Moldova,2014,13,44,-31
HUN,Hungary,MDA,Moldova,2015,5,36,-31
HUN,Hungary,MDA,Moldova,2016,5,30,-25
HUN,Hungary,MDA,Moldova,2017,0,152,-152
ISL,Iceland,MDA,Moldova,2008,3,1,2
ISL,Iceland,MDA,Moldova,2009,1,0,1
ISL,Iceland,MDA,Moldova,2010,0,1,-1
ISL,Iceland,MDA,Moldova,2011,1,1,0
ISL,Iceland,MDA,Moldova,2012,0,0,0
ISL,Iceland,MDA,Moldova,2013,1,1,0
ISL,Iceland,MDA,Moldova,2014,0,2,-2
ISL,Iceland,MDA,Moldova,2015,1,1,0
ISL,Iceland,MDA,Moldova,2016,0,1,-1
ISL,Iceland,MDA,Moldova,2017,0,6,-6
ITA,Italy,MDA,Moldova,2008,388,22007,-21619
ITA,Italy,MDA,Moldova,2009,463,16812,-16349
ITA,Italy,MDA,Moldova,2010,822,26591,-25769
ITA,Italy,MDA,Moldova,2011,806,14956,-14150
ITA,Italy,MDA,Moldova,2012,1090,8813,-7723
ITA,Italy,MDA,Moldova,2013,1585,8064,-6479
ITA,Italy,MDA,Moldova,2014,1477,3759,-2282
ITA,Italy,MDA,Moldova,2015,1237,2893,-1656
ITA,Italy,MDA,Moldova,2016,0,2339,-2339
ITA,Italy,MDA,Moldova,2017,723,2138,-1415
JPN,Japan,MDA,Moldova,2008,78,72,6
JPN,Japan,MDA,Moldova,2009,58,67,-9
JPN,Japan,MDA,Moldova,2010,6,58,-52
JPN,Japan,MDA,Moldova,2011,59,62,-3
JPN,Japan,MDA,Moldova,2012,56,57,-1
JPN,Japan,MDA,Moldova,2013,51,52,-1
JPN,Japan,MDA,Moldova,2014,31,34,-3
JPN,Japan,MDA,Moldova,2015,40,47,-7
JPN,Japan,MDA,Moldova,2016,65,68,-3
JPN,Japan,MDA,Moldova,2017,29,40,-11
KOR,Korea,MDA,Moldova,2008,45,20,25
KOR,Korea,MDA,Moldova,2009,36,25,11
KOR,Korea,MDA,Moldova,2010,48,39,9
KOR,Korea,MDA,Moldova,2011,33,24,9
KOR,Korea,MDA,Moldova,2012,24,38,-14
KOR,Korea,MDA,Moldova,2013,27,23,4
KOR,Korea,MDA,Moldova,2014,24,48,-24
KOR,Korea,MDA,Moldova,2015,45,25,20
KOR,Korea,MDA,Moldova,2016,39,37,2
KOR,Korea,MDA,Moldova,2017,34,29,5
LUX,Luxembourg,MDA,Moldova,2008,4,8,-4
LUX,Luxembourg,MDA,Moldova,2009,4,9,-5
LUX,Luxembourg,MDA,Moldova,2010,4,9,-5
LUX,Luxembourg,MDA,Moldova,2011,0,6,-6
LUX,Luxembourg,MDA,Moldova,2012,3,10,-7
LUX,Luxembourg,MDA,Moldova,2013,2,8,-6
LUX,Luxembourg,MDA,Moldova,2014,1,11,-10
LUX,Luxembourg,MDA,Moldova,2015,5,7,-2
LUX,Luxembourg,MDA,Moldova,2016,3,9,-6
LUX,Luxembourg,MDA,Moldova,2017,0,19,-19
MEX,Mexico,MDA,Moldova,2009,0,1,-1
MEX,Mexico,MDA,Moldova,2011,0,2,-2
MEX,Mexico,MDA,Moldova,2012,0,2,-2
MEX,Mexico,MDA,Moldova,2013,0,6,-6
MEX,Mexico,MDA,Moldova,2014,0,9,-9
MEX,Mexico,MDA,Moldova,2015,0,6,-6
MEX,Mexico,MDA,Moldova,2016,0,10,-10
MEX,Mexico,MDA,Moldova,2017,0,7,-7
NLD,Netherlands,MDA,Moldova,2008,33,90,-57
NLD,Netherlands,MDA,Moldova,2009,40,66,-26
NLD,Netherlands,MDA,Moldova,2010,43,66,-23
NLD,Netherlands,MDA,Moldova,2011,46,79,-33
NLD,Netherlands,MDA,Moldova,2012,52,75,-23
NLD,Netherlands,MDA,Moldova,2013,47,67,-20
NLD,Netherlands,MDA,Moldova,2014,38,67,-29
NLD,Netherlands,MDA,Moldova,2015,37,50,-13
NLD,Netherlands,MDA,Moldova,2016,35,71,-36
NLD,Netherlands,MDA,Moldova,2017,33,91,-58
NZL,New Zealand,MDA,Moldova,2008,0,2,-2
NZL,New Zealand,MDA,Moldova,2009,1,4,-3
NZL,New Zealand,MDA,Moldova,2010,0,4,-4
NZL,New Zealand,MDA,Moldova,2011,0,1,-1
NZL,New Zealand,MDA,Moldova,2012,1,5,-4
NZL,New Zealand,MDA,Moldova,2013,0,5,-5
NZL,New Zealand,MDA,Moldova,2014,1,24,-23
NZL,New Zealand,MDA,Moldova,2015,2,2,0
NZL,New Zealand,MDA,Moldova,2016,1,3,-2
NZL,New Zealand,MDA,Moldova,2017,0,9,-9
NOR,Norway,MDA,Moldova,2008,10,32,-22
NOR,Norway,MDA,Moldova,2009,9,39,-30
NOR,Norway,MDA,Moldova,2010,13,35,-22
NOR,Norway,MDA,Moldova,2011,12,41,-29
NOR,Norway,MDA,Moldova,2012,9,42,-33
NOR,Norway,MDA,Moldova,2013,11,32,-21
NOR,Norway,MDA,Moldova,2014,7,25,-18
NOR,Norway,MDA,Moldova,2015,12,33,-21
NOR,Norway,MDA,Moldova,2016,14,16,-2
NOR,Norway,MDA,Moldova,2017,3,18,-15
POL,Poland,MDA,Moldova,2008,0,547,-547
POL,Poland,MDA,Moldova,2009,0,468,-468
POL,Poland,MDA,Moldova,2010,0,353,-353
POL,Poland,MDA,Moldova,2011,0,353,-353
POL,Poland,MDA,Moldova,2012,0,404,-404
POL,Poland,MDA,Moldova,2013,0,358,-358
POL,Poland,MDA,Moldova,2014,0,297,-297
POL,Poland,MDA,Moldova,2015,0,510,-510
POL,Poland,MDA,Moldova,2016,0,706,-706
POL,Poland,MDA,Moldova,2017,0,919,-919
PRT,Portugal,MDA,Moldova,2008,0,2438,-2438
PRT,Portugal,MDA,Moldova,2009,0,1533,-1533
PRT,Portugal,MDA,Moldova,2010,0,1152,-1152
PRT,Portugal,MDA,Moldova,2011,0,863,-863
PRT,Portugal,MDA,Moldova,2012,0,473,-473
PRT,Portugal,MDA,Moldova,2013,0,299,-299
PRT,Portugal,MDA,Moldova,2014,0,251,-251
PRT,Portugal,MDA,Moldova,2015,0,235,-235
PRT,Portugal,MDA,Moldova,2016,0,249,-249
PRT,Portugal,MDA,Moldova,2017,0,256,-256
SVK,Slovak Republic,MDA,Moldova,2008,15,1,14
SVK,Slovak Republic,MDA,Moldova,2009,13,1,12
SVK,Slovak Republic,MDA,Moldova,2010,13,3,10
SVK,Slovak Republic,MDA,Moldova,2011,4,1,3
SVK,Slovak Republic,MDA,Moldova,2012,1,1,0
SVK,Slovak Republic,MDA,Moldova,2013,0,4,-4
SVK,Slovak Republic,MDA,Moldova,2014,0,1,-1
SVK,Slovak Republic,MDA,Moldova,2015,0,1,-1
ESP,Spain,MDA,Moldova,2008,874,2299,-1425
ESP,Spain,MDA,Moldova,2009,1111,1282,-171
ESP,Spain,MDA,Moldova,2010,992,879,113
ESP,Spain,MDA,Moldova,2011,983,802,181
ESP,Spain,MDA,Moldova,2012,906,574,332
ESP,Spain,MDA,Moldova,2013,986,486,500
ESP,Spain,MDA,Moldova,2014,506,698,-192
ESP,Spain,MDA,Moldova,2015,365,888,-523
ESP,Spain,MDA,Moldova,2016,447,933,-486
ESP,Spain,MDA,Moldova,2017,546,1027,-481
SWE,Sweden,MDA,Moldova,2008,10,40,-30
SWE,Sweden,MDA,Moldova,2009,2,54,-52
SWE,Sweden,MDA,Moldova,2010,12,39,-27
SWE,Sweden,MDA,Moldova,2011,18,25,-7
SWE,Sweden,MDA,Moldova,2012,4,54,-50
SWE,Sweden,MDA,Moldova,2013,1,45,-44
SWE,Sweden,MDA,Moldova,2014,7,31,-24
SWE,Sweden,MDA,Moldova,2015,25,58,-33
SWE,Sweden,MDA,Moldova,2016,9,43,-34
SWE,Sweden,MDA,Moldova,2017,5,32,-27
CHE,Switzerland,MDA,Moldova,2010,49,113,-64
CHE,Switzerland,MDA,Moldova,2011,34,84,-50
CHE,Switzerland,MDA,Moldova,2012,31,66,-35
CHE,Switzerland,MDA,Moldova,2013,18,80,-62
CHE,Switzerland,MDA,Moldova,2014,23,58,-35
CHE,Switzerland,MDA,Moldova,2015,24,56,-32
CHE,Switzerland,MDA,Moldova,2016,21,64,-43
CHE,Switzerland,MDA,Moldova,2017,16,49,-33
TUR,Turkey,MDA,Moldova,2010,0,575,-575
TUR,Turkey,MDA,Moldova,2016,1406,2388,-982
TUR,Turkey,MDA,Moldova,2017,1496,2517,-1021
GBR,United Kingdom,MDA,Moldova,2014,0,1000,-1000
USA,United States,MDA,Moldova,2008,0,1692,-1692
USA,United States,MDA,Moldova,2009,0,2295,-2295
USA,United States,MDA,Moldova,2010,0,1981,-1981
USA,United States,MDA,Moldova,2011,0,2258,-2258
USA,United States,MDA,Moldova,2012,0,2021,-2021
USA,United States,MDA,Moldova,2013,0,2485,-2485
USA,United States,MDA,Moldova,2014,0,2341,-2341
USA,United States,MDA,Moldova,2015,0,2496,-2496
USA,United States,MDA,Moldova,2016,0,2929,-2929
USA,United States,MDA,Moldova,2017,0,2480,-2480
CHL,Chile,MDA,Moldova,2008,0,1,-1
CHL,Chile,MDA,Moldova,2009,0,1,-1
CHL,Chile,MDA,Moldova,2010,0,3,-3
CHL,Chile,MDA,Moldova,2011,0,5,-5
CHL,Chile,MDA,Moldova,2012,0,5,-5
CHL,Chile,MDA,Moldova,2013,0,3,-3
CHL,Chile,MDA,Moldova,2014,0,1,-1
CHL,Chile,MDA,Moldova,2015,0,4,-4
CHL,Chile,MDA,Moldova,2016,0,2,-2
EST,Estonia,MDA,Moldova,2008,0,14,-14
EST,Estonia,MDA,Moldova,2009,0,12,-12
EST,Estonia,MDA,Moldova,2010,0,4,-4
EST,Estonia,MDA,Moldova,2011,0,13,-13
EST,Estonia,MDA,Moldova,2012,0,8,-8
EST,Estonia,MDA,Moldova,2013,0,10,-10
EST,Estonia,MDA,Moldova,2014,0,3,-3
EST,Estonia,MDA,Moldova,2015,0,9,-9
EST,Estonia,MDA,Moldova,2016,0,17,-17
EST,Estonia,MDA,Moldova,2017,0,19,-19
SVN,Slovenia,MDA,Moldova,2008,0,136,-136
SVN,Slovenia,MDA,Moldova,2009,0,102,-102
SVN,Slovenia,MDA,Moldova,2010,0,68,-68
SVN,Slovenia,MDA,Moldova,2011,10,59,-49
SVN,Slovenia,MDA,Moldova,2012,8,34,-26
SVN,Slovenia,MDA,Moldova,2013,6,24,-18
SVN,Slovenia,MDA,Moldova,2014,1,14,-13
SVN,Slovenia,MDA,Moldova,2015,5,18,-13
SVN,Slovenia,MDA,Moldova,2016,5,16,-11
SVN,Slovenia,MDA,Moldova,2017,6,35,-29
AUS,Australia,MCO,Monaco,2008,0,1,-1
AUS,Australia,MCO,Monaco,2009,0,0,0
AUS,Australia,MCO,Monaco,2010,0,0,0
AUS,Australia,MCO,Monaco,2011,0,0,0
AUS,Australia,MCO,Monaco,2012,0,0,0
AUS,Australia,MCO,Monaco,2013,0,0,0
AUS,Australia,MCO,Monaco,2014,0,0,0
AUS,Australia,MCO,Monaco,2015,0,0,0
AUS,Australia,MCO,Monaco,2017,0,0,0
AUT,Austria,MCO,Monaco,2008,0,4,-4
AUT,Austria,MCO,Monaco,2009,3,5,-2
AUT,Austria,MCO,Monaco,2010,0,0,0
AUT,Austria,MCO,Monaco,2011,0,1,-1
AUT,Austria,MCO,Monaco,2012,0,0,0
AUT,Austria,MCO,Monaco,2013,0,1,-1
AUT,Austria,MCO,Monaco,2014,0,0,0
AUT,Austria,MCO,Monaco,2015,0,0,0
AUT,Austria,MCO,Monaco,2016,0,0,0
AUT,Austria,MCO,Monaco,2017,0,0,0
BEL,Belgium,MCO,Monaco,2008,0,0,0
BEL,Belgium,MCO,Monaco,2009,0,1,-1
BEL,Belgium,MCO,Monaco,2010,1,0,1
BEL,Belgium,MCO,Monaco,2013,1,1,0
BEL,Belgium,MCO,Monaco,2014,2,1,1
BEL,Belgium,MCO,Monaco,2016,0,1,-1
BEL,Belgium,MCO,Monaco,2017,0,2,-2
CAN,Canada,MCO,Monaco,2008,0,0,0
CAN,Canada,MCO,Monaco,2009,0,0,0
CAN,Canada,MCO,Monaco,2010,0,4,-4
CAN,Canada,MCO,Monaco,2011,0,1,-1
CAN,Canada,MCO,Monaco,2012,0,3,-3
CAN,Canada,MCO,Monaco,2013,0,1,-1
CAN,Canada,MCO,Monaco,2014,0,0,0
CAN,Canada,MCO,Monaco,2015,0,0,0
CAN,Canada,MCO,Monaco,2016,0,0,0
CAN,Canada,MCO,Monaco,2017,0,0,0
DNK,Denmark,MCO,Monaco,2013,0,0,0
DNK,Denmark,MCO,Monaco,2014,0,0,0
DNK,Denmark,MCO,Monaco,2015,0,0,0
DNK,Denmark,MCO,Monaco,2016,0,0,0
DNK,Denmark,MCO,Monaco,2017,0,0,0
FIN,Finland,MCO,Monaco,2008,0,0,0
FIN,Finland,MCO,Monaco,2009,0,0,0
FIN,Finland,MCO,Monaco,2010,0,0,0
FIN,Finland,MCO,Monaco,2011,0,0,0
FIN,Finland,MCO,Monaco,2012,0,0,0
FIN,Finland,MCO,Monaco,2013,0,0,0
FIN,Finland,MCO,Monaco,2014,0,0,0
FIN,Finland,MCO,Monaco,2015,0,0,0
FIN,Finland,MCO,Monaco,2016,0,0,0
FIN,Finland,MCO,Monaco,2017,0,0,0
FRA,France,MCO,Monaco,2008,0,0,0
FRA,France,MCO,Monaco,2009,0,1,-1
FRA,France,MCO,Monaco,2010,0,0,0
FRA,France,MCO,Monaco,2011,0,0,0
FRA,France,MCO,Monaco,2012,0,0,0
FRA,France,MCO,Monaco,2013,0,0,0
FRA,France,MCO,Monaco,2014,0,0,0
FRA,France,MCO,Monaco,2015,0,0,0
FRA,France,MCO,Monaco,2016,0,0,0
FRA,France,MCO,Monaco,2017,0,0,0
DEU,Germany,MCO,Monaco,2008,2,8,-6
DEU,Germany,MCO,Monaco,2009,10,1,9
DEU,Germany,MCO,Monaco,2010,0,4,-4
DEU,Germany,MCO,Monaco,2011,2,3,-1
DEU,Germany,MCO,Monaco,2012,1,3,-2
DEU,Germany,MCO,Monaco,2013,1,1,0
DEU,Germany,MCO,Monaco,2014,2,6,-4
DEU,Germany,MCO,Monaco,2015,1,6,-5
DEU,Germany,MCO,Monaco,2016,1,0,1
DEU,Germany,MCO,Monaco,2017,0,3,-3
HUN,Hungary,MCO,Monaco,2008,0,0,0
HUN,Hungary,MCO,Monaco,2009,0,0,0
HUN,Hungary,MCO,Monaco,2010,0,0,0
HUN,Hungary,MCO,Monaco,2011,0,0,0
HUN,Hungary,MCO,Monaco,2012,0,0,0
HUN,Hungary,MCO,Monaco,2013,0,0,0
HUN,Hungary,MCO,Monaco,2014,0,0,0
HUN,Hungary,MCO,Monaco,2015,0,0,0
HUN,Hungary,MCO,Monaco,2016,0,0,0
HUN,Hungary,MCO,Monaco,2017,0,0,0
ISL,Iceland,MCO,Monaco,2008,0,0,0
ISL,Iceland,MCO,Monaco,2009,0,0,0
ISL,Iceland,MCO,Monaco,2010,0,0,0
ISL,Iceland,MCO,Monaco,2011,0,0,0
ISL,Iceland,MCO,Monaco,2012,0,0,0
ISL,Iceland,MCO,Monaco,2014,0,1,-1
ISL,Iceland,MCO,Monaco,2016,0,0,0
ISL,Iceland,MCO,Monaco,2017,0,0,0
ITA,Italy,MCO,Monaco,2008,1,8,-7
ITA,Italy,MCO,Monaco,2009,1,9,-8
ITA,Italy,MCO,Monaco,2010,1,8,-7
ITA,Italy,MCO,Monaco,2011,0,4,-4
ITA,Italy,MCO,Monaco,2012,1,1,0
ITA,Italy,MCO,Monaco,2013,6,7,-1
ITA,Italy,MCO,Monaco,2014,0,2,-2
ITA,Italy,MCO,Monaco,2015,1,2,-1
ITA,Italy,MCO,Monaco,2016,0,1,-1
ITA,Italy,MCO,Monaco,2017,0,8,-8
JPN,Japan,MCO,Monaco,2008,6,6,0
JPN,Japan,MCO,Monaco,2009,4,4,0
JPN,Japan,MCO,Monaco,2010,0,0,0
JPN,Japan,MCO,Monaco,2011,3,4,-1
JPN,Japan,MCO,Monaco,2012,3,4,-1
JPN,Japan,MCO,Monaco,2013,0,0,0
JPN,Japan,MCO,Monaco,2014,0,0,0
JPN,Japan,MCO,Monaco,2015,1,1,0
JPN,Japan,MCO,Monaco,2016,8,8,0
JPN,Japan,MCO,Monaco,2017,3,2,1
KOR,Korea,MCO,Monaco,2008,1,0,1
KOR,Korea,MCO,Monaco,2009,0,0,0
KOR,Korea,MCO,Monaco,2010,0,0,0
KOR,Korea,MCO,Monaco,2011,0,0,0
KOR,Korea,MCO,Monaco,2012,1,2,-1
KOR,Korea,MCO,Monaco,2013,0,0,0
KOR,Korea,MCO,Monaco,2014,0,0,0
KOR,Korea,MCO,Monaco,2015,1,1,0
KOR,Korea,MCO,Monaco,2016,0,0,0
KOR,Korea,MCO,Monaco,2017,0,0,0
LUX,Luxembourg,MCO,Monaco,2008,0,0,0
LUX,Luxembourg,MCO,Monaco,2009,0,1,-1
LUX,Luxembourg,MCO,Monaco,2010,1,0,1
LUX,Luxembourg,MCO,Monaco,2011,0,0,0
LUX,Luxembourg,MCO,Monaco,2012,0,0,0
LUX,Luxembourg,MCO,Monaco,2013,0,1,-1
LUX,Luxembourg,MCO,Monaco,2014,0,0,0
LUX,Luxembourg,MCO,Monaco,2015,0,0,0
LUX,Luxembourg,MCO,Monaco,2016,0,0,0
LUX,Luxembourg,MCO,Monaco,2017,0,0,0
MEX,Mexico,MCO,Monaco,2012,0,0,0
MEX,Mexico,MCO,Monaco,2013,0,0,0
MEX,Mexico,MCO,Monaco,2014,0,0,0
NLD,Netherlands,MCO,Monaco,2010,0,1,-1
NLD,Netherlands,MCO,Monaco,2011,1,3,-2
NLD,Netherlands,MCO,Monaco,2013,1,0,1
NLD,Netherlands,MCO,Monaco,2014,0,1,-1
NLD,Netherlands,MCO,Monaco,2017,2,0,2
NZL,New Zealand,MCO,Monaco,2013,0,1,-1
NZL,New Zealand,MCO,Monaco,2015,0,1,-1
NZL,New Zealand,MCO,Monaco,2017,0,2,-2
NOR,Norway,MCO,Monaco,2008,0,3,-3
NOR,Norway,MCO,Monaco,2009,1,1,0
NOR,Norway,MCO,Monaco,2010,0,0,0
NOR,Norway,MCO,Monaco,2011,0,2,-2
NOR,Norway,MCO,Monaco,2012,0,0,0
NOR,Norway,MCO,Monaco,2013,0,1,-1
NOR,Norway,MCO,Monaco,2014,0,0,0
NOR,Norway,MCO,Monaco,2015,0,0,0
NOR,Norway,MCO,Monaco,2016,0,0,0
NOR,Norway,MCO,Monaco,2017,0,0,0
POL,Poland,MCO,Monaco,2009,0,0,0
POL,Poland,MCO,Monaco,2010,0,0,0
POL,Poland,MCO,Monaco,2011,0,0,0
POL,Poland,MCO,Monaco,2012,0,0,0
POL,Poland,MCO,Monaco,2013,0,0,0
POL,Poland,MCO,Monaco,2014,0,0,0
POL,Poland,MCO,Monaco,2015,0,0,0
POL,Poland,MCO,Monaco,2016,0,0,0
POL,Poland,MCO,Monaco,2017,0,0,0
SVK,Slovak Republic,MCO,Monaco,2008,0,0,0
SVK,Slovak Republic,MCO,Monaco,2011,0,1,-1
ESP,Spain,MCO,Monaco,2008,0,0,0
ESP,Spain,MCO,Monaco,2009,0,2,-2
ESP,Spain,MCO,Monaco,2010,0,2,-2
ESP,Spain,MCO,Monaco,2011,0,3,-3
ESP,Spain,MCO,Monaco,2012,0,1,-1
ESP,Spain,MCO,Monaco,2013,1,0,1
ESP,Spain,MCO,Monaco,2014,0,2,-2
ESP,Spain,MCO,Monaco,2015,0,2,-2
ESP,Spain,MCO,Monaco,2016,0,0,0
SWE,Sweden,MCO,Monaco,2008,0,0,0
SWE,Sweden,MCO,Monaco,2009,0,0,0
SWE,Sweden,MCO,Monaco,2010,0,1,-1
SWE,Sweden,MCO,Monaco,2011,0,1,-1
SWE,Sweden,MCO,Monaco,2012,0,0,0
SWE,Sweden,MCO,Monaco,2013,0,1,-1
SWE,Sweden,MCO,Monaco,2014,0,0,0
SWE,Sweden,MCO,Monaco,2015,0,1,-1
SWE,Sweden,MCO,Monaco,2016,0,0,0
SWE,Sweden,MCO,Monaco,2017,0,0,0
CHE,Switzerland,MCO,Monaco,2010,3,1,2
CHE,Switzerland,MCO,Monaco,2011,2,12,-10
CHE,Switzerland,MCO,Monaco,2012,2,4,-2
CHE,Switzerland,MCO,Monaco,2013,0,3,-3
CHE,Switzerland,MCO,Monaco,2014,2,1,1
CHE,Switzerland,MCO,Monaco,2015,4,3,1
CHE,Switzerland,MCO,Monaco,2016,4,2,2
CHE,Switzerland,MCO,Monaco,2017,1,2,-1
USA,United States,MCO,Monaco,2008,0,7,-7
USA,United States,MCO,Monaco,2009,0,4,-4
USA,United States,MCO,Monaco,2010,0,12,-12
USA,United States,MCO,Monaco,2011,0,6,-6
USA,United States,MCO,Monaco,2012,0,5,-5
USA,United States,MCO,Monaco,2013,0,8,-8
USA,United States,MCO,Monaco,2014,0,8,-8
USA,United States,MCO,Monaco,2015,0,10,-10
USA,United States,MCO,Monaco,2016,0,11,-11
USA,United States,MCO,Monaco,2017,0,14,-14
CHL,Chile,MCO,Monaco,2008,0,0,0
CHL,Chile,MCO,Monaco,2009,0,0,0
CHL,Chile,MCO,Monaco,2010,0,0,0
CHL,Chile,MCO,Monaco,2011,0,0,0
CHL,Chile,MCO,Monaco,2012,0,0,0
CHL,Chile,MCO,Monaco,2013,0,0,0
CHL,Chile,MCO,Monaco,2014,0,0,0
CHL,Chile,MCO,Monaco,2015,0,0,0
CHL,Chile,MCO,Monaco,2016,0,0,0
EST,Estonia,MCO,Monaco,2008,0,0,0
EST,Estonia,MCO,Monaco,2009,0,0,0
EST,Estonia,MCO,Monaco,2010,0,0,0
EST,Estonia,MCO,Monaco,2011,0,0,0
EST,Estonia,MCO,Monaco,2012,0,0,0
EST,Estonia,MCO,Monaco,2013,0,0,0
EST,Estonia,MCO,Monaco,2014,0,0,0
EST,Estonia,MCO,Monaco,2015,0,0,0
EST,Estonia,MCO,Monaco,2016,0,0,0
EST,Estonia,MCO,Monaco,2017,0,0,0
AUS,Australia,MNG,Mongolia,2008,0,38,-38
AUS,Australia,MNG,Mongolia,2009,0,55,-55
AUS,Australia,MNG,Mongolia,2010,0,45,-45
AUS,Australia,MNG,Mongolia,2011,0,39,-39
AUS,Australia,MNG,Mongolia,2012,0,58,-58
AUS,Australia,MNG,Mongolia,2013,5,44,-39
AUS,Australia,MNG,Mongolia,2014,6,47,-41
AUS,Australia,MNG,Mongolia,2015,0,18,-18
AUS,Australia,MNG,Mongolia,2016,0,44,-44
AUS,Australia,MNG,Mongolia,2017,0,42,-42
AUT,Austria,MNG,Mongolia,2008,203,281,-78
AUT,Austria,MNG,Mongolia,2009,230,361,-131
AUT,Austria,MNG,Mongolia,2010,336,226,110
AUT,Austria,MNG,Mongolia,2011,286,317,-31
AUT,Austria,MNG,Mongolia,2012,213,343,-130
AUT,Austria,MNG,Mongolia,2013,201,309,-108
AUT,Austria,MNG,Mongolia,2014,160,330,-170
AUT,Austria,MNG,Mongolia,2015,184,436,-252
AUT,Austria,MNG,Mongolia,2016,195,256,-61
AUT,Austria,MNG,Mongolia,2017,192,193,-1
BEL,Belgium,MNG,Mongolia,2008,0,36,-36
BEL,Belgium,MNG,Mongolia,2009,0,45,-45
BEL,Belgium,MNG,Mongolia,2010,2,65,-63
BEL,Belgium,MNG,Mongolia,2012,44,92,-48
BEL,Belgium,MNG,Mongolia,2013,83,52,31
BEL,Belgium,MNG,Mongolia,2014,106,42,64
BEL,Belgium,MNG,Mongolia,2015,58,62,-4
BEL,Belgium,MNG,Mongolia,2016,29,30,-1
BEL,Belgium,MNG,Mongolia,2017,22,34,-12
CAN,Canada,MNG,Mongolia,2008,0,59,-59
CAN,Canada,MNG,Mongolia,2009,0,118,-118
CAN,Canada,MNG,Mongolia,2010,0,169,-169
CAN,Canada,MNG,Mongolia,2011,0,103,-103
CAN,Canada,MNG,Mongolia,2012,0,68,-68
CAN,Canada,MNG,Mongolia,2013,0,99,-99
CAN,Canada,MNG,Mongolia,2014,0,93,-93
CAN,Canada,MNG,Mongolia,2015,0,45,-45
CAN,Canada,MNG,Mongolia,2016,0,95,-95
CAN,Canada,MNG,Mongolia,2017,0,85,-85
CZE,Czech Republic,MNG,Mongolia,2008,3,3500,-3497
CZE,Czech Republic,MNG,Mongolia,2009,2,513,-511
CZE,Czech Republic,MNG,Mongolia,2010,0,327,-327
CZE,Czech Republic,MNG,Mongolia,2011,9,159,-150
CZE,Czech Republic,MNG,Mongolia,2012,169,345,-176
CZE,Czech Republic,MNG,Mongolia,2013,269,148,121
CZE,Czech Republic,MNG,Mongolia,2014,137,227,-90
CZE,Czech Republic,MNG,Mongolia,2015,135,558,-423
CZE,Czech Republic,MNG,Mongolia,2016,187,709,-522
CZE,Czech Republic,MNG,Mongolia,2017,210,1165,-955
DNK,Denmark,MNG,Mongolia,2008,14,13,1
DNK,Denmark,MNG,Mongolia,2009,8,13,-5
DNK,Denmark,MNG,Mongolia,2010,6,5,1
DNK,Denmark,MNG,Mongolia,2011,12,7,5
DNK,Denmark,MNG,Mongolia,2012,4,8,-4
DNK,Denmark,MNG,Mongolia,2013,3,8,-5
DNK,Denmark,MNG,Mongolia,2014,7,2,5
DNK,Denmark,MNG,Mongolia,2015,8,5,3
DNK,Denmark,MNG,Mongolia,2016,5,1,4
DNK,Denmark,MNG,Mongolia,2017,3,4,-1
FIN,Finland,MNG,Mongolia,2008,0,3,-3
FIN,Finland,MNG,Mongolia,2009,0,1,-1
FIN,Finland,MNG,Mongolia,2010,0,4,-4
FIN,Finland,MNG,Mongolia,2011,0,4,-4
FIN,Finland,MNG,Mongolia,2012,5,2,3
FIN,Finland,MNG,Mongolia,2013,0,1,-1
FIN,Finland,MNG,Mongolia,2014,0,5,-5
FIN,Finland,MNG,Mongolia,2015,1,0,1
FIN,Finland,MNG,Mongolia,2016,0,4,-4
FIN,Finland,MNG,Mongolia,2017,0,3,-3
FRA,France,MNG,Mongolia,2008,0,96,-96
FRA,France,MNG,Mongolia,2009,0,101,-101
FRA,France,MNG,Mongolia,2010,0,108,-108
FRA,France,MNG,Mongolia,2011,0,105,-105
FRA,France,MNG,Mongolia,2012,0,148,-148
FRA,France,MNG,Mongolia,2013,0,159,-159
FRA,France,MNG,Mongolia,2014,0,181,-181
FRA,France,MNG,Mongolia,2015,0,224,-224
FRA,France,MNG,Mongolia,2016,0,217,-217
FRA,France,MNG,Mongolia,2017,0,252,-252
DEU,Germany,MNG,Mongolia,2008,692,399,293
DEU,Germany,MNG,Mongolia,2009,821,393,428
DEU,Germany,MNG,Mongolia,2010,644,492,152
DEU,Germany,MNG,Mongolia,2011,431,531,-100
DEU,Germany,MNG,Mongolia,2012,441,485,-44
DEU,Germany,MNG,Mongolia,2013,425,598,-173
DEU,Germany,MNG,Mongolia,2014,544,952,-408
DEU,Germany,MNG,Mongolia,2015,642,1298,-656
DEU,Germany,MNG,Mongolia,2016,811,779,32
DEU,Germany,MNG,Mongolia,2017,603,818,-215
HUN,Hungary,MNG,Mongolia,2008,50,270,-220
HUN,Hungary,MNG,Mongolia,2009,40,118,-78
HUN,Hungary,MNG,Mongolia,2010,95,96,-1
HUN,Hungary,MNG,Mongolia,2011,33,84,-51
HUN,Hungary,MNG,Mongolia,2012,84,72,12
HUN,Hungary,MNG,Mongolia,2013,66,65,1
HUN,Hungary,MNG,Mongolia,2014,38,63,-25
HUN,Hungary,MNG,Mongolia,2015,24,98,-74
HUN,Hungary,MNG,Mongolia,2016,37,169,-132
HUN,Hungary,MNG,Mongolia,2017,32,271,-239
ISL,Iceland,MNG,Mongolia,2008,5,6,-1
ISL,Iceland,MNG,Mongolia,2009,6,3,3
ISL,Iceland,MNG,Mongolia,2010,6,4,2
ISL,Iceland,MNG,Mongolia,2011,2,3,-1
ISL,Iceland,MNG,Mongolia,2012,2,4,-2
ISL,Iceland,MNG,Mongolia,2013,7,1,6
ISL,Iceland,MNG,Mongolia,2014,3,2,1
ISL,Iceland,MNG,Mongolia,2015,4,3,1
ISL,Iceland,MNG,Mongolia,2016,4,3,1
ISL,Iceland,MNG,Mongolia,2017,3,3,0
ITA,Italy,MNG,Mongolia,2008,0,28,-28
ITA,Italy,MNG,Mongolia,2009,0,15,-15
ITA,Italy,MNG,Mongolia,2010,1,29,-28
ITA,Italy,MNG,Mongolia,2011,0,31,-31
ITA,Italy,MNG,Mongolia,2012,1,17,-16
ITA,Italy,MNG,Mongolia,2013,5,21,-16
ITA,Italy,MNG,Mongolia,2014,4,8,-4
ITA,Italy,MNG,Mongolia,2015,1,15,-14
ITA,Italy,MNG,Mongolia,2016,0,14,-14
ITA,Italy,MNG,Mongolia,2017,4,14,-10
JPN,Japan,MNG,Mongolia,2008,752,1326,-574
JPN,Japan,MNG,Mongolia,2009,861,1163,-302
JPN,Japan,MNG,Mongolia,2010,929,1182,-253
JPN,Japan,MNG,Mongolia,2011,1071,1278,-207
JPN,Japan,MNG,Mongolia,2012,991,1514,-523
JPN,Japan,MNG,Mongolia,2013,900,1546,-646
JPN,Japan,MNG,Mongolia,2014,1096,1966,-870
JPN,Japan,MNG,Mongolia,2015,1264,2336,-1072
JPN,Japan,MNG,Mongolia,2016,1211,2507,-1296
JPN,Japan,MNG,Mongolia,2017,1484,3187,-1703
KOR,Korea,MNG,Mongolia,2008,8517,8065,452
KOR,Korea,MNG,Mongolia,2009,7845,5276,2569
KOR,Korea,MNG,Mongolia,2010,6733,5430,1303
KOR,Korea,MNG,Mongolia,2011,7212,4268,2944
KOR,Korea,MNG,Mongolia,2012,8931,5676,3255
KOR,Korea,MNG,Mongolia,2013,7090,4331,2759
KOR,Korea,MNG,Mongolia,2014,5297,3966,1331
KOR,Korea,MNG,Mongolia,2015,4582,8286,-3704
KOR,Korea,MNG,Mongolia,2016,5324,8155,-2831
KOR,Korea,MNG,Mongolia,2017,6088,11781,-5693
LUX,Luxembourg,MNG,Mongolia,2008,1,3,-2
LUX,Luxembourg,MNG,Mongolia,2009,2,3,-1
LUX,Luxembourg,MNG,Mongolia,2010,0,5,-5
LUX,Luxembourg,MNG,Mongolia,2011,1,3,-2
LUX,Luxembourg,MNG,Mongolia,2012,3,3,0
LUX,Luxembourg,MNG,Mongolia,2013,0,4,-4
LUX,Luxembourg,MNG,Mongolia,2014,3,8,-5
LUX,Luxembourg,MNG,Mongolia,2015,3,8,-5
LUX,Luxembourg,MNG,Mongolia,2016,1,10,-9
LUX,Luxembourg,MNG,Mongolia,2017,5,5,0
MEX,Mexico,MNG,Mongolia,2009,0,4,-4
MEX,Mexico,MNG,Mongolia,2011,0,1,-1
MEX,Mexico,MNG,Mongolia,2012,0,0,0
MEX,Mexico,MNG,Mongolia,2013,0,4,-4
MEX,Mexico,MNG,Mongolia,2014,0,2,-2
MEX,Mexico,MNG,Mongolia,2015,0,1,-1
MEX,Mexico,MNG,Mongolia,2016,0,3,-3
MEX,Mexico,MNG,Mongolia,2017,0,1,-1
NLD,Netherlands,MNG,Mongolia,2008,14,35,-21
NLD,Netherlands,MNG,Mongolia,2009,21,32,-11
NLD,Netherlands,MNG,Mongolia,2010,11,26,-15
NLD,Netherlands,MNG,Mongolia,2011,26,25,1
NLD,Netherlands,MNG,Mongolia,2012,17,28,-11
NLD,Netherlands,MNG,Mongolia,2013,14,16,-2
NLD,Netherlands,MNG,Mongolia,2014,21,28,-7
NLD,Netherlands,MNG,Mongolia,2015,12,55,-43
NLD,Netherlands,MNG,Mongolia,2016,20,57,-37
NLD,Netherlands,MNG,Mongolia,2017,29,40,-11
NZL,New Zealand,MNG,Mongolia,2008,3,14,-11
NZL,New Zealand,MNG,Mongolia,2009,13,14,-1
NZL,New Zealand,MNG,Mongolia,2010,4,11,-7
NZL,New Zealand,MNG,Mongolia,2011,15,7,8
NZL,New Zealand,MNG,Mongolia,2012,4,10,-6
NZL,New Zealand,MNG,Mongolia,2013,9,10,-1
NZL,New Zealand,MNG,Mongolia,2014,10,9,1
NZL,New Zealand,MNG,Mongolia,2015,12,11,1
NZL,New Zealand,MNG,Mongolia,2016,13,12,1
NZL,New Zealand,MNG,Mongolia,2017,3,18,-15
NOR,Norway,MNG,Mongolia,2008,3,10,-7
NOR,Norway,MNG,Mongolia,2009,7,14,-7
NOR,Norway,MNG,Mongolia,2010,4,7,-3
NOR,Norway,MNG,Mongolia,2011,4,12,-8
NOR,Norway,MNG,Mongolia,2012,4,12,-8
NOR,Norway,MNG,Mongolia,2013,6,16,-10
NOR,Norway,MNG,Mongolia,2014,4,11,-7
NOR,Norway,MNG,Mongolia,2015,9,11,-2
NOR,Norway,MNG,Mongolia,2016,5,12,-7
NOR,Norway,MNG,Mongolia,2017,11,14,-3
POL,Poland,MNG,Mongolia,2008,0,401,-401
POL,Poland,MNG,Mongolia,2009,0,418,-418
POL,Poland,MNG,Mongolia,2010,0,355,-355
POL,Poland,MNG,Mongolia,2011,0,308,-308
POL,Poland,MNG,Mongolia,2012,0,292,-292
POL,Poland,MNG,Mongolia,2013,0,270,-270
POL,Poland,MNG,Mongolia,2014,0,148,-148
POL,Poland,MNG,Mongolia,2015,0,233,-233
POL,Poland,MNG,Mongolia,2016,0,181,-181
POL,Poland,MNG,Mongolia,2017,0,120,-120
SVK,Slovak Republic,MNG,Mongolia,2008,3,10,-7
SVK,Slovak Republic,MNG,Mongolia,2009,3,13,-10
SVK,Slovak Republic,MNG,Mongolia,2010,5,1,4
SVK,Slovak Republic,MNG,Mongolia,2011,3,1,2
SVK,Slovak Republic,MNG,Mongolia,2012,0,4,-4
SVK,Slovak Republic,MNG,Mongolia,2016,0,1,-1
SVK,Slovak Republic,MNG,Mongolia,2017,0,1,-1
ESP,Spain,MNG,Mongolia,2008,15,72,-57
ESP,Spain,MNG,Mongolia,2009,26,111,-85
ESP,Spain,MNG,Mongolia,2010,43,111,-68
ESP,Spain,MNG,Mongolia,2011,57,101,-44
ESP,Spain,MNG,Mongolia,2012,65,54,11
ESP,Spain,MNG,Mongolia,2013,102,56,46
ESP,Spain,MNG,Mongolia,2014,46,65,-19
ESP,Spain,MNG,Mongolia,2015,46,81,-35
ESP,Spain,MNG,Mongolia,2016,44,82,-38
ESP,Spain,MNG,Mongolia,2017,48,97,-49
SWE,Sweden,MNG,Mongolia,2008,6,95,-89
SWE,Sweden,MNG,Mongolia,2009,9,153,-144
SWE,Sweden,MNG,Mongolia,2010,4,351,-347
SWE,Sweden,MNG,Mongolia,2011,9,562,-553
SWE,Sweden,MNG,Mongolia,2012,18,481,-463
SWE,Sweden,MNG,Mongolia,2013,36,357,-321
SWE,Sweden,MNG,Mongolia,2014,82,383,-301
SWE,Sweden,MNG,Mongolia,2015,68,342,-274
SWE,Sweden,MNG,Mongolia,2016,36,320,-284
SWE,Sweden,MNG,Mongolia,2017,20,564,-544
CHE,Switzerland,MNG,Mongolia,2010,18,86,-68
CHE,Switzerland,MNG,Mongolia,2011,19,54,-35
CHE,Switzerland,MNG,Mongolia,2012,17,73,-56
CHE,Switzerland,MNG,Mongolia,2013,36,73,-37
CHE,Switzerland,MNG,Mongolia,2014,34,81,-47
CHE,Switzerland,MNG,Mongolia,2015,21,74,-53
CHE,Switzerland,MNG,Mongolia,2016,21,76,-55
CHE,Switzerland,MNG,Mongolia,2017,23,130,-107
TUR,Turkey,MNG,Mongolia,2010,0,171,-171
TUR,Turkey,MNG,Mongolia,2016,275,358,-83
TUR,Turkey,MNG,Mongolia,2017,346,546,-200
USA,United States,MNG,Mongolia,2008,0,659,-659
USA,United States,MNG,Mongolia,2009,0,831,-831
USA,United States,MNG,Mongolia,2010,0,594,-594
USA,United States,MNG,Mongolia,2011,0,774,-774
USA,United States,MNG,Mongolia,2012,0,691,-691
USA,United States,MNG,Mongolia,2013,0,729,-729
USA,United States,MNG,Mongolia,2014,0,651,-651
USA,United States,MNG,Mongolia,2015,0,644,-644
USA,United States,MNG,Mongolia,2016,0,750,-750
USA,United States,MNG,Mongolia,2017,0,661,-661
CHL,Chile,MNG,Mongolia,2008,0,0,0
CHL,Chile,MNG,Mongolia,2009,0,0,0
CHL,Chile,MNG,Mongolia,2010,0,0,0
CHL,Chile,MNG,Mongolia,2011,0,0,0
CHL,Chile,MNG,Mongolia,2012,0,0,0
CHL,Chile,MNG,Mongolia,2013,0,0,0
CHL,Chile,MNG,Mongolia,2014,0,0,0
CHL,Chile,MNG,Mongolia,2015,0,0,0
CHL,Chile,MNG,Mongolia,2016,0,1,-1
EST,Estonia,MNG,Mongolia,2008,0,0,0
EST,Estonia,MNG,Mongolia,2009,0,0,0
EST,Estonia,MNG,Mongolia,2010,0,0,0
EST,Estonia,MNG,Mongolia,2011,0,0,0
EST,Estonia,MNG,Mongolia,2012,0,0,0
EST,Estonia,MNG,Mongolia,2013,0,0,0
EST,Estonia,MNG,Mongolia,2014,0,1,-1
EST,Estonia,MNG,Mongolia,2015,0,1,-1
EST,Estonia,MNG,Mongolia,2016,0,0,0
EST,Estonia,MNG,Mongolia,2017,0,0,0
AUS,Australia,MNE,Montenegro,2008,10,10,0
AUS,Australia,MNE,Montenegro,2009,11,8,3
AUS,Australia,MNE,Montenegro,2010,13,7,6
AUS,Australia,MNE,Montenegro,2011,6,11,-5
AUS,Australia,MNE,Montenegro,2012,8,14,-6
AUS,Australia,MNE,Montenegro,2013,0,11,-11
AUS,Australia,MNE,Montenegro,2014,6,18,-12
AUS,Australia,MNE,Montenegro,2015,0,17,-17
AUS,Australia,MNE,Montenegro,2016,0,13,-13
AUS,Australia,MNE,Montenegro,2017,0,8,-8
AUT,Austria,MNE,Montenegro,2008,37,63,-26
AUT,Austria,MNE,Montenegro,2009,57,54,3
AUT,Austria,MNE,Montenegro,2010,64,76,-12
AUT,Austria,MNE,Montenegro,2011,59,94,-35
AUT,Austria,MNE,Montenegro,2012,80,118,-38
AUT,Austria,MNE,Montenegro,2013,64,144,-80
AUT,Austria,MNE,Montenegro,2014,63,155,-92
AUT,Austria,MNE,Montenegro,2015,82,158,-76
AUT,Austria,MNE,Montenegro,2016,106,148,-42
AUT,Austria,MNE,Montenegro,2017,97,130,-33
BEL,Belgium,MNE,Montenegro,2008,0,17,-17
BEL,Belgium,MNE,Montenegro,2009,0,17,-17
BEL,Belgium,MNE,Montenegro,2010,7,50,-43
BEL,Belgium,MNE,Montenegro,2012,67,126,-59
BEL,Belgium,MNE,Montenegro,2013,50,18,32
BEL,Belgium,MNE,Montenegro,2014,33,40,-7
BEL,Belgium,MNE,Montenegro,2015,25,34,-9
BEL,Belgium,MNE,Montenegro,2016,15,36,-21
BEL,Belgium,MNE,Montenegro,2017,5,35,-30
CAN,Canada,MNE,Montenegro,2008,0,15,-15
CAN,Canada,MNE,Montenegro,2009,0,8,-8
CAN,Canada,MNE,Montenegro,2010,0,13,-13
CAN,Canada,MNE,Montenegro,2011,0,18,-18
CAN,Canada,MNE,Montenegro,2012,0,24,-24
CAN,Canada,MNE,Montenegro,2013,0,9,-9
CAN,Canada,MNE,Montenegro,2014,0,7,-7
CAN,Canada,MNE,Montenegro,2015,0,23,-23
CAN,Canada,MNE,Montenegro,2016,0,25,-25
CAN,Canada,MNE,Montenegro,2017,0,10,-10
CZE,Czech Republic,MNE,Montenegro,2008,0,7,-7
CZE,Czech Republic,MNE,Montenegro,2009,0,10,-10
CZE,Czech Republic,MNE,Montenegro,2010,0,7,-7
CZE,Czech Republic,MNE,Montenegro,2011,1,4,-3
CZE,Czech Republic,MNE,Montenegro,2012,3,8,-5
CZE,Czech Republic,MNE,Montenegro,2013,7,11,-4
CZE,Czech Republic,MNE,Montenegro,2014,11,12,-1
CZE,Czech Republic,MNE,Montenegro,2015,7,17,-10
CZE,Czech Republic,MNE,Montenegro,2016,7,19,-12
CZE,Czech Republic,MNE,Montenegro,2017,11,14,-3
DNK,Denmark,MNE,Montenegro,2008,1,10,-9
DNK,Denmark,MNE,Montenegro,2009,2,15,-13
DNK,Denmark,MNE,Montenegro,2010,1,13,-12
DNK,Denmark,MNE,Montenegro,2011,2,4,-2
DNK,Denmark,MNE,Montenegro,2012,2,13,-11
DNK,Denmark,MNE,Montenegro,2013,6,6,0
DNK,Denmark,MNE,Montenegro,2014,0,15,-15
DNK,Denmark,MNE,Montenegro,2015,6,13,-7
DNK,Denmark,MNE,Montenegro,2016,3,12,-9
DNK,Denmark,MNE,Montenegro,2017,7,15,-8
FIN,Finland,MNE,Montenegro,2008,0,5,-5
FIN,Finland,MNE,Montenegro,2009,0,2,-2
FIN,Finland,MNE,Montenegro,2010,0,1,-1
FIN,Finland,MNE,Montenegro,2011,0,0,0
FIN,Finland,MNE,Montenegro,2012,0,2,-2
FIN,Finland,MNE,Montenegro,2013,0,0,0
FIN,Finland,MNE,Montenegro,2014,0,0,0
FIN,Finland,MNE,Montenegro,2015,0,2,-2
FIN,Finland,MNE,Montenegro,2016,0,14,-14
FIN,Finland,MNE,Montenegro,2017,0,2,-2
FRA,France,MNE,Montenegro,2008,0,26,-26
FRA,France,MNE,Montenegro,2009,0,29,-29
FRA,France,MNE,Montenegro,2010,0,36,-36
FRA,France,MNE,Montenegro,2011,0,42,-42
FRA,France,MNE,Montenegro,2012,0,70,-70
FRA,France,MNE,Montenegro,2013,0,114,-114
FRA,France,MNE,Montenegro,2014,0,119,-119
FRA,France,MNE,Montenegro,2015,0,106,-106
FRA,France,MNE,Montenegro,2016,0,120,-120
FRA,France,MNE,Montenegro,2017,0,123,-123
DEU,Germany,MNE,Montenegro,2008,217,370,-153
DEU,Germany,MNE,Montenegro,2009,276,422,-146
DEU,Germany,MNE,Montenegro,2010,441,640,-199
DEU,Germany,MNE,Montenegro,2011,417,655,-238
DEU,Germany,MNE,Montenegro,2012,564,988,-424
DEU,Germany,MNE,Montenegro,2013,692,999,-307
DEU,Germany,MNE,Montenegro,2014,799,2367,-1568
DEU,Germany,MNE,Montenegro,2015,1921,5194,-3273
DEU,Germany,MNE,Montenegro,2016,4005,1990,2015
DEU,Germany,MNE,Montenegro,2017,1825,2230,-405
HUN,Hungary,MNE,Montenegro,2008,1,8,-7
HUN,Hungary,MNE,Montenegro,2009,1,14,-13
HUN,Hungary,MNE,Montenegro,2010,5,12,-7
HUN,Hungary,MNE,Montenegro,2011,4,24,-20
HUN,Hungary,MNE,Montenegro,2012,12,19,-7
HUN,Hungary,MNE,Montenegro,2013,7,34,-27
HUN,Hungary,MNE,Montenegro,2014,3,25,-22
HUN,Hungary,MNE,Montenegro,2015,8,49,-41
HUN,Hungary,MNE,Montenegro,2016,7,26,-19
HUN,Hungary,MNE,Montenegro,2017,0,45,-45
ISL,Iceland,MNE,Montenegro,2008,0,0,0
ISL,Iceland,MNE,Montenegro,2009,0,0,0
ISL,Iceland,MNE,Montenegro,2010,0,0,0
ISL,Iceland,MNE,Montenegro,2011,0,1,-1
ISL,Iceland,MNE,Montenegro,2012,0,0,0
ISL,Iceland,MNE,Montenegro,2013,1,0,1
ISL,Iceland,MNE,Montenegro,2014,0,2,-2
ISL,Iceland,MNE,Montenegro,2015,2,4,-2
ISL,Iceland,MNE,Montenegro,2016,2,0,2
ISL,Iceland,MNE,Montenegro,2017,2,4,-2
ITA,Italy,MNE,Montenegro,2008,9,56,-47
ITA,Italy,MNE,Montenegro,2009,12,44,-32
ITA,Italy,MNE,Montenegro,2010,1,65,-64
ITA,Italy,MNE,Montenegro,2011,8,87,-79
ITA,Italy,MNE,Montenegro,2012,10,60,-50
ITA,Italy,MNE,Montenegro,2013,18,84,-66
ITA,Italy,MNE,Montenegro,2014,59,98,-39
ITA,Italy,MNE,Montenegro,2015,24,95,-71
ITA,Italy,MNE,Montenegro,2016,0,70,-70
ITA,Italy,MNE,Montenegro,2017,14,74,-60
JPN,Japan,MNE,Montenegro,2008,1,4,-3
JPN,Japan,MNE,Montenegro,2009,7,9,-2
JPN,Japan,MNE,Montenegro,2010,20,21,-1
JPN,Japan,MNE,Montenegro,2011,3,5,-2
JPN,Japan,MNE,Montenegro,2012,17,17,0
JPN,Japan,MNE,Montenegro,2013,16,19,-3
JPN,Japan,MNE,Montenegro,2014,22,19,3
JPN,Japan,MNE,Montenegro,2015,20,22,-2
JPN,Japan,MNE,Montenegro,2016,20,19,1
JPN,Japan,MNE,Montenegro,2017,8,10,-2
KOR,Korea,MNE,Montenegro,2008,0,0,0
KOR,Korea,MNE,Montenegro,2009,0,2,-2
KOR,Korea,MNE,Montenegro,2010,0,2,-2
KOR,Korea,MNE,Montenegro,2011,5,4,1
KOR,Korea,MNE,Montenegro,2012,0,3,-3
KOR,Korea,MNE,Montenegro,2013,6,1,5
KOR,Korea,MNE,Montenegro,2014,3,4,-1
KOR,Korea,MNE,Montenegro,2015,2,3,-1
KOR,Korea,MNE,Montenegro,2016,2,4,-2
KOR,Korea,MNE,Montenegro,2017,4,5,-1
LUX,Luxembourg,MNE,Montenegro,2008,9,40,-31
LUX,Luxembourg,MNE,Montenegro,2009,12,55,-43
LUX,Luxembourg,MNE,Montenegro,2010,14,57,-43
LUX,Luxembourg,MNE,Montenegro,2011,19,152,-133
LUX,Luxembourg,MNE,Montenegro,2012,62,257,-195
LUX,Luxembourg,MNE,Montenegro,2013,91,182,-91
LUX,Luxembourg,MNE,Montenegro,2014,100,208,-108
LUX,Luxembourg,MNE,Montenegro,2015,155,156,-1
LUX,Luxembourg,MNE,Montenegro,2016,48,165,-117
LUX,Luxembourg,MNE,Montenegro,2017,39,120,-81
MEX,Mexico,MNE,Montenegro,2010,0,2,-2
MEX,Mexico,MNE,Montenegro,2012,0,0,0
MEX,Mexico,MNE,Montenegro,2013,0,1,-1
MEX,Mexico,MNE,Montenegro,2014,0,1,-1
MEX,Mexico,MNE,Montenegro,2015,0,2,-2
MEX,Mexico,MNE,Montenegro,2017,0,2,-2
NLD,Netherlands,MNE,Montenegro,2008,1,0,1
NLD,Netherlands,MNE,Montenegro,2010,11,24,-13
NLD,Netherlands,MNE,Montenegro,2011,10,19,-9
NLD,Netherlands,MNE,Montenegro,2012,10,29,-19
NLD,Netherlands,MNE,Montenegro,2013,18,28,-10
NLD,Netherlands,MNE,Montenegro,2014,11,23,-12
NLD,Netherlands,MNE,Montenegro,2015,11,21,-10
NLD,Netherlands,MNE,Montenegro,2016,8,24,-16
NLD,Netherlands,MNE,Montenegro,2017,10,21,-11
NZL,New Zealand,MNE,Montenegro,2010,0,1,-1
NZL,New Zealand,MNE,Montenegro,2011,0,1,-1
NZL,New Zealand,MNE,Montenegro,2012,0,0,0
NZL,New Zealand,MNE,Montenegro,2015,0,1,-1
NZL,New Zealand,MNE,Montenegro,2016,0,1,-1
NOR,Norway,MNE,Montenegro,2008,0,15,-15
NOR,Norway,MNE,Montenegro,2009,27,18,9
NOR,Norway,MNE,Montenegro,2010,1,16,-15
NOR,Norway,MNE,Montenegro,2011,2,25,-23
NOR,Norway,MNE,Montenegro,2012,4,21,-17
NOR,Norway,MNE,Montenegro,2013,5,22,-17
NOR,Norway,MNE,Montenegro,2014,10,30,-20
NOR,Norway,MNE,Montenegro,2015,5,23,-18
NOR,Norway,MNE,Montenegro,2016,9,26,-17
NOR,Norway,MNE,Montenegro,2017,8,20,-12
POL,Poland,MNE,Montenegro,2009,0,23,-23
POL,Poland,MNE,Montenegro,2010,0,18,-18
POL,Poland,MNE,Montenegro,2011,0,12,-12
POL,Poland,MNE,Montenegro,2012,0,19,-19
POL,Poland,MNE,Montenegro,2013,0,20,-20
POL,Poland,MNE,Montenegro,2014,0,7,-7
POL,Poland,MNE,Montenegro,2015,0,39,-39
POL,Poland,MNE,Montenegro,2016,0,27,-27
POL,Poland,MNE,Montenegro,2017,0,28,-28
SVK,Slovak Republic,MNE,Montenegro,2008,1,4,-3
SVK,Slovak Republic,MNE,Montenegro,2009,1,2,-1
SVK,Slovak Republic,MNE,Montenegro,2010,2,1,1
SVK,Slovak Republic,MNE,Montenegro,2011,1,1,0
SVK,Slovak Republic,MNE,Montenegro,2015,0,1,-1
ESP,Spain,MNE,Montenegro,2008,2,28,-26
ESP,Spain,MNE,Montenegro,2009,9,15,-6
ESP,Spain,MNE,Montenegro,2010,21,29,-8
ESP,Spain,MNE,Montenegro,2011,42,29,13
ESP,Spain,MNE,Montenegro,2012,12,25,-13
ESP,Spain,MNE,Montenegro,2013,15,26,-11
ESP,Spain,MNE,Montenegro,2014,10,26,-16
ESP,Spain,MNE,Montenegro,2015,13,31,-18
ESP,Spain,MNE,Montenegro,2016,16,40,-24
ESP,Spain,MNE,Montenegro,2017,16,36,-20
SWE,Sweden,MNE,Montenegro,2008,7,86,-79
SWE,Sweden,MNE,Montenegro,2009,8,81,-73
SWE,Sweden,MNE,Montenegro,2010,2,82,-80
SWE,Sweden,MNE,Montenegro,2011,6,105,-99
SWE,Sweden,MNE,Montenegro,2012,3,121,-118
SWE,Sweden,MNE,Montenegro,2013,4,89,-85
SWE,Sweden,MNE,Montenegro,2014,3,83,-80
SWE,Sweden,MNE,Montenegro,2015,10,87,-77
SWE,Sweden,MNE,Montenegro,2016,11,90,-79
SWE,Sweden,MNE,Montenegro,2017,11,112,-101
CHE,Switzerland,MNE,Montenegro,2010,17,51,-34
CHE,Switzerland,MNE,Montenegro,2011,20,67,-47
CHE,Switzerland,MNE,Montenegro,2012,23,74,-51
CHE,Switzerland,MNE,Montenegro,2013,21,78,-57
CHE,Switzerland,MNE,Montenegro,2014,22,62,-40
CHE,Switzerland,MNE,Montenegro,2015,26,65,-39
CHE,Switzerland,MNE,Montenegro,2016,17,69,-52
CHE,Switzerland,MNE,Montenegro,2017,20,55,-35
USA,United States,MNE,Montenegro,2010,0,120,-120
USA,United States,MNE,Montenegro,2011,0,204,-204
USA,United States,MNE,Montenegro,2012,0,265,-265
USA,United States,MNE,Montenegro,2013,0,265,-265
USA,United States,MNE,Montenegro,2014,0,289,-289
USA,United States,MNE,Montenegro,2015,0,251,-251
USA,United States,MNE,Montenegro,2016,0,387,-387
USA,United States,MNE,Montenegro,2017,0,323,-323
CHL,Chile,MNE,Montenegro,2008,0,0,0
CHL,Chile,MNE,Montenegro,2009,0,0,0
CHL,Chile,MNE,Montenegro,2010,0,0,0
CHL,Chile,MNE,Montenegro,2011,0,0,0
CHL,Chile,MNE,Montenegro,2012,0,0,0
CHL,Chile,MNE,Montenegro,2013,0,0,0
CHL,Chile,MNE,Montenegro,2014,0,0,0
CHL,Chile,MNE,Montenegro,2015,0,0,0
CHL,Chile,MNE,Montenegro,2016,0,0,0
EST,Estonia,MNE,Montenegro,2008,0,0,0
EST,Estonia,MNE,Montenegro,2009,0,0,0
EST,Estonia,MNE,Montenegro,2010,0,0,0
EST,Estonia,MNE,Montenegro,2011,0,0,0
EST,Estonia,MNE,Montenegro,2012,0,0,0
EST,Estonia,MNE,Montenegro,2013,0,0,0
EST,Estonia,MNE,Montenegro,2014,0,0,0
EST,Estonia,MNE,Montenegro,2015,0,1,-1
EST,Estonia,MNE,Montenegro,2016,0,3,-3
EST,Estonia,MNE,Montenegro,2017,0,0,0
SVN,Slovenia,MNE,Montenegro,2008,22,147,-125
SVN,Slovenia,MNE,Montenegro,2009,61,125,-64
SVN,Slovenia,MNE,Montenegro,2010,57,57,0
SVN,Slovenia,MNE,Montenegro,2011,7,119,-112
SVN,Slovenia,MNE,Montenegro,2012,4,86,-82
SVN,Slovenia,MNE,Montenegro,2013,2,66,-64
SVN,Slovenia,MNE,Montenegro,2014,1,51,-50
SVN,Slovenia,MNE,Montenegro,2015,11,125,-114
SVN,Slovenia,MNE,Montenegro,2016,10,105,-95
SVN,Slovenia,MNE,Montenegro,2017,10,142,-132
AUS,Australia,MAR,Morocco,2008,23,60,-37
AUS,Australia,MAR,Morocco,2009,24,47,-23
AUS,Australia,MAR,Morocco,2010,11,40,-29
AUS,Australia,MAR,Morocco,2011,24,67,-43
AUS,Australia,MAR,Morocco,2012,23,56,-33
AUS,Australia,MAR,Morocco,2013,27,83,-56
AUS,Australia,MAR,Morocco,2014,29,75,-46
AUS,Australia,MAR,Morocco,2015,0,79,-79
AUS,Australia,MAR,Morocco,2016,0,73,-73
AUS,Australia,MAR,Morocco,2017,0,80,-80
AUT,Austria,MAR,Morocco,2008,111,178,-67
AUT,Austria,MAR,Morocco,2009,136,184,-48
AUT,Austria,MAR,Morocco,2010,145,167,-22
AUT,Austria,MAR,Morocco,2011,122,194,-72
AUT,Austria,MAR,Morocco,2012,122,194,-72
AUT,Austria,MAR,Morocco,2013,130,250,-120
AUT,Austria,MAR,Morocco,2014,182,249,-67
AUT,Austria,MAR,Morocco,2015,208,388,-180
AUT,Austria,MAR,Morocco,2016,383,507,-124
AUT,Austria,MAR,Morocco,2017,354,330,24
BEL,Belgium,MAR,Morocco,2008,845,8221,-7376
BEL,Belgium,MAR,Morocco,2009,793,9093,-8300
BEL,Belgium,MAR,Morocco,2010,726,9754,-9028
BEL,Belgium,MAR,Morocco,2011,1014,8491,-7477
BEL,Belgium,MAR,Morocco,2012,1514,5852,-4338
BEL,Belgium,MAR,Morocco,2013,1848,4687,-2839
BEL,Belgium,MAR,Morocco,2014,1626,4709,-3083
BEL,Belgium,MAR,Morocco,2015,1502,4816,-3314
BEL,Belgium,MAR,Morocco,2016,1126,4411,-3285
BEL,Belgium,MAR,Morocco,2017,1002,4491,-3489
CAN,Canada,MAR,Morocco,2008,0,4225,-4225
CAN,Canada,MAR,Morocco,2009,0,5532,-5532
CAN,Canada,MAR,Morocco,2010,0,6242,-6242
CAN,Canada,MAR,Morocco,2011,0,4390,-4390
CAN,Canada,MAR,Morocco,2012,0,3855,-3855
CAN,Canada,MAR,Morocco,2013,0,3276,-3276
CAN,Canada,MAR,Morocco,2014,0,2491,-2491
CAN,Canada,MAR,Morocco,2015,0,2736,-2736
CAN,Canada,MAR,Morocco,2016,0,2115,-2115
CAN,Canada,MAR,Morocco,2017,0,2270,-2270
CZE,Czech Republic,MAR,Morocco,2008,0,21,-21
CZE,Czech Republic,MAR,Morocco,2009,0,25,-25
CZE,Czech Republic,MAR,Morocco,2010,2,14,-12
CZE,Czech Republic,MAR,Morocco,2011,0,9,-9
CZE,Czech Republic,MAR,Morocco,2012,2,15,-13
CZE,Czech Republic,MAR,Morocco,2013,8,20,-12
CZE,Czech Republic,MAR,Morocco,2014,11,25,-14
CZE,Czech Republic,MAR,Morocco,2015,7,27,-20
CZE,Czech Republic,MAR,Morocco,2016,12,28,-16
CZE,Czech Republic,MAR,Morocco,2017,17,47,-30
DNK,Denmark,MAR,Morocco,2008,35,92,-57
DNK,Denmark,MAR,Morocco,2009,17,104,-87
DNK,Denmark,MAR,Morocco,2010,23,93,-70
DNK,Denmark,MAR,Morocco,2011,24,84,-60
DNK,Denmark,MAR,Morocco,2012,41,57,-16
DNK,Denmark,MAR,Morocco,2013,22,103,-81
DNK,Denmark,MAR,Morocco,2014,29,114,-85
DNK,Denmark,MAR,Morocco,2015,20,96,-76
DNK,Denmark,MAR,Morocco,2016,25,97,-72
DNK,Denmark,MAR,Morocco,2017,39,108,-69
FIN,Finland,MAR,Morocco,2008,11,92,-81
FIN,Finland,MAR,Morocco,2009,13,101,-88
FIN,Finland,MAR,Morocco,2010,6,63,-57
FIN,Finland,MAR,Morocco,2011,5,87,-82
FIN,Finland,MAR,Morocco,2012,4,81,-77
FIN,Finland,MAR,Morocco,2013,9,112,-103
FIN,Finland,MAR,Morocco,2014,12,119,-107
FIN,Finland,MAR,Morocco,2015,16,113,-97
FIN,Finland,MAR,Morocco,2016,8,147,-139
FIN,Finland,MAR,Morocco,2017,14,108,-94
FRA,France,MAR,Morocco,2008,0,24866,-24866
FRA,France,MAR,Morocco,2009,0,21520,-21520
FRA,France,MAR,Morocco,2010,0,20110,-20110
FRA,France,MAR,Morocco,2011,0,18765,-18765
FRA,France,MAR,Morocco,2012,0,19790,-19790
FRA,France,MAR,Morocco,2013,0,20049,-20049
FRA,France,MAR,Morocco,2014,0,21104,-21104
FRA,France,MAR,Morocco,2015,0,18423,-18423
FRA,France,MAR,Morocco,2016,0,18811,-18811
FRA,France,MAR,Morocco,2017,0,18792,-18792
DEU,Germany,MAR,Morocco,2008,2765,3374,-609
DEU,Germany,MAR,Morocco,2009,2652,3925,-1273
DEU,Germany,MAR,Morocco,2010,2426,3762,-1336
DEU,Germany,MAR,Morocco,2011,2275,4370,-2095
DEU,Germany,MAR,Morocco,2012,2373,5024,-2651
DEU,Germany,MAR,Morocco,2013,2993,6666,-3673
DEU,Germany,MAR,Morocco,2014,3406,7836,-4430
DEU,Germany,MAR,Morocco,2015,4330,11636,-7306
DEU,Germany,MAR,Morocco,2016,8542,10594,-2052
DEU,Germany,MAR,Morocco,2017,5960,8436,-2476
HUN,Hungary,MAR,Morocco,2008,1,22,-21
HUN,Hungary,MAR,Morocco,2009,0,33,-33
HUN,Hungary,MAR,Morocco,2010,6,14,-8
HUN,Hungary,MAR,Morocco,2011,12,26,-14
HUN,Hungary,MAR,Morocco,2012,3,17,-14
HUN,Hungary,MAR,Morocco,2013,4,14,-10
HUN,Hungary,MAR,Morocco,2014,0,21,-21
HUN,Hungary,MAR,Morocco,2015,3,44,-41
HUN,Hungary,MAR,Morocco,2016,3,74,-71
HUN,Hungary,MAR,Morocco,2017,0,105,-105
ISL,Iceland,MAR,Morocco,2008,14,15,-1
ISL,Iceland,MAR,Morocco,2009,5,7,-2
ISL,Iceland,MAR,Morocco,2010,5,5,0
ISL,Iceland,MAR,Morocco,2011,6,9,-3
ISL,Iceland,MAR,Morocco,2012,2,7,-5
ISL,Iceland,MAR,Morocco,2013,2,10,-8
ISL,Iceland,MAR,Morocco,2014,4,6,-2
ISL,Iceland,MAR,Morocco,2015,2,8,-6
ISL,Iceland,MAR,Morocco,2016,2,17,-15
ISL,Iceland,MAR,Morocco,2017,2,17,-15
ITA,Italy,MAR,Morocco,2008,1046,37275,-36229
ITA,Italy,MAR,Morocco,2009,1178,33128,-31950
ITA,Italy,MAR,Morocco,2010,2179,29960,-27781
ITA,Italy,MAR,Morocco,2011,1761,23885,-22124
ITA,Italy,MAR,Morocco,2012,1960,19590,-17630
ITA,Italy,MAR,Morocco,2013,2418,19568,-17150
ITA,Italy,MAR,Morocco,2014,2726,17637,-14911
ITA,Italy,MAR,Morocco,2015,2536,15009,-12473
ITA,Italy,MAR,Morocco,2016,0,14651,-14651
ITA,Italy,MAR,Morocco,2017,2232,15690,-13458
JPN,Japan,MAR,Morocco,2008,128,163,-35
JPN,Japan,MAR,Morocco,2009,127,142,-15
JPN,Japan,MAR,Morocco,2010,14,164,-150
JPN,Japan,MAR,Morocco,2011,101,121,-20
JPN,Japan,MAR,Morocco,2012,148,182,-34
JPN,Japan,MAR,Morocco,2013,130,156,-26
JPN,Japan,MAR,Morocco,2014,218,247,-29
JPN,Japan,MAR,Morocco,2015,159,211,-52
JPN,Japan,MAR,Morocco,2016,142,233,-91
JPN,Japan,MAR,Morocco,2017,193,256,-63
KOR,Korea,MAR,Morocco,2008,44,74,-30
KOR,Korea,MAR,Morocco,2009,67,80,-13
KOR,Korea,MAR,Morocco,2010,69,65,4
KOR,Korea,MAR,Morocco,2011,59,89,-30
KOR,Korea,MAR,Morocco,2012,90,90,0
KOR,Korea,MAR,Morocco,2013,83,139,-56
KOR,Korea,MAR,Morocco,2014,112,186,-74
KOR,Korea,MAR,Morocco,2015,129,206,-77
KOR,Korea,MAR,Morocco,2016,184,285,-101
KOR,Korea,MAR,Morocco,2017,197,379,-182
LUX,Luxembourg,MAR,Morocco,2008,15,78,-63
LUX,Luxembourg,MAR,Morocco,2009,20,56,-36
LUX,Luxembourg,MAR,Morocco,2010,14,80,-66
LUX,Luxembourg,MAR,Morocco,2011,15,56,-41
LUX,Luxembourg,MAR,Morocco,2012,22,78,-56
LUX,Luxembourg,MAR,Morocco,2013,27,82,-55
LUX,Luxembourg,MAR,Morocco,2014,27,97,-70
LUX,Luxembourg,MAR,Morocco,2015,30,123,-93
LUX,Luxembourg,MAR,Morocco,2016,30,149,-119
LUX,Luxembourg,MAR,Morocco,2017,35,204,-169
MEX,Mexico,MAR,Morocco,2008,0,14,-14
MEX,Mexico,MAR,Morocco,2009,0,27,-27
MEX,Mexico,MAR,Morocco,2010,0,19,-19
MEX,Mexico,MAR,Morocco,2011,0,26,-26
MEX,Mexico,MAR,Morocco,2012,0,15,-15
MEX,Mexico,MAR,Morocco,2013,0,35,-35
MEX,Mexico,MAR,Morocco,2014,0,33,-33
MEX,Mexico,MAR,Morocco,2015,0,32,-32
MEX,Mexico,MAR,Morocco,2016,0,34,-34
MEX,Mexico,MAR,Morocco,2017,0,29,-29
NLD,Netherlands,MAR,Morocco,2008,861,1465,-604
NLD,Netherlands,MAR,Morocco,2009,629,1680,-1051
NLD,Netherlands,MAR,Morocco,2010,608,1632,-1024
NLD,Netherlands,MAR,Morocco,2011,501,1841,-1340
NLD,Netherlands,MAR,Morocco,2012,730,1432,-702
NLD,Netherlands,MAR,Morocco,2013,503,1469,-966
NLD,Netherlands,MAR,Morocco,2014,482,1405,-923
NLD,Netherlands,MAR,Morocco,2015,350,1080,-730
NLD,Netherlands,MAR,Morocco,2016,271,1337,-1066
NLD,Netherlands,MAR,Morocco,2017,346,1470,-1124
NZL,New Zealand,MAR,Morocco,2008,2,9,-7
NZL,New Zealand,MAR,Morocco,2009,1,3,-2
NZL,New Zealand,MAR,Morocco,2010,1,4,-3
NZL,New Zealand,MAR,Morocco,2011,0,10,-10
NZL,New Zealand,MAR,Morocco,2012,1,7,-6
NZL,New Zealand,MAR,Morocco,2013,0,7,-7
NZL,New Zealand,MAR,Morocco,2014,1,6,-5
NZL,New Zealand,MAR,Morocco,2015,3,11,-8
NZL,New Zealand,MAR,Morocco,2016,3,5,-2
NZL,New Zealand,MAR,Morocco,2017,3,10,-7
NOR,Norway,MAR,Morocco,2008,19,122,-103
NOR,Norway,MAR,Morocco,2009,0,114,-114
NOR,Norway,MAR,Morocco,2010,25,123,-98
NOR,Norway,MAR,Morocco,2011,34,123,-89
NOR,Norway,MAR,Morocco,2012,39,121,-82
NOR,Norway,MAR,Morocco,2013,30,139,-109
NOR,Norway,MAR,Morocco,2014,26,123,-97
NOR,Norway,MAR,Morocco,2015,29,123,-94
NOR,Norway,MAR,Morocco,2016,26,148,-122
NOR,Norway,MAR,Morocco,2017,17,142,-125
POL,Poland,MAR,Morocco,2008,0,144,-144
POL,Poland,MAR,Morocco,2009,0,181,-181
POL,Poland,MAR,Morocco,2010,0,156,-156
POL,Poland,MAR,Morocco,2011,0,175,-175
POL,Poland,MAR,Morocco,2012,0,217,-217
POL,Poland,MAR,Morocco,2013,0,168,-168
POL,Poland,MAR,Morocco,2014,0,107,-107
POL,Poland,MAR,Morocco,2015,0,227,-227
POL,Poland,MAR,Morocco,2016,0,213,-213
POL,Poland,MAR,Morocco,2017,0,237,-237
PRT,Portugal,MAR,Morocco,2008,0,190,-190
PRT,Portugal,MAR,Morocco,2009,0,109,-109
PRT,Portugal,MAR,Morocco,2010,0,259,-259
PRT,Portugal,MAR,Morocco,2011,0,242,-242
PRT,Portugal,MAR,Morocco,2012,0,173,-173
PRT,Portugal,MAR,Morocco,2013,0,166,-166
PRT,Portugal,MAR,Morocco,2014,0,127,-127
PRT,Portugal,MAR,Morocco,2015,0,136,-136
PRT,Portugal,MAR,Morocco,2016,0,92,-92
PRT,Portugal,MAR,Morocco,2017,0,143,-143
SVK,Slovak Republic,MAR,Morocco,2008,4,1,3
SVK,Slovak Republic,MAR,Morocco,2009,8,2,6
SVK,Slovak Republic,MAR,Morocco,2010,0,2,-2
SVK,Slovak Republic,MAR,Morocco,2011,2,3,-1
SVK,Slovak Republic,MAR,Morocco,2012,1,2,-1
SVK,Slovak Republic,MAR,Morocco,2013,0,2,-2
SVK,Slovak Republic,MAR,Morocco,2014,0,1,-1
SVK,Slovak Republic,MAR,Morocco,2015,0,2,-2
SVK,Slovak Republic,MAR,Morocco,2016,0,3,-3
ESP,Spain,MAR,Morocco,2008,26709,71761,-45052
ESP,Spain,MAR,Morocco,2009,33374,43178,-9804
ESP,Spain,MAR,Morocco,2010,37662,30169,7493
ESP,Spain,MAR,Morocco,2011,42231,27978,14253
ESP,Spain,MAR,Morocco,2012,44423,22444,21979
ESP,Spain,MAR,Morocco,2013,47463,20516,26947
ESP,Spain,MAR,Morocco,2014,30545,19994,10551
ESP,Spain,MAR,Morocco,2015,23537,23831,-294
ESP,Spain,MAR,Morocco,2016,23364,29712,-6348
ESP,Spain,MAR,Morocco,2017,22498,39847,-17349
SWE,Sweden,MAR,Morocco,2008,34,459,-425
SWE,Sweden,MAR,Morocco,2009,32,400,-368
SWE,Sweden,MAR,Morocco,2010,49,421,-372
SWE,Sweden,MAR,Morocco,2011,31,416,-385
SWE,Sweden,MAR,Morocco,2012,52,475,-423
SWE,Sweden,MAR,Morocco,2013,60,521,-461
SWE,Sweden,MAR,Morocco,2014,59,541,-482
SWE,Sweden,MAR,Morocco,2015,83,529,-446
SWE,Sweden,MAR,Morocco,2016,57,520,-463
SWE,Sweden,MAR,Morocco,2017,49,600,-551
CHE,Switzerland,MAR,Morocco,2010,183,730,-547
CHE,Switzerland,MAR,Morocco,2011,227,619,-392
CHE,Switzerland,MAR,Morocco,2012,181,505,-324
CHE,Switzerland,MAR,Morocco,2013,186,542,-356
CHE,Switzerland,MAR,Morocco,2014,174,492,-318
CHE,Switzerland,MAR,Morocco,2015,175,51,124
CHE,Switzerland,MAR,Morocco,2016,189,486,-297
CHE,Switzerland,MAR,Morocco,2017,150,534,-384
TUR,Turkey,MAR,Morocco,2010,0,128,-128
TUR,Turkey,MAR,Morocco,2016,643,1763,-1120
TUR,Turkey,MAR,Morocco,2017,903,2556,-1653
GBR,United Kingdom,MAR,Morocco,2013,1000,1000,0
GBR,United Kingdom,MAR,Morocco,2014,0,1000,-1000
USA,United States,MAR,Morocco,2008,0,4425,-4425
USA,United States,MAR,Morocco,2009,0,5447,-5447
USA,United States,MAR,Morocco,2010,0,5013,-5013
USA,United States,MAR,Morocco,2011,0,4399,-4399
USA,United States,MAR,Morocco,2012,0,3656,-3656
USA,United States,MAR,Morocco,2013,0,3336,-3336
USA,United States,MAR,Morocco,2014,0,3605,-3605
USA,United States,MAR,Morocco,2015,0,3710,-3710
USA,United States,MAR,Morocco,2016,0,4586,-4586
USA,United States,MAR,Morocco,2017,0,4229,-4229
CHL,Chile,MAR,Morocco,2008,0,7,-7
CHL,Chile,MAR,Morocco,2009,0,7,-7
CHL,Chile,MAR,Morocco,2010,0,6,-6
CHL,Chile,MAR,Morocco,2011,0,13,-13
CHL,Chile,MAR,Morocco,2012,0,8,-8
CHL,Chile,MAR,Morocco,2013,0,9,-9
CHL,Chile,MAR,Morocco,2014,0,5,-5
CHL,Chile,MAR,Morocco,2015,0,8,-8
CHL,Chile,MAR,Morocco,2016,0,9,-9
EST,Estonia,MAR,Morocco,2008,0,1,-1
EST,Estonia,MAR,Morocco,2009,0,0,0
EST,Estonia,MAR,Morocco,2010,0,1,-1
EST,Estonia,MAR,Morocco,2011,0,2,-2
EST,Estonia,MAR,Morocco,2012,0,1,-1
EST,Estonia,MAR,Morocco,2013,0,4,-4
EST,Estonia,MAR,Morocco,2014,0,0,0
EST,Estonia,MAR,Morocco,2015,0,4,-4
EST,Estonia,MAR,Morocco,2016,0,5,-5
EST,Estonia,MAR,Morocco,2017,0,3,-3
ISR,Israel,MAR,Morocco,2008,0,42,-42
ISR,Israel,MAR,Morocco,2009,0,25,-25
ISR,Israel,MAR,Morocco,2010,0,35,-35
ISR,Israel,MAR,Morocco,2011,0,40,-40
ISR,Israel,MAR,Morocco,2012,0,45,-45
ISR,Israel,MAR,Morocco,2013,0,37,-37
ISR,Israel,MAR,Morocco,2014,0,48,-48
ISR,Israel,MAR,Morocco,2015,0,95,-95
ISR,Israel,MAR,Morocco,2016,0,66,-66
ISR,Israel,MAR,Morocco,2017,0,57,-57
SVN,Slovenia,MAR,Morocco,2008,0,3,-3
SVN,Slovenia,MAR,Morocco,2009,0,1,-1
SVN,Slovenia,MAR,Morocco,2010,0,4,-4
SVN,Slovenia,MAR,Morocco,2011,0,3,-3
SVN,Slovenia,MAR,Morocco,2012,1,1,0
SVN,Slovenia,MAR,Morocco,2013,0,3,-3
SVN,Slovenia,MAR,Morocco,2014,0,1,-1
SVN,Slovenia,MAR,Morocco,2015,0,3,-3
SVN,Slovenia,MAR,Morocco,2016,0,8,-8
SVN,Slovenia,MAR,Morocco,2017,2,9,-7
AUS,Australia,MOZ,Mozambique,2008,9,9,0
AUS,Australia,MOZ,Mozambique,2009,5,12,-7
AUS,Australia,MOZ,Mozambique,2010,9,21,-12
AUS,Australia,MOZ,Mozambique,2011,5,10,-5
AUS,Australia,MOZ,Mozambique,2012,8,14,-6
AUS,Australia,MOZ,Mozambique,2013,5,11,-6
AUS,Australia,MOZ,Mozambique,2014,7,21,-14
AUS,Australia,MOZ,Mozambique,2015,0,0,0
AUS,Australia,MOZ,Mozambique,2016,0,7,-7
AUS,Australia,MOZ,Mozambique,2017,0,11,-11
AUT,Austria,MOZ,Mozambique,2008,2,8,-6
AUT,Austria,MOZ,Mozambique,2009,2,1,1
AUT,Austria,MOZ,Mozambique,2010,3,4,-1
AUT,Austria,MOZ,Mozambique,2011,3,1,2
AUT,Austria,MOZ,Mozambique,2012,2,3,-1
AUT,Austria,MOZ,Mozambique,2013,1,3,-2
AUT,Austria,MOZ,Mozambique,2014,1,6,-5
AUT,Austria,MOZ,Mozambique,2015,0,3,-3
AUT,Austria,MOZ,Mozambique,2016,4,2,2
AUT,Austria,MOZ,Mozambique,2017,2,5,-3
BEL,Belgium,MOZ,Mozambique,2008,0,4,-4
BEL,Belgium,MOZ,Mozambique,2009,0,9,-9
BEL,Belgium,MOZ,Mozambique,2010,2,13,-11
BEL,Belgium,MOZ,Mozambique,2012,7,8,-1
BEL,Belgium,MOZ,Mozambique,2013,5,10,-5
BEL,Belgium,MOZ,Mozambique,2014,4,4,0
BEL,Belgium,MOZ,Mozambique,2015,4,3,1
BEL,Belgium,MOZ,Mozambique,2016,6,6,0
BEL,Belgium,MOZ,Mozambique,2017,4,7,-3
CAN,Canada,MOZ,Mozambique,2008,0,5,-5
CAN,Canada,MOZ,Mozambique,2009,0,12,-12
CAN,Canada,MOZ,Mozambique,2010,0,7,-7
CAN,Canada,MOZ,Mozambique,2011,0,3,-3
CAN,Canada,MOZ,Mozambique,2012,0,4,-4
CAN,Canada,MOZ,Mozambique,2013,0,12,-12
CAN,Canada,MOZ,Mozambique,2014,0,3,-3
CAN,Canada,MOZ,Mozambique,2015,0,8,-8
CAN,Canada,MOZ,Mozambique,2016,0,0,0
CAN,Canada,MOZ,Mozambique,2017,0,5,-5
CZE,Czech Republic,MOZ,Mozambique,2014,0,1,-1
DNK,Denmark,MOZ,Mozambique,2008,9,9,0
DNK,Denmark,MOZ,Mozambique,2009,8,11,-3
DNK,Denmark,MOZ,Mozambique,2010,3,6,-3
DNK,Denmark,MOZ,Mozambique,2011,7,1,6
DNK,Denmark,MOZ,Mozambique,2012,1,8,-7
DNK,Denmark,MOZ,Mozambique,2013,2,12,-10
DNK,Denmark,MOZ,Mozambique,2014,4,5,-1
DNK,Denmark,MOZ,Mozambique,2015,2,7,-5
DNK,Denmark,MOZ,Mozambique,2016,0,7,-7
DNK,Denmark,MOZ,Mozambique,2017,3,4,-1
FIN,Finland,MOZ,Mozambique,2008,0,3,-3
FIN,Finland,MOZ,Mozambique,2009,0,3,-3
FIN,Finland,MOZ,Mozambique,2010,1,4,-3
FIN,Finland,MOZ,Mozambique,2011,0,1,-1
FIN,Finland,MOZ,Mozambique,2012,1,1,0
FIN,Finland,MOZ,Mozambique,2013,0,3,-3
FIN,Finland,MOZ,Mozambique,2014,0,2,-2
FIN,Finland,MOZ,Mozambique,2015,0,2,-2
FIN,Finland,MOZ,Mozambique,2016,0,0,0
FIN,Finland,MOZ,Mozambique,2017,0,4,-4
FRA,France,MOZ,Mozambique,2008,0,5,-5
FRA,France,MOZ,Mozambique,2009,0,9,-9
FRA,France,MOZ,Mozambique,2010,0,11,-11
FRA,France,MOZ,Mozambique,2011,0,8,-8
FRA,France,MOZ,Mozambique,2012,0,7,-7
FRA,France,MOZ,Mozambique,2013,0,10,-10
FRA,France,MOZ,Mozambique,2014,0,11,-11
FRA,France,MOZ,Mozambique,2015,0,9,-9
FRA,France,MOZ,Mozambique,2016,0,11,-11
FRA,France,MOZ,Mozambique,2017,0,12,-12
DEU,Germany,MOZ,Mozambique,2008,141,106,35
DEU,Germany,MOZ,Mozambique,2009,177,98,79
DEU,Germany,MOZ,Mozambique,2010,81,81,0
DEU,Germany,MOZ,Mozambique,2011,48,87,-39
DEU,Germany,MOZ,Mozambique,2012,37,68,-31
DEU,Germany,MOZ,Mozambique,2013,40,59,-19
DEU,Germany,MOZ,Mozambique,2014,47,73,-26
DEU,Germany,MOZ,Mozambique,2015,41,78,-37
DEU,Germany,MOZ,Mozambique,2016,36,85,-49
DEU,Germany,MOZ,Mozambique,2017,45,100,-55
HUN,Hungary,MOZ,Mozambique,2008,0,1,-1
HUN,Hungary,MOZ,Mozambique,2009,0,0,0
HUN,Hungary,MOZ,Mozambique,2010,0,0,0
HUN,Hungary,MOZ,Mozambique,2011,0,0,0
HUN,Hungary,MOZ,Mozambique,2012,0,1,-1
HUN,Hungary,MOZ,Mozambique,2013,0,1,-1
HUN,Hungary,MOZ,Mozambique,2014,0,0,0
HUN,Hungary,MOZ,Mozambique,2015,0,0,0
HUN,Hungary,MOZ,Mozambique,2016,0,2,-2
HUN,Hungary,MOZ,Mozambique,2017,0,4,-4
ISL,Iceland,MOZ,Mozambique,2008,1,2,-1
ISL,Iceland,MOZ,Mozambique,2009,2,1,1
ISL,Iceland,MOZ,Mozambique,2010,1,2,-1
ISL,Iceland,MOZ,Mozambique,2011,0,2,-2
ISL,Iceland,MOZ,Mozambique,2012,1,5,-4
ISL,Iceland,MOZ,Mozambique,2013,4,6,-2
ISL,Iceland,MOZ,Mozambique,2014,6,5,1
ISL,Iceland,MOZ,Mozambique,2015,4,3,1
ISL,Iceland,MOZ,Mozambique,2016,3,4,-1
ISL,Iceland,MOZ,Mozambique,2017,1,1,0
ITA,Italy,MOZ,Mozambique,2008,0,27,-27
ITA,Italy,MOZ,Mozambique,2009,0,37,-37
ITA,Italy,MOZ,Mozambique,2010,2,32,-30
ITA,Italy,MOZ,Mozambique,2011,0,29,-29
ITA,Italy,MOZ,Mozambique,2012,3,30,-27
ITA,Italy,MOZ,Mozambique,2013,3,28,-25
ITA,Italy,MOZ,Mozambique,2014,4,26,-22
ITA,Italy,MOZ,Mozambique,2015,8,36,-28
ITA,Italy,MOZ,Mozambique,2016,0,22,-22
ITA,Italy,MOZ,Mozambique,2017,6,41,-35
JPN,Japan,MOZ,Mozambique,2008,111,103,8
JPN,Japan,MOZ,Mozambique,2009,18,20,-2
JPN,Japan,MOZ,Mozambique,2010,48,53,-5
JPN,Japan,MOZ,Mozambique,2011,70,76,-6
JPN,Japan,MOZ,Mozambique,2012,148,145,3
JPN,Japan,MOZ,Mozambique,2013,305,309,-4
JPN,Japan,MOZ,Mozambique,2014,211,238,-27
JPN,Japan,MOZ,Mozambique,2015,206,248,-42
JPN,Japan,MOZ,Mozambique,2016,170,197,-27
JPN,Japan,MOZ,Mozambique,2017,302,318,-16
KOR,Korea,MOZ,Mozambique,2008,11,19,-8
KOR,Korea,MOZ,Mozambique,2009,15,8,7
KOR,Korea,MOZ,Mozambique,2010,3,5,-2
KOR,Korea,MOZ,Mozambique,2011,3,6,-3
KOR,Korea,MOZ,Mozambique,2012,8,8,0
KOR,Korea,MOZ,Mozambique,2013,3,4,-1
KOR,Korea,MOZ,Mozambique,2014,13,13,0
KOR,Korea,MOZ,Mozambique,2015,28,28,0
KOR,Korea,MOZ,Mozambique,2016,7,9,-2
KOR,Korea,MOZ,Mozambique,2017,7,23,-16
LUX,Luxembourg,MOZ,Mozambique,2008,0,1,-1
LUX,Luxembourg,MOZ,Mozambique,2009,0,0,0
LUX,Luxembourg,MOZ,Mozambique,2010,0,2,-2
LUX,Luxembourg,MOZ,Mozambique,2011,0,1,-1
LUX,Luxembourg,MOZ,Mozambique,2012,0,0,0
LUX,Luxembourg,MOZ,Mozambique,2013,0,0,0
LUX,Luxembourg,MOZ,Mozambique,2014,0,0,0
LUX,Luxembourg,MOZ,Mozambique,2015,0,1,-1
LUX,Luxembourg,MOZ,Mozambique,2016,0,0,0
LUX,Luxembourg,MOZ,Mozambique,2017,0,2,-2
MEX,Mexico,MOZ,Mozambique,2010,0,1,-1
MEX,Mexico,MOZ,Mozambique,2012,0,1,-1
MEX,Mexico,MOZ,Mozambique,2013,0,2,-2
MEX,Mexico,MOZ,Mozambique,2014,0,1,-1
MEX,Mexico,MOZ,Mozambique,2016,0,1,-1
MEX,Mexico,MOZ,Mozambique,2017,0,1,-1
NLD,Netherlands,MOZ,Mozambique,2008,3,18,-15
NLD,Netherlands,MOZ,Mozambique,2009,6,11,-5
NLD,Netherlands,MOZ,Mozambique,2010,24,12,12
NLD,Netherlands,MOZ,Mozambique,2011,6,19,-13
NLD,Netherlands,MOZ,Mozambique,2012,12,16,-4
NLD,Netherlands,MOZ,Mozambique,2013,24,16,8
NLD,Netherlands,MOZ,Mozambique,2014,12,12,0
NLD,Netherlands,MOZ,Mozambique,2015,12,15,-3
NLD,Netherlands,MOZ,Mozambique,2016,14,4,10
NLD,Netherlands,MOZ,Mozambique,2017,6,17,-11
NZL,New Zealand,MOZ,Mozambique,2008,0,1,-1
NZL,New Zealand,MOZ,Mozambique,2009,1,1,0
NZL,New Zealand,MOZ,Mozambique,2010,1,1,0
NZL,New Zealand,MOZ,Mozambique,2011,1,0,1
NZL,New Zealand,MOZ,Mozambique,2012,1,0,1
NZL,New Zealand,MOZ,Mozambique,2014,1,2,-1
NZL,New Zealand,MOZ,Mozambique,2015,0,2,-2
NZL,New Zealand,MOZ,Mozambique,2016,0,3,-3
NZL,New Zealand,MOZ,Mozambique,2017,0,1,-1
NOR,Norway,MOZ,Mozambique,2008,7,15,-8
NOR,Norway,MOZ,Mozambique,2009,8,10,-2
NOR,Norway,MOZ,Mozambique,2010,14,9,5
NOR,Norway,MOZ,Mozambique,2011,4,10,-6
NOR,Norway,MOZ,Mozambique,2012,8,14,-6
NOR,Norway,MOZ,Mozambique,2013,9,11,-2
NOR,Norway,MOZ,Mozambique,2014,9,10,-1
NOR,Norway,MOZ,Mozambique,2015,10,3,7
NOR,Norway,MOZ,Mozambique,2016,1,3,-2
NOR,Norway,MOZ,Mozambique,2017,1,2,-1
POL,Poland,MOZ,Mozambique,2009,0,0,0
POL,Poland,MOZ,Mozambique,2010,0,0,0
POL,Poland,MOZ,Mozambique,2011,0,0,0
POL,Poland,MOZ,Mozambique,2012,0,0,0
POL,Poland,MOZ,Mozambique,2013,0,0,0
POL,Poland,MOZ,Mozambique,2014,0,0,0
POL,Poland,MOZ,Mozambique,2015,0,0,0
POL,Poland,MOZ,Mozambique,2016,0,2,-2
POL,Poland,MOZ,Mozambique,2017,0,6,-6
PRT,Portugal,MOZ,Mozambique,2008,0,314,-314
PRT,Portugal,MOZ,Mozambique,2009,0,321,-321
PRT,Portugal,MOZ,Mozambique,2010,0,299,-299
PRT,Portugal,MOZ,Mozambique,2011,0,299,-299
PRT,Portugal,MOZ,Mozambique,2012,0,256,-256
PRT,Portugal,MOZ,Mozambique,2013,0,223,-223
PRT,Portugal,MOZ,Mozambique,2014,0,255,-255
PRT,Portugal,MOZ,Mozambique,2015,0,318,-318
PRT,Portugal,MOZ,Mozambique,2016,0,342,-342
PRT,Portugal,MOZ,Mozambique,2017,0,329,-329
SVK,Slovak Republic,MOZ,Mozambique,2008,0,0,0
ESP,Spain,MOZ,Mozambique,2008,30,43,-13
ESP,Spain,MOZ,Mozambique,2009,35,33,2
ESP,Spain,MOZ,Mozambique,2010,31,53,-22
ESP,Spain,MOZ,Mozambique,2011,46,29,17
ESP,Spain,MOZ,Mozambique,2012,15,28,-13
ESP,Spain,MOZ,Mozambique,2013,18,37,-19
ESP,Spain,MOZ,Mozambique,2014,9,34,-25
ESP,Spain,MOZ,Mozambique,2015,9,51,-42
ESP,Spain,MOZ,Mozambique,2016,18,49,-31
ESP,Spain,MOZ,Mozambique,2017,34,47,-13
SWE,Sweden,MOZ,Mozambique,2008,2,17,-15
SWE,Sweden,MOZ,Mozambique,2009,2,10,-8
SWE,Sweden,MOZ,Mozambique,2010,3,15,-12
SWE,Sweden,MOZ,Mozambique,2011,10,9,1
SWE,Sweden,MOZ,Mozambique,2012,7,9,-2
SWE,Sweden,MOZ,Mozambique,2013,7,7,0
SWE,Sweden,MOZ,Mozambique,2014,7,5,2
SWE,Sweden,MOZ,Mozambique,2015,4,14,-10
SWE,Sweden,MOZ,Mozambique,2016,9,4,5
SWE,Sweden,MOZ,Mozambique,2017,7,9,-2
CHE,Switzerland,MOZ,Mozambique,2010,2,7,-5
CHE,Switzerland,MOZ,Mozambique,2011,3,7,-4
CHE,Switzerland,MOZ,Mozambique,2012,2,15,-13
CHE,Switzerland,MOZ,Mozambique,2013,1,7,-6
CHE,Switzerland,MOZ,Mozambique,2014,1,8,-7
CHE,Switzerland,MOZ,Mozambique,2015,5,13,-8
CHE,Switzerland,MOZ,Mozambique,2016,4,3,1
CHE,Switzerland,MOZ,Mozambique,2017,5,5,0
TUR,Turkey,MOZ,Mozambique,2010,0,6,-6
USA,United States,MOZ,Mozambique,2008,0,69,-69
USA,United States,MOZ,Mozambique,2009,0,66,-66
USA,United States,MOZ,Mozambique,2010,0,53,-53
USA,United States,MOZ,Mozambique,2011,0,60,-60
USA,United States,MOZ,Mozambique,2012,0,94,-94
USA,United States,MOZ,Mozambique,2013,0,73,-73
USA,United States,MOZ,Mozambique,2014,0,71,-71
USA,United States,MOZ,Mozambique,2015,0,107,-107
USA,United States,MOZ,Mozambique,2016,0,101,-101
USA,United States,MOZ,Mozambique,2017,0,96,-96
CHL,Chile,MOZ,Mozambique,2008,0,0,0
CHL,Chile,MOZ,Mozambique,2009,0,0,0
CHL,Chile,MOZ,Mozambique,2010,0,0,0
CHL,Chile,MOZ,Mozambique,2011,0,1,-1
CHL,Chile,MOZ,Mozambique,2012,0,0,0
CHL,Chile,MOZ,Mozambique,2013,0,2,-2
CHL,Chile,MOZ,Mozambique,2014,0,1,-1
CHL,Chile,MOZ,Mozambique,2015,0,7,-7
CHL,Chile,MOZ,Mozambique,2016,0,5,-5
EST,Estonia,MOZ,Mozambique,2008,0,0,0
EST,Estonia,MOZ,Mozambique,2009,0,0,0
EST,Estonia,MOZ,Mozambique,2010,0,0,0
EST,Estonia,MOZ,Mozambique,2011,0,0,0
EST,Estonia,MOZ,Mozambique,2012,0,0,0
EST,Estonia,MOZ,Mozambique,2013,0,0,0
EST,Estonia,MOZ,Mozambique,2014,0,0,0
EST,Estonia,MOZ,Mozambique,2015,0,0,0
EST,Estonia,MOZ,Mozambique,2016,0,0,0
EST,Estonia,MOZ,Mozambique,2017,0,0,0
SVN,Slovenia,MOZ,Mozambique,2008,0,3,-3
SVN,Slovenia,MOZ,Mozambique,2012,0,1,-1
SVN,Slovenia,MOZ,Mozambique,2013,0,1,-1
SVN,Slovenia,MOZ,Mozambique,2015,0,1,-1
AUS,Australia,MMR,Myanmar,2008,37,2646,-2609
AUS,Australia,MMR,Myanmar,2009,44,3068,-3024
AUS,Australia,MMR,Myanmar,2010,49,2576,-2527
AUS,Australia,MMR,Myanmar,2011,64,1649,-1585
AUS,Australia,MMR,Myanmar,2012,74,2521,-2447
AUS,Australia,MMR,Myanmar,2013,76,2341,-2265
AUS,Australia,MMR,Myanmar,2014,100,2380,-2280
AUS,Australia,MMR,Myanmar,2015,100,2481,-2381
AUS,Australia,MMR,Myanmar,2016,100,2288,-2188
AUS,Australia,MMR,Myanmar,2017,0,2175,-2175
AUT,Austria,MMR,Myanmar,2008,3,12,-9
AUT,Austria,MMR,Myanmar,2009,5,4,1
AUT,Austria,MMR,Myanmar,2010,0,6,-6
AUT,Austria,MMR,Myanmar,2011,3,7,-4
AUT,Austria,MMR,Myanmar,2012,6,12,-6
AUT,Austria,MMR,Myanmar,2013,3,23,-20
AUT,Austria,MMR,Myanmar,2014,8,7,1
AUT,Austria,MMR,Myanmar,2015,6,21,-15
AUT,Austria,MMR,Myanmar,2016,4,12,-8
AUT,Austria,MMR,Myanmar,2017,7,17,-10
BEL,Belgium,MMR,Myanmar,2008,0,6,-6
BEL,Belgium,MMR,Myanmar,2009,0,8,-8
BEL,Belgium,MMR,Myanmar,2010,2,5,-3
BEL,Belgium,MMR,Myanmar,2012,9,27,-18
BEL,Belgium,MMR,Myanmar,2013,7,33,-26
BEL,Belgium,MMR,Myanmar,2014,16,10,6
BEL,Belgium,MMR,Myanmar,2015,26,17,9
BEL,Belgium,MMR,Myanmar,2016,15,9,6
BEL,Belgium,MMR,Myanmar,2017,10,12,-2
CAN,Canada,MMR,Myanmar,2008,0,975,-975
CAN,Canada,MMR,Myanmar,2009,0,1152,-1152
CAN,Canada,MMR,Myanmar,2010,0,556,-556
CAN,Canada,MMR,Myanmar,2011,0,365,-365
CAN,Canada,MMR,Myanmar,2012,0,193,-193
CAN,Canada,MMR,Myanmar,2013,0,262,-262
CAN,Canada,MMR,Myanmar,2014,0,440,-440
CAN,Canada,MMR,Myanmar,2015,0,439,-439
CAN,Canada,MMR,Myanmar,2016,0,425,-425
CAN,Canada,MMR,Myanmar,2017,0,175,-175
CZE,Czech Republic,MMR,Myanmar,2008,0,28,-28
CZE,Czech Republic,MMR,Myanmar,2009,0,22,-22
CZE,Czech Republic,MMR,Myanmar,2010,0,47,-47
CZE,Czech Republic,MMR,Myanmar,2011,0,22,-22
CZE,Czech Republic,MMR,Myanmar,2012,1,3,-2
CZE,Czech Republic,MMR,Myanmar,2013,5,29,-24
CZE,Czech Republic,MMR,Myanmar,2014,2,5,-3
CZE,Czech Republic,MMR,Myanmar,2015,2,5,-3
CZE,Czech Republic,MMR,Myanmar,2016,4,7,-3
CZE,Czech Republic,MMR,Myanmar,2017,1,9,-8
DNK,Denmark,MMR,Myanmar,2008,0,169,-169
DNK,Denmark,MMR,Myanmar,2009,4,75,-71
DNK,Denmark,MMR,Myanmar,2010,4,227,-223
DNK,Denmark,MMR,Myanmar,2011,9,193,-184
DNK,Denmark,MMR,Myanmar,2012,5,109,-104
DNK,Denmark,MMR,Myanmar,2013,8,55,-47
DNK,Denmark,MMR,Myanmar,2014,9,18,-9
DNK,Denmark,MMR,Myanmar,2015,17,14,3
DNK,Denmark,MMR,Myanmar,2016,13,19,-6
DNK,Denmark,MMR,Myanmar,2017,24,20,4
FIN,Finland,MMR,Myanmar,2008,2,271,-269
FIN,Finland,MMR,Myanmar,2009,4,218,-214
FIN,Finland,MMR,Myanmar,2010,0,126,-126
FIN,Finland,MMR,Myanmar,2011,1,154,-153
FIN,Finland,MMR,Myanmar,2012,1,110,-109
FIN,Finland,MMR,Myanmar,2013,0,114,-114
FIN,Finland,MMR,Myanmar,2014,0,9,-9
FIN,Finland,MMR,Myanmar,2015,1,17,-16
FIN,Finland,MMR,Myanmar,2016,2,12,-10
FIN,Finland,MMR,Myanmar,2017,0,9,-9
FRA,France,MMR,Myanmar,2008,0,27,-27
FRA,France,MMR,Myanmar,2009,0,44,-44
FRA,France,MMR,Myanmar,2010,0,41,-41
FRA,France,MMR,Myanmar,2011,0,24,-24
FRA,France,MMR,Myanmar,2012,0,33,-33
FRA,France,MMR,Myanmar,2013,0,65,-65
FRA,France,MMR,Myanmar,2014,0,87,-87
FRA,France,MMR,Myanmar,2015,0,53,-53
FRA,France,MMR,Myanmar,2016,0,46,-46
FRA,France,MMR,Myanmar,2017,0,45,-45
DEU,Germany,MMR,Myanmar,2008,310,434,-124
DEU,Germany,MMR,Myanmar,2009,388,491,-103
DEU,Germany,MMR,Myanmar,2010,427,446,-19
DEU,Germany,MMR,Myanmar,2011,254,452,-198
DEU,Germany,MMR,Myanmar,2012,528,411,117
DEU,Germany,MMR,Myanmar,2013,295,353,-58
DEU,Germany,MMR,Myanmar,2014,128,296,-168
DEU,Germany,MMR,Myanmar,2015,380,392,-12
DEU,Germany,MMR,Myanmar,2016,292,294,-2
DEU,Germany,MMR,Myanmar,2017,228,335,-107
HUN,Hungary,MMR,Myanmar,2008,1,0,1
HUN,Hungary,MMR,Myanmar,2009,0,1,-1
HUN,Hungary,MMR,Myanmar,2010,0,2,-2
HUN,Hungary,MMR,Myanmar,2011,0,1,-1
HUN,Hungary,MMR,Myanmar,2012,0,1,-1
HUN,Hungary,MMR,Myanmar,2013,0,0,0
HUN,Hungary,MMR,Myanmar,2014,0,3,-3
HUN,Hungary,MMR,Myanmar,2015,0,3,-3
HUN,Hungary,MMR,Myanmar,2016,0,2,-2
HUN,Hungary,MMR,Myanmar,2017,0,12,-12
ISL,Iceland,MMR,Myanmar,2008,1,0,1
ISL,Iceland,MMR,Myanmar,2009,0,0,0
ISL,Iceland,MMR,Myanmar,2010,0,0,0
ISL,Iceland,MMR,Myanmar,2011,0,0,0
ISL,Iceland,MMR,Myanmar,2012,0,0,0
ISL,Iceland,MMR,Myanmar,2013,0,0,0
ISL,Iceland,MMR,Myanmar,2014,0,0,0
ISL,Iceland,MMR,Myanmar,2015,0,0,0
ISL,Iceland,MMR,Myanmar,2016,0,1,-1
ISL,Iceland,MMR,Myanmar,2017,0,2,-2
ITA,Italy,MMR,Myanmar,2008,0,18,-18
ITA,Italy,MMR,Myanmar,2009,0,38,-38
ITA,Italy,MMR,Myanmar,2010,0,34,-34
ITA,Italy,MMR,Myanmar,2011,9,27,-18
ITA,Italy,MMR,Myanmar,2012,3,22,-19
ITA,Italy,MMR,Myanmar,2013,1,71,-70
ITA,Italy,MMR,Myanmar,2014,4,43,-39
ITA,Italy,MMR,Myanmar,2015,1,44,-43
ITA,Italy,MMR,Myanmar,2016,0,39,-39
ITA,Italy,MMR,Myanmar,2017,7,31,-24
JPN,Japan,MMR,Myanmar,2008,749,1415,-666
JPN,Japan,MMR,Myanmar,2009,798,1424,-626
JPN,Japan,MMR,Myanmar,2010,761,1139,-378
JPN,Japan,MMR,Myanmar,2011,807,1097,-290
JPN,Japan,MMR,Myanmar,2012,1149,1532,-383
JPN,Japan,MMR,Myanmar,2013,1440,2053,-613
JPN,Japan,MMR,Myanmar,2014,1518,3301,-1783
JPN,Japan,MMR,Myanmar,2015,1630,5218,-3588
JPN,Japan,MMR,Myanmar,2016,1811,6135,-4324
JPN,Japan,MMR,Myanmar,2017,2514,7608,-5094
KOR,Korea,MMR,Myanmar,2008,883,517,366
KOR,Korea,MMR,Myanmar,2009,972,1743,-771
KOR,Korea,MMR,Myanmar,2010,716,618,98
KOR,Korea,MMR,Myanmar,2011,813,2571,-1758
KOR,Korea,MMR,Myanmar,2012,1479,4148,-2669
KOR,Korea,MMR,Myanmar,2013,1187,4560,-3373
KOR,Korea,MMR,Myanmar,2014,1994,5106,-3112
KOR,Korea,MMR,Myanmar,2015,1864,5208,-3344
KOR,Korea,MMR,Myanmar,2016,3373,6671,-3298
KOR,Korea,MMR,Myanmar,2017,3931,6307,-2376
LUX,Luxembourg,MMR,Myanmar,2008,0,0,0
LUX,Luxembourg,MMR,Myanmar,2009,0,0,0
LUX,Luxembourg,MMR,Myanmar,2010,0,0,0
LUX,Luxembourg,MMR,Myanmar,2011,0,0,0
LUX,Luxembourg,MMR,Myanmar,2012,0,0,0
LUX,Luxembourg,MMR,Myanmar,2013,0,0,0
LUX,Luxembourg,MMR,Myanmar,2014,0,1,-1
LUX,Luxembourg,MMR,Myanmar,2015,0,0,0
LUX,Luxembourg,MMR,Myanmar,2016,0,1,-1
LUX,Luxembourg,MMR,Myanmar,2017,1,5,-4
MEX,Mexico,MMR,Myanmar,2011,0,4,-4
MEX,Mexico,MMR,Myanmar,2012,0,0,0
MEX,Mexico,MMR,Myanmar,2013,0,0,0
MEX,Mexico,MMR,Myanmar,2014,0,0,0
MEX,Mexico,MMR,Myanmar,2015,0,1,-1
NLD,Netherlands,MMR,Myanmar,2008,6,13,-7
NLD,Netherlands,MMR,Myanmar,2009,3,26,-23
NLD,Netherlands,MMR,Myanmar,2010,7,86,-79
NLD,Netherlands,MMR,Myanmar,2011,7,57,-50
NLD,Netherlands,MMR,Myanmar,2012,9,29,-20
NLD,Netherlands,MMR,Myanmar,2013,7,51,-44
NLD,Netherlands,MMR,Myanmar,2014,14,55,-41
NLD,Netherlands,MMR,Myanmar,2015,14,51,-37
NLD,Netherlands,MMR,Myanmar,2016,13,45,-32
NLD,Netherlands,MMR,Myanmar,2017,12,69,-57
NZL,New Zealand,MMR,Myanmar,2008,1,146,-145
NZL,New Zealand,MMR,Myanmar,2009,2,210,-208
NZL,New Zealand,MMR,Myanmar,2010,6,222,-216
NZL,New Zealand,MMR,Myanmar,2011,5,248,-243
NZL,New Zealand,MMR,Myanmar,2012,5,331,-326
NZL,New Zealand,MMR,Myanmar,2013,2,277,-275
NZL,New Zealand,MMR,Myanmar,2014,8,215,-207
NZL,New Zealand,MMR,Myanmar,2015,13,272,-259
NZL,New Zealand,MMR,Myanmar,2016,17,228,-211
NZL,New Zealand,MMR,Myanmar,2017,12,212,-200
NOR,Norway,MMR,Myanmar,2008,0,405,-405
NOR,Norway,MMR,Myanmar,2009,9,364,-355
NOR,Norway,MMR,Myanmar,2010,10,279,-269
NOR,Norway,MMR,Myanmar,2011,29,151,-122
NOR,Norway,MMR,Myanmar,2012,22,340,-318
NOR,Norway,MMR,Myanmar,2013,18,67,-49
NOR,Norway,MMR,Myanmar,2014,17,40,-23
NOR,Norway,MMR,Myanmar,2015,34,34,0
NOR,Norway,MMR,Myanmar,2016,15,68,-53
NOR,Norway,MMR,Myanmar,2017,10,40,-30
POL,Poland,MMR,Myanmar,2009,0,3,-3
POL,Poland,MMR,Myanmar,2010,0,8,-8
POL,Poland,MMR,Myanmar,2011,0,9,-9
POL,Poland,MMR,Myanmar,2012,0,11,-11
POL,Poland,MMR,Myanmar,2013,0,10,-10
POL,Poland,MMR,Myanmar,2014,0,7,-7
POL,Poland,MMR,Myanmar,2015,0,3,-3
POL,Poland,MMR,Myanmar,2016,0,6,-6
POL,Poland,MMR,Myanmar,2017,0,5,-5
SVK,Slovak Republic,MMR,Myanmar,2008,0,0,0
ESP,Spain,MMR,Myanmar,2008,0,5,-5
ESP,Spain,MMR,Myanmar,2009,2,2,0
ESP,Spain,MMR,Myanmar,2010,1,6,-5
ESP,Spain,MMR,Myanmar,2011,4,6,-2
ESP,Spain,MMR,Myanmar,2012,1,10,-9
ESP,Spain,MMR,Myanmar,2013,0,5,-5
ESP,Spain,MMR,Myanmar,2014,1,8,-7
ESP,Spain,MMR,Myanmar,2015,2,7,-5
ESP,Spain,MMR,Myanmar,2016,1,6,-5
ESP,Spain,MMR,Myanmar,2017,4,9,-5
SWE,Sweden,MMR,Myanmar,2008,5,249,-244
SWE,Sweden,MMR,Myanmar,2009,2,196,-194
SWE,Sweden,MMR,Myanmar,2010,4,91,-87
SWE,Sweden,MMR,Myanmar,2011,2,41,-39
SWE,Sweden,MMR,Myanmar,2012,5,54,-49
SWE,Sweden,MMR,Myanmar,2013,7,23,-16
SWE,Sweden,MMR,Myanmar,2014,6,17,-11
SWE,Sweden,MMR,Myanmar,2015,6,12,-6
SWE,Sweden,MMR,Myanmar,2016,6,18,-12
SWE,Sweden,MMR,Myanmar,2017,7,22,-15
CHE,Switzerland,MMR,Myanmar,2010,8,11,-3
CHE,Switzerland,MMR,Myanmar,2011,6,19,-13
CHE,Switzerland,MMR,Myanmar,2012,4,16,-12
CHE,Switzerland,MMR,Myanmar,2013,5,17,-12
CHE,Switzerland,MMR,Myanmar,2014,10,28,-18
CHE,Switzerland,MMR,Myanmar,2015,13,31,-18
CHE,Switzerland,MMR,Myanmar,2016,25,49,-24
CHE,Switzerland,MMR,Myanmar,2017,29,68,-39
TUR,Turkey,MMR,Myanmar,2010,0,10,-10
USA,United States,MMR,Myanmar,2008,0,3403,-3403
USA,United States,MMR,Myanmar,2009,0,13621,-13621
USA,United States,MMR,Myanmar,2010,0,12925,-12925
USA,United States,MMR,Myanmar,2011,0,16518,-16518
USA,United States,MMR,Myanmar,2012,0,17383,-17383
USA,United States,MMR,Myanmar,2013,0,12565,-12565
USA,United States,MMR,Myanmar,2014,0,11144,-11144
USA,United States,MMR,Myanmar,2015,0,12808,-12808
USA,United States,MMR,Myanmar,2016,0,13065,-13065
USA,United States,MMR,Myanmar,2017,0,12897,-12897
CHL,Chile,MMR,Myanmar,2008,0,1,-1
CHL,Chile,MMR,Myanmar,2009,0,0,0
CHL,Chile,MMR,Myanmar,2010,0,0,0
CHL,Chile,MMR,Myanmar,2011,0,0,0
CHL,Chile,MMR,Myanmar,2012,0,0,0
CHL,Chile,MMR,Myanmar,2013,0,0,0
CHL,Chile,MMR,Myanmar,2014,0,0,0
CHL,Chile,MMR,Myanmar,2015,0,1,-1
CHL,Chile,MMR,Myanmar,2016,0,0,0
EST,Estonia,MMR,Myanmar,2008,0,0,0
EST,Estonia,MMR,Myanmar,2009,0,0,0
EST,Estonia,MMR,Myanmar,2010,0,0,0
EST,Estonia,MMR,Myanmar,2011,0,0,0
EST,Estonia,MMR,Myanmar,2012,0,0,0
EST,Estonia,MMR,Myanmar,2013,0,1,-1
EST,Estonia,MMR,Myanmar,2014,0,0,0
EST,Estonia,MMR,Myanmar,2015,0,0,0
EST,Estonia,MMR,Myanmar,2016,0,0,0
EST,Estonia,MMR,Myanmar,2017,0,0,0
SVN,Slovenia,MMR,Myanmar,2016,0,1,-1
AUS,Australia,NAM,Namibia,2008,5,21,-16
AUS,Australia,NAM,Namibia,2009,7,18,-11
AUS,Australia,NAM,Namibia,2010,8,42,-34
AUS,Australia,NAM,Namibia,2011,0,27,-27
AUS,Australia,NAM,Namibia,2012,6,22,-16
AUS,Australia,NAM,Namibia,2013,7,18,-11
AUS,Australia,NAM,Namibia,2014,8,20,-12
AUS,Australia,NAM,Namibia,2015,0,11,-11
AUS,Australia,NAM,Namibia,2016,0,10,-10
AUS,Australia,NAM,Namibia,2017,0,18,-18
AUT,Austria,NAM,Namibia,2008,5,6,-1
AUT,Austria,NAM,Namibia,2009,1,4,-3
AUT,Austria,NAM,Namibia,2010,6,9,-3
AUT,Austria,NAM,Namibia,2011,4,11,-7
AUT,Austria,NAM,Namibia,2012,5,13,-8
AUT,Austria,NAM,Namibia,2013,8,6,2
AUT,Austria,NAM,Namibia,2014,4,11,-7
AUT,Austria,NAM,Namibia,2015,9,7,2
AUT,Austria,NAM,Namibia,2016,4,6,-2
AUT,Austria,NAM,Namibia,2017,4,4,0
BEL,Belgium,NAM,Namibia,2008,0,4,-4
BEL,Belgium,NAM,Namibia,2009,0,4,-4
BEL,Belgium,NAM,Namibia,2010,1,3,-2
BEL,Belgium,NAM,Namibia,2012,3,5,-2
BEL,Belgium,NAM,Namibia,2013,2,1,1
BEL,Belgium,NAM,Namibia,2014,1,6,-5
BEL,Belgium,NAM,Namibia,2015,2,2,0
BEL,Belgium,NAM,Namibia,2016,1,6,-5
BEL,Belgium,NAM,Namibia,2017,1,3,-2
CAN,Canada,NAM,Namibia,2008,0,26,-26
CAN,Canada,NAM,Namibia,2009,0,14,-14
CAN,Canada,NAM,Namibia,2010,0,16,-16
CAN,Canada,NAM,Namibia,2011,0,22,-22
CAN,Canada,NAM,Namibia,2012,0,24,-24
CAN,Canada,NAM,Namibia,2013,0,83,-83
CAN,Canada,NAM,Namibia,2014,0,120,-120
CAN,Canada,NAM,Namibia,2015,0,102,-102
CAN,Canada,NAM,Namibia,2016,0,70,-70
CAN,Canada,NAM,Namibia,2017,0,120,-120
CZE,Czech Republic,NAM,Namibia,2008,0,2,-2
CZE,Czech Republic,NAM,Namibia,2009,0,2,-2
CZE,Czech Republic,NAM,Namibia,2010,0,3,-3
CZE,Czech Republic,NAM,Namibia,2011,0,2,-2
CZE,Czech Republic,NAM,Namibia,2012,3,2,1
CZE,Czech Republic,NAM,Namibia,2013,0,1,-1
CZE,Czech Republic,NAM,Namibia,2014,2,1,1
CZE,Czech Republic,NAM,Namibia,2015,3,2,1
CZE,Czech Republic,NAM,Namibia,2016,5,5,0
CZE,Czech Republic,NAM,Namibia,2017,2,4,-2
DNK,Denmark,NAM,Namibia,2008,1,0,1
DNK,Denmark,NAM,Namibia,2009,2,0,2
DNK,Denmark,NAM,Namibia,2010,1,2,-1
DNK,Denmark,NAM,Namibia,2011,0,3,-3
DNK,Denmark,NAM,Namibia,2012,1,2,-1
DNK,Denmark,NAM,Namibia,2013,1,4,-3
DNK,Denmark,NAM,Namibia,2014,1,4,-3
DNK,Denmark,NAM,Namibia,2015,1,2,-1
DNK,Denmark,NAM,Namibia,2016,1,2,-1
DNK,Denmark,NAM,Namibia,2017,3,2,1
FIN,Finland,NAM,Namibia,2008,2,1,1
FIN,Finland,NAM,Namibia,2009,0,7,-7
FIN,Finland,NAM,Namibia,2010,0,2,-2
FIN,Finland,NAM,Namibia,2011,0,2,-2
FIN,Finland,NAM,Namibia,2012,0,3,-3
FIN,Finland,NAM,Namibia,2013,0,9,-9
FIN,Finland,NAM,Namibia,2014,2,6,-4
FIN,Finland,NAM,Namibia,2015,0,3,-3
FIN,Finland,NAM,Namibia,2016,3,4,-1
FIN,Finland,NAM,Namibia,2017,0,53,-53
FRA,France,NAM,Namibia,2008,0,3,-3
FRA,France,NAM,Namibia,2009,0,1,-1
FRA,France,NAM,Namibia,2010,0,5,-5
FRA,France,NAM,Namibia,2011,0,5,-5
FRA,France,NAM,Namibia,2012,0,2,-2
FRA,France,NAM,Namibia,2013,0,4,-4
FRA,France,NAM,Namibia,2014,0,0,0
FRA,France,NAM,Namibia,2015,0,1,-1
FRA,France,NAM,Namibia,2016,0,6,-6
FRA,France,NAM,Namibia,2017,0,4,-4
DEU,Germany,NAM,Namibia,2008,60,90,-30
DEU,Germany,NAM,Namibia,2009,71,99,-28
DEU,Germany,NAM,Namibia,2010,104,124,-20
DEU,Germany,NAM,Namibia,2011,52,120,-68
DEU,Germany,NAM,Namibia,2012,81,115,-34
DEU,Germany,NAM,Namibia,2013,83,107,-24
DEU,Germany,NAM,Namibia,2014,77,91,-14
DEU,Germany,NAM,Namibia,2015,63,116,-53
DEU,Germany,NAM,Namibia,2016,64,109,-45
DEU,Germany,NAM,Namibia,2017,64,88,-24
HUN,Hungary,NAM,Namibia,2008,0,0,0
HUN,Hungary,NAM,Namibia,2009,0,0,0
HUN,Hungary,NAM,Namibia,2010,0,3,-3
HUN,Hungary,NAM,Namibia,2011,0,0,0
HUN,Hungary,NAM,Namibia,2012,0,2,-2
HUN,Hungary,NAM,Namibia,2013,0,0,0
HUN,Hungary,NAM,Namibia,2014,1,8,-7
HUN,Hungary,NAM,Namibia,2015,1,7,-6
HUN,Hungary,NAM,Namibia,2016,0,4,-4
HUN,Hungary,NAM,Namibia,2017,0,5,-5
ISL,Iceland,NAM,Namibia,2008,0,6,-6
ISL,Iceland,NAM,Namibia,2009,3,1,2
ISL,Iceland,NAM,Namibia,2010,2,2,0
ISL,Iceland,NAM,Namibia,2011,1,0,1
ISL,Iceland,NAM,Namibia,2012,0,4,-4
ISL,Iceland,NAM,Namibia,2013,2,3,-1
ISL,Iceland,NAM,Namibia,2014,4,1,3
ISL,Iceland,NAM,Namibia,2015,1,4,-3
ISL,Iceland,NAM,Namibia,2016,2,5,-3
ISL,Iceland,NAM,Namibia,2017,4,2,2
ITA,Italy,NAM,Namibia,2008,0,6,-6
ITA,Italy,NAM,Namibia,2009,0,3,-3
ITA,Italy,NAM,Namibia,2010,0,2,-2
ITA,Italy,NAM,Namibia,2011,0,7,-7
ITA,Italy,NAM,Namibia,2012,1,2,-1
ITA,Italy,NAM,Namibia,2013,1,4,-3
ITA,Italy,NAM,Namibia,2014,3,1,2
ITA,Italy,NAM,Namibia,2015,0,1,-1
ITA,Italy,NAM,Namibia,2016,0,2,-2
ITA,Italy,NAM,Namibia,2017,0,1,-1
JPN,Japan,NAM,Namibia,2008,46,53,-7
JPN,Japan,NAM,Namibia,2009,41,34,7
JPN,Japan,NAM,Namibia,2010,46,54,-8
JPN,Japan,NAM,Namibia,2011,51,51,0
JPN,Japan,NAM,Namibia,2012,78,80,-2
JPN,Japan,NAM,Namibia,2013,137,138,-1
JPN,Japan,NAM,Namibia,2014,58,65,-7
JPN,Japan,NAM,Namibia,2015,56,64,-8
JPN,Japan,NAM,Namibia,2016,64,67,-3
JPN,Japan,NAM,Namibia,2017,28,23,5
KOR,Korea,NAM,Namibia,2008,0,0,0
KOR,Korea,NAM,Namibia,2009,0,0,0
KOR,Korea,NAM,Namibia,2010,1,1,0
KOR,Korea,NAM,Namibia,2011,0,0,0
KOR,Korea,NAM,Namibia,2012,3,0,3
KOR,Korea,NAM,Namibia,2013,0,0,0
KOR,Korea,NAM,Namibia,2014,0,0,0
KOR,Korea,NAM,Namibia,2015,1,1,0
KOR,Korea,NAM,Namibia,2016,2,2,0
KOR,Korea,NAM,Namibia,2017,1,1,0
LUX,Luxembourg,NAM,Namibia,2008,1,1,0
LUX,Luxembourg,NAM,Namibia,2009,0,0,0
LUX,Luxembourg,NAM,Namibia,2010,0,1,-1
LUX,Luxembourg,NAM,Namibia,2011,0,0,0
LUX,Luxembourg,NAM,Namibia,2012,0,0,0
LUX,Luxembourg,NAM,Namibia,2013,0,1,-1
LUX,Luxembourg,NAM,Namibia,2014,0,0,0
LUX,Luxembourg,NAM,Namibia,2015,1,3,-2
LUX,Luxembourg,NAM,Namibia,2016,0,0,0
LUX,Luxembourg,NAM,Namibia,2017,2,2,0
MEX,Mexico,NAM,Namibia,2010,0,1,-1
MEX,Mexico,NAM,Namibia,2012,0,0,0
MEX,Mexico,NAM,Namibia,2013,0,0,0
MEX,Mexico,NAM,Namibia,2014,0,0,0
NLD,Netherlands,NAM,Namibia,2008,8,23,-15
NLD,Netherlands,NAM,Namibia,2009,25,17,8
NLD,Netherlands,NAM,Namibia,2010,16,13,3
NLD,Netherlands,NAM,Namibia,2011,10,17,-7
NLD,Netherlands,NAM,Namibia,2012,13,20,-7
NLD,Netherlands,NAM,Namibia,2013,20,21,-1
NLD,Netherlands,NAM,Namibia,2014,12,14,-2
NLD,Netherlands,NAM,Namibia,2015,24,16,8
NLD,Netherlands,NAM,Namibia,2016,7,14,-7
NLD,Netherlands,NAM,Namibia,2017,6,34,-28
NZL,New Zealand,NAM,Namibia,2008,2,4,-2
NZL,New Zealand,NAM,Namibia,2009,0,3,-3
NZL,New Zealand,NAM,Namibia,2010,3,5,-2
NZL,New Zealand,NAM,Namibia,2011,3,6,-3
NZL,New Zealand,NAM,Namibia,2012,4,11,-7
NZL,New Zealand,NAM,Namibia,2013,0,1,-1
NZL,New Zealand,NAM,Namibia,2014,1,3,-2
NZL,New Zealand,NAM,Namibia,2016,4,6,-2
NZL,New Zealand,NAM,Namibia,2017,4,23,-19
NOR,Norway,NAM,Namibia,2008,4,4,0
NOR,Norway,NAM,Namibia,2009,3,5,-2
NOR,Norway,NAM,Namibia,2010,4,7,-3
NOR,Norway,NAM,Namibia,2011,14,13,1
NOR,Norway,NAM,Namibia,2012,7,10,-3
NOR,Norway,NAM,Namibia,2013,4,4,0
NOR,Norway,NAM,Namibia,2014,8,7,1
NOR,Norway,NAM,Namibia,2015,4,3,1
NOR,Norway,NAM,Namibia,2016,6,5,1
NOR,Norway,NAM,Namibia,2017,3,6,-3
POL,Poland,NAM,Namibia,2009,0,0,0
POL,Poland,NAM,Namibia,2010,0,3,-3
POL,Poland,NAM,Namibia,2011,0,1,-1
POL,Poland,NAM,Namibia,2012,0,2,-2
POL,Poland,NAM,Namibia,2013,0,1,-1
POL,Poland,NAM,Namibia,2014,0,0,0
POL,Poland,NAM,Namibia,2015,0,3,-3
POL,Poland,NAM,Namibia,2016,0,6,-6
POL,Poland,NAM,Namibia,2017,0,7,-7
SVK,Slovak Republic,NAM,Namibia,2008,2,1,1
SVK,Slovak Republic,NAM,Namibia,2009,0,3,-3
SVK,Slovak Republic,NAM,Namibia,2011,0,1,-1
ESP,Spain,NAM,Namibia,2008,2,7,-5
ESP,Spain,NAM,Namibia,2009,1,5,-4
ESP,Spain,NAM,Namibia,2010,3,3,0
ESP,Spain,NAM,Namibia,2011,2,10,-8
ESP,Spain,NAM,Namibia,2012,1,9,-8
ESP,Spain,NAM,Namibia,2013,4,10,-6
ESP,Spain,NAM,Namibia,2014,2,6,-4
ESP,Spain,NAM,Namibia,2015,0,6,-6
ESP,Spain,NAM,Namibia,2016,1,11,-10
ESP,Spain,NAM,Namibia,2017,4,19,-15
SWE,Sweden,NAM,Namibia,2008,3,1,2
SWE,Sweden,NAM,Namibia,2009,2,18,-16
SWE,Sweden,NAM,Namibia,2010,2,9,-7
SWE,Sweden,NAM,Namibia,2011,4,23,-19
SWE,Sweden,NAM,Namibia,2012,1,12,-11
SWE,Sweden,NAM,Namibia,2013,2,18,-16
SWE,Sweden,NAM,Namibia,2014,2,2,0
SWE,Sweden,NAM,Namibia,2015,2,6,-4
SWE,Sweden,NAM,Namibia,2016,1,10,-9
SWE,Sweden,NAM,Namibia,2017,5,13,-8
CHE,Switzerland,NAM,Namibia,2010,4,4,0
CHE,Switzerland,NAM,Namibia,2011,0,2,-2
CHE,Switzerland,NAM,Namibia,2012,6,6,0
CHE,Switzerland,NAM,Namibia,2013,3,6,-3
CHE,Switzerland,NAM,Namibia,2014,2,5,-3
CHE,Switzerland,NAM,Namibia,2015,6,7,-1
CHE,Switzerland,NAM,Namibia,2016,0,5,-5
CHE,Switzerland,NAM,Namibia,2017,1,6,-5
TUR,Turkey,NAM,Namibia,2010,0,1,-1
USA,United States,NAM,Namibia,2008,0,46,-46
USA,United States,NAM,Namibia,2009,0,53,-53
USA,United States,NAM,Namibia,2010,0,60,-60
USA,United States,NAM,Namibia,2011,0,43,-43
USA,United States,NAM,Namibia,2012,0,59,-59
USA,United States,NAM,Namibia,2013,0,57,-57
USA,United States,NAM,Namibia,2014,0,44,-44
USA,United States,NAM,Namibia,2015,0,86,-86
USA,United States,NAM,Namibia,2016,0,87,-87
USA,United States,NAM,Namibia,2017,0,130,-130
CHL,Chile,NAM,Namibia,2008,0,0,0
CHL,Chile,NAM,Namibia,2009,0,0,0
CHL,Chile,NAM,Namibia,2010,0,0,0
CHL,Chile,NAM,Namibia,2011,0,1,-1
CHL,Chile,NAM,Namibia,2012,0,0,0
CHL,Chile,NAM,Namibia,2013,0,0,0
CHL,Chile,NAM,Namibia,2014,0,0,0
CHL,Chile,NAM,Namibia,2015,0,4,-4
CHL,Chile,NAM,Namibia,2016,0,0,0
EST,Estonia,NAM,Namibia,2008,0,0,0
EST,Estonia,NAM,Namibia,2009,0,0,0
EST,Estonia,NAM,Namibia,2010,0,0,0
EST,Estonia,NAM,Namibia,2011,0,0,0
EST,Estonia,NAM,Namibia,2012,0,0,0
EST,Estonia,NAM,Namibia,2013,0,0,0
EST,Estonia,NAM,Namibia,2014,0,1,-1
EST,Estonia,NAM,Namibia,2015,0,3,-3
EST,Estonia,NAM,Namibia,2016,0,1,-1
EST,Estonia,NAM,Namibia,2017,0,2,-2
SVN,Slovenia,NAM,Namibia,2015,0,1,-1
AUS,Australia,NRU,Nauru,2008,6,13,-7
AUS,Australia,NRU,Nauru,2009,0,11,-11
AUS,Australia,NRU,Nauru,2010,8,10,-2
AUS,Australia,NRU,Nauru,2011,0,2,-2
AUS,Australia,NRU,Nauru,2012,8,19,-11
AUS,Australia,NRU,Nauru,2013,0,11,-11
AUS,Australia,NRU,Nauru,2014,8,0,8
AUS,Australia,NRU,Nauru,2015,0,8,-8
AUS,Australia,NRU,Nauru,2016,0,8,-8
AUS,Australia,NRU,Nauru,2017,0,7,-7
AUT,Austria,NRU,Nauru,2008,0,0,0
AUT,Austria,NRU,Nauru,2009,0,0,0
AUT,Austria,NRU,Nauru,2010,0,0,0
AUT,Austria,NRU,Nauru,2011,0,0,0
AUT,Austria,NRU,Nauru,2012,0,0,0
AUT,Austria,NRU,Nauru,2013,0,0,0
AUT,Austria,NRU,Nauru,2014,0,0,0
AUT,Austria,NRU,Nauru,2015,0,0,0
AUT,Austria,NRU,Nauru,2016,0,0,0
AUT,Austria,NRU,Nauru,2017,0,1,-1
BEL,Belgium,NRU,Nauru,2010,0,0,0
CAN,Canada,NRU,Nauru,2008,0,0,0
CAN,Canada,NRU,Nauru,2009,0,1,-1
CAN,Canada,NRU,Nauru,2010,0,0,0
CAN,Canada,NRU,Nauru,2011,0,0,0
CAN,Canada,NRU,Nauru,2012,0,0,0
CAN,Canada,NRU,Nauru,2013,0,1,-1
CAN,Canada,NRU,Nauru,2014,0,1,-1
CAN,Canada,NRU,Nauru,2015,0,0,0
CAN,Canada,NRU,Nauru,2016,0,0,0
CAN,Canada,NRU,Nauru,2017,0,0,0
DNK,Denmark,NRU,Nauru,2013,0,0,0
DNK,Denmark,NRU,Nauru,2014,0,0,0
DNK,Denmark,NRU,Nauru,2015,0,0,0
DNK,Denmark,NRU,Nauru,2016,1,0,1
DNK,Denmark,NRU,Nauru,2017,1,0,1
FIN,Finland,NRU,Nauru,2008,0,0,0
FIN,Finland,NRU,Nauru,2009,0,0,0
FIN,Finland,NRU,Nauru,2010,0,0,0
FIN,Finland,NRU,Nauru,2011,0,0,0
FIN,Finland,NRU,Nauru,2012,0,0,0
FIN,Finland,NRU,Nauru,2013,0,0,0
FIN,Finland,NRU,Nauru,2014,0,0,0
FIN,Finland,NRU,Nauru,2015,0,0,0
FIN,Finland,NRU,Nauru,2016,0,0,0
FIN,Finland,NRU,Nauru,2017,0,0,0
FRA,France,NRU,Nauru,2008,0,0,0
FRA,France,NRU,Nauru,2009,0,0,0
FRA,France,NRU,Nauru,2010,0,0,0
FRA,France,NRU,Nauru,2011,0,1,-1
FRA,France,NRU,Nauru,2012,0,0,0
FRA,France,NRU,Nauru,2013,0,0,0
FRA,France,NRU,Nauru,2014,0,0,0
FRA,France,NRU,Nauru,2015,0,0,0
FRA,France,NRU,Nauru,2016,0,0,0
FRA,France,NRU,Nauru,2017,0,0,0
DEU,Germany,NRU,Nauru,2008,0,0,0
DEU,Germany,NRU,Nauru,2009,0,0,0
DEU,Germany,NRU,Nauru,2010,0,0,0
DEU,Germany,NRU,Nauru,2011,0,0,0
DEU,Germany,NRU,Nauru,2012,0,1,-1
DEU,Germany,NRU,Nauru,2013,0,0,0
DEU,Germany,NRU,Nauru,2014,0,0,0
DEU,Germany,NRU,Nauru,2015,0,2,-2
DEU,Germany,NRU,Nauru,2016,0,0,0
DEU,Germany,NRU,Nauru,2017,0,0,0
HUN,Hungary,NRU,Nauru,2008,0,0,0
HUN,Hungary,NRU,Nauru,2009,0,0,0
HUN,Hungary,NRU,Nauru,2010,0,0,0
HUN,Hungary,NRU,Nauru,2011,0,0,0
HUN,Hungary,NRU,Nauru,2012,0,0,0
HUN,Hungary,NRU,Nauru,2013,0,0,0
HUN,Hungary,NRU,Nauru,2014,0,0,0
HUN,Hungary,NRU,Nauru,2015,0,0,0
HUN,Hungary,NRU,Nauru,2016,0,0,0
HUN,Hungary,NRU,Nauru,2017,0,0,0
ISL,Iceland,NRU,Nauru,2008,1,0,1
ISL,Iceland,NRU,Nauru,2009,0,0,0
ISL,Iceland,NRU,Nauru,2010,0,0,0
ISL,Iceland,NRU,Nauru,2011,0,0,0
ISL,Iceland,NRU,Nauru,2012,0,0,0
ISL,Iceland,NRU,Nauru,2013,0,0,0
ISL,Iceland,NRU,Nauru,2014,0,0,0
ISL,Iceland,NRU,Nauru,2015,0,0,0
ISL,Iceland,NRU,Nauru,2016,0,0,0
ISL,Iceland,NRU,Nauru,2017,0,0,0
ITA,Italy,NRU,Nauru,2008,0,0,0
ITA,Italy,NRU,Nauru,2009,0,0,0
ITA,Italy,NRU,Nauru,2010,0,0,0
ITA,Italy,NRU,Nauru,2011,0,0,0
ITA,Italy,NRU,Nauru,2012,0,0,0
ITA,Italy,NRU,Nauru,2013,0,0,0
ITA,Italy,NRU,Nauru,2014,0,0,0
ITA,Italy,NRU,Nauru,2015,0,0,0
ITA,Italy,NRU,Nauru,2016,0,0,0
ITA,Italy,NRU,Nauru,2017,0,0,0
JPN,Japan,NRU,Nauru,2008,9,7,2
JPN,Japan,NRU,Nauru,2009,11,12,-1
JPN,Japan,NRU,Nauru,2010,12,12,0
JPN,Japan,NRU,Nauru,2011,5,5,0
JPN,Japan,NRU,Nauru,2012,11,10,1
JPN,Japan,NRU,Nauru,2013,4,4,0
JPN,Japan,NRU,Nauru,2014,13,13,0
JPN,Japan,NRU,Nauru,2015,26,28,-2
JPN,Japan,NRU,Nauru,2016,18,17,1
JPN,Japan,NRU,Nauru,2017,28,28,0
KOR,Korea,NRU,Nauru,2008,0,0,0
KOR,Korea,NRU,Nauru,2009,0,0,0
KOR,Korea,NRU,Nauru,2010,1,0,1
KOR,Korea,NRU,Nauru,2011,0,1,-1
KOR,Korea,NRU,Nauru,2012,2,2,0
KOR,Korea,NRU,Nauru,2013,0,0,0
KOR,Korea,NRU,Nauru,2014,0,0,0
KOR,Korea,NRU,Nauru,2015,1,0,1
KOR,Korea,NRU,Nauru,2016,0,0,0
KOR,Korea,NRU,Nauru,2017,2,0,2
LUX,Luxembourg,NRU,Nauru,2008,0,0,0
LUX,Luxembourg,NRU,Nauru,2009,0,0,0
LUX,Luxembourg,NRU,Nauru,2010,0,0,0
LUX,Luxembourg,NRU,Nauru,2011,0,0,0
LUX,Luxembourg,NRU,Nauru,2012,0,0,0
LUX,Luxembourg,NRU,Nauru,2013,0,0,0
LUX,Luxembourg,NRU,Nauru,2014,0,0,0
LUX,Luxembourg,NRU,Nauru,2015,0,0,0
LUX,Luxembourg,NRU,Nauru,2016,0,0,0
LUX,Luxembourg,NRU,Nauru,2017,0,0,0
MEX,Mexico,NRU,Nauru,2012,0,0,0
MEX,Mexico,NRU,Nauru,2013,0,0,0
MEX,Mexico,NRU,Nauru,2014,0,0,0
NZL,New Zealand,NRU,Nauru,2008,4,0,4
NZL,New Zealand,NRU,Nauru,2009,0,1,-1
NZL,New Zealand,NRU,Nauru,2010,1,2,-1
NZL,New Zealand,NRU,Nauru,2011,3,3,0
NZL,New Zealand,NRU,Nauru,2012,0,11,-11
NZL,New Zealand,NRU,Nauru,2013,2,15,-13
NZL,New Zealand,NRU,Nauru,2014,2,9,-7
NZL,New Zealand,NRU,Nauru,2015,8,5,3
NZL,New Zealand,NRU,Nauru,2016,8,4,4
NZL,New Zealand,NRU,Nauru,2017,5,5,0
NOR,Norway,NRU,Nauru,2008,0,0,0
NOR,Norway,NRU,Nauru,2009,0,0,0
NOR,Norway,NRU,Nauru,2010,0,0,0
NOR,Norway,NRU,Nauru,2011,0,0,0
NOR,Norway,NRU,Nauru,2012,0,0,0
NOR,Norway,NRU,Nauru,2013,0,0,0
NOR,Norway,NRU,Nauru,2014,0,0,0
NOR,Norway,NRU,Nauru,2015,0,0,0
NOR,Norway,NRU,Nauru,2016,0,0,0
NOR,Norway,NRU,Nauru,2017,0,0,0
POL,Poland,NRU,Nauru,2009,0,0,0
POL,Poland,NRU,Nauru,2010,0,0,0
POL,Poland,NRU,Nauru,2011,0,0,0
POL,Poland,NRU,Nauru,2012,0,0,0
POL,Poland,NRU,Nauru,2013,0,0,0
POL,Poland,NRU,Nauru,2014,0,0,0
POL,Poland,NRU,Nauru,2015,0,0,0
POL,Poland,NRU,Nauru,2016,0,0,0
POL,Poland,NRU,Nauru,2017,0,0,0
SVK,Slovak Republic,NRU,Nauru,2008,0,0,0
ESP,Spain,NRU,Nauru,2008,0,0,0
ESP,Spain,NRU,Nauru,2009,0,1,-1
ESP,Spain,NRU,Nauru,2010,0,0,0
ESP,Spain,NRU,Nauru,2011,6,0,6
ESP,Spain,NRU,Nauru,2012,0,1,-1
ESP,Spain,NRU,Nauru,2013,0,0,0
ESP,Spain,NRU,Nauru,2014,0,0,0
ESP,Spain,NRU,Nauru,2015,0,0,0
ESP,Spain,NRU,Nauru,2016,0,0,0
ESP,Spain,NRU,Nauru,2017,0,1,-1
SWE,Sweden,NRU,Nauru,2008,0,0,0
SWE,Sweden,NRU,Nauru,2009,0,0,0
SWE,Sweden,NRU,Nauru,2010,0,0,0
SWE,Sweden,NRU,Nauru,2011,0,0,0
SWE,Sweden,NRU,Nauru,2012,0,0,0
SWE,Sweden,NRU,Nauru,2013,0,0,0
SWE,Sweden,NRU,Nauru,2014,0,0,0
SWE,Sweden,NRU,Nauru,2015,0,0,0
SWE,Sweden,NRU,Nauru,2016,0,0,0
SWE,Sweden,NRU,Nauru,2017,0,0,0
CHE,Switzerland,NRU,Nauru,2010,0,0,0
CHE,Switzerland,NRU,Nauru,2011,0,0,0
CHE,Switzerland,NRU,Nauru,2012,0,0,0
CHE,Switzerland,NRU,Nauru,2013,0,0,0
USA,United States,NRU,Nauru,2009,0,0,0
USA,United States,NRU,Nauru,2010,0,0,0
USA,United States,NRU,Nauru,2012,0,8,-8
USA,United States,NRU,Nauru,2013,0,3,-3
USA,United States,NRU,Nauru,2014,0,0,0
USA,United States,NRU,Nauru,2017,0,1,-1
CHL,Chile,NRU,Nauru,2008,0,0,0
CHL,Chile,NRU,Nauru,2009,0,0,0
CHL,Chile,NRU,Nauru,2010,0,0,0
CHL,Chile,NRU,Nauru,2011,0,0,0
CHL,Chile,NRU,Nauru,2012,0,0,0
CHL,Chile,NRU,Nauru,2013,0,0,0
CHL,Chile,NRU,Nauru,2014,0,0,0
CHL,Chile,NRU,Nauru,2015,0,0,0
CHL,Chile,NRU,Nauru,2016,0,0,0
EST,Estonia,NRU,Nauru,2008,0,0,0
EST,Estonia,NRU,Nauru,2009,0,0,0
EST,Estonia,NRU,Nauru,2010,0,0,0
EST,Estonia,NRU,Nauru,2011,0,0,0
EST,Estonia,NRU,Nauru,2012,0,0,0
EST,Estonia,NRU,Nauru,2013,0,0,0
EST,Estonia,NRU,Nauru,2014,0,0,0
EST,Estonia,NRU,Nauru,2015,0,0,0
EST,Estonia,NRU,Nauru,2016,0,0,0
EST,Estonia,NRU,Nauru,2017,0,0,0
AUS,Australia,NPL,Nepal,2008,31,883,-852
AUS,Australia,NPL,Nepal,2009,20,975,-955
AUS,Australia,NPL,Nepal,2010,16,1262,-1246
AUS,Australia,NPL,Nepal,2011,31,2073,-2042
AUS,Australia,NPL,Nepal,2012,41,2507,-2466
AUS,Australia,NPL,Nepal,2013,29,4042,-4013
AUS,Australia,NPL,Nepal,2014,49,4351,-4302
AUS,Australia,NPL,Nepal,2015,100,4157,-4057
AUS,Australia,NPL,Nepal,2016,100,5060,-4960
AUS,Australia,NPL,Nepal,2017,0,4361,-4361
AUT,Austria,NPL,Nepal,2008,80,91,-11
AUT,Austria,NPL,Nepal,2009,78,82,-4
AUT,Austria,NPL,Nepal,2010,91,93,-2
AUT,Austria,NPL,Nepal,2011,68,106,-38
AUT,Austria,NPL,Nepal,2012,84,120,-36
AUT,Austria,NPL,Nepal,2013,60,84,-24
AUT,Austria,NPL,Nepal,2014,52,90,-38
AUT,Austria,NPL,Nepal,2015,54,108,-54
AUT,Austria,NPL,Nepal,2016,54,111,-57
AUT,Austria,NPL,Nepal,2017,62,91,-29
BEL,Belgium,NPL,Nepal,2008,0,171,-171
BEL,Belgium,NPL,Nepal,2009,0,220,-220
BEL,Belgium,NPL,Nepal,2010,14,216,-202
BEL,Belgium,NPL,Nepal,2011,0,284,-284
BEL,Belgium,NPL,Nepal,2012,168,485,-317
BEL,Belgium,NPL,Nepal,2013,344,276,68
BEL,Belgium,NPL,Nepal,2014,378,232,146
BEL,Belgium,NPL,Nepal,2015,145,202,-57
BEL,Belgium,NPL,Nepal,2016,67,138,-71
BEL,Belgium,NPL,Nepal,2017,49,142,-93
CAN,Canada,NPL,Nepal,2008,0,581,-581
CAN,Canada,NPL,Nepal,2009,0,561,-561
CAN,Canada,NPL,Nepal,2010,0,1392,-1392
CAN,Canada,NPL,Nepal,2011,0,1129,-1129
CAN,Canada,NPL,Nepal,2012,0,1185,-1185
CAN,Canada,NPL,Nepal,2013,0,1308,-1308
CAN,Canada,NPL,Nepal,2014,0,1219,-1219
CAN,Canada,NPL,Nepal,2015,0,1499,-1499
CAN,Canada,NPL,Nepal,2016,0,750,-750
CAN,Canada,NPL,Nepal,2017,0,1110,-1110
CZE,Czech Republic,NPL,Nepal,2008,1,26,-25
CZE,Czech Republic,NPL,Nepal,2009,0,67,-67
CZE,Czech Republic,NPL,Nepal,2010,0,29,-29
CZE,Czech Republic,NPL,Nepal,2011,0,13,-13
CZE,Czech Republic,NPL,Nepal,2012,10,22,-12
CZE,Czech Republic,NPL,Nepal,2013,21,22,-1
CZE,Czech Republic,NPL,Nepal,2014,11,35,-24
CZE,Czech Republic,NPL,Nepal,2015,8,54,-46
CZE,Czech Republic,NPL,Nepal,2016,23,109,-86
CZE,Czech Republic,NPL,Nepal,2017,29,270,-241
DNK,Denmark,NPL,Nepal,2008,85,540,-455
DNK,Denmark,NPL,Nepal,2009,117,248,-131
DNK,Denmark,NPL,Nepal,2010,178,200,-22
DNK,Denmark,NPL,Nepal,2011,162,276,-114
DNK,Denmark,NPL,Nepal,2012,136,331,-195
DNK,Denmark,NPL,Nepal,2013,184,450,-266
DNK,Denmark,NPL,Nepal,2014,192,544,-352
DNK,Denmark,NPL,Nepal,2015,246,725,-479
DNK,Denmark,NPL,Nepal,2016,432,1027,-595
DNK,Denmark,NPL,Nepal,2017,502,751,-249
FIN,Finland,NPL,Nepal,2008,12,234,-222
FIN,Finland,NPL,Nepal,2009,3,223,-220
FIN,Finland,NPL,Nepal,2010,4,258,-254
FIN,Finland,NPL,Nepal,2011,10,269,-259
FIN,Finland,NPL,Nepal,2012,6,386,-380
FIN,Finland,NPL,Nepal,2013,9,334,-325
FIN,Finland,NPL,Nepal,2014,17,342,-325
FIN,Finland,NPL,Nepal,2015,18,372,-354
FIN,Finland,NPL,Nepal,2016,21,356,-335
FIN,Finland,NPL,Nepal,2017,27,321,-294
FRA,France,NPL,Nepal,2008,0,49,-49
FRA,France,NPL,Nepal,2009,0,57,-57
FRA,France,NPL,Nepal,2010,0,69,-69
FRA,France,NPL,Nepal,2011,0,64,-64
FRA,France,NPL,Nepal,2012,0,79,-79
FRA,France,NPL,Nepal,2013,0,103,-103
FRA,France,NPL,Nepal,2014,0,106,-106
FRA,France,NPL,Nepal,2015,0,117,-117
FRA,France,NPL,Nepal,2016,0,122,-122
FRA,France,NPL,Nepal,2017,0,121,-121
DEU,Germany,NPL,Nepal,2008,361,428,-67
DEU,Germany,NPL,Nepal,2009,318,470,-152
DEU,Germany,NPL,Nepal,2010,328,559,-231
DEU,Germany,NPL,Nepal,2011,278,632,-354
DEU,Germany,NPL,Nepal,2012,328,800,-472
DEU,Germany,NPL,Nepal,2013,398,901,-503
DEU,Germany,NPL,Nepal,2014,393,1010,-617
DEU,Germany,NPL,Nepal,2015,532,1213,-681
DEU,Germany,NPL,Nepal,2016,605,1386,-781
DEU,Germany,NPL,Nepal,2017,546,1322,-776
HUN,Hungary,NPL,Nepal,2008,3,13,-10
HUN,Hungary,NPL,Nepal,2009,0,10,-10
HUN,Hungary,NPL,Nepal,2010,4,17,-13
HUN,Hungary,NPL,Nepal,2011,2,10,-8
HUN,Hungary,NPL,Nepal,2012,4,9,-5
HUN,Hungary,NPL,Nepal,2013,4,11,-7
HUN,Hungary,NPL,Nepal,2014,6,10,-4
HUN,Hungary,NPL,Nepal,2015,2,18,-16
HUN,Hungary,NPL,Nepal,2016,5,25,-20
HUN,Hungary,NPL,Nepal,2017,0,51,-51
ISL,Iceland,NPL,Nepal,2008,8,14,-6
ISL,Iceland,NPL,Nepal,2009,7,9,-2
ISL,Iceland,NPL,Nepal,2010,7,9,-2
ISL,Iceland,NPL,Nepal,2011,4,4,0
ISL,Iceland,NPL,Nepal,2012,0,5,-5
ISL,Iceland,NPL,Nepal,2013,7,9,-2
ISL,Iceland,NPL,Nepal,2014,13,13,0
ISL,Iceland,NPL,Nepal,2015,3,9,-6
ISL,Iceland,NPL,Nepal,2016,8,12,-4
ISL,Iceland,NPL,Nepal,2017,12,14,-2
ITA,Italy,NPL,Nepal,2008,2,178,-176
ITA,Italy,NPL,Nepal,2009,2,102,-100
ITA,Italy,NPL,Nepal,2010,0,187,-187
ITA,Italy,NPL,Nepal,2011,8,134,-126
ITA,Italy,NPL,Nepal,2012,14,160,-146
ITA,Italy,NPL,Nepal,2013,8,154,-146
ITA,Italy,NPL,Nepal,2014,12,169,-157
ITA,Italy,NPL,Nepal,2015,15,197,-182
ITA,Italy,NPL,Nepal,2016,0,187,-187
ITA,Italy,NPL,Nepal,2017,21,165,-144
JPN,Japan,NPL,Nepal,2008,352,3593,-3241
JPN,Japan,NPL,Nepal,2009,380,3629,-3249
JPN,Japan,NPL,Nepal,2010,378,2889,-2511
JPN,Japan,NPL,Nepal,2011,446,3541,-3095
JPN,Japan,NPL,Nepal,2012,496,4839,-4343
JPN,Japan,NPL,Nepal,2013,759,8281,-7522
JPN,Japan,NPL,Nepal,2014,759,11529,-10770
JPN,Japan,NPL,Nepal,2015,967,13351,-12384
JPN,Japan,NPL,Nepal,2016,1098,14132,-13034
JPN,Japan,NPL,Nepal,2017,1450,14481,-13031
KOR,Korea,NPL,Nepal,2008,1091,2417,-1326
KOR,Korea,NPL,Nepal,2009,1359,2606,-1247
KOR,Korea,NPL,Nepal,2010,1133,2692,-1559
KOR,Korea,NPL,Nepal,2011,1095,4339,-3244
KOR,Korea,NPL,Nepal,2012,1268,6894,-5626
KOR,Korea,NPL,Nepal,2013,2871,6017,-3146
KOR,Korea,NPL,Nepal,2014,2077,6763,-4686
KOR,Korea,NPL,Nepal,2015,3124,6546,-3422
KOR,Korea,NPL,Nepal,2016,4696,8724,-4028
KOR,Korea,NPL,Nepal,2017,5999,8649,-2650
LUX,Luxembourg,NPL,Nepal,2008,2,15,-13
LUX,Luxembourg,NPL,Nepal,2009,1,16,-15
LUX,Luxembourg,NPL,Nepal,2010,0,13,-13
LUX,Luxembourg,NPL,Nepal,2011,1,10,-9
LUX,Luxembourg,NPL,Nepal,2012,0,15,-15
LUX,Luxembourg,NPL,Nepal,2013,1,31,-30
LUX,Luxembourg,NPL,Nepal,2014,1,28,-27
LUX,Luxembourg,NPL,Nepal,2015,6,50,-44
LUX,Luxembourg,NPL,Nepal,2016,14,27,-13
LUX,Luxembourg,NPL,Nepal,2017,5,52,-47
MEX,Mexico,NPL,Nepal,2008,0,1,-1
MEX,Mexico,NPL,Nepal,2009,0,2,-2
MEX,Mexico,NPL,Nepal,2010,0,2,-2
MEX,Mexico,NPL,Nepal,2011,0,3,-3
MEX,Mexico,NPL,Nepal,2012,0,5,-5
MEX,Mexico,NPL,Nepal,2013,0,7,-7
MEX,Mexico,NPL,Nepal,2014,0,2,-2
MEX,Mexico,NPL,Nepal,2015,0,3,-3
MEX,Mexico,NPL,Nepal,2016,0,2,-2
MEX,Mexico,NPL,Nepal,2017,0,1,-1
NLD,Netherlands,NPL,Nepal,2008,119,172,-53
NLD,Netherlands,NPL,Nepal,2009,70,191,-121
NLD,Netherlands,NPL,Nepal,2010,127,168,-41
NLD,Netherlands,NPL,Nepal,2011,133,142,-9
NLD,Netherlands,NPL,Nepal,2012,110,144,-34
NLD,Netherlands,NPL,Nepal,2013,113,169,-56
NLD,Netherlands,NPL,Nepal,2014,77,232,-155
NLD,Netherlands,NPL,Nepal,2015,126,190,-64
NLD,Netherlands,NPL,Nepal,2016,118,202,-84
NLD,Netherlands,NPL,Nepal,2017,126,184,-58
NZL,New Zealand,NPL,Nepal,2008,9,100,-91
NZL,New Zealand,NPL,Nepal,2009,32,78,-46
NZL,New Zealand,NPL,Nepal,2010,20,179,-159
NZL,New Zealand,NPL,Nepal,2011,22,177,-155
NZL,New Zealand,NPL,Nepal,2012,38,185,-147
NZL,New Zealand,NPL,Nepal,2013,38,229,-191
NZL,New Zealand,NPL,Nepal,2014,28,567,-539
NZL,New Zealand,NPL,Nepal,2015,34,458,-424
NZL,New Zealand,NPL,Nepal,2016,35,442,-407
NZL,New Zealand,NPL,Nepal,2017,85,397,-312
NOR,Norway,NPL,Nepal,2008,56,138,-82
NOR,Norway,NPL,Nepal,2009,76,233,-157
NOR,Norway,NPL,Nepal,2010,82,246,-164
NOR,Norway,NPL,Nepal,2011,94,186,-92
NOR,Norway,NPL,Nepal,2012,106,272,-166
NOR,Norway,NPL,Nepal,2013,154,279,-125
NOR,Norway,NPL,Nepal,2014,140,250,-110
NOR,Norway,NPL,Nepal,2015,202,270,-68
NOR,Norway,NPL,Nepal,2016,153,276,-123
NOR,Norway,NPL,Nepal,2017,110,327,-217
POL,Poland,NPL,Nepal,2008,0,195,-195
POL,Poland,NPL,Nepal,2009,0,254,-254
POL,Poland,NPL,Nepal,2010,0,447,-447
POL,Poland,NPL,Nepal,2011,0,417,-417
POL,Poland,NPL,Nepal,2012,0,380,-380
POL,Poland,NPL,Nepal,2013,0,416,-416
POL,Poland,NPL,Nepal,2014,0,231,-231
POL,Poland,NPL,Nepal,2015,0,359,-359
POL,Poland,NPL,Nepal,2016,0,406,-406
POL,Poland,NPL,Nepal,2017,0,681,-681
PRT,Portugal,NPL,Nepal,2008,0,114,-114
PRT,Portugal,NPL,Nepal,2009,0,157,-157
PRT,Portugal,NPL,Nepal,2010,0,225,-225
PRT,Portugal,NPL,Nepal,2011,0,365,-365
PRT,Portugal,NPL,Nepal,2012,0,527,-527
PRT,Portugal,NPL,Nepal,2013,0,847,-847
PRT,Portugal,NPL,Nepal,2014,0,947,-947
PRT,Portugal,NPL,Nepal,2015,0,1369,-1369
PRT,Portugal,NPL,Nepal,2016,0,1348,-1348
PRT,Portugal,NPL,Nepal,2017,0,1746,-1746
SVK,Slovak Republic,NPL,Nepal,2008,0,0,0
SVK,Slovak Republic,NPL,Nepal,2009,1,2,-1
SVK,Slovak Republic,NPL,Nepal,2010,1,1,0
SVK,Slovak Republic,NPL,Nepal,2014,0,1,-1
ESP,Spain,NPL,Nepal,2008,116,626,-510
ESP,Spain,NPL,Nepal,2009,292,422,-130
ESP,Spain,NPL,Nepal,2010,274,388,-114
ESP,Spain,NPL,Nepal,2011,425,431,-6
ESP,Spain,NPL,Nepal,2012,255,571,-316
ESP,Spain,NPL,Nepal,2013,312,487,-175
ESP,Spain,NPL,Nepal,2014,240,362,-122
ESP,Spain,NPL,Nepal,2015,170,309,-139
ESP,Spain,NPL,Nepal,2016,134,420,-286
ESP,Spain,NPL,Nepal,2017,159,623,-464
SWE,Sweden,NPL,Nepal,2008,5,71,-66
SWE,Sweden,NPL,Nepal,2009,6,137,-131
SWE,Sweden,NPL,Nepal,2010,15,216,-201
SWE,Sweden,NPL,Nepal,2011,34,73,-39
SWE,Sweden,NPL,Nepal,2012,51,84,-33
SWE,Sweden,NPL,Nepal,2013,46,104,-58
SWE,Sweden,NPL,Nepal,2014,52,96,-44
SWE,Sweden,NPL,Nepal,2015,89,58,31
SWE,Sweden,NPL,Nepal,2016,24,66,-42
SWE,Sweden,NPL,Nepal,2017,19,79,-60
CHE,Switzerland,NPL,Nepal,2010,25,121,-96
CHE,Switzerland,NPL,Nepal,2011,38,61,-23
CHE,Switzerland,NPL,Nepal,2012,22,54,-32
CHE,Switzerland,NPL,Nepal,2013,41,69,-28
CHE,Switzerland,NPL,Nepal,2014,50,73,-23
CHE,Switzerland,NPL,Nepal,2015,36,79,-43
CHE,Switzerland,NPL,Nepal,2016,36,57,-21
CHE,Switzerland,NPL,Nepal,2017,23,78,-55
TUR,Turkey,NPL,Nepal,2010,0,3,-3
TUR,Turkey,NPL,Nepal,2016,59,397,-338
TUR,Turkey,NPL,Nepal,2017,239,1228,-989
GBR,United Kingdom,NPL,Nepal,2008,0,4000,-4000
GBR,United Kingdom,NPL,Nepal,2009,0,8000,-8000
GBR,United Kingdom,NPL,Nepal,2010,0,6000,-6000
GBR,United Kingdom,NPL,Nepal,2011,1000,5000,-4000
GBR,United Kingdom,NPL,Nepal,2012,1000,2000,-1000
GBR,United Kingdom,NPL,Nepal,2013,0,1000,-1000
GBR,United Kingdom,NPL,Nepal,2014,0,1000,-1000
GBR,United Kingdom,NPL,Nepal,2015,1000,2000,-1000
USA,United States,NPL,Nepal,2008,0,4093,-4093
USA,United States,NPL,Nepal,2009,0,4514,-4514
USA,United States,NPL,Nepal,2010,0,7115,-7115
USA,United States,NPL,Nepal,2011,0,10166,-10166
USA,United States,NPL,Nepal,2012,0,11312,-11312
USA,United States,NPL,Nepal,2013,0,13046,-13046
USA,United States,NPL,Nepal,2014,0,12357,-12357
USA,United States,NPL,Nepal,2015,0,12926,-12926
USA,United States,NPL,Nepal,2016,0,12851,-12851
USA,United States,NPL,Nepal,2017,0,11610,-11610
CHL,Chile,NPL,Nepal,2008,0,6,-6
CHL,Chile,NPL,Nepal,2009,0,8,-8
CHL,Chile,NPL,Nepal,2010,0,6,-6
CHL,Chile,NPL,Nepal,2011,0,5,-5
CHL,Chile,NPL,Nepal,2012,0,27,-27
CHL,Chile,NPL,Nepal,2013,0,8,-8
CHL,Chile,NPL,Nepal,2014,0,4,-4
CHL,Chile,NPL,Nepal,2015,0,6,-6
CHL,Chile,NPL,Nepal,2016,0,61,-61
EST,Estonia,NPL,Nepal,2008,0,0,0
EST,Estonia,NPL,Nepal,2009,0,0,0
EST,Estonia,NPL,Nepal,2010,0,3,-3
EST,Estonia,NPL,Nepal,2011,0,1,-1
EST,Estonia,NPL,Nepal,2012,0,3,-3
EST,Estonia,NPL,Nepal,2013,0,6,-6
EST,Estonia,NPL,Nepal,2014,0,7,-7
EST,Estonia,NPL,Nepal,2015,0,15,-15
EST,Estonia,NPL,Nepal,2016,0,13,-13
EST,Estonia,NPL,Nepal,2017,0,39,-39
SVN,Slovenia,NPL,Nepal,2009,0,1,-1
SVN,Slovenia,NPL,Nepal,2010,0,3,-3
SVN,Slovenia,NPL,Nepal,2011,0,2,-2
SVN,Slovenia,NPL,Nepal,2012,0,2,-2
SVN,Slovenia,NPL,Nepal,2014,0,1,-1
SVN,Slovenia,NPL,Nepal,2015,0,3,-3
SVN,Slovenia,NPL,Nepal,2016,0,5,-5
SVN,Slovenia,NPL,Nepal,2017,1,8,-7
SVN,Slovenia,NLD,Netherlands,2008,0,1,-1
LUX,Luxembourg,NZL,New Zealand,2014,0,5,-5
AUS,Australia,NIC,Nicaragua,2008,6,4,2
AUS,Australia,NIC,Nicaragua,2009,0,5,-5
AUS,Australia,NIC,Nicaragua,2010,0,4,-4
AUS,Australia,NIC,Nicaragua,2011,10,5,5
AUS,Australia,NIC,Nicaragua,2012,6,12,-6
AUS,Australia,NIC,Nicaragua,2013,11,8,3
AUS,Australia,NIC,Nicaragua,2014,9,8,1
AUS,Australia,NIC,Nicaragua,2015,0,0,0
AUS,Australia,NIC,Nicaragua,2016,0,8,-8
AUS,Australia,NIC,Nicaragua,2017,0,9,-9
AUT,Austria,NIC,Nicaragua,2008,4,12,-8
AUT,Austria,NIC,Nicaragua,2009,11,13,-2
AUT,Austria,NIC,Nicaragua,2010,9,21,-12
AUT,Austria,NIC,Nicaragua,2011,11,21,-10
AUT,Austria,NIC,Nicaragua,2012,10,18,-8
AUT,Austria,NIC,Nicaragua,2013,11,18,-7
AUT,Austria,NIC,Nicaragua,2014,6,14,-8
AUT,Austria,NIC,Nicaragua,2015,7,14,-7
AUT,Austria,NIC,Nicaragua,2016,11,16,-5
AUT,Austria,NIC,Nicaragua,2017,7,25,-18
BEL,Belgium,NIC,Nicaragua,2008,0,12,-12
BEL,Belgium,NIC,Nicaragua,2009,0,11,-11
BEL,Belgium,NIC,Nicaragua,2010,4,34,-30
BEL,Belgium,NIC,Nicaragua,2012,8,12,-4
BEL,Belgium,NIC,Nicaragua,2013,11,20,-9
BEL,Belgium,NIC,Nicaragua,2014,10,7,3
BEL,Belgium,NIC,Nicaragua,2015,8,16,-8
BEL,Belgium,NIC,Nicaragua,2016,9,18,-9
BEL,Belgium,NIC,Nicaragua,2017,3,17,-14
CAN,Canada,NIC,Nicaragua,2008,0,123,-123
CAN,Canada,NIC,Nicaragua,2009,0,114,-114
CAN,Canada,NIC,Nicaragua,2010,0,91,-91
CAN,Canada,NIC,Nicaragua,2011,0,122,-122
CAN,Canada,NIC,Nicaragua,2012,0,106,-106
CAN,Canada,NIC,Nicaragua,2013,0,96,-96
CAN,Canada,NIC,Nicaragua,2014,0,118,-118
CAN,Canada,NIC,Nicaragua,2015,0,96,-96
CAN,Canada,NIC,Nicaragua,2016,0,75,-75
CAN,Canada,NIC,Nicaragua,2017,0,105,-105
CZE,Czech Republic,NIC,Nicaragua,2008,0,2,-2
CZE,Czech Republic,NIC,Nicaragua,2013,1,2,-1
CZE,Czech Republic,NIC,Nicaragua,2014,2,3,-1
CZE,Czech Republic,NIC,Nicaragua,2015,2,2,0
CZE,Czech Republic,NIC,Nicaragua,2016,0,1,-1
DNK,Denmark,NIC,Nicaragua,2008,2,13,-11
DNK,Denmark,NIC,Nicaragua,2009,4,5,-1
DNK,Denmark,NIC,Nicaragua,2010,2,5,-3
DNK,Denmark,NIC,Nicaragua,2011,0,5,-5
DNK,Denmark,NIC,Nicaragua,2012,1,1,0
DNK,Denmark,NIC,Nicaragua,2013,1,7,-6
DNK,Denmark,NIC,Nicaragua,2014,3,8,-5
DNK,Denmark,NIC,Nicaragua,2015,1,6,-5
DNK,Denmark,NIC,Nicaragua,2016,6,5,1
DNK,Denmark,NIC,Nicaragua,2017,5,11,-6
FIN,Finland,NIC,Nicaragua,2008,0,7,-7
FIN,Finland,NIC,Nicaragua,2009,0,5,-5
FIN,Finland,NIC,Nicaragua,2010,0,4,-4
FIN,Finland,NIC,Nicaragua,2011,0,3,-3
FIN,Finland,NIC,Nicaragua,2012,2,5,-3
FIN,Finland,NIC,Nicaragua,2013,2,5,-3
FIN,Finland,NIC,Nicaragua,2014,1,4,-3
FIN,Finland,NIC,Nicaragua,2015,0,4,-4
FIN,Finland,NIC,Nicaragua,2016,0,5,-5
FIN,Finland,NIC,Nicaragua,2017,1,3,-2
FRA,France,NIC,Nicaragua,2008,0,14,-14
FRA,France,NIC,Nicaragua,2009,0,22,-22
FRA,France,NIC,Nicaragua,2010,0,32,-32
FRA,France,NIC,Nicaragua,2011,0,31,-31
FRA,France,NIC,Nicaragua,2012,0,28,-28
FRA,France,NIC,Nicaragua,2013,0,20,-20
FRA,France,NIC,Nicaragua,2014,0,37,-37
FRA,France,NIC,Nicaragua,2015,0,34,-34
FRA,France,NIC,Nicaragua,2016,0,36,-36
FRA,France,NIC,Nicaragua,2017,0,37,-37
DEU,Germany,NIC,Nicaragua,2008,33,77,-44
DEU,Germany,NIC,Nicaragua,2009,47,83,-36
DEU,Germany,NIC,Nicaragua,2010,42,77,-35
DEU,Germany,NIC,Nicaragua,2011,39,90,-51
DEU,Germany,NIC,Nicaragua,2012,60,92,-32
DEU,Germany,NIC,Nicaragua,2013,54,106,-52
DEU,Germany,NIC,Nicaragua,2014,51,112,-61
DEU,Germany,NIC,Nicaragua,2015,51,108,-57
DEU,Germany,NIC,Nicaragua,2016,61,145,-84
DEU,Germany,NIC,Nicaragua,2017,74,137,-63
HUN,Hungary,NIC,Nicaragua,2008,0,0,0
HUN,Hungary,NIC,Nicaragua,2009,0,1,-1
HUN,Hungary,NIC,Nicaragua,2010,0,0,0
HUN,Hungary,NIC,Nicaragua,2011,0,1,-1
HUN,Hungary,NIC,Nicaragua,2012,0,1,-1
HUN,Hungary,NIC,Nicaragua,2013,0,2,-2
HUN,Hungary,NIC,Nicaragua,2014,0,0,0
HUN,Hungary,NIC,Nicaragua,2015,0,3,-3
HUN,Hungary,NIC,Nicaragua,2016,0,1,-1
HUN,Hungary,NIC,Nicaragua,2017,0,0,0
ISL,Iceland,NIC,Nicaragua,2008,2,1,1
ISL,Iceland,NIC,Nicaragua,2009,1,1,0
ISL,Iceland,NIC,Nicaragua,2010,2,2,0
ISL,Iceland,NIC,Nicaragua,2011,1,2,-1
ISL,Iceland,NIC,Nicaragua,2012,0,2,-2
ISL,Iceland,NIC,Nicaragua,2013,0,2,-2
ISL,Iceland,NIC,Nicaragua,2014,5,1,4
ISL,Iceland,NIC,Nicaragua,2015,0,0,0
ISL,Iceland,NIC,Nicaragua,2016,0,0,0
ISL,Iceland,NIC,Nicaragua,2017,0,1,-1
ITA,Italy,NIC,Nicaragua,2008,0,62,-62
ITA,Italy,NIC,Nicaragua,2009,0,70,-70
ITA,Italy,NIC,Nicaragua,2010,5,75,-70
ITA,Italy,NIC,Nicaragua,2011,8,76,-68
ITA,Italy,NIC,Nicaragua,2012,5,66,-61
ITA,Italy,NIC,Nicaragua,2013,5,53,-48
ITA,Italy,NIC,Nicaragua,2014,8,44,-36
ITA,Italy,NIC,Nicaragua,2015,3,43,-40
ITA,Italy,NIC,Nicaragua,2016,0,48,-48
ITA,Italy,NIC,Nicaragua,2017,4,39,-35
JPN,Japan,NIC,Nicaragua,2008,83,88,-5
JPN,Japan,NIC,Nicaragua,2009,90,95,-5
JPN,Japan,NIC,Nicaragua,2010,81,77,4
JPN,Japan,NIC,Nicaragua,2011,75,75,0
JPN,Japan,NIC,Nicaragua,2012,98,101,-3
JPN,Japan,NIC,Nicaragua,2013,105,112,-7
JPN,Japan,NIC,Nicaragua,2014,120,124,-4
JPN,Japan,NIC,Nicaragua,2015,79,92,-13
JPN,Japan,NIC,Nicaragua,2016,99,97,2
JPN,Japan,NIC,Nicaragua,2017,106,113,-7
KOR,Korea,NIC,Nicaragua,2008,3,6,-3
KOR,Korea,NIC,Nicaragua,2009,4,5,-1
KOR,Korea,NIC,Nicaragua,2010,4,4,0
KOR,Korea,NIC,Nicaragua,2011,4,5,-1
KOR,Korea,NIC,Nicaragua,2012,4,5,-1
KOR,Korea,NIC,Nicaragua,2013,6,7,-1
KOR,Korea,NIC,Nicaragua,2014,10,8,2
KOR,Korea,NIC,Nicaragua,2015,4,6,-2
KOR,Korea,NIC,Nicaragua,2016,8,16,-8
KOR,Korea,NIC,Nicaragua,2017,9,9,0
LUX,Luxembourg,NIC,Nicaragua,2008,0,2,-2
LUX,Luxembourg,NIC,Nicaragua,2009,0,1,-1
LUX,Luxembourg,NIC,Nicaragua,2010,0,1,-1
LUX,Luxembourg,NIC,Nicaragua,2011,1,0,1
LUX,Luxembourg,NIC,Nicaragua,2012,0,3,-3
LUX,Luxembourg,NIC,Nicaragua,2013,1,3,-2
LUX,Luxembourg,NIC,Nicaragua,2014,2,4,-2
LUX,Luxembourg,NIC,Nicaragua,2015,2,5,-3
LUX,Luxembourg,NIC,Nicaragua,2016,2,2,0
LUX,Luxembourg,NIC,Nicaragua,2017,1,2,-1
MEX,Mexico,NIC,Nicaragua,2008,0,175,-175
MEX,Mexico,NIC,Nicaragua,2009,0,328,-328
MEX,Mexico,NIC,Nicaragua,2010,0,350,-350
MEX,Mexico,NIC,Nicaragua,2011,0,235,-235
MEX,Mexico,NIC,Nicaragua,2012,0,119,-119
MEX,Mexico,NIC,Nicaragua,2013,0,567,-567
MEX,Mexico,NIC,Nicaragua,2014,0,456,-456
MEX,Mexico,NIC,Nicaragua,2015,0,324,-324
MEX,Mexico,NIC,Nicaragua,2016,0,304,-304
MEX,Mexico,NIC,Nicaragua,2017,0,209,-209
NLD,Netherlands,NIC,Nicaragua,2008,1,24,-23
NLD,Netherlands,NIC,Nicaragua,2009,1,20,-19
NLD,Netherlands,NIC,Nicaragua,2010,11,18,-7
NLD,Netherlands,NIC,Nicaragua,2011,6,25,-19
NLD,Netherlands,NIC,Nicaragua,2012,13,32,-19
NLD,Netherlands,NIC,Nicaragua,2013,19,36,-17
NLD,Netherlands,NIC,Nicaragua,2014,13,31,-18
NLD,Netherlands,NIC,Nicaragua,2015,6,25,-19
NLD,Netherlands,NIC,Nicaragua,2016,10,24,-14
NLD,Netherlands,NIC,Nicaragua,2017,11,17,-6
NZL,New Zealand,NIC,Nicaragua,2009,0,0,0
NZL,New Zealand,NIC,Nicaragua,2010,0,3,-3
NZL,New Zealand,NIC,Nicaragua,2011,1,2,-1
NZL,New Zealand,NIC,Nicaragua,2012,0,1,-1
NZL,New Zealand,NIC,Nicaragua,2014,0,5,-5
NZL,New Zealand,NIC,Nicaragua,2015,0,2,-2
NZL,New Zealand,NIC,Nicaragua,2016,0,1,-1
NZL,New Zealand,NIC,Nicaragua,2017,3,1,2
NOR,Norway,NIC,Nicaragua,2008,4,11,-7
NOR,Norway,NIC,Nicaragua,2009,4,15,-11
NOR,Norway,NIC,Nicaragua,2010,10,11,-1
NOR,Norway,NIC,Nicaragua,2011,8,11,-3
NOR,Norway,NIC,Nicaragua,2012,3,12,-9
NOR,Norway,NIC,Nicaragua,2013,7,12,-5
NOR,Norway,NIC,Nicaragua,2014,2,12,-10
NOR,Norway,NIC,Nicaragua,2015,5,10,-5
NOR,Norway,NIC,Nicaragua,2016,3,11,-8
NOR,Norway,NIC,Nicaragua,2017,1,8,-7
POL,Poland,NIC,Nicaragua,2009,0,0,0
POL,Poland,NIC,Nicaragua,2010,0,2,-2
POL,Poland,NIC,Nicaragua,2011,0,5,-5
POL,Poland,NIC,Nicaragua,2012,0,3,-3
POL,Poland,NIC,Nicaragua,2013,0,4,-4
POL,Poland,NIC,Nicaragua,2014,0,1,-1
POL,Poland,NIC,Nicaragua,2015,0,7,-7
POL,Poland,NIC,Nicaragua,2016,0,3,-3
POL,Poland,NIC,Nicaragua,2017,0,5,-5
SVK,Slovak Republic,NIC,Nicaragua,2008,1,1,0
SVK,Slovak Republic,NIC,Nicaragua,2010,0,1,-1
SVK,Slovak Republic,NIC,Nicaragua,2012,0,1,-1
ESP,Spain,NIC,Nicaragua,2008,445,2893,-2448
ESP,Spain,NIC,Nicaragua,2009,659,2354,-1695
ESP,Spain,NIC,Nicaragua,2010,713,2966,-2253
ESP,Spain,NIC,Nicaragua,2011,933,3590,-2657
ESP,Spain,NIC,Nicaragua,2012,1289,2768,-1479
ESP,Spain,NIC,Nicaragua,2013,2185,2134,51
ESP,Spain,NIC,Nicaragua,2014,1425,2693,-1268
ESP,Spain,NIC,Nicaragua,2015,999,3098,-2099
ESP,Spain,NIC,Nicaragua,2016,1098,4110,-3012
ESP,Spain,NIC,Nicaragua,2017,1483,6172,-4689
SWE,Sweden,NIC,Nicaragua,2008,8,33,-25
SWE,Sweden,NIC,Nicaragua,2009,1,37,-36
SWE,Sweden,NIC,Nicaragua,2010,4,38,-34
SWE,Sweden,NIC,Nicaragua,2011,14,52,-38
SWE,Sweden,NIC,Nicaragua,2012,10,49,-39
SWE,Sweden,NIC,Nicaragua,2013,6,30,-24
SWE,Sweden,NIC,Nicaragua,2014,6,32,-26
SWE,Sweden,NIC,Nicaragua,2015,10,37,-27
SWE,Sweden,NIC,Nicaragua,2016,4,29,-25
SWE,Sweden,NIC,Nicaragua,2017,4,38,-34
CHE,Switzerland,NIC,Nicaragua,2010,9,39,-30
CHE,Switzerland,NIC,Nicaragua,2011,3,20,-17
CHE,Switzerland,NIC,Nicaragua,2012,11,36,-25
CHE,Switzerland,NIC,Nicaragua,2013,11,19,-8
CHE,Switzerland,NIC,Nicaragua,2014,10,21,-11
CHE,Switzerland,NIC,Nicaragua,2015,6,34,-28
CHE,Switzerland,NIC,Nicaragua,2016,8,34,-26
CHE,Switzerland,NIC,Nicaragua,2017,6,39,-33
USA,United States,NIC,Nicaragua,2008,0,3614,-3614
USA,United States,NIC,Nicaragua,2009,0,4137,-4137
USA,United States,NIC,Nicaragua,2010,0,3565,-3565
USA,United States,NIC,Nicaragua,2011,0,3401,-3401
USA,United States,NIC,Nicaragua,2012,0,3046,-3046
USA,United States,NIC,Nicaragua,2013,0,3048,-3048
USA,United States,NIC,Nicaragua,2014,0,2886,-2886
USA,United States,NIC,Nicaragua,2015,0,3324,-3324
USA,United States,NIC,Nicaragua,2016,0,3486,-3486
USA,United States,NIC,Nicaragua,2017,0,3072,-3072
CHL,Chile,NIC,Nicaragua,2008,0,40,-40
CHL,Chile,NIC,Nicaragua,2009,0,58,-58
CHL,Chile,NIC,Nicaragua,2010,0,37,-37
CHL,Chile,NIC,Nicaragua,2011,0,45,-45
CHL,Chile,NIC,Nicaragua,2012,0,47,-47
CHL,Chile,NIC,Nicaragua,2013,0,40,-40
CHL,Chile,NIC,Nicaragua,2014,0,39,-39
CHL,Chile,NIC,Nicaragua,2015,0,63,-63
CHL,Chile,NIC,Nicaragua,2016,0,44,-44
EST,Estonia,NIC,Nicaragua,2008,0,0,0
EST,Estonia,NIC,Nicaragua,2009,0,1,-1
EST,Estonia,NIC,Nicaragua,2010,0,0,0
EST,Estonia,NIC,Nicaragua,2011,0,0,0
EST,Estonia,NIC,Nicaragua,2012,0,0,0
EST,Estonia,NIC,Nicaragua,2013,0,0,0
EST,Estonia,NIC,Nicaragua,2014,0,0,0
EST,Estonia,NIC,Nicaragua,2015,0,1,-1
EST,Estonia,NIC,Nicaragua,2016,0,0,0
EST,Estonia,NIC,Nicaragua,2017,0,2,-2
SVN,Slovenia,NIC,Nicaragua,2008,0,3,-3
SVN,Slovenia,NIC,Nicaragua,2009,0,3,-3
SVN,Slovenia,NIC,Nicaragua,2015,0,1,-1
SVN,Slovenia,NIC,Nicaragua,2017,0,2,-2
AUS,Australia,NER,Niger,2008,0,2,-2
AUS,Australia,NER,Niger,2009,0,2,-2
AUS,Australia,NER,Niger,2010,0,0,0
AUS,Australia,NER,Niger,2011,0,2,-2
AUS,Australia,NER,Niger,2012,0,0,0
AUS,Australia,NER,Niger,2013,0,4,-4
AUS,Australia,NER,Niger,2014,0,0,0
AUS,Australia,NER,Niger,2015,0,0,0
AUS,Australia,NER,Niger,2017,0,3,-3
AUT,Austria,NER,Niger,2008,4,5,-1
AUT,Austria,NER,Niger,2009,1,8,-7
AUT,Austria,NER,Niger,2010,2,8,-6
AUT,Austria,NER,Niger,2011,8,7,1
AUT,Austria,NER,Niger,2012,3,6,-3
AUT,Austria,NER,Niger,2013,6,19,-13
AUT,Austria,NER,Niger,2014,9,12,-3
AUT,Austria,NER,Niger,2015,7,13,-6
AUT,Austria,NER,Niger,2016,7,15,-8
AUT,Austria,NER,Niger,2017,14,7,7
BEL,Belgium,NER,Niger,2008,0,80,-80
BEL,Belgium,NER,Niger,2009,0,139,-139
BEL,Belgium,NER,Niger,2010,47,122,-75
BEL,Belgium,NER,Niger,2011,0,121,-121
BEL,Belgium,NER,Niger,2012,75,171,-96
BEL,Belgium,NER,Niger,2013,111,143,-32
BEL,Belgium,NER,Niger,2014,114,161,-47
BEL,Belgium,NER,Niger,2015,77,139,-62
BEL,Belgium,NER,Niger,2016,54,86,-32
BEL,Belgium,NER,Niger,2017,51,99,-48
CAN,Canada,NER,Niger,2008,0,75,-75
CAN,Canada,NER,Niger,2009,0,82,-82
CAN,Canada,NER,Niger,2010,0,80,-80
CAN,Canada,NER,Niger,2011,0,90,-90
CAN,Canada,NER,Niger,2012,0,95,-95
CAN,Canada,NER,Niger,2013,0,105,-105
CAN,Canada,NER,Niger,2014,0,62,-62
CAN,Canada,NER,Niger,2015,0,77,-77
CAN,Canada,NER,Niger,2016,0,85,-85
CAN,Canada,NER,Niger,2017,0,60,-60
CZE,Czech Republic,NER,Niger,2009,0,1,-1
CZE,Czech Republic,NER,Niger,2014,1,1,0
CZE,Czech Republic,NER,Niger,2015,0,1,-1
DNK,Denmark,NER,Niger,2008,1,0,1
DNK,Denmark,NER,Niger,2009,0,2,-2
DNK,Denmark,NER,Niger,2012,1,0,1
DNK,Denmark,NER,Niger,2013,0,0,0
DNK,Denmark,NER,Niger,2014,1,1,0
DNK,Denmark,NER,Niger,2015,0,2,-2
DNK,Denmark,NER,Niger,2016,1,1,0
DNK,Denmark,NER,Niger,2017,0,3,-3
FIN,Finland,NER,Niger,2008,0,6,-6
FIN,Finland,NER,Niger,2009,0,3,-3
FIN,Finland,NER,Niger,2010,0,2,-2
FIN,Finland,NER,Niger,2011,0,4,-4
FIN,Finland,NER,Niger,2012,0,0,0
FIN,Finland,NER,Niger,2013,0,3,-3
FIN,Finland,NER,Niger,2014,0,4,-4
FIN,Finland,NER,Niger,2015,0,1,-1
FIN,Finland,NER,Niger,2016,0,6,-6
FIN,Finland,NER,Niger,2017,1,0,1
FRA,France,NER,Niger,2008,0,174,-174
FRA,France,NER,Niger,2009,0,147,-147
FRA,France,NER,Niger,2010,0,166,-166
FRA,France,NER,Niger,2011,0,139,-139
FRA,France,NER,Niger,2012,0,151,-151
FRA,France,NER,Niger,2013,0,162,-162
FRA,France,NER,Niger,2014,0,173,-173
FRA,France,NER,Niger,2015,0,106,-106
FRA,France,NER,Niger,2016,0,99,-99
FRA,France,NER,Niger,2017,0,110,-110
DEU,Germany,NER,Niger,2008,66,68,-2
DEU,Germany,NER,Niger,2009,84,81,3
DEU,Germany,NER,Niger,2010,64,77,-13
DEU,Germany,NER,Niger,2011,75,84,-9
DEU,Germany,NER,Niger,2012,73,126,-53
DEU,Germany,NER,Niger,2013,82,183,-101
DEU,Germany,NER,Niger,2014,131,220,-89
DEU,Germany,NER,Niger,2015,145,272,-127
DEU,Germany,NER,Niger,2016,172,222,-50
DEU,Germany,NER,Niger,2017,185,239,-54
HUN,Hungary,NER,Niger,2008,0,0,0
HUN,Hungary,NER,Niger,2009,0,0,0
HUN,Hungary,NER,Niger,2010,0,1,-1
HUN,Hungary,NER,Niger,2011,0,0,0
HUN,Hungary,NER,Niger,2012,0,1,-1
HUN,Hungary,NER,Niger,2013,0,1,-1
HUN,Hungary,NER,Niger,2014,0,1,-1
HUN,Hungary,NER,Niger,2015,0,3,-3
HUN,Hungary,NER,Niger,2016,0,0,0
HUN,Hungary,NER,Niger,2017,0,2,-2
ISL,Iceland,NER,Niger,2008,0,0,0
ISL,Iceland,NER,Niger,2009,0,0,0
ISL,Iceland,NER,Niger,2010,1,1,0
ISL,Iceland,NER,Niger,2011,0,1,-1
ISL,Iceland,NER,Niger,2012,0,0,0
ISL,Iceland,NER,Niger,2013,3,2,1
ISL,Iceland,NER,Niger,2014,2,2,0
ISL,Iceland,NER,Niger,2015,0,0,0
ISL,Iceland,NER,Niger,2016,1,1,0
ISL,Iceland,NER,Niger,2017,1,1,0
ITA,Italy,NER,Niger,2008,5,70,-65
ITA,Italy,NER,Niger,2009,5,61,-56
ITA,Italy,NER,Niger,2010,3,80,-77
ITA,Italy,NER,Niger,2011,3,64,-61
ITA,Italy,NER,Niger,2012,2,387,-385
ITA,Italy,NER,Niger,2013,15,252,-237
ITA,Italy,NER,Niger,2014,12,69,-57
ITA,Italy,NER,Niger,2015,4,130,-126
ITA,Italy,NER,Niger,2016,0,194,-194
ITA,Italy,NER,Niger,2017,9,360,-351
JPN,Japan,NER,Niger,2008,72,72,0
JPN,Japan,NER,Niger,2009,54,58,-4
JPN,Japan,NER,Niger,2010,23,22,1
JPN,Japan,NER,Niger,2011,9,13,-4
JPN,Japan,NER,Niger,2012,45,46,-1
JPN,Japan,NER,Niger,2013,50,53,-3
JPN,Japan,NER,Niger,2014,43,45,-2
JPN,Japan,NER,Niger,2015,63,67,-4
JPN,Japan,NER,Niger,2016,41,43,-2
JPN,Japan,NER,Niger,2017,44,49,-5
KOR,Korea,NER,Niger,2008,0,0,0
KOR,Korea,NER,Niger,2009,0,1,-1
KOR,Korea,NER,Niger,2010,1,0,1
KOR,Korea,NER,Niger,2011,0,2,-2
KOR,Korea,NER,Niger,2012,0,0,0
KOR,Korea,NER,Niger,2013,1,1,0
KOR,Korea,NER,Niger,2014,0,0,0
KOR,Korea,NER,Niger,2015,3,0,3
KOR,Korea,NER,Niger,2016,0,3,-3
KOR,Korea,NER,Niger,2017,2,4,-2
LUX,Luxembourg,NER,Niger,2008,0,1,-1
LUX,Luxembourg,NER,Niger,2009,2,2,0
LUX,Luxembourg,NER,Niger,2010,1,1,0
LUX,Luxembourg,NER,Niger,2011,1,2,-1
LUX,Luxembourg,NER,Niger,2012,0,0,0
LUX,Luxembourg,NER,Niger,2013,0,2,-2
LUX,Luxembourg,NER,Niger,2014,2,3,-1
LUX,Luxembourg,NER,Niger,2015,0,3,-3
LUX,Luxembourg,NER,Niger,2016,0,2,-2
LUX,Luxembourg,NER,Niger,2017,3,7,-4
MEX,Mexico,NER,Niger,2008,0,3,-3
MEX,Mexico,NER,Niger,2009,0,5,-5
MEX,Mexico,NER,Niger,2012,0,0,0
MEX,Mexico,NER,Niger,2013,0,0,0
MEX,Mexico,NER,Niger,2014,0,0,0
NLD,Netherlands,NER,Niger,2008,0,13,-13
NLD,Netherlands,NER,Niger,2009,3,12,-9
NLD,Netherlands,NER,Niger,2010,9,15,-6
NLD,Netherlands,NER,Niger,2011,2,3,-1
NLD,Netherlands,NER,Niger,2012,8,2,6
NLD,Netherlands,NER,Niger,2013,4,2,2
NLD,Netherlands,NER,Niger,2014,2,7,-5
NLD,Netherlands,NER,Niger,2015,4,5,-1
NLD,Netherlands,NER,Niger,2016,2,4,-2
NLD,Netherlands,NER,Niger,2017,4,7,-3
NOR,Norway,NER,Niger,2008,0,3,-3
NOR,Norway,NER,Niger,2009,0,3,-3
NOR,Norway,NER,Niger,2010,0,3,-3
NOR,Norway,NER,Niger,2011,1,3,-2
NOR,Norway,NER,Niger,2012,0,4,-4
NOR,Norway,NER,Niger,2013,0,0,0
NOR,Norway,NER,Niger,2014,2,1,1
NOR,Norway,NER,Niger,2015,1,12,-11
NOR,Norway,NER,Niger,2016,87,2,85
NOR,Norway,NER,Niger,2017,0,2,-2
POL,Poland,NER,Niger,2009,0,0,0
POL,Poland,NER,Niger,2010,0,1,-1
POL,Poland,NER,Niger,2011,0,1,-1
POL,Poland,NER,Niger,2012,0,1,-1
POL,Poland,NER,Niger,2013,0,0,0
POL,Poland,NER,Niger,2014,0,0,0
POL,Poland,NER,Niger,2015,0,0,0
POL,Poland,NER,Niger,2016,0,1,-1
POL,Poland,NER,Niger,2017,0,1,-1
SVK,Slovak Republic,NER,Niger,2008,0,0,0
ESP,Spain,NER,Niger,2008,17,33,-16
ESP,Spain,NER,Niger,2009,19,36,-17
ESP,Spain,NER,Niger,2010,31,18,13
ESP,Spain,NER,Niger,2011,10,24,-14
ESP,Spain,NER,Niger,2012,15,23,-8
ESP,Spain,NER,Niger,2013,8,37,-29
ESP,Spain,NER,Niger,2014,14,35,-21
ESP,Spain,NER,Niger,2015,4,30,-26
ESP,Spain,NER,Niger,2016,14,36,-22
ESP,Spain,NER,Niger,2017,20,20,0
SWE,Sweden,NER,Niger,2008,1,2,-1
SWE,Sweden,NER,Niger,2009,0,3,-3
SWE,Sweden,NER,Niger,2010,0,2,-2
SWE,Sweden,NER,Niger,2011,0,0,0
SWE,Sweden,NER,Niger,2012,0,3,-3
SWE,Sweden,NER,Niger,2013,0,2,-2
SWE,Sweden,NER,Niger,2014,0,0,0
SWE,Sweden,NER,Niger,2015,1,2,-1
SWE,Sweden,NER,Niger,2016,0,4,-4
SWE,Sweden,NER,Niger,2017,0,8,-8
CHE,Switzerland,NER,Niger,2010,2,11,-9
CHE,Switzerland,NER,Niger,2011,2,11,-9
CHE,Switzerland,NER,Niger,2012,5,6,-1
CHE,Switzerland,NER,Niger,2013,3,7,-4
CHE,Switzerland,NER,Niger,2014,4,4,0
CHE,Switzerland,NER,Niger,2015,1,9,-8
CHE,Switzerland,NER,Niger,2016,5,5,0
CHE,Switzerland,NER,Niger,2017,2,5,-3
TUR,Turkey,NER,Niger,2010,0,5,-5
USA,United States,NER,Niger,2008,0,107,-107
USA,United States,NER,Niger,2009,0,183,-183
USA,United States,NER,Niger,2010,0,96,-96
USA,United States,NER,Niger,2011,0,96,-96
USA,United States,NER,Niger,2012,0,48,-48
USA,United States,NER,Niger,2013,0,37,-37
USA,United States,NER,Niger,2014,0,71,-71
USA,United States,NER,Niger,2015,0,55,-55
USA,United States,NER,Niger,2016,0,119,-119
USA,United States,NER,Niger,2017,0,116,-116
CHL,Chile,NER,Niger,2008,0,0,0
CHL,Chile,NER,Niger,2009,0,0,0
CHL,Chile,NER,Niger,2010,0,0,0
CHL,Chile,NER,Niger,2011,0,0,0
CHL,Chile,NER,Niger,2012,0,0,0
CHL,Chile,NER,Niger,2013,0,0,0
CHL,Chile,NER,Niger,2014,0,0,0
CHL,Chile,NER,Niger,2015,0,0,0
CHL,Chile,NER,Niger,2016,0,0,0
EST,Estonia,NER,Niger,2008,0,0,0
EST,Estonia,NER,Niger,2009,0,0,0
EST,Estonia,NER,Niger,2010,0,0,0
EST,Estonia,NER,Niger,2011,0,0,0
EST,Estonia,NER,Niger,2012,0,0,0
EST,Estonia,NER,Niger,2013,0,0,0
EST,Estonia,NER,Niger,2014,0,0,0
EST,Estonia,NER,Niger,2015,0,0,0
EST,Estonia,NER,Niger,2016,0,0,0
EST,Estonia,NER,Niger,2017,0,0,0
AUS,Australia,NGA,Nigeria,2008,32,250,-218
AUS,Australia,NGA,Nigeria,2009,38,377,-339
AUS,Australia,NGA,Nigeria,2010,29,429,-400
AUS,Australia,NGA,Nigeria,2011,32,338,-306
AUS,Australia,NGA,Nigeria,2012,46,400,-354
AUS,Australia,NGA,Nigeria,2013,40,442,-402
AUS,Australia,NGA,Nigeria,2014,38,496,-458
AUS,Australia,NGA,Nigeria,2015,0,478,-478
AUS,Australia,NGA,Nigeria,2016,0,621,-621
AUS,Australia,NGA,Nigeria,2017,0,728,-728
AUT,Austria,NGA,Nigeria,2008,840,769,71
AUT,Austria,NGA,Nigeria,2009,967,941,26
AUT,Austria,NGA,Nigeria,2010,1126,784,342
AUT,Austria,NGA,Nigeria,2011,892,750,142
AUT,Austria,NGA,Nigeria,2012,668,782,-114
AUT,Austria,NGA,Nigeria,2013,645,1039,-394
AUT,Austria,NGA,Nigeria,2014,590,1051,-461
AUT,Austria,NGA,Nigeria,2015,676,1501,-825
AUT,Austria,NGA,Nigeria,2016,1147,1861,-714
AUT,Austria,NGA,Nigeria,2017,1433,1345,88
BEL,Belgium,NGA,Nigeria,2008,0,336,-336
BEL,Belgium,NGA,Nigeria,2009,0,377,-377
BEL,Belgium,NGA,Nigeria,2010,71,461,-390
BEL,Belgium,NGA,Nigeria,2011,0,414,-414
BEL,Belgium,NGA,Nigeria,2012,201,501,-300
BEL,Belgium,NGA,Nigeria,2013,281,479,-198
BEL,Belgium,NGA,Nigeria,2014,219,397,-178
BEL,Belgium,NGA,Nigeria,2015,204,396,-192
BEL,Belgium,NGA,Nigeria,2016,141,367,-226
BEL,Belgium,NGA,Nigeria,2017,104,375,-271
CAN,Canada,NGA,Nigeria,2008,0,2108,-2108
CAN,Canada,NGA,Nigeria,2009,0,3156,-3156
CAN,Canada,NGA,Nigeria,2010,0,3906,-3906
CAN,Canada,NGA,Nigeria,2011,0,3102,-3102
CAN,Canada,NGA,Nigeria,2012,0,3441,-3441
CAN,Canada,NGA,Nigeria,2013,0,4171,-4171
CAN,Canada,NGA,Nigeria,2014,0,4160,-4160
CAN,Canada,NGA,Nigeria,2015,0,4133,-4133
CAN,Canada,NGA,Nigeria,2016,0,4425,-4425
CAN,Canada,NGA,Nigeria,2017,0,5460,-5460
CZE,Czech Republic,NGA,Nigeria,2008,1,87,-86
CZE,Czech Republic,NGA,Nigeria,2009,1,64,-63
CZE,Czech Republic,NGA,Nigeria,2010,2,52,-50
CZE,Czech Republic,NGA,Nigeria,2011,1,24,-23
CZE,Czech Republic,NGA,Nigeria,2012,9,37,-28
CZE,Czech Republic,NGA,Nigeria,2013,43,38,5
CZE,Czech Republic,NGA,Nigeria,2014,29,64,-35
CZE,Czech Republic,NGA,Nigeria,2015,34,55,-21
CZE,Czech Republic,NGA,Nigeria,2016,29,43,-14
CZE,Czech Republic,NGA,Nigeria,2017,27,62,-35
DNK,Denmark,NGA,Nigeria,2008,28,79,-51
DNK,Denmark,NGA,Nigeria,2009,26,138,-112
DNK,Denmark,NGA,Nigeria,2010,55,125,-70
DNK,Denmark,NGA,Nigeria,2011,52,129,-77
DNK,Denmark,NGA,Nigeria,2012,64,93,-29
DNK,Denmark,NGA,Nigeria,2013,76,117,-41
DNK,Denmark,NGA,Nigeria,2014,81,141,-60
DNK,Denmark,NGA,Nigeria,2015,46,95,-49
DNK,Denmark,NGA,Nigeria,2016,67,95,-28
DNK,Denmark,NGA,Nigeria,2017,60,80,-20
FIN,Finland,NGA,Nigeria,2008,19,263,-244
FIN,Finland,NGA,Nigeria,2009,19,129,-110
FIN,Finland,NGA,Nigeria,2010,17,180,-163
FIN,Finland,NGA,Nigeria,2011,19,242,-223
FIN,Finland,NGA,Nigeria,2012,29,200,-171
FIN,Finland,NGA,Nigeria,2013,35,224,-189
FIN,Finland,NGA,Nigeria,2014,26,297,-271
FIN,Finland,NGA,Nigeria,2015,14,271,-257
FIN,Finland,NGA,Nigeria,2016,27,286,-259
FIN,Finland,NGA,Nigeria,2017,26,212,-186
FRA,France,NGA,Nigeria,2008,0,582,-582
FRA,France,NGA,Nigeria,2009,0,594,-594
FRA,France,NGA,Nigeria,2010,0,653,-653
FRA,France,NGA,Nigeria,2011,0,624,-624
FRA,France,NGA,Nigeria,2012,0,788,-788
FRA,France,NGA,Nigeria,2013,0,904,-904
FRA,France,NGA,Nigeria,2014,0,960,-960
FRA,France,NGA,Nigeria,2015,0,964,-964
FRA,France,NGA,Nigeria,2016,0,1121,-1121
FRA,France,NGA,Nigeria,2017,0,1180,-1180
DEU,Germany,NGA,Nigeria,2008,1560,1796,-236
DEU,Germany,NGA,Nigeria,2009,1550,2159,-609
DEU,Germany,NGA,Nigeria,2010,1359,2351,-992
DEU,Germany,NGA,Nigeria,2011,1323,2611,-1288
DEU,Germany,NGA,Nigeria,2012,1559,2748,-1189
DEU,Germany,NGA,Nigeria,2013,1668,4151,-2483
DEU,Germany,NGA,Nigeria,2014,1796,6516,-4720
DEU,Germany,NGA,Nigeria,2015,2362,12135,-9773
DEU,Germany,NGA,Nigeria,2016,3308,10007,-6699
DEU,Germany,NGA,Nigeria,2017,4023,9651,-5628
HUN,Hungary,NGA,Nigeria,2008,36,225,-189
HUN,Hungary,NGA,Nigeria,2009,24,206,-182
HUN,Hungary,NGA,Nigeria,2010,36,181,-145
HUN,Hungary,NGA,Nigeria,2011,22,239,-217
HUN,Hungary,NGA,Nigeria,2012,26,302,-276
HUN,Hungary,NGA,Nigeria,2013,59,234,-175
HUN,Hungary,NGA,Nigeria,2014,70,241,-171
HUN,Hungary,NGA,Nigeria,2015,80,235,-155
HUN,Hungary,NGA,Nigeria,2016,110,177,-67
HUN,Hungary,NGA,Nigeria,2017,230,310,-80
ISL,Iceland,NGA,Nigeria,2008,5,10,-5
ISL,Iceland,NGA,Nigeria,2009,7,3,4
ISL,Iceland,NGA,Nigeria,2010,4,8,-4
ISL,Iceland,NGA,Nigeria,2011,2,6,-4
ISL,Iceland,NGA,Nigeria,2012,3,8,-5
ISL,Iceland,NGA,Nigeria,2013,5,9,-4
ISL,Iceland,NGA,Nigeria,2014,4,13,-9
ISL,Iceland,NGA,Nigeria,2015,1,14,-13
ISL,Iceland,NGA,Nigeria,2016,4,20,-16
ISL,Iceland,NGA,Nigeria,2017,4,32,-28
ITA,Italy,NGA,Nigeria,2008,96,3717,-3621
ITA,Italy,NGA,Nigeria,2009,115,3998,-3883
ITA,Italy,NGA,Nigeria,2010,191,4842,-4651
ITA,Italy,NGA,Nigeria,2011,162,4487,-4325
ITA,Italy,NGA,Nigeria,2012,188,6739,-6551
ITA,Italy,NGA,Nigeria,2013,229,6310,-6081
ITA,Italy,NGA,Nigeria,2014,198,5273,-5075
ITA,Italy,NGA,Nigeria,2015,281,8882,-8601
ITA,Italy,NGA,Nigeria,2016,0,14729,-14729
ITA,Italy,NGA,Nigeria,2017,350,23338,-22988
JPN,Japan,NGA,Nigeria,2008,300,359,-59
JPN,Japan,NGA,Nigeria,2009,187,278,-91
JPN,Japan,NGA,Nigeria,2010,174,253,-79
JPN,Japan,NGA,Nigeria,2011,193,243,-50
JPN,Japan,NGA,Nigeria,2012,387,466,-79
JPN,Japan,NGA,Nigeria,2013,386,467,-81
JPN,Japan,NGA,Nigeria,2014,227,313,-86
JPN,Japan,NGA,Nigeria,2015,204,309,-105
JPN,Japan,NGA,Nigeria,2016,294,425,-131
JPN,Japan,NGA,Nigeria,2017,250,353,-103
KOR,Korea,NGA,Nigeria,2008,413,353,60
KOR,Korea,NGA,Nigeria,2009,373,332,41
KOR,Korea,NGA,Nigeria,2010,350,277,73
KOR,Korea,NGA,Nigeria,2011,424,375,49
KOR,Korea,NGA,Nigeria,2012,411,437,-26
KOR,Korea,NGA,Nigeria,2013,379,412,-33
KOR,Korea,NGA,Nigeria,2014,276,495,-219
KOR,Korea,NGA,Nigeria,2015,424,468,-44
KOR,Korea,NGA,Nigeria,2016,342,472,-130
KOR,Korea,NGA,Nigeria,2017,389,576,-187
LUX,Luxembourg,NGA,Nigeria,2008,25,19,6
LUX,Luxembourg,NGA,Nigeria,2009,7,22,-15
LUX,Luxembourg,NGA,Nigeria,2010,12,27,-15
LUX,Luxembourg,NGA,Nigeria,2011,9,19,-10
LUX,Luxembourg,NGA,Nigeria,2012,4,25,-21
LUX,Luxembourg,NGA,Nigeria,2013,8,52,-44
LUX,Luxembourg,NGA,Nigeria,2014,32,36,-4
LUX,Luxembourg,NGA,Nigeria,2015,27,28,-1
LUX,Luxembourg,NGA,Nigeria,2016,22,40,-18
LUX,Luxembourg,NGA,Nigeria,2017,28,31,-3
MEX,Mexico,NGA,Nigeria,2008,0,8,-8
MEX,Mexico,NGA,Nigeria,2009,0,16,-16
MEX,Mexico,NGA,Nigeria,2010,0,61,-61
MEX,Mexico,NGA,Nigeria,2011,0,68,-68
MEX,Mexico,NGA,Nigeria,2012,0,82,-82
MEX,Mexico,NGA,Nigeria,2013,0,90,-90
MEX,Mexico,NGA,Nigeria,2014,0,100,-100
MEX,Mexico,NGA,Nigeria,2015,0,81,-81
MEX,Mexico,NGA,Nigeria,2016,0,139,-139
MEX,Mexico,NGA,Nigeria,2017,0,111,-111
NLD,Netherlands,NGA,Nigeria,2008,158,476,-318
NLD,Netherlands,NGA,Nigeria,2009,234,539,-305
NLD,Netherlands,NGA,Nigeria,2010,241,467,-226
NLD,Netherlands,NGA,Nigeria,2011,221,432,-211
NLD,Netherlands,NGA,Nigeria,2012,259,397,-138
NLD,Netherlands,NGA,Nigeria,2013,262,438,-176
NLD,Netherlands,NGA,Nigeria,2014,266,492,-226
NLD,Netherlands,NGA,Nigeria,2015,254,438,-184
NLD,Netherlands,NGA,Nigeria,2016,275,357,-82
NLD,Netherlands,NGA,Nigeria,2017,260,450,-190
NZL,New Zealand,NGA,Nigeria,2008,3,51,-48
NZL,New Zealand,NGA,Nigeria,2009,1,42,-41
NZL,New Zealand,NGA,Nigeria,2010,11,23,-12
NZL,New Zealand,NGA,Nigeria,2011,10,36,-26
NZL,New Zealand,NGA,Nigeria,2012,5,39,-34
NZL,New Zealand,NGA,Nigeria,2013,11,34,-23
NZL,New Zealand,NGA,Nigeria,2014,5,76,-71
NZL,New Zealand,NGA,Nigeria,2015,6,77,-71
NZL,New Zealand,NGA,Nigeria,2016,14,81,-67
NZL,New Zealand,NGA,Nigeria,2017,13,96,-83
NOR,Norway,NGA,Nigeria,2008,50,126,-76
NOR,Norway,NGA,Nigeria,2009,35,144,-109
NOR,Norway,NGA,Nigeria,2010,43,159,-116
NOR,Norway,NGA,Nigeria,2011,85,206,-121
NOR,Norway,NGA,Nigeria,2012,53,194,-141
NOR,Norway,NGA,Nigeria,2013,65,215,-150
NOR,Norway,NGA,Nigeria,2014,73,228,-155
NOR,Norway,NGA,Nigeria,2015,98,151,-53
NOR,Norway,NGA,Nigeria,2016,0,131,-131
NOR,Norway,NGA,Nigeria,2017,77,135,-58
POL,Poland,NGA,Nigeria,2008,0,631,-631
POL,Poland,NGA,Nigeria,2009,0,651,-651
POL,Poland,NGA,Nigeria,2010,0,624,-624
POL,Poland,NGA,Nigeria,2011,0,542,-542
POL,Poland,NGA,Nigeria,2012,0,505,-505
POL,Poland,NGA,Nigeria,2013,0,431,-431
POL,Poland,NGA,Nigeria,2014,0,195,-195
POL,Poland,NGA,Nigeria,2015,0,338,-338
POL,Poland,NGA,Nigeria,2016,0,278,-278
POL,Poland,NGA,Nigeria,2017,0,303,-303
SVK,Slovak Republic,NGA,Nigeria,2008,2,15,-13
SVK,Slovak Republic,NGA,Nigeria,2009,1,7,-6
SVK,Slovak Republic,NGA,Nigeria,2010,5,6,-1
SVK,Slovak Republic,NGA,Nigeria,2011,3,11,-8
SVK,Slovak Republic,NGA,Nigeria,2012,0,5,-5
SVK,Slovak Republic,NGA,Nigeria,2013,1,5,-4
SVK,Slovak Republic,NGA,Nigeria,2014,0,2,-2
SVK,Slovak Republic,NGA,Nigeria,2015,0,3,-3
SVK,Slovak Republic,NGA,Nigeria,2016,0,6,-6
SVK,Slovak Republic,NGA,Nigeria,2017,0,1,-1
ESP,Spain,NGA,Nigeria,2008,2741,4907,-2166
ESP,Spain,NGA,Nigeria,2009,3477,3034,443
ESP,Spain,NGA,Nigeria,2010,3552,2511,1041
ESP,Spain,NGA,Nigeria,2011,3943,2284,1659
ESP,Spain,NGA,Nigeria,2012,3787,1894,1893
ESP,Spain,NGA,Nigeria,2013,4172,1557,2615
ESP,Spain,NGA,Nigeria,2014,2808,1361,1447
ESP,Spain,NGA,Nigeria,2015,2074,1360,714
ESP,Spain,NGA,Nigeria,2016,1938,1319,619
ESP,Spain,NGA,Nigeria,2017,2113,1466,647
SWE,Sweden,NGA,Nigeria,2008,75,366,-291
SWE,Sweden,NGA,Nigeria,2009,41,413,-372
SWE,Sweden,NGA,Nigeria,2010,80,461,-381
SWE,Sweden,NGA,Nigeria,2011,88,437,-349
SWE,Sweden,NGA,Nigeria,2012,143,451,-308
SWE,Sweden,NGA,Nigeria,2013,71,495,-424
SWE,Sweden,NGA,Nigeria,2014,75,569,-494
SWE,Sweden,NGA,Nigeria,2015,131,522,-391
SWE,Sweden,NGA,Nigeria,2016,65,553,-488
SWE,Sweden,NGA,Nigeria,2017,62,507,-445
CHE,Switzerland,NGA,Nigeria,2010,77,192,-115
CHE,Switzerland,NGA,Nigeria,2011,66,194,-128
CHE,Switzerland,NGA,Nigeria,2012,79,198,-119
CHE,Switzerland,NGA,Nigeria,2013,87,173,-86
CHE,Switzerland,NGA,Nigeria,2014,83,166,-83
CHE,Switzerland,NGA,Nigeria,2015,77,173,-96
CHE,Switzerland,NGA,Nigeria,2016,68,146,-78
CHE,Switzerland,NGA,Nigeria,2017,75,181,-106
TUR,Turkey,NGA,Nigeria,2010,0,128,-128
TUR,Turkey,NGA,Nigeria,2016,483,1583,-1100
TUR,Turkey,NGA,Nigeria,2017,614,1734,-1120
GBR,United Kingdom,NGA,Nigeria,2008,0,11000,-11000
GBR,United Kingdom,NGA,Nigeria,2009,0,12000,-12000
GBR,United Kingdom,NGA,Nigeria,2010,0,10000,-10000
GBR,United Kingdom,NGA,Nigeria,2011,1000,8000,-7000
GBR,United Kingdom,NGA,Nigeria,2012,2000,9000,-7000
GBR,United Kingdom,NGA,Nigeria,2013,2000,7000,-5000
GBR,United Kingdom,NGA,Nigeria,2014,2000,7000,-5000
GBR,United Kingdom,NGA,Nigeria,2015,2000,8000,-6000
GBR,United Kingdom,NGA,Nigeria,2016,0,6000,-6000
GBR,United Kingdom,NGA,Nigeria,2017,0,10000,-10000
USA,United States,NGA,Nigeria,2008,0,12475,-12475
USA,United States,NGA,Nigeria,2009,0,15253,-15253
USA,United States,NGA,Nigeria,2010,0,13376,-13376
USA,United States,NGA,Nigeria,2011,0,11824,-11824
USA,United States,NGA,Nigeria,2012,0,13575,-13575
USA,United States,NGA,Nigeria,2013,0,13840,-13840
USA,United States,NGA,Nigeria,2014,0,12828,-12828
USA,United States,NGA,Nigeria,2015,0,11542,-11542
USA,United States,NGA,Nigeria,2016,0,14380,-14380
USA,United States,NGA,Nigeria,2017,0,13539,-13539
CHL,Chile,NGA,Nigeria,2008,0,3,-3
CHL,Chile,NGA,Nigeria,2009,0,2,-2
CHL,Chile,NGA,Nigeria,2010,0,7,-7
CHL,Chile,NGA,Nigeria,2011,0,4,-4
CHL,Chile,NGA,Nigeria,2012,0,2,-2
CHL,Chile,NGA,Nigeria,2013,0,5,-5
CHL,Chile,NGA,Nigeria,2014,0,3,-3
CHL,Chile,NGA,Nigeria,2015,0,6,-6
CHL,Chile,NGA,Nigeria,2016,0,2,-2
EST,Estonia,NGA,Nigeria,2008,0,1,-1
EST,Estonia,NGA,Nigeria,2009,0,2,-2
EST,Estonia,NGA,Nigeria,2010,0,1,-1
EST,Estonia,NGA,Nigeria,2011,0,7,-7
EST,Estonia,NGA,Nigeria,2012,0,7,-7
EST,Estonia,NGA,Nigeria,2013,0,18,-18
EST,Estonia,NGA,Nigeria,2014,0,3,-3
EST,Estonia,NGA,Nigeria,2015,0,109,-109
EST,Estonia,NGA,Nigeria,2016,0,103,-103
EST,Estonia,NGA,Nigeria,2017,0,142,-142
SVN,Slovenia,NGA,Nigeria,2008,0,8,-8
SVN,Slovenia,NGA,Nigeria,2009,0,8,-8
SVN,Slovenia,NGA,Nigeria,2010,0,7,-7
SVN,Slovenia,NGA,Nigeria,2011,0,10,-10
SVN,Slovenia,NGA,Nigeria,2013,0,4,-4
SVN,Slovenia,NGA,Nigeria,2014,1,5,-4
SVN,Slovenia,NGA,Nigeria,2015,0,10,-10
SVN,Slovenia,NGA,Nigeria,2016,1,3,-2
SVN,Slovenia,NGA,Nigeria,2017,1,21,-20
AUS,Australia,NIU,Niue,2009,0,0,0
AUS,Australia,NIU,Niue,2010,0,0,0
AUS,Australia,NIU,Niue,2011,0,0,0
AUS,Australia,NIU,Niue,2012,0,0,0
AUS,Australia,NIU,Niue,2013,0,0,0
AUS,Australia,NIU,Niue,2014,0,0,0
AUS,Australia,NIU,Niue,2015,0,0,0
AUS,Australia,NIU,Niue,2016,0,0,0
AUS,Australia,NIU,Niue,2017,0,0,0
AUT,Austria,NIU,Niue,2014,0,0,0
AUT,Austria,NIU,Niue,2015,0,0,0
AUT,Austria,NIU,Niue,2016,0,0,0
AUT,Austria,NIU,Niue,2017,0,0,0
BEL,Belgium,NIU,Niue,2010,0,0,0
CAN,Canada,NIU,Niue,2008,0,0,0
CAN,Canada,NIU,Niue,2009,0,0,0
CAN,Canada,NIU,Niue,2010,0,0,0
CAN,Canada,NIU,Niue,2011,0,0,0
CAN,Canada,NIU,Niue,2012,0,0,0
CAN,Canada,NIU,Niue,2013,0,0,0
CAN,Canada,NIU,Niue,2014,0,0,0
CAN,Canada,NIU,Niue,2015,0,0,0
CAN,Canada,NIU,Niue,2016,0,0,0
CAN,Canada,NIU,Niue,2017,0,0,0
DNK,Denmark,NIU,Niue,2015,0,0,0
DNK,Denmark,NIU,Niue,2016,0,0,0
FIN,Finland,NIU,Niue,2008,0,0,0
FIN,Finland,NIU,Niue,2009,0,0,0
FIN,Finland,NIU,Niue,2010,0,0,0
FIN,Finland,NIU,Niue,2011,0,0,0
FIN,Finland,NIU,Niue,2012,0,0,0
FIN,Finland,NIU,Niue,2013,0,0,0
FIN,Finland,NIU,Niue,2014,0,0,0
FIN,Finland,NIU,Niue,2015,0,0,0
FIN,Finland,NIU,Niue,2016,0,0,0
FIN,Finland,NIU,Niue,2017,0,0,0
FRA,France,NIU,Niue,2008,0,0,0
FRA,France,NIU,Niue,2009,0,0,0
FRA,France,NIU,Niue,2010,0,0,0
FRA,France,NIU,Niue,2011,0,0,0
FRA,France,NIU,Niue,2012,0,0,0
FRA,France,NIU,Niue,2013,0,0,0
FRA,France,NIU,Niue,2014,0,0,0
FRA,France,NIU,Niue,2015,0,0,0
FRA,France,NIU,Niue,2016,0,0,0
FRA,France,NIU,Niue,2017,0,0,0
DEU,Germany,NIU,Niue,2008,0,0,0
DEU,Germany,NIU,Niue,2009,0,0,0
DEU,Germany,NIU,Niue,2010,0,0,0
DEU,Germany,NIU,Niue,2011,0,0,0
DEU,Germany,NIU,Niue,2012,0,0,0
DEU,Germany,NIU,Niue,2013,0,0,0
DEU,Germany,NIU,Niue,2014,0,0,0
DEU,Germany,NIU,Niue,2015,0,0,0
DEU,Germany,NIU,Niue,2016,0,0,0
DEU,Germany,NIU,Niue,2017,0,0,0
HUN,Hungary,NIU,Niue,2008,0,0,0
HUN,Hungary,NIU,Niue,2009,0,0,0
HUN,Hungary,NIU,Niue,2010,0,0,0
HUN,Hungary,NIU,Niue,2011,0,0,0
HUN,Hungary,NIU,Niue,2012,0,0,0
HUN,Hungary,NIU,Niue,2013,0,0,0
HUN,Hungary,NIU,Niue,2014,0,0,0
HUN,Hungary,NIU,Niue,2015,0,0,0
HUN,Hungary,NIU,Niue,2016,0,0,0
HUN,Hungary,NIU,Niue,2017,0,0,0
ISL,Iceland,NIU,Niue,2016,0,0,0
ISL,Iceland,NIU,Niue,2017,0,0,0
JPN,Japan,NIU,Niue,2008,0,0,0
JPN,Japan,NIU,Niue,2009,0,0,0
JPN,Japan,NIU,Niue,2010,0,0,0
JPN,Japan,NIU,Niue,2011,0,0,0
JPN,Japan,NIU,Niue,2012,0,0,0
JPN,Japan,NIU,Niue,2013,0,0,0
JPN,Japan,NIU,Niue,2014,0,0,0
JPN,Japan,NIU,Niue,2015,0,0,0
JPN,Japan,NIU,Niue,2016,0,0,0
JPN,Japan,NIU,Niue,2017,0,0,0
KOR,Korea,NIU,Niue,2008,0,0,0
KOR,Korea,NIU,Niue,2009,0,0,0
KOR,Korea,NIU,Niue,2010,0,0,0
KOR,Korea,NIU,Niue,2011,0,0,0
KOR,Korea,NIU,Niue,2012,0,0,0
KOR,Korea,NIU,Niue,2013,0,0,0
KOR,Korea,NIU,Niue,2014,0,0,0
KOR,Korea,NIU,Niue,2015,0,0,0
KOR,Korea,NIU,Niue,2016,0,0,0
KOR,Korea,NIU,Niue,2017,0,0,0
LUX,Luxembourg,NIU,Niue,2008,0,0,0
LUX,Luxembourg,NIU,Niue,2009,0,0,0
LUX,Luxembourg,NIU,Niue,2010,0,0,0
LUX,Luxembourg,NIU,Niue,2011,0,0,0
LUX,Luxembourg,NIU,Niue,2012,0,0,0
LUX,Luxembourg,NIU,Niue,2013,0,0,0
LUX,Luxembourg,NIU,Niue,2014,0,0,0
LUX,Luxembourg,NIU,Niue,2015,0,0,0
LUX,Luxembourg,NIU,Niue,2016,0,0,0
LUX,Luxembourg,NIU,Niue,2017,0,0,0
MEX,Mexico,NIU,Niue,2012,0,0,0
MEX,Mexico,NIU,Niue,2013,0,0,0
MEX,Mexico,NIU,Niue,2014,0,0,0
NOR,Norway,NIU,Niue,2008,0,0,0
NOR,Norway,NIU,Niue,2009,0,0,0
NOR,Norway,NIU,Niue,2010,0,0,0
NOR,Norway,NIU,Niue,2011,0,0,0
NOR,Norway,NIU,Niue,2012,0,0,0
NOR,Norway,NIU,Niue,2013,0,0,0
NOR,Norway,NIU,Niue,2014,0,0,0
NOR,Norway,NIU,Niue,2015,0,0,0
NOR,Norway,NIU,Niue,2016,0,0,0
NOR,Norway,NIU,Niue,2017,0,0,0
POL,Poland,NIU,Niue,2009,0,0,0
POL,Poland,NIU,Niue,2010,0,0,0
POL,Poland,NIU,Niue,2011,0,0,0
POL,Poland,NIU,Niue,2012,0,0,0
POL,Poland,NIU,Niue,2013,0,0,0
POL,Poland,NIU,Niue,2014,0,0,0
POL,Poland,NIU,Niue,2015,0,0,0
POL,Poland,NIU,Niue,2016,0,0,0
POL,Poland,NIU,Niue,2017,0,0,0
ESP,Spain,NIU,Niue,2008,0,0,0
ESP,Spain,NIU,Niue,2009,0,0,0
ESP,Spain,NIU,Niue,2010,0,0,0
ESP,Spain,NIU,Niue,2011,0,0,0
ESP,Spain,NIU,Niue,2012,0,0,0
ESP,Spain,NIU,Niue,2013,0,0,0
SWE,Sweden,NIU,Niue,2008,0,0,0
SWE,Sweden,NIU,Niue,2009,0,0,0
SWE,Sweden,NIU,Niue,2010,0,0,0
SWE,Sweden,NIU,Niue,2011,0,0,0
SWE,Sweden,NIU,Niue,2012,0,0,0
SWE,Sweden,NIU,Niue,2013,0,0,0
SWE,Sweden,NIU,Niue,2014,0,0,0
SWE,Sweden,NIU,Niue,2015,0,0,0
CHL,Chile,NIU,Niue,2008,0,0,0
CHL,Chile,NIU,Niue,2009,0,0,0
CHL,Chile,NIU,Niue,2010,0,0,0
CHL,Chile,NIU,Niue,2011,0,0,0
CHL,Chile,NIU,Niue,2012,0,0,0
CHL,Chile,NIU,Niue,2013,0,0,0
CHL,Chile,NIU,Niue,2014,0,0,0
CHL,Chile,NIU,Niue,2015,0,0,0
CHL,Chile,NIU,Niue,2016,0,0,0
EST,Estonia,NIU,Niue,2017,0,0,0
AUS,Australia,OMN,Oman,2008,5,11,-6
AUS,Australia,OMN,Oman,2009,7,11,-4
AUS,Australia,OMN,Oman,2010,7,0,7
AUS,Australia,OMN,Oman,2011,11,8,3
AUS,Australia,OMN,Oman,2012,11,2,9
AUS,Australia,OMN,Oman,2013,13,8,5
AUS,Australia,OMN,Oman,2014,8,13,-5
AUS,Australia,OMN,Oman,2015,0,30,-30
AUS,Australia,OMN,Oman,2016,0,11,-11
AUS,Australia,OMN,Oman,2017,0,16,-16
AUT,Austria,OMN,Oman,2008,3,2,1
AUT,Austria,OMN,Oman,2009,1,1,0
AUT,Austria,OMN,Oman,2010,1,1,0
AUT,Austria,OMN,Oman,2011,1,3,-2
AUT,Austria,OMN,Oman,2012,1,96,-95
AUT,Austria,OMN,Oman,2013,7,42,-35
AUT,Austria,OMN,Oman,2014,12,11,1
AUT,Austria,OMN,Oman,2015,20,20,0
AUT,Austria,OMN,Oman,2016,35,15,20
AUT,Austria,OMN,Oman,2017,32,2,30
BEL,Belgium,OMN,Oman,2008,0,2,-2
BEL,Belgium,OMN,Oman,2009,0,2,-2
BEL,Belgium,OMN,Oman,2010,0,1,-1
BEL,Belgium,OMN,Oman,2012,1,1,0
BEL,Belgium,OMN,Oman,2013,0,1,-1
BEL,Belgium,OMN,Oman,2014,0,1,-1
BEL,Belgium,OMN,Oman,2016,0,3,-3
CAN,Canada,OMN,Oman,2008,0,10,-10
CAN,Canada,OMN,Oman,2009,0,7,-7
CAN,Canada,OMN,Oman,2010,0,14,-14
CAN,Canada,OMN,Oman,2011,0,10,-10
CAN,Canada,OMN,Oman,2012,0,13,-13
CAN,Canada,OMN,Oman,2013,0,11,-11
CAN,Canada,OMN,Oman,2014,0,8,-8
CAN,Canada,OMN,Oman,2015,0,5,-5
CAN,Canada,OMN,Oman,2016,0,0,0
CAN,Canada,OMN,Oman,2017,0,10,-10
CZE,Czech Republic,OMN,Oman,2008,0,4,-4
CZE,Czech Republic,OMN,Oman,2009,0,4,-4
DNK,Denmark,OMN,Oman,2008,0,0,0
DNK,Denmark,OMN,Oman,2009,0,0,0
DNK,Denmark,OMN,Oman,2012,0,0,0
DNK,Denmark,OMN,Oman,2013,0,0,0
DNK,Denmark,OMN,Oman,2014,0,7,-7
DNK,Denmark,OMN,Oman,2015,9,0,9
DNK,Denmark,OMN,Oman,2016,1,0,1
DNK,Denmark,OMN,Oman,2017,0,2,-2
FIN,Finland,OMN,Oman,2008,0,0,0
FIN,Finland,OMN,Oman,2009,0,0,0
FIN,Finland,OMN,Oman,2010,0,0,0
FIN,Finland,OMN,Oman,2011,0,0,0
FIN,Finland,OMN,Oman,2012,0,1,-1
FIN,Finland,OMN,Oman,2013,0,0,0
FIN,Finland,OMN,Oman,2014,0,0,0
FIN,Finland,OMN,Oman,2015,0,0,0
FIN,Finland,OMN,Oman,2016,0,0,0
FIN,Finland,OMN,Oman,2017,0,5,-5
FRA,France,OMN,Oman,2008,0,6,-6
FRA,France,OMN,Oman,2009,0,5,-5
FRA,France,OMN,Oman,2010,0,3,-3
FRA,France,OMN,Oman,2011,0,8,-8
FRA,France,OMN,Oman,2012,0,11,-11
FRA,France,OMN,Oman,2013,0,8,-8
FRA,France,OMN,Oman,2014,0,5,-5
FRA,France,OMN,Oman,2015,0,9,-9
FRA,France,OMN,Oman,2016,0,6,-6
FRA,France,OMN,Oman,2017,0,8,-8
DEU,Germany,OMN,Oman,2008,61,81,-20
DEU,Germany,OMN,Oman,2009,40,109,-69
DEU,Germany,OMN,Oman,2010,73,92,-19
DEU,Germany,OMN,Oman,2011,116,210,-94
DEU,Germany,OMN,Oman,2012,98,87,11
DEU,Germany,OMN,Oman,2013,121,126,-5
DEU,Germany,OMN,Oman,2014,122,248,-126
DEU,Germany,OMN,Oman,2015,148,159,-11
DEU,Germany,OMN,Oman,2016,120,101,19
DEU,Germany,OMN,Oman,2017,116,94,22
HUN,Hungary,OMN,Oman,2008,0,0,0
HUN,Hungary,OMN,Oman,2009,0,2,-2
HUN,Hungary,OMN,Oman,2010,0,2,-2
HUN,Hungary,OMN,Oman,2011,0,4,-4
HUN,Hungary,OMN,Oman,2012,0,2,-2
HUN,Hungary,OMN,Oman,2013,0,0,0
HUN,Hungary,OMN,Oman,2014,1,0,1
HUN,Hungary,OMN,Oman,2015,0,5,-5
HUN,Hungary,OMN,Oman,2016,0,0,0
HUN,Hungary,OMN,Oman,2017,0,4,-4
ISL,Iceland,OMN,Oman,2008,0,0,0
ISL,Iceland,OMN,Oman,2009,0,0,0
ISL,Iceland,OMN,Oman,2010,0,2,-2
ISL,Iceland,OMN,Oman,2011,0,0,0
ISL,Iceland,OMN,Oman,2012,0,0,0
ISL,Iceland,OMN,Oman,2013,0,0,0
ISL,Iceland,OMN,Oman,2014,0,0,0
ISL,Iceland,OMN,Oman,2015,0,0,0
ISL,Iceland,OMN,Oman,2016,2,0,2
ISL,Iceland,OMN,Oman,2017,0,0,0
ITA,Italy,OMN,Oman,2008,3,1,2
ITA,Italy,OMN,Oman,2009,3,2,1
ITA,Italy,OMN,Oman,2010,0,1,-1
ITA,Italy,OMN,Oman,2011,0,2,-2
ITA,Italy,OMN,Oman,2012,0,1,-1
ITA,Italy,OMN,Oman,2013,8,14,-6
ITA,Italy,OMN,Oman,2014,1,4,-3
ITA,Italy,OMN,Oman,2015,0,11,-11
ITA,Italy,OMN,Oman,2016,0,9,-9
ITA,Italy,OMN,Oman,2017,15,29,-14
JPN,Japan,OMN,Oman,2008,70,71,-1
JPN,Japan,OMN,Oman,2009,92,92,0
JPN,Japan,OMN,Oman,2010,135,145,-10
JPN,Japan,OMN,Oman,2011,64,58,6
JPN,Japan,OMN,Oman,2012,102,114,-12
JPN,Japan,OMN,Oman,2013,83,91,-8
JPN,Japan,OMN,Oman,2014,169,170,-1
JPN,Japan,OMN,Oman,2015,67,67,0
JPN,Japan,OMN,Oman,2016,49,50,-1
JPN,Japan,OMN,Oman,2017,60,69,-9
KOR,Korea,OMN,Oman,2008,5,5,0
KOR,Korea,OMN,Oman,2009,4,3,1
KOR,Korea,OMN,Oman,2010,23,56,-33
KOR,Korea,OMN,Oman,2011,52,9,43
KOR,Korea,OMN,Oman,2012,14,10,4
KOR,Korea,OMN,Oman,2013,6,12,-6
KOR,Korea,OMN,Oman,2014,15,22,-7
KOR,Korea,OMN,Oman,2015,21,18,3
KOR,Korea,OMN,Oman,2016,10,14,-4
KOR,Korea,OMN,Oman,2017,23,11,12
LUX,Luxembourg,OMN,Oman,2008,0,0,0
LUX,Luxembourg,OMN,Oman,2009,0,0,0
LUX,Luxembourg,OMN,Oman,2010,0,0,0
LUX,Luxembourg,OMN,Oman,2011,0,0,0
LUX,Luxembourg,OMN,Oman,2012,0,0,0
LUX,Luxembourg,OMN,Oman,2013,0,0,0
LUX,Luxembourg,OMN,Oman,2014,0,0,0
LUX,Luxembourg,OMN,Oman,2015,0,0,0
LUX,Luxembourg,OMN,Oman,2016,0,0,0
LUX,Luxembourg,OMN,Oman,2017,0,0,0
MEX,Mexico,OMN,Oman,2009,0,1,-1
MEX,Mexico,OMN,Oman,2012,0,0,0
MEX,Mexico,OMN,Oman,2013,0,0,0
MEX,Mexico,OMN,Oman,2014,0,0,0
NLD,Netherlands,OMN,Oman,2008,29,21,8
NLD,Netherlands,OMN,Oman,2009,50,18,32
NLD,Netherlands,OMN,Oman,2010,15,12,3
NLD,Netherlands,OMN,Oman,2011,13,22,-9
NLD,Netherlands,OMN,Oman,2012,16,54,-38
NLD,Netherlands,OMN,Oman,2013,24,82,-58
NLD,Netherlands,OMN,Oman,2014,50,83,-33
NLD,Netherlands,OMN,Oman,2015,39,60,-21
NLD,Netherlands,OMN,Oman,2016,56,61,-5
NLD,Netherlands,OMN,Oman,2017,74,86,-12
NZL,New Zealand,OMN,Oman,2008,16,50,-34
NZL,New Zealand,OMN,Oman,2009,27,32,-5
NZL,New Zealand,OMN,Oman,2010,36,37,-1
NZL,New Zealand,OMN,Oman,2011,14,24,-10
NZL,New Zealand,OMN,Oman,2012,14,32,-18
NZL,New Zealand,OMN,Oman,2013,19,36,-17
NZL,New Zealand,OMN,Oman,2014,12,36,-24
NZL,New Zealand,OMN,Oman,2015,19,46,-27
NZL,New Zealand,OMN,Oman,2016,12,63,-51
NZL,New Zealand,OMN,Oman,2017,26,60,-34
NOR,Norway,OMN,Oman,2008,0,0,0
NOR,Norway,OMN,Oman,2009,0,0,0
NOR,Norway,OMN,Oman,2010,0,2,-2
NOR,Norway,OMN,Oman,2011,0,3,-3
NOR,Norway,OMN,Oman,2012,0,2,-2
NOR,Norway,OMN,Oman,2013,0,3,-3
NOR,Norway,OMN,Oman,2014,2,11,-9
NOR,Norway,OMN,Oman,2015,8,3,5
NOR,Norway,OMN,Oman,2016,7,6,1
NOR,Norway,OMN,Oman,2017,0,3,-3
POL,Poland,OMN,Oman,2009,0,0,0
POL,Poland,OMN,Oman,2010,0,0,0
POL,Poland,OMN,Oman,2011,0,0,0
POL,Poland,OMN,Oman,2012,0,0,0
POL,Poland,OMN,Oman,2013,0,0,0
POL,Poland,OMN,Oman,2014,0,0,0
POL,Poland,OMN,Oman,2015,0,4,-4
POL,Poland,OMN,Oman,2016,0,71,-71
POL,Poland,OMN,Oman,2017,0,39,-39
SVK,Slovak Republic,OMN,Oman,2008,1,0,1
ESP,Spain,OMN,Oman,2008,7,1,6
ESP,Spain,OMN,Oman,2009,2,2,0
ESP,Spain,OMN,Oman,2010,0,1,-1
ESP,Spain,OMN,Oman,2011,2,1,1
ESP,Spain,OMN,Oman,2012,1,7,-6
ESP,Spain,OMN,Oman,2013,2,23,-21
ESP,Spain,OMN,Oman,2014,2,10,-8
ESP,Spain,OMN,Oman,2015,9,7,2
ESP,Spain,OMN,Oman,2016,5,23,-18
ESP,Spain,OMN,Oman,2017,9,15,-6
SWE,Sweden,OMN,Oman,2008,0,8,-8
SWE,Sweden,OMN,Oman,2009,0,0,0
SWE,Sweden,OMN,Oman,2010,3,1,2
SWE,Sweden,OMN,Oman,2011,10,9,1
SWE,Sweden,OMN,Oman,2012,4,8,-4
SWE,Sweden,OMN,Oman,2013,1,7,-6
SWE,Sweden,OMN,Oman,2014,7,5,2
SWE,Sweden,OMN,Oman,2015,2,6,-4
SWE,Sweden,OMN,Oman,2016,7,3,4
SWE,Sweden,OMN,Oman,2017,1,2,-1
CHE,Switzerland,OMN,Oman,2010,5,10,-5
CHE,Switzerland,OMN,Oman,2011,5,8,-3
CHE,Switzerland,OMN,Oman,2012,2,7,-5
CHE,Switzerland,OMN,Oman,2013,3,4,-1
CHE,Switzerland,OMN,Oman,2014,3,11,-8
CHE,Switzerland,OMN,Oman,2015,6,10,-4
CHE,Switzerland,OMN,Oman,2016,12,8,4
CHE,Switzerland,OMN,Oman,2017,4,3,1
TUR,Turkey,OMN,Oman,2010,0,1,-1
GBR,United Kingdom,OMN,Oman,2011,0,1000,-1000
GBR,United Kingdom,OMN,Oman,2012,0,1000,-1000
GBR,United Kingdom,OMN,Oman,2013,0,1000,-1000
GBR,United Kingdom,OMN,Oman,2014,0,1000,-1000
GBR,United Kingdom,OMN,Oman,2015,0,1000,-1000
USA,United States,OMN,Oman,2008,0,70,-70
USA,United States,OMN,Oman,2009,0,74,-74
USA,United States,OMN,Oman,2010,0,63,-63
USA,United States,OMN,Oman,2011,0,60,-60
USA,United States,OMN,Oman,2012,0,74,-74
USA,United States,OMN,Oman,2013,0,73,-73
USA,United States,OMN,Oman,2014,0,90,-90
USA,United States,OMN,Oman,2015,0,85,-85
USA,United States,OMN,Oman,2016,0,116,-116
USA,United States,OMN,Oman,2017,0,104,-104
CHL,Chile,OMN,Oman,2008,0,0,0
CHL,Chile,OMN,Oman,2009,0,0,0
CHL,Chile,OMN,Oman,2010,0,0,0
CHL,Chile,OMN,Oman,2011,0,0,0
CHL,Chile,OMN,Oman,2012,0,1,-1
CHL,Chile,OMN,Oman,2013,0,1,-1
CHL,Chile,OMN,Oman,2014,0,0,0
CHL,Chile,OMN,Oman,2015,0,0,0
CHL,Chile,OMN,Oman,2016,0,1,-1
EST,Estonia,OMN,Oman,2008,0,0,0
EST,Estonia,OMN,Oman,2009,0,0,0
EST,Estonia,OMN,Oman,2010,0,0,0
EST,Estonia,OMN,Oman,2011,0,0,0
EST,Estonia,OMN,Oman,2012,0,0,0
EST,Estonia,OMN,Oman,2013,0,0,0
EST,Estonia,OMN,Oman,2014,0,0,0
EST,Estonia,OMN,Oman,2015,0,0,0
EST,Estonia,OMN,Oman,2016,0,0,0
EST,Estonia,OMN,Oman,2017,0,0,0
SVN,Slovenia,OMN,Oman,2009,0,1,-1
AUS,Australia,PAK,Pakistan,2008,309,1881,-1572
AUS,Australia,PAK,Pakistan,2009,253,1972,-1719
AUS,Australia,PAK,Pakistan,2010,281,1799,-1518
AUS,Australia,PAK,Pakistan,2011,303,1845,-1542
AUS,Australia,PAK,Pakistan,2012,273,3891,-3618
AUS,Australia,PAK,Pakistan,2013,322,3612,-3290
AUS,Australia,PAK,Pakistan,2014,342,5669,-5327
AUS,Australia,PAK,Pakistan,2015,400,8019,-7619
AUS,Australia,PAK,Pakistan,2016,400,6958,-6558
AUS,Australia,PAK,Pakistan,2017,0,6819,-6819
AUT,Austria,PAK,Pakistan,2008,212,402,-190
AUT,Austria,PAK,Pakistan,2009,241,376,-135
AUT,Austria,PAK,Pakistan,2010,357,450,-93
AUT,Austria,PAK,Pakistan,2011,433,866,-433
AUT,Austria,PAK,Pakistan,2012,588,1036,-448
AUT,Austria,PAK,Pakistan,2013,795,628,167
AUT,Austria,PAK,Pakistan,2014,506,649,-143
AUT,Austria,PAK,Pakistan,2015,484,1379,-895
AUT,Austria,PAK,Pakistan,2016,726,863,-137
AUT,Austria,PAK,Pakistan,2017,679,592,87
BEL,Belgium,PAK,Pakistan,2008,0,400,-400
BEL,Belgium,PAK,Pakistan,2009,0,574,-574
BEL,Belgium,PAK,Pakistan,2010,92,597,-505
BEL,Belgium,PAK,Pakistan,2011,0,751,-751
BEL,Belgium,PAK,Pakistan,2012,382,1320,-938
BEL,Belgium,PAK,Pakistan,2013,662,684,-22
BEL,Belgium,PAK,Pakistan,2014,734,560,174
BEL,Belgium,PAK,Pakistan,2015,559,876,-317
BEL,Belgium,PAK,Pakistan,2016,250,594,-344
BEL,Belgium,PAK,Pakistan,2017,263,583,-320
CAN,Canada,PAK,Pakistan,2008,0,8984,-8984
CAN,Canada,PAK,Pakistan,2009,0,7213,-7213
CAN,Canada,PAK,Pakistan,2010,0,6810,-6810
CAN,Canada,PAK,Pakistan,2011,0,7467,-7467
CAN,Canada,PAK,Pakistan,2012,0,11208,-11208
CAN,Canada,PAK,Pakistan,2013,0,12609,-12609
CAN,Canada,PAK,Pakistan,2014,0,9114,-9114
CAN,Canada,PAK,Pakistan,2015,0,11329,-11329
CAN,Canada,PAK,Pakistan,2016,0,11335,-11335
CAN,Canada,PAK,Pakistan,2017,0,7655,-7655
CZE,Czech Republic,PAK,Pakistan,2008,0,68,-68
CZE,Czech Republic,PAK,Pakistan,2009,0,52,-52
CZE,Czech Republic,PAK,Pakistan,2010,0,77,-77
CZE,Czech Republic,PAK,Pakistan,2011,0,20,-20
CZE,Czech Republic,PAK,Pakistan,2012,8,40,-32
CZE,Czech Republic,PAK,Pakistan,2013,26,33,-7
CZE,Czech Republic,PAK,Pakistan,2014,20,48,-28
CZE,Czech Republic,PAK,Pakistan,2015,18,40,-22
CZE,Czech Republic,PAK,Pakistan,2016,24,51,-27
CZE,Czech Republic,PAK,Pakistan,2017,28,64,-36
DNK,Denmark,PAK,Pakistan,2008,107,346,-239
DNK,Denmark,PAK,Pakistan,2009,120,463,-343
DNK,Denmark,PAK,Pakistan,2010,168,721,-553
DNK,Denmark,PAK,Pakistan,2011,236,653,-417
DNK,Denmark,PAK,Pakistan,2012,215,495,-280
DNK,Denmark,PAK,Pakistan,2013,264,795,-531
DNK,Denmark,PAK,Pakistan,2014,249,735,-486
DNK,Denmark,PAK,Pakistan,2015,239,548,-309
DNK,Denmark,PAK,Pakistan,2016,329,497,-168
DNK,Denmark,PAK,Pakistan,2017,291,467,-176
FIN,Finland,PAK,Pakistan,2008,21,123,-102
FIN,Finland,PAK,Pakistan,2009,11,181,-170
FIN,Finland,PAK,Pakistan,2010,16,174,-158
FIN,Finland,PAK,Pakistan,2011,22,227,-205
FIN,Finland,PAK,Pakistan,2012,32,269,-237
FIN,Finland,PAK,Pakistan,2013,31,190,-159
FIN,Finland,PAK,Pakistan,2014,18,316,-298
FIN,Finland,PAK,Pakistan,2015,28,287,-259
FIN,Finland,PAK,Pakistan,2016,39,299,-260
FIN,Finland,PAK,Pakistan,2017,37,286,-249
FRA,France,PAK,Pakistan,2008,0,795,-795
FRA,France,PAK,Pakistan,2009,0,789,-789
FRA,France,PAK,Pakistan,2010,0,822,-822
FRA,France,PAK,Pakistan,2011,0,876,-876
FRA,France,PAK,Pakistan,2012,0,1001,-1001
FRA,France,PAK,Pakistan,2013,0,1196,-1196
FRA,France,PAK,Pakistan,2014,0,1395,-1395
FRA,France,PAK,Pakistan,2015,0,1387,-1387
FRA,France,PAK,Pakistan,2016,0,1440,-1440
FRA,France,PAK,Pakistan,2017,0,1400,-1400
DEU,Germany,PAK,Pakistan,2008,1741,2169,-428
DEU,Germany,PAK,Pakistan,2009,1809,2756,-947
DEU,Germany,PAK,Pakistan,2010,1633,3310,-1677
DEU,Germany,PAK,Pakistan,2011,1660,5395,-3735
DEU,Germany,PAK,Pakistan,2012,1955,6513,-4558
DEU,Germany,PAK,Pakistan,2013,2211,7966,-5755
DEU,Germany,PAK,Pakistan,2014,2815,9549,-6734
DEU,Germany,PAK,Pakistan,2015,3997,24496,-20499
DEU,Germany,PAK,Pakistan,2016,9527,12207,-2680
DEU,Germany,PAK,Pakistan,2017,8054,9007,-953
HUN,Hungary,PAK,Pakistan,2008,3,20,-17
HUN,Hungary,PAK,Pakistan,2009,0,38,-38
HUN,Hungary,PAK,Pakistan,2010,6,39,-33
HUN,Hungary,PAK,Pakistan,2011,5,47,-42
HUN,Hungary,PAK,Pakistan,2012,7,49,-42
HUN,Hungary,PAK,Pakistan,2013,20,76,-56
HUN,Hungary,PAK,Pakistan,2014,8,81,-73
HUN,Hungary,PAK,Pakistan,2015,18,135,-117
HUN,Hungary,PAK,Pakistan,2016,17,184,-167
HUN,Hungary,PAK,Pakistan,2017,0,329,-329
ISL,Iceland,PAK,Pakistan,2008,39,0,39
ISL,Iceland,PAK,Pakistan,2009,8,1,7
ISL,Iceland,PAK,Pakistan,2010,0,4,-4
ISL,Iceland,PAK,Pakistan,2011,0,1,-1
ISL,Iceland,PAK,Pakistan,2012,0,4,-4
ISL,Iceland,PAK,Pakistan,2013,1,3,-2
ISL,Iceland,PAK,Pakistan,2014,1,4,-3
ISL,Iceland,PAK,Pakistan,2015,1,8,-7
ISL,Iceland,PAK,Pakistan,2016,4,11,-7
ISL,Iceland,PAK,Pakistan,2017,1,19,-18
ITA,Italy,PAK,Pakistan,2008,322,5706,-5384
ITA,Italy,PAK,Pakistan,2009,365,7858,-7493
ITA,Italy,PAK,Pakistan,2010,584,10816,-10232
ITA,Italy,PAK,Pakistan,2011,577,7452,-6875
ITA,Italy,PAK,Pakistan,2012,598,8754,-8156
ITA,Italy,PAK,Pakistan,2013,785,7794,-7009
ITA,Italy,PAK,Pakistan,2014,869,9558,-8689
ITA,Italy,PAK,Pakistan,2015,859,11361,-10502
ITA,Italy,PAK,Pakistan,2016,0,14735,-14735
ITA,Italy,PAK,Pakistan,2017,910,14978,-14068
JPN,Japan,PAK,Pakistan,2008,537,1174,-637
JPN,Japan,PAK,Pakistan,2009,554,1182,-628
JPN,Japan,PAK,Pakistan,2010,570,1037,-467
JPN,Japan,PAK,Pakistan,2011,524,1245,-721
JPN,Japan,PAK,Pakistan,2012,569,1345,-776
JPN,Japan,PAK,Pakistan,2013,468,1051,-583
JPN,Japan,PAK,Pakistan,2014,436,1170,-734
JPN,Japan,PAK,Pakistan,2015,530,1495,-965
JPN,Japan,PAK,Pakistan,2016,513,1486,-973
JPN,Japan,PAK,Pakistan,2017,579,1675,-1096
KOR,Korea,PAK,Pakistan,2008,2072,1905,167
KOR,Korea,PAK,Pakistan,2009,1753,1458,295
KOR,Korea,PAK,Pakistan,2010,1411,1666,-255
KOR,Korea,PAK,Pakistan,2011,1871,1681,190
KOR,Korea,PAK,Pakistan,2012,2285,2060,225
KOR,Korea,PAK,Pakistan,2013,2075,2457,-382
KOR,Korea,PAK,Pakistan,2014,1651,2190,-539
KOR,Korea,PAK,Pakistan,2015,2133,2690,-557
KOR,Korea,PAK,Pakistan,2016,1863,2724,-861
KOR,Korea,PAK,Pakistan,2017,2185,2491,-306
LUX,Luxembourg,PAK,Pakistan,2008,0,10,-10
LUX,Luxembourg,PAK,Pakistan,2009,3,9,-6
LUX,Luxembourg,PAK,Pakistan,2010,2,1,1
LUX,Luxembourg,PAK,Pakistan,2011,1,12,-11
LUX,Luxembourg,PAK,Pakistan,2012,0,12,-12
LUX,Luxembourg,PAK,Pakistan,2013,9,19,-10
LUX,Luxembourg,PAK,Pakistan,2014,7,13,-6
LUX,Luxembourg,PAK,Pakistan,2015,6,17,-11
LUX,Luxembourg,PAK,Pakistan,2016,9,38,-29
LUX,Luxembourg,PAK,Pakistan,2017,10,31,-21
MEX,Mexico,PAK,Pakistan,2008,0,20,-20
MEX,Mexico,PAK,Pakistan,2009,0,19,-19
MEX,Mexico,PAK,Pakistan,2010,0,26,-26
MEX,Mexico,PAK,Pakistan,2011,0,34,-34
MEX,Mexico,PAK,Pakistan,2012,0,37,-37
MEX,Mexico,PAK,Pakistan,2013,0,84,-84
MEX,Mexico,PAK,Pakistan,2014,0,54,-54
MEX,Mexico,PAK,Pakistan,2015,0,26,-26
MEX,Mexico,PAK,Pakistan,2016,0,42,-42
MEX,Mexico,PAK,Pakistan,2017,0,48,-48
NLD,Netherlands,PAK,Pakistan,2008,279,383,-104
NLD,Netherlands,PAK,Pakistan,2009,142,392,-250
NLD,Netherlands,PAK,Pakistan,2010,269,406,-137
NLD,Netherlands,PAK,Pakistan,2011,263,489,-226
NLD,Netherlands,PAK,Pakistan,2012,286,463,-177
NLD,Netherlands,PAK,Pakistan,2013,277,541,-264
NLD,Netherlands,PAK,Pakistan,2014,273,512,-239
NLD,Netherlands,PAK,Pakistan,2015,223,660,-437
NLD,Netherlands,PAK,Pakistan,2016,249,669,-420
NLD,Netherlands,PAK,Pakistan,2017,229,771,-542
NZL,New Zealand,PAK,Pakistan,2008,14,210,-196
NZL,New Zealand,PAK,Pakistan,2009,39,174,-135
NZL,New Zealand,PAK,Pakistan,2010,50,260,-210
NZL,New Zealand,PAK,Pakistan,2011,72,261,-189
NZL,New Zealand,PAK,Pakistan,2012,65,263,-198
NZL,New Zealand,PAK,Pakistan,2013,107,388,-281
NZL,New Zealand,PAK,Pakistan,2014,70,533,-463
NZL,New Zealand,PAK,Pakistan,2015,62,714,-652
NZL,New Zealand,PAK,Pakistan,2016,78,764,-686
NZL,New Zealand,PAK,Pakistan,2017,53,706,-653
NOR,Norway,PAK,Pakistan,2008,116,572,-456
NOR,Norway,PAK,Pakistan,2009,168,652,-484
NOR,Norway,PAK,Pakistan,2010,168,506,-338
NOR,Norway,PAK,Pakistan,2011,187,602,-415
NOR,Norway,PAK,Pakistan,2012,214,781,-567
NOR,Norway,PAK,Pakistan,2013,290,605,-315
NOR,Norway,PAK,Pakistan,2014,221,559,-338
NOR,Norway,PAK,Pakistan,2015,236,539,-303
NOR,Norway,PAK,Pakistan,2016,214,591,-377
NOR,Norway,PAK,Pakistan,2017,194,581,-387
POL,Poland,PAK,Pakistan,2008,0,139,-139
POL,Poland,PAK,Pakistan,2009,0,153,-153
POL,Poland,PAK,Pakistan,2010,0,159,-159
POL,Poland,PAK,Pakistan,2011,0,141,-141
POL,Poland,PAK,Pakistan,2012,0,223,-223
POL,Poland,PAK,Pakistan,2013,0,283,-283
POL,Poland,PAK,Pakistan,2014,0,155,-155
POL,Poland,PAK,Pakistan,2015,0,484,-484
POL,Poland,PAK,Pakistan,2016,0,600,-600
POL,Poland,PAK,Pakistan,2017,0,654,-654
PRT,Portugal,PAK,Pakistan,2008,0,268,-268
PRT,Portugal,PAK,Pakistan,2009,0,342,-342
PRT,Portugal,PAK,Pakistan,2010,0,357,-357
PRT,Portugal,PAK,Pakistan,2011,0,312,-312
PRT,Portugal,PAK,Pakistan,2012,0,415,-415
PRT,Portugal,PAK,Pakistan,2013,0,403,-403
PRT,Portugal,PAK,Pakistan,2014,0,424,-424
PRT,Portugal,PAK,Pakistan,2015,0,568,-568
PRT,Portugal,PAK,Pakistan,2016,0,468,-468
PRT,Portugal,PAK,Pakistan,2017,0,625,-625
SVK,Slovak Republic,PAK,Pakistan,2008,6,4,2
SVK,Slovak Republic,PAK,Pakistan,2009,1,1,0
SVK,Slovak Republic,PAK,Pakistan,2010,8,2,6
SVK,Slovak Republic,PAK,Pakistan,2011,0,3,-3
SVK,Slovak Republic,PAK,Pakistan,2012,0,1,-1
SVK,Slovak Republic,PAK,Pakistan,2013,0,2,-2
SVK,Slovak Republic,PAK,Pakistan,2014,0,1,-1
SVK,Slovak Republic,PAK,Pakistan,2015,0,2,-2
SVK,Slovak Republic,PAK,Pakistan,2016,1,1,0
SVK,Slovak Republic,PAK,Pakistan,2017,0,3,-3
ESP,Spain,PAK,Pakistan,2008,4843,8872,-4029
ESP,Spain,PAK,Pakistan,2009,7056,6425,631
ESP,Spain,PAK,Pakistan,2010,7921,15322,-7401
ESP,Spain,PAK,Pakistan,2011,11305,11513,-208
ESP,Spain,PAK,Pakistan,2012,12597,8345,4252
ESP,Spain,PAK,Pakistan,2013,13560,6484,7076
ESP,Spain,PAK,Pakistan,2014,7967,5311,2656
ESP,Spain,PAK,Pakistan,2015,6098,4811,1287
ESP,Spain,PAK,Pakistan,2016,5218,6371,-1153
ESP,Spain,PAK,Pakistan,2017,4693,6556,-1863
SWE,Sweden,PAK,Pakistan,2008,248,1500,-1252
SWE,Sweden,PAK,Pakistan,2009,285,1756,-1471
SWE,Sweden,PAK,Pakistan,2010,451,1575,-1124
SWE,Sweden,PAK,Pakistan,2011,615,896,-281
SWE,Sweden,PAK,Pakistan,2012,708,931,-223
SWE,Sweden,PAK,Pakistan,2013,576,796,-220
SWE,Sweden,PAK,Pakistan,2014,578,796,-218
SWE,Sweden,PAK,Pakistan,2015,802,1090,-288
SWE,Sweden,PAK,Pakistan,2016,235,1211,-976
SWE,Sweden,PAK,Pakistan,2017,229,1699,-1470
CHE,Switzerland,PAK,Pakistan,2010,99,241,-142
CHE,Switzerland,PAK,Pakistan,2011,102,233,-131
CHE,Switzerland,PAK,Pakistan,2012,89,218,-129
CHE,Switzerland,PAK,Pakistan,2013,106,217,-111
CHE,Switzerland,PAK,Pakistan,2014,90,216,-126
CHE,Switzerland,PAK,Pakistan,2015,96,207,-111
CHE,Switzerland,PAK,Pakistan,2016,103,228,-125
CHE,Switzerland,PAK,Pakistan,2017,85,198,-113
TUR,Turkey,PAK,Pakistan,2010,0,143,-143
TUR,Turkey,PAK,Pakistan,2016,624,1113,-489
TUR,Turkey,PAK,Pakistan,2017,627,1468,-841
GBR,United Kingdom,PAK,Pakistan,2008,3000,17000,-14000
GBR,United Kingdom,PAK,Pakistan,2009,4000,17000,-13000
GBR,United Kingdom,PAK,Pakistan,2010,3000,30000,-27000
GBR,United Kingdom,PAK,Pakistan,2011,2000,43000,-41000
GBR,United Kingdom,PAK,Pakistan,2012,4000,19000,-15000
GBR,United Kingdom,PAK,Pakistan,2013,4000,10000,-6000
GBR,United Kingdom,PAK,Pakistan,2014,3000,11000,-8000
GBR,United Kingdom,PAK,Pakistan,2015,3000,8000,-5000
GBR,United Kingdom,PAK,Pakistan,2016,0,11000,-11000
GBR,United Kingdom,PAK,Pakistan,2017,0,15000,-15000
USA,United States,PAK,Pakistan,2008,0,19719,-19719
USA,United States,PAK,Pakistan,2009,0,21555,-21555
USA,United States,PAK,Pakistan,2010,0,18258,-18258
USA,United States,PAK,Pakistan,2011,0,15546,-15546
USA,United States,PAK,Pakistan,2012,0,14740,-14740
USA,United States,PAK,Pakistan,2013,0,13251,-13251
USA,United States,PAK,Pakistan,2014,0,18612,-18612
USA,United States,PAK,Pakistan,2015,0,18057,-18057
USA,United States,PAK,Pakistan,2016,0,19313,-19313
USA,United States,PAK,Pakistan,2017,0,17408,-17408
CHL,Chile,PAK,Pakistan,2008,0,39,-39
CHL,Chile,PAK,Pakistan,2009,0,73,-73
CHL,Chile,PAK,Pakistan,2010,0,52,-52
CHL,Chile,PAK,Pakistan,2011,0,44,-44
CHL,Chile,PAK,Pakistan,2012,0,44,-44
CHL,Chile,PAK,Pakistan,2013,0,41,-41
CHL,Chile,PAK,Pakistan,2014,0,21,-21
CHL,Chile,PAK,Pakistan,2015,0,57,-57
CHL,Chile,PAK,Pakistan,2016,0,114,-114
EST,Estonia,PAK,Pakistan,2008,0,1,-1
EST,Estonia,PAK,Pakistan,2009,0,4,-4
EST,Estonia,PAK,Pakistan,2010,0,1,-1
EST,Estonia,PAK,Pakistan,2011,0,10,-10
EST,Estonia,PAK,Pakistan,2012,0,8,-8
EST,Estonia,PAK,Pakistan,2013,0,10,-10
EST,Estonia,PAK,Pakistan,2014,0,1,-1
EST,Estonia,PAK,Pakistan,2015,0,28,-28
EST,Estonia,PAK,Pakistan,2016,0,39,-39
EST,Estonia,PAK,Pakistan,2017,0,48,-48
SVN,Slovenia,PAK,Pakistan,2008,0,4,-4
SVN,Slovenia,PAK,Pakistan,2009,0,4,-4
SVN,Slovenia,PAK,Pakistan,2010,0,4,-4
SVN,Slovenia,PAK,Pakistan,2011,0,3,-3
SVN,Slovenia,PAK,Pakistan,2012,0,1,-1
SVN,Slovenia,PAK,Pakistan,2013,0,7,-7
SVN,Slovenia,PAK,Pakistan,2014,0,9,-9
SVN,Slovenia,PAK,Pakistan,2015,1,10,-9
SVN,Slovenia,PAK,Pakistan,2016,0,18,-18
SVN,Slovenia,PAK,Pakistan,2017,0,7,-7
AUS,Australia,PLW,Palau,2008,0,0,0
AUS,Australia,PLW,Palau,2009,0,0,0
AUS,Australia,PLW,Palau,2010,0,0,0
AUS,Australia,PLW,Palau,2011,0,0,0
AUS,Australia,PLW,Palau,2012,0,0,0
AUS,Australia,PLW,Palau,2013,0,0,0
AUS,Australia,PLW,Palau,2014,0,0,0
AUS,Australia,PLW,Palau,2015,0,0,0
AUS,Australia,PLW,Palau,2016,0,0,0
AUS,Australia,PLW,Palau,2017,0,0,0
AUT,Austria,PLW,Palau,2008,0,0,0
AUT,Austria,PLW,Palau,2009,0,2,-2
AUT,Austria,PLW,Palau,2010,0,0,0
AUT,Austria,PLW,Palau,2011,0,0,0
AUT,Austria,PLW,Palau,2012,0,0,0
AUT,Austria,PLW,Palau,2013,0,2,-2
AUT,Austria,PLW,Palau,2014,0,6,-6
AUT,Austria,PLW,Palau,2015,1,0,1
AUT,Austria,PLW,Palau,2016,1,9,-8
AUT,Austria,PLW,Palau,2017,0,0,0
BEL,Belgium,PLW,Palau,2010,0,0,0
CAN,Canada,PLW,Palau,2008,0,0,0
CAN,Canada,PLW,Palau,2009,0,0,0
CAN,Canada,PLW,Palau,2010,0,0,0
CAN,Canada,PLW,Palau,2011,0,0,0
CAN,Canada,PLW,Palau,2012,0,0,0
CAN,Canada,PLW,Palau,2013,0,0,0
CAN,Canada,PLW,Palau,2014,0,0,0
CAN,Canada,PLW,Palau,2015,0,0,0
CAN,Canada,PLW,Palau,2016,0,0,0
CAN,Canada,PLW,Palau,2017,0,0,0
DNK,Denmark,PLW,Palau,2013,0,0,0
DNK,Denmark,PLW,Palau,2014,0,0,0
DNK,Denmark,PLW,Palau,2015,0,0,0
DNK,Denmark,PLW,Palau,2016,0,0,0
DNK,Denmark,PLW,Palau,2017,0,0,0
FIN,Finland,PLW,Palau,2008,0,0,0
FIN,Finland,PLW,Palau,2009,0,0,0
FIN,Finland,PLW,Palau,2010,0,0,0
FIN,Finland,PLW,Palau,2011,0,0,0
FIN,Finland,PLW,Palau,2012,0,0,0
FIN,Finland,PLW,Palau,2013,0,0,0
FIN,Finland,PLW,Palau,2014,0,0,0
FIN,Finland,PLW,Palau,2015,0,0,0
FIN,Finland,PLW,Palau,2016,0,0,0
FIN,Finland,PLW,Palau,2017,0,0,0
FRA,France,PLW,Palau,2008,0,0,0
FRA,France,PLW,Palau,2009,0,0,0
FRA,France,PLW,Palau,2010,0,0,0
FRA,France,PLW,Palau,2011,0,0,0
FRA,France,PLW,Palau,2012,0,0,0
FRA,France,PLW,Palau,2013,0,0,0
FRA,France,PLW,Palau,2014,0,0,0
FRA,France,PLW,Palau,2015,0,0,0
FRA,France,PLW,Palau,2016,0,0,0
FRA,France,PLW,Palau,2017,0,0,0
DEU,Germany,PLW,Palau,2008,0,3,-3
DEU,Germany,PLW,Palau,2009,2,3,-1
DEU,Germany,PLW,Palau,2010,1,5,-4
DEU,Germany,PLW,Palau,2011,2,2,0
DEU,Germany,PLW,Palau,2012,1,3,-2
DEU,Germany,PLW,Palau,2013,3,3,0
DEU,Germany,PLW,Palau,2014,1,2,-1
DEU,Germany,PLW,Palau,2015,1,4,-3
DEU,Germany,PLW,Palau,2016,2,4,-2
DEU,Germany,PLW,Palau,2017,1,0,1
HUN,Hungary,PLW,Palau,2008,0,0,0
HUN,Hungary,PLW,Palau,2009,0,0,0
HUN,Hungary,PLW,Palau,2010,0,0,0
HUN,Hungary,PLW,Palau,2011,0,0,0
HUN,Hungary,PLW,Palau,2012,0,0,0
HUN,Hungary,PLW,Palau,2013,0,0,0
HUN,Hungary,PLW,Palau,2014,0,0,0
HUN,Hungary,PLW,Palau,2015,0,0,0
HUN,Hungary,PLW,Palau,2016,0,0,0
HUN,Hungary,PLW,Palau,2017,0,0,0
ISL,Iceland,PLW,Palau,2016,0,0,0
ISL,Iceland,PLW,Palau,2017,0,0,0
ITA,Italy,PLW,Palau,2008,0,3,-3
ITA,Italy,PLW,Palau,2009,0,2,-2
ITA,Italy,PLW,Palau,2010,0,3,-3
ITA,Italy,PLW,Palau,2011,0,1,-1
ITA,Italy,PLW,Palau,2012,0,0,0
ITA,Italy,PLW,Palau,2013,0,0,0
ITA,Italy,PLW,Palau,2015,0,0,0
ITA,Italy,PLW,Palau,2017,0,1,-1
JPN,Japan,PLW,Palau,2008,74,73,1
JPN,Japan,PLW,Palau,2009,60,59,1
JPN,Japan,PLW,Palau,2010,32,36,-4
JPN,Japan,PLW,Palau,2011,15,15,0
JPN,Japan,PLW,Palau,2012,18,22,-4
JPN,Japan,PLW,Palau,2013,52,53,-1
JPN,Japan,PLW,Palau,2014,57,57,0
JPN,Japan,PLW,Palau,2015,74,77,-3
JPN,Japan,PLW,Palau,2016,61,64,-3
JPN,Japan,PLW,Palau,2017,83,85,-2
KOR,Korea,PLW,Palau,2008,0,1,-1
KOR,Korea,PLW,Palau,2009,1,3,-2
KOR,Korea,PLW,Palau,2010,2,1,1
KOR,Korea,PLW,Palau,2011,1,2,-1
KOR,Korea,PLW,Palau,2012,7,8,-1
KOR,Korea,PLW,Palau,2013,0,1,-1
KOR,Korea,PLW,Palau,2014,5,3,2
KOR,Korea,PLW,Palau,2015,3,1,2
KOR,Korea,PLW,Palau,2016,2,2,0
KOR,Korea,PLW,Palau,2017,0,2,-2
LUX,Luxembourg,PLW,Palau,2008,0,0,0
LUX,Luxembourg,PLW,Palau,2009,0,0,0
LUX,Luxembourg,PLW,Palau,2010,0,0,0
LUX,Luxembourg,PLW,Palau,2011,0,0,0
LUX,Luxembourg,PLW,Palau,2012,0,0,0
LUX,Luxembourg,PLW,Palau,2013,0,0,0
LUX,Luxembourg,PLW,Palau,2014,0,0,0
LUX,Luxembourg,PLW,Palau,2015,0,0,0
LUX,Luxembourg,PLW,Palau,2016,0,0,0
LUX,Luxembourg,PLW,Palau,2017,0,0,0
MEX,Mexico,PLW,Palau,2012,0,0,0
MEX,Mexico,PLW,Palau,2013,0,0,0
MEX,Mexico,PLW,Palau,2014,0,0,0
NZL,New Zealand,PLW,Palau,2008,0,1,-1
NZL,New Zealand,PLW,Palau,2010,3,1,2
NZL,New Zealand,PLW,Palau,2011,0,1,-1
NZL,New Zealand,PLW,Palau,2016,0,1,-1
NOR,Norway,PLW,Palau,2008,0,0,0
NOR,Norway,PLW,Palau,2009,0,0,0
NOR,Norway,PLW,Palau,2010,0,0,0
NOR,Norway,PLW,Palau,2011,0,0,0
NOR,Norway,PLW,Palau,2012,0,0,0
NOR,Norway,PLW,Palau,2013,0,0,0
NOR,Norway,PLW,Palau,2014,0,0,0
NOR,Norway,PLW,Palau,2015,0,0,0
NOR,Norway,PLW,Palau,2016,0,0,0
NOR,Norway,PLW,Palau,2017,0,0,0
POL,Poland,PLW,Palau,2009,0,0,0
POL,Poland,PLW,Palau,2010,0,0,0
POL,Poland,PLW,Palau,2011,0,0,0
POL,Poland,PLW,Palau,2012,0,0,0
POL,Poland,PLW,Palau,2013,0,0,0
POL,Poland,PLW,Palau,2014,0,0,0
POL,Poland,PLW,Palau,2015,0,0,0
POL,Poland,PLW,Palau,2016,0,0,0
POL,Poland,PLW,Palau,2017,0,0,0
SVK,Slovak Republic,PLW,Palau,2008,1,0,1
ESP,Spain,PLW,Palau,2008,3,2,1
ESP,Spain,PLW,Palau,2009,0,3,-3
ESP,Spain,PLW,Palau,2010,0,1,-1
ESP,Spain,PLW,Palau,2011,0,0,0
ESP,Spain,PLW,Palau,2012,0,2,-2
ESP,Spain,PLW,Palau,2013,0,1,-1
ESP,Spain,PLW,Palau,2014,0,3,-3
ESP,Spain,PLW,Palau,2015,0,1,-1
ESP,Spain,PLW,Palau,2016,0,4,-4
ESP,Spain,PLW,Palau,2017,0,4,-4
SWE,Sweden,PLW,Palau,2008,0,0,0
SWE,Sweden,PLW,Palau,2009,0,0,0
SWE,Sweden,PLW,Palau,2010,0,0,0
SWE,Sweden,PLW,Palau,2011,0,0,0
SWE,Sweden,PLW,Palau,2012,0,0,0
SWE,Sweden,PLW,Palau,2013,0,0,0
SWE,Sweden,PLW,Palau,2014,0,0,0
SWE,Sweden,PLW,Palau,2015,0,0,0
SWE,Sweden,PLW,Palau,2016,0,1,-1
SWE,Sweden,PLW,Palau,2017,0,0,0
CHE,Switzerland,PLW,Palau,2010,0,0,0
CHE,Switzerland,PLW,Palau,2011,0,0,0
CHE,Switzerland,PLW,Palau,2012,0,0,0
CHE,Switzerland,PLW,Palau,2013,0,0,0
USA,United States,PLW,Palau,2008,0,6,-6
USA,United States,PLW,Palau,2009,0,16,-16
USA,United States,PLW,Palau,2010,0,18,-18
USA,United States,PLW,Palau,2011,0,7,-7
USA,United States,PLW,Palau,2012,0,10,-10
USA,United States,PLW,Palau,2013,0,16,-16
USA,United States,PLW,Palau,2014,0,12,-12
USA,United States,PLW,Palau,2015,0,15,-15
USA,United States,PLW,Palau,2016,0,14,-14
USA,United States,PLW,Palau,2017,0,13,-13
CHL,Chile,PLW,Palau,2008,0,0,0
CHL,Chile,PLW,Palau,2009,0,0,0
CHL,Chile,PLW,Palau,2010,0,0,0
CHL,Chile,PLW,Palau,2011,0,0,0
CHL,Chile,PLW,Palau,2012,0,0,0
CHL,Chile,PLW,Palau,2013,0,0,0
CHL,Chile,PLW,Palau,2014,0,0,0
CHL,Chile,PLW,Palau,2015,0,0,0
CHL,Chile,PLW,Palau,2016,0,0,0
EST,Estonia,PLW,Palau,2008,0,0,0
EST,Estonia,PLW,Palau,2009,0,0,0
EST,Estonia,PLW,Palau,2010,0,0,0
EST,Estonia,PLW,Palau,2011,0,0,0
EST,Estonia,PLW,Palau,2012,0,0,0
EST,Estonia,PLW,Palau,2013,0,0,0
EST,Estonia,PLW,Palau,2014,0,0,0
EST,Estonia,PLW,Palau,2015,0,0,0
EST,Estonia,PLW,Palau,2016,0,0,0
EST,Estonia,PLW,Palau,2017,0,0,0
AUS,Australia,PSE,West Bank and Gaza Strip,2008,0,0,0
AUS,Australia,PSE,West Bank and Gaza Strip,2009,0,4,-4
AUS,Australia,PSE,West Bank and Gaza Strip,2010,0,1,-1
AUS,Australia,PSE,West Bank and Gaza Strip,2011,0,0,0
AUS,Australia,PSE,West Bank and Gaza Strip,2012,0,0,0
AUS,Australia,PSE,West Bank and Gaza Strip,2013,5,0,5
AUS,Australia,PSE,West Bank and Gaza Strip,2014,0,0,0
AUS,Australia,PSE,West Bank and Gaza Strip,2015,0,0,0
AUS,Australia,PSE,West Bank and Gaza Strip,2016,0,0,0
AUS,Australia,PSE,West Bank and Gaza Strip,2017,0,0,0
AUT,Austria,PSE,West Bank and Gaza Strip,2014,0,0,0
AUT,Austria,PSE,West Bank and Gaza Strip,2015,0,0,0
AUT,Austria,PSE,West Bank and Gaza Strip,2016,0,0,0
AUT,Austria,PSE,West Bank and Gaza Strip,2017,0,0,0
BEL,Belgium,PSE,West Bank and Gaza Strip,2008,0,54,-54
BEL,Belgium,PSE,West Bank and Gaza Strip,2009,0,69,-69
BEL,Belgium,PSE,West Bank and Gaza Strip,2010,1,60,-59
BEL,Belgium,PSE,West Bank and Gaza Strip,2012,25,86,-61
BEL,Belgium,PSE,West Bank and Gaza Strip,2013,57,51,6
BEL,Belgium,PSE,West Bank and Gaza Strip,2014,25,83,-58
BEL,Belgium,PSE,West Bank and Gaza Strip,2015,7,109,-102
BEL,Belgium,PSE,West Bank and Gaza Strip,2016,19,564,-545
BEL,Belgium,PSE,West Bank and Gaza Strip,2017,18,820,-802
CAN,Canada,PSE,West Bank and Gaza Strip,2008,0,481,-481
CAN,Canada,PSE,West Bank and Gaza Strip,2009,0,399,-399
CAN,Canada,PSE,West Bank and Gaza Strip,2010,0,652,-652
CAN,Canada,PSE,West Bank and Gaza Strip,2011,0,555,-555
CAN,Canada,PSE,West Bank and Gaza Strip,2012,0,531,-531
CAN,Canada,PSE,West Bank and Gaza Strip,2013,0,462,-462
CAN,Canada,PSE,West Bank and Gaza Strip,2014,0,443,-443
CAN,Canada,PSE,West Bank and Gaza Strip,2015,0,553,-553
CAN,Canada,PSE,West Bank and Gaza Strip,2016,0,440,-440
CAN,Canada,PSE,West Bank and Gaza Strip,2017,0,345,-345
CZE,Czech Republic,PSE,West Bank and Gaza Strip,2008,3,5,-2
CZE,Czech Republic,PSE,West Bank and Gaza Strip,2009,1,11,-10
CZE,Czech Republic,PSE,West Bank and Gaza Strip,2010,0,14,-14
CZE,Czech Republic,PSE,West Bank and Gaza Strip,2011,0,6,-6
CZE,Czech Republic,PSE,West Bank and Gaza Strip,2012,2,11,-9
CZE,Czech Republic,PSE,West Bank and Gaza Strip,2013,15,8,7
CZE,Czech Republic,PSE,West Bank and Gaza Strip,2014,4,24,-20
CZE,Czech Republic,PSE,West Bank and Gaza Strip,2015,6,20,-14
CZE,Czech Republic,PSE,West Bank and Gaza Strip,2016,9,16,-7
CZE,Czech Republic,PSE,West Bank and Gaza Strip,2017,12,18,-6
DNK,Denmark,PSE,West Bank and Gaza Strip,2013,0,0,0
DNK,Denmark,PSE,West Bank and Gaza Strip,2014,0,0,0
DNK,Denmark,PSE,West Bank and Gaza Strip,2015,0,0,0
DNK,Denmark,PSE,West Bank and Gaza Strip,2016,0,0,0
DNK,Denmark,PSE,West Bank and Gaza Strip,2017,0,0,0
FIN,Finland,PSE,West Bank and Gaza Strip,2008,0,2,-2
FIN,Finland,PSE,West Bank and Gaza Strip,2009,0,19,-19
FIN,Finland,PSE,West Bank and Gaza Strip,2010,0,3,-3
FIN,Finland,PSE,West Bank and Gaza Strip,2011,0,4,-4
FIN,Finland,PSE,West Bank and Gaza Strip,2012,0,3,-3
FIN,Finland,PSE,West Bank and Gaza Strip,2013,0,0,0
FIN,Finland,PSE,West Bank and Gaza Strip,2014,0,3,-3
FIN,Finland,PSE,West Bank and Gaza Strip,2015,0,2,-2
FIN,Finland,PSE,West Bank and Gaza Strip,2016,0,0,0
FIN,Finland,PSE,West Bank and Gaza Strip,2017,2,0,2
FRA,France,PSE,West Bank and Gaza Strip,2008,0,56,-56
FRA,France,PSE,West Bank and Gaza Strip,2009,0,88,-88
FRA,France,PSE,West Bank and Gaza Strip,2010,0,94,-94
FRA,France,PSE,West Bank and Gaza Strip,2011,0,76,-76
FRA,France,PSE,West Bank and Gaza Strip,2012,0,86,-86
FRA,France,PSE,West Bank and Gaza Strip,2013,0,79,-79
FRA,France,PSE,West Bank and Gaza Strip,2014,0,116,-116
FRA,France,PSE,West Bank and Gaza Strip,2015,0,121,-121
FRA,France,PSE,West Bank and Gaza Strip,2016,0,175,-175
FRA,France,PSE,West Bank and Gaza Strip,2017,0,160,-160
DEU,Germany,PSE,West Bank and Gaza Strip,2016,288,946,-658
DEU,Germany,PSE,West Bank and Gaza Strip,2017,158,577,-419
HUN,Hungary,PSE,West Bank and Gaza Strip,2008,0,8,-8
HUN,Hungary,PSE,West Bank and Gaza Strip,2009,1,16,-15
HUN,Hungary,PSE,West Bank and Gaza Strip,2010,3,10,-7
HUN,Hungary,PSE,West Bank and Gaza Strip,2011,1,14,-13
HUN,Hungary,PSE,West Bank and Gaza Strip,2012,2,19,-17
HUN,Hungary,PSE,West Bank and Gaza Strip,2013,1,17,-16
HUN,Hungary,PSE,West Bank and Gaza Strip,2014,3,44,-41
HUN,Hungary,PSE,West Bank and Gaza Strip,2015,6,45,-39
HUN,Hungary,PSE,West Bank and Gaza Strip,2016,16,58,-42
HUN,Hungary,PSE,West Bank and Gaza Strip,2017,0,65,-65
ISL,Iceland,PSE,West Bank and Gaza Strip,2008,0,0,0
ISL,Iceland,PSE,West Bank and Gaza Strip,2009,0,0,0
ISL,Iceland,PSE,West Bank and Gaza Strip,2010,0,2,-2
ISL,Iceland,PSE,West Bank and Gaza Strip,2011,0,0,0
ISL,Iceland,PSE,West Bank and Gaza Strip,2012,0,4,-4
ISL,Iceland,PSE,West Bank and Gaza Strip,2013,3,3,0
ISL,Iceland,PSE,West Bank and Gaza Strip,2014,4,2,2
ISL,Iceland,PSE,West Bank and Gaza Strip,2015,2,8,-6
ISL,Iceland,PSE,West Bank and Gaza Strip,2016,1,7,-6
ISL,Iceland,PSE,West Bank and Gaza Strip,2017,4,9,-5
ITA,Italy,PSE,West Bank and Gaza Strip,2008,3,25,-22
ITA,Italy,PSE,West Bank and Gaza Strip,2009,3,109,-106
ITA,Italy,PSE,West Bank and Gaza Strip,2010,2,130,-128
ITA,Italy,PSE,West Bank and Gaza Strip,2011,2,73,-71
ITA,Italy,PSE,West Bank and Gaza Strip,2012,0,87,-87
ITA,Italy,PSE,West Bank and Gaza Strip,2013,2,53,-51
ITA,Italy,PSE,West Bank and Gaza Strip,2014,11,123,-112
ITA,Italy,PSE,West Bank and Gaza Strip,2015,12,118,-106
ITA,Italy,PSE,West Bank and Gaza Strip,2016,0,115,-115
ITA,Italy,PSE,West Bank and Gaza Strip,2017,7,206,-199
JPN,Japan,PSE,West Bank and Gaza Strip,2008,49,54,-5
JPN,Japan,PSE,West Bank and Gaza Strip,2009,47,52,-5
JPN,Japan,PSE,West Bank and Gaza Strip,2010,79,82,-3
JPN,Japan,PSE,West Bank and Gaza Strip,2011,34,34,0
JPN,Japan,PSE,West Bank and Gaza Strip,2012,52,55,-3
JPN,Japan,PSE,West Bank and Gaza Strip,2013,50,52,-2
JPN,Japan,PSE,West Bank and Gaza Strip,2014,54,58,-4
JPN,Japan,PSE,West Bank and Gaza Strip,2015,56,72,-16
JPN,Japan,PSE,West Bank and Gaza Strip,2016,58,70,-12
JPN,Japan,PSE,West Bank and Gaza Strip,2017,37,46,-9
KOR,Korea,PSE,West Bank and Gaza Strip,2008,3,6,-3
KOR,Korea,PSE,West Bank and Gaza Strip,2009,8,6,2
KOR,Korea,PSE,West Bank and Gaza Strip,2010,2,12,-10
KOR,Korea,PSE,West Bank and Gaza Strip,2011,15,15,0
KOR,Korea,PSE,West Bank and Gaza Strip,2012,4,10,-6
KOR,Korea,PSE,West Bank and Gaza Strip,2013,13,17,-4
KOR,Korea,PSE,West Bank and Gaza Strip,2014,20,17,3
KOR,Korea,PSE,West Bank and Gaza Strip,2015,13,16,-3
KOR,Korea,PSE,West Bank and Gaza Strip,2016,13,14,-1
KOR,Korea,PSE,West Bank and Gaza Strip,2017,9,22,-13
LUX,Luxembourg,PSE,West Bank and Gaza Strip,2008,0,0,0
LUX,Luxembourg,PSE,West Bank and Gaza Strip,2009,0,0,0
LUX,Luxembourg,PSE,West Bank and Gaza Strip,2010,0,0,0
LUX,Luxembourg,PSE,West Bank and Gaza Strip,2011,0,1,-1
LUX,Luxembourg,PSE,West Bank and Gaza Strip,2012,0,0,0
LUX,Luxembourg,PSE,West Bank and Gaza Strip,2013,0,0,0
LUX,Luxembourg,PSE,West Bank and Gaza Strip,2014,0,2,-2
LUX,Luxembourg,PSE,West Bank and Gaza Strip,2015,0,1,-1
LUX,Luxembourg,PSE,West Bank and Gaza Strip,2016,2,2,0
LUX,Luxembourg,PSE,West Bank and Gaza Strip,2017,2,0,2
MEX,Mexico,PSE,West Bank and Gaza Strip,2008,0,3,-3
MEX,Mexico,PSE,West Bank and Gaza Strip,2009,0,4,-4
MEX,Mexico,PSE,West Bank and Gaza Strip,2010,0,5,-5
MEX,Mexico,PSE,West Bank and Gaza Strip,2011,0,5,-5
MEX,Mexico,PSE,West Bank and Gaza Strip,2012,0,2,-2
MEX,Mexico,PSE,West Bank and Gaza Strip,2013,0,9,-9
MEX,Mexico,PSE,West Bank and Gaza Strip,2014,0,4,-4
MEX,Mexico,PSE,West Bank and Gaza Strip,2015,0,1,-1
MEX,Mexico,PSE,West Bank and Gaza Strip,2016,0,3,-3
NZL,New Zealand,PSE,West Bank and Gaza Strip,2008,0,6,-6
NZL,New Zealand,PSE,West Bank and Gaza Strip,2009,0,18,-18
NZL,New Zealand,PSE,West Bank and Gaza Strip,2010,1,31,-30
NZL,New Zealand,PSE,West Bank and Gaza Strip,2011,0,7,-7
NZL,New Zealand,PSE,West Bank and Gaza Strip,2012,1,22,-21
NZL,New Zealand,PSE,West Bank and Gaza Strip,2013,2,46,-44
NZL,New Zealand,PSE,West Bank and Gaza Strip,2014,2,26,-24
NZL,New Zealand,PSE,West Bank and Gaza Strip,2015,0,40,-40
NZL,New Zealand,PSE,West Bank and Gaza Strip,2016,0,85,-85
NZL,New Zealand,PSE,West Bank and Gaza Strip,2017,0,66,-66
NOR,Norway,PSE,West Bank and Gaza Strip,2008,0,0,0
NOR,Norway,PSE,West Bank and Gaza Strip,2009,0,0,0
NOR,Norway,PSE,West Bank and Gaza Strip,2010,0,0,0
NOR,Norway,PSE,West Bank and Gaza Strip,2011,0,0,0
NOR,Norway,PSE,West Bank and Gaza Strip,2012,0,0,0
NOR,Norway,PSE,West Bank and Gaza Strip,2013,0,0,0
NOR,Norway,PSE,West Bank and Gaza Strip,2014,0,0,0
NOR,Norway,PSE,West Bank and Gaza Strip,2015,0,0,0
NOR,Norway,PSE,West Bank and Gaza Strip,2016,0,0,0
NOR,Norway,PSE,West Bank and Gaza Strip,2017,0,0,0
POL,Poland,PSE,West Bank and Gaza Strip,2009,0,80,-80
POL,Poland,PSE,West Bank and Gaza Strip,2010,0,68,-68
POL,Poland,PSE,West Bank and Gaza Strip,2011,0,68,-68
POL,Poland,PSE,West Bank and Gaza Strip,2012,0,68,-68
POL,Poland,PSE,West Bank and Gaza Strip,2013,0,14,-14
POL,Poland,PSE,West Bank and Gaza Strip,2014,0,33,-33
POL,Poland,PSE,West Bank and Gaza Strip,2015,0,66,-66
POL,Poland,PSE,West Bank and Gaza Strip,2016,0,58,-58
POL,Poland,PSE,West Bank and Gaza Strip,2017,0,64,-64
SVK,Slovak Republic,PSE,West Bank and Gaza Strip,2008,3,1,2
SVK,Slovak Republic,PSE,West Bank and Gaza Strip,2009,5,1,4
SVK,Slovak Republic,PSE,West Bank and Gaza Strip,2010,3,4,-1
SVK,Slovak Republic,PSE,West Bank and Gaza Strip,2011,2,5,-3
SVK,Slovak Republic,PSE,West Bank and Gaza Strip,2012,1,3,-2
SVK,Slovak Republic,PSE,West Bank and Gaza Strip,2013,0,1,-1
SVK,Slovak Republic,PSE,West Bank and Gaza Strip,2014,0,3,-3
SVK,Slovak Republic,PSE,West Bank and Gaza Strip,2015,0,2,-2
SVK,Slovak Republic,PSE,West Bank and Gaza Strip,2016,0,1,-1
SVK,Slovak Republic,PSE,West Bank and Gaza Strip,2017,0,2,-2
ESP,Spain,PSE,West Bank and Gaza Strip,2008,0,0,0
ESP,Spain,PSE,West Bank and Gaza Strip,2009,0,0,0
ESP,Spain,PSE,West Bank and Gaza Strip,2010,0,0,0
ESP,Spain,PSE,West Bank and Gaza Strip,2011,0,0,0
ESP,Spain,PSE,West Bank and Gaza Strip,2012,0,0,0
ESP,Spain,PSE,West Bank and Gaza Strip,2013,0,0,0
SWE,Sweden,PSE,West Bank and Gaza Strip,2008,0,0,0
SWE,Sweden,PSE,West Bank and Gaza Strip,2009,0,0,0
SWE,Sweden,PSE,West Bank and Gaza Strip,2010,0,0,0
SWE,Sweden,PSE,West Bank and Gaza Strip,2011,0,0,0
SWE,Sweden,PSE,West Bank and Gaza Strip,2012,0,0,0
SWE,Sweden,PSE,West Bank and Gaza Strip,2013,0,0,0
SWE,Sweden,PSE,West Bank and Gaza Strip,2014,0,0,0
SWE,Sweden,PSE,West Bank and Gaza Strip,2015,0,423,-423
SWE,Sweden,PSE,West Bank and Gaza Strip,2016,1,824,-823
SWE,Sweden,PSE,West Bank and Gaza Strip,2017,4,734,-730
CHE,Switzerland,PSE,West Bank and Gaza Strip,2010,2,18,-16
CHE,Switzerland,PSE,West Bank and Gaza Strip,2011,7,10,-3
CHE,Switzerland,PSE,West Bank and Gaza Strip,2012,5,23,-18
CHE,Switzerland,PSE,West Bank and Gaza Strip,2013,5,22,-17
TUR,Turkey,PSE,West Bank and Gaza Strip,2010,0,175,-175
TUR,Turkey,PSE,West Bank and Gaza Strip,2016,486,2026,-1540
TUR,Turkey,PSE,West Bank and Gaza Strip,2017,650,4817,-4167
CHL,Chile,PSE,West Bank and Gaza Strip,2008,0,4,-4
CHL,Chile,PSE,West Bank and Gaza Strip,2009,0,3,-3
CHL,Chile,PSE,West Bank and Gaza Strip,2010,0,4,-4
CHL,Chile,PSE,West Bank and Gaza Strip,2011,0,4,-4
CHL,Chile,PSE,West Bank and Gaza Strip,2012,0,7,-7
CHL,Chile,PSE,West Bank and Gaza Strip,2013,0,16,-16
CHL,Chile,PSE,West Bank and Gaza Strip,2014,0,8,-8
CHL,Chile,PSE,West Bank and Gaza Strip,2015,0,12,-12
CHL,Chile,PSE,West Bank and Gaza Strip,2016,0,24,-24
EST,Estonia,PSE,West Bank and Gaza Strip,2008,0,1,-1
EST,Estonia,PSE,West Bank and Gaza Strip,2009,0,0,0
EST,Estonia,PSE,West Bank and Gaza Strip,2010,0,0,0
EST,Estonia,PSE,West Bank and Gaza Strip,2011,0,3,-3
EST,Estonia,PSE,West Bank and Gaza Strip,2012,0,0,0
EST,Estonia,PSE,West Bank and Gaza Strip,2013,0,3,-3
EST,Estonia,PSE,West Bank and Gaza Strip,2014,0,1,-1
EST,Estonia,PSE,West Bank and Gaza Strip,2015,0,13,-13
EST,Estonia,PSE,West Bank and Gaza Strip,2016,0,12,-12
EST,Estonia,PSE,West Bank and Gaza Strip,2017,0,2,-2
SVN,Slovenia,PSE,West Bank and Gaza Strip,2009,0,1,-1
SVN,Slovenia,PSE,West Bank and Gaza Strip,2010,0,2,-2
SVN,Slovenia,PSE,West Bank and Gaza Strip,2013,0,1,-1
SVN,Slovenia,PSE,West Bank and Gaza Strip,2015,0,4,-4
SVN,Slovenia,PSE,West Bank and Gaza Strip,2016,0,3,-3
SVN,Slovenia,PSE,West Bank and Gaza Strip,2017,0,14,-14
AUS,Australia,PAN,Panama,2008,0,4,-4
AUS,Australia,PAN,Panama,2009,0,8,-8
AUS,Australia,PAN,Panama,2010,0,5,-5
AUS,Australia,PAN,Panama,2011,0,4,-4
AUS,Australia,PAN,Panama,2012,0,2,-2
AUS,Australia,PAN,Panama,2013,0,7,-7
AUS,Australia,PAN,Panama,2014,0,0,0
AUS,Australia,PAN,Panama,2015,0,5,-5
AUS,Australia,PAN,Panama,2017,0,3,-3
AUT,Austria,PAN,Panama,2008,0,2,-2
AUT,Austria,PAN,Panama,2009,2,5,-3
AUT,Austria,PAN,Panama,2010,6,5,1
AUT,Austria,PAN,Panama,2011,2,9,-7
AUT,Austria,PAN,Panama,2012,4,5,-1
AUT,Austria,PAN,Panama,2013,5,5,0
AUT,Austria,PAN,Panama,2014,3,7,-4
AUT,Austria,PAN,Panama,2015,8,7,1
AUT,Austria,PAN,Panama,2016,4,8,-4
AUT,Austria,PAN,Panama,2017,9,7,2
BEL,Belgium,PAN,Panama,2008,0,8,-8
BEL,Belgium,PAN,Panama,2009,0,15,-15
BEL,Belgium,PAN,Panama,2010,4,15,-11
BEL,Belgium,PAN,Panama,2012,10,8,2
BEL,Belgium,PAN,Panama,2013,9,8,1
BEL,Belgium,PAN,Panama,2014,1,9,-8
BEL,Belgium,PAN,Panama,2015,5,12,-7
BEL,Belgium,PAN,Panama,2016,4,11,-7
BEL,Belgium,PAN,Panama,2017,2,14,-12
CAN,Canada,PAN,Panama,2008,0,52,-52
CAN,Canada,PAN,Panama,2009,0,73,-73
CAN,Canada,PAN,Panama,2010,0,65,-65
CAN,Canada,PAN,Panama,2011,0,49,-49
CAN,Canada,PAN,Panama,2012,0,34,-34
CAN,Canada,PAN,Panama,2013,0,43,-43
CAN,Canada,PAN,Panama,2014,0,59,-59
CAN,Canada,PAN,Panama,2015,0,39,-39
CAN,Canada,PAN,Panama,2016,0,45,-45
CAN,Canada,PAN,Panama,2017,0,55,-55
CZE,Czech Republic,PAN,Panama,2008,0,5,-5
CZE,Czech Republic,PAN,Panama,2009,0,12,-12
CZE,Czech Republic,PAN,Panama,2010,0,1,-1
CZE,Czech Republic,PAN,Panama,2011,0,6,-6
CZE,Czech Republic,PAN,Panama,2012,1,9,-8
CZE,Czech Republic,PAN,Panama,2013,10,9,1
CZE,Czech Republic,PAN,Panama,2014,6,13,-7
CZE,Czech Republic,PAN,Panama,2015,5,6,-1
CZE,Czech Republic,PAN,Panama,2016,7,8,-1
CZE,Czech Republic,PAN,Panama,2017,9,7,2
DNK,Denmark,PAN,Panama,2008,1,6,-5
DNK,Denmark,PAN,Panama,2009,4,4,0
DNK,Denmark,PAN,Panama,2010,3,3,0
DNK,Denmark,PAN,Panama,2011,2,5,-3
DNK,Denmark,PAN,Panama,2012,0,3,-3
DNK,Denmark,PAN,Panama,2013,2,4,-2
DNK,Denmark,PAN,Panama,2014,4,10,-6
DNK,Denmark,PAN,Panama,2015,3,4,-1
DNK,Denmark,PAN,Panama,2016,6,3,3
DNK,Denmark,PAN,Panama,2017,0,7,-7
FIN,Finland,PAN,Panama,2008,1,1,0
FIN,Finland,PAN,Panama,2009,1,1,0
FIN,Finland,PAN,Panama,2010,0,1,-1
FIN,Finland,PAN,Panama,2011,2,3,-1
FIN,Finland,PAN,Panama,2012,0,2,-2
FIN,Finland,PAN,Panama,2013,1,1,0
FIN,Finland,PAN,Panama,2014,0,1,-1
FIN,Finland,PAN,Panama,2015,0,2,-2
FIN,Finland,PAN,Panama,2016,2,3,-1
FIN,Finland,PAN,Panama,2017,2,1,1
FRA,France,PAN,Panama,2008,0,10,-10
FRA,France,PAN,Panama,2009,0,10,-10
FRA,France,PAN,Panama,2010,0,17,-17
FRA,France,PAN,Panama,2011,0,15,-15
FRA,France,PAN,Panama,2012,0,18,-18
FRA,France,PAN,Panama,2013,0,16,-16
FRA,France,PAN,Panama,2014,0,18,-18
FRA,France,PAN,Panama,2015,0,23,-23
FRA,France,PAN,Panama,2016,0,19,-19
FRA,France,PAN,Panama,2017,0,19,-19
DEU,Germany,PAN,Panama,2008,67,47,20
DEU,Germany,PAN,Panama,2009,66,95,-29
DEU,Germany,PAN,Panama,2010,75,66,9
DEU,Germany,PAN,Panama,2011,50,81,-31
DEU,Germany,PAN,Panama,2012,55,64,-9
DEU,Germany,PAN,Panama,2013,50,82,-32
DEU,Germany,PAN,Panama,2014,49,66,-17
DEU,Germany,PAN,Panama,2015,37,91,-54
DEU,Germany,PAN,Panama,2016,51,76,-25
DEU,Germany,PAN,Panama,2017,46,77,-31
HUN,Hungary,PAN,Panama,2008,0,2,-2
HUN,Hungary,PAN,Panama,2009,0,2,-2
HUN,Hungary,PAN,Panama,2010,0,3,-3
HUN,Hungary,PAN,Panama,2011,0,2,-2
HUN,Hungary,PAN,Panama,2012,0,0,0
HUN,Hungary,PAN,Panama,2013,0,2,-2
HUN,Hungary,PAN,Panama,2014,0,4,-4
HUN,Hungary,PAN,Panama,2015,0,3,-3
HUN,Hungary,PAN,Panama,2016,0,1,-1
HUN,Hungary,PAN,Panama,2017,0,4,-4
ISL,Iceland,PAN,Panama,2008,0,2,-2
ISL,Iceland,PAN,Panama,2009,0,0,0
ISL,Iceland,PAN,Panama,2010,1,0,1
ISL,Iceland,PAN,Panama,2011,0,0,0
ISL,Iceland,PAN,Panama,2012,0,0,0
ISL,Iceland,PAN,Panama,2013,0,0,0
ISL,Iceland,PAN,Panama,2014,0,1,-1
ISL,Iceland,PAN,Panama,2015,1,0,1
ISL,Iceland,PAN,Panama,2016,0,0,0
ISL,Iceland,PAN,Panama,2017,0,1,-1
ITA,Italy,PAN,Panama,2008,6,38,-32
ITA,Italy,PAN,Panama,2009,6,28,-22
ITA,Italy,PAN,Panama,2010,10,36,-26
ITA,Italy,PAN,Panama,2011,2,28,-26
ITA,Italy,PAN,Panama,2012,4,24,-20
ITA,Italy,PAN,Panama,2013,3,24,-21
ITA,Italy,PAN,Panama,2014,2,20,-18
ITA,Italy,PAN,Panama,2015,8,19,-11
ITA,Italy,PAN,Panama,2016,0,21,-21
ITA,Italy,PAN,Panama,2017,6,31,-25
JPN,Japan,PAN,Panama,2008,70,68,2
JPN,Japan,PAN,Panama,2009,69,70,-1
JPN,Japan,PAN,Panama,2010,54,56,-2
JPN,Japan,PAN,Panama,2011,49,53,-4
JPN,Japan,PAN,Panama,2012,112,115,-3
JPN,Japan,PAN,Panama,2013,68,69,-1
JPN,Japan,PAN,Panama,2014,71,78,-7
JPN,Japan,PAN,Panama,2015,92,100,-8
JPN,Japan,PAN,Panama,2016,142,152,-10
JPN,Japan,PAN,Panama,2017,92,90,2
KOR,Korea,PAN,Panama,2008,3,9,-6
KOR,Korea,PAN,Panama,2009,3,12,-9
KOR,Korea,PAN,Panama,2010,6,10,-4
KOR,Korea,PAN,Panama,2011,7,5,2
KOR,Korea,PAN,Panama,2012,10,12,-2
KOR,Korea,PAN,Panama,2013,9,13,-4
KOR,Korea,PAN,Panama,2014,6,15,-9
KOR,Korea,PAN,Panama,2015,13,21,-8
KOR,Korea,PAN,Panama,2016,13,19,-6
KOR,Korea,PAN,Panama,2017,24,12,12
LUX,Luxembourg,PAN,Panama,2008,1,1,0
LUX,Luxembourg,PAN,Panama,2009,0,0,0
LUX,Luxembourg,PAN,Panama,2010,1,1,0
LUX,Luxembourg,PAN,Panama,2011,0,2,-2
LUX,Luxembourg,PAN,Panama,2012,0,3,-3
LUX,Luxembourg,PAN,Panama,2013,3,0,3
LUX,Luxembourg,PAN,Panama,2014,0,2,-2
LUX,Luxembourg,PAN,Panama,2015,0,0,0
LUX,Luxembourg,PAN,Panama,2016,2,1,1
LUX,Luxembourg,PAN,Panama,2017,0,0,0
MEX,Mexico,PAN,Panama,2008,0,81,-81
MEX,Mexico,PAN,Panama,2009,0,126,-126
MEX,Mexico,PAN,Panama,2010,0,92,-92
MEX,Mexico,PAN,Panama,2011,0,60,-60
MEX,Mexico,PAN,Panama,2012,0,41,-41
MEX,Mexico,PAN,Panama,2013,0,215,-215
MEX,Mexico,PAN,Panama,2014,0,140,-140
MEX,Mexico,PAN,Panama,2015,0,87,-87
MEX,Mexico,PAN,Panama,2016,0,80,-80
MEX,Mexico,PAN,Panama,2017,0,58,-58
NLD,Netherlands,PAN,Panama,2008,3,6,-3
NLD,Netherlands,PAN,Panama,2009,12,13,-1
NLD,Netherlands,PAN,Panama,2010,8,9,-1
NLD,Netherlands,PAN,Panama,2011,5,15,-10
NLD,Netherlands,PAN,Panama,2012,6,13,-7
NLD,Netherlands,PAN,Panama,2013,9,24,-15
NLD,Netherlands,PAN,Panama,2014,10,5,5
NLD,Netherlands,PAN,Panama,2015,6,15,-9
NLD,Netherlands,PAN,Panama,2016,7,17,-10
NLD,Netherlands,PAN,Panama,2017,13,23,-10
NZL,New Zealand,PAN,Panama,2008,0,7,-7
NZL,New Zealand,PAN,Panama,2009,1,5,-4
NZL,New Zealand,PAN,Panama,2010,7,3,4
NZL,New Zealand,PAN,Panama,2011,0,2,-2
NZL,New Zealand,PAN,Panama,2012,1,0,1
NZL,New Zealand,PAN,Panama,2013,0,2,-2
NZL,New Zealand,PAN,Panama,2016,0,1,-1
NZL,New Zealand,PAN,Panama,2017,0,4,-4
NOR,Norway,PAN,Panama,2008,3,4,-1
NOR,Norway,PAN,Panama,2009,2,8,-6
NOR,Norway,PAN,Panama,2010,3,3,0
NOR,Norway,PAN,Panama,2011,2,4,-2
NOR,Norway,PAN,Panama,2012,5,4,1
NOR,Norway,PAN,Panama,2013,5,6,-1
NOR,Norway,PAN,Panama,2014,2,3,-1
NOR,Norway,PAN,Panama,2015,1,6,-5
NOR,Norway,PAN,Panama,2016,2,13,-11
NOR,Norway,PAN,Panama,2017,0,2,-2
POL,Poland,PAN,Panama,2009,0,2,-2
POL,Poland,PAN,Panama,2010,0,2,-2
POL,Poland,PAN,Panama,2011,0,5,-5
POL,Poland,PAN,Panama,2012,0,1,-1
POL,Poland,PAN,Panama,2013,0,3,-3
POL,Poland,PAN,Panama,2014,0,3,-3
POL,Poland,PAN,Panama,2015,0,4,-4
POL,Poland,PAN,Panama,2016,0,5,-5
POL,Poland,PAN,Panama,2017,0,7,-7
SVK,Slovak Republic,PAN,Panama,2008,0,0,0
SVK,Slovak Republic,PAN,Panama,2009,0,1,-1
SVK,Slovak Republic,PAN,Panama,2010,0,1,-1
SVK,Slovak Republic,PAN,Panama,2011,0,1,-1
ESP,Spain,PAN,Panama,2008,211,407,-196
ESP,Spain,PAN,Panama,2009,238,342,-104
ESP,Spain,PAN,Panama,2010,221,280,-59
ESP,Spain,PAN,Panama,2011,318,325,-7
ESP,Spain,PAN,Panama,2012,247,298,-51
ESP,Spain,PAN,Panama,2013,317,289,28
ESP,Spain,PAN,Panama,2014,156,306,-150
ESP,Spain,PAN,Panama,2015,146,345,-199
ESP,Spain,PAN,Panama,2016,141,495,-354
ESP,Spain,PAN,Panama,2017,288,643,-355
SWE,Sweden,PAN,Panama,2008,2,4,-2
SWE,Sweden,PAN,Panama,2009,3,14,-11
SWE,Sweden,PAN,Panama,2010,2,11,-9
SWE,Sweden,PAN,Panama,2011,3,12,-9
SWE,Sweden,PAN,Panama,2012,6,11,-5
SWE,Sweden,PAN,Panama,2013,4,10,-6
SWE,Sweden,PAN,Panama,2014,2,14,-12
SWE,Sweden,PAN,Panama,2015,1,3,-2
SWE,Sweden,PAN,Panama,2016,5,14,-9
SWE,Sweden,PAN,Panama,2017,6,9,-3
CHE,Switzerland,PAN,Panama,2010,36,30,6
CHE,Switzerland,PAN,Panama,2011,64,35,29
CHE,Switzerland,PAN,Panama,2012,70,39,31
CHE,Switzerland,PAN,Panama,2013,23,26,-3
CHE,Switzerland,PAN,Panama,2014,16,22,-6
CHE,Switzerland,PAN,Panama,2015,10,21,-11
CHE,Switzerland,PAN,Panama,2016,20,30,-10
CHE,Switzerland,PAN,Panama,2017,17,63,-46
TUR,Turkey,PAN,Panama,2010,0,1,-1
USA,United States,PAN,Panama,2008,0,1678,-1678
USA,United States,PAN,Panama,2009,0,1806,-1806
USA,United States,PAN,Panama,2010,0,1536,-1536
USA,United States,PAN,Panama,2011,0,1374,-1374
USA,United States,PAN,Panama,2012,0,1281,-1281
USA,United States,PAN,Panama,2013,0,1234,-1234
USA,United States,PAN,Panama,2014,0,1095,-1095
USA,United States,PAN,Panama,2015,0,1052,-1052
USA,United States,PAN,Panama,2016,0,1029,-1029
USA,United States,PAN,Panama,2017,0,889,-889
CHL,Chile,PAN,Panama,2008,0,197,-197
CHL,Chile,PAN,Panama,2009,0,193,-193
CHL,Chile,PAN,Panama,2010,0,54,-54
CHL,Chile,PAN,Panama,2011,0,66,-66
CHL,Chile,PAN,Panama,2012,0,64,-64
CHL,Chile,PAN,Panama,2013,0,72,-72
CHL,Chile,PAN,Panama,2014,0,64,-64
CHL,Chile,PAN,Panama,2015,0,48,-48
CHL,Chile,PAN,Panama,2016,0,65,-65
EST,Estonia,PAN,Panama,2008,0,0,0
EST,Estonia,PAN,Panama,2009,0,0,0
EST,Estonia,PAN,Panama,2010,0,0,0
EST,Estonia,PAN,Panama,2011,0,0,0
EST,Estonia,PAN,Panama,2012,0,0,0
EST,Estonia,PAN,Panama,2013,0,0,0
EST,Estonia,PAN,Panama,2014,0,0,0
EST,Estonia,PAN,Panama,2015,0,1,-1
EST,Estonia,PAN,Panama,2016,0,2,-2
EST,Estonia,PAN,Panama,2017,0,0,0
SVN,Slovenia,PAN,Panama,2011,0,1,-1
SVN,Slovenia,PAN,Panama,2013,0,1,-1
AUS,Australia,PNG,Papua New Guinea,2008,186,356,-170
AUS,Australia,PNG,Papua New Guinea,2009,156,447,-291
AUS,Australia,PNG,Papua New Guinea,2010,175,515,-340
AUS,Australia,PNG,Papua New Guinea,2011,156,601,-445
AUS,Australia,PNG,Papua New Guinea,2012,152,550,-398
AUS,Australia,PNG,Papua New Guinea,2013,141,382,-241
AUS,Australia,PNG,Papua New Guinea,2014,144,276,-132
AUS,Australia,PNG,Papua New Guinea,2015,200,332,-132
AUS,Australia,PNG,Papua New Guinea,2016,100,313,-213
AUS,Australia,PNG,Papua New Guinea,2017,0,271,-271
AUT,Austria,PNG,Papua New Guinea,2008,1,0,1
AUT,Austria,PNG,Papua New Guinea,2009,1,1,0
AUT,Austria,PNG,Papua New Guinea,2010,1,1,0
AUT,Austria,PNG,Papua New Guinea,2011,2,0,2
AUT,Austria,PNG,Papua New Guinea,2012,1,0,1
AUT,Austria,PNG,Papua New Guinea,2013,0,0,0
AUT,Austria,PNG,Papua New Guinea,2014,0,2,-2
AUT,Austria,PNG,Papua New Guinea,2015,1,0,1
AUT,Austria,PNG,Papua New Guinea,2016,0,2,-2
AUT,Austria,PNG,Papua New Guinea,2017,3,0,3
BEL,Belgium,PNG,Papua New Guinea,2008,0,0,0
BEL,Belgium,PNG,Papua New Guinea,2009,0,0,0
BEL,Belgium,PNG,Papua New Guinea,2010,0,0,0
BEL,Belgium,PNG,Papua New Guinea,2014,0,1,-1
CAN,Canada,PNG,Papua New Guinea,2008,0,9,-9
CAN,Canada,PNG,Papua New Guinea,2009,0,1,-1
CAN,Canada,PNG,Papua New Guinea,2010,0,3,-3
CAN,Canada,PNG,Papua New Guinea,2011,0,0,0
CAN,Canada,PNG,Papua New Guinea,2012,0,3,-3
CAN,Canada,PNG,Papua New Guinea,2013,0,3,-3
CAN,Canada,PNG,Papua New Guinea,2014,0,0,0
CAN,Canada,PNG,Papua New Guinea,2015,0,7,-7
CAN,Canada,PNG,Papua New Guinea,2016,0,5,-5
CAN,Canada,PNG,Papua New Guinea,2017,0,5,-5
CZE,Czech Republic,PNG,Papua New Guinea,2014,0,1,-1
DNK,Denmark,PNG,Papua New Guinea,2012,0,0,0
DNK,Denmark,PNG,Papua New Guinea,2013,0,0,0
DNK,Denmark,PNG,Papua New Guinea,2014,0,0,0
DNK,Denmark,PNG,Papua New Guinea,2015,0,0,0
DNK,Denmark,PNG,Papua New Guinea,2016,0,0,0
DNK,Denmark,PNG,Papua New Guinea,2017,1,0,1
FIN,Finland,PNG,Papua New Guinea,2008,0,0,0
FIN,Finland,PNG,Papua New Guinea,2009,0,0,0
FIN,Finland,PNG,Papua New Guinea,2010,0,0,0
FIN,Finland,PNG,Papua New Guinea,2011,0,0,0
FIN,Finland,PNG,Papua New Guinea,2012,0,0,0
FIN,Finland,PNG,Papua New Guinea,2013,0,0,0
FIN,Finland,PNG,Papua New Guinea,2014,0,1,-1
FIN,Finland,PNG,Papua New Guinea,2015,0,0,0
FIN,Finland,PNG,Papua New Guinea,2016,0,0,0
FIN,Finland,PNG,Papua New Guinea,2017,0,0,0
FRA,France,PNG,Papua New Guinea,2008,0,1,-1
FRA,France,PNG,Papua New Guinea,2009,0,0,0
FRA,France,PNG,Papua New Guinea,2010,0,0,0
FRA,France,PNG,Papua New Guinea,2011,0,1,-1
FRA,France,PNG,Papua New Guinea,2012,0,1,-1
FRA,France,PNG,Papua New Guinea,2013,0,1,-1
FRA,France,PNG,Papua New Guinea,2014,0,0,0
FRA,France,PNG,Papua New Guinea,2015,0,3,-3
FRA,France,PNG,Papua New Guinea,2016,0,0,0
FRA,France,PNG,Papua New Guinea,2017,0,2,-2
DEU,Germany,PNG,Papua New Guinea,2008,5,2,3
DEU,Germany,PNG,Papua New Guinea,2009,5,12,-7
DEU,Germany,PNG,Papua New Guinea,2010,3,11,-8
DEU,Germany,PNG,Papua New Guinea,2011,7,6,1
DEU,Germany,PNG,Papua New Guinea,2012,1,6,-5
DEU,Germany,PNG,Papua New Guinea,2013,3,12,-9
DEU,Germany,PNG,Papua New Guinea,2014,7,2,5
DEU,Germany,PNG,Papua New Guinea,2015,7,11,-4
DEU,Germany,PNG,Papua New Guinea,2016,6,14,-8
DEU,Germany,PNG,Papua New Guinea,2017,3,14,-11
HUN,Hungary,PNG,Papua New Guinea,2008,0,0,0
HUN,Hungary,PNG,Papua New Guinea,2009,0,0,0
HUN,Hungary,PNG,Papua New Guinea,2010,0,0,0
HUN,Hungary,PNG,Papua New Guinea,2011,1,0,1
HUN,Hungary,PNG,Papua New Guinea,2012,0,0,0
HUN,Hungary,PNG,Papua New Guinea,2013,0,0,0
HUN,Hungary,PNG,Papua New Guinea,2014,0,2,-2
HUN,Hungary,PNG,Papua New Guinea,2015,0,0,0
HUN,Hungary,PNG,Papua New Guinea,2016,0,0,0
HUN,Hungary,PNG,Papua New Guinea,2017,0,0,0
ISL,Iceland,PNG,Papua New Guinea,2008,0,0,0
ISL,Iceland,PNG,Papua New Guinea,2009,0,0,0
ISL,Iceland,PNG,Papua New Guinea,2010,0,0,0
ISL,Iceland,PNG,Papua New Guinea,2011,0,0,0
ISL,Iceland,PNG,Papua New Guinea,2012,0,2,-2
ISL,Iceland,PNG,Papua New Guinea,2013,0,1,-1
ISL,Iceland,PNG,Papua New Guinea,2014,4,1,3
ISL,Iceland,PNG,Papua New Guinea,2015,1,1,0
ISL,Iceland,PNG,Papua New Guinea,2016,0,0,0
ISL,Iceland,PNG,Papua New Guinea,2017,0,0,0
ITA,Italy,PNG,Papua New Guinea,2008,0,4,-4
ITA,Italy,PNG,Papua New Guinea,2009,0,0,0
ITA,Italy,PNG,Papua New Guinea,2010,0,11,-11
ITA,Italy,PNG,Papua New Guinea,2011,2,9,-7
ITA,Italy,PNG,Papua New Guinea,2012,1,3,-2
ITA,Italy,PNG,Papua New Guinea,2013,0,2,-2
ITA,Italy,PNG,Papua New Guinea,2014,0,2,-2
ITA,Italy,PNG,Papua New Guinea,2015,0,3,-3
ITA,Italy,PNG,Papua New Guinea,2016,0,5,-5
ITA,Italy,PNG,Papua New Guinea,2017,0,18,-18
JPN,Japan,PNG,Papua New Guinea,2008,136,132,4
JPN,Japan,PNG,Papua New Guinea,2009,196,199,-3
JPN,Japan,PNG,Papua New Guinea,2010,247,247,0
JPN,Japan,PNG,Papua New Guinea,2011,146,157,-11
JPN,Japan,PNG,Papua New Guinea,2012,151,143,8
JPN,Japan,PNG,Papua New Guinea,2013,148,163,-15
JPN,Japan,PNG,Papua New Guinea,2014,137,137,0
JPN,Japan,PNG,Papua New Guinea,2015,223,221,2
JPN,Japan,PNG,Papua New Guinea,2016,169,184,-15
JPN,Japan,PNG,Papua New Guinea,2017,220,224,-4
KOR,Korea,PNG,Papua New Guinea,2008,0,2,-2
KOR,Korea,PNG,Papua New Guinea,2009,0,2,-2
KOR,Korea,PNG,Papua New Guinea,2010,1,3,-2
KOR,Korea,PNG,Papua New Guinea,2011,6,5,1
KOR,Korea,PNG,Papua New Guinea,2012,4,3,1
KOR,Korea,PNG,Papua New Guinea,2013,2,4,-2
KOR,Korea,PNG,Papua New Guinea,2014,5,10,-5
KOR,Korea,PNG,Papua New Guinea,2015,15,21,-6
KOR,Korea,PNG,Papua New Guinea,2016,18,4,14
KOR,Korea,PNG,Papua New Guinea,2017,6,7,-1
LUX,Luxembourg,PNG,Papua New Guinea,2008,0,0,0
LUX,Luxembourg,PNG,Papua New Guinea,2009,0,0,0
LUX,Luxembourg,PNG,Papua New Guinea,2010,0,0,0
LUX,Luxembourg,PNG,Papua New Guinea,2011,0,0,0
LUX,Luxembourg,PNG,Papua New Guinea,2012,0,0,0
LUX,Luxembourg,PNG,Papua New Guinea,2013,0,0,0
LUX,Luxembourg,PNG,Papua New Guinea,2014,0,0,0
LUX,Luxembourg,PNG,Papua New Guinea,2015,0,0,0
LUX,Luxembourg,PNG,Papua New Guinea,2016,0,0,0
LUX,Luxembourg,PNG,Papua New Guinea,2017,0,0,0
MEX,Mexico,PNG,Papua New Guinea,2012,0,0,0
MEX,Mexico,PNG,Papua New Guinea,2013,0,0,0
MEX,Mexico,PNG,Papua New Guinea,2014,0,0,0
NLD,Netherlands,PNG,Papua New Guinea,2008,1,3,-2
NLD,Netherlands,PNG,Papua New Guinea,2009,1,1,0
NLD,Netherlands,PNG,Papua New Guinea,2010,0,1,-1
NLD,Netherlands,PNG,Papua New Guinea,2013,0,2,-2
NLD,Netherlands,PNG,Papua New Guinea,2014,3,1,2
NLD,Netherlands,PNG,Papua New Guinea,2015,-1,0,-1
NLD,Netherlands,PNG,Papua New Guinea,2016,1,3,-2
NLD,Netherlands,PNG,Papua New Guinea,2017,2,0,2
NZL,New Zealand,PNG,Papua New Guinea,2008,80,96,-16
NZL,New Zealand,PNG,Papua New Guinea,2009,64,123,-59
NZL,New Zealand,PNG,Papua New Guinea,2010,60,95,-35
NZL,New Zealand,PNG,Papua New Guinea,2011,114,110,4
NZL,New Zealand,PNG,Papua New Guinea,2012,58,137,-79
NZL,New Zealand,PNG,Papua New Guinea,2013,80,88,-8
NZL,New Zealand,PNG,Papua New Guinea,2014,57,106,-49
NZL,New Zealand,PNG,Papua New Guinea,2015,51,113,-62
NZL,New Zealand,PNG,Papua New Guinea,2016,64,112,-48
NZL,New Zealand,PNG,Papua New Guinea,2017,59,124,-65
NOR,Norway,PNG,Papua New Guinea,2008,0,0,0
NOR,Norway,PNG,Papua New Guinea,2009,0,0,0
NOR,Norway,PNG,Papua New Guinea,2010,2,1,1
NOR,Norway,PNG,Papua New Guinea,2011,1,0,1
NOR,Norway,PNG,Papua New Guinea,2012,1,0,1
NOR,Norway,PNG,Papua New Guinea,2013,0,0,0
NOR,Norway,PNG,Papua New Guinea,2014,0,1,-1
NOR,Norway,PNG,Papua New Guinea,2015,0,1,-1
NOR,Norway,PNG,Papua New Guinea,2016,0,2,-2
NOR,Norway,PNG,Papua New Guinea,2017,0,0,0
POL,Poland,PNG,Papua New Guinea,2009,0,2,-2
POL,Poland,PNG,Papua New Guinea,2010,0,0,0
POL,Poland,PNG,Papua New Guinea,2011,0,0,0
POL,Poland,PNG,Papua New Guinea,2012,0,0,0
POL,Poland,PNG,Papua New Guinea,2013,0,0,0
POL,Poland,PNG,Papua New Guinea,2014,0,0,0
POL,Poland,PNG,Papua New Guinea,2015,0,0,0
POL,Poland,PNG,Papua New Guinea,2016,0,0,0
POL,Poland,PNG,Papua New Guinea,2017,0,0,0
SVK,Slovak Republic,PNG,Papua New Guinea,2008,0,0,0
ESP,Spain,PNG,Papua New Guinea,2008,0,0,0
ESP,Spain,PNG,Papua New Guinea,2009,0,3,-3
ESP,Spain,PNG,Papua New Guinea,2010,0,0,0
ESP,Spain,PNG,Papua New Guinea,2011,2,0,2
ESP,Spain,PNG,Papua New Guinea,2012,1,2,-1
ESP,Spain,PNG,Papua New Guinea,2013,4,1,3
ESP,Spain,PNG,Papua New Guinea,2014,0,0,0
ESP,Spain,PNG,Papua New Guinea,2015,0,1,-1
ESP,Spain,PNG,Papua New Guinea,2016,1,0,1
ESP,Spain,PNG,Papua New Guinea,2017,2,2,0
SWE,Sweden,PNG,Papua New Guinea,2008,0,0,0
SWE,Sweden,PNG,Papua New Guinea,2009,0,0,0
SWE,Sweden,PNG,Papua New Guinea,2010,0,0,0
SWE,Sweden,PNG,Papua New Guinea,2011,0,0,0
SWE,Sweden,PNG,Papua New Guinea,2012,0,0,0
SWE,Sweden,PNG,Papua New Guinea,2013,0,1,-1
SWE,Sweden,PNG,Papua New Guinea,2014,0,0,0
SWE,Sweden,PNG,Papua New Guinea,2015,0,2,-2
SWE,Sweden,PNG,Papua New Guinea,2016,0,1,-1
SWE,Sweden,PNG,Papua New Guinea,2017,1,1,0
CHE,Switzerland,PNG,Papua New Guinea,2010,0,2,-2
CHE,Switzerland,PNG,Papua New Guinea,2011,1,3,-2
CHE,Switzerland,PNG,Papua New Guinea,2012,2,0,2
CHE,Switzerland,PNG,Papua New Guinea,2013,2,1,1
CHE,Switzerland,PNG,Papua New Guinea,2014,0,2,-2
CHE,Switzerland,PNG,Papua New Guinea,2015,0,0,0
CHE,Switzerland,PNG,Papua New Guinea,2016,0,3,-3
CHE,Switzerland,PNG,Papua New Guinea,2017,0,0,0
USA,United States,PNG,Papua New Guinea,2008,0,15,-15
USA,United States,PNG,Papua New Guinea,2009,0,19,-19
USA,United States,PNG,Papua New Guinea,2010,0,30,-30
USA,United States,PNG,Papua New Guinea,2011,0,20,-20
USA,United States,PNG,Papua New Guinea,2012,0,21,-21
USA,United States,PNG,Papua New Guinea,2013,0,27,-27
USA,United States,PNG,Papua New Guinea,2014,0,18,-18
USA,United States,PNG,Papua New Guinea,2015,0,11,-11
USA,United States,PNG,Papua New Guinea,2016,0,23,-23
USA,United States,PNG,Papua New Guinea,2017,0,18,-18
CHL,Chile,PNG,Papua New Guinea,2008,0,0,0
CHL,Chile,PNG,Papua New Guinea,2009,0,0,0
CHL,Chile,PNG,Papua New Guinea,2010,0,0,0
CHL,Chile,PNG,Papua New Guinea,2011,0,0,0
CHL,Chile,PNG,Papua New Guinea,2012,0,0,0
CHL,Chile,PNG,Papua New Guinea,2013,0,0,0
CHL,Chile,PNG,Papua New Guinea,2014,0,0,0
CHL,Chile,PNG,Papua New Guinea,2015,0,0,0
CHL,Chile,PNG,Papua New Guinea,2016,0,0,0
EST,Estonia,PNG,Papua New Guinea,2008,0,0,0
EST,Estonia,PNG,Papua New Guinea,2009,0,0,0
EST,Estonia,PNG,Papua New Guinea,2010,0,0,0
EST,Estonia,PNG,Papua New Guinea,2011,0,0,0
EST,Estonia,PNG,Papua New Guinea,2012,0,0,0
EST,Estonia,PNG,Papua New Guinea,2013,0,0,0
EST,Estonia,PNG,Papua New Guinea,2014,0,0,0
EST,Estonia,PNG,Papua New Guinea,2015,0,0,0
EST,Estonia,PNG,Papua New Guinea,2016,0,0,0
EST,Estonia,PNG,Papua New Guinea,2017,0,0,0
AUS,Australia,PRY,Paraguay,2008,5,7,-2
AUS,Australia,PRY,Paraguay,2009,6,10,-4
AUS,Australia,PRY,Paraguay,2010,6,12,-6
AUS,Australia,PRY,Paraguay,2011,5,3,2
AUS,Australia,PRY,Paraguay,2012,5,3,2
AUS,Australia,PRY,Paraguay,2013,0,7,-7
AUS,Australia,PRY,Paraguay,2014,0,0,0
AUS,Australia,PRY,Paraguay,2015,0,0,0
AUS,Australia,PRY,Paraguay,2016,0,8,-8
AUS,Australia,PRY,Paraguay,2017,0,8,-8
AUT,Austria,PRY,Paraguay,2008,10,24,-14
AUT,Austria,PRY,Paraguay,2009,18,25,-7
AUT,Austria,PRY,Paraguay,2010,23,26,-3
AUT,Austria,PRY,Paraguay,2011,16,16,0
AUT,Austria,PRY,Paraguay,2012,8,11,-3
AUT,Austria,PRY,Paraguay,2013,14,19,-5
AUT,Austria,PRY,Paraguay,2014,14,16,-2
AUT,Austria,PRY,Paraguay,2015,8,19,-11
AUT,Austria,PRY,Paraguay,2016,13,11,2
AUT,Austria,PRY,Paraguay,2017,14,10,4
BEL,Belgium,PRY,Paraguay,2008,0,32,-32
BEL,Belgium,PRY,Paraguay,2009,0,38,-38
BEL,Belgium,PRY,Paraguay,2010,7,42,-35
BEL,Belgium,PRY,Paraguay,2012,12,31,-19
BEL,Belgium,PRY,Paraguay,2013,13,29,-16
BEL,Belgium,PRY,Paraguay,2014,10,21,-11
BEL,Belgium,PRY,Paraguay,2015,8,29,-21
BEL,Belgium,PRY,Paraguay,2016,4,25,-21
BEL,Belgium,PRY,Paraguay,2017,10,23,-13
CAN,Canada,PRY,Paraguay,2008,0,94,-94
CAN,Canada,PRY,Paraguay,2009,0,88,-88
CAN,Canada,PRY,Paraguay,2010,0,89,-89
CAN,Canada,PRY,Paraguay,2011,0,83,-83
CAN,Canada,PRY,Paraguay,2012,0,55,-55
CAN,Canada,PRY,Paraguay,2013,0,66,-66
CAN,Canada,PRY,Paraguay,2014,0,38,-38
CAN,Canada,PRY,Paraguay,2015,0,36,-36
CAN,Canada,PRY,Paraguay,2016,0,40,-40
CAN,Canada,PRY,Paraguay,2017,0,60,-60
CZE,Czech Republic,PRY,Paraguay,2008,0,5,-5
CZE,Czech Republic,PRY,Paraguay,2009,0,3,-3
CZE,Czech Republic,PRY,Paraguay,2010,0,4,-4
CZE,Czech Republic,PRY,Paraguay,2011,0,2,-2
CZE,Czech Republic,PRY,Paraguay,2012,3,4,-1
CZE,Czech Republic,PRY,Paraguay,2013,4,1,3
CZE,Czech Republic,PRY,Paraguay,2014,0,4,-4
CZE,Czech Republic,PRY,Paraguay,2015,6,2,4
CZE,Czech Republic,PRY,Paraguay,2016,3,3,0
DNK,Denmark,PRY,Paraguay,2008,2,3,-1
DNK,Denmark,PRY,Paraguay,2009,4,1,3
DNK,Denmark,PRY,Paraguay,2010,0,6,-6
DNK,Denmark,PRY,Paraguay,2011,5,1,4
DNK,Denmark,PRY,Paraguay,2012,4,5,-1
DNK,Denmark,PRY,Paraguay,2013,2,2,0
DNK,Denmark,PRY,Paraguay,2014,6,8,-2
DNK,Denmark,PRY,Paraguay,2015,3,6,-3
DNK,Denmark,PRY,Paraguay,2016,2,4,-2
DNK,Denmark,PRY,Paraguay,2017,4,2,2
FIN,Finland,PRY,Paraguay,2008,1,1,0
FIN,Finland,PRY,Paraguay,2009,0,5,-5
FIN,Finland,PRY,Paraguay,2010,0,0,0
FIN,Finland,PRY,Paraguay,2011,0,2,-2
FIN,Finland,PRY,Paraguay,2012,0,3,-3
FIN,Finland,PRY,Paraguay,2013,0,1,-1
FIN,Finland,PRY,Paraguay,2014,0,4,-4
FIN,Finland,PRY,Paraguay,2015,0,2,-2
FIN,Finland,PRY,Paraguay,2016,0,1,-1
FIN,Finland,PRY,Paraguay,2017,0,0,0
FRA,France,PRY,Paraguay,2008,0,28,-28
FRA,France,PRY,Paraguay,2009,0,58,-58
FRA,France,PRY,Paraguay,2010,0,37,-37
FRA,France,PRY,Paraguay,2011,0,31,-31
FRA,France,PRY,Paraguay,2012,0,42,-42
FRA,France,PRY,Paraguay,2013,0,83,-83
FRA,France,PRY,Paraguay,2014,0,54,-54
FRA,France,PRY,Paraguay,2015,0,61,-61
FRA,France,PRY,Paraguay,2016,0,64,-64
FRA,France,PRY,Paraguay,2017,0,73,-73
DEU,Germany,PRY,Paraguay,2008,185,184,1
DEU,Germany,PRY,Paraguay,2009,175,193,-18
DEU,Germany,PRY,Paraguay,2010,148,195,-47
DEU,Germany,PRY,Paraguay,2011,148,201,-53
DEU,Germany,PRY,Paraguay,2012,130,205,-75
DEU,Germany,PRY,Paraguay,2013,159,209,-50
DEU,Germany,PRY,Paraguay,2014,160,242,-82
DEU,Germany,PRY,Paraguay,2015,178,231,-53
DEU,Germany,PRY,Paraguay,2016,132,231,-99
DEU,Germany,PRY,Paraguay,2017,158,209,-51
HUN,Hungary,PRY,Paraguay,2008,0,3,-3
HUN,Hungary,PRY,Paraguay,2009,1,0,1
HUN,Hungary,PRY,Paraguay,2010,1,2,-1
HUN,Hungary,PRY,Paraguay,2011,1,2,-1
HUN,Hungary,PRY,Paraguay,2012,0,0,0
HUN,Hungary,PRY,Paraguay,2013,1,0,1
HUN,Hungary,PRY,Paraguay,2014,0,2,-2
HUN,Hungary,PRY,Paraguay,2015,3,1,2
HUN,Hungary,PRY,Paraguay,2016,1,0,1
HUN,Hungary,PRY,Paraguay,2017,0,0,0
ISL,Iceland,PRY,Paraguay,2008,1,0,1
ISL,Iceland,PRY,Paraguay,2009,0,0,0
ISL,Iceland,PRY,Paraguay,2010,0,1,-1
ISL,Iceland,PRY,Paraguay,2011,0,1,-1
ISL,Iceland,PRY,Paraguay,2012,2,2,0
ISL,Iceland,PRY,Paraguay,2013,0,0,0
ISL,Iceland,PRY,Paraguay,2014,1,0,1
ISL,Iceland,PRY,Paraguay,2015,1,0,1
ISL,Iceland,PRY,Paraguay,2016,0,0,0
ISL,Iceland,PRY,Paraguay,2017,0,0,0
ITA,Italy,PRY,Paraguay,2008,8,208,-200
ITA,Italy,PRY,Paraguay,2009,9,260,-251
ITA,Italy,PRY,Paraguay,2010,7,320,-313
ITA,Italy,PRY,Paraguay,2011,12,207,-195
ITA,Italy,PRY,Paraguay,2012,24,183,-159
ITA,Italy,PRY,Paraguay,2013,17,155,-138
ITA,Italy,PRY,Paraguay,2014,16,120,-104
ITA,Italy,PRY,Paraguay,2015,9,94,-85
ITA,Italy,PRY,Paraguay,2016,0,93,-93
ITA,Italy,PRY,Paraguay,2017,12,91,-79
JPN,Japan,PRY,Paraguay,2008,217,286,-69
JPN,Japan,PRY,Paraguay,2009,297,147,150
JPN,Japan,PRY,Paraguay,2010,191,242,-51
JPN,Japan,PRY,Paraguay,2011,161,182,-21
JPN,Japan,PRY,Paraguay,2012,181,255,-74
JPN,Japan,PRY,Paraguay,2013,172,212,-40
JPN,Japan,PRY,Paraguay,2014,137,210,-73
JPN,Japan,PRY,Paraguay,2015,127,256,-129
JPN,Japan,PRY,Paraguay,2016,127,231,-104
JPN,Japan,PRY,Paraguay,2017,96,199,-103
KOR,Korea,PRY,Paraguay,2008,25,33,-8
KOR,Korea,PRY,Paraguay,2009,24,37,-13
KOR,Korea,PRY,Paraguay,2010,20,35,-15
KOR,Korea,PRY,Paraguay,2011,8,24,-16
KOR,Korea,PRY,Paraguay,2012,22,27,-5
KOR,Korea,PRY,Paraguay,2013,17,30,-13
KOR,Korea,PRY,Paraguay,2014,13,16,-3
KOR,Korea,PRY,Paraguay,2015,16,19,-3
KOR,Korea,PRY,Paraguay,2016,16,26,-10
KOR,Korea,PRY,Paraguay,2017,21,33,-12
LUX,Luxembourg,PRY,Paraguay,2008,0,2,-2
LUX,Luxembourg,PRY,Paraguay,2009,1,4,-3
LUX,Luxembourg,PRY,Paraguay,2010,0,0,0
LUX,Luxembourg,PRY,Paraguay,2011,0,2,-2
LUX,Luxembourg,PRY,Paraguay,2012,0,2,-2
LUX,Luxembourg,PRY,Paraguay,2013,2,2,0
LUX,Luxembourg,PRY,Paraguay,2014,1,2,-1
LUX,Luxembourg,PRY,Paraguay,2015,0,0,0
LUX,Luxembourg,PRY,Paraguay,2016,0,1,-1
LUX,Luxembourg,PRY,Paraguay,2017,5,2,3
MEX,Mexico,PRY,Paraguay,2008,0,29,-29
MEX,Mexico,PRY,Paraguay,2009,0,58,-58
MEX,Mexico,PRY,Paraguay,2010,0,55,-55
MEX,Mexico,PRY,Paraguay,2011,0,46,-46
MEX,Mexico,PRY,Paraguay,2012,0,29,-29
MEX,Mexico,PRY,Paraguay,2013,0,111,-111
MEX,Mexico,PRY,Paraguay,2014,0,79,-79
MEX,Mexico,PRY,Paraguay,2015,0,56,-56
MEX,Mexico,PRY,Paraguay,2016,0,62,-62
MEX,Mexico,PRY,Paraguay,2017,0,48,-48
NLD,Netherlands,PRY,Paraguay,2008,2,9,-7
NLD,Netherlands,PRY,Paraguay,2009,5,8,-3
NLD,Netherlands,PRY,Paraguay,2010,3,6,-3
NLD,Netherlands,PRY,Paraguay,2011,1,9,-8
NLD,Netherlands,PRY,Paraguay,2012,5,7,-2
NLD,Netherlands,PRY,Paraguay,2013,0,11,-11
NLD,Netherlands,PRY,Paraguay,2014,4,10,-6
NLD,Netherlands,PRY,Paraguay,2015,8,10,-2
NLD,Netherlands,PRY,Paraguay,2016,10,10,0
NLD,Netherlands,PRY,Paraguay,2017,11,13,-2
NZL,New Zealand,PRY,Paraguay,2008,1,4,-3
NZL,New Zealand,PRY,Paraguay,2009,8,9,-1
NZL,New Zealand,PRY,Paraguay,2010,1,6,-5
NZL,New Zealand,PRY,Paraguay,2011,3,4,-1
NZL,New Zealand,PRY,Paraguay,2012,0,2,-2
NZL,New Zealand,PRY,Paraguay,2013,2,3,-1
NZL,New Zealand,PRY,Paraguay,2014,0,1,-1
NZL,New Zealand,PRY,Paraguay,2015,0,2,-2
NZL,New Zealand,PRY,Paraguay,2016,0,6,-6
NOR,Norway,PRY,Paraguay,2008,3,18,-15
NOR,Norway,PRY,Paraguay,2009,2,8,-6
NOR,Norway,PRY,Paraguay,2010,43,7,36
NOR,Norway,PRY,Paraguay,2011,10,4,6
NOR,Norway,PRY,Paraguay,2012,5,7,-2
NOR,Norway,PRY,Paraguay,2013,2,5,-3
NOR,Norway,PRY,Paraguay,2014,1,11,-10
NOR,Norway,PRY,Paraguay,2015,1,4,-3
NOR,Norway,PRY,Paraguay,2016,4,10,-6
NOR,Norway,PRY,Paraguay,2017,2,5,-3
POL,Poland,PRY,Paraguay,2009,0,8,-8
POL,Poland,PRY,Paraguay,2010,0,8,-8
POL,Poland,PRY,Paraguay,2011,0,3,-3
POL,Poland,PRY,Paraguay,2012,0,9,-9
POL,Poland,PRY,Paraguay,2013,0,4,-4
POL,Poland,PRY,Paraguay,2014,0,1,-1
POL,Poland,PRY,Paraguay,2015,0,4,-4
POL,Poland,PRY,Paraguay,2016,0,5,-5
POL,Poland,PRY,Paraguay,2017,0,7,-7
SVK,Slovak Republic,PRY,Paraguay,2008,1,3,-2
SVK,Slovak Republic,PRY,Paraguay,2009,2,2,0
SVK,Slovak Republic,PRY,Paraguay,2010,1,1,0
SVK,Slovak Republic,PRY,Paraguay,2011,0,1,-1
ESP,Spain,PRY,Paraguay,2008,4602,17407,-12805
ESP,Spain,PRY,Paraguay,2009,7157,10765,-3608
ESP,Spain,PRY,Paraguay,2010,8105,9371,-1266
ESP,Spain,PRY,Paraguay,2011,10169,8224,1945
ESP,Spain,PRY,Paraguay,2012,12342,4797,7545
ESP,Spain,PRY,Paraguay,2013,14270,3762,10508
ESP,Spain,PRY,Paraguay,2014,6959,4239,2720
ESP,Spain,PRY,Paraguay,2015,4022,4668,-646
ESP,Spain,PRY,Paraguay,2016,3314,7169,-3855
ESP,Spain,PRY,Paraguay,2017,3428,8384,-4956
SWE,Sweden,PRY,Paraguay,2008,0,7,-7
SWE,Sweden,PRY,Paraguay,2009,0,10,-10
SWE,Sweden,PRY,Paraguay,2010,3,8,-5
SWE,Sweden,PRY,Paraguay,2011,0,5,-5
SWE,Sweden,PRY,Paraguay,2012,0,9,-9
SWE,Sweden,PRY,Paraguay,2013,0,4,-4
SWE,Sweden,PRY,Paraguay,2014,2,4,-2
SWE,Sweden,PRY,Paraguay,2015,2,4,-2
SWE,Sweden,PRY,Paraguay,2016,4,6,-2
SWE,Sweden,PRY,Paraguay,2017,2,8,-6
CHE,Switzerland,PRY,Paraguay,2010,13,37,-24
CHE,Switzerland,PRY,Paraguay,2011,9,49,-40
CHE,Switzerland,PRY,Paraguay,2012,20,48,-28
CHE,Switzerland,PRY,Paraguay,2013,11,33,-22
CHE,Switzerland,PRY,Paraguay,2014,10,43,-33
CHE,Switzerland,PRY,Paraguay,2015,19,47,-28
CHE,Switzerland,PRY,Paraguay,2016,14,43,-29
CHE,Switzerland,PRY,Paraguay,2017,8,54,-46
TUR,Turkey,PRY,Paraguay,2010,0,1,-1
USA,United States,PRY,Paraguay,2008,0,481,-481
USA,United States,PRY,Paraguay,2009,0,530,-530
USA,United States,PRY,Paraguay,2010,0,467,-467
USA,United States,PRY,Paraguay,2011,0,500,-500
USA,United States,PRY,Paraguay,2012,0,467,-467
USA,United States,PRY,Paraguay,2013,0,448,-448
USA,United States,PRY,Paraguay,2014,0,391,-391
USA,United States,PRY,Paraguay,2015,0,382,-382
USA,United States,PRY,Paraguay,2016,0,434,-434
USA,United States,PRY,Paraguay,2017,0,391,-391
CHL,Chile,PRY,Paraguay,2008,0,423,-423
CHL,Chile,PRY,Paraguay,2009,0,381,-381
CHL,Chile,PRY,Paraguay,2010,0,415,-415
CHL,Chile,PRY,Paraguay,2011,0,564,-564
CHL,Chile,PRY,Paraguay,2012,0,614,-614
CHL,Chile,PRY,Paraguay,2013,0,735,-735
CHL,Chile,PRY,Paraguay,2014,0,679,-679
CHL,Chile,PRY,Paraguay,2015,0,775,-775
CHL,Chile,PRY,Paraguay,2016,0,757,-757
EST,Estonia,PRY,Paraguay,2008,0,0,0
EST,Estonia,PRY,Paraguay,2009,0,0,0
EST,Estonia,PRY,Paraguay,2010,0,0,0
EST,Estonia,PRY,Paraguay,2011,0,0,0
EST,Estonia,PRY,Paraguay,2012,0,0,0
EST,Estonia,PRY,Paraguay,2013,0,1,-1
EST,Estonia,PRY,Paraguay,2014,0,0,0
EST,Estonia,PRY,Paraguay,2015,0,0,0
EST,Estonia,PRY,Paraguay,2016,0,0,0
EST,Estonia,PRY,Paraguay,2017,0,0,0
SVN,Slovenia,PRY,Paraguay,2009,0,2,-2
SVN,Slovenia,PRY,Paraguay,2015,0,2,-2
SVN,Slovenia,PRY,Paraguay,2017,0,1,-1
AUS,Australia,PER,Peru,2008,60,323,-263
AUS,Australia,PER,Peru,2009,72,375,-303
AUS,Australia,PER,Peru,2010,67,358,-291
AUS,Australia,PER,Peru,2011,60,343,-283
AUS,Australia,PER,Peru,2012,76,340,-264
AUS,Australia,PER,Peru,2013,76,376,-300
AUS,Australia,PER,Peru,2014,70,290,-220
AUS,Australia,PER,Peru,2015,100,257,-157
AUS,Australia,PER,Peru,2016,100,225,-125
AUS,Australia,PER,Peru,2017,0,267,-267
AUT,Austria,PER,Peru,2008,77,114,-37
AUT,Austria,PER,Peru,2009,78,107,-29
AUT,Austria,PER,Peru,2010,71,95,-24
AUT,Austria,PER,Peru,2011,61,95,-34
AUT,Austria,PER,Peru,2012,74,106,-32
AUT,Austria,PER,Peru,2013,73,87,-14
AUT,Austria,PER,Peru,2014,57,79,-22
AUT,Austria,PER,Peru,2015,51,82,-31
AUT,Austria,PER,Peru,2016,55,81,-26
AUT,Austria,PER,Peru,2017,72,95,-23
BEL,Belgium,PER,Peru,2008,0,223,-223
BEL,Belgium,PER,Peru,2009,0,232,-232
BEL,Belgium,PER,Peru,2010,82,268,-186
BEL,Belgium,PER,Peru,2011,0,200,-200
BEL,Belgium,PER,Peru,2012,86,188,-102
BEL,Belgium,PER,Peru,2013,116,152,-36
BEL,Belgium,PER,Peru,2014,77,98,-21
BEL,Belgium,PER,Peru,2015,69,104,-35
BEL,Belgium,PER,Peru,2016,44,133,-89
BEL,Belgium,PER,Peru,2017,33,167,-134
CAN,Canada,PER,Peru,2008,0,1094,-1094
CAN,Canada,PER,Peru,2009,0,1881,-1881
CAN,Canada,PER,Peru,2010,0,1282,-1282
CAN,Canada,PER,Peru,2011,0,886,-886
CAN,Canada,PER,Peru,2012,0,787,-787
CAN,Canada,PER,Peru,2013,0,683,-683
CAN,Canada,PER,Peru,2014,0,712,-712
CAN,Canada,PER,Peru,2015,0,559,-559
CAN,Canada,PER,Peru,2016,0,435,-435
CAN,Canada,PER,Peru,2017,0,425,-425
CZE,Czech Republic,PER,Peru,2008,0,24,-24
CZE,Czech Republic,PER,Peru,2009,0,30,-30
CZE,Czech Republic,PER,Peru,2010,1,19,-18
CZE,Czech Republic,PER,Peru,2011,0,21,-21
CZE,Czech Republic,PER,Peru,2012,7,18,-11
CZE,Czech Republic,PER,Peru,2013,13,20,-7
CZE,Czech Republic,PER,Peru,2014,11,18,-7
CZE,Czech Republic,PER,Peru,2015,16,30,-14
CZE,Czech Republic,PER,Peru,2016,15,16,-1
CZE,Czech Republic,PER,Peru,2017,13,30,-17
DNK,Denmark,PER,Peru,2008,19,57,-38
DNK,Denmark,PER,Peru,2009,16,54,-38
DNK,Denmark,PER,Peru,2010,21,52,-31
DNK,Denmark,PER,Peru,2011,27,39,-12
DNK,Denmark,PER,Peru,2012,21,34,-13
DNK,Denmark,PER,Peru,2013,33,34,-1
DNK,Denmark,PER,Peru,2014,25,25,0
DNK,Denmark,PER,Peru,2015,15,39,-24
DNK,Denmark,PER,Peru,2016,20,30,-10
DNK,Denmark,PER,Peru,2017,27,40,-13
FIN,Finland,PER,Peru,2008,12,22,-10
FIN,Finland,PER,Peru,2009,3,18,-15
FIN,Finland,PER,Peru,2010,7,30,-23
FIN,Finland,PER,Peru,2011,8,24,-16
FIN,Finland,PER,Peru,2012,5,24,-19
FIN,Finland,PER,Peru,2013,3,23,-20
FIN,Finland,PER,Peru,2014,6,15,-9
FIN,Finland,PER,Peru,2015,9,21,-12
FIN,Finland,PER,Peru,2016,3,30,-27
FIN,Finland,PER,Peru,2017,2,16,-14
FRA,France,PER,Peru,2008,0,502,-502
FRA,France,PER,Peru,2009,0,487,-487
FRA,France,PER,Peru,2010,0,511,-511
FRA,France,PER,Peru,2011,0,475,-475
FRA,France,PER,Peru,2012,0,531,-531
FRA,France,PER,Peru,2013,0,523,-523
FRA,France,PER,Peru,2014,0,507,-507
FRA,France,PER,Peru,2015,0,409,-409
FRA,France,PER,Peru,2016,0,380,-380
FRA,France,PER,Peru,2017,0,391,-391
DEU,Germany,PER,Peru,2008,865,944,-79
DEU,Germany,PER,Peru,2009,828,853,-25
DEU,Germany,PER,Peru,2010,638,862,-224
DEU,Germany,PER,Peru,2011,570,821,-251
DEU,Germany,PER,Peru,2012,580,953,-373
DEU,Germany,PER,Peru,2013,550,989,-439
DEU,Germany,PER,Peru,2014,563,926,-363
DEU,Germany,PER,Peru,2015,564,968,-404
DEU,Germany,PER,Peru,2016,543,1101,-558
DEU,Germany,PER,Peru,2017,565,1209,-644
HUN,Hungary,PER,Peru,2008,1,24,-23
HUN,Hungary,PER,Peru,2009,1,19,-18
HUN,Hungary,PER,Peru,2010,1,12,-11
HUN,Hungary,PER,Peru,2011,2,8,-6
HUN,Hungary,PER,Peru,2012,3,10,-7
HUN,Hungary,PER,Peru,2013,0,18,-18
HUN,Hungary,PER,Peru,2014,3,8,-5
HUN,Hungary,PER,Peru,2015,0,13,-13
HUN,Hungary,PER,Peru,2016,0,14,-14
HUN,Hungary,PER,Peru,2017,0,28,-28
ISL,Iceland,PER,Peru,2008,3,5,-2
ISL,Iceland,PER,Peru,2009,2,2,0
ISL,Iceland,PER,Peru,2010,1,5,-4
ISL,Iceland,PER,Peru,2011,4,1,3
ISL,Iceland,PER,Peru,2012,2,3,-1
ISL,Iceland,PER,Peru,2013,4,5,-1
ISL,Iceland,PER,Peru,2014,1,3,-2
ISL,Iceland,PER,Peru,2015,1,1,0
ISL,Iceland,PER,Peru,2016,1,5,-4
ISL,Iceland,PER,Peru,2017,0,8,-8
ITA,Italy,PER,Peru,2008,163,7182,-7019
ITA,Italy,PER,Peru,2009,181,10421,-10240
ITA,Italy,PER,Peru,2010,353,12166,-11813
ITA,Italy,PER,Peru,2011,390,8686,-8296
ITA,Italy,PER,Peru,2012,430,5614,-5184
ITA,Italy,PER,Peru,2013,631,4338,-3707
ITA,Italy,PER,Peru,2014,690,2760,-2070
ITA,Italy,PER,Peru,2015,541,1906,-1365
ITA,Italy,PER,Peru,2016,0,1701,-1701
ITA,Italy,PER,Peru,2017,363,2159,-1796
JPN,Japan,PER,Peru,2008,627,1647,-1020
JPN,Japan,PER,Peru,2009,1447,1121,326
JPN,Japan,PER,Peru,2010,934,1193,-259
JPN,Japan,PER,Peru,2011,536,749,-213
JPN,Japan,PER,Peru,2012,514,1014,-500
JPN,Japan,PER,Peru,2013,349,919,-570
JPN,Japan,PER,Peru,2014,309,897,-588
JPN,Japan,PER,Peru,2015,362,1054,-692
JPN,Japan,PER,Peru,2016,319,963,-644
JPN,Japan,PER,Peru,2017,397,1061,-664
KOR,Korea,PER,Peru,2008,203,141,62
KOR,Korea,PER,Peru,2009,198,92,106
KOR,Korea,PER,Peru,2010,178,109,69
KOR,Korea,PER,Peru,2011,122,110,12
KOR,Korea,PER,Peru,2012,193,152,41
KOR,Korea,PER,Peru,2013,104,106,-2
KOR,Korea,PER,Peru,2014,138,136,2
KOR,Korea,PER,Peru,2015,134,153,-19
KOR,Korea,PER,Peru,2016,157,142,15
KOR,Korea,PER,Peru,2017,135,130,5
LUX,Luxembourg,PER,Peru,2008,0,13,-13
LUX,Luxembourg,PER,Peru,2009,3,17,-14
LUX,Luxembourg,PER,Peru,2010,3,12,-9
LUX,Luxembourg,PER,Peru,2011,1,16,-15
LUX,Luxembourg,PER,Peru,2012,7,12,-5
LUX,Luxembourg,PER,Peru,2013,6,8,-2
LUX,Luxembourg,PER,Peru,2014,3,9,-6
LUX,Luxembourg,PER,Peru,2015,2,13,-11
LUX,Luxembourg,PER,Peru,2016,3,13,-10
LUX,Luxembourg,PER,Peru,2017,9,15,-6
MEX,Mexico,PER,Peru,2008,0,412,-412
MEX,Mexico,PER,Peru,2009,0,667,-667
MEX,Mexico,PER,Peru,2010,0,825,-825
MEX,Mexico,PER,Peru,2011,0,550,-550
MEX,Mexico,PER,Peru,2012,0,377,-377
MEX,Mexico,PER,Peru,2013,0,1226,-1226
MEX,Mexico,PER,Peru,2014,0,932,-932
MEX,Mexico,PER,Peru,2015,0,630,-630
MEX,Mexico,PER,Peru,2016,0,577,-577
MEX,Mexico,PER,Peru,2017,0,506,-506
NLD,Netherlands,PER,Peru,2008,165,290,-125
NLD,Netherlands,PER,Peru,2009,135,243,-108
NLD,Netherlands,PER,Peru,2010,128,244,-116
NLD,Netherlands,PER,Peru,2011,108,214,-106
NLD,Netherlands,PER,Peru,2012,113,204,-91
NLD,Netherlands,PER,Peru,2013,147,172,-25
NLD,Netherlands,PER,Peru,2014,100,157,-57
NLD,Netherlands,PER,Peru,2015,109,176,-67
NLD,Netherlands,PER,Peru,2016,106,163,-57
NLD,Netherlands,PER,Peru,2017,128,231,-103
NZL,New Zealand,PER,Peru,2008,10,24,-14
NZL,New Zealand,PER,Peru,2009,4,19,-15
NZL,New Zealand,PER,Peru,2010,10,22,-12
NZL,New Zealand,PER,Peru,2011,13,48,-35
NZL,New Zealand,PER,Peru,2012,17,41,-24
NZL,New Zealand,PER,Peru,2013,7,48,-41
NZL,New Zealand,PER,Peru,2014,19,71,-52
NZL,New Zealand,PER,Peru,2015,15,64,-49
NZL,New Zealand,PER,Peru,2016,21,86,-65
NZL,New Zealand,PER,Peru,2017,29,99,-70
NOR,Norway,PER,Peru,2008,33,77,-44
NOR,Norway,PER,Peru,2009,26,103,-77
NOR,Norway,PER,Peru,2010,0,80,-80
NOR,Norway,PER,Peru,2011,57,56,1
NOR,Norway,PER,Peru,2012,31,79,-48
NOR,Norway,PER,Peru,2013,34,80,-46
NOR,Norway,PER,Peru,2014,28,74,-46
NOR,Norway,PER,Peru,2015,53,57,-4
NOR,Norway,PER,Peru,2016,33,66,-33
NOR,Norway,PER,Peru,2017,24,43,-19
POL,Poland,PER,Peru,2008,0,72,-72
POL,Poland,PER,Peru,2009,0,56,-56
POL,Poland,PER,Peru,2010,0,53,-53
POL,Poland,PER,Peru,2011,0,40,-40
POL,Poland,PER,Peru,2012,0,50,-50
POL,Poland,PER,Peru,2013,0,39,-39
POL,Poland,PER,Peru,2014,0,34,-34
POL,Poland,PER,Peru,2015,0,38,-38
POL,Poland,PER,Peru,2016,0,45,-45
POL,Poland,PER,Peru,2017,0,40,-40
SVK,Slovak Republic,PER,Peru,2008,1,1,0
SVK,Slovak Republic,PER,Peru,2009,4,3,1
SVK,Slovak Republic,PER,Peru,2010,1,1,0
SVK,Slovak Republic,PER,Peru,2011,1,3,-2
SVK,Slovak Republic,PER,Peru,2012,0,1,-1
SVK,Slovak Republic,PER,Peru,2014,0,2,-2
SVK,Slovak Republic,PER,Peru,2015,0,1,-1
SVK,Slovak Republic,PER,Peru,2017,0,1,-1
ESP,Spain,PER,Peru,2008,4388,27523,-23135
ESP,Spain,PER,Peru,2009,6673,13664,-6991
ESP,Spain,PER,Peru,2010,8378,8021,357
ESP,Spain,PER,Peru,2011,9074,7660,1414
ESP,Spain,PER,Peru,2012,9542,5593,3949
ESP,Spain,PER,Peru,2013,11065,4844,6221
ESP,Spain,PER,Peru,2014,5934,4674,1260
ESP,Spain,PER,Peru,2015,3477,5255,-1778
ESP,Spain,PER,Peru,2016,2974,7954,-4980
ESP,Spain,PER,Peru,2017,3743,13936,-10193
SWE,Sweden,PER,Peru,2008,16,265,-249
SWE,Sweden,PER,Peru,2009,18,275,-257
SWE,Sweden,PER,Peru,2010,27,251,-224
SWE,Sweden,PER,Peru,2011,33,224,-191
SWE,Sweden,PER,Peru,2012,42,205,-163
SWE,Sweden,PER,Peru,2013,39,154,-115
SWE,Sweden,PER,Peru,2014,47,130,-83
SWE,Sweden,PER,Peru,2015,69,141,-72
SWE,Sweden,PER,Peru,2016,42,132,-90
SWE,Sweden,PER,Peru,2017,31,136,-105
CHE,Switzerland,PER,Peru,2010,117,275,-158
CHE,Switzerland,PER,Peru,2011,102,260,-158
CHE,Switzerland,PER,Peru,2012,94,217,-123
CHE,Switzerland,PER,Peru,2013,73,211,-138
CHE,Switzerland,PER,Peru,2014,83,191,-108
CHE,Switzerland,PER,Peru,2015,87,197,-110
CHE,Switzerland,PER,Peru,2016,84,195,-111
CHE,Switzerland,PER,Peru,2017,81,222,-141
TUR,Turkey,PER,Peru,2010,0,4,-4
USA,United States,PER,Peru,2008,0,15184,-15184
USA,United States,PER,Peru,2009,0,16957,-16957
USA,United States,PER,Peru,2010,0,14247,-14247
USA,United States,PER,Peru,2011,0,14064,-14064
USA,United States,PER,Peru,2012,0,12609,-12609
USA,United States,PER,Peru,2013,0,12564,-12564
USA,United States,PER,Peru,2014,0,10606,-10606
USA,United States,PER,Peru,2015,0,10148,-10148
USA,United States,PER,Peru,2016,0,10940,-10940
USA,United States,PER,Peru,2017,0,10115,-10115
CHL,Chile,PER,Peru,2008,0,22345,-22345
CHL,Chile,PER,Peru,2009,0,14892,-14892
CHL,Chile,PER,Peru,2010,0,14746,-14746
CHL,Chile,PER,Peru,2011,0,16371,-16371
CHL,Chile,PER,Peru,2012,0,18918,-18918
CHL,Chile,PER,Peru,2013,0,18925,-18925
CHL,Chile,PER,Peru,2014,0,19818,-19818
CHL,Chile,PER,Peru,2015,0,24687,-24687
CHL,Chile,PER,Peru,2016,0,25482,-25482
EST,Estonia,PER,Peru,2008,0,2,-2
EST,Estonia,PER,Peru,2009,0,1,-1
EST,Estonia,PER,Peru,2010,0,0,0
EST,Estonia,PER,Peru,2011,0,0,0
EST,Estonia,PER,Peru,2012,0,0,0
EST,Estonia,PER,Peru,2013,0,3,-3
EST,Estonia,PER,Peru,2014,0,0,0
EST,Estonia,PER,Peru,2015,0,2,-2
EST,Estonia,PER,Peru,2016,0,3,-3
EST,Estonia,PER,Peru,2017,0,4,-4
ISR,Israel,PER,Peru,2008,0,138,-138
ISR,Israel,PER,Peru,2009,0,102,-102
ISR,Israel,PER,Peru,2010,0,121,-121
ISR,Israel,PER,Peru,2011,0,79,-79
ISR,Israel,PER,Peru,2012,0,37,-37
ISR,Israel,PER,Peru,2013,0,101,-101
ISR,Israel,PER,Peru,2014,0,31,-31
ISR,Israel,PER,Peru,2015,0,30,-30
ISR,Israel,PER,Peru,2016,0,45,-45
ISR,Israel,PER,Peru,2017,0,59,-59
SVN,Slovenia,PER,Peru,2008,0,8,-8
SVN,Slovenia,PER,Peru,2009,0,3,-3
SVN,Slovenia,PER,Peru,2010,0,3,-3
SVN,Slovenia,PER,Peru,2011,0,9,-9
SVN,Slovenia,PER,Peru,2012,0,1,-1
SVN,Slovenia,PER,Peru,2013,0,2,-2
SVN,Slovenia,PER,Peru,2014,0,1,-1
SVN,Slovenia,PER,Peru,2015,0,7,-7
SVN,Slovenia,PER,Peru,2016,0,1,-1
AUS,Australia,PHL,Philippines,2008,760,7078,-6318
AUS,Australia,PHL,Philippines,2009,789,8904,-8115
AUS,Australia,PHL,Philippines,2010,711,10248,-9537
AUS,Australia,PHL,Philippines,2011,850,10651,-9801
AUS,Australia,PHL,Philippines,2012,820,12777,-11957
AUS,Australia,PHL,Philippines,2013,838,11032,-10194
AUS,Australia,PHL,Philippines,2014,926,10345,-9419
AUS,Australia,PHL,Philippines,2015,1000,11942,-10942
AUS,Australia,PHL,Philippines,2016,900,11968,-11068
AUS,Australia,PHL,Philippines,2017,0,12145,-12145
AUT,Austria,PHL,Philippines,2008,147,347,-200
AUT,Austria,PHL,Philippines,2009,159,330,-171
AUT,Austria,PHL,Philippines,2010,151,241,-90
AUT,Austria,PHL,Philippines,2011,168,279,-111
AUT,Austria,PHL,Philippines,2012,122,288,-166
AUT,Austria,PHL,Philippines,2013,140,341,-201
AUT,Austria,PHL,Philippines,2014,161,335,-174
AUT,Austria,PHL,Philippines,2015,159,370,-211
AUT,Austria,PHL,Philippines,2016,162,315,-153
AUT,Austria,PHL,Philippines,2017,163,339,-176
BEL,Belgium,PHL,Philippines,2008,134,494,-360
BEL,Belgium,PHL,Philippines,2009,149,503,-354
BEL,Belgium,PHL,Philippines,2010,132,609,-477
BEL,Belgium,PHL,Philippines,2011,133,662,-529
BEL,Belgium,PHL,Philippines,2012,146,557,-411
BEL,Belgium,PHL,Philippines,2013,224,524,-300
BEL,Belgium,PHL,Philippines,2014,128,448,-320
BEL,Belgium,PHL,Philippines,2015,162,430,-268
BEL,Belgium,PHL,Philippines,2016,127,493,-366
BEL,Belgium,PHL,Philippines,2017,105,456,-351
CAN,Canada,PHL,Philippines,2008,0,24883,-24883
CAN,Canada,PHL,Philippines,2009,0,28568,-28568
CAN,Canada,PHL,Philippines,2010,0,38614,-38614
CAN,Canada,PHL,Philippines,2011,0,36758,-36758
CAN,Canada,PHL,Philippines,2012,0,34299,-34299
CAN,Canada,PHL,Philippines,2013,0,29532,-29532
CAN,Canada,PHL,Philippines,2014,0,40031,-40031
CAN,Canada,PHL,Philippines,2015,0,50825,-50825
CAN,Canada,PHL,Philippines,2016,0,41815,-41815
CAN,Canada,PHL,Philippines,2017,0,40855,-40855
CZE,Czech Republic,PHL,Philippines,2008,0,113,-113
CZE,Czech Republic,PHL,Philippines,2009,0,279,-279
CZE,Czech Republic,PHL,Philippines,2010,0,100,-100
CZE,Czech Republic,PHL,Philippines,2011,0,62,-62
CZE,Czech Republic,PHL,Philippines,2012,42,86,-44
CZE,Czech Republic,PHL,Philippines,2013,105,71,34
CZE,Czech Republic,PHL,Philippines,2014,68,169,-101
CZE,Czech Republic,PHL,Philippines,2015,47,105,-58
CZE,Czech Republic,PHL,Philippines,2016,55,197,-142
CZE,Czech Republic,PHL,Philippines,2017,56,317,-261
DNK,Denmark,PHL,Philippines,2008,777,1659,-882
DNK,Denmark,PHL,Philippines,2009,910,1770,-860
DNK,Denmark,PHL,Philippines,2010,1214,1842,-628
DNK,Denmark,PHL,Philippines,2011,1209,1651,-442
DNK,Denmark,PHL,Philippines,2012,1069,1431,-362
DNK,Denmark,PHL,Philippines,2013,1133,1653,-520
DNK,Denmark,PHL,Philippines,2014,1039,1468,-429
DNK,Denmark,PHL,Philippines,2015,953,1324,-371
DNK,Denmark,PHL,Philippines,2016,1002,1133,-131
DNK,Denmark,PHL,Philippines,2017,1030,1283,-253
FIN,Finland,PHL,Philippines,2008,17,226,-209
FIN,Finland,PHL,Philippines,2009,9,207,-198
FIN,Finland,PHL,Philippines,2010,8,178,-170
FIN,Finland,PHL,Philippines,2011,12,225,-213
FIN,Finland,PHL,Philippines,2012,22,290,-268
FIN,Finland,PHL,Philippines,2013,12,345,-333
FIN,Finland,PHL,Philippines,2014,19,485,-466
FIN,Finland,PHL,Philippines,2015,19,379,-360
FIN,Finland,PHL,Philippines,2016,28,416,-388
FIN,Finland,PHL,Philippines,2017,23,409,-386
FRA,France,PHL,Philippines,2008,0,766,-766
FRA,France,PHL,Philippines,2009,0,833,-833
FRA,France,PHL,Philippines,2010,0,724,-724
FRA,France,PHL,Philippines,2011,0,736,-736
FRA,France,PHL,Philippines,2012,0,779,-779
FRA,France,PHL,Philippines,2013,0,1063,-1063
FRA,France,PHL,Philippines,2014,0,1077,-1077
FRA,France,PHL,Philippines,2015,0,1162,-1162
FRA,France,PHL,Philippines,2016,0,1358,-1358
FRA,France,PHL,Philippines,2017,0,1531,-1531
DEU,Germany,PHL,Philippines,2008,5056,5609,-553
DEU,Germany,PHL,Philippines,2009,5575,6037,-462
DEU,Germany,PHL,Philippines,2010,4462,5316,-854
DEU,Germany,PHL,Philippines,2011,4412,5653,-1241
DEU,Germany,PHL,Philippines,2012,4075,4724,-649
DEU,Germany,PHL,Philippines,2013,3192,4250,-1058
DEU,Germany,PHL,Philippines,2014,3233,4090,-857
DEU,Germany,PHL,Philippines,2015,2959,3909,-950
DEU,Germany,PHL,Philippines,2016,2390,3665,-1275
DEU,Germany,PHL,Philippines,2017,2081,3851,-1770
GRC,Greece,PHL,Philippines,2008,0,771,-771
GRC,Greece,PHL,Philippines,2009,0,1077,-1077
GRC,Greece,PHL,Philippines,2010,0,522,-522
GRC,Greece,PHL,Philippines,2011,0,345,-345
HUN,Hungary,PHL,Philippines,2008,0,41,-41
HUN,Hungary,PHL,Philippines,2009,3,68,-65
HUN,Hungary,PHL,Philippines,2010,8,39,-31
HUN,Hungary,PHL,Philippines,2011,5,51,-46
HUN,Hungary,PHL,Philippines,2012,4,48,-44
HUN,Hungary,PHL,Philippines,2013,2,29,-27
HUN,Hungary,PHL,Philippines,2014,8,51,-43
HUN,Hungary,PHL,Philippines,2015,9,50,-41
HUN,Hungary,PHL,Philippines,2016,18,69,-51
HUN,Hungary,PHL,Philippines,2017,0,94,-94
ISL,Iceland,PHL,Philippines,2008,38,92,-54
ISL,Iceland,PHL,Philippines,2009,34,49,-15
ISL,Iceland,PHL,Philippines,2010,21,50,-29
ISL,Iceland,PHL,Philippines,2011,10,54,-44
ISL,Iceland,PHL,Philippines,2012,15,53,-38
ISL,Iceland,PHL,Philippines,2013,13,74,-61
ISL,Iceland,PHL,Philippines,2014,16,46,-30
ISL,Iceland,PHL,Philippines,2015,13,86,-73
ISL,Iceland,PHL,Philippines,2016,23,110,-87
ISL,Iceland,PHL,Philippines,2017,32,180,-148
ITA,Italy,PHL,Philippines,2008,202,7849,-7647
ITA,Italy,PHL,Philippines,2009,240,9995,-9755
ITA,Italy,PHL,Philippines,2010,298,10745,-10447
ITA,Italy,PHL,Philippines,2011,289,10351,-10062
ITA,Italy,PHL,Philippines,2012,439,9893,-9454
ITA,Italy,PHL,Philippines,2013,401,7565,-7164
ITA,Italy,PHL,Philippines,2014,408,5816,-5408
ITA,Italy,PHL,Philippines,2015,455,3773,-3318
ITA,Italy,PHL,Philippines,2016,0,3181,-3181
ITA,Italy,PHL,Philippines,2017,390,3081,-2691
JPN,Japan,PHL,Philippines,2008,10711,20973,-10262
JPN,Japan,PHL,Philippines,2009,10331,15780,-5449
JPN,Japan,PHL,Philippines,2010,9540,13264,-3724
JPN,Japan,PHL,Philippines,2011,9089,13599,-4510
JPN,Japan,PHL,Philippines,2012,8612,15412,-6800
JPN,Japan,PHL,Philippines,2013,9171,16430,-7259
JPN,Japan,PHL,Philippines,2014,10236,19912,-9676
JPN,Japan,PHL,Philippines,2015,11780,23957,-12177
JPN,Japan,PHL,Philippines,2016,12785,26226,-13441
JPN,Japan,PHL,Philippines,2017,16756,29617,-12861
KOR,Korea,PHL,Philippines,2008,11552,9125,2427
KOR,Korea,PHL,Philippines,2009,11203,8895,2308
KOR,Korea,PHL,Philippines,2010,8802,9079,-277
KOR,Korea,PHL,Philippines,2011,10944,9565,1379
KOR,Korea,PHL,Philippines,2012,14393,9858,4535
KOR,Korea,PHL,Philippines,2013,6891,11963,-5072
KOR,Korea,PHL,Philippines,2014,6232,10717,-4485
KOR,Korea,PHL,Philippines,2015,8144,9867,-1723
KOR,Korea,PHL,Philippines,2016,8397,9530,-1133
KOR,Korea,PHL,Philippines,2017,8663,8988,-325
LUX,Luxembourg,PHL,Philippines,2008,9,25,-16
LUX,Luxembourg,PHL,Philippines,2009,5,27,-22
LUX,Luxembourg,PHL,Philippines,2010,13,23,-10
LUX,Luxembourg,PHL,Philippines,2011,8,20,-12
LUX,Luxembourg,PHL,Philippines,2012,7,18,-11
LUX,Luxembourg,PHL,Philippines,2013,5,24,-19
LUX,Luxembourg,PHL,Philippines,2014,9,42,-33
LUX,Luxembourg,PHL,Philippines,2015,20,50,-30
LUX,Luxembourg,PHL,Philippines,2016,11,60,-49
LUX,Luxembourg,PHL,Philippines,2017,10,90,-80
MEX,Mexico,PHL,Philippines,2008,0,32,-32
MEX,Mexico,PHL,Philippines,2009,0,44,-44
MEX,Mexico,PHL,Philippines,2010,0,52,-52
MEX,Mexico,PHL,Philippines,2011,0,50,-50
MEX,Mexico,PHL,Philippines,2012,0,36,-36
MEX,Mexico,PHL,Philippines,2013,0,177,-177
MEX,Mexico,PHL,Philippines,2014,0,181,-181
MEX,Mexico,PHL,Philippines,2015,0,68,-68
MEX,Mexico,PHL,Philippines,2016,0,84,-84
MEX,Mexico,PHL,Philippines,2017,0,76,-76
NLD,Netherlands,PHL,Philippines,2008,392,1017,-625
NLD,Netherlands,PHL,Philippines,2009,523,980,-457
NLD,Netherlands,PHL,Philippines,2010,553,958,-405
NLD,Netherlands,PHL,Philippines,2011,586,845,-259
NLD,Netherlands,PHL,Philippines,2012,471,869,-398
NLD,Netherlands,PHL,Philippines,2013,529,949,-420
NLD,Netherlands,PHL,Philippines,2014,505,942,-437
NLD,Netherlands,PHL,Philippines,2015,490,928,-438
NLD,Netherlands,PHL,Philippines,2016,475,1022,-547
NLD,Netherlands,PHL,Philippines,2017,514,1185,-671
NZL,New Zealand,PHL,Philippines,2008,216,4139,-3923
NZL,New Zealand,PHL,Philippines,2009,386,2751,-2365
NZL,New Zealand,PHL,Philippines,2010,402,1972,-1570
NZL,New Zealand,PHL,Philippines,2011,550,2425,-1875
NZL,New Zealand,PHL,Philippines,2012,412,2888,-2476
NZL,New Zealand,PHL,Philippines,2013,358,3178,-2820
NZL,New Zealand,PHL,Philippines,2014,238,4657,-4419
NZL,New Zealand,PHL,Philippines,2015,253,6304,-6051
NZL,New Zealand,PHL,Philippines,2016,385,6010,-5625
NZL,New Zealand,PHL,Philippines,2017,539,6610,-6071
NOR,Norway,PHL,Philippines,2008,384,1765,-1381
NOR,Norway,PHL,Philippines,2009,595,1673,-1078
NOR,Norway,PHL,Philippines,2010,887,2126,-1239
NOR,Norway,PHL,Philippines,2011,1046,2553,-1507
NOR,Norway,PHL,Philippines,2012,1047,2490,-1443
NOR,Norway,PHL,Philippines,2013,1079,2815,-1736
NOR,Norway,PHL,Philippines,2014,1144,2157,-1013
NOR,Norway,PHL,Philippines,2015,1525,2241,-716
NOR,Norway,PHL,Philippines,2016,1308,2074,-766
NOR,Norway,PHL,Philippines,2017,1009,1884,-875
POL,Poland,PHL,Philippines,2008,0,93,-93
POL,Poland,PHL,Philippines,2009,0,133,-133
POL,Poland,PHL,Philippines,2010,0,166,-166
POL,Poland,PHL,Philippines,2011,0,185,-185
POL,Poland,PHL,Philippines,2012,0,172,-172
POL,Poland,PHL,Philippines,2013,0,200,-200
POL,Poland,PHL,Philippines,2014,0,123,-123
POL,Poland,PHL,Philippines,2015,0,193,-193
POL,Poland,PHL,Philippines,2016,0,193,-193
POL,Poland,PHL,Philippines,2017,0,228,-228
SVK,Slovak Republic,PHL,Philippines,2008,12,15,-3
SVK,Slovak Republic,PHL,Philippines,2009,3,10,-7
SVK,Slovak Republic,PHL,Philippines,2010,10,1,9
SVK,Slovak Republic,PHL,Philippines,2011,1,2,-1
SVK,Slovak Republic,PHL,Philippines,2012,0,1,-1
SVK,Slovak Republic,PHL,Philippines,2013,0,1,-1
SVK,Slovak Republic,PHL,Philippines,2014,0,3,-3
SVK,Slovak Republic,PHL,Philippines,2015,0,3,-3
SVK,Slovak Republic,PHL,Philippines,2016,0,5,-5
SVK,Slovak Republic,PHL,Philippines,2017,0,6,-6
ESP,Spain,PHL,Philippines,2008,809,4849,-4040
ESP,Spain,PHL,Philippines,2009,1049,3124,-2075
ESP,Spain,PHL,Philippines,2010,1152,2135,-983
ESP,Spain,PHL,Philippines,2011,1424,2483,-1059
ESP,Spain,PHL,Philippines,2012,1458,2140,-682
ESP,Spain,PHL,Philippines,2013,1946,2095,-149
ESP,Spain,PHL,Philippines,2014,1315,2001,-686
ESP,Spain,PHL,Philippines,2015,900,2465,-1565
ESP,Spain,PHL,Philippines,2016,931,2525,-1594
ESP,Spain,PHL,Philippines,2017,990,2824,-1834
SWE,Sweden,PHL,Philippines,2008,38,560,-522
SWE,Sweden,PHL,Philippines,2009,34,632,-598
SWE,Sweden,PHL,Philippines,2010,47,588,-541
SWE,Sweden,PHL,Philippines,2011,54,580,-526
SWE,Sweden,PHL,Philippines,2012,60,662,-602
SWE,Sweden,PHL,Philippines,2013,44,546,-502
SWE,Sweden,PHL,Philippines,2014,54,575,-521
SWE,Sweden,PHL,Philippines,2015,96,524,-428
SWE,Sweden,PHL,Philippines,2016,57,612,-555
SWE,Sweden,PHL,Philippines,2017,61,810,-749
CHE,Switzerland,PHL,Philippines,2010,139,440,-301
CHE,Switzerland,PHL,Philippines,2011,145,415,-270
CHE,Switzerland,PHL,Philippines,2012,153,411,-258
CHE,Switzerland,PHL,Philippines,2013,178,487,-309
CHE,Switzerland,PHL,Philippines,2014,149,486,-337
CHE,Switzerland,PHL,Philippines,2015,194,504,-310
CHE,Switzerland,PHL,Philippines,2016,224,578,-354
CHE,Switzerland,PHL,Philippines,2017,159,475,-316
TUR,Turkey,PHL,Philippines,2010,0,87,-87
TUR,Turkey,PHL,Philippines,2016,386,1005,-619
TUR,Turkey,PHL,Philippines,2017,488,1224,-736
GBR,United Kingdom,PHL,Philippines,2008,0,13000,-13000
GBR,United Kingdom,PHL,Philippines,2009,0,12000,-12000
GBR,United Kingdom,PHL,Philippines,2010,0,9000,-9000
GBR,United Kingdom,PHL,Philippines,2011,1000,4000,-3000
GBR,United Kingdom,PHL,Philippines,2012,1000,2000,-1000
GBR,United Kingdom,PHL,Philippines,2013,1000,2000,-1000
GBR,United Kingdom,PHL,Philippines,2014,1000,4000,-3000
GBR,United Kingdom,PHL,Philippines,2015,0,3000,-3000
GBR,United Kingdom,PHL,Philippines,2016,0,3000,-3000
GBR,United Kingdom,PHL,Philippines,2017,0,5000,-5000
USA,United States,PHL,Philippines,2008,0,54030,-54030
USA,United States,PHL,Philippines,2009,0,60029,-60029
USA,United States,PHL,Philippines,2010,0,58173,-58173
USA,United States,PHL,Philippines,2011,0,57011,-57011
USA,United States,PHL,Philippines,2012,0,57327,-57327
USA,United States,PHL,Philippines,2013,0,54446,-54446
USA,United States,PHL,Philippines,2014,0,49996,-49996
USA,United States,PHL,Philippines,2015,0,56478,-56478
USA,United States,PHL,Philippines,2016,0,53287,-53287
USA,United States,PHL,Philippines,2017,0,49147,-49147
CHL,Chile,PHL,Philippines,2008,0,20,-20
CHL,Chile,PHL,Philippines,2009,0,31,-31
CHL,Chile,PHL,Philippines,2010,0,54,-54
CHL,Chile,PHL,Philippines,2011,0,58,-58
CHL,Chile,PHL,Philippines,2012,0,31,-31
CHL,Chile,PHL,Philippines,2013,0,31,-31
CHL,Chile,PHL,Philippines,2014,0,44,-44
CHL,Chile,PHL,Philippines,2015,0,81,-81
CHL,Chile,PHL,Philippines,2016,0,76,-76
EST,Estonia,PHL,Philippines,2008,0,0,0
EST,Estonia,PHL,Philippines,2009,0,6,-6
EST,Estonia,PHL,Philippines,2010,0,3,-3
EST,Estonia,PHL,Philippines,2011,0,9,-9
EST,Estonia,PHL,Philippines,2012,0,2,-2
EST,Estonia,PHL,Philippines,2013,0,8,-8
EST,Estonia,PHL,Philippines,2014,0,9,-9
EST,Estonia,PHL,Philippines,2015,0,7,-7
EST,Estonia,PHL,Philippines,2016,0,16,-16
EST,Estonia,PHL,Philippines,2017,0,21,-21
SVN,Slovenia,PHL,Philippines,2009,0,37,-37
SVN,Slovenia,PHL,Philippines,2011,2,26,-24
SVN,Slovenia,PHL,Philippines,2012,1,5,-4
SVN,Slovenia,PHL,Philippines,2013,0,1,-1
SVN,Slovenia,PHL,Philippines,2014,1,7,-6
SVN,Slovenia,PHL,Philippines,2015,0,21,-21
SVN,Slovenia,PHL,Philippines,2016,0,5,-5
SVN,Slovenia,PHL,Philippines,2017,0,16,-16
ISL,Iceland,POL,Poland,2008,0,3890,-3890
NZL,New Zealand,POL,Poland,2008,0,44,-44
CHL,Chile,POL,Poland,2008,0,25,-25
AUS,Australia,PRT,Portugal,2008,0,182,-182
AUS,Australia,PRT,Portugal,2009,0,185,-185
AUS,Australia,PRT,Portugal,2010,0,226,-226
AUS,Australia,PRT,Portugal,2011,0,216,-216
AUS,Australia,PRT,Portugal,2012,0,279,-279
AUS,Australia,PRT,Portugal,2013,0,289,-289
AUS,Australia,PRT,Portugal,2014,0,322,-322
AUS,Australia,PRT,Portugal,2015,0,331,-331
AUS,Australia,PRT,Portugal,2016,0,283,-283
AUS,Australia,PRT,Portugal,2017,0,330,-330
AUT,Austria,PRT,Portugal,2008,0,349,-349
AUT,Austria,PRT,Portugal,2009,0,357,-357
AUT,Austria,PRT,Portugal,2010,0,444,-444
AUT,Austria,PRT,Portugal,2011,0,531,-531
AUT,Austria,PRT,Portugal,2012,0,693,-693
AUT,Austria,PRT,Portugal,2013,0,878,-878
AUT,Austria,PRT,Portugal,2014,0,581,-581
AUT,Austria,PRT,Portugal,2015,0,663,-663
AUT,Austria,PRT,Portugal,2016,0,561,-561
AUT,Austria,PRT,Portugal,2017,0,618,-618
BEL,Belgium,PRT,Portugal,2008,0,3200,-3200
BEL,Belgium,PRT,Portugal,2009,0,2854,-2854
BEL,Belgium,PRT,Portugal,2010,0,2717,-2717
BEL,Belgium,PRT,Portugal,2011,0,3140,-3140
BEL,Belgium,PRT,Portugal,2012,0,4228,-4228
BEL,Belgium,PRT,Portugal,2013,0,4332,-4332
BEL,Belgium,PRT,Portugal,2014,0,2993,-2993
BEL,Belgium,PRT,Portugal,2015,0,2927,-2927
BEL,Belgium,PRT,Portugal,2016,0,2863,-2863
BEL,Belgium,PRT,Portugal,2017,0,2691,-2691
CZE,Czech Republic,PRT,Portugal,2008,0,32,-32
CZE,Czech Republic,PRT,Portugal,2009,0,22,-22
CZE,Czech Republic,PRT,Portugal,2010,0,35,-35
CZE,Czech Republic,PRT,Portugal,2011,0,38,-38
CZE,Czech Republic,PRT,Portugal,2012,0,30,-30
CZE,Czech Republic,PRT,Portugal,2013,0,46,-46
CZE,Czech Republic,PRT,Portugal,2014,0,79,-79
CZE,Czech Republic,PRT,Portugal,2015,0,60,-60
CZE,Czech Republic,PRT,Portugal,2016,0,61,-61
CZE,Czech Republic,PRT,Portugal,2017,0,76,-76
DNK,Denmark,PRT,Portugal,2008,0,136,-136
DNK,Denmark,PRT,Portugal,2009,0,152,-152
DNK,Denmark,PRT,Portugal,2010,0,168,-168
DNK,Denmark,PRT,Portugal,2011,0,182,-182
DNK,Denmark,PRT,Portugal,2012,0,307,-307
DNK,Denmark,PRT,Portugal,2013,0,335,-335
DNK,Denmark,PRT,Portugal,2014,0,494,-494
DNK,Denmark,PRT,Portugal,2015,0,617,-617
DNK,Denmark,PRT,Portugal,2016,0,467,-467
DNK,Denmark,PRT,Portugal,2017,0,473,-473
FIN,Finland,PRT,Portugal,2008,0,56,-56
FIN,Finland,PRT,Portugal,2009,0,40,-40
FIN,Finland,PRT,Portugal,2010,0,41,-41
FIN,Finland,PRT,Portugal,2011,0,42,-42
FIN,Finland,PRT,Portugal,2012,0,83,-83
FIN,Finland,PRT,Portugal,2013,0,71,-71
FIN,Finland,PRT,Portugal,2014,0,108,-108
FIN,Finland,PRT,Portugal,2015,0,63,-63
FIN,Finland,PRT,Portugal,2016,0,65,-65
FIN,Finland,PRT,Portugal,2017,0,72,-72
HUN,Hungary,PRT,Portugal,2008,0,69,-69
HUN,Hungary,PRT,Portugal,2009,0,49,-49
HUN,Hungary,PRT,Portugal,2010,0,36,-36
HUN,Hungary,PRT,Portugal,2011,0,68,-68
HUN,Hungary,PRT,Portugal,2012,0,68,-68
HUN,Hungary,PRT,Portugal,2013,0,77,-77
HUN,Hungary,PRT,Portugal,2014,0,64,-64
HUN,Hungary,PRT,Portugal,2015,0,86,-86
HUN,Hungary,PRT,Portugal,2016,0,92,-92
HUN,Hungary,PRT,Portugal,2017,0,108,-108
ISL,Iceland,PRT,Portugal,2008,0,288,-288
ISL,Iceland,PRT,Portugal,2009,0,58,-58
ISL,Iceland,PRT,Portugal,2010,0,25,-25
ISL,Iceland,PRT,Portugal,2011,0,39,-39
ISL,Iceland,PRT,Portugal,2012,0,46,-46
ISL,Iceland,PRT,Portugal,2013,0,92,-92
ISL,Iceland,PRT,Portugal,2014,0,97,-97
ISL,Iceland,PRT,Portugal,2015,0,120,-120
ISL,Iceland,PRT,Portugal,2016,0,238,-238
ISL,Iceland,PRT,Portugal,2017,0,287,-287
JPN,Japan,PRT,Portugal,2008,0,120,-120
JPN,Japan,PRT,Portugal,2009,0,116,-116
JPN,Japan,PRT,Portugal,2010,0,129,-129
JPN,Japan,PRT,Portugal,2011,0,94,-94
JPN,Japan,PRT,Portugal,2012,0,129,-129
JPN,Japan,PRT,Portugal,2013,0,138,-138
JPN,Japan,PRT,Portugal,2014,0,132,-132
JPN,Japan,PRT,Portugal,2015,0,238,-238
JPN,Japan,PRT,Portugal,2016,0,248,-248
JPN,Japan,PRT,Portugal,2017,0,292,-292
KOR,Korea,PRT,Portugal,2008,0,25,-25
KOR,Korea,PRT,Portugal,2009,0,23,-23
KOR,Korea,PRT,Portugal,2010,0,30,-30
KOR,Korea,PRT,Portugal,2011,0,29,-29
KOR,Korea,PRT,Portugal,2012,0,50,-50
KOR,Korea,PRT,Portugal,2013,0,35,-35
KOR,Korea,PRT,Portugal,2014,0,37,-37
KOR,Korea,PRT,Portugal,2015,0,42,-42
KOR,Korea,PRT,Portugal,2016,0,34,-34
KOR,Korea,PRT,Portugal,2017,0,55,-55
LUX,Luxembourg,PRT,Portugal,2008,0,4531,-4531
LUX,Luxembourg,PRT,Portugal,2009,0,3844,-3844
LUX,Luxembourg,PRT,Portugal,2010,0,3845,-3845
LUX,Luxembourg,PRT,Portugal,2011,0,4977,-4977
LUX,Luxembourg,PRT,Portugal,2012,0,5193,-5193
LUX,Luxembourg,PRT,Portugal,2013,0,4590,-4590
LUX,Luxembourg,PRT,Portugal,2014,0,3832,-3832
LUX,Luxembourg,PRT,Portugal,2015,0,3525,-3525
LUX,Luxembourg,PRT,Portugal,2016,0,3355,-3355
LUX,Luxembourg,PRT,Portugal,2017,0,3342,-3342
MEX,Mexico,PRT,Portugal,2008,0,24,-24
MEX,Mexico,PRT,Portugal,2009,0,38,-38
MEX,Mexico,PRT,Portugal,2010,0,34,-34
MEX,Mexico,PRT,Portugal,2011,0,46,-46
MEX,Mexico,PRT,Portugal,2012,0,40,-40
MEX,Mexico,PRT,Portugal,2013,0,117,-117
MEX,Mexico,PRT,Portugal,2014,0,83,-83
MEX,Mexico,PRT,Portugal,2015,0,72,-72
MEX,Mexico,PRT,Portugal,2016,0,80,-80
MEX,Mexico,PRT,Portugal,2017,0,72,-72
NZL,New Zealand,PRT,Portugal,2008,0,23,-23
NZL,New Zealand,PRT,Portugal,2009,0,25,-25
NZL,New Zealand,PRT,Portugal,2010,0,20,-20
NZL,New Zealand,PRT,Portugal,2011,0,20,-20
NZL,New Zealand,PRT,Portugal,2012,0,47,-47
NZL,New Zealand,PRT,Portugal,2013,0,37,-37
NZL,New Zealand,PRT,Portugal,2014,0,55,-55
NZL,New Zealand,PRT,Portugal,2015,0,43,-43
NZL,New Zealand,PRT,Portugal,2016,0,43,-43
NZL,New Zealand,PRT,Portugal,2017,0,61,-61
NOR,Norway,PRT,Portugal,2008,0,271,-271
NOR,Norway,PRT,Portugal,2009,0,257,-257
NOR,Norway,PRT,Portugal,2010,0,284,-284
NOR,Norway,PRT,Portugal,2011,0,458,-458
NOR,Norway,PRT,Portugal,2012,0,582,-582
NOR,Norway,PRT,Portugal,2013,0,815,-815
NOR,Norway,PRT,Portugal,2014,0,653,-653
NOR,Norway,PRT,Portugal,2015,0,488,-488
NOR,Norway,PRT,Portugal,2016,0,427,-427
NOR,Norway,PRT,Portugal,2017,0,375,-375
POL,Poland,PRT,Portugal,2008,0,119,-119
POL,Poland,PRT,Portugal,2009,0,163,-163
POL,Poland,PRT,Portugal,2010,0,101,-101
POL,Poland,PRT,Portugal,2011,0,142,-142
POL,Poland,PRT,Portugal,2012,0,182,-182
POL,Poland,PRT,Portugal,2013,0,312,-312
POL,Poland,PRT,Portugal,2014,0,312,-312
POL,Poland,PRT,Portugal,2015,0,246,-246
POL,Poland,PRT,Portugal,2016,0,277,-277
POL,Poland,PRT,Portugal,2017,0,274,-274
SVK,Slovak Republic,PRT,Portugal,2008,0,17,-17
SVK,Slovak Republic,PRT,Portugal,2009,0,34,-34
SVK,Slovak Republic,PRT,Portugal,2010,0,13,-13
SVK,Slovak Republic,PRT,Portugal,2011,0,28,-28
SVK,Slovak Republic,PRT,Portugal,2012,0,16,-16
SVK,Slovak Republic,PRT,Portugal,2013,0,11,-11
SVK,Slovak Republic,PRT,Portugal,2014,0,12,-12
SVK,Slovak Republic,PRT,Portugal,2015,0,36,-36
SVK,Slovak Republic,PRT,Portugal,2016,0,19,-19
SVK,Slovak Republic,PRT,Portugal,2017,0,26,-26
SWE,Sweden,PRT,Portugal,2008,0,200,-200
SWE,Sweden,PRT,Portugal,2009,0,209,-209
SWE,Sweden,PRT,Portugal,2010,0,186,-186
SWE,Sweden,PRT,Portugal,2011,0,189,-189
SWE,Sweden,PRT,Portugal,2012,0,307,-307
SWE,Sweden,PRT,Portugal,2013,0,309,-309
SWE,Sweden,PRT,Portugal,2014,0,309,-309
SWE,Sweden,PRT,Portugal,2015,0,330,-330
SWE,Sweden,PRT,Portugal,2016,0,380,-380
SWE,Sweden,PRT,Portugal,2017,0,390,-390
CHE,Switzerland,PRT,Portugal,2008,0,17772,-17772
CHE,Switzerland,PRT,Portugal,2009,0,13670,-13670
CHE,Switzerland,PRT,Portugal,2010,0,12826,-12826
CHE,Switzerland,PRT,Portugal,2011,0,15358,-15358
CHE,Switzerland,PRT,Portugal,2012,0,18577,-18577
CHE,Switzerland,PRT,Portugal,2013,0,19925,-19925
CHE,Switzerland,PRT,Portugal,2014,0,14893,-14893
CHE,Switzerland,PRT,Portugal,2015,0,12617,-12617
CHE,Switzerland,PRT,Portugal,2016,0,10146,-10146
CHE,Switzerland,PRT,Portugal,2017,0,9231,-9231
TUR,Turkey,PRT,Portugal,2010,0,33,-33
TUR,Turkey,PRT,Portugal,2016,0,102,-102
TUR,Turkey,PRT,Portugal,2017,0,101,-101
CHL,Chile,PRT,Portugal,2008,0,26,-26
CHL,Chile,PRT,Portugal,2009,0,23,-23
CHL,Chile,PRT,Portugal,2010,0,41,-41
CHL,Chile,PRT,Portugal,2011,0,41,-41
CHL,Chile,PRT,Portugal,2012,0,129,-129
CHL,Chile,PRT,Portugal,2013,0,277,-277
CHL,Chile,PRT,Portugal,2014,0,220,-220
CHL,Chile,PRT,Portugal,2015,0,267,-267
CHL,Chile,PRT,Portugal,2016,0,208,-208
EST,Estonia,PRT,Portugal,2008,0,18,-18
EST,Estonia,PRT,Portugal,2009,0,13,-13
EST,Estonia,PRT,Portugal,2010,0,12,-12
EST,Estonia,PRT,Portugal,2011,0,1,-1
EST,Estonia,PRT,Portugal,2012,0,0,0
EST,Estonia,PRT,Portugal,2013,0,0,0
EST,Estonia,PRT,Portugal,2014,0,0,0
EST,Estonia,PRT,Portugal,2015,0,55,-55
EST,Estonia,PRT,Portugal,2016,0,47,-47
EST,Estonia,PRT,Portugal,2017,0,67,-67
SVN,Slovenia,PRT,Portugal,2008,0,760,-760
SVN,Slovenia,PRT,Portugal,2009,0,45,-45
SVN,Slovenia,PRT,Portugal,2010,0,1,-1
SVN,Slovenia,PRT,Portugal,2011,0,92,-92
SVN,Slovenia,PRT,Portugal,2012,0,122,-122
SVN,Slovenia,PRT,Portugal,2013,0,148,-148
SVN,Slovenia,PRT,Portugal,2014,0,115,-115
SVN,Slovenia,PRT,Portugal,2015,0,127,-127
SVN,Slovenia,PRT,Portugal,2016,0,145,-145
SVN,Slovenia,PRT,Portugal,2017,0,136,-136
AUS,Australia,PRI,Puerto Rico,2009,5,0,5
AUS,Australia,PRI,Puerto Rico,2010,0,0,0
AUS,Australia,PRI,Puerto Rico,2011,0,0,0
AUS,Australia,PRI,Puerto Rico,2012,0,0,0
AUS,Australia,PRI,Puerto Rico,2013,0,0,0
AUS,Australia,PRI,Puerto Rico,2014,0,0,0
AUS,Australia,PRI,Puerto Rico,2015,0,0,0
AUS,Australia,PRI,Puerto Rico,2016,0,0,0
AUS,Australia,PRI,Puerto Rico,2017,0,0,0
AUT,Austria,PRI,Puerto Rico,2014,0,0,0
AUT,Austria,PRI,Puerto Rico,2015,0,0,0
AUT,Austria,PRI,Puerto Rico,2016,0,0,0
AUT,Austria,PRI,Puerto Rico,2017,0,0,0
BEL,Belgium,PRI,Puerto Rico,2010,0,0,0
CAN,Canada,PRI,Puerto Rico,2008,0,6,-6
CAN,Canada,PRI,Puerto Rico,2009,0,5,-5
CAN,Canada,PRI,Puerto Rico,2010,0,10,-10
CAN,Canada,PRI,Puerto Rico,2011,0,10,-10
CAN,Canada,PRI,Puerto Rico,2012,0,5,-5
CAN,Canada,PRI,Puerto Rico,2013,0,0,0
CAN,Canada,PRI,Puerto Rico,2014,0,0,0
CAN,Canada,PRI,Puerto Rico,2015,0,0,0
CAN,Canada,PRI,Puerto Rico,2016,0,0,0
CAN,Canada,PRI,Puerto Rico,2017,0,0,0
DNK,Denmark,PRI,Puerto Rico,2015,0,0,0
DNK,Denmark,PRI,Puerto Rico,2016,0,0,0
FIN,Finland,PRI,Puerto Rico,2008,0,0,0
FIN,Finland,PRI,Puerto Rico,2009,0,0,0
FIN,Finland,PRI,Puerto Rico,2010,0,0,0
FIN,Finland,PRI,Puerto Rico,2011,0,0,0
FIN,Finland,PRI,Puerto Rico,2012,0,0,0
FIN,Finland,PRI,Puerto Rico,2013,0,0,0
FIN,Finland,PRI,Puerto Rico,2014,0,0,0
FIN,Finland,PRI,Puerto Rico,2015,0,0,0
FIN,Finland,PRI,Puerto Rico,2016,0,0,0
FIN,Finland,PRI,Puerto Rico,2017,0,0,0
FRA,France,PRI,Puerto Rico,2008,0,0,0
FRA,France,PRI,Puerto Rico,2009,0,0,0
FRA,France,PRI,Puerto Rico,2010,0,0,0
FRA,France,PRI,Puerto Rico,2011,0,0,0
FRA,France,PRI,Puerto Rico,2012,0,0,0
FRA,France,PRI,Puerto Rico,2013,0,0,0
FRA,France,PRI,Puerto Rico,2014,0,0,0
FRA,France,PRI,Puerto Rico,2015,0,0,0
FRA,France,PRI,Puerto Rico,2016,0,0,0
FRA,France,PRI,Puerto Rico,2017,0,0,0
HUN,Hungary,PRI,Puerto Rico,2008,0,0,0
HUN,Hungary,PRI,Puerto Rico,2009,0,0,0
HUN,Hungary,PRI,Puerto Rico,2010,0,0,0
HUN,Hungary,PRI,Puerto Rico,2011,0,0,0
HUN,Hungary,PRI,Puerto Rico,2012,0,0,0
HUN,Hungary,PRI,Puerto Rico,2013,0,0,0
HUN,Hungary,PRI,Puerto Rico,2014,0,0,0
HUN,Hungary,PRI,Puerto Rico,2015,0,0,0
HUN,Hungary,PRI,Puerto Rico,2016,0,0,0
HUN,Hungary,PRI,Puerto Rico,2017,0,0,0
ISL,Iceland,PRI,Puerto Rico,2008,0,0,0
ISL,Iceland,PRI,Puerto Rico,2009,0,0,0
ISL,Iceland,PRI,Puerto Rico,2010,0,0,0
ISL,Iceland,PRI,Puerto Rico,2011,0,0,0
ISL,Iceland,PRI,Puerto Rico,2012,0,0,0
ISL,Iceland,PRI,Puerto Rico,2013,0,0,0
ISL,Iceland,PRI,Puerto Rico,2014,0,0,0
ISL,Iceland,PRI,Puerto Rico,2015,0,0,0
ISL,Iceland,PRI,Puerto Rico,2016,0,0,0
ISL,Iceland,PRI,Puerto Rico,2017,0,0,0
JPN,Japan,PRI,Puerto Rico,2008,0,0,0
JPN,Japan,PRI,Puerto Rico,2009,0,0,0
JPN,Japan,PRI,Puerto Rico,2010,0,0,0
JPN,Japan,PRI,Puerto Rico,2011,0,0,0
JPN,Japan,PRI,Puerto Rico,2012,0,0,0
JPN,Japan,PRI,Puerto Rico,2013,0,0,0
JPN,Japan,PRI,Puerto Rico,2014,0,0,0
JPN,Japan,PRI,Puerto Rico,2015,0,0,0
JPN,Japan,PRI,Puerto Rico,2016,0,0,0
JPN,Japan,PRI,Puerto Rico,2017,0,0,0
KOR,Korea,PRI,Puerto Rico,2008,0,0,0
KOR,Korea,PRI,Puerto Rico,2009,0,0,0
KOR,Korea,PRI,Puerto Rico,2010,0,0,0
KOR,Korea,PRI,Puerto Rico,2011,0,0,0
KOR,Korea,PRI,Puerto Rico,2012,0,0,0
KOR,Korea,PRI,Puerto Rico,2013,0,0,0
KOR,Korea,PRI,Puerto Rico,2014,0,0,0
KOR,Korea,PRI,Puerto Rico,2015,0,0,0
KOR,Korea,PRI,Puerto Rico,2016,0,0,0
KOR,Korea,PRI,Puerto Rico,2017,0,0,0
LUX,Luxembourg,PRI,Puerto Rico,2008,0,0,0
LUX,Luxembourg,PRI,Puerto Rico,2009,0,0,0
LUX,Luxembourg,PRI,Puerto Rico,2010,0,0,0
LUX,Luxembourg,PRI,Puerto Rico,2011,0,0,0
LUX,Luxembourg,PRI,Puerto Rico,2012,0,0,0
LUX,Luxembourg,PRI,Puerto Rico,2013,0,0,0
LUX,Luxembourg,PRI,Puerto Rico,2014,0,0,0
LUX,Luxembourg,PRI,Puerto Rico,2015,0,0,0
LUX,Luxembourg,PRI,Puerto Rico,2016,0,0,0
LUX,Luxembourg,PRI,Puerto Rico,2017,0,0,0
MEX,Mexico,PRI,Puerto Rico,2012,0,0,0
MEX,Mexico,PRI,Puerto Rico,2013,0,0,0
MEX,Mexico,PRI,Puerto Rico,2014,0,0,0
NOR,Norway,PRI,Puerto Rico,2008,0,0,0
NOR,Norway,PRI,Puerto Rico,2009,0,0,0
NOR,Norway,PRI,Puerto Rico,2010,0,0,0
NOR,Norway,PRI,Puerto Rico,2011,0,0,0
NOR,Norway,PRI,Puerto Rico,2012,0,0,0
NOR,Norway,PRI,Puerto Rico,2013,0,0,0
NOR,Norway,PRI,Puerto Rico,2014,0,0,0
NOR,Norway,PRI,Puerto Rico,2015,0,0,0
NOR,Norway,PRI,Puerto Rico,2016,0,1,-1
NOR,Norway,PRI,Puerto Rico,2017,0,0,0
POL,Poland,PRI,Puerto Rico,2009,0,0,0
POL,Poland,PRI,Puerto Rico,2010,0,0,0
POL,Poland,PRI,Puerto Rico,2011,0,0,0
POL,Poland,PRI,Puerto Rico,2012,0,0,0
POL,Poland,PRI,Puerto Rico,2013,0,0,0
POL,Poland,PRI,Puerto Rico,2014,0,0,0
POL,Poland,PRI,Puerto Rico,2015,0,0,0
POL,Poland,PRI,Puerto Rico,2016,0,0,0
POL,Poland,PRI,Puerto Rico,2017,0,0,0
ESP,Spain,PRI,Puerto Rico,2008,0,0,0
ESP,Spain,PRI,Puerto Rico,2009,0,0,0
ESP,Spain,PRI,Puerto Rico,2010,0,0,0
ESP,Spain,PRI,Puerto Rico,2011,0,0,0
ESP,Spain,PRI,Puerto Rico,2012,0,0,0
ESP,Spain,PRI,Puerto Rico,2013,0,0,0
SWE,Sweden,PRI,Puerto Rico,2008,0,0,0
SWE,Sweden,PRI,Puerto Rico,2009,0,0,0
SWE,Sweden,PRI,Puerto Rico,2010,0,0,0
SWE,Sweden,PRI,Puerto Rico,2011,0,0,0
SWE,Sweden,PRI,Puerto Rico,2012,0,0,0
SWE,Sweden,PRI,Puerto Rico,2013,0,0,0
SWE,Sweden,PRI,Puerto Rico,2014,0,0,0
SWE,Sweden,PRI,Puerto Rico,2015,0,0,0
USA,United States,PRI,Puerto Rico,2017,0,6,-6
CHL,Chile,PRI,Puerto Rico,2008,0,0,0
CHL,Chile,PRI,Puerto Rico,2009,0,0,0
CHL,Chile,PRI,Puerto Rico,2010,0,0,0
CHL,Chile,PRI,Puerto Rico,2011,0,0,0
CHL,Chile,PRI,Puerto Rico,2012,0,1,-1
CHL,Chile,PRI,Puerto Rico,2013,0,0,0
CHL,Chile,PRI,Puerto Rico,2014,0,0,0
CHL,Chile,PRI,Puerto Rico,2015,0,1,-1
CHL,Chile,PRI,Puerto Rico,2016,0,0,0
EST,Estonia,PRI,Puerto Rico,2017,0,0,0
AUS,Australia,QAT,Qatar,2008,13,1,12
AUS,Australia,QAT,Qatar,2009,10,1,9
AUS,Australia,QAT,Qatar,2010,9,2,7
AUS,Australia,QAT,Qatar,2011,11,0,11
AUS,Australia,QAT,Qatar,2012,10,1,9
AUS,Australia,QAT,Qatar,2013,10,1,9
AUS,Australia,QAT,Qatar,2014,14,0,14
AUS,Australia,QAT,Qatar,2015,0,5,-5
AUS,Australia,QAT,Qatar,2017,0,3,-3
AUT,Austria,QAT,Qatar,2008,0,0,0
AUT,Austria,QAT,Qatar,2009,1,2,-1
AUT,Austria,QAT,Qatar,2010,1,0,1
AUT,Austria,QAT,Qatar,2011,1,0,1
AUT,Austria,QAT,Qatar,2012,0,1,-1
AUT,Austria,QAT,Qatar,2013,0,1,-1
AUT,Austria,QAT,Qatar,2014,1,3,-2
AUT,Austria,QAT,Qatar,2015,0,7,-7
AUT,Austria,QAT,Qatar,2016,6,11,-5
AUT,Austria,QAT,Qatar,2017,2,5,-3
BEL,Belgium,QAT,Qatar,2009,0,0,0
BEL,Belgium,QAT,Qatar,2010,0,1,-1
BEL,Belgium,QAT,Qatar,2013,0,4,-4
BEL,Belgium,QAT,Qatar,2014,1,2,-1
BEL,Belgium,QAT,Qatar,2015,2,1,1
BEL,Belgium,QAT,Qatar,2016,2,4,-2
BEL,Belgium,QAT,Qatar,2017,2,4,-2
CAN,Canada,QAT,Qatar,2008,0,9,-9
CAN,Canada,QAT,Qatar,2009,0,6,-6
CAN,Canada,QAT,Qatar,2010,0,18,-18
CAN,Canada,QAT,Qatar,2011,0,3,-3
CAN,Canada,QAT,Qatar,2012,0,14,-14
CAN,Canada,QAT,Qatar,2013,0,6,-6
CAN,Canada,QAT,Qatar,2014,0,9,-9
CAN,Canada,QAT,Qatar,2015,0,0,0
CAN,Canada,QAT,Qatar,2016,0,0,0
CAN,Canada,QAT,Qatar,2017,0,0,0
CZE,Czech Republic,QAT,Qatar,2008,0,3,-3
CZE,Czech Republic,QAT,Qatar,2009,0,1,-1
CZE,Czech Republic,QAT,Qatar,2010,0,2,-2
DNK,Denmark,QAT,Qatar,2010,0,3,-3
DNK,Denmark,QAT,Qatar,2012,0,1,-1
DNK,Denmark,QAT,Qatar,2013,1,0,1
DNK,Denmark,QAT,Qatar,2014,0,1,-1
DNK,Denmark,QAT,Qatar,2015,0,1,-1
DNK,Denmark,QAT,Qatar,2016,7,0,7
DNK,Denmark,QAT,Qatar,2017,2,2,0
FIN,Finland,QAT,Qatar,2008,0,0,0
FIN,Finland,QAT,Qatar,2009,0,0,0
FIN,Finland,QAT,Qatar,2010,0,0,0
FIN,Finland,QAT,Qatar,2011,0,0,0
FIN,Finland,QAT,Qatar,2012,0,0,0
FIN,Finland,QAT,Qatar,2013,0,0,0
FIN,Finland,QAT,Qatar,2014,0,0,0
FIN,Finland,QAT,Qatar,2015,0,0,0
FIN,Finland,QAT,Qatar,2016,0,0,0
FIN,Finland,QAT,Qatar,2017,0,0,0
FRA,France,QAT,Qatar,2008,0,7,-7
FRA,France,QAT,Qatar,2009,0,4,-4
FRA,France,QAT,Qatar,2010,0,39,-39
FRA,France,QAT,Qatar,2011,0,4,-4
FRA,France,QAT,Qatar,2012,0,13,-13
FRA,France,QAT,Qatar,2013,0,5,-5
FRA,France,QAT,Qatar,2014,0,9,-9
FRA,France,QAT,Qatar,2015,0,1,-1
FRA,France,QAT,Qatar,2016,0,3,-3
FRA,France,QAT,Qatar,2017,0,3,-3
DEU,Germany,QAT,Qatar,2008,84,82,2
DEU,Germany,QAT,Qatar,2009,69,119,-50
DEU,Germany,QAT,Qatar,2010,139,167,-28
DEU,Germany,QAT,Qatar,2011,153,121,32
DEU,Germany,QAT,Qatar,2012,105,189,-84
DEU,Germany,QAT,Qatar,2013,200,354,-154
DEU,Germany,QAT,Qatar,2014,247,365,-118
DEU,Germany,QAT,Qatar,2015,314,307,7
DEU,Germany,QAT,Qatar,2016,400,574,-174
DEU,Germany,QAT,Qatar,2017,449,459,-10
HUN,Hungary,QAT,Qatar,2008,0,0,0
HUN,Hungary,QAT,Qatar,2009,0,4,-4
HUN,Hungary,QAT,Qatar,2010,0,7,-7
HUN,Hungary,QAT,Qatar,2011,4,0,4
HUN,Hungary,QAT,Qatar,2012,0,9,-9
HUN,Hungary,QAT,Qatar,2013,0,3,-3
HUN,Hungary,QAT,Qatar,2014,0,0,0
HUN,Hungary,QAT,Qatar,2015,2,6,-4
HUN,Hungary,QAT,Qatar,2016,9,15,-6
HUN,Hungary,QAT,Qatar,2017,0,8,-8
ISL,Iceland,QAT,Qatar,2008,0,0,0
ISL,Iceland,QAT,Qatar,2009,0,0,0
ISL,Iceland,QAT,Qatar,2010,0,0,0
ISL,Iceland,QAT,Qatar,2011,1,0,1
ISL,Iceland,QAT,Qatar,2012,0,0,0
ISL,Iceland,QAT,Qatar,2016,0,0,0
ISL,Iceland,QAT,Qatar,2017,0,0,0
ITA,Italy,QAT,Qatar,2008,1,8,-7
ITA,Italy,QAT,Qatar,2009,1,1,0
ITA,Italy,QAT,Qatar,2010,0,1,-1
ITA,Italy,QAT,Qatar,2011,0,4,-4
ITA,Italy,QAT,Qatar,2012,0,0,0
ITA,Italy,QAT,Qatar,2013,4,2,2
ITA,Italy,QAT,Qatar,2014,0,1,-1
ITA,Italy,QAT,Qatar,2015,0,2,-2
ITA,Italy,QAT,Qatar,2016,0,3,-3
JPN,Japan,QAT,Qatar,2008,41,42,-1
JPN,Japan,QAT,Qatar,2009,106,97,9
JPN,Japan,QAT,Qatar,2010,30,30,0
JPN,Japan,QAT,Qatar,2011,77,107,-30
JPN,Japan,QAT,Qatar,2012,162,150,12
JPN,Japan,QAT,Qatar,2013,139,151,-12
JPN,Japan,QAT,Qatar,2014,122,126,-4
JPN,Japan,QAT,Qatar,2015,254,260,-6
JPN,Japan,QAT,Qatar,2016,68,72,-4
JPN,Japan,QAT,Qatar,2017,61,62,-1
KOR,Korea,QAT,Qatar,2008,10,12,-2
KOR,Korea,QAT,Qatar,2009,7,6,1
KOR,Korea,QAT,Qatar,2010,5,3,2
KOR,Korea,QAT,Qatar,2011,2,1,1
KOR,Korea,QAT,Qatar,2012,23,16,7
KOR,Korea,QAT,Qatar,2013,6,1,5
KOR,Korea,QAT,Qatar,2014,6,7,-1
KOR,Korea,QAT,Qatar,2015,6,4,2
KOR,Korea,QAT,Qatar,2016,12,7,5
KOR,Korea,QAT,Qatar,2017,3,3,0
LUX,Luxembourg,QAT,Qatar,2008,0,0,0
LUX,Luxembourg,QAT,Qatar,2009,0,0,0
LUX,Luxembourg,QAT,Qatar,2010,0,0,0
LUX,Luxembourg,QAT,Qatar,2011,0,0,0
LUX,Luxembourg,QAT,Qatar,2012,0,0,0
LUX,Luxembourg,QAT,Qatar,2013,0,0,0
LUX,Luxembourg,QAT,Qatar,2014,0,0,0
LUX,Luxembourg,QAT,Qatar,2015,0,1,-1
LUX,Luxembourg,QAT,Qatar,2016,0,0,0
LUX,Luxembourg,QAT,Qatar,2017,0,0,0
MEX,Mexico,QAT,Qatar,2012,0,0,0
MEX,Mexico,QAT,Qatar,2013,0,0,0
MEX,Mexico,QAT,Qatar,2014,0,0,0
NLD,Netherlands,QAT,Qatar,2009,3,2,1
NLD,Netherlands,QAT,Qatar,2010,1,3,-2
NLD,Netherlands,QAT,Qatar,2011,3,5,-2
NLD,Netherlands,QAT,Qatar,2012,2,4,-2
NLD,Netherlands,QAT,Qatar,2013,5,11,-6
NLD,Netherlands,QAT,Qatar,2014,6,9,-3
NLD,Netherlands,QAT,Qatar,2015,12,26,-14
NLD,Netherlands,QAT,Qatar,2016,20,10,10
NLD,Netherlands,QAT,Qatar,2017,16,5,11
NZL,New Zealand,QAT,Qatar,2009,0,5,-5
NZL,New Zealand,QAT,Qatar,2012,0,4,-4
NZL,New Zealand,QAT,Qatar,2014,0,1,-1
NZL,New Zealand,QAT,Qatar,2015,0,2,-2
NZL,New Zealand,QAT,Qatar,2017,0,1,-1
NOR,Norway,QAT,Qatar,2008,0,0,0
NOR,Norway,QAT,Qatar,2009,0,4,-4
NOR,Norway,QAT,Qatar,2010,1,0,1
NOR,Norway,QAT,Qatar,2011,0,1,-1
NOR,Norway,QAT,Qatar,2012,0,0,0
NOR,Norway,QAT,Qatar,2013,0,0,0
NOR,Norway,QAT,Qatar,2014,1,0,1
NOR,Norway,QAT,Qatar,2015,0,1,-1
NOR,Norway,QAT,Qatar,2016,0,0,0
NOR,Norway,QAT,Qatar,2017,1,0,1
POL,Poland,QAT,Qatar,2009,0,0,0
POL,Poland,QAT,Qatar,2010,0,0,0
POL,Poland,QAT,Qatar,2011,0,0,0
POL,Poland,QAT,Qatar,2012,0,0,0
POL,Poland,QAT,Qatar,2013,0,0,0
POL,Poland,QAT,Qatar,2014,0,0,0
POL,Poland,QAT,Qatar,2015,0,0,0
POL,Poland,QAT,Qatar,2016,0,10,-10
POL,Poland,QAT,Qatar,2017,0,10,-10
SVK,Slovak Republic,QAT,Qatar,2008,0,0,0
ESP,Spain,QAT,Qatar,2008,3,2,1
ESP,Spain,QAT,Qatar,2009,1,3,-2
ESP,Spain,QAT,Qatar,2010,1,3,-2
ESP,Spain,QAT,Qatar,2011,1,2,-1
ESP,Spain,QAT,Qatar,2012,0,2,-2
ESP,Spain,QAT,Qatar,2013,0,2,-2
ESP,Spain,QAT,Qatar,2014,1,12,-11
ESP,Spain,QAT,Qatar,2015,2,19,-17
ESP,Spain,QAT,Qatar,2016,6,22,-16
ESP,Spain,QAT,Qatar,2017,7,12,-5
SWE,Sweden,QAT,Qatar,2008,0,2,-2
SWE,Sweden,QAT,Qatar,2009,1,1,0
SWE,Sweden,QAT,Qatar,2010,11,1,10
SWE,Sweden,QAT,Qatar,2011,1,2,-1
SWE,Sweden,QAT,Qatar,2012,3,1,2
SWE,Sweden,QAT,Qatar,2013,1,1,0
SWE,Sweden,QAT,Qatar,2014,1,0,1
SWE,Sweden,QAT,Qatar,2015,3,2,1
SWE,Sweden,QAT,Qatar,2016,0,0,0
SWE,Sweden,QAT,Qatar,2017,1,1,0
CHE,Switzerland,QAT,Qatar,2010,3,3,0
CHE,Switzerland,QAT,Qatar,2011,3,10,-7
CHE,Switzerland,QAT,Qatar,2012,4,1,3
CHE,Switzerland,QAT,Qatar,2013,1,7,-6
CHE,Switzerland,QAT,Qatar,2014,2,0,2
CHE,Switzerland,QAT,Qatar,2015,1,5,-4
CHE,Switzerland,QAT,Qatar,2016,18,4,14
CHE,Switzerland,QAT,Qatar,2017,3,7,-4
TUR,Turkey,QAT,Qatar,2010,0,1,-1
GBR,United Kingdom,QAT,Qatar,2014,0,1000,-1000
USA,United States,QAT,Qatar,2008,0,151,-151
USA,United States,QAT,Qatar,2009,0,134,-134
USA,United States,QAT,Qatar,2010,0,148,-148
USA,United States,QAT,Qatar,2011,0,193,-193
USA,United States,QAT,Qatar,2012,0,141,-141
USA,United States,QAT,Qatar,2013,0,191,-191
USA,United States,QAT,Qatar,2014,0,202,-202
USA,United States,QAT,Qatar,2015,0,229,-229
USA,United States,QAT,Qatar,2016,0,272,-272
USA,United States,QAT,Qatar,2017,0,224,-224
CHL,Chile,QAT,Qatar,2008,0,0,0
CHL,Chile,QAT,Qatar,2009,0,0,0
CHL,Chile,QAT,Qatar,2010,0,0,0
CHL,Chile,QAT,Qatar,2011,0,0,0
CHL,Chile,QAT,Qatar,2012,0,0,0
CHL,Chile,QAT,Qatar,2013,0,0,0
CHL,Chile,QAT,Qatar,2014,0,0,0
CHL,Chile,QAT,Qatar,2015,0,0,0
CHL,Chile,QAT,Qatar,2016,0,0,0
EST,Estonia,QAT,Qatar,2008,0,0,0
EST,Estonia,QAT,Qatar,2009,0,0,0
EST,Estonia,QAT,Qatar,2010,0,0,0
EST,Estonia,QAT,Qatar,2011,0,0,0
EST,Estonia,QAT,Qatar,2012,0,0,0
EST,Estonia,QAT,Qatar,2013,0,0,0
EST,Estonia,QAT,Qatar,2014,0,0,0
EST,Estonia,QAT,Qatar,2015,0,0,0
EST,Estonia,QAT,Qatar,2016,0,0,0
EST,Estonia,QAT,Qatar,2017,0,0,0
AUS,Australia,ROU,Romania,2008,106,303,-197
AUS,Australia,ROU,Romania,2009,101,300,-199
AUS,Australia,ROU,Romania,2010,115,294,-179
AUS,Australia,ROU,Romania,2011,89,247,-158
AUS,Australia,ROU,Romania,2012,94,300,-206
AUS,Australia,ROU,Romania,2013,109,305,-196
AUS,Australia,ROU,Romania,2014,139,310,-171
AUS,Australia,ROU,Romania,2015,100,297,-197
AUS,Australia,ROU,Romania,2016,100,271,-171
AUS,Australia,ROU,Romania,2017,0,206,-206
AUT,Austria,ROU,Romania,2008,4718,9234,-4516
AUT,Austria,ROU,Romania,2009,5827,9319,-3492
AUT,Austria,ROU,Romania,2010,6358,11344,-4986
AUT,Austria,ROU,Romania,2011,7707,12907,-5200
AUT,Austria,ROU,Romania,2012,8004,13362,-5358
AUT,Austria,ROU,Romania,2013,7791,13491,-5700
AUT,Austria,ROU,Romania,2014,8005,20715,-12710
AUT,Austria,ROU,Romania,2015,9205,17455,-8250
AUT,Austria,ROU,Romania,2016,9134,16665,-7531
AUT,Austria,ROU,Romania,2017,9447,17863,-8416
BEL,Belgium,ROU,Romania,2008,879,6779,-5900
BEL,Belgium,ROU,Romania,2009,1392,6066,-4674
BEL,Belgium,ROU,Romania,2010,1831,8020,-6189
BEL,Belgium,ROU,Romania,2011,2710,10889,-8179
BEL,Belgium,ROU,Romania,2012,3241,11216,-7975
BEL,Belgium,ROU,Romania,2013,4258,10046,-5788
BEL,Belgium,ROU,Romania,2014,3243,11345,-8102
BEL,Belgium,ROU,Romania,2015,3303,10627,-7324
BEL,Belgium,ROU,Romania,2016,3025,10301,-7276
BEL,Belgium,ROU,Romania,2017,3114,11569,-8455
CAN,Canada,ROU,Romania,2008,0,2836,-2836
CAN,Canada,ROU,Romania,2009,0,2076,-2076
CAN,Canada,ROU,Romania,2010,0,1922,-1922
CAN,Canada,ROU,Romania,2011,0,1776,-1776
CAN,Canada,ROU,Romania,2012,0,1588,-1588
CAN,Canada,ROU,Romania,2013,0,1512,-1512
CAN,Canada,ROU,Romania,2014,0,1553,-1553
CAN,Canada,ROU,Romania,2015,0,1183,-1183
CAN,Canada,ROU,Romania,2016,0,1360,-1360
CAN,Canada,ROU,Romania,2017,0,975,-975
CZE,Czech Republic,ROU,Romania,2008,112,634,-522
CZE,Czech Republic,ROU,Romania,2009,47,460,-413
CZE,Czech Republic,ROU,Romania,2010,103,432,-329
CZE,Czech Republic,ROU,Romania,2011,19,437,-418
CZE,Czech Republic,ROU,Romania,2012,54,661,-607
CZE,Czech Republic,ROU,Romania,2013,66,931,-865
CZE,Czech Republic,ROU,Romania,2014,140,1231,-1091
CZE,Czech Republic,ROU,Romania,2015,96,1334,-1238
CZE,Czech Republic,ROU,Romania,2016,121,1648,-1527
CZE,Czech Republic,ROU,Romania,2017,227,1829,-1602
DNK,Denmark,ROU,Romania,2008,287,1390,-1103
DNK,Denmark,ROU,Romania,2009,475,1484,-1009
DNK,Denmark,ROU,Romania,2010,556,2027,-1471
DNK,Denmark,ROU,Romania,2011,702,2725,-2023
DNK,Denmark,ROU,Romania,2012,1093,3239,-2146
DNK,Denmark,ROU,Romania,2013,1401,3587,-2186
DNK,Denmark,ROU,Romania,2014,1705,4200,-2495
DNK,Denmark,ROU,Romania,2015,1890,4306,-2416
DNK,Denmark,ROU,Romania,2016,2535,4185,-1650
DNK,Denmark,ROU,Romania,2017,3064,4109,-1045
FIN,Finland,ROU,Romania,2008,66,197,-131
FIN,Finland,ROU,Romania,2009,41,164,-123
FIN,Finland,ROU,Romania,2010,26,206,-180
FIN,Finland,ROU,Romania,2011,28,258,-230
FIN,Finland,ROU,Romania,2012,63,302,-239
FIN,Finland,ROU,Romania,2013,47,257,-210
FIN,Finland,ROU,Romania,2014,51,400,-349
FIN,Finland,ROU,Romania,2015,40,355,-315
FIN,Finland,ROU,Romania,2016,72,440,-368
FIN,Finland,ROU,Romania,2017,56,413,-357
FRA,France,ROU,Romania,2008,0,0,0
FRA,France,ROU,Romania,2009,0,0,0
FRA,France,ROU,Romania,2010,0,0,0
FRA,France,ROU,Romania,2011,0,0,0
FRA,France,ROU,Romania,2012,0,0,0
FRA,France,ROU,Romania,2013,0,6108,-6108
FRA,France,ROU,Romania,2014,0,8056,-8056
FRA,France,ROU,Romania,2015,0,10059,-10059
FRA,France,ROU,Romania,2016,0,8547,-8547
FRA,France,ROU,Romania,2017,0,8071,-8071
DEU,Germany,ROU,Romania,2008,37778,48225,-10447
DEU,Germany,ROU,Romania,2009,44305,57273,-12968
DEU,Germany,ROU,Romania,2010,48943,75531,-26588
DEU,Germany,ROU,Romania,2011,59821,97518,-37697
DEU,Germany,ROU,Romania,2012,71715,120524,-48809
DEU,Germany,ROU,Romania,2013,86742,139487,-52745
DEU,Germany,ROU,Romania,2014,118346,198705,-80359
DEU,Germany,ROU,Romania,2015,129059,221405,-92346
DEU,Germany,ROU,Romania,2016,162209,222298,-60089
DEU,Germany,ROU,Romania,2017,157415,230603,-73188
HUN,Hungary,ROU,Romania,2008,1718,9987,-8269
HUN,Hungary,ROU,Romania,2009,1602,7104,-5502
HUN,Hungary,ROU,Romania,2010,1132,6581,-5449
HUN,Hungary,ROU,Romania,2011,168,5804,-5636
HUN,Hungary,ROU,Romania,2012,4245,4243,2
HUN,Hungary,ROU,Romania,2013,6056,4039,2017
HUN,Hungary,ROU,Romania,2014,3516,3675,-159
HUN,Hungary,ROU,Romania,2015,2519,3494,-975
HUN,Hungary,ROU,Romania,2016,2576,3090,-514
HUN,Hungary,ROU,Romania,2017,2401,2934,-533
ISL,Iceland,ROU,Romania,2008,25,53,-28
ISL,Iceland,ROU,Romania,2009,54,36,18
ISL,Iceland,ROU,Romania,2010,19,23,-4
ISL,Iceland,ROU,Romania,2011,9,19,-10
ISL,Iceland,ROU,Romania,2012,7,62,-55
ISL,Iceland,ROU,Romania,2013,22,60,-38
ISL,Iceland,ROU,Romania,2014,24,115,-91
ISL,Iceland,ROU,Romania,2015,32,163,-131
ISL,Iceland,ROU,Romania,2016,65,257,-192
ISL,Iceland,ROU,Romania,2017,84,485,-401
ITA,Italy,ROU,Romania,2008,8308,174554,-166246
ITA,Italy,ROU,Romania,2009,9924,105597,-95673
ITA,Italy,ROU,Romania,2010,7488,92116,-84628
ITA,Italy,ROU,Romania,2011,7693,90096,-82403
ITA,Italy,ROU,Romania,2012,9131,81666,-72535
ITA,Italy,ROU,Romania,2013,11014,58227,-47213
ITA,Italy,ROU,Romania,2014,13518,50705,-37187
ITA,Italy,ROU,Romania,2015,12914,46439,-33525
ITA,Italy,ROU,Romania,2016,0,45238,-45238
ITA,Italy,ROU,Romania,2017,12220,43485,-31265
JPN,Japan,ROU,Romania,2008,395,381,14
JPN,Japan,ROU,Romania,2009,366,391,-25
JPN,Japan,ROU,Romania,2010,356,367,-11
JPN,Japan,ROU,Romania,2011,217,221,-4
JPN,Japan,ROU,Romania,2012,277,294,-17
JPN,Japan,ROU,Romania,2013,257,292,-35
JPN,Japan,ROU,Romania,2014,250,269,-19
JPN,Japan,ROU,Romania,2015,323,497,-174
JPN,Japan,ROU,Romania,2016,266,412,-146
JPN,Japan,ROU,Romania,2017,358,370,-12
KOR,Korea,ROU,Romania,2008,282,200,82
KOR,Korea,ROU,Romania,2009,146,96,50
KOR,Korea,ROU,Romania,2010,103,93,10
KOR,Korea,ROU,Romania,2011,114,117,-3
KOR,Korea,ROU,Romania,2012,129,131,-2
KOR,Korea,ROU,Romania,2013,118,131,-13
KOR,Korea,ROU,Romania,2014,127,119,8
KOR,Korea,ROU,Romania,2015,125,100,25
KOR,Korea,ROU,Romania,2016,105,100,5
KOR,Korea,ROU,Romania,2017,130,89,41
LUX,Luxembourg,ROU,Romania,2008,66,277,-211
LUX,Luxembourg,ROU,Romania,2009,67,238,-171
LUX,Luxembourg,ROU,Romania,2010,75,317,-242
LUX,Luxembourg,ROU,Romania,2011,103,453,-350
LUX,Luxembourg,ROU,Romania,2012,130,409,-279
LUX,Luxembourg,ROU,Romania,2013,149,402,-253
LUX,Luxembourg,ROU,Romania,2014,88,755,-667
LUX,Luxembourg,ROU,Romania,2015,158,726,-568
LUX,Luxembourg,ROU,Romania,2016,306,642,-336
LUX,Luxembourg,ROU,Romania,2017,198,717,-519
MEX,Mexico,ROU,Romania,2008,0,28,-28
MEX,Mexico,ROU,Romania,2009,0,39,-39
MEX,Mexico,ROU,Romania,2010,0,46,-46
MEX,Mexico,ROU,Romania,2011,0,47,-47
MEX,Mexico,ROU,Romania,2012,0,45,-45
MEX,Mexico,ROU,Romania,2013,0,121,-121
MEX,Mexico,ROU,Romania,2014,0,77,-77
MEX,Mexico,ROU,Romania,2015,0,86,-86
MEX,Mexico,ROU,Romania,2016,0,83,-83
MEX,Mexico,ROU,Romania,2017,0,59,-59
NLD,Netherlands,ROU,Romania,2008,1004,2411,-1407
NLD,Netherlands,ROU,Romania,2009,1233,2167,-934
NLD,Netherlands,ROU,Romania,2010,1388,2627,-1239
NLD,Netherlands,ROU,Romania,2011,1825,2743,-918
NLD,Netherlands,ROU,Romania,2012,1972,2535,-563
NLD,Netherlands,ROU,Romania,2013,1893,2521,-628
NLD,Netherlands,ROU,Romania,2014,2420,4553,-2133
NLD,Netherlands,ROU,Romania,2015,2548,4287,-1739
NLD,Netherlands,ROU,Romania,2016,2783,5190,-2407
NLD,Netherlands,ROU,Romania,2017,3580,7544,-3964
NZL,New Zealand,ROU,Romania,2008,57,39,18
NZL,New Zealand,ROU,Romania,2009,32,30,2
NZL,New Zealand,ROU,Romania,2010,27,42,-15
NZL,New Zealand,ROU,Romania,2011,23,41,-18
NZL,New Zealand,ROU,Romania,2012,17,54,-37
NZL,New Zealand,ROU,Romania,2013,20,60,-40
NZL,New Zealand,ROU,Romania,2014,15,66,-51
NZL,New Zealand,ROU,Romania,2015,19,32,-13
NZL,New Zealand,ROU,Romania,2016,20,41,-21
NZL,New Zealand,ROU,Romania,2017,16,36,-20
NOR,Norway,ROU,Romania,2008,73,1104,-1031
NOR,Norway,ROU,Romania,2009,184,1142,-958
NOR,Norway,ROU,Romania,2010,285,1322,-1037
NOR,Norway,ROU,Romania,2011,315,1424,-1109
NOR,Norway,ROU,Romania,2012,300,2020,-1720
NOR,Norway,ROU,Romania,2013,236,2544,-2308
NOR,Norway,ROU,Romania,2014,237,2148,-1911
NOR,Norway,ROU,Romania,2015,324,1933,-1609
NOR,Norway,ROU,Romania,2016,720,1235,-515
NOR,Norway,ROU,Romania,2017,877,1202,-325
POL,Poland,ROU,Romania,2008,0,185,-185
POL,Poland,ROU,Romania,2009,0,176,-176
POL,Poland,ROU,Romania,2010,0,168,-168
POL,Poland,ROU,Romania,2011,0,283,-283
POL,Poland,ROU,Romania,2012,0,368,-368
POL,Poland,ROU,Romania,2013,0,340,-340
POL,Poland,ROU,Romania,2014,0,340,-340
POL,Poland,ROU,Romania,2015,0,562,-562
POL,Poland,ROU,Romania,2016,0,634,-634
POL,Poland,ROU,Romania,2017,0,661,-661
PRT,Portugal,ROU,Romania,2008,0,5252,-5252
PRT,Portugal,ROU,Romania,2009,0,8111,-8111
PRT,Portugal,ROU,Romania,2010,0,6047,-6047
PRT,Portugal,ROU,Romania,2011,0,4582,-4582
PRT,Portugal,ROU,Romania,2012,0,3010,-3010
PRT,Portugal,ROU,Romania,2013,0,2665,-2665
PRT,Portugal,ROU,Romania,2014,0,2455,-2455
PRT,Portugal,ROU,Romania,2015,0,2569,-2569
PRT,Portugal,ROU,Romania,2016,0,2479,-2479
PRT,Portugal,ROU,Romania,2017,0,2421,-2421
SVK,Slovak Republic,ROU,Romania,2008,25,2122,-2097
SVK,Slovak Republic,ROU,Romania,2009,46,579,-533
SVK,Slovak Republic,ROU,Romania,2010,14,412,-398
SVK,Slovak Republic,ROU,Romania,2011,13,458,-445
SVK,Slovak Republic,ROU,Romania,2012,12,275,-263
SVK,Slovak Republic,ROU,Romania,2013,3,274,-271
SVK,Slovak Republic,ROU,Romania,2014,1,290,-289
SVK,Slovak Republic,ROU,Romania,2015,1,498,-497
SVK,Slovak Republic,ROU,Romania,2016,6,471,-465
SVK,Slovak Republic,ROU,Romania,2017,0,238,-238
ESP,Spain,ROU,Romania,2008,32411,61262,-28851
ESP,Spain,ROU,Romania,2009,50473,44079,6394
ESP,Spain,ROU,Romania,2010,49792,51915,-2123
ESP,Spain,ROU,Romania,2011,42501,50831,-8330
ESP,Spain,ROU,Romania,2012,64714,27273,37441
ESP,Spain,ROU,Romania,2013,70678,22774,47904
ESP,Spain,ROU,Romania,2014,55969,29721,26248
ESP,Spain,ROU,Romania,2015,49123,28785,20338
ESP,Spain,ROU,Romania,2016,46328,28629,17699
ESP,Spain,ROU,Romania,2017,47396,31184,16212
SWE,Sweden,ROU,Romania,2008,269,2544,-2275
SWE,Sweden,ROU,Romania,2009,529,1829,-1300
SWE,Sweden,ROU,Romania,2010,443,1726,-1283
SWE,Sweden,ROU,Romania,2011,541,1928,-1387
SWE,Sweden,ROU,Romania,2012,530,1737,-1207
SWE,Sweden,ROU,Romania,2013,468,1863,-1395
SWE,Sweden,ROU,Romania,2014,435,1994,-1559
SWE,Sweden,ROU,Romania,2015,480,2309,-1829
SWE,Sweden,ROU,Romania,2016,533,2279,-1746
SWE,Sweden,ROU,Romania,2017,473,2211,-1738
CHE,Switzerland,ROU,Romania,2008,270,808,-538
CHE,Switzerland,ROU,Romania,2009,262,1003,-741
CHE,Switzerland,ROU,Romania,2010,334,1407,-1073
CHE,Switzerland,ROU,Romania,2011,395,1722,-1327
CHE,Switzerland,ROU,Romania,2012,480,2258,-1778
CHE,Switzerland,ROU,Romania,2013,813,2659,-1846
CHE,Switzerland,ROU,Romania,2014,971,2387,-1416
CHE,Switzerland,ROU,Romania,2015,786,2014,-1228
CHE,Switzerland,ROU,Romania,2016,855,2883,-2028
CHE,Switzerland,ROU,Romania,2017,861,2882,-2021
TUR,Turkey,ROU,Romania,2010,0,142,-142
TUR,Turkey,ROU,Romania,2016,476,505,-29
TUR,Turkey,ROU,Romania,2017,409,553,-144
GBR,United Kingdom,ROU,Romania,2009,0,10000,-10000
GBR,United Kingdom,ROU,Romania,2010,0,7000,-7000
GBR,United Kingdom,ROU,Romania,2011,4000,8000,-4000
GBR,United Kingdom,ROU,Romania,2012,2000,6000,-4000
GBR,United Kingdom,ROU,Romania,2013,2000,19000,-17000
GBR,United Kingdom,ROU,Romania,2014,3000,37000,-34000
GBR,United Kingdom,ROU,Romania,2015,5000,56000,-51000
GBR,United Kingdom,ROU,Romania,2016,10000,55000,-45000
GBR,United Kingdom,ROU,Romania,2017,15000,51000,-36000
USA,United States,ROU,Romania,2008,0,4930,-4930
USA,United States,ROU,Romania,2009,0,4910,-4910
USA,United States,ROU,Romania,2010,0,4003,-4003
USA,United States,ROU,Romania,2011,0,3882,-3882
USA,United States,ROU,Romania,2012,0,3748,-3748
USA,United States,ROU,Romania,2013,0,3773,-3773
USA,United States,ROU,Romania,2014,0,3246,-3246
USA,United States,ROU,Romania,2015,0,3376,-3376
USA,United States,ROU,Romania,2016,0,3554,-3554
USA,United States,ROU,Romania,2017,0,2953,-2953
CHL,Chile,ROU,Romania,2008,0,18,-18
CHL,Chile,ROU,Romania,2009,0,22,-22
CHL,Chile,ROU,Romania,2010,0,27,-27
CHL,Chile,ROU,Romania,2011,0,46,-46
CHL,Chile,ROU,Romania,2012,0,39,-39
CHL,Chile,ROU,Romania,2013,0,91,-91
CHL,Chile,ROU,Romania,2014,0,75,-75
CHL,Chile,ROU,Romania,2015,0,70,-70
CHL,Chile,ROU,Romania,2016,0,102,-102
EST,Estonia,ROU,Romania,2008,0,10,-10
EST,Estonia,ROU,Romania,2009,0,4,-4
EST,Estonia,ROU,Romania,2010,0,3,-3
EST,Estonia,ROU,Romania,2011,0,1,-1
EST,Estonia,ROU,Romania,2012,0,0,0
EST,Estonia,ROU,Romania,2013,0,1,-1
EST,Estonia,ROU,Romania,2014,0,6,-6
EST,Estonia,ROU,Romania,2015,0,52,-52
EST,Estonia,ROU,Romania,2016,0,60,-60
EST,Estonia,ROU,Romania,2017,0,153,-153
ISR,Israel,ROU,Romania,2008,0,29,-29
ISR,Israel,ROU,Romania,2009,0,35,-35
ISR,Israel,ROU,Romania,2010,0,54,-54
ISR,Israel,ROU,Romania,2011,0,41,-41
ISR,Israel,ROU,Romania,2012,0,51,-51
ISR,Israel,ROU,Romania,2013,0,41,-41
ISR,Israel,ROU,Romania,2014,0,22,-22
ISR,Israel,ROU,Romania,2015,0,21,-21
ISR,Israel,ROU,Romania,2016,0,15,-15
ISR,Israel,ROU,Romania,2017,0,9,-9
SVN,Slovenia,ROU,Romania,2008,46,437,-391
SVN,Slovenia,ROU,Romania,2009,111,205,-94
SVN,Slovenia,ROU,Romania,2010,48,1,47
SVN,Slovenia,ROU,Romania,2011,14,307,-293
SVN,Slovenia,ROU,Romania,2012,18,269,-251
SVN,Slovenia,ROU,Romania,2013,0,448,-448
SVN,Slovenia,ROU,Romania,2014,10,350,-340
SVN,Slovenia,ROU,Romania,2015,7,212,-205
SVN,Slovenia,ROU,Romania,2016,16,227,-211
SVN,Slovenia,ROU,Romania,2017,14,200,-186
AUS,Australia,RUS,Russia,2008,160,906,-746
AUS,Australia,RUS,Russia,2009,135,1213,-1078
AUS,Australia,RUS,Russia,2010,141,1109,-968
AUS,Australia,RUS,Russia,2011,156,1090,-934
AUS,Australia,RUS,Russia,2012,148,1175,-1027
AUS,Australia,RUS,Russia,2013,161,1397,-1236
AUS,Australia,RUS,Russia,2014,185,1217,-1032
AUS,Australia,RUS,Russia,2015,200,1270,-1070
AUS,Australia,RUS,Russia,2016,200,1010,-810
AUS,Australia,RUS,Russia,2017,0,1126,-1126
AUT,Austria,RUS,Russia,2008,1215,2885,-1670
AUT,Austria,RUS,Russia,2009,1781,2404,-623
AUT,Austria,RUS,Russia,2010,1639,2205,-566
AUT,Austria,RUS,Russia,2011,1578,2643,-1065
AUT,Austria,RUS,Russia,2012,1600,3438,-1838
AUT,Austria,RUS,Russia,2013,1972,3471,-1499
AUT,Austria,RUS,Russia,2014,1823,3139,-1316
AUT,Austria,RUS,Russia,2015,1814,2949,-1135
AUT,Austria,RUS,Russia,2016,1852,2699,-847
AUT,Austria,RUS,Russia,2017,2023,2378,-355
BEL,Belgium,RUS,Russia,2008,269,809,-540
BEL,Belgium,RUS,Russia,2009,271,810,-539
BEL,Belgium,RUS,Russia,2010,406,900,-494
BEL,Belgium,RUS,Russia,2011,410,970,-560
BEL,Belgium,RUS,Russia,2012,1417,2041,-624
BEL,Belgium,RUS,Russia,2013,1820,1507,313
BEL,Belgium,RUS,Russia,2014,1571,1114,457
BEL,Belgium,RUS,Russia,2015,1156,1098,58
BEL,Belgium,RUS,Russia,2016,652,941,-289
BEL,Belgium,RUS,Russia,2017,361,933,-572
CAN,Canada,RUS,Russia,2008,0,2690,-2690
CAN,Canada,RUS,Russia,2009,0,2931,-2931
CAN,Canada,RUS,Russia,2010,0,2288,-2288
CAN,Canada,RUS,Russia,2011,0,1963,-1963
CAN,Canada,RUS,Russia,2012,0,2077,-2077
CAN,Canada,RUS,Russia,2013,0,2462,-2462
CAN,Canada,RUS,Russia,2014,0,1772,-1772
CAN,Canada,RUS,Russia,2015,0,2147,-2147
CAN,Canada,RUS,Russia,2016,0,2430,-2430
CAN,Canada,RUS,Russia,2017,0,2295,-2295
CZE,Czech Republic,RUS,Russia,2008,35,5763,-5728
CZE,Czech Republic,RUS,Russia,2009,9,4115,-4106
CZE,Czech Republic,RUS,Russia,2010,11,3681,-3670
CZE,Czech Republic,RUS,Russia,2011,23,2146,-2123
CZE,Czech Republic,RUS,Russia,2012,1635,3201,-1566
CZE,Czech Republic,RUS,Russia,2013,3231,3050,181
CZE,Czech Republic,RUS,Russia,2014,1757,4862,-3105
CZE,Czech Republic,RUS,Russia,2015,2061,2852,-791
CZE,Czech Republic,RUS,Russia,2016,1867,2404,-537
CZE,Czech Republic,RUS,Russia,2017,1545,2891,-1346
DNK,Denmark,RUS,Russia,2008,226,431,-205
DNK,Denmark,RUS,Russia,2009,218,400,-182
DNK,Denmark,RUS,Russia,2010,201,363,-162
DNK,Denmark,RUS,Russia,2011,147,388,-241
DNK,Denmark,RUS,Russia,2012,180,371,-191
DNK,Denmark,RUS,Russia,2013,191,495,-304
DNK,Denmark,RUS,Russia,2014,183,387,-204
DNK,Denmark,RUS,Russia,2015,145,323,-178
DNK,Denmark,RUS,Russia,2016,210,278,-68
DNK,Denmark,RUS,Russia,2017,246,282,-36
FIN,Finland,RUS,Russia,2008,301,2950,-2649
FIN,Finland,RUS,Russia,2009,252,2336,-2084
FIN,Finland,RUS,Russia,2010,264,2297,-2033
FIN,Finland,RUS,Russia,2011,198,2795,-2597
FIN,Finland,RUS,Russia,2012,275,3050,-2775
FIN,Finland,RUS,Russia,2013,292,2875,-2583
FIN,Finland,RUS,Russia,2014,393,2420,-2027
FIN,Finland,RUS,Russia,2015,278,2086,-1808
FIN,Finland,RUS,Russia,2016,446,2540,-2094
FIN,Finland,RUS,Russia,2017,493,1549,-1056
FRA,France,RUS,Russia,2008,0,3112,-3112
FRA,France,RUS,Russia,2009,0,3408,-3408
FRA,France,RUS,Russia,2010,0,3494,-3494
FRA,France,RUS,Russia,2011,0,3784,-3784
FRA,France,RUS,Russia,2012,0,3837,-3837
FRA,France,RUS,Russia,2013,0,4066,-4066
FRA,France,RUS,Russia,2014,0,4349,-4349
FRA,France,RUS,Russia,2015,0,3898,-3898
FRA,France,RUS,Russia,2016,0,4075,-4075
FRA,France,RUS,Russia,2017,0,4028,-4028
DEU,Germany,RUS,Russia,2008,13881,15052,-1171
DEU,Germany,RUS,Russia,2009,13267,15652,-2385
DEU,Germany,RUS,Russia,2010,11424,16063,-4639
DEU,Germany,RUS,Russia,2011,10544,17487,-6943
DEU,Germany,RUS,Russia,2012,9553,18812,-9259
DEU,Germany,RUS,Russia,2013,14408,31367,-16959
DEU,Germany,RUS,Russia,2014,13888,20629,-6741
DEU,Germany,RUS,Russia,2015,10584,21633,-11049
DEU,Germany,RUS,Russia,2016,11173,23085,-11912
DEU,Germany,RUS,Russia,2017,11287,18137,-6850
GRC,Greece,RUS,Russia,2008,0,1040,-1040
GRC,Greece,RUS,Russia,2009,0,1200,-1200
GRC,Greece,RUS,Russia,2010,0,1221,-1221
GRC,Greece,RUS,Russia,2011,0,1436,-1436
HUN,Hungary,RUS,Russia,2008,15,366,-351
HUN,Hungary,RUS,Russia,2009,55,450,-395
HUN,Hungary,RUS,Russia,2010,72,391,-319
HUN,Hungary,RUS,Russia,2011,70,434,-364
HUN,Hungary,RUS,Russia,2012,51,527,-476
HUN,Hungary,RUS,Russia,2013,50,590,-540
HUN,Hungary,RUS,Russia,2014,88,1040,-952
HUN,Hungary,RUS,Russia,2015,149,907,-758
HUN,Hungary,RUS,Russia,2016,199,655,-456
HUN,Hungary,RUS,Russia,2017,276,814,-538
ISL,Iceland,RUS,Russia,2008,28,32,-4
ISL,Iceland,RUS,Russia,2009,18,19,-1
ISL,Iceland,RUS,Russia,2010,6,21,-15
ISL,Iceland,RUS,Russia,2011,10,25,-15
ISL,Iceland,RUS,Russia,2012,6,21,-15
ISL,Iceland,RUS,Russia,2013,19,23,-4
ISL,Iceland,RUS,Russia,2014,15,27,-12
ISL,Iceland,RUS,Russia,2016,16,53,-37
ISL,Iceland,RUS,Russia,2017,14,32,-18
ITA,Italy,RUS,Russia,2008,104,3752,-3648
ITA,Italy,RUS,Russia,2009,120,4061,-3941
ITA,Italy,RUS,Russia,2010,152,5138,-4986
ITA,Italy,RUS,Russia,2011,168,4269,-4101
ITA,Italy,RUS,Russia,2012,243,3970,-3727
ITA,Italy,RUS,Russia,2013,387,4384,-3997
ITA,Italy,RUS,Russia,2014,337,3193,-2856
ITA,Italy,RUS,Russia,2015,328,3035,-2707
ITA,Italy,RUS,Russia,2016,0,2877,-2877
ITA,Italy,RUS,Russia,2017,307,2787,-2480
JPN,Japan,RUS,Russia,2008,4190,4531,-341
JPN,Japan,RUS,Russia,2009,3608,4531,-923
JPN,Japan,RUS,Russia,2010,3191,3462,-271
JPN,Japan,RUS,Russia,2011,2531,2761,-230
JPN,Japan,RUS,Russia,2012,3542,3829,-287
JPN,Japan,RUS,Russia,2013,2173,2540,-367
JPN,Japan,RUS,Russia,2014,2555,3047,-492
JPN,Japan,RUS,Russia,2015,2868,3431,-563
JPN,Japan,RUS,Russia,2016,3403,3905,-502
JPN,Japan,RUS,Russia,2017,2323,3629,-1306
KOR,Korea,RUS,Russia,2008,3170,2587,583
KOR,Korea,RUS,Russia,2009,2578,2895,-317
KOR,Korea,RUS,Russia,2010,2298,2601,-303
KOR,Korea,RUS,Russia,2011,2298,2560,-262
KOR,Korea,RUS,Russia,2012,2371,2723,-352
KOR,Korea,RUS,Russia,2013,2398,2846,-448
KOR,Korea,RUS,Russia,2014,2627,3207,-580
KOR,Korea,RUS,Russia,2015,2837,6784,-3947
KOR,Korea,RUS,Russia,2016,5187,15025,-9838
KOR,Korea,RUS,Russia,2017,8621,18638,-10017
LUX,Luxembourg,RUS,Russia,2008,47,96,-49
LUX,Luxembourg,RUS,Russia,2009,53,93,-40
LUX,Luxembourg,RUS,Russia,2010,34,101,-67
LUX,Luxembourg,RUS,Russia,2011,23,127,-104
LUX,Luxembourg,RUS,Russia,2012,48,130,-82
LUX,Luxembourg,RUS,Russia,2013,48,210,-162
LUX,Luxembourg,RUS,Russia,2014,48,212,-164
LUX,Luxembourg,RUS,Russia,2015,67,259,-192
LUX,Luxembourg,RUS,Russia,2016,83,239,-156
LUX,Luxembourg,RUS,Russia,2017,66,306,-240
MEX,Mexico,RUS,Russia,2008,0,91,-91
MEX,Mexico,RUS,Russia,2009,0,132,-132
MEX,Mexico,RUS,Russia,2010,0,95,-95
MEX,Mexico,RUS,Russia,2011,0,95,-95
MEX,Mexico,RUS,Russia,2012,0,101,-101
MEX,Mexico,RUS,Russia,2013,0,290,-290
MEX,Mexico,RUS,Russia,2014,0,199,-199
MEX,Mexico,RUS,Russia,2015,0,173,-173
MEX,Mexico,RUS,Russia,2016,0,212,-212
MEX,Mexico,RUS,Russia,2017,0,201,-201
NLD,Netherlands,RUS,Russia,2009,421,876,-455
NLD,Netherlands,RUS,Russia,2010,419,969,-550
NLD,Netherlands,RUS,Russia,2011,447,1173,-726
NLD,Netherlands,RUS,Russia,2012,489,1234,-745
NLD,Netherlands,RUS,Russia,2013,650,1318,-668
NLD,Netherlands,RUS,Russia,2014,557,1453,-896
NLD,Netherlands,RUS,Russia,2015,618,1640,-1022
NLD,Netherlands,RUS,Russia,2016,724,1766,-1042
NLD,Netherlands,RUS,Russia,2017,762,1968,-1206
NZL,New Zealand,RUS,Russia,2008,53,297,-244
NZL,New Zealand,RUS,Russia,2009,64,265,-201
NZL,New Zealand,RUS,Russia,2010,85,281,-196
NZL,New Zealand,RUS,Russia,2011,80,361,-281
NZL,New Zealand,RUS,Russia,2012,89,340,-251
NZL,New Zealand,RUS,Russia,2013,84,370,-286
NZL,New Zealand,RUS,Russia,2014,83,438,-355
NZL,New Zealand,RUS,Russia,2015,79,394,-315
NZL,New Zealand,RUS,Russia,2016,66,448,-382
NZL,New Zealand,RUS,Russia,2017,109,468,-359
NOR,Norway,RUS,Russia,2008,182,1157,-975
NOR,Norway,RUS,Russia,2009,322,999,-677
NOR,Norway,RUS,Russia,2010,294,934,-640
NOR,Norway,RUS,Russia,2011,435,1020,-585
NOR,Norway,RUS,Russia,2012,317,1080,-763
NOR,Norway,RUS,Russia,2013,434,1016,-582
NOR,Norway,RUS,Russia,2014,392,732,-340
NOR,Norway,RUS,Russia,2015,377,699,-322
NOR,Norway,RUS,Russia,2016,362,525,-163
NOR,Norway,RUS,Russia,2017,227,498,-271
POL,Poland,RUS,Russia,2008,0,1806,-1806
POL,Poland,RUS,Russia,2009,0,1567,-1567
POL,Poland,RUS,Russia,2010,0,1604,-1604
POL,Poland,RUS,Russia,2011,0,1620,-1620
POL,Poland,RUS,Russia,2012,0,1871,-1871
POL,Poland,RUS,Russia,2013,0,1894,-1894
POL,Poland,RUS,Russia,2014,0,1113,-1113
POL,Poland,RUS,Russia,2015,0,2499,-2499
POL,Poland,RUS,Russia,2016,0,2609,-2609
POL,Poland,RUS,Russia,2017,0,2706,-2706
PRT,Portugal,RUS,Russia,2008,0,501,-501
PRT,Portugal,RUS,Russia,2009,0,396,-396
PRT,Portugal,RUS,Russia,2010,0,311,-311
PRT,Portugal,RUS,Russia,2011,0,324,-324
PRT,Portugal,RUS,Russia,2012,0,320,-320
PRT,Portugal,RUS,Russia,2013,0,332,-332
PRT,Portugal,RUS,Russia,2014,0,365,-365
PRT,Portugal,RUS,Russia,2015,0,293,-293
PRT,Portugal,RUS,Russia,2016,0,314,-314
PRT,Portugal,RUS,Russia,2017,0,421,-421
SVK,Slovak Republic,RUS,Russia,2008,1,29,-28
SVK,Slovak Republic,RUS,Russia,2009,82,52,30
SVK,Slovak Republic,RUS,Russia,2010,94,61,33
SVK,Slovak Republic,RUS,Russia,2011,81,40,41
SVK,Slovak Republic,RUS,Russia,2012,1,34,-33
SVK,Slovak Republic,RUS,Russia,2013,0,43,-43
SVK,Slovak Republic,RUS,Russia,2014,3,39,-36
SVK,Slovak Republic,RUS,Russia,2015,1,53,-52
SVK,Slovak Republic,RUS,Russia,2016,0,49,-49
SVK,Slovak Republic,RUS,Russia,2017,2,60,-58
ESP,Spain,RUS,Russia,2008,2879,5752,-2873
ESP,Spain,RUS,Russia,2009,3172,5288,-2116
ESP,Spain,RUS,Russia,2010,3134,6171,-3037
ESP,Spain,RUS,Russia,2011,3127,7635,-4508
ESP,Spain,RUS,Russia,2012,3466,7642,-4176
ESP,Spain,RUS,Russia,2013,5529,8440,-2911
ESP,Spain,RUS,Russia,2014,3735,8208,-4473
ESP,Spain,RUS,Russia,2015,3254,7042,-3788
ESP,Spain,RUS,Russia,2016,3847,6236,-2389
ESP,Spain,RUS,Russia,2017,5159,6971,-1812
SWE,Sweden,RUS,Russia,2008,139,914,-775
SWE,Sweden,RUS,Russia,2009,126,1094,-968
SWE,Sweden,RUS,Russia,2010,132,1221,-1089
SWE,Sweden,RUS,Russia,2011,213,1186,-973
SWE,Sweden,RUS,Russia,2012,250,1266,-1016
SWE,Sweden,RUS,Russia,2013,156,1125,-969
SWE,Sweden,RUS,Russia,2014,278,1140,-862
SWE,Sweden,RUS,Russia,2015,387,814,-427
SWE,Sweden,RUS,Russia,2016,210,1072,-862
SWE,Sweden,RUS,Russia,2017,208,1017,-809
CHE,Switzerland,RUS,Russia,2010,890,1926,-1036
CHE,Switzerland,RUS,Russia,2011,805,2048,-1243
CHE,Switzerland,RUS,Russia,2012,813,2057,-1244
CHE,Switzerland,RUS,Russia,2013,840,2145,-1305
CHE,Switzerland,RUS,Russia,2014,859,1914,-1055
CHE,Switzerland,RUS,Russia,2015,962,1768,-806
CHE,Switzerland,RUS,Russia,2016,947,1634,-687
CHE,Switzerland,RUS,Russia,2017,857,1544,-687
TUR,Turkey,RUS,Russia,2010,0,1778,-1778
TUR,Turkey,RUS,Russia,2016,3680,6425,-2745
TUR,Turkey,RUS,Russia,2017,5767,7311,-1544
GBR,United Kingdom,RUS,Russia,2013,0,1000,-1000
GBR,United Kingdom,RUS,Russia,2014,0,3000,-3000
GBR,United Kingdom,RUS,Russia,2015,0,1000,-1000
USA,United States,RUS,Russia,2008,0,11695,-11695
USA,United States,RUS,Russia,2009,0,8238,-8238
USA,United States,RUS,Russia,2010,0,6718,-6718
USA,United States,RUS,Russia,2011,0,7944,-7944
USA,United States,RUS,Russia,2012,0,9969,-9969
USA,United States,RUS,Russia,2013,0,9753,-9753
USA,United States,RUS,Russia,2014,0,9079,-9079
USA,United States,RUS,Russia,2015,0,8799,-8799
USA,United States,RUS,Russia,2016,0,9297,-9297
USA,United States,RUS,Russia,2017,0,8918,-8918
CHL,Chile,RUS,Russia,2008,0,77,-77
CHL,Chile,RUS,Russia,2009,0,90,-90
CHL,Chile,RUS,Russia,2010,0,92,-92
CHL,Chile,RUS,Russia,2011,0,144,-144
CHL,Chile,RUS,Russia,2012,0,107,-107
CHL,Chile,RUS,Russia,2013,0,165,-165
CHL,Chile,RUS,Russia,2014,0,168,-168
CHL,Chile,RUS,Russia,2015,0,194,-194
CHL,Chile,RUS,Russia,2016,0,181,-181
EST,Estonia,RUS,Russia,2008,151,435,-284
EST,Estonia,RUS,Russia,2009,193,505,-312
EST,Estonia,RUS,Russia,2010,189,356,-167
EST,Estonia,RUS,Russia,2011,154,913,-759
EST,Estonia,RUS,Russia,2012,114,460,-346
EST,Estonia,RUS,Russia,2013,106,544,-438
EST,Estonia,RUS,Russia,2014,115,421,-306
EST,Estonia,RUS,Russia,2015,677,1294,-617
EST,Estonia,RUS,Russia,2016,981,1290,-309
EST,Estonia,RUS,Russia,2017,915,1272,-357
SVN,Slovenia,RUS,Russia,2008,49,174,-125
SVN,Slovenia,RUS,Russia,2009,59,126,-67
SVN,Slovenia,RUS,Russia,2010,41,140,-99
SVN,Slovenia,RUS,Russia,2011,10,273,-263
SVN,Slovenia,RUS,Russia,2012,18,315,-297
SVN,Slovenia,RUS,Russia,2013,11,511,-500
SVN,Slovenia,RUS,Russia,2014,21,727,-706
SVN,Slovenia,RUS,Russia,2015,63,562,-499
SVN,Slovenia,RUS,Russia,2016,64,394,-330
SVN,Slovenia,RUS,Russia,2017,50,504,-454
AUS,Australia,RWA,Rwanda,2008,0,78,-78
AUS,Australia,RWA,Rwanda,2009,5,66,-61
AUS,Australia,RWA,Rwanda,2010,0,139,-139
AUS,Australia,RWA,Rwanda,2011,0,73,-73
AUS,Australia,RWA,Rwanda,2012,0,46,-46
AUS,Australia,RWA,Rwanda,2013,0,43,-43
AUS,Australia,RWA,Rwanda,2014,0,36,-36
AUS,Australia,RWA,Rwanda,2015,0,25,-25
AUS,Australia,RWA,Rwanda,2016,0,66,-66
AUS,Australia,RWA,Rwanda,2017,0,50,-50
AUT,Austria,RWA,Rwanda,2008,3,10,-7
AUT,Austria,RWA,Rwanda,2009,4,7,-3
AUT,Austria,RWA,Rwanda,2010,8,10,-2
AUT,Austria,RWA,Rwanda,2011,6,25,-19
AUT,Austria,RWA,Rwanda,2012,6,18,-12
AUT,Austria,RWA,Rwanda,2013,4,17,-13
AUT,Austria,RWA,Rwanda,2014,10,20,-10
AUT,Austria,RWA,Rwanda,2015,8,30,-22
AUT,Austria,RWA,Rwanda,2016,9,27,-18
AUT,Austria,RWA,Rwanda,2017,15,14,1
BEL,Belgium,RWA,Rwanda,2008,0,216,-216
BEL,Belgium,RWA,Rwanda,2009,0,313,-313
BEL,Belgium,RWA,Rwanda,2010,67,321,-254
BEL,Belgium,RWA,Rwanda,2011,0,334,-334
BEL,Belgium,RWA,Rwanda,2012,156,439,-283
BEL,Belgium,RWA,Rwanda,2013,239,326,-87
BEL,Belgium,RWA,Rwanda,2014,240,324,-84
BEL,Belgium,RWA,Rwanda,2015,175,295,-120
BEL,Belgium,RWA,Rwanda,2016,128,318,-190
BEL,Belgium,RWA,Rwanda,2017,83,308,-225
CAN,Canada,RWA,Rwanda,2008,0,358,-358
CAN,Canada,RWA,Rwanda,2009,0,415,-415
CAN,Canada,RWA,Rwanda,2010,0,396,-396
CAN,Canada,RWA,Rwanda,2011,0,492,-492
CAN,Canada,RWA,Rwanda,2012,0,562,-562
CAN,Canada,RWA,Rwanda,2013,0,415,-415
CAN,Canada,RWA,Rwanda,2014,0,335,-335
CAN,Canada,RWA,Rwanda,2015,0,362,-362
CAN,Canada,RWA,Rwanda,2016,0,365,-365
CAN,Canada,RWA,Rwanda,2017,0,355,-355
CZE,Czech Republic,RWA,Rwanda,2008,0,1,-1
CZE,Czech Republic,RWA,Rwanda,2009,0,1,-1
CZE,Czech Republic,RWA,Rwanda,2012,1,2,-1
CZE,Czech Republic,RWA,Rwanda,2013,1,5,-4
CZE,Czech Republic,RWA,Rwanda,2014,1,1,0
CZE,Czech Republic,RWA,Rwanda,2015,2,2,0
CZE,Czech Republic,RWA,Rwanda,2016,0,4,-4
DNK,Denmark,RWA,Rwanda,2008,3,27,-24
DNK,Denmark,RWA,Rwanda,2009,0,10,-10
DNK,Denmark,RWA,Rwanda,2010,2,22,-20
DNK,Denmark,RWA,Rwanda,2011,1,17,-16
DNK,Denmark,RWA,Rwanda,2012,2,12,-10
DNK,Denmark,RWA,Rwanda,2013,6,10,-4
DNK,Denmark,RWA,Rwanda,2014,2,18,-16
DNK,Denmark,RWA,Rwanda,2015,4,12,-8
DNK,Denmark,RWA,Rwanda,2016,5,7,-2
DNK,Denmark,RWA,Rwanda,2017,2,10,-8
FIN,Finland,RWA,Rwanda,2008,1,30,-29
FIN,Finland,RWA,Rwanda,2009,2,9,-7
FIN,Finland,RWA,Rwanda,2010,0,12,-12
FIN,Finland,RWA,Rwanda,2011,1,10,-9
FIN,Finland,RWA,Rwanda,2012,1,13,-12
FIN,Finland,RWA,Rwanda,2013,0,16,-16
FIN,Finland,RWA,Rwanda,2014,1,25,-24
FIN,Finland,RWA,Rwanda,2015,0,8,-8
FIN,Finland,RWA,Rwanda,2016,2,13,-11
FIN,Finland,RWA,Rwanda,2017,3,26,-23
FRA,France,RWA,Rwanda,2008,0,321,-321
FRA,France,RWA,Rwanda,2009,0,235,-235
FRA,France,RWA,Rwanda,2010,0,244,-244
FRA,France,RWA,Rwanda,2011,0,236,-236
FRA,France,RWA,Rwanda,2012,0,301,-301
FRA,France,RWA,Rwanda,2013,0,257,-257
FRA,France,RWA,Rwanda,2014,0,272,-272
FRA,France,RWA,Rwanda,2015,0,198,-198
FRA,France,RWA,Rwanda,2016,0,207,-207
FRA,France,RWA,Rwanda,2017,0,318,-318
DEU,Germany,RWA,Rwanda,2008,53,72,-19
DEU,Germany,RWA,Rwanda,2009,72,113,-41
DEU,Germany,RWA,Rwanda,2010,69,86,-17
DEU,Germany,RWA,Rwanda,2011,45,110,-65
DEU,Germany,RWA,Rwanda,2012,29,120,-91
DEU,Germany,RWA,Rwanda,2013,37,104,-67
DEU,Germany,RWA,Rwanda,2014,52,152,-100
DEU,Germany,RWA,Rwanda,2015,51,115,-64
DEU,Germany,RWA,Rwanda,2016,58,187,-129
DEU,Germany,RWA,Rwanda,2017,59,159,-100
HUN,Hungary,RWA,Rwanda,2008,0,0,0
HUN,Hungary,RWA,Rwanda,2009,2,4,-2
HUN,Hungary,RWA,Rwanda,2010,0,2,-2
HUN,Hungary,RWA,Rwanda,2011,1,2,-1
HUN,Hungary,RWA,Rwanda,2012,0,0,0
HUN,Hungary,RWA,Rwanda,2013,0,0,0
HUN,Hungary,RWA,Rwanda,2014,0,5,-5
HUN,Hungary,RWA,Rwanda,2015,0,2,-2
HUN,Hungary,RWA,Rwanda,2016,0,3,-3
HUN,Hungary,RWA,Rwanda,2017,0,2,-2
ISL,Iceland,RWA,Rwanda,2008,1,1,0
ISL,Iceland,RWA,Rwanda,2009,2,2,0
ISL,Iceland,RWA,Rwanda,2010,1,2,-1
ISL,Iceland,RWA,Rwanda,2011,1,1,0
ISL,Iceland,RWA,Rwanda,2012,1,2,-1
ISL,Iceland,RWA,Rwanda,2013,0,2,-2
ISL,Iceland,RWA,Rwanda,2014,5,2,3
ISL,Iceland,RWA,Rwanda,2015,1,0,1
ISL,Iceland,RWA,Rwanda,2016,1,1,0
ISL,Iceland,RWA,Rwanda,2017,0,0,0
ITA,Italy,RWA,Rwanda,2008,4,30,-26
ITA,Italy,RWA,Rwanda,2009,4,45,-41
ITA,Italy,RWA,Rwanda,2010,2,41,-39
ITA,Italy,RWA,Rwanda,2011,3,50,-47
ITA,Italy,RWA,Rwanda,2012,1,44,-43
ITA,Italy,RWA,Rwanda,2013,2,39,-37
ITA,Italy,RWA,Rwanda,2014,4,36,-32
ITA,Italy,RWA,Rwanda,2015,4,32,-28
ITA,Italy,RWA,Rwanda,2016,0,22,-22
ITA,Italy,RWA,Rwanda,2017,1,46,-45
JPN,Japan,RWA,Rwanda,2008,86,85,1
JPN,Japan,RWA,Rwanda,2009,61,0,61
JPN,Japan,RWA,Rwanda,2010,70,75,-5
JPN,Japan,RWA,Rwanda,2011,67,75,-8
JPN,Japan,RWA,Rwanda,2012,96,105,-9
JPN,Japan,RWA,Rwanda,2013,92,106,-14
JPN,Japan,RWA,Rwanda,2014,67,84,-17
JPN,Japan,RWA,Rwanda,2015,86,89,-3
JPN,Japan,RWA,Rwanda,2016,59,86,-27
JPN,Japan,RWA,Rwanda,2017,83,101,-18
KOR,Korea,RWA,Rwanda,2008,4,17,-13
KOR,Korea,RWA,Rwanda,2009,20,22,-2
KOR,Korea,RWA,Rwanda,2010,7,30,-23
KOR,Korea,RWA,Rwanda,2011,8,25,-17
KOR,Korea,RWA,Rwanda,2012,37,28,9
KOR,Korea,RWA,Rwanda,2013,11,46,-35
KOR,Korea,RWA,Rwanda,2014,29,56,-27
KOR,Korea,RWA,Rwanda,2015,46,58,-12
KOR,Korea,RWA,Rwanda,2016,33,63,-30
KOR,Korea,RWA,Rwanda,2017,39,67,-28
LUX,Luxembourg,RWA,Rwanda,2008,4,0,4
LUX,Luxembourg,RWA,Rwanda,2009,0,4,-4
LUX,Luxembourg,RWA,Rwanda,2010,2,7,-5
LUX,Luxembourg,RWA,Rwanda,2011,1,1,0
LUX,Luxembourg,RWA,Rwanda,2012,1,1,0
LUX,Luxembourg,RWA,Rwanda,2013,0,2,-2
LUX,Luxembourg,RWA,Rwanda,2014,1,1,0
LUX,Luxembourg,RWA,Rwanda,2015,1,1,0
LUX,Luxembourg,RWA,Rwanda,2016,1,2,-1
LUX,Luxembourg,RWA,Rwanda,2017,1,2,-1
MEX,Mexico,RWA,Rwanda,2008,0,2,-2
MEX,Mexico,RWA,Rwanda,2009,0,1,-1
MEX,Mexico,RWA,Rwanda,2012,0,0,0
MEX,Mexico,RWA,Rwanda,2013,0,0,0
MEX,Mexico,RWA,Rwanda,2014,0,0,0
MEX,Mexico,RWA,Rwanda,2017,0,1,-1
NLD,Netherlands,RWA,Rwanda,2008,22,54,-32
NLD,Netherlands,RWA,Rwanda,2009,46,81,-35
NLD,Netherlands,RWA,Rwanda,2010,57,84,-27
NLD,Netherlands,RWA,Rwanda,2011,72,57,15
NLD,Netherlands,RWA,Rwanda,2012,48,67,-19
NLD,Netherlands,RWA,Rwanda,2013,73,62,11
NLD,Netherlands,RWA,Rwanda,2014,66,76,-10
NLD,Netherlands,RWA,Rwanda,2015,51,47,4
NLD,Netherlands,RWA,Rwanda,2016,71,50,21
NLD,Netherlands,RWA,Rwanda,2017,32,55,-23
NZL,New Zealand,RWA,Rwanda,2008,0,5,-5
NZL,New Zealand,RWA,Rwanda,2009,1,8,-7
NZL,New Zealand,RWA,Rwanda,2011,0,0,0
NZL,New Zealand,RWA,Rwanda,2012,0,6,-6
NZL,New Zealand,RWA,Rwanda,2013,0,1,-1
NZL,New Zealand,RWA,Rwanda,2014,0,12,-12
NZL,New Zealand,RWA,Rwanda,2015,0,10,-10
NZL,New Zealand,RWA,Rwanda,2016,3,1,2
NZL,New Zealand,RWA,Rwanda,2017,0,3,-3
NOR,Norway,RWA,Rwanda,2008,0,44,-44
NOR,Norway,RWA,Rwanda,2009,8,18,-10
NOR,Norway,RWA,Rwanda,2010,7,31,-24
NOR,Norway,RWA,Rwanda,2011,8,26,-18
NOR,Norway,RWA,Rwanda,2012,6,33,-27
NOR,Norway,RWA,Rwanda,2013,8,20,-12
NOR,Norway,RWA,Rwanda,2014,4,24,-20
NOR,Norway,RWA,Rwanda,2015,7,28,-21
NOR,Norway,RWA,Rwanda,2016,13,7,6
NOR,Norway,RWA,Rwanda,2017,3,13,-10
POL,Poland,RWA,Rwanda,2009,0,8,-8
POL,Poland,RWA,Rwanda,2010,0,14,-14
POL,Poland,RWA,Rwanda,2011,0,13,-13
POL,Poland,RWA,Rwanda,2012,0,13,-13
POL,Poland,RWA,Rwanda,2013,0,15,-15
POL,Poland,RWA,Rwanda,2014,0,9,-9
POL,Poland,RWA,Rwanda,2015,0,10,-10
POL,Poland,RWA,Rwanda,2016,0,12,-12
POL,Poland,RWA,Rwanda,2017,0,18,-18
SVK,Slovak Republic,RWA,Rwanda,2008,0,0,0
SVK,Slovak Republic,RWA,Rwanda,2012,0,1,-1
ESP,Spain,RWA,Rwanda,2008,5,21,-16
ESP,Spain,RWA,Rwanda,2009,10,21,-11
ESP,Spain,RWA,Rwanda,2010,9,17,-8
ESP,Spain,RWA,Rwanda,2011,7,17,-10
ESP,Spain,RWA,Rwanda,2012,3,23,-20
ESP,Spain,RWA,Rwanda,2013,3,26,-23
ESP,Spain,RWA,Rwanda,2014,10,18,-8
ESP,Spain,RWA,Rwanda,2015,8,30,-22
ESP,Spain,RWA,Rwanda,2016,5,18,-13
ESP,Spain,RWA,Rwanda,2017,11,17,-6
SWE,Sweden,RWA,Rwanda,2008,1,25,-24
SWE,Sweden,RWA,Rwanda,2009,1,44,-43
SWE,Sweden,RWA,Rwanda,2010,3,46,-43
SWE,Sweden,RWA,Rwanda,2011,6,47,-41
SWE,Sweden,RWA,Rwanda,2012,9,56,-47
SWE,Sweden,RWA,Rwanda,2013,6,42,-36
SWE,Sweden,RWA,Rwanda,2014,24,68,-44
SWE,Sweden,RWA,Rwanda,2015,10,64,-54
SWE,Sweden,RWA,Rwanda,2016,10,48,-38
SWE,Sweden,RWA,Rwanda,2017,11,74,-63
CHE,Switzerland,RWA,Rwanda,2010,9,33,-24
CHE,Switzerland,RWA,Rwanda,2011,9,46,-37
CHE,Switzerland,RWA,Rwanda,2012,12,31,-19
CHE,Switzerland,RWA,Rwanda,2013,13,23,-10
CHE,Switzerland,RWA,Rwanda,2014,5,18,-13
CHE,Switzerland,RWA,Rwanda,2015,3,27,-24
CHE,Switzerland,RWA,Rwanda,2016,10,24,-14
CHE,Switzerland,RWA,Rwanda,2017,9,19,-10
USA,United States,RWA,Rwanda,2008,0,378,-378
USA,United States,RWA,Rwanda,2009,0,952,-952
USA,United States,RWA,Rwanda,2010,0,489,-489
USA,United States,RWA,Rwanda,2011,0,520,-520
USA,United States,RWA,Rwanda,2012,0,592,-592
USA,United States,RWA,Rwanda,2013,0,540,-540
USA,United States,RWA,Rwanda,2014,0,555,-555
USA,United States,RWA,Rwanda,2015,0,732,-732
USA,United States,RWA,Rwanda,2016,0,1357,-1357
USA,United States,RWA,Rwanda,2017,0,1394,-1394
CHL,Chile,RWA,Rwanda,2008,0,0,0
CHL,Chile,RWA,Rwanda,2009,0,0,0
CHL,Chile,RWA,Rwanda,2010,0,0,0
CHL,Chile,RWA,Rwanda,2011,0,0,0
CHL,Chile,RWA,Rwanda,2012,0,0,0
CHL,Chile,RWA,Rwanda,2013,0,0,0
CHL,Chile,RWA,Rwanda,2014,0,0,0
CHL,Chile,RWA,Rwanda,2015,0,0,0
CHL,Chile,RWA,Rwanda,2016,0,0,0
EST,Estonia,RWA,Rwanda,2008,0,0,0
EST,Estonia,RWA,Rwanda,2009,0,0,0
EST,Estonia,RWA,Rwanda,2010,0,0,0
EST,Estonia,RWA,Rwanda,2011,0,0,0
EST,Estonia,RWA,Rwanda,2012,0,1,-1
EST,Estonia,RWA,Rwanda,2013,0,0,0
EST,Estonia,RWA,Rwanda,2014,0,0,0
EST,Estonia,RWA,Rwanda,2015,0,0,0
EST,Estonia,RWA,Rwanda,2016,0,0,0
EST,Estonia,RWA,Rwanda,2017,0,1,-1
SVN,Slovenia,RWA,Rwanda,2015,0,1,-1
AUS,Australia,KNA,Saint Kitts and Nevis,2008,0,1,-1
AUS,Australia,KNA,Saint Kitts and Nevis,2009,0,1,-1
AUS,Australia,KNA,Saint Kitts and Nevis,2010,0,0,0
AUS,Australia,KNA,Saint Kitts and Nevis,2011,0,2,-2
AUS,Australia,KNA,Saint Kitts and Nevis,2012,0,0,0
AUS,Australia,KNA,Saint Kitts and Nevis,2013,0,1,-1
AUS,Australia,KNA,Saint Kitts and Nevis,2014,0,0,0
AUS,Australia,KNA,Saint Kitts and Nevis,2015,0,0,0
AUS,Australia,KNA,Saint Kitts and Nevis,2017,0,5,-5
AUT,Austria,KNA,Saint Kitts and Nevis,2008,0,0,0
AUT,Austria,KNA,Saint Kitts and Nevis,2009,0,1,-1
AUT,Austria,KNA,Saint Kitts and Nevis,2010,1,2,-1
AUT,Austria,KNA,Saint Kitts and Nevis,2011,2,0,2
AUT,Austria,KNA,Saint Kitts and Nevis,2012,0,0,0
AUT,Austria,KNA,Saint Kitts and Nevis,2013,0,1,-1
AUT,Austria,KNA,Saint Kitts and Nevis,2014,1,0,1
AUT,Austria,KNA,Saint Kitts and Nevis,2015,0,6,-6
AUT,Austria,KNA,Saint Kitts and Nevis,2016,0,3,-3
AUT,Austria,KNA,Saint Kitts and Nevis,2017,0,3,-3
BEL,Belgium,KNA,Saint Kitts and Nevis,2008,0,1,-1
BEL,Belgium,KNA,Saint Kitts and Nevis,2009,0,0,0
BEL,Belgium,KNA,Saint Kitts and Nevis,2010,0,0,0
BEL,Belgium,KNA,Saint Kitts and Nevis,2013,0,1,-1
BEL,Belgium,KNA,Saint Kitts and Nevis,2014,1,2,-1
BEL,Belgium,KNA,Saint Kitts and Nevis,2015,0,3,-3
BEL,Belgium,KNA,Saint Kitts and Nevis,2016,1,1,0
CAN,Canada,KNA,Saint Kitts and Nevis,2008,0,25,-25
CAN,Canada,KNA,Saint Kitts and Nevis,2009,0,11,-11
CAN,Canada,KNA,Saint Kitts and Nevis,2010,0,21,-21
CAN,Canada,KNA,Saint Kitts and Nevis,2011,0,12,-12
CAN,Canada,KNA,Saint Kitts and Nevis,2012,0,21,-21
CAN,Canada,KNA,Saint Kitts and Nevis,2013,0,17,-17
CAN,Canada,KNA,Saint Kitts and Nevis,2014,0,24,-24
CAN,Canada,KNA,Saint Kitts and Nevis,2015,0,23,-23
CAN,Canada,KNA,Saint Kitts and Nevis,2016,0,40,-40
CAN,Canada,KNA,Saint Kitts and Nevis,2017,0,35,-35
CZE,Czech Republic,KNA,Saint Kitts and Nevis,2014,0,1,-1
DNK,Denmark,KNA,Saint Kitts and Nevis,2013,0,0,0
DNK,Denmark,KNA,Saint Kitts and Nevis,2014,0,0,0
DNK,Denmark,KNA,Saint Kitts and Nevis,2015,0,2,-2
DNK,Denmark,KNA,Saint Kitts and Nevis,2016,0,0,0
DNK,Denmark,KNA,Saint Kitts and Nevis,2017,0,0,0
FIN,Finland,KNA,Saint Kitts and Nevis,2008,0,0,0
FIN,Finland,KNA,Saint Kitts and Nevis,2009,0,0,0
FIN,Finland,KNA,Saint Kitts and Nevis,2010,0,0,0
FIN,Finland,KNA,Saint Kitts and Nevis,2011,0,0,0
FIN,Finland,KNA,Saint Kitts and Nevis,2012,0,0,0
FIN,Finland,KNA,Saint Kitts and Nevis,2013,0,0,0
FIN,Finland,KNA,Saint Kitts and Nevis,2014,0,0,0
FIN,Finland,KNA,Saint Kitts and Nevis,2015,0,1,-1
FIN,Finland,KNA,Saint Kitts and Nevis,2016,0,0,0
FIN,Finland,KNA,Saint Kitts and Nevis,2017,0,0,0
FRA,France,KNA,Saint Kitts and Nevis,2008,0,4,-4
FRA,France,KNA,Saint Kitts and Nevis,2009,0,1,-1
FRA,France,KNA,Saint Kitts and Nevis,2010,0,2,-2
FRA,France,KNA,Saint Kitts and Nevis,2011,0,6,-6
FRA,France,KNA,Saint Kitts and Nevis,2012,0,5,-5
FRA,France,KNA,Saint Kitts and Nevis,2013,0,5,-5
FRA,France,KNA,Saint Kitts and Nevis,2014,0,8,-8
FRA,France,KNA,Saint Kitts and Nevis,2015,0,4,-4
FRA,France,KNA,Saint Kitts and Nevis,2016,0,11,-11
FRA,France,KNA,Saint Kitts and Nevis,2017,0,5,-5
DEU,Germany,KNA,Saint Kitts and Nevis,2008,0,1,-1
DEU,Germany,KNA,Saint Kitts and Nevis,2009,0,0,0
DEU,Germany,KNA,Saint Kitts and Nevis,2010,2,2,0
DEU,Germany,KNA,Saint Kitts and Nevis,2011,0,3,-3
DEU,Germany,KNA,Saint Kitts and Nevis,2012,1,1,0
DEU,Germany,KNA,Saint Kitts and Nevis,2013,1,4,-3
DEU,Germany,KNA,Saint Kitts and Nevis,2014,8,14,-6
DEU,Germany,KNA,Saint Kitts and Nevis,2015,1,7,-6
DEU,Germany,KNA,Saint Kitts and Nevis,2016,10,16,-6
DEU,Germany,KNA,Saint Kitts and Nevis,2017,5,11,-6
HUN,Hungary,KNA,Saint Kitts and Nevis,2008,0,0,0
HUN,Hungary,KNA,Saint Kitts and Nevis,2009,0,0,0
HUN,Hungary,KNA,Saint Kitts and Nevis,2010,0,0,0
HUN,Hungary,KNA,Saint Kitts and Nevis,2011,0,0,0
HUN,Hungary,KNA,Saint Kitts and Nevis,2012,0,0,0
HUN,Hungary,KNA,Saint Kitts and Nevis,2013,0,1,-1
HUN,Hungary,KNA,Saint Kitts and Nevis,2014,0,1,-1
HUN,Hungary,KNA,Saint Kitts and Nevis,2015,0,6,-6
HUN,Hungary,KNA,Saint Kitts and Nevis,2016,0,4,-4
HUN,Hungary,KNA,Saint Kitts and Nevis,2017,0,0,0
ISL,Iceland,KNA,Saint Kitts and Nevis,2008,0,0,0
ISL,Iceland,KNA,Saint Kitts and Nevis,2009,0,0,0
ISL,Iceland,KNA,Saint Kitts and Nevis,2010,1,1,0
ISL,Iceland,KNA,Saint Kitts and Nevis,2011,0,0,0
ISL,Iceland,KNA,Saint Kitts and Nevis,2012,0,1,-1
ISL,Iceland,KNA,Saint Kitts and Nevis,2013,0,0,0
ISL,Iceland,KNA,Saint Kitts and Nevis,2014,1,0,1
ISL,Iceland,KNA,Saint Kitts and Nevis,2015,0,0,0
ISL,Iceland,KNA,Saint Kitts and Nevis,2016,0,0,0
ISL,Iceland,KNA,Saint Kitts and Nevis,2017,0,0,0
ITA,Italy,KNA,Saint Kitts and Nevis,2008,0,0,0
ITA,Italy,KNA,Saint Kitts and Nevis,2009,0,4,-4
ITA,Italy,KNA,Saint Kitts and Nevis,2010,0,1,-1
ITA,Italy,KNA,Saint Kitts and Nevis,2011,0,0,0
ITA,Italy,KNA,Saint Kitts and Nevis,2012,0,3,-3
ITA,Italy,KNA,Saint Kitts and Nevis,2013,2,0,2
ITA,Italy,KNA,Saint Kitts and Nevis,2015,0,1,-1
ITA,Italy,KNA,Saint Kitts and Nevis,2016,0,2,-2
JPN,Japan,KNA,Saint Kitts and Nevis,2008,3,3,0
JPN,Japan,KNA,Saint Kitts and Nevis,2009,8,7,1
JPN,Japan,KNA,Saint Kitts and Nevis,2010,8,8,0
JPN,Japan,KNA,Saint Kitts and Nevis,2011,5,5,0
JPN,Japan,KNA,Saint Kitts and Nevis,2012,6,6,0
JPN,Japan,KNA,Saint Kitts and Nevis,2013,6,6,0
JPN,Japan,KNA,Saint Kitts and Nevis,2014,7,7,0
JPN,Japan,KNA,Saint Kitts and Nevis,2015,14,14,0
JPN,Japan,KNA,Saint Kitts and Nevis,2016,11,13,-2
JPN,Japan,KNA,Saint Kitts and Nevis,2017,9,10,-1
KOR,Korea,KNA,Saint Kitts and Nevis,2008,0,0,0
KOR,Korea,KNA,Saint Kitts and Nevis,2009,0,1,-1
KOR,Korea,KNA,Saint Kitts and Nevis,2010,0,0,0
KOR,Korea,KNA,Saint Kitts and Nevis,2011,0,0,0
KOR,Korea,KNA,Saint Kitts and Nevis,2012,2,2,0
KOR,Korea,KNA,Saint Kitts and Nevis,2013,0,0,0
KOR,Korea,KNA,Saint Kitts and Nevis,2014,1,1,0
KOR,Korea,KNA,Saint Kitts and Nevis,2015,0,2,-2
KOR,Korea,KNA,Saint Kitts and Nevis,2016,1,1,0
KOR,Korea,KNA,Saint Kitts and Nevis,2017,1,0,1
LUX,Luxembourg,KNA,Saint Kitts and Nevis,2008,0,0,0
LUX,Luxembourg,KNA,Saint Kitts and Nevis,2009,0,0,0
LUX,Luxembourg,KNA,Saint Kitts and Nevis,2010,0,0,0
LUX,Luxembourg,KNA,Saint Kitts and Nevis,2011,0,0,0
LUX,Luxembourg,KNA,Saint Kitts and Nevis,2012,0,0,0
LUX,Luxembourg,KNA,Saint Kitts and Nevis,2013,0,0,0
LUX,Luxembourg,KNA,Saint Kitts and Nevis,2014,0,0,0
LUX,Luxembourg,KNA,Saint Kitts and Nevis,2015,0,1,-1
LUX,Luxembourg,KNA,Saint Kitts and Nevis,2016,0,0,0
LUX,Luxembourg,KNA,Saint Kitts and Nevis,2017,0,1,-1
MEX,Mexico,KNA,Saint Kitts and Nevis,2012,0,0,0
MEX,Mexico,KNA,Saint Kitts and Nevis,2013,0,0,0
MEX,Mexico,KNA,Saint Kitts and Nevis,2014,0,0,0
MEX,Mexico,KNA,Saint Kitts and Nevis,2016,0,1,-1
NLD,Netherlands,KNA,Saint Kitts and Nevis,2009,0,1,-1
NLD,Netherlands,KNA,Saint Kitts and Nevis,2010,1,2,-1
NLD,Netherlands,KNA,Saint Kitts and Nevis,2013,0,1,-1
NLD,Netherlands,KNA,Saint Kitts and Nevis,2015,2,0,2
NLD,Netherlands,KNA,Saint Kitts and Nevis,2016,0,2,-2
NLD,Netherlands,KNA,Saint Kitts and Nevis,2017,0,2,-2
NZL,New Zealand,KNA,Saint Kitts and Nevis,2010,0,1,-1
NZL,New Zealand,KNA,Saint Kitts and Nevis,2011,0,1,-1
NZL,New Zealand,KNA,Saint Kitts and Nevis,2012,0,0,0
NZL,New Zealand,KNA,Saint Kitts and Nevis,2016,0,1,-1
NZL,New Zealand,KNA,Saint Kitts and Nevis,2017,0,1,-1
NOR,Norway,KNA,Saint Kitts and Nevis,2008,0,0,0
NOR,Norway,KNA,Saint Kitts and Nevis,2009,0,0,0
NOR,Norway,KNA,Saint Kitts and Nevis,2010,1,0,1
NOR,Norway,KNA,Saint Kitts and Nevis,2011,0,0,0
NOR,Norway,KNA,Saint Kitts and Nevis,2012,0,0,0
NOR,Norway,KNA,Saint Kitts and Nevis,2013,0,0,0
NOR,Norway,KNA,Saint Kitts and Nevis,2014,0,0,0
NOR,Norway,KNA,Saint Kitts and Nevis,2015,0,0,0
NOR,Norway,KNA,Saint Kitts and Nevis,2016,0,0,0
NOR,Norway,KNA,Saint Kitts and Nevis,2017,0,0,0
POL,Poland,KNA,Saint Kitts and Nevis,2009,0,0,0
POL,Poland,KNA,Saint Kitts and Nevis,2010,0,0,0
POL,Poland,KNA,Saint Kitts and Nevis,2011,0,0,0
POL,Poland,KNA,Saint Kitts and Nevis,2012,0,0,0
POL,Poland,KNA,Saint Kitts and Nevis,2013,0,0,0
POL,Poland,KNA,Saint Kitts and Nevis,2014,0,0,0
POL,Poland,KNA,Saint Kitts and Nevis,2015,0,0,0
POL,Poland,KNA,Saint Kitts and Nevis,2016,0,0,0
POL,Poland,KNA,Saint Kitts and Nevis,2017,0,0,0
SVK,Slovak Republic,KNA,Saint Kitts and Nevis,2008,0,0,0
SVK,Slovak Republic,KNA,Saint Kitts and Nevis,2009,0,2,-2
ESP,Spain,KNA,Saint Kitts and Nevis,2008,0,1,-1
ESP,Spain,KNA,Saint Kitts and Nevis,2009,0,1,-1
ESP,Spain,KNA,Saint Kitts and Nevis,2010,0,1,-1
ESP,Spain,KNA,Saint Kitts and Nevis,2011,4,3,1
ESP,Spain,KNA,Saint Kitts and Nevis,2012,0,9,-9
ESP,Spain,KNA,Saint Kitts and Nevis,2013,2,6,-4
ESP,Spain,KNA,Saint Kitts and Nevis,2014,1,5,-4
ESP,Spain,KNA,Saint Kitts and Nevis,2015,2,7,-5
ESP,Spain,KNA,Saint Kitts and Nevis,2016,1,7,-6
ESP,Spain,KNA,Saint Kitts and Nevis,2017,2,7,-5
SWE,Sweden,KNA,Saint Kitts and Nevis,2008,0,0,0
SWE,Sweden,KNA,Saint Kitts and Nevis,2009,0,0,0
SWE,Sweden,KNA,Saint Kitts and Nevis,2010,0,0,0
SWE,Sweden,KNA,Saint Kitts and Nevis,2011,0,0,0
SWE,Sweden,KNA,Saint Kitts and Nevis,2012,0,0,0
SWE,Sweden,KNA,Saint Kitts and Nevis,2013,0,0,0
SWE,Sweden,KNA,Saint Kitts and Nevis,2014,0,1,-1
SWE,Sweden,KNA,Saint Kitts and Nevis,2015,0,1,-1
SWE,Sweden,KNA,Saint Kitts and Nevis,2016,1,4,-3
SWE,Sweden,KNA,Saint Kitts and Nevis,2017,3,1,2
CHE,Switzerland,KNA,Saint Kitts and Nevis,2010,3,0,3
CHE,Switzerland,KNA,Saint Kitts and Nevis,2011,1,5,-4
CHE,Switzerland,KNA,Saint Kitts and Nevis,2012,6,1,5
CHE,Switzerland,KNA,Saint Kitts and Nevis,2013,3,10,-7
CHE,Switzerland,KNA,Saint Kitts and Nevis,2014,3,7,-4
CHE,Switzerland,KNA,Saint Kitts and Nevis,2015,5,4,1
CHE,Switzerland,KNA,Saint Kitts and Nevis,2016,1,8,-7
CHE,Switzerland,KNA,Saint Kitts and Nevis,2017,2,11,-9
USA,United States,KNA,Saint Kitts and Nevis,2008,0,363,-363
USA,United States,KNA,Saint Kitts and Nevis,2009,0,310,-310
USA,United States,KNA,Saint Kitts and Nevis,2010,0,339,-339
USA,United States,KNA,Saint Kitts and Nevis,2011,0,350,-350
USA,United States,KNA,Saint Kitts and Nevis,2012,0,311,-311
USA,United States,KNA,Saint Kitts and Nevis,2013,0,259,-259
USA,United States,KNA,Saint Kitts and Nevis,2014,0,263,-263
USA,United States,KNA,Saint Kitts and Nevis,2015,0,222,-222
USA,United States,KNA,Saint Kitts and Nevis,2016,0,250,-250
USA,United States,KNA,Saint Kitts and Nevis,2017,0,238,-238
CHL,Chile,KNA,Saint Kitts and Nevis,2008,0,0,0
CHL,Chile,KNA,Saint Kitts and Nevis,2009,0,0,0
CHL,Chile,KNA,Saint Kitts and Nevis,2010,0,1,-1
CHL,Chile,KNA,Saint Kitts and Nevis,2011,0,1,-1
CHL,Chile,KNA,Saint Kitts and Nevis,2012,0,0,0
CHL,Chile,KNA,Saint Kitts and Nevis,2013,0,1,-1
CHL,Chile,KNA,Saint Kitts and Nevis,2014,0,2,-2
CHL,Chile,KNA,Saint Kitts and Nevis,2015,0,0,0
CHL,Chile,KNA,Saint Kitts and Nevis,2016,0,0,0
EST,Estonia,KNA,Saint Kitts and Nevis,2008,0,0,0
EST,Estonia,KNA,Saint Kitts and Nevis,2009,0,0,0
EST,Estonia,KNA,Saint Kitts and Nevis,2010,0,0,0
EST,Estonia,KNA,Saint Kitts and Nevis,2011,0,0,0
EST,Estonia,KNA,Saint Kitts and Nevis,2012,0,0,0
EST,Estonia,KNA,Saint Kitts and Nevis,2013,0,0,0
EST,Estonia,KNA,Saint Kitts and Nevis,2014,0,0,0
EST,Estonia,KNA,Saint Kitts and Nevis,2015,0,1,-1
EST,Estonia,KNA,Saint Kitts and Nevis,2016,0,0,0
EST,Estonia,KNA,Saint Kitts and Nevis,2017,0,0,0
AUS,Australia,LCA,Saint Lucia,2008,0,1,-1
AUS,Australia,LCA,Saint Lucia,2009,0,0,0
AUS,Australia,LCA,Saint Lucia,2010,0,0,0
AUS,Australia,LCA,Saint Lucia,2011,0,3,-3
AUS,Australia,LCA,Saint Lucia,2012,0,11,-11
AUS,Australia,LCA,Saint Lucia,2013,0,2,-2
AUS,Australia,LCA,Saint Lucia,2014,0,0,0
AUS,Australia,LCA,Saint Lucia,2015,0,0,0
AUS,Australia,LCA,Saint Lucia,2017,0,0,0
AUT,Austria,LCA,Saint Lucia,2008,0,4,-4
AUT,Austria,LCA,Saint Lucia,2009,3,0,3
AUT,Austria,LCA,Saint Lucia,2010,2,1,1
AUT,Austria,LCA,Saint Lucia,2011,0,1,-1
AUT,Austria,LCA,Saint Lucia,2012,1,1,0
AUT,Austria,LCA,Saint Lucia,2013,1,1,0
AUT,Austria,LCA,Saint Lucia,2014,0,1,-1
AUT,Austria,LCA,Saint Lucia,2015,0,0,0
AUT,Austria,LCA,Saint Lucia,2016,1,1,0
AUT,Austria,LCA,Saint Lucia,2017,0,2,-2
BEL,Belgium,LCA,Saint Lucia,2008,0,1,-1
BEL,Belgium,LCA,Saint Lucia,2009,0,1,-1
BEL,Belgium,LCA,Saint Lucia,2010,1,2,-1
BEL,Belgium,LCA,Saint Lucia,2013,1,4,-3
BEL,Belgium,LCA,Saint Lucia,2015,0,1,-1
BEL,Belgium,LCA,Saint Lucia,2016,0,1,-1
BEL,Belgium,LCA,Saint Lucia,2017,0,1,-1
CAN,Canada,LCA,Saint Lucia,2008,0,298,-298
CAN,Canada,LCA,Saint Lucia,2009,0,257,-257
CAN,Canada,LCA,Saint Lucia,2010,0,249,-249
CAN,Canada,LCA,Saint Lucia,2011,0,261,-261
CAN,Canada,LCA,Saint Lucia,2012,0,382,-382
CAN,Canada,LCA,Saint Lucia,2013,0,392,-392
CAN,Canada,LCA,Saint Lucia,2014,0,505,-505
CAN,Canada,LCA,Saint Lucia,2015,0,437,-437
CAN,Canada,LCA,Saint Lucia,2016,0,330,-330
CAN,Canada,LCA,Saint Lucia,2017,0,385,-385
CZE,Czech Republic,LCA,Saint Lucia,2008,0,1,-1
CZE,Czech Republic,LCA,Saint Lucia,2011,0,1,-1
DNK,Denmark,LCA,Saint Lucia,2008,0,1,-1
DNK,Denmark,LCA,Saint Lucia,2009,0,1,-1
DNK,Denmark,LCA,Saint Lucia,2010,0,1,-1
DNK,Denmark,LCA,Saint Lucia,2011,0,1,-1
DNK,Denmark,LCA,Saint Lucia,2012,0,0,0
DNK,Denmark,LCA,Saint Lucia,2013,0,1,-1
DNK,Denmark,LCA,Saint Lucia,2014,0,1,-1
DNK,Denmark,LCA,Saint Lucia,2015,0,0,0
DNK,Denmark,LCA,Saint Lucia,2016,0,1,-1
DNK,Denmark,LCA,Saint Lucia,2017,1,0,1
FIN,Finland,LCA,Saint Lucia,2008,0,1,-1
FIN,Finland,LCA,Saint Lucia,2009,0,0,0
FIN,Finland,LCA,Saint Lucia,2010,0,0,0
FIN,Finland,LCA,Saint Lucia,2011,0,1,-1
FIN,Finland,LCA,Saint Lucia,2012,0,0,0
FIN,Finland,LCA,Saint Lucia,2013,0,0,0
FIN,Finland,LCA,Saint Lucia,2014,1,1,0
FIN,Finland,LCA,Saint Lucia,2015,0,0,0
FIN,Finland,LCA,Saint Lucia,2016,0,0,0
FIN,Finland,LCA,Saint Lucia,2017,0,0,0
FRA,France,LCA,Saint Lucia,2008,0,136,-136
FRA,France,LCA,Saint Lucia,2009,0,136,-136
FRA,France,LCA,Saint Lucia,2010,0,91,-91
FRA,France,LCA,Saint Lucia,2011,0,149,-149
FRA,France,LCA,Saint Lucia,2012,0,96,-96
FRA,France,LCA,Saint Lucia,2013,0,136,-136
FRA,France,LCA,Saint Lucia,2014,0,160,-160
FRA,France,LCA,Saint Lucia,2015,0,151,-151
FRA,France,LCA,Saint Lucia,2016,0,140,-140
FRA,France,LCA,Saint Lucia,2017,0,141,-141
DEU,Germany,LCA,Saint Lucia,2008,9,12,-3
DEU,Germany,LCA,Saint Lucia,2009,9,10,-1
DEU,Germany,LCA,Saint Lucia,2010,9,5,4
DEU,Germany,LCA,Saint Lucia,2011,6,13,-7
DEU,Germany,LCA,Saint Lucia,2012,3,6,-3
DEU,Germany,LCA,Saint Lucia,2013,3,6,-3
DEU,Germany,LCA,Saint Lucia,2014,13,9,4
DEU,Germany,LCA,Saint Lucia,2015,8,8,0
DEU,Germany,LCA,Saint Lucia,2016,2,9,-7
DEU,Germany,LCA,Saint Lucia,2017,9,10,-1
HUN,Hungary,LCA,Saint Lucia,2008,0,0,0
HUN,Hungary,LCA,Saint Lucia,2009,0,0,0
HUN,Hungary,LCA,Saint Lucia,2010,0,0,0
HUN,Hungary,LCA,Saint Lucia,2011,0,0,0
HUN,Hungary,LCA,Saint Lucia,2012,0,0,0
HUN,Hungary,LCA,Saint Lucia,2013,0,0,0
HUN,Hungary,LCA,Saint Lucia,2014,0,0,0
HUN,Hungary,LCA,Saint Lucia,2015,0,0,0
HUN,Hungary,LCA,Saint Lucia,2016,0,0,0
HUN,Hungary,LCA,Saint Lucia,2017,0,0,0
ISL,Iceland,LCA,Saint Lucia,2016,0,0,0
ISL,Iceland,LCA,Saint Lucia,2017,0,1,-1
ITA,Italy,LCA,Saint Lucia,2008,0,2,-2
ITA,Italy,LCA,Saint Lucia,2009,0,5,-5
ITA,Italy,LCA,Saint Lucia,2010,0,2,-2
ITA,Italy,LCA,Saint Lucia,2011,0,0,0
ITA,Italy,LCA,Saint Lucia,2012,0,2,-2
ITA,Italy,LCA,Saint Lucia,2013,0,2,-2
ITA,Italy,LCA,Saint Lucia,2014,0,1,-1
ITA,Italy,LCA,Saint Lucia,2015,0,0,0
ITA,Italy,LCA,Saint Lucia,2017,0,4,-4
JPN,Japan,LCA,Saint Lucia,2008,13,11,2
JPN,Japan,LCA,Saint Lucia,2009,21,24,-3
JPN,Japan,LCA,Saint Lucia,2010,25,26,-1
JPN,Japan,LCA,Saint Lucia,2011,19,15,4
JPN,Japan,LCA,Saint Lucia,2012,15,16,-1
JPN,Japan,LCA,Saint Lucia,2013,18,19,-1
JPN,Japan,LCA,Saint Lucia,2014,17,17,0
JPN,Japan,LCA,Saint Lucia,2015,20,20,0
JPN,Japan,LCA,Saint Lucia,2016,11,13,-2
JPN,Japan,LCA,Saint Lucia,2017,23,24,-1
KOR,Korea,LCA,Saint Lucia,2008,0,0,0
KOR,Korea,LCA,Saint Lucia,2009,0,0,0
KOR,Korea,LCA,Saint Lucia,2010,0,0,0
KOR,Korea,LCA,Saint Lucia,2011,0,0,0
KOR,Korea,LCA,Saint Lucia,2012,0,1,-1
KOR,Korea,LCA,Saint Lucia,2013,2,3,-1
KOR,Korea,LCA,Saint Lucia,2014,0,0,0
KOR,Korea,LCA,Saint Lucia,2015,0,0,0
KOR,Korea,LCA,Saint Lucia,2016,0,0,0
KOR,Korea,LCA,Saint Lucia,2017,0,0,0
LUX,Luxembourg,LCA,Saint Lucia,2008,0,0,0
LUX,Luxembourg,LCA,Saint Lucia,2009,0,0,0
LUX,Luxembourg,LCA,Saint Lucia,2010,0,0,0
LUX,Luxembourg,LCA,Saint Lucia,2011,0,0,0
LUX,Luxembourg,LCA,Saint Lucia,2012,0,0,0
LUX,Luxembourg,LCA,Saint Lucia,2013,0,0,0
LUX,Luxembourg,LCA,Saint Lucia,2014,0,0,0
LUX,Luxembourg,LCA,Saint Lucia,2015,0,0,0
LUX,Luxembourg,LCA,Saint Lucia,2016,0,0,0
LUX,Luxembourg,LCA,Saint Lucia,2017,1,0,1
MEX,Mexico,LCA,Saint Lucia,2008,0,1,-1
MEX,Mexico,LCA,Saint Lucia,2009,0,1,-1
MEX,Mexico,LCA,Saint Lucia,2012,0,1,-1
MEX,Mexico,LCA,Saint Lucia,2013,0,2,-2
MEX,Mexico,LCA,Saint Lucia,2014,0,0,0
MEX,Mexico,LCA,Saint Lucia,2015,0,1,-1
MEX,Mexico,LCA,Saint Lucia,2016,0,2,-2
MEX,Mexico,LCA,Saint Lucia,2017,0,1,-1
NLD,Netherlands,LCA,Saint Lucia,2008,0,1,-1
NLD,Netherlands,LCA,Saint Lucia,2009,0,4,-4
NLD,Netherlands,LCA,Saint Lucia,2011,2,2,0
NLD,Netherlands,LCA,Saint Lucia,2012,3,1,2
NLD,Netherlands,LCA,Saint Lucia,2013,0,1,-1
NLD,Netherlands,LCA,Saint Lucia,2015,0,3,-3
NLD,Netherlands,LCA,Saint Lucia,2016,1,4,-3
NLD,Netherlands,LCA,Saint Lucia,2017,4,1,3
NZL,New Zealand,LCA,Saint Lucia,2009,5,2,3
NZL,New Zealand,LCA,Saint Lucia,2010,1,2,-1
NZL,New Zealand,LCA,Saint Lucia,2012,1,3,-2
NZL,New Zealand,LCA,Saint Lucia,2013,1,2,-1
NZL,New Zealand,LCA,Saint Lucia,2014,0,5,-5
NZL,New Zealand,LCA,Saint Lucia,2016,2,1,1
NZL,New Zealand,LCA,Saint Lucia,2017,0,4,-4
NOR,Norway,LCA,Saint Lucia,2008,0,0,0
NOR,Norway,LCA,Saint Lucia,2009,0,0,0
NOR,Norway,LCA,Saint Lucia,2010,0,0,0
NOR,Norway,LCA,Saint Lucia,2011,0,0,0
NOR,Norway,LCA,Saint Lucia,2012,0,0,0
NOR,Norway,LCA,Saint Lucia,2013,0,0,0
NOR,Norway,LCA,Saint Lucia,2014,0,0,0
NOR,Norway,LCA,Saint Lucia,2015,0,0,0
NOR,Norway,LCA,Saint Lucia,2016,0,0,0
NOR,Norway,LCA,Saint Lucia,2017,0,0,0
POL,Poland,LCA,Saint Lucia,2009,0,0,0
POL,Poland,LCA,Saint Lucia,2010,0,0,0
POL,Poland,LCA,Saint Lucia,2011,0,0,0
POL,Poland,LCA,Saint Lucia,2012,0,0,0
POL,Poland,LCA,Saint Lucia,2013,0,0,0
POL,Poland,LCA,Saint Lucia,2014,0,0,0
POL,Poland,LCA,Saint Lucia,2015,0,1,-1
POL,Poland,LCA,Saint Lucia,2016,0,0,0
POL,Poland,LCA,Saint Lucia,2017,0,1,-1
SVK,Slovak Republic,LCA,Saint Lucia,2008,0,0,0
ESP,Spain,LCA,Saint Lucia,2008,0,3,-3
ESP,Spain,LCA,Saint Lucia,2009,1,4,-3
ESP,Spain,LCA,Saint Lucia,2010,0,1,-1
ESP,Spain,LCA,Saint Lucia,2011,0,4,-4
ESP,Spain,LCA,Saint Lucia,2012,1,3,-2
ESP,Spain,LCA,Saint Lucia,2013,1,4,-3
ESP,Spain,LCA,Saint Lucia,2014,0,0,0
ESP,Spain,LCA,Saint Lucia,2015,1,1,0
ESP,Spain,LCA,Saint Lucia,2016,0,4,-4
ESP,Spain,LCA,Saint Lucia,2017,1,3,-2
SWE,Sweden,LCA,Saint Lucia,2008,0,0,0
SWE,Sweden,LCA,Saint Lucia,2009,0,1,-1
SWE,Sweden,LCA,Saint Lucia,2010,0,1,-1
SWE,Sweden,LCA,Saint Lucia,2011,0,0,0
SWE,Sweden,LCA,Saint Lucia,2012,0,1,-1
SWE,Sweden,LCA,Saint Lucia,2013,0,2,-2
SWE,Sweden,LCA,Saint Lucia,2014,0,1,-1
SWE,Sweden,LCA,Saint Lucia,2015,1,0,1
SWE,Sweden,LCA,Saint Lucia,2016,0,0,0
SWE,Sweden,LCA,Saint Lucia,2017,0,3,-3
CHE,Switzerland,LCA,Saint Lucia,2010,0,1,-1
CHE,Switzerland,LCA,Saint Lucia,2011,0,1,-1
CHE,Switzerland,LCA,Saint Lucia,2012,2,1,1
CHE,Switzerland,LCA,Saint Lucia,2013,0,3,-3
CHE,Switzerland,LCA,Saint Lucia,2014,1,1,0
CHE,Switzerland,LCA,Saint Lucia,2015,2,2,0
CHE,Switzerland,LCA,Saint Lucia,2016,1,1,0
CHE,Switzerland,LCA,Saint Lucia,2017,0,5,-5
USA,United States,LCA,Saint Lucia,2008,0,946,-946
USA,United States,LCA,Saint Lucia,2009,0,1027,-1027
USA,United States,LCA,Saint Lucia,2010,0,872,-872
USA,United States,LCA,Saint Lucia,2011,0,785,-785
USA,United States,LCA,Saint Lucia,2012,0,919,-919
USA,United States,LCA,Saint Lucia,2013,0,853,-853
USA,United States,LCA,Saint Lucia,2014,0,844,-844
USA,United States,LCA,Saint Lucia,2015,0,739,-739
USA,United States,LCA,Saint Lucia,2016,0,777,-777
USA,United States,LCA,Saint Lucia,2017,0,777,-777
CHL,Chile,LCA,Saint Lucia,2008,0,0,0
CHL,Chile,LCA,Saint Lucia,2009,0,0,0
CHL,Chile,LCA,Saint Lucia,2010,0,0,0
CHL,Chile,LCA,Saint Lucia,2011,0,0,0
CHL,Chile,LCA,Saint Lucia,2012,0,0,0
CHL,Chile,LCA,Saint Lucia,2013,0,1,-1
CHL,Chile,LCA,Saint Lucia,2014,0,1,-1
CHL,Chile,LCA,Saint Lucia,2015,0,1,-1
CHL,Chile,LCA,Saint Lucia,2016,0,0,0
EST,Estonia,LCA,Saint Lucia,2008,0,0,0
EST,Estonia,LCA,Saint Lucia,2009,0,0,0
EST,Estonia,LCA,Saint Lucia,2010,0,0,0
EST,Estonia,LCA,Saint Lucia,2011,0,0,0
EST,Estonia,LCA,Saint Lucia,2012,0,0,0
EST,Estonia,LCA,Saint Lucia,2013,0,0,0
EST,Estonia,LCA,Saint Lucia,2014,0,0,0
EST,Estonia,LCA,Saint Lucia,2015,0,0,0
EST,Estonia,LCA,Saint Lucia,2016,0,0,0
EST,Estonia,LCA,Saint Lucia,2017,0,1,-1
AUS,Australia,VCT,Saint Vincent and the Grenadines,2008,0,0,0
AUS,Australia,VCT,Saint Vincent and the Grenadines,2009,0,1,-1
AUS,Australia,VCT,Saint Vincent and the Grenadines,2010,0,1,-1
AUS,Australia,VCT,Saint Vincent and the Grenadines,2011,0,1,-1
AUS,Australia,VCT,Saint Vincent and the Grenadines,2012,0,0,0
AUS,Australia,VCT,Saint Vincent and the Grenadines,2013,0,0,0
AUS,Australia,VCT,Saint Vincent and the Grenadines,2014,0,0,0
AUS,Australia,VCT,Saint Vincent and the Grenadines,2015,0,0,0
AUS,Australia,VCT,Saint Vincent and the Grenadines,2017,0,3,-3
AUT,Austria,VCT,Saint Vincent and the Grenadines,2008,1,4,-3
AUT,Austria,VCT,Saint Vincent and the Grenadines,2009,3,1,2
AUT,Austria,VCT,Saint Vincent and the Grenadines,2010,0,0,0
AUT,Austria,VCT,Saint Vincent and the Grenadines,2011,0,3,-3
AUT,Austria,VCT,Saint Vincent and the Grenadines,2012,2,1,1
AUT,Austria,VCT,Saint Vincent and the Grenadines,2013,2,2,0
AUT,Austria,VCT,Saint Vincent and the Grenadines,2014,1,0,1
AUT,Austria,VCT,Saint Vincent and the Grenadines,2015,1,2,-1
AUT,Austria,VCT,Saint Vincent and the Grenadines,2016,1,2,-1
AUT,Austria,VCT,Saint Vincent and the Grenadines,2017,1,3,-2
BEL,Belgium,VCT,Saint Vincent and the Grenadines,2010,0,0,0
BEL,Belgium,VCT,Saint Vincent and the Grenadines,2012,0,1,-1
BEL,Belgium,VCT,Saint Vincent and the Grenadines,2015,0,1,-1
BEL,Belgium,VCT,Saint Vincent and the Grenadines,2017,0,2,-2
CAN,Canada,VCT,Saint Vincent and the Grenadines,2008,0,433,-433
CAN,Canada,VCT,Saint Vincent and the Grenadines,2009,0,511,-511
CAN,Canada,VCT,Saint Vincent and the Grenadines,2010,0,434,-434
CAN,Canada,VCT,Saint Vincent and the Grenadines,2011,0,451,-451
CAN,Canada,VCT,Saint Vincent and the Grenadines,2012,0,523,-523
CAN,Canada,VCT,Saint Vincent and the Grenadines,2013,0,539,-539
CAN,Canada,VCT,Saint Vincent and the Grenadines,2014,0,607,-607
CAN,Canada,VCT,Saint Vincent and the Grenadines,2015,0,490,-490
CAN,Canada,VCT,Saint Vincent and the Grenadines,2016,0,425,-425
CAN,Canada,VCT,Saint Vincent and the Grenadines,2017,0,475,-475
CZE,Czech Republic,VCT,Saint Vincent and the Grenadines,2013,0,1,-1
DNK,Denmark,VCT,Saint Vincent and the Grenadines,2008,0,0,0
DNK,Denmark,VCT,Saint Vincent and the Grenadines,2009,1,0,1
DNK,Denmark,VCT,Saint Vincent and the Grenadines,2012,0,0,0
DNK,Denmark,VCT,Saint Vincent and the Grenadines,2013,0,0,0
DNK,Denmark,VCT,Saint Vincent and the Grenadines,2014,0,0,0
DNK,Denmark,VCT,Saint Vincent and the Grenadines,2015,0,0,0
DNK,Denmark,VCT,Saint Vincent and the Grenadines,2016,0,0,0
DNK,Denmark,VCT,Saint Vincent and the Grenadines,2017,0,0,0
FIN,Finland,VCT,Saint Vincent and the Grenadines,2008,0,0,0
FIN,Finland,VCT,Saint Vincent and the Grenadines,2009,0,0,0
FIN,Finland,VCT,Saint Vincent and the Grenadines,2010,0,1,-1
FIN,Finland,VCT,Saint Vincent and the Grenadines,2011,0,0,0
FIN,Finland,VCT,Saint Vincent and the Grenadines,2012,1,0,1
FIN,Finland,VCT,Saint Vincent and the Grenadines,2013,0,0,0
FIN,Finland,VCT,Saint Vincent and the Grenadines,2014,0,0,0
FIN,Finland,VCT,Saint Vincent and the Grenadines,2015,0,0,0
FIN,Finland,VCT,Saint Vincent and the Grenadines,2016,0,0,0
FIN,Finland,VCT,Saint Vincent and the Grenadines,2017,0,0,0
FRA,France,VCT,Saint Vincent and the Grenadines,2008,0,1,-1
FRA,France,VCT,Saint Vincent and the Grenadines,2009,0,2,-2
FRA,France,VCT,Saint Vincent and the Grenadines,2010,0,7,-7
FRA,France,VCT,Saint Vincent and the Grenadines,2011,0,3,-3
FRA,France,VCT,Saint Vincent and the Grenadines,2012,0,1,-1
FRA,France,VCT,Saint Vincent and the Grenadines,2013,0,3,-3
FRA,France,VCT,Saint Vincent and the Grenadines,2014,0,3,-3
FRA,France,VCT,Saint Vincent and the Grenadines,2015,0,1,-1
FRA,France,VCT,Saint Vincent and the Grenadines,2016,0,1,-1
FRA,France,VCT,Saint Vincent and the Grenadines,2017,0,3,-3
DEU,Germany,VCT,Saint Vincent and the Grenadines,2008,0,1,-1
DEU,Germany,VCT,Saint Vincent and the Grenadines,2009,5,5,0
DEU,Germany,VCT,Saint Vincent and the Grenadines,2010,3,4,-1
DEU,Germany,VCT,Saint Vincent and the Grenadines,2011,2,5,-3
DEU,Germany,VCT,Saint Vincent and the Grenadines,2012,2,7,-5
DEU,Germany,VCT,Saint Vincent and the Grenadines,2013,3,1,2
DEU,Germany,VCT,Saint Vincent and the Grenadines,2014,2,0,2
DEU,Germany,VCT,Saint Vincent and the Grenadines,2015,3,5,-2
DEU,Germany,VCT,Saint Vincent and the Grenadines,2016,3,4,-1
DEU,Germany,VCT,Saint Vincent and the Grenadines,2017,0,5,-5
HUN,Hungary,VCT,Saint Vincent and the Grenadines,2008,0,1,-1
HUN,Hungary,VCT,Saint Vincent and the Grenadines,2009,0,0,0
HUN,Hungary,VCT,Saint Vincent and the Grenadines,2010,0,0,0
HUN,Hungary,VCT,Saint Vincent and the Grenadines,2011,0,0,0
HUN,Hungary,VCT,Saint Vincent and the Grenadines,2012,0,0,0
HUN,Hungary,VCT,Saint Vincent and the Grenadines,2013,0,0,0
HUN,Hungary,VCT,Saint Vincent and the Grenadines,2014,0,0,0
HUN,Hungary,VCT,Saint Vincent and the Grenadines,2015,1,2,-1
HUN,Hungary,VCT,Saint Vincent and the Grenadines,2016,0,0,0
HUN,Hungary,VCT,Saint Vincent and the Grenadines,2017,0,1,-1
ISL,Iceland,VCT,Saint Vincent and the Grenadines,2008,0,0,0
ISL,Iceland,VCT,Saint Vincent and the Grenadines,2009,0,0,0
ISL,Iceland,VCT,Saint Vincent and the Grenadines,2010,0,0,0
ISL,Iceland,VCT,Saint Vincent and the Grenadines,2011,0,0,0
ISL,Iceland,VCT,Saint Vincent and the Grenadines,2012,0,2,-2
ISL,Iceland,VCT,Saint Vincent and the Grenadines,2013,1,1,0
ISL,Iceland,VCT,Saint Vincent and the Grenadines,2014,2,2,0
ISL,Iceland,VCT,Saint Vincent and the Grenadines,2015,1,0,1
ISL,Iceland,VCT,Saint Vincent and the Grenadines,2016,0,1,-1
ISL,Iceland,VCT,Saint Vincent and the Grenadines,2017,0,1,-1
ITA,Italy,VCT,Saint Vincent and the Grenadines,2008,0,0,0
ITA,Italy,VCT,Saint Vincent and the Grenadines,2009,0,1,-1
ITA,Italy,VCT,Saint Vincent and the Grenadines,2010,0,0,0
ITA,Italy,VCT,Saint Vincent and the Grenadines,2011,0,1,-1
ITA,Italy,VCT,Saint Vincent and the Grenadines,2012,0,0,0
ITA,Italy,VCT,Saint Vincent and the Grenadines,2013,0,0,0
ITA,Italy,VCT,Saint Vincent and the Grenadines,2015,0,0,0
ITA,Italy,VCT,Saint Vincent and the Grenadines,2017,0,1,-1
JPN,Japan,VCT,Saint Vincent and the Grenadines,2008,10,10,0
JPN,Japan,VCT,Saint Vincent and the Grenadines,2009,8,7,1
JPN,Japan,VCT,Saint Vincent and the Grenadines,2010,11,13,-2
JPN,Japan,VCT,Saint Vincent and the Grenadines,2011,3,5,-2
JPN,Japan,VCT,Saint Vincent and the Grenadines,2012,9,9,0
JPN,Japan,VCT,Saint Vincent and the Grenadines,2013,11,11,0
JPN,Japan,VCT,Saint Vincent and the Grenadines,2014,10,11,-1
JPN,Japan,VCT,Saint Vincent and the Grenadines,2015,16,17,-1
JPN,Japan,VCT,Saint Vincent and the Grenadines,2016,10,9,1
JPN,Japan,VCT,Saint Vincent and the Grenadines,2017,11,11,0
KOR,Korea,VCT,Saint Vincent and the Grenadines,2008,0,0,0
KOR,Korea,VCT,Saint Vincent and the Grenadines,2009,0,0,0
KOR,Korea,VCT,Saint Vincent and the Grenadines,2010,0,0,0
KOR,Korea,VCT,Saint Vincent and the Grenadines,2011,0,1,-1
KOR,Korea,VCT,Saint Vincent and the Grenadines,2012,1,0,1
KOR,Korea,VCT,Saint Vincent and the Grenadines,2013,0,0,0
KOR,Korea,VCT,Saint Vincent and the Grenadines,2014,0,0,0
KOR,Korea,VCT,Saint Vincent and the Grenadines,2015,0,0,0
KOR,Korea,VCT,Saint Vincent and the Grenadines,2016,0,0,0
KOR,Korea,VCT,Saint Vincent and the Grenadines,2017,2,1,1
LUX,Luxembourg,VCT,Saint Vincent and the Grenadines,2008,0,0,0
LUX,Luxembourg,VCT,Saint Vincent and the Grenadines,2009,0,0,0
LUX,Luxembourg,VCT,Saint Vincent and the Grenadines,2010,0,0,0
LUX,Luxembourg,VCT,Saint Vincent and the Grenadines,2011,0,0,0
LUX,Luxembourg,VCT,Saint Vincent and the Grenadines,2012,0,0,0
LUX,Luxembourg,VCT,Saint Vincent and the Grenadines,2013,0,0,0
LUX,Luxembourg,VCT,Saint Vincent and the Grenadines,2014,0,0,0
LUX,Luxembourg,VCT,Saint Vincent and the Grenadines,2015,0,0,0
LUX,Luxembourg,VCT,Saint Vincent and the Grenadines,2016,0,0,0
LUX,Luxembourg,VCT,Saint Vincent and the Grenadines,2017,0,0,0
MEX,Mexico,VCT,Saint Vincent and the Grenadines,2008,0,1,-1
MEX,Mexico,VCT,Saint Vincent and the Grenadines,2009,0,1,-1
MEX,Mexico,VCT,Saint Vincent and the Grenadines,2010,0,3,-3
MEX,Mexico,VCT,Saint Vincent and the Grenadines,2011,0,1,-1
MEX,Mexico,VCT,Saint Vincent and the Grenadines,2012,0,1,-1
MEX,Mexico,VCT,Saint Vincent and the Grenadines,2013,0,8,-8
MEX,Mexico,VCT,Saint Vincent and the Grenadines,2014,0,2,-2
MEX,Mexico,VCT,Saint Vincent and the Grenadines,2015,0,1,-1
MEX,Mexico,VCT,Saint Vincent and the Grenadines,2016,0,2,-2
MEX,Mexico,VCT,Saint Vincent and the Grenadines,2017,0,1,-1
NLD,Netherlands,VCT,Saint Vincent and the Grenadines,2008,3,2,1
NLD,Netherlands,VCT,Saint Vincent and the Grenadines,2009,0,12,-12
NLD,Netherlands,VCT,Saint Vincent and the Grenadines,2010,0,2,-2
NLD,Netherlands,VCT,Saint Vincent and the Grenadines,2011,1,1,0
NLD,Netherlands,VCT,Saint Vincent and the Grenadines,2013,1,0,1
NLD,Netherlands,VCT,Saint Vincent and the Grenadines,2015,1,0,1
NLD,Netherlands,VCT,Saint Vincent and the Grenadines,2016,0,2,-2
NLD,Netherlands,VCT,Saint Vincent and the Grenadines,2017,0,1,-1
NZL,New Zealand,VCT,Saint Vincent and the Grenadines,2008,1,3,-2
NZL,New Zealand,VCT,Saint Vincent and the Grenadines,2009,0,1,-1
NZL,New Zealand,VCT,Saint Vincent and the Grenadines,2010,0,2,-2
NZL,New Zealand,VCT,Saint Vincent and the Grenadines,2011,2,2,0
NZL,New Zealand,VCT,Saint Vincent and the Grenadines,2013,0,1,-1
NZL,New Zealand,VCT,Saint Vincent and the Grenadines,2015,0,1,-1
NZL,New Zealand,VCT,Saint Vincent and the Grenadines,2017,0,2,-2
NOR,Norway,VCT,Saint Vincent and the Grenadines,2008,0,0,0
NOR,Norway,VCT,Saint Vincent and the Grenadines,2009,0,0,0
NOR,Norway,VCT,Saint Vincent and the Grenadines,2010,0,0,0
NOR,Norway,VCT,Saint Vincent and the Grenadines,2011,0,0,0
NOR,Norway,VCT,Saint Vincent and the Grenadines,2012,0,1,-1
NOR,Norway,VCT,Saint Vincent and the Grenadines,2013,0,0,0
NOR,Norway,VCT,Saint Vincent and the Grenadines,2014,0,0,0
NOR,Norway,VCT,Saint Vincent and the Grenadines,2015,0,0,0
NOR,Norway,VCT,Saint Vincent and the Grenadines,2016,0,0,0
NOR,Norway,VCT,Saint Vincent and the Grenadines,2017,0,0,0
POL,Poland,VCT,Saint Vincent and the Grenadines,2009,0,0,0
POL,Poland,VCT,Saint Vincent and the Grenadines,2010,0,0,0
POL,Poland,VCT,Saint Vincent and the Grenadines,2011,0,1,-1
POL,Poland,VCT,Saint Vincent and the Grenadines,2012,0,1,-1
POL,Poland,VCT,Saint Vincent and the Grenadines,2013,0,0,0
POL,Poland,VCT,Saint Vincent and the Grenadines,2014,0,0,0
POL,Poland,VCT,Saint Vincent and the Grenadines,2015,0,0,0
POL,Poland,VCT,Saint Vincent and the Grenadines,2016,0,0,0
POL,Poland,VCT,Saint Vincent and the Grenadines,2017,0,1,-1
SVK,Slovak Republic,VCT,Saint Vincent and the Grenadines,2008,0,0,0
ESP,Spain,VCT,Saint Vincent and the Grenadines,2008,0,0,0
ESP,Spain,VCT,Saint Vincent and the Grenadines,2009,0,3,-3
ESP,Spain,VCT,Saint Vincent and the Grenadines,2010,0,0,0
ESP,Spain,VCT,Saint Vincent and the Grenadines,2011,0,3,-3
ESP,Spain,VCT,Saint Vincent and the Grenadines,2012,0,1,-1
ESP,Spain,VCT,Saint Vincent and the Grenadines,2013,0,2,-2
ESP,Spain,VCT,Saint Vincent and the Grenadines,2014,0,3,-3
ESP,Spain,VCT,Saint Vincent and the Grenadines,2015,0,1,-1
ESP,Spain,VCT,Saint Vincent and the Grenadines,2016,0,1,-1
ESP,Spain,VCT,Saint Vincent and the Grenadines,2017,0,5,-5
SWE,Sweden,VCT,Saint Vincent and the Grenadines,2008,0,1,-1
SWE,Sweden,VCT,Saint Vincent and the Grenadines,2009,0,0,0
SWE,Sweden,VCT,Saint Vincent and the Grenadines,2010,1,0,1
SWE,Sweden,VCT,Saint Vincent and the Grenadines,2011,0,1,-1
SWE,Sweden,VCT,Saint Vincent and the Grenadines,2012,0,0,0
SWE,Sweden,VCT,Saint Vincent and the Grenadines,2013,0,0,0
SWE,Sweden,VCT,Saint Vincent and the Grenadines,2014,0,0,0
SWE,Sweden,VCT,Saint Vincent and the Grenadines,2015,0,1,-1
SWE,Sweden,VCT,Saint Vincent and the Grenadines,2016,0,2,-2
SWE,Sweden,VCT,Saint Vincent and the Grenadines,2017,1,1,0
CHE,Switzerland,VCT,Saint Vincent and the Grenadines,2010,1,0,1
CHE,Switzerland,VCT,Saint Vincent and the Grenadines,2011,0,0,0
CHE,Switzerland,VCT,Saint Vincent and the Grenadines,2012,0,0,0
CHE,Switzerland,VCT,Saint Vincent and the Grenadines,2013,1,0,1
CHE,Switzerland,VCT,Saint Vincent and the Grenadines,2014,1,0,1
CHE,Switzerland,VCT,Saint Vincent and the Grenadines,2015,1,0,1
CHE,Switzerland,VCT,Saint Vincent and the Grenadines,2016,0,1,-1
CHE,Switzerland,VCT,Saint Vincent and the Grenadines,2017,1,0,1
USA,United States,VCT,Saint Vincent and the Grenadines,2008,0,568,-568
USA,United States,VCT,Saint Vincent and the Grenadines,2009,0,591,-591
USA,United States,VCT,Saint Vincent and the Grenadines,2010,0,576,-576
USA,United States,VCT,Saint Vincent and the Grenadines,2011,0,468,-468
USA,United States,VCT,Saint Vincent and the Grenadines,2012,0,503,-503
USA,United States,VCT,Saint Vincent and the Grenadines,2013,0,529,-529
USA,United States,VCT,Saint Vincent and the Grenadines,2014,0,448,-448
USA,United States,VCT,Saint Vincent and the Grenadines,2015,0,415,-415
USA,United States,VCT,Saint Vincent and the Grenadines,2016,0,422,-422
USA,United States,VCT,Saint Vincent and the Grenadines,2017,0,361,-361
CHL,Chile,VCT,Saint Vincent and the Grenadines,2008,0,0,0
CHL,Chile,VCT,Saint Vincent and the Grenadines,2009,0,1,-1
CHL,Chile,VCT,Saint Vincent and the Grenadines,2010,0,0,0
CHL,Chile,VCT,Saint Vincent and the Grenadines,2011,0,0,0
CHL,Chile,VCT,Saint Vincent and the Grenadines,2012,0,0,0
CHL,Chile,VCT,Saint Vincent and the Grenadines,2013,0,1,-1
CHL,Chile,VCT,Saint Vincent and the Grenadines,2014,0,0,0
CHL,Chile,VCT,Saint Vincent and the Grenadines,2015,0,0,0
CHL,Chile,VCT,Saint Vincent and the Grenadines,2016,0,0,0
EST,Estonia,VCT,Saint Vincent and the Grenadines,2008,0,0,0
EST,Estonia,VCT,Saint Vincent and the Grenadines,2009,0,0,0
EST,Estonia,VCT,Saint Vincent and the Grenadines,2010,0,0,0
EST,Estonia,VCT,Saint Vincent and the Grenadines,2011,0,0,0
EST,Estonia,VCT,Saint Vincent and the Grenadines,2012,0,0,0
EST,Estonia,VCT,Saint Vincent and the Grenadines,2013,0,0,0
EST,Estonia,VCT,Saint Vincent and the Grenadines,2014,0,0,0
EST,Estonia,VCT,Saint Vincent and the Grenadines,2015,0,0,0
EST,Estonia,VCT,Saint Vincent and the Grenadines,2016,0,0,0
EST,Estonia,VCT,Saint Vincent and the Grenadines,2017,0,0,0
AUS,Australia,WSM,Samoa,2008,106,57,49
AUS,Australia,WSM,Samoa,2009,101,72,29
AUS,Australia,WSM,Samoa,2010,116,98,18
AUS,Australia,WSM,Samoa,2011,99,58,41
AUS,Australia,WSM,Samoa,2012,83,75,8
AUS,Australia,WSM,Samoa,2013,89,76,13
AUS,Australia,WSM,Samoa,2014,69,65,4
AUS,Australia,WSM,Samoa,2015,100,56,44
AUS,Australia,WSM,Samoa,2016,100,46,54
AUS,Australia,WSM,Samoa,2017,0,42,-42
AUT,Austria,WSM,Samoa,2008,0,0,0
AUT,Austria,WSM,Samoa,2009,0,0,0
AUT,Austria,WSM,Samoa,2010,1,0,1
AUT,Austria,WSM,Samoa,2011,0,1,-1
AUT,Austria,WSM,Samoa,2012,0,0,0
AUT,Austria,WSM,Samoa,2013,0,0,0
AUT,Austria,WSM,Samoa,2014,0,0,0
AUT,Austria,WSM,Samoa,2015,0,0,0
AUT,Austria,WSM,Samoa,2016,0,0,0
AUT,Austria,WSM,Samoa,2017,0,1,-1
BEL,Belgium,WSM,Samoa,2010,0,0,0
BEL,Belgium,WSM,Samoa,2012,0,1,-1
BEL,Belgium,WSM,Samoa,2015,0,3,-3
CAN,Canada,WSM,Samoa,2008,0,4,-4
CAN,Canada,WSM,Samoa,2009,0,2,-2
CAN,Canada,WSM,Samoa,2010,0,5,-5
CAN,Canada,WSM,Samoa,2011,0,3,-3
CAN,Canada,WSM,Samoa,2012,0,2,-2
CAN,Canada,WSM,Samoa,2013,0,0,0
CAN,Canada,WSM,Samoa,2014,0,1,-1
CAN,Canada,WSM,Samoa,2015,0,0,0
CAN,Canada,WSM,Samoa,2016,0,5,-5
CAN,Canada,WSM,Samoa,2017,0,0,0
CZE,Czech Republic,WSM,Samoa,2011,0,1,-1
CZE,Czech Republic,WSM,Samoa,2013,0,1,-1
DNK,Denmark,WSM,Samoa,2008,0,1,-1
DNK,Denmark,WSM,Samoa,2009,0,0,0
DNK,Denmark,WSM,Samoa,2011,0,1,-1
DNK,Denmark,WSM,Samoa,2012,0,0,0
DNK,Denmark,WSM,Samoa,2013,0,1,-1
DNK,Denmark,WSM,Samoa,2014,0,0,0
DNK,Denmark,WSM,Samoa,2015,1,1,0
DNK,Denmark,WSM,Samoa,2016,0,0,0
DNK,Denmark,WSM,Samoa,2017,0,0,0
FIN,Finland,WSM,Samoa,2008,0,0,0
FIN,Finland,WSM,Samoa,2009,0,0,0
FIN,Finland,WSM,Samoa,2010,0,0,0
FIN,Finland,WSM,Samoa,2011,0,0,0
FIN,Finland,WSM,Samoa,2012,0,0,0
FIN,Finland,WSM,Samoa,2013,0,0,0
FIN,Finland,WSM,Samoa,2014,0,0,0
FIN,Finland,WSM,Samoa,2015,0,0,0
FIN,Finland,WSM,Samoa,2016,0,0,0
FIN,Finland,WSM,Samoa,2017,0,0,0
FRA,France,WSM,Samoa,2008,0,12,-12
FRA,France,WSM,Samoa,2009,0,4,-4
FRA,France,WSM,Samoa,2010,0,4,-4
FRA,France,WSM,Samoa,2011,0,5,-5
FRA,France,WSM,Samoa,2012,0,5,-5
FRA,France,WSM,Samoa,2013,0,4,-4
FRA,France,WSM,Samoa,2014,0,7,-7
FRA,France,WSM,Samoa,2015,0,6,-6
FRA,France,WSM,Samoa,2016,0,11,-11
FRA,France,WSM,Samoa,2017,0,2,-2
DEU,Germany,WSM,Samoa,2008,2,7,-5
DEU,Germany,WSM,Samoa,2009,2,1,1
DEU,Germany,WSM,Samoa,2010,2,3,-1
DEU,Germany,WSM,Samoa,2011,3,0,3
DEU,Germany,WSM,Samoa,2012,0,2,-2
DEU,Germany,WSM,Samoa,2013,1,1,0
DEU,Germany,WSM,Samoa,2014,2,4,-2
DEU,Germany,WSM,Samoa,2015,0,7,-7
DEU,Germany,WSM,Samoa,2016,5,4,1
DEU,Germany,WSM,Samoa,2017,0,4,-4
HUN,Hungary,WSM,Samoa,2008,1,0,1
HUN,Hungary,WSM,Samoa,2009,0,0,0
HUN,Hungary,WSM,Samoa,2010,0,0,0
HUN,Hungary,WSM,Samoa,2011,0,0,0
HUN,Hungary,WSM,Samoa,2012,0,0,0
HUN,Hungary,WSM,Samoa,2013,0,0,0
HUN,Hungary,WSM,Samoa,2014,0,0,0
HUN,Hungary,WSM,Samoa,2015,0,0,0
HUN,Hungary,WSM,Samoa,2016,0,0,0
HUN,Hungary,WSM,Samoa,2017,0,0,0
ISL,Iceland,WSM,Samoa,2016,0,0,0
ISL,Iceland,WSM,Samoa,2017,0,0,0
ITA,Italy,WSM,Samoa,2008,5,5,0
ITA,Italy,WSM,Samoa,2009,7,3,4
ITA,Italy,WSM,Samoa,2010,0,1,-1
ITA,Italy,WSM,Samoa,2011,0,1,-1
ITA,Italy,WSM,Samoa,2012,0,4,-4
ITA,Italy,WSM,Samoa,2013,0,0,0
ITA,Italy,WSM,Samoa,2014,0,3,-3
ITA,Italy,WSM,Samoa,2015,0,2,-2
ITA,Italy,WSM,Samoa,2016,0,3,-3
ITA,Italy,WSM,Samoa,2017,2,3,-1
JPN,Japan,WSM,Samoa,2008,59,53,6
JPN,Japan,WSM,Samoa,2009,71,79,-8
JPN,Japan,WSM,Samoa,2010,66,62,4
JPN,Japan,WSM,Samoa,2011,60,55,5
JPN,Japan,WSM,Samoa,2012,58,63,-5
JPN,Japan,WSM,Samoa,2013,47,47,0
JPN,Japan,WSM,Samoa,2014,54,60,-6
JPN,Japan,WSM,Samoa,2015,58,75,-17
JPN,Japan,WSM,Samoa,2016,57,61,-4
JPN,Japan,WSM,Samoa,2017,84,84,0
KOR,Korea,WSM,Samoa,2008,1,1,0
KOR,Korea,WSM,Samoa,2009,1,5,-4
KOR,Korea,WSM,Samoa,2010,5,1,4
KOR,Korea,WSM,Samoa,2011,1,0,1
KOR,Korea,WSM,Samoa,2012,3,2,1
KOR,Korea,WSM,Samoa,2013,1,1,0
KOR,Korea,WSM,Samoa,2014,7,7,0
KOR,Korea,WSM,Samoa,2015,8,9,-1
KOR,Korea,WSM,Samoa,2016,1,0,1
KOR,Korea,WSM,Samoa,2017,3,0,3
LUX,Luxembourg,WSM,Samoa,2008,0,0,0
LUX,Luxembourg,WSM,Samoa,2009,0,0,0
LUX,Luxembourg,WSM,Samoa,2010,0,0,0
LUX,Luxembourg,WSM,Samoa,2011,0,0,0
LUX,Luxembourg,WSM,Samoa,2012,0,0,0
LUX,Luxembourg,WSM,Samoa,2013,0,0,0
LUX,Luxembourg,WSM,Samoa,2014,0,0,0
LUX,Luxembourg,WSM,Samoa,2015,0,0,0
LUX,Luxembourg,WSM,Samoa,2016,0,1,-1
LUX,Luxembourg,WSM,Samoa,2017,0,0,0
MEX,Mexico,WSM,Samoa,2012,0,1,-1
MEX,Mexico,WSM,Samoa,2013,0,0,0
MEX,Mexico,WSM,Samoa,2014,0,1,-1
NLD,Netherlands,WSM,Samoa,2010,0,1,-1
NLD,Netherlands,WSM,Samoa,2011,0,5,-5
NLD,Netherlands,WSM,Samoa,2012,0,4,-4
NLD,Netherlands,WSM,Samoa,2015,5,1,4
NLD,Netherlands,WSM,Samoa,2016,1,0,1
NZL,New Zealand,WSM,Samoa,2008,453,1267,-814
NZL,New Zealand,WSM,Samoa,2009,487,1193,-706
NZL,New Zealand,WSM,Samoa,2010,555,1040,-485
NZL,New Zealand,WSM,Samoa,2011,482,1489,-1007
NZL,New Zealand,WSM,Samoa,2012,444,1427,-983
NZL,New Zealand,WSM,Samoa,2013,338,1355,-1017
NZL,New Zealand,WSM,Samoa,2014,239,1528,-1289
NZL,New Zealand,WSM,Samoa,2015,244,1668,-1424
NZL,New Zealand,WSM,Samoa,2016,188,1653,-1465
NZL,New Zealand,WSM,Samoa,2017,186,1884,-1698
NOR,Norway,WSM,Samoa,2008,0,0,0
NOR,Norway,WSM,Samoa,2009,0,0,0
NOR,Norway,WSM,Samoa,2010,0,0,0
NOR,Norway,WSM,Samoa,2011,0,0,0
NOR,Norway,WSM,Samoa,2012,0,0,0
NOR,Norway,WSM,Samoa,2013,0,0,0
NOR,Norway,WSM,Samoa,2014,0,0,0
NOR,Norway,WSM,Samoa,2015,0,0,0
NOR,Norway,WSM,Samoa,2016,0,0,0
NOR,Norway,WSM,Samoa,2017,0,0,0
POL,Poland,WSM,Samoa,2009,0,2,-2
POL,Poland,WSM,Samoa,2010,0,0,0
POL,Poland,WSM,Samoa,2011,0,0,0
POL,Poland,WSM,Samoa,2012,0,0,0
POL,Poland,WSM,Samoa,2013,0,0,0
POL,Poland,WSM,Samoa,2014,0,0,0
POL,Poland,WSM,Samoa,2015,0,0,0
POL,Poland,WSM,Samoa,2016,0,0,0
POL,Poland,WSM,Samoa,2017,0,0,0
SVK,Slovak Republic,WSM,Samoa,2008,0,0,0
ESP,Spain,WSM,Samoa,2008,0,0,0
ESP,Spain,WSM,Samoa,2009,0,0,0
ESP,Spain,WSM,Samoa,2010,0,1,-1
ESP,Spain,WSM,Samoa,2011,0,0,0
ESP,Spain,WSM,Samoa,2012,0,0,0
ESP,Spain,WSM,Samoa,2013,0,1,-1
ESP,Spain,WSM,Samoa,2014,0,0,0
ESP,Spain,WSM,Samoa,2015,1,1,0
ESP,Spain,WSM,Samoa,2016,0,0,0
ESP,Spain,WSM,Samoa,2017,0,1,-1
SWE,Sweden,WSM,Samoa,2008,0,0,0
SWE,Sweden,WSM,Samoa,2009,0,2,-2
SWE,Sweden,WSM,Samoa,2010,0,0,0
SWE,Sweden,WSM,Samoa,2011,0,0,0
SWE,Sweden,WSM,Samoa,2012,1,1,0
SWE,Sweden,WSM,Samoa,2013,0,0,0
SWE,Sweden,WSM,Samoa,2014,1,0,1
SWE,Sweden,WSM,Samoa,2015,0,0,0
SWE,Sweden,WSM,Samoa,2016,0,3,-3
SWE,Sweden,WSM,Samoa,2017,1,0,1
CHE,Switzerland,WSM,Samoa,2010,0,0,0
CHE,Switzerland,WSM,Samoa,2011,0,0,0
CHE,Switzerland,WSM,Samoa,2012,0,3,-3
CHE,Switzerland,WSM,Samoa,2013,1,1,0
CHE,Switzerland,WSM,Samoa,2015,1,0,1
CHE,Switzerland,WSM,Samoa,2016,0,0,0
CHE,Switzerland,WSM,Samoa,2017,0,0,0
USA,United States,WSM,Samoa,2008,0,227,-227
USA,United States,WSM,Samoa,2009,0,250,-250
USA,United States,WSM,Samoa,2010,0,219,-219
USA,United States,WSM,Samoa,2011,0,267,-267
USA,United States,WSM,Samoa,2012,0,238,-238
USA,United States,WSM,Samoa,2013,0,237,-237
USA,United States,WSM,Samoa,2014,0,239,-239
USA,United States,WSM,Samoa,2015,0,207,-207
USA,United States,WSM,Samoa,2016,0,219,-219
USA,United States,WSM,Samoa,2017,0,194,-194
CHL,Chile,WSM,Samoa,2008,0,0,0
CHL,Chile,WSM,Samoa,2009,0,1,-1
CHL,Chile,WSM,Samoa,2010,0,0,0
CHL,Chile,WSM,Samoa,2011,0,0,0
CHL,Chile,WSM,Samoa,2012,0,0,0
CHL,Chile,WSM,Samoa,2013,0,0,0
CHL,Chile,WSM,Samoa,2014,0,0,0
CHL,Chile,WSM,Samoa,2015,0,0,0
CHL,Chile,WSM,Samoa,2016,0,0,0
EST,Estonia,WSM,Samoa,2008,0,0,0
EST,Estonia,WSM,Samoa,2009,0,0,0
EST,Estonia,WSM,Samoa,2010,0,0,0
EST,Estonia,WSM,Samoa,2011,0,0,0
EST,Estonia,WSM,Samoa,2012,0,0,0
EST,Estonia,WSM,Samoa,2013,0,0,0
EST,Estonia,WSM,Samoa,2014,0,0,0
EST,Estonia,WSM,Samoa,2015,0,0,0
EST,Estonia,WSM,Samoa,2016,0,0,0
EST,Estonia,WSM,Samoa,2017,0,0,0
AUS,Australia,SMR,San Marino,2008,0,0,0
AUS,Australia,SMR,San Marino,2009,0,0,0
AUS,Australia,SMR,San Marino,2010,0,0,0
AUS,Australia,SMR,San Marino,2011,0,0,0
AUS,Australia,SMR,San Marino,2012,0,0,0
AUS,Australia,SMR,San Marino,2013,0,0,0
AUS,Australia,SMR,San Marino,2014,0,0,0
AUS,Australia,SMR,San Marino,2015,0,0,0
AUS,Australia,SMR,San Marino,2016,0,0,0
AUS,Australia,SMR,San Marino,2017,0,3,-3
AUT,Austria,SMR,San Marino,2008,1,0,1
AUT,Austria,SMR,San Marino,2009,0,0,0
AUT,Austria,SMR,San Marino,2010,0,0,0
AUT,Austria,SMR,San Marino,2011,0,0,0
AUT,Austria,SMR,San Marino,2012,0,0,0
AUT,Austria,SMR,San Marino,2013,0,0,0
AUT,Austria,SMR,San Marino,2014,0,0,0
AUT,Austria,SMR,San Marino,2015,0,1,-1
AUT,Austria,SMR,San Marino,2016,1,0,1
AUT,Austria,SMR,San Marino,2017,1,1,0
BEL,Belgium,SMR,San Marino,2008,0,0,0
BEL,Belgium,SMR,San Marino,2009,0,2,-2
BEL,Belgium,SMR,San Marino,2010,2,0,2
BEL,Belgium,SMR,San Marino,2012,0,1,-1
BEL,Belgium,SMR,San Marino,2014,0,1,-1
BEL,Belgium,SMR,San Marino,2015,1,1,0
BEL,Belgium,SMR,San Marino,2017,0,1,-1
CAN,Canada,SMR,San Marino,2008,0,0,0
CAN,Canada,SMR,San Marino,2009,0,0,0
CAN,Canada,SMR,San Marino,2010,0,0,0
CAN,Canada,SMR,San Marino,2011,0,0,0
CAN,Canada,SMR,San Marino,2012,0,0,0
CAN,Canada,SMR,San Marino,2013,0,0,0
CAN,Canada,SMR,San Marino,2014,0,0,0
CAN,Canada,SMR,San Marino,2015,0,0,0
CAN,Canada,SMR,San Marino,2016,0,0,0
CAN,Canada,SMR,San Marino,2017,0,0,0
DNK,Denmark,SMR,San Marino,2008,0,0,0
DNK,Denmark,SMR,San Marino,2009,0,0,0
DNK,Denmark,SMR,San Marino,2012,0,1,-1
DNK,Denmark,SMR,San Marino,2013,0,0,0
DNK,Denmark,SMR,San Marino,2014,0,0,0
DNK,Denmark,SMR,San Marino,2015,0,0,0
DNK,Denmark,SMR,San Marino,2016,0,0,0
DNK,Denmark,SMR,San Marino,2017,1,0,1
FIN,Finland,SMR,San Marino,2008,0,0,0
FIN,Finland,SMR,San Marino,2009,0,0,0
FIN,Finland,SMR,San Marino,2010,0,0,0
FIN,Finland,SMR,San Marino,2011,0,0,0
FIN,Finland,SMR,San Marino,2012,0,0,0
FIN,Finland,SMR,San Marino,2013,0,0,0
FIN,Finland,SMR,San Marino,2014,0,0,0
FIN,Finland,SMR,San Marino,2015,0,0,0
FIN,Finland,SMR,San Marino,2016,0,0,0
FIN,Finland,SMR,San Marino,2017,0,0,0
FRA,France,SMR,San Marino,2008,0,2,-2
FRA,France,SMR,San Marino,2009,0,2,-2
FRA,France,SMR,San Marino,2010,0,0,0
FRA,France,SMR,San Marino,2011,0,0,0
FRA,France,SMR,San Marino,2012,0,0,0
FRA,France,SMR,San Marino,2013,0,0,0
FRA,France,SMR,San Marino,2014,0,0,0
FRA,France,SMR,San Marino,2015,0,1,-1
FRA,France,SMR,San Marino,2016,0,2,-2
FRA,France,SMR,San Marino,2017,0,1,-1
DEU,Germany,SMR,San Marino,2008,4,1,3
DEU,Germany,SMR,San Marino,2009,7,5,2
DEU,Germany,SMR,San Marino,2010,4,8,-4
DEU,Germany,SMR,San Marino,2011,3,6,-3
DEU,Germany,SMR,San Marino,2012,3,8,-5
DEU,Germany,SMR,San Marino,2013,4,13,-9
DEU,Germany,SMR,San Marino,2014,5,13,-8
DEU,Germany,SMR,San Marino,2015,4,9,-5
DEU,Germany,SMR,San Marino,2016,6,7,-1
DEU,Germany,SMR,San Marino,2017,1,5,-4
HUN,Hungary,SMR,San Marino,2008,0,0,0
HUN,Hungary,SMR,San Marino,2009,0,0,0
HUN,Hungary,SMR,San Marino,2010,0,0,0
HUN,Hungary,SMR,San Marino,2011,0,0,0
HUN,Hungary,SMR,San Marino,2012,0,0,0
HUN,Hungary,SMR,San Marino,2013,0,0,0
HUN,Hungary,SMR,San Marino,2014,0,0,0
HUN,Hungary,SMR,San Marino,2015,0,0,0
HUN,Hungary,SMR,San Marino,2016,0,0,0
HUN,Hungary,SMR,San Marino,2017,0,0,0
ISL,Iceland,SMR,San Marino,2016,0,0,0
ISL,Iceland,SMR,San Marino,2017,0,2,-2
ITA,Italy,SMR,San Marino,2008,8,49,-41
ITA,Italy,SMR,San Marino,2009,7,24,-17
ITA,Italy,SMR,San Marino,2010,4,38,-34
ITA,Italy,SMR,San Marino,2011,7,27,-20
ITA,Italy,SMR,San Marino,2012,11,28,-17
ITA,Italy,SMR,San Marino,2013,6,27,-21
ITA,Italy,SMR,San Marino,2014,13,30,-17
ITA,Italy,SMR,San Marino,2015,16,18,-2
ITA,Italy,SMR,San Marino,2016,0,24,-24
ITA,Italy,SMR,San Marino,2017,11,26,-15
JPN,Japan,SMR,San Marino,2008,2,3,-1
JPN,Japan,SMR,San Marino,2009,2,1,1
JPN,Japan,SMR,San Marino,2010,2,2,0
JPN,Japan,SMR,San Marino,2011,2,2,0
JPN,Japan,SMR,San Marino,2012,2,2,0
JPN,Japan,SMR,San Marino,2013,1,2,-1
JPN,Japan,SMR,San Marino,2014,3,2,1
JPN,Japan,SMR,San Marino,2015,2,2,0
JPN,Japan,SMR,San Marino,2016,2,4,-2
JPN,Japan,SMR,San Marino,2017,2,1,1
KOR,Korea,SMR,San Marino,2008,0,0,0
KOR,Korea,SMR,San Marino,2009,0,1,-1
KOR,Korea,SMR,San Marino,2010,0,0,0
KOR,Korea,SMR,San Marino,2011,0,0,0
KOR,Korea,SMR,San Marino,2012,0,0,0
KOR,Korea,SMR,San Marino,2013,0,0,0
KOR,Korea,SMR,San Marino,2014,0,0,0
KOR,Korea,SMR,San Marino,2015,1,0,1
KOR,Korea,SMR,San Marino,2016,0,0,0
KOR,Korea,SMR,San Marino,2017,0,0,0
LUX,Luxembourg,SMR,San Marino,2008,0,0,0
LUX,Luxembourg,SMR,San Marino,2009,0,0,0
LUX,Luxembourg,SMR,San Marino,2010,0,0,0
LUX,Luxembourg,SMR,San Marino,2011,0,0,0
LUX,Luxembourg,SMR,San Marino,2012,0,1,-1
LUX,Luxembourg,SMR,San Marino,2013,0,1,-1
LUX,Luxembourg,SMR,San Marino,2014,1,0,1
LUX,Luxembourg,SMR,San Marino,2015,0,1,-1
LUX,Luxembourg,SMR,San Marino,2016,0,0,0
LUX,Luxembourg,SMR,San Marino,2017,0,0,0
MEX,Mexico,SMR,San Marino,2012,0,0,0
MEX,Mexico,SMR,San Marino,2013,0,0,0
MEX,Mexico,SMR,San Marino,2014,0,0,0
NLD,Netherlands,SMR,San Marino,2014,0,1,-1
NLD,Netherlands,SMR,San Marino,2015,1,0,1
NLD,Netherlands,SMR,San Marino,2016,1,1,0
NOR,Norway,SMR,San Marino,2008,0,0,0
NOR,Norway,SMR,San Marino,2009,0,1,-1
NOR,Norway,SMR,San Marino,2010,0,1,-1
NOR,Norway,SMR,San Marino,2011,0,0,0
NOR,Norway,SMR,San Marino,2012,0,0,0
NOR,Norway,SMR,San Marino,2013,0,0,0
NOR,Norway,SMR,San Marino,2014,0,0,0
NOR,Norway,SMR,San Marino,2015,0,1,-1
NOR,Norway,SMR,San Marino,2016,0,0,0
NOR,Norway,SMR,San Marino,2017,0,0,0
POL,Poland,SMR,San Marino,2009,0,0,0
POL,Poland,SMR,San Marino,2010,0,0,0
POL,Poland,SMR,San Marino,2011,0,0,0
POL,Poland,SMR,San Marino,2012,0,0,0
POL,Poland,SMR,San Marino,2013,0,0,0
POL,Poland,SMR,San Marino,2014,0,0,0
POL,Poland,SMR,San Marino,2015,0,0,0
POL,Poland,SMR,San Marino,2016,0,0,0
POL,Poland,SMR,San Marino,2017,0,0,0
SVK,Slovak Republic,SMR,San Marino,2008,0,0,0
ESP,Spain,SMR,San Marino,2008,4,5,-1
ESP,Spain,SMR,San Marino,2009,4,6,-2
ESP,Spain,SMR,San Marino,2010,3,1,2
ESP,Spain,SMR,San Marino,2011,0,2,-2
ESP,Spain,SMR,San Marino,2012,0,3,-3
ESP,Spain,SMR,San Marino,2013,0,2,-2
ESP,Spain,SMR,San Marino,2014,1,7,-6
ESP,Spain,SMR,San Marino,2015,0,0,0
ESP,Spain,SMR,San Marino,2016,1,6,-5
ESP,Spain,SMR,San Marino,2017,0,2,-2
SWE,Sweden,SMR,San Marino,2008,0,0,0
SWE,Sweden,SMR,San Marino,2009,0,0,0
SWE,Sweden,SMR,San Marino,2010,0,0,0
SWE,Sweden,SMR,San Marino,2011,0,2,-2
SWE,Sweden,SMR,San Marino,2012,1,1,0
SWE,Sweden,SMR,San Marino,2013,0,0,0
SWE,Sweden,SMR,San Marino,2014,0,0,0
SWE,Sweden,SMR,San Marino,2015,0,0,0
SWE,Sweden,SMR,San Marino,2016,0,0,0
SWE,Sweden,SMR,San Marino,2017,0,0,0
CHE,Switzerland,SMR,San Marino,2010,0,1,-1
CHE,Switzerland,SMR,San Marino,2012,0,1,-1
CHE,Switzerland,SMR,San Marino,2013,2,1,1
CHE,Switzerland,SMR,San Marino,2014,0,3,-3
CHE,Switzerland,SMR,San Marino,2015,1,2,-1
CHE,Switzerland,SMR,San Marino,2016,0,2,-2
CHE,Switzerland,SMR,San Marino,2017,1,4,-3
USA,United States,SMR,San Marino,2017,0,1,-1
CHL,Chile,SMR,San Marino,2008,0,0,0
CHL,Chile,SMR,San Marino,2009,0,0,0
CHL,Chile,SMR,San Marino,2010,0,0,0
CHL,Chile,SMR,San Marino,2011,0,1,-1
CHL,Chile,SMR,San Marino,2012,0,0,0
CHL,Chile,SMR,San Marino,2013,0,0,0
CHL,Chile,SMR,San Marino,2014,0,0,0
CHL,Chile,SMR,San Marino,2015,0,0,0
CHL,Chile,SMR,San Marino,2016,0,0,0
EST,Estonia,SMR,San Marino,2008,0,0,0
EST,Estonia,SMR,San Marino,2009,0,0,0
EST,Estonia,SMR,San Marino,2010,0,0,0
EST,Estonia,SMR,San Marino,2011,0,0,0
EST,Estonia,SMR,San Marino,2012,0,0,0
EST,Estonia,SMR,San Marino,2013,0,0,0
EST,Estonia,SMR,San Marino,2014,0,0,0
EST,Estonia,SMR,San Marino,2015,0,1,-1
EST,Estonia,SMR,San Marino,2016,0,0,0
EST,Estonia,SMR,San Marino,2017,0,0,0
AUS,Australia,STP,Sao Tome and Principe,2008,0,2,-2
AUS,Australia,STP,Sao Tome and Principe,2009,0,0,0
AUS,Australia,STP,Sao Tome and Principe,2010,0,0,0
AUS,Australia,STP,Sao Tome and Principe,2011,0,0,0
AUS,Australia,STP,Sao Tome and Principe,2012,0,0,0
AUS,Australia,STP,Sao Tome and Principe,2013,0,0,0
AUS,Australia,STP,Sao Tome and Principe,2014,0,0,0
AUS,Australia,STP,Sao Tome and Principe,2015,0,0,0
AUS,Australia,STP,Sao Tome and Principe,2016,0,0,0
AUS,Australia,STP,Sao Tome and Principe,2017,0,0,0
AUT,Austria,STP,Sao Tome and Principe,2008,0,0,0
AUT,Austria,STP,Sao Tome and Principe,2009,0,0,0
AUT,Austria,STP,Sao Tome and Principe,2010,0,0,0
AUT,Austria,STP,Sao Tome and Principe,2011,0,0,0
AUT,Austria,STP,Sao Tome and Principe,2012,0,0,0
AUT,Austria,STP,Sao Tome and Principe,2013,0,0,0
AUT,Austria,STP,Sao Tome and Principe,2014,0,0,0
AUT,Austria,STP,Sao Tome and Principe,2015,0,0,0
AUT,Austria,STP,Sao Tome and Principe,2016,0,0,0
AUT,Austria,STP,Sao Tome and Principe,2017,0,0,0
BEL,Belgium,STP,Sao Tome and Principe,2008,0,1,-1
BEL,Belgium,STP,Sao Tome and Principe,2009,0,5,-5
BEL,Belgium,STP,Sao Tome and Principe,2010,0,3,-3
BEL,Belgium,STP,Sao Tome and Principe,2012,2,1,1
BEL,Belgium,STP,Sao Tome and Principe,2013,0,2,-2
BEL,Belgium,STP,Sao Tome and Principe,2014,2,2,0
BEL,Belgium,STP,Sao Tome and Principe,2015,1,3,-2
BEL,Belgium,STP,Sao Tome and Principe,2016,0,5,-5
BEL,Belgium,STP,Sao Tome and Principe,2017,0,2,-2
CAN,Canada,STP,Sao Tome and Principe,2008,0,0,0
CAN,Canada,STP,Sao Tome and Principe,2009,0,1,-1
CAN,Canada,STP,Sao Tome and Principe,2010,0,2,-2
CAN,Canada,STP,Sao Tome and Principe,2011,0,0,0
CAN,Canada,STP,Sao Tome and Principe,2012,0,0,0
CAN,Canada,STP,Sao Tome and Principe,2013,0,1,-1
CAN,Canada,STP,Sao Tome and Principe,2014,0,1,-1
CAN,Canada,STP,Sao Tome and Principe,2015,0,0,0
CAN,Canada,STP,Sao Tome and Principe,2016,0,0,0
CAN,Canada,STP,Sao Tome and Principe,2017,0,0,0
DNK,Denmark,STP,Sao Tome and Principe,2013,0,0,0
DNK,Denmark,STP,Sao Tome and Principe,2014,0,0,0
DNK,Denmark,STP,Sao Tome and Principe,2015,0,0,0
DNK,Denmark,STP,Sao Tome and Principe,2016,0,0,0
DNK,Denmark,STP,Sao Tome and Principe,2017,0,0,0
FIN,Finland,STP,Sao Tome and Principe,2008,0,0,0
FIN,Finland,STP,Sao Tome and Principe,2009,0,0,0
FIN,Finland,STP,Sao Tome and Principe,2010,0,0,0
FIN,Finland,STP,Sao Tome and Principe,2011,0,0,0
FIN,Finland,STP,Sao Tome and Principe,2012,0,0,0
FIN,Finland,STP,Sao Tome and Principe,2013,0,0,0
FIN,Finland,STP,Sao Tome and Principe,2014,0,0,0
FIN,Finland,STP,Sao Tome and Principe,2015,0,0,0
FIN,Finland,STP,Sao Tome and Principe,2016,0,0,0
FIN,Finland,STP,Sao Tome and Principe,2017,0,0,0
FRA,France,STP,Sao Tome and Principe,2008,0,6,-6
FRA,France,STP,Sao Tome and Principe,2009,0,12,-12
FRA,France,STP,Sao Tome and Principe,2010,0,8,-8
FRA,France,STP,Sao Tome and Principe,2011,0,10,-10
FRA,France,STP,Sao Tome and Principe,2012,0,10,-10
FRA,France,STP,Sao Tome and Principe,2013,0,13,-13
FRA,France,STP,Sao Tome and Principe,2014,0,14,-14
FRA,France,STP,Sao Tome and Principe,2015,0,20,-20
FRA,France,STP,Sao Tome and Principe,2016,0,17,-17
FRA,France,STP,Sao Tome and Principe,2017,0,13,-13
DEU,Germany,STP,Sao Tome and Principe,2008,2,2,0
DEU,Germany,STP,Sao Tome and Principe,2009,5,5,0
DEU,Germany,STP,Sao Tome and Principe,2010,3,3,0
DEU,Germany,STP,Sao Tome and Principe,2011,0,5,-5
DEU,Germany,STP,Sao Tome and Principe,2012,2,3,-1
DEU,Germany,STP,Sao Tome and Principe,2013,2,4,-2
DEU,Germany,STP,Sao Tome and Principe,2014,2,8,-6
DEU,Germany,STP,Sao Tome and Principe,2015,1,5,-4
DEU,Germany,STP,Sao Tome and Principe,2016,1,0,1
DEU,Germany,STP,Sao Tome and Principe,2017,1,5,-4
HUN,Hungary,STP,Sao Tome and Principe,2008,0,0,0
HUN,Hungary,STP,Sao Tome and Principe,2009,0,0,0
HUN,Hungary,STP,Sao Tome and Principe,2010,0,0,0
HUN,Hungary,STP,Sao Tome and Principe,2011,0,0,0
HUN,Hungary,STP,Sao Tome and Principe,2012,0,0,0
HUN,Hungary,STP,Sao Tome and Principe,2013,0,0,0
HUN,Hungary,STP,Sao Tome and Principe,2014,0,0,0
HUN,Hungary,STP,Sao Tome and Principe,2015,0,0,0
HUN,Hungary,STP,Sao Tome and Principe,2016,0,0,0
HUN,Hungary,STP,Sao Tome and Principe,2017,0,0,0
ISL,Iceland,STP,Sao Tome and Principe,2008,0,0,0
ISL,Iceland,STP,Sao Tome and Principe,2009,0,0,0
ISL,Iceland,STP,Sao Tome and Principe,2010,0,0,0
ISL,Iceland,STP,Sao Tome and Principe,2011,0,0,0
ISL,Iceland,STP,Sao Tome and Principe,2012,0,0,0
ISL,Iceland,STP,Sao Tome and Principe,2016,0,0,0
ISL,Iceland,STP,Sao Tome and Principe,2017,0,0,0
ITA,Italy,STP,Sao Tome and Principe,2008,0,3,-3
ITA,Italy,STP,Sao Tome and Principe,2009,0,6,-6
ITA,Italy,STP,Sao Tome and Principe,2010,2,1,1
ITA,Italy,STP,Sao Tome and Principe,2011,0,2,-2
ITA,Italy,STP,Sao Tome and Principe,2012,1,5,-4
ITA,Italy,STP,Sao Tome and Principe,2015,0,1,-1
ITA,Italy,STP,Sao Tome and Principe,2016,0,0,0
ITA,Italy,STP,Sao Tome and Principe,2017,0,0,0
JPN,Japan,STP,Sao Tome and Principe,2008,4,4,0
JPN,Japan,STP,Sao Tome and Principe,2009,7,7,0
JPN,Japan,STP,Sao Tome and Principe,2010,8,8,0
JPN,Japan,STP,Sao Tome and Principe,2011,5,5,0
JPN,Japan,STP,Sao Tome and Principe,2012,8,8,0
JPN,Japan,STP,Sao Tome and Principe,2013,5,5,0
JPN,Japan,STP,Sao Tome and Principe,2014,5,6,-1
JPN,Japan,STP,Sao Tome and Principe,2015,4,4,0
JPN,Japan,STP,Sao Tome and Principe,2016,7,7,0
JPN,Japan,STP,Sao Tome and Principe,2017,6,9,-3
KOR,Korea,STP,Sao Tome and Principe,2008,0,0,0
KOR,Korea,STP,Sao Tome and Principe,2009,1,1,0
KOR,Korea,STP,Sao Tome and Principe,2010,0,1,-1
KOR,Korea,STP,Sao Tome and Principe,2011,0,0,0
KOR,Korea,STP,Sao Tome and Principe,2012,0,0,0
KOR,Korea,STP,Sao Tome and Principe,2013,1,0,1
KOR,Korea,STP,Sao Tome and Principe,2014,0,0,0
KOR,Korea,STP,Sao Tome and Principe,2015,0,0,0
KOR,Korea,STP,Sao Tome and Principe,2016,1,0,1
KOR,Korea,STP,Sao Tome and Principe,2017,0,0,0
LUX,Luxembourg,STP,Sao Tome and Principe,2008,0,0,0
LUX,Luxembourg,STP,Sao Tome and Principe,2009,0,4,-4
LUX,Luxembourg,STP,Sao Tome and Principe,2010,0,3,-3
LUX,Luxembourg,STP,Sao Tome and Principe,2011,0,3,-3
LUX,Luxembourg,STP,Sao Tome and Principe,2012,1,5,-4
LUX,Luxembourg,STP,Sao Tome and Principe,2013,0,0,0
LUX,Luxembourg,STP,Sao Tome and Principe,2014,0,3,-3
LUX,Luxembourg,STP,Sao Tome and Principe,2015,0,1,-1
LUX,Luxembourg,STP,Sao Tome and Principe,2016,1,3,-2
LUX,Luxembourg,STP,Sao Tome and Principe,2017,0,2,-2
MEX,Mexico,STP,Sao Tome and Principe,2012,0,0,0
MEX,Mexico,STP,Sao Tome and Principe,2013,0,1,-1
MEX,Mexico,STP,Sao Tome and Principe,2014,0,0,0
NLD,Netherlands,STP,Sao Tome and Principe,2009,0,2,-2
NLD,Netherlands,STP,Sao Tome and Principe,2011,1,1,0
NLD,Netherlands,STP,Sao Tome and Principe,2013,1,3,-2
NLD,Netherlands,STP,Sao Tome and Principe,2015,2,0,2
NLD,Netherlands,STP,Sao Tome and Principe,2016,0,1,-1
NLD,Netherlands,STP,Sao Tome and Principe,2017,0,1,-1
NOR,Norway,STP,Sao Tome and Principe,2008,0,0,0
NOR,Norway,STP,Sao Tome and Principe,2009,0,0,0
NOR,Norway,STP,Sao Tome and Principe,2010,0,0,0
NOR,Norway,STP,Sao Tome and Principe,2011,0,0,0
NOR,Norway,STP,Sao Tome and Principe,2012,0,0,0
NOR,Norway,STP,Sao Tome and Principe,2013,0,0,0
NOR,Norway,STP,Sao Tome and Principe,2014,0,0,0
NOR,Norway,STP,Sao Tome and Principe,2015,0,0,0
NOR,Norway,STP,Sao Tome and Principe,2016,0,0,0
NOR,Norway,STP,Sao Tome and Principe,2017,0,0,0
POL,Poland,STP,Sao Tome and Principe,2009,0,0,0
POL,Poland,STP,Sao Tome and Principe,2010,0,0,0
POL,Poland,STP,Sao Tome and Principe,2011,0,0,0
POL,Poland,STP,Sao Tome and Principe,2012,0,0,0
POL,Poland,STP,Sao Tome and Principe,2013,0,0,0
POL,Poland,STP,Sao Tome and Principe,2014,0,0,0
POL,Poland,STP,Sao Tome and Principe,2015,0,0,0
POL,Poland,STP,Sao Tome and Principe,2016,0,0,0
POL,Poland,STP,Sao Tome and Principe,2017,0,1,-1
PRT,Portugal,STP,Sao Tome and Principe,2008,0,1072,-1072
PRT,Portugal,STP,Sao Tome and Principe,2009,0,1072,-1072
PRT,Portugal,STP,Sao Tome and Principe,2010,0,1273,-1273
PRT,Portugal,STP,Sao Tome and Principe,2011,0,1322,-1322
PRT,Portugal,STP,Sao Tome and Principe,2012,0,1007,-1007
PRT,Portugal,STP,Sao Tome and Principe,2013,0,762,-762
PRT,Portugal,STP,Sao Tome and Principe,2014,0,582,-582
PRT,Portugal,STP,Sao Tome and Principe,2015,0,505,-505
PRT,Portugal,STP,Sao Tome and Principe,2016,0,548,-548
PRT,Portugal,STP,Sao Tome and Principe,2017,0,772,-772
SVK,Slovak Republic,STP,Sao Tome and Principe,2008,0,0,0
ESP,Spain,STP,Sao Tome and Principe,2008,14,21,-7
ESP,Spain,STP,Sao Tome and Principe,2009,18,11,7
ESP,Spain,STP,Sao Tome and Principe,2010,5,10,-5
ESP,Spain,STP,Sao Tome and Principe,2011,20,6,14
ESP,Spain,STP,Sao Tome and Principe,2012,3,4,-1
ESP,Spain,STP,Sao Tome and Principe,2013,2,11,-9
ESP,Spain,STP,Sao Tome and Principe,2014,2,5,-3
ESP,Spain,STP,Sao Tome and Principe,2015,4,8,-4
ESP,Spain,STP,Sao Tome and Principe,2016,4,11,-7
ESP,Spain,STP,Sao Tome and Principe,2017,4,8,-4
SWE,Sweden,STP,Sao Tome and Principe,2008,0,0,0
SWE,Sweden,STP,Sao Tome and Principe,2009,0,0,0
SWE,Sweden,STP,Sao Tome and Principe,2010,0,1,-1
SWE,Sweden,STP,Sao Tome and Principe,2011,0,1,-1
SWE,Sweden,STP,Sao Tome and Principe,2012,1,1,0
SWE,Sweden,STP,Sao Tome and Principe,2013,0,0,0
SWE,Sweden,STP,Sao Tome and Principe,2014,0,0,0
SWE,Sweden,STP,Sao Tome and Principe,2015,0,0,0
SWE,Sweden,STP,Sao Tome and Principe,2016,0,0,0
SWE,Sweden,STP,Sao Tome and Principe,2017,0,0,0
CHE,Switzerland,STP,Sao Tome and Principe,2010,0,1,-1
CHE,Switzerland,STP,Sao Tome and Principe,2011,0,1,-1
CHE,Switzerland,STP,Sao Tome and Principe,2012,0,1,-1
CHE,Switzerland,STP,Sao Tome and Principe,2013,0,4,-4
CHE,Switzerland,STP,Sao Tome and Principe,2015,0,0,0
CHE,Switzerland,STP,Sao Tome and Principe,2016,1,3,-2
CHE,Switzerland,STP,Sao Tome and Principe,2017,0,0,0
USA,United States,STP,Sao Tome and Principe,2008,0,7,-7
USA,United States,STP,Sao Tome and Principe,2009,0,11,-11
USA,United States,STP,Sao Tome and Principe,2010,0,10,-10
USA,United States,STP,Sao Tome and Principe,2011,0,9,-9
USA,United States,STP,Sao Tome and Principe,2012,0,12,-12
USA,United States,STP,Sao Tome and Principe,2013,0,6,-6
USA,United States,STP,Sao Tome and Principe,2014,0,5,-5
USA,United States,STP,Sao Tome and Principe,2015,0,6,-6
USA,United States,STP,Sao Tome and Principe,2016,0,12,-12
USA,United States,STP,Sao Tome and Principe,2017,0,10,-10
CHL,Chile,STP,Sao Tome and Principe,2008,0,0,0
CHL,Chile,STP,Sao Tome and Principe,2009,0,1,-1
CHL,Chile,STP,Sao Tome and Principe,2010,0,0,0
CHL,Chile,STP,Sao Tome and Principe,2011,0,0,0
CHL,Chile,STP,Sao Tome and Principe,2012,0,0,0
CHL,Chile,STP,Sao Tome and Principe,2013,0,0,0
CHL,Chile,STP,Sao Tome and Principe,2014,0,0,0
CHL,Chile,STP,Sao Tome and Principe,2015,0,0,0
CHL,Chile,STP,Sao Tome and Principe,2016,0,0,0
EST,Estonia,STP,Sao Tome and Principe,2008,0,0,0
EST,Estonia,STP,Sao Tome and Principe,2009,0,0,0
EST,Estonia,STP,Sao Tome and Principe,2010,0,0,0
EST,Estonia,STP,Sao Tome and Principe,2011,0,0,0
EST,Estonia,STP,Sao Tome and Principe,2012,0,0,0
EST,Estonia,STP,Sao Tome and Principe,2013,0,0,0
EST,Estonia,STP,Sao Tome and Principe,2014,0,0,0
EST,Estonia,STP,Sao Tome and Principe,2015,0,0,0
EST,Estonia,STP,Sao Tome and Principe,2016,0,0,0
EST,Estonia,STP,Sao Tome and Principe,2017,0,0,0
SVN,Slovenia,STP,Sao Tome and Principe,2012,0,1,-1
AUS,Australia,SAU,Saudi Arabia,2008,50,17,33
AUS,Australia,SAU,Saudi Arabia,2009,58,20,38
AUS,Australia,SAU,Saudi Arabia,2010,49,25,24
AUS,Australia,SAU,Saudi Arabia,2011,51,31,20
AUS,Australia,SAU,Saudi Arabia,2012,63,24,39
AUS,Australia,SAU,Saudi Arabia,2013,52,31,21
AUS,Australia,SAU,Saudi Arabia,2014,49,45,4
AUS,Australia,SAU,Saudi Arabia,2015,0,56,-56
AUS,Australia,SAU,Saudi Arabia,2016,100,57,43
AUS,Australia,SAU,Saudi Arabia,2017,0,54,-54
AUT,Austria,SAU,Saudi Arabia,2008,38,31,7
AUT,Austria,SAU,Saudi Arabia,2009,29,65,-36
AUT,Austria,SAU,Saudi Arabia,2010,44,59,-15
AUT,Austria,SAU,Saudi Arabia,2011,26,52,-26
AUT,Austria,SAU,Saudi Arabia,2012,31,31,0
AUT,Austria,SAU,Saudi Arabia,2013,30,115,-85
AUT,Austria,SAU,Saudi Arabia,2014,25,60,-35
AUT,Austria,SAU,Saudi Arabia,2015,60,79,-19
AUT,Austria,SAU,Saudi Arabia,2016,94,58,36
AUT,Austria,SAU,Saudi Arabia,2017,84,81,3
BEL,Belgium,SAU,Saudi Arabia,2008,0,7,-7
BEL,Belgium,SAU,Saudi Arabia,2009,0,9,-9
BEL,Belgium,SAU,Saudi Arabia,2010,10,15,-5
BEL,Belgium,SAU,Saudi Arabia,2012,13,20,-7
BEL,Belgium,SAU,Saudi Arabia,2013,13,31,-18
BEL,Belgium,SAU,Saudi Arabia,2014,22,18,4
BEL,Belgium,SAU,Saudi Arabia,2015,23,29,-6
BEL,Belgium,SAU,Saudi Arabia,2016,7,19,-12
BEL,Belgium,SAU,Saudi Arabia,2017,2,40,-38
CAN,Canada,SAU,Saudi Arabia,2008,0,249,-249
CAN,Canada,SAU,Saudi Arabia,2009,0,246,-246
CAN,Canada,SAU,Saudi Arabia,2010,0,330,-330
CAN,Canada,SAU,Saudi Arabia,2011,0,278,-278
CAN,Canada,SAU,Saudi Arabia,2012,0,286,-286
CAN,Canada,SAU,Saudi Arabia,2013,0,267,-267
CAN,Canada,SAU,Saudi Arabia,2014,0,232,-232
CAN,Canada,SAU,Saudi Arabia,2015,0,196,-196
CAN,Canada,SAU,Saudi Arabia,2016,0,175,-175
CAN,Canada,SAU,Saudi Arabia,2017,0,205,-205
CZE,Czech Republic,SAU,Saudi Arabia,2008,0,73,-73
CZE,Czech Republic,SAU,Saudi Arabia,2009,0,67,-67
CZE,Czech Republic,SAU,Saudi Arabia,2010,0,71,-71
CZE,Czech Republic,SAU,Saudi Arabia,2011,0,62,-62
CZE,Czech Republic,SAU,Saudi Arabia,2012,7,44,-37
CZE,Czech Republic,SAU,Saudi Arabia,2013,45,25,20
CZE,Czech Republic,SAU,Saudi Arabia,2014,19,44,-25
CZE,Czech Republic,SAU,Saudi Arabia,2015,21,25,-4
CZE,Czech Republic,SAU,Saudi Arabia,2016,23,35,-12
CZE,Czech Republic,SAU,Saudi Arabia,2017,37,25,12
DNK,Denmark,SAU,Saudi Arabia,2008,3,2,1
DNK,Denmark,SAU,Saudi Arabia,2009,3,0,3
DNK,Denmark,SAU,Saudi Arabia,2010,1,5,-4
DNK,Denmark,SAU,Saudi Arabia,2012,1,3,-2
DNK,Denmark,SAU,Saudi Arabia,2013,0,0,0
DNK,Denmark,SAU,Saudi Arabia,2014,1,12,-11
DNK,Denmark,SAU,Saudi Arabia,2015,7,5,2
DNK,Denmark,SAU,Saudi Arabia,2016,8,11,-3
DNK,Denmark,SAU,Saudi Arabia,2017,4,7,-3
FIN,Finland,SAU,Saudi Arabia,2008,0,0,0
FIN,Finland,SAU,Saudi Arabia,2009,0,0,0
FIN,Finland,SAU,Saudi Arabia,2010,0,0,0
FIN,Finland,SAU,Saudi Arabia,2011,0,1,-1
FIN,Finland,SAU,Saudi Arabia,2012,0,0,0
FIN,Finland,SAU,Saudi Arabia,2013,0,0,0
FIN,Finland,SAU,Saudi Arabia,2014,0,4,-4
FIN,Finland,SAU,Saudi Arabia,2015,0,3,-3
FIN,Finland,SAU,Saudi Arabia,2016,0,0,0
FIN,Finland,SAU,Saudi Arabia,2017,4,1,3
FRA,France,SAU,Saudi Arabia,2008,0,88,-88
FRA,France,SAU,Saudi Arabia,2009,0,113,-113
FRA,France,SAU,Saudi Arabia,2010,0,87,-87
FRA,France,SAU,Saudi Arabia,2011,0,96,-96
FRA,France,SAU,Saudi Arabia,2012,0,101,-101
FRA,France,SAU,Saudi Arabia,2013,0,122,-122
FRA,France,SAU,Saudi Arabia,2014,0,113,-113
FRA,France,SAU,Saudi Arabia,2015,0,80,-80
FRA,France,SAU,Saudi Arabia,2016,0,105,-105
FRA,France,SAU,Saudi Arabia,2017,0,77,-77
DEU,Germany,SAU,Saudi Arabia,2008,618,471,147
DEU,Germany,SAU,Saudi Arabia,2009,426,510,-84
DEU,Germany,SAU,Saudi Arabia,2010,393,782,-389
DEU,Germany,SAU,Saudi Arabia,2011,529,854,-325
DEU,Germany,SAU,Saudi Arabia,2012,673,1091,-418
DEU,Germany,SAU,Saudi Arabia,2013,910,1502,-592
DEU,Germany,SAU,Saudi Arabia,2014,1241,2010,-769
DEU,Germany,SAU,Saudi Arabia,2015,1949,2959,-1010
DEU,Germany,SAU,Saudi Arabia,2016,2663,2133,530
DEU,Germany,SAU,Saudi Arabia,2017,1443,1040,403
HUN,Hungary,SAU,Saudi Arabia,2008,6,126,-120
HUN,Hungary,SAU,Saudi Arabia,2009,1,87,-86
HUN,Hungary,SAU,Saudi Arabia,2010,21,88,-67
HUN,Hungary,SAU,Saudi Arabia,2011,12,70,-58
HUN,Hungary,SAU,Saudi Arabia,2012,6,32,-26
HUN,Hungary,SAU,Saudi Arabia,2013,27,50,-23
HUN,Hungary,SAU,Saudi Arabia,2014,29,45,-16
HUN,Hungary,SAU,Saudi Arabia,2015,24,90,-66
HUN,Hungary,SAU,Saudi Arabia,2016,36,40,-4
HUN,Hungary,SAU,Saudi Arabia,2017,0,80,-80
ISL,Iceland,SAU,Saudi Arabia,2008,0,0,0
ISL,Iceland,SAU,Saudi Arabia,2009,0,0,0
ISL,Iceland,SAU,Saudi Arabia,2010,0,0,0
ISL,Iceland,SAU,Saudi Arabia,2011,0,0,0
ISL,Iceland,SAU,Saudi Arabia,2012,0,1,-1
ISL,Iceland,SAU,Saudi Arabia,2013,0,0,0
ISL,Iceland,SAU,Saudi Arabia,2014,0,0,0
ISL,Iceland,SAU,Saudi Arabia,2015,0,0,0
ISL,Iceland,SAU,Saudi Arabia,2016,0,0,0
ISL,Iceland,SAU,Saudi Arabia,2017,0,0,0
ITA,Italy,SAU,Saudi Arabia,2008,1,5,-4
ITA,Italy,SAU,Saudi Arabia,2009,1,15,-14
ITA,Italy,SAU,Saudi Arabia,2010,7,32,-25
ITA,Italy,SAU,Saudi Arabia,2011,1,18,-17
ITA,Italy,SAU,Saudi Arabia,2012,1,19,-18
ITA,Italy,SAU,Saudi Arabia,2013,5,65,-60
ITA,Italy,SAU,Saudi Arabia,2014,2,19,-17
ITA,Italy,SAU,Saudi Arabia,2015,4,39,-35
ITA,Italy,SAU,Saudi Arabia,2016,0,22,-22
ITA,Italy,SAU,Saudi Arabia,2017,6,30,-24
JPN,Japan,SAU,Saudi Arabia,2008,200,239,-39
JPN,Japan,SAU,Saudi Arabia,2009,204,384,-180
JPN,Japan,SAU,Saudi Arabia,2010,257,317,-60
JPN,Japan,SAU,Saudi Arabia,2011,212,375,-163
JPN,Japan,SAU,Saudi Arabia,2012,353,505,-152
JPN,Japan,SAU,Saudi Arabia,2013,278,488,-210
JPN,Japan,SAU,Saudi Arabia,2014,590,696,-106
JPN,Japan,SAU,Saudi Arabia,2015,480,536,-56
JPN,Japan,SAU,Saudi Arabia,2016,579,630,-51
JPN,Japan,SAU,Saudi Arabia,2017,1115,1057,58
KOR,Korea,SAU,Saudi Arabia,2008,151,202,-51
KOR,Korea,SAU,Saudi Arabia,2009,157,216,-59
KOR,Korea,SAU,Saudi Arabia,2010,278,291,-13
KOR,Korea,SAU,Saudi Arabia,2011,216,865,-649
KOR,Korea,SAU,Saudi Arabia,2012,880,546,334
KOR,Korea,SAU,Saudi Arabia,2013,429,662,-233
KOR,Korea,SAU,Saudi Arabia,2014,586,343,243
KOR,Korea,SAU,Saudi Arabia,2015,291,329,-38
KOR,Korea,SAU,Saudi Arabia,2016,311,346,-35
KOR,Korea,SAU,Saudi Arabia,2017,468,352,116
LUX,Luxembourg,SAU,Saudi Arabia,2008,0,0,0
LUX,Luxembourg,SAU,Saudi Arabia,2009,0,0,0
LUX,Luxembourg,SAU,Saudi Arabia,2010,0,0,0
LUX,Luxembourg,SAU,Saudi Arabia,2011,0,0,0
LUX,Luxembourg,SAU,Saudi Arabia,2012,0,1,-1
LUX,Luxembourg,SAU,Saudi Arabia,2013,1,0,1
LUX,Luxembourg,SAU,Saudi Arabia,2014,0,3,-3
LUX,Luxembourg,SAU,Saudi Arabia,2015,3,0,3
LUX,Luxembourg,SAU,Saudi Arabia,2016,0,0,0
LUX,Luxembourg,SAU,Saudi Arabia,2017,0,1,-1
MEX,Mexico,SAU,Saudi Arabia,2010,0,1,-1
MEX,Mexico,SAU,Saudi Arabia,2012,0,1,-1
MEX,Mexico,SAU,Saudi Arabia,2013,0,0,0
MEX,Mexico,SAU,Saudi Arabia,2014,0,0,0
MEX,Mexico,SAU,Saudi Arabia,2015,0,2,-2
MEX,Mexico,SAU,Saudi Arabia,2016,0,3,-3
MEX,Mexico,SAU,Saudi Arabia,2017,0,1,-1
NLD,Netherlands,SAU,Saudi Arabia,2008,72,121,-49
NLD,Netherlands,SAU,Saudi Arabia,2009,98,231,-133
NLD,Netherlands,SAU,Saudi Arabia,2010,174,337,-163
NLD,Netherlands,SAU,Saudi Arabia,2011,176,175,1
NLD,Netherlands,SAU,Saudi Arabia,2012,135,121,14
NLD,Netherlands,SAU,Saudi Arabia,2013,170,194,-24
NLD,Netherlands,SAU,Saudi Arabia,2014,159,149,10
NLD,Netherlands,SAU,Saudi Arabia,2015,138,156,-18
NLD,Netherlands,SAU,Saudi Arabia,2016,118,176,-58
NLD,Netherlands,SAU,Saudi Arabia,2017,172,167,5
NZL,New Zealand,SAU,Saudi Arabia,2008,55,556,-501
NZL,New Zealand,SAU,Saudi Arabia,2009,61,550,-489
NZL,New Zealand,SAU,Saudi Arabia,2010,156,588,-432
NZL,New Zealand,SAU,Saudi Arabia,2011,156,490,-334
NZL,New Zealand,SAU,Saudi Arabia,2012,200,269,-69
NZL,New Zealand,SAU,Saudi Arabia,2013,211,217,-6
NZL,New Zealand,SAU,Saudi Arabia,2014,167,432,-265
NZL,New Zealand,SAU,Saudi Arabia,2015,153,216,-63
NZL,New Zealand,SAU,Saudi Arabia,2016,139,175,-36
NZL,New Zealand,SAU,Saudi Arabia,2017,107,141,-34
NOR,Norway,SAU,Saudi Arabia,2008,0,12,-12
NOR,Norway,SAU,Saudi Arabia,2009,5,7,-2
NOR,Norway,SAU,Saudi Arabia,2010,8,4,4
NOR,Norway,SAU,Saudi Arabia,2011,0,4,-4
NOR,Norway,SAU,Saudi Arabia,2012,8,1,7
NOR,Norway,SAU,Saudi Arabia,2013,1,2,-1
NOR,Norway,SAU,Saudi Arabia,2014,1,5,-4
NOR,Norway,SAU,Saudi Arabia,2015,4,4,0
NOR,Norway,SAU,Saudi Arabia,2016,4,10,-6
NOR,Norway,SAU,Saudi Arabia,2017,2,7,-5
POL,Poland,SAU,Saudi Arabia,2009,0,94,-94
POL,Poland,SAU,Saudi Arabia,2010,0,169,-169
POL,Poland,SAU,Saudi Arabia,2011,0,381,-381
POL,Poland,SAU,Saudi Arabia,2012,0,359,-359
POL,Poland,SAU,Saudi Arabia,2013,0,326,-326
POL,Poland,SAU,Saudi Arabia,2014,0,201,-201
POL,Poland,SAU,Saudi Arabia,2015,0,754,-754
POL,Poland,SAU,Saudi Arabia,2016,0,746,-746
POL,Poland,SAU,Saudi Arabia,2017,0,551,-551
SVK,Slovak Republic,SAU,Saudi Arabia,2008,6,1,5
SVK,Slovak Republic,SAU,Saudi Arabia,2009,5,67,-62
SVK,Slovak Republic,SAU,Saudi Arabia,2010,6,46,-40
SVK,Slovak Republic,SAU,Saudi Arabia,2011,2,14,-12
SVK,Slovak Republic,SAU,Saudi Arabia,2012,0,1,-1
SVK,Slovak Republic,SAU,Saudi Arabia,2013,0,1,-1
ESP,Spain,SAU,Saudi Arabia,2008,62,66,-4
ESP,Spain,SAU,Saudi Arabia,2009,56,50,6
ESP,Spain,SAU,Saudi Arabia,2010,54,110,-56
ESP,Spain,SAU,Saudi Arabia,2011,62,159,-97
ESP,Spain,SAU,Saudi Arabia,2012,113,143,-30
ESP,Spain,SAU,Saudi Arabia,2013,119,228,-109
ESP,Spain,SAU,Saudi Arabia,2014,140,204,-64
ESP,Spain,SAU,Saudi Arabia,2015,109,162,-53
ESP,Spain,SAU,Saudi Arabia,2016,152,214,-62
ESP,Spain,SAU,Saudi Arabia,2017,186,136,50
SWE,Sweden,SAU,Saudi Arabia,2008,3,22,-19
SWE,Sweden,SAU,Saudi Arabia,2009,6,108,-102
SWE,Sweden,SAU,Saudi Arabia,2010,19,30,-11
SWE,Sweden,SAU,Saudi Arabia,2011,16,87,-71
SWE,Sweden,SAU,Saudi Arabia,2012,30,52,-22
SWE,Sweden,SAU,Saudi Arabia,2013,17,102,-85
SWE,Sweden,SAU,Saudi Arabia,2014,81,59,22
SWE,Sweden,SAU,Saudi Arabia,2015,106,101,5
SWE,Sweden,SAU,Saudi Arabia,2016,57,60,-3
SWE,Sweden,SAU,Saudi Arabia,2017,48,91,-43
CHE,Switzerland,SAU,Saudi Arabia,2010,97,106,-9
CHE,Switzerland,SAU,Saudi Arabia,2011,89,105,-16
CHE,Switzerland,SAU,Saudi Arabia,2012,85,105,-20
CHE,Switzerland,SAU,Saudi Arabia,2013,67,110,-43
CHE,Switzerland,SAU,Saudi Arabia,2014,92,110,-18
CHE,Switzerland,SAU,Saudi Arabia,2015,86,104,-18
CHE,Switzerland,SAU,Saudi Arabia,2016,99,91,8
CHE,Switzerland,SAU,Saudi Arabia,2017,87,97,-10
TUR,Turkey,SAU,Saudi Arabia,2010,0,18,-18
TUR,Turkey,SAU,Saudi Arabia,2016,351,759,-408
TUR,Turkey,SAU,Saudi Arabia,2017,370,1538,-1168
GBR,United Kingdom,SAU,Saudi Arabia,2008,0,6000,-6000
GBR,United Kingdom,SAU,Saudi Arabia,2009,0,5000,-5000
GBR,United Kingdom,SAU,Saudi Arabia,2010,0,6000,-6000
GBR,United Kingdom,SAU,Saudi Arabia,2011,1000,3000,-2000
GBR,United Kingdom,SAU,Saudi Arabia,2012,2000,2000,0
GBR,United Kingdom,SAU,Saudi Arabia,2013,1000,4000,-3000
GBR,United Kingdom,SAU,Saudi Arabia,2014,1000,5000,-4000
GBR,United Kingdom,SAU,Saudi Arabia,2015,1000,6000,-5000
USA,United States,SAU,Saudi Arabia,2008,0,1194,-1194
USA,United States,SAU,Saudi Arabia,2009,0,1418,-1418
USA,United States,SAU,Saudi Arabia,2010,0,1263,-1263
USA,United States,SAU,Saudi Arabia,2011,0,1396,-1396
USA,United States,SAU,Saudi Arabia,2012,0,1343,-1343
USA,United States,SAU,Saudi Arabia,2013,0,1463,-1463
USA,United States,SAU,Saudi Arabia,2014,0,1696,-1696
USA,United States,SAU,Saudi Arabia,2015,0,1744,-1744
USA,United States,SAU,Saudi Arabia,2016,0,2117,-2117
USA,United States,SAU,Saudi Arabia,2017,0,2135,-2135
CHL,Chile,SAU,Saudi Arabia,2008,0,0,0
CHL,Chile,SAU,Saudi Arabia,2009,0,1,-1
CHL,Chile,SAU,Saudi Arabia,2010,0,0,0
CHL,Chile,SAU,Saudi Arabia,2011,0,0,0
CHL,Chile,SAU,Saudi Arabia,2012,0,1,-1
CHL,Chile,SAU,Saudi Arabia,2013,0,0,0
CHL,Chile,SAU,Saudi Arabia,2014,0,0,0
CHL,Chile,SAU,Saudi Arabia,2015,0,0,0
CHL,Chile,SAU,Saudi Arabia,2016,0,0,0
EST,Estonia,SAU,Saudi Arabia,2008,0,0,0
EST,Estonia,SAU,Saudi Arabia,2009,0,0,0
EST,Estonia,SAU,Saudi Arabia,2010,0,0,0
EST,Estonia,SAU,Saudi Arabia,2011,0,0,0
EST,Estonia,SAU,Saudi Arabia,2012,0,0,0
EST,Estonia,SAU,Saudi Arabia,2013,0,0,0
EST,Estonia,SAU,Saudi Arabia,2014,0,0,0
EST,Estonia,SAU,Saudi Arabia,2015,0,0,0
EST,Estonia,SAU,Saudi Arabia,2016,0,0,0
EST,Estonia,SAU,Saudi Arabia,2017,0,0,0
SVN,Slovenia,SAU,Saudi Arabia,2008,0,3,-3
SVN,Slovenia,SAU,Saudi Arabia,2010,0,1,-1
SVN,Slovenia,SAU,Saudi Arabia,2013,0,1,-1
SVN,Slovenia,SAU,Saudi Arabia,2015,0,2,-2
SVN,Slovenia,SAU,Saudi Arabia,2016,0,1,-1
SVN,Slovenia,SAU,Saudi Arabia,2017,0,2,-2
AUS,Australia,SEN,Senegal,2008,0,7,-7
AUS,Australia,SEN,Senegal,2009,0,7,-7
AUS,Australia,SEN,Senegal,2010,0,8,-8
AUS,Australia,SEN,Senegal,2011,0,10,-10
AUS,Australia,SEN,Senegal,2012,0,8,-8
AUS,Australia,SEN,Senegal,2013,0,12,-12
AUS,Australia,SEN,Senegal,2014,0,6,-6
AUS,Australia,SEN,Senegal,2015,0,0,0
AUS,Australia,SEN,Senegal,2016,0,13,-13
AUS,Australia,SEN,Senegal,2017,0,7,-7
AUT,Austria,SEN,Senegal,2008,20,30,-10
AUT,Austria,SEN,Senegal,2009,19,35,-16
AUT,Austria,SEN,Senegal,2010,31,51,-20
AUT,Austria,SEN,Senegal,2011,29,47,-18
AUT,Austria,SEN,Senegal,2012,40,47,-7
AUT,Austria,SEN,Senegal,2013,34,46,-12
AUT,Austria,SEN,Senegal,2014,32,54,-22
AUT,Austria,SEN,Senegal,2015,37,74,-37
AUT,Austria,SEN,Senegal,2016,55,61,-6
AUT,Austria,SEN,Senegal,2017,32,30,2
BEL,Belgium,SEN,Senegal,2008,0,235,-235
BEL,Belgium,SEN,Senegal,2009,0,300,-300
BEL,Belgium,SEN,Senegal,2010,26,276,-250
BEL,Belgium,SEN,Senegal,2011,0,304,-304
BEL,Belgium,SEN,Senegal,2012,130,702,-572
BEL,Belgium,SEN,Senegal,2013,249,517,-268
BEL,Belgium,SEN,Senegal,2014,303,395,-92
BEL,Belgium,SEN,Senegal,2015,178,448,-270
BEL,Belgium,SEN,Senegal,2016,130,338,-208
BEL,Belgium,SEN,Senegal,2017,116,390,-274
CAN,Canada,SEN,Senegal,2008,0,555,-555
CAN,Canada,SEN,Senegal,2009,0,668,-668
CAN,Canada,SEN,Senegal,2010,0,765,-765
CAN,Canada,SEN,Senegal,2011,0,740,-740
CAN,Canada,SEN,Senegal,2012,0,948,-948
CAN,Canada,SEN,Senegal,2013,0,818,-818
CAN,Canada,SEN,Senegal,2014,0,731,-731
CAN,Canada,SEN,Senegal,2015,0,649,-649
CAN,Canada,SEN,Senegal,2016,0,595,-595
CAN,Canada,SEN,Senegal,2017,0,515,-515
CZE,Czech Republic,SEN,Senegal,2008,0,5,-5
CZE,Czech Republic,SEN,Senegal,2009,0,6,-6
CZE,Czech Republic,SEN,Senegal,2010,0,3,-3
CZE,Czech Republic,SEN,Senegal,2011,0,5,-5
CZE,Czech Republic,SEN,Senegal,2012,2,2,0
CZE,Czech Republic,SEN,Senegal,2013,1,1,0
CZE,Czech Republic,SEN,Senegal,2014,0,4,-4
CZE,Czech Republic,SEN,Senegal,2015,0,7,-7
CZE,Czech Republic,SEN,Senegal,2016,0,6,-6
CZE,Czech Republic,SEN,Senegal,2017,0,4,-4
DNK,Denmark,SEN,Senegal,2008,1,9,-8
DNK,Denmark,SEN,Senegal,2009,4,9,-5
DNK,Denmark,SEN,Senegal,2010,6,11,-5
DNK,Denmark,SEN,Senegal,2011,1,9,-8
DNK,Denmark,SEN,Senegal,2012,6,9,-3
DNK,Denmark,SEN,Senegal,2013,1,21,-20
DNK,Denmark,SEN,Senegal,2014,6,12,-6
DNK,Denmark,SEN,Senegal,2015,8,9,-1
DNK,Denmark,SEN,Senegal,2016,4,7,-3
DNK,Denmark,SEN,Senegal,2017,1,3,-2
FIN,Finland,SEN,Senegal,2008,0,11,-11
FIN,Finland,SEN,Senegal,2009,0,12,-12
FIN,Finland,SEN,Senegal,2010,0,6,-6
FIN,Finland,SEN,Senegal,2011,2,5,-3
FIN,Finland,SEN,Senegal,2012,0,14,-14
FIN,Finland,SEN,Senegal,2013,1,15,-14
FIN,Finland,SEN,Senegal,2014,0,17,-17
FIN,Finland,SEN,Senegal,2015,2,15,-13
FIN,Finland,SEN,Senegal,2016,2,15,-13
FIN,Finland,SEN,Senegal,2017,3,9,-6
FRA,France,SEN,Senegal,2008,0,3345,-3345
FRA,France,SEN,Senegal,2009,0,3862,-3862
FRA,France,SEN,Senegal,2010,0,4034,-4034
FRA,France,SEN,Senegal,2011,0,4019,-4019
FRA,France,SEN,Senegal,2012,0,4201,-4201
FRA,France,SEN,Senegal,2013,0,4361,-4361
FRA,France,SEN,Senegal,2014,0,4566,-4566
FRA,France,SEN,Senegal,2015,0,3700,-3700
FRA,France,SEN,Senegal,2016,0,3869,-3869
FRA,France,SEN,Senegal,2017,0,4130,-4130
DEU,Germany,SEN,Senegal,2008,173,226,-53
DEU,Germany,SEN,Senegal,2009,228,277,-49
DEU,Germany,SEN,Senegal,2010,175,265,-90
DEU,Germany,SEN,Senegal,2011,168,270,-102
DEU,Germany,SEN,Senegal,2012,198,410,-212
DEU,Germany,SEN,Senegal,2013,259,929,-670
DEU,Germany,SEN,Senegal,2014,499,1252,-753
DEU,Germany,SEN,Senegal,2015,514,2255,-1741
DEU,Germany,SEN,Senegal,2016,1316,1355,-39
DEU,Germany,SEN,Senegal,2017,1324,734,590
HUN,Hungary,SEN,Senegal,2008,0,4,-4
HUN,Hungary,SEN,Senegal,2009,1,2,-1
HUN,Hungary,SEN,Senegal,2010,2,4,-2
HUN,Hungary,SEN,Senegal,2011,0,3,-3
HUN,Hungary,SEN,Senegal,2012,1,5,-4
HUN,Hungary,SEN,Senegal,2013,0,3,-3
HUN,Hungary,SEN,Senegal,2014,1,4,-3
HUN,Hungary,SEN,Senegal,2015,0,4,-4
HUN,Hungary,SEN,Senegal,2016,1,7,-6
HUN,Hungary,SEN,Senegal,2017,0,8,-8
ISL,Iceland,SEN,Senegal,2008,0,1,-1
ISL,Iceland,SEN,Senegal,2009,0,0,0
ISL,Iceland,SEN,Senegal,2010,0,2,-2
ISL,Iceland,SEN,Senegal,2011,0,4,-4
ISL,Iceland,SEN,Senegal,2012,0,2,-2
ISL,Iceland,SEN,Senegal,2013,3,1,2
ISL,Iceland,SEN,Senegal,2014,2,3,-1
ISL,Iceland,SEN,Senegal,2015,1,3,-2
ISL,Iceland,SEN,Senegal,2016,1,0,1
ISL,Iceland,SEN,Senegal,2017,1,1,0
ITA,Italy,SEN,Senegal,2008,178,4770,-4592
ITA,Italy,SEN,Senegal,2009,216,4858,-4642
ITA,Italy,SEN,Senegal,2010,234,8851,-8617
ITA,Italy,SEN,Senegal,2011,246,6608,-6362
ITA,Italy,SEN,Senegal,2012,397,5493,-5096
ITA,Italy,SEN,Senegal,2013,434,6451,-6017
ITA,Italy,SEN,Senegal,2014,495,6270,-5775
ITA,Italy,SEN,Senegal,2015,455,7471,-7016
ITA,Italy,SEN,Senegal,2016,0,8524,-8524
ITA,Italy,SEN,Senegal,2017,441,10862,-10421
JPN,Japan,SEN,Senegal,2008,182,185,-3
JPN,Japan,SEN,Senegal,2009,94,121,-27
JPN,Japan,SEN,Senegal,2010,123,145,-22
JPN,Japan,SEN,Senegal,2011,132,161,-29
JPN,Japan,SEN,Senegal,2012,148,169,-21
JPN,Japan,SEN,Senegal,2013,204,225,-21
JPN,Japan,SEN,Senegal,2014,112,155,-43
JPN,Japan,SEN,Senegal,2015,144,193,-49
JPN,Japan,SEN,Senegal,2016,171,229,-58
JPN,Japan,SEN,Senegal,2017,177,244,-67
KOR,Korea,SEN,Senegal,2008,11,14,-3
KOR,Korea,SEN,Senegal,2009,15,21,-6
KOR,Korea,SEN,Senegal,2010,14,15,-1
KOR,Korea,SEN,Senegal,2011,16,19,-3
KOR,Korea,SEN,Senegal,2012,23,27,-4
KOR,Korea,SEN,Senegal,2013,15,36,-21
KOR,Korea,SEN,Senegal,2014,29,49,-20
KOR,Korea,SEN,Senegal,2015,24,32,-8
KOR,Korea,SEN,Senegal,2016,30,83,-53
KOR,Korea,SEN,Senegal,2017,36,193,-157
LUX,Luxembourg,SEN,Senegal,2008,6,25,-19
LUX,Luxembourg,SEN,Senegal,2009,6,28,-22
LUX,Luxembourg,SEN,Senegal,2010,6,37,-31
LUX,Luxembourg,SEN,Senegal,2011,5,38,-33
LUX,Luxembourg,SEN,Senegal,2012,6,25,-19
LUX,Luxembourg,SEN,Senegal,2013,5,37,-32
LUX,Luxembourg,SEN,Senegal,2014,16,30,-14
LUX,Luxembourg,SEN,Senegal,2015,16,47,-31
LUX,Luxembourg,SEN,Senegal,2016,8,60,-52
LUX,Luxembourg,SEN,Senegal,2017,24,47,-23
MEX,Mexico,SEN,Senegal,2008,0,2,-2
MEX,Mexico,SEN,Senegal,2009,0,4,-4
MEX,Mexico,SEN,Senegal,2010,0,3,-3
MEX,Mexico,SEN,Senegal,2011,0,2,-2
MEX,Mexico,SEN,Senegal,2012,0,1,-1
MEX,Mexico,SEN,Senegal,2013,0,1,-1
MEX,Mexico,SEN,Senegal,2014,0,6,-6
MEX,Mexico,SEN,Senegal,2016,0,3,-3
MEX,Mexico,SEN,Senegal,2017,0,4,-4
NLD,Netherlands,SEN,Senegal,2008,21,28,-7
NLD,Netherlands,SEN,Senegal,2009,13,36,-23
NLD,Netherlands,SEN,Senegal,2010,18,24,-6
NLD,Netherlands,SEN,Senegal,2011,6,25,-19
NLD,Netherlands,SEN,Senegal,2012,19,28,-9
NLD,Netherlands,SEN,Senegal,2013,11,36,-25
NLD,Netherlands,SEN,Senegal,2014,9,28,-19
NLD,Netherlands,SEN,Senegal,2015,-1,25,-26
NLD,Netherlands,SEN,Senegal,2016,16,39,-23
NLD,Netherlands,SEN,Senegal,2017,10,28,-18
NZL,New Zealand,SEN,Senegal,2008,0,1,-1
NZL,New Zealand,SEN,Senegal,2009,0,0,0
NZL,New Zealand,SEN,Senegal,2011,1,0,1
NZL,New Zealand,SEN,Senegal,2015,1,1,0
NOR,Norway,SEN,Senegal,2008,3,8,-5
NOR,Norway,SEN,Senegal,2009,2,22,-20
NOR,Norway,SEN,Senegal,2010,0,12,-12
NOR,Norway,SEN,Senegal,2011,8,20,-12
NOR,Norway,SEN,Senegal,2012,4,21,-17
NOR,Norway,SEN,Senegal,2013,6,10,-4
NOR,Norway,SEN,Senegal,2014,5,17,-12
NOR,Norway,SEN,Senegal,2015,5,18,-13
NOR,Norway,SEN,Senegal,2016,8,16,-8
NOR,Norway,SEN,Senegal,2017,2,9,-7
POL,Poland,SEN,Senegal,2008,0,27,-27
POL,Poland,SEN,Senegal,2009,0,41,-41
POL,Poland,SEN,Senegal,2010,0,42,-42
POL,Poland,SEN,Senegal,2011,0,29,-29
POL,Poland,SEN,Senegal,2012,0,48,-48
POL,Poland,SEN,Senegal,2013,0,31,-31
POL,Poland,SEN,Senegal,2014,0,18,-18
POL,Poland,SEN,Senegal,2015,0,25,-25
POL,Poland,SEN,Senegal,2016,0,19,-19
POL,Poland,SEN,Senegal,2017,0,24,-24
SVK,Slovak Republic,SEN,Senegal,2008,0,1,-1
SVK,Slovak Republic,SEN,Senegal,2009,2,4,-2
SVK,Slovak Republic,SEN,Senegal,2010,2,1,1
SVK,Slovak Republic,SEN,Senegal,2011,0,1,-1
SVK,Slovak Republic,SEN,Senegal,2012,0,1,-1
SVK,Slovak Republic,SEN,Senegal,2014,0,1,-1
SVK,Slovak Republic,SEN,Senegal,2015,0,1,-1
ESP,Spain,SEN,Senegal,2008,2220,10568,-8348
ESP,Spain,SEN,Senegal,2009,3049,7176,-4127
ESP,Spain,SEN,Senegal,2010,3950,3824,126
ESP,Spain,SEN,Senegal,2011,4548,3601,947
ESP,Spain,SEN,Senegal,2012,5303,2923,2380
ESP,Spain,SEN,Senegal,2013,6181,3091,3090
ESP,Spain,SEN,Senegal,2014,3829,2982,847
ESP,Spain,SEN,Senegal,2015,2964,3386,-422
ESP,Spain,SEN,Senegal,2016,2750,3830,-1080
ESP,Spain,SEN,Senegal,2017,2800,4313,-1513
SWE,Sweden,SEN,Senegal,2008,2,39,-37
SWE,Sweden,SEN,Senegal,2009,4,51,-47
SWE,Sweden,SEN,Senegal,2010,5,51,-46
SWE,Sweden,SEN,Senegal,2011,1,58,-57
SWE,Sweden,SEN,Senegal,2012,8,72,-64
SWE,Sweden,SEN,Senegal,2013,8,61,-53
SWE,Sweden,SEN,Senegal,2014,8,48,-40
SWE,Sweden,SEN,Senegal,2015,6,56,-50
SWE,Sweden,SEN,Senegal,2016,3,43,-40
SWE,Sweden,SEN,Senegal,2017,8,40,-32
CHE,Switzerland,SEN,Senegal,2010,43,121,-78
CHE,Switzerland,SEN,Senegal,2011,46,118,-72
CHE,Switzerland,SEN,Senegal,2012,43,102,-59
CHE,Switzerland,SEN,Senegal,2013,44,112,-68
CHE,Switzerland,SEN,Senegal,2014,47,112,-65
CHE,Switzerland,SEN,Senegal,2015,31,169,-138
CHE,Switzerland,SEN,Senegal,2016,35,105,-70
CHE,Switzerland,SEN,Senegal,2017,38,109,-71
TUR,Turkey,SEN,Senegal,2010,0,20,-20
TUR,Turkey,SEN,Senegal,2016,78,323,-245
TUR,Turkey,SEN,Senegal,2017,137,249,-112
USA,United States,SEN,Senegal,2008,0,1149,-1149
USA,United States,SEN,Senegal,2009,0,1524,-1524
USA,United States,SEN,Senegal,2010,0,1285,-1285
USA,United States,SEN,Senegal,2011,0,1424,-1424
USA,United States,SEN,Senegal,2012,0,1615,-1615
USA,United States,SEN,Senegal,2013,0,1340,-1340
USA,United States,SEN,Senegal,2014,0,1273,-1273
USA,United States,SEN,Senegal,2015,0,1244,-1244
USA,United States,SEN,Senegal,2016,0,1533,-1533
USA,United States,SEN,Senegal,2017,0,1470,-1470
CHL,Chile,SEN,Senegal,2008,0,0,0
CHL,Chile,SEN,Senegal,2009,0,0,0
CHL,Chile,SEN,Senegal,2010,0,7,-7
CHL,Chile,SEN,Senegal,2011,0,0,0
CHL,Chile,SEN,Senegal,2012,0,2,-2
CHL,Chile,SEN,Senegal,2013,0,0,0
CHL,Chile,SEN,Senegal,2014,0,3,-3
CHL,Chile,SEN,Senegal,2015,0,3,-3
CHL,Chile,SEN,Senegal,2016,0,4,-4
EST,Estonia,SEN,Senegal,2008,0,0,0
EST,Estonia,SEN,Senegal,2009,0,0,0
EST,Estonia,SEN,Senegal,2010,0,0,0
EST,Estonia,SEN,Senegal,2011,0,0,0
EST,Estonia,SEN,Senegal,2012,0,0,0
EST,Estonia,SEN,Senegal,2013,0,0,0
EST,Estonia,SEN,Senegal,2014,0,0,0
EST,Estonia,SEN,Senegal,2015,0,0,0
EST,Estonia,SEN,Senegal,2016,0,0,0
EST,Estonia,SEN,Senegal,2017,0,0,0
SVN,Slovenia,SEN,Senegal,2010,0,1,-1
SVN,Slovenia,SEN,Senegal,2011,0,2,-2
SVN,Slovenia,SEN,Senegal,2012,0,1,-1
SVN,Slovenia,SEN,Senegal,2014,0,1,-1
AUS,Australia,SCG,Serbia and Montenegro,2008,0,155,-155
AUS,Australia,SCG,Serbia and Montenegro,2009,0,73,-73
AUS,Australia,SCG,Serbia and Montenegro,2010,0,50,-50
AUS,Australia,SCG,Serbia and Montenegro,2011,0,21,-21
AUS,Australia,SCG,Serbia and Montenegro,2012,0,14,-14
AUS,Australia,SCG,Serbia and Montenegro,2013,0,11,-11
AUS,Australia,SCG,Serbia and Montenegro,2014,0,11,-11
AUS,Australia,SCG,Serbia and Montenegro,2015,0,0,0
AUS,Australia,SCG,Serbia and Montenegro,2016,0,8,-8
AUS,Australia,SCG,Serbia and Montenegro,2017,0,0,0
AUT,Austria,SCG,Serbia and Montenegro,2014,0,0,0
AUT,Austria,SCG,Serbia and Montenegro,2015,0,0,0
AUT,Austria,SCG,Serbia and Montenegro,2016,0,0,0
AUT,Austria,SCG,Serbia and Montenegro,2017,0,0,0
BEL,Belgium,SCG,Serbia and Montenegro,2010,53,55,-2
BEL,Belgium,SCG,Serbia and Montenegro,2012,911,29,882
BEL,Belgium,SCG,Serbia and Montenegro,2013,181,16,165
BEL,Belgium,SCG,Serbia and Montenegro,2014,301,25,276
BEL,Belgium,SCG,Serbia and Montenegro,2015,83,21,62
BEL,Belgium,SCG,Serbia and Montenegro,2016,54,24,30
BEL,Belgium,SCG,Serbia and Montenegro,2017,32,23,9
CAN,Canada,SCG,Serbia and Montenegro,2008,0,456,-456
CAN,Canada,SCG,Serbia and Montenegro,2009,0,204,-204
CAN,Canada,SCG,Serbia and Montenegro,2010,0,109,-109
CAN,Canada,SCG,Serbia and Montenegro,2011,0,39,-39
CAN,Canada,SCG,Serbia and Montenegro,2012,0,32,-32
CAN,Canada,SCG,Serbia and Montenegro,2013,0,34,-34
CAN,Canada,SCG,Serbia and Montenegro,2014,0,17,-17
CAN,Canada,SCG,Serbia and Montenegro,2015,0,18,-18
CAN,Canada,SCG,Serbia and Montenegro,2016,0,0,0
CAN,Canada,SCG,Serbia and Montenegro,2017,0,0,0
CZE,Czech Republic,SCG,Serbia and Montenegro,2008,8,297,-289
CZE,Czech Republic,SCG,Serbia and Montenegro,2009,9,184,-175
CZE,Czech Republic,SCG,Serbia and Montenegro,2010,6,201,-195
CZE,Czech Republic,SCG,Serbia and Montenegro,2011,9,740,-731
CZE,Czech Republic,SCG,Serbia and Montenegro,2012,74,179,-105
DNK,Denmark,SCG,Serbia and Montenegro,2008,9,10,-1
DNK,Denmark,SCG,Serbia and Montenegro,2009,3,5,-2
DNK,Denmark,SCG,Serbia and Montenegro,2012,0,0,0
DNK,Denmark,SCG,Serbia and Montenegro,2013,2,8,-6
DNK,Denmark,SCG,Serbia and Montenegro,2014,0,2,-2
DNK,Denmark,SCG,Serbia and Montenegro,2015,4,4,0
DNK,Denmark,SCG,Serbia and Montenegro,2016,7,2,5
DNK,Denmark,SCG,Serbia and Montenegro,2017,6,3,3
FIN,Finland,SCG,Serbia and Montenegro,2008,17,7,10
FIN,Finland,SCG,Serbia and Montenegro,2009,4,4,0
FIN,Finland,SCG,Serbia and Montenegro,2010,10,5,5
FIN,Finland,SCG,Serbia and Montenegro,2011,8,0,8
FIN,Finland,SCG,Serbia and Montenegro,2012,10,1,9
FIN,Finland,SCG,Serbia and Montenegro,2013,4,8,-4
FIN,Finland,SCG,Serbia and Montenegro,2014,15,4,11
FIN,Finland,SCG,Serbia and Montenegro,2015,10,0,10
FIN,Finland,SCG,Serbia and Montenegro,2016,10,0,10
FIN,Finland,SCG,Serbia and Montenegro,2017,11,299,-288
FRA,France,SCG,Serbia and Montenegro,2008,0,0,0
FRA,France,SCG,Serbia and Montenegro,2009,0,0,0
FRA,France,SCG,Serbia and Montenegro,2010,0,0,0
FRA,France,SCG,Serbia and Montenegro,2011,0,0,0
FRA,France,SCG,Serbia and Montenegro,2012,0,0,0
FRA,France,SCG,Serbia and Montenegro,2013,0,0,0
FRA,France,SCG,Serbia and Montenegro,2014,0,0,0
FRA,France,SCG,Serbia and Montenegro,2015,0,0,0
FRA,France,SCG,Serbia and Montenegro,2016,0,0,0
FRA,France,SCG,Serbia and Montenegro,2017,0,0,0
DEU,Germany,SCG,Serbia and Montenegro,2008,4898,1230,3668
DEU,Germany,SCG,Serbia and Montenegro,2009,6673,1643,5030
DEU,Germany,SCG,Serbia and Montenegro,2010,4546,1752,2794
DEU,Germany,SCG,Serbia and Montenegro,2011,2708,1270,1438
DEU,Germany,SCG,Serbia and Montenegro,2012,2270,998,1272
DEU,Germany,SCG,Serbia and Montenegro,2013,1765,373,1392
DEU,Germany,SCG,Serbia and Montenegro,2014,1009,340,669
DEU,Germany,SCG,Serbia and Montenegro,2015,883,290,593
DEU,Germany,SCG,Serbia and Montenegro,2016,927,260,667
DEU,Germany,SCG,Serbia and Montenegro,2017,634,208,426
HUN,Hungary,SCG,Serbia and Montenegro,2008,33,22,11
HUN,Hungary,SCG,Serbia and Montenegro,2009,18,5,13
HUN,Hungary,SCG,Serbia and Montenegro,2010,44,1,43
HUN,Hungary,SCG,Serbia and Montenegro,2011,67,0,67
HUN,Hungary,SCG,Serbia and Montenegro,2012,32,1,31
HUN,Hungary,SCG,Serbia and Montenegro,2013,3,2,1
HUN,Hungary,SCG,Serbia and Montenegro,2014,3,2,1
HUN,Hungary,SCG,Serbia and Montenegro,2015,0,0,0
HUN,Hungary,SCG,Serbia and Montenegro,2016,0,0,0
HUN,Hungary,SCG,Serbia and Montenegro,2017,0,0,0
ISL,Iceland,SCG,Serbia and Montenegro,2008,0,0,0
ISL,Iceland,SCG,Serbia and Montenegro,2009,0,0,0
ISL,Iceland,SCG,Serbia and Montenegro,2010,0,0,0
ISL,Iceland,SCG,Serbia and Montenegro,2011,0,0,0
ISL,Iceland,SCG,Serbia and Montenegro,2012,0,0,0
ISL,Iceland,SCG,Serbia and Montenegro,2013,0,0,0
ISL,Iceland,SCG,Serbia and Montenegro,2014,0,0,0
ISL,Iceland,SCG,Serbia and Montenegro,2015,0,0,0
ISL,Iceland,SCG,Serbia and Montenegro,2016,0,0,0
ISL,Iceland,SCG,Serbia and Montenegro,2017,0,0,0
JPN,Japan,SCG,Serbia and Montenegro,2008,100,110,-10
JPN,Japan,SCG,Serbia and Montenegro,2009,52,48,4
JPN,Japan,SCG,Serbia and Montenegro,2010,15,9,6
JPN,Japan,SCG,Serbia and Montenegro,2011,7,0,7
JPN,Japan,SCG,Serbia and Montenegro,2012,6,0,6
JPN,Japan,SCG,Serbia and Montenegro,2013,2,0,2
JPN,Japan,SCG,Serbia and Montenegro,2014,0,0,0
JPN,Japan,SCG,Serbia and Montenegro,2015,0,0,0
JPN,Japan,SCG,Serbia and Montenegro,2016,3,0,3
JPN,Japan,SCG,Serbia and Montenegro,2017,0,0,0
KOR,Korea,SCG,Serbia and Montenegro,2008,8,28,-20
KOR,Korea,SCG,Serbia and Montenegro,2009,9,4,5
KOR,Korea,SCG,Serbia and Montenegro,2010,2,1,1
KOR,Korea,SCG,Serbia and Montenegro,2011,3,0,3
KOR,Korea,SCG,Serbia and Montenegro,2012,2,0,2
KOR,Korea,SCG,Serbia and Montenegro,2013,1,0,1
KOR,Korea,SCG,Serbia and Montenegro,2014,0,0,0
KOR,Korea,SCG,Serbia and Montenegro,2015,0,0,0
KOR,Korea,SCG,Serbia and Montenegro,2016,0,0,0
KOR,Korea,SCG,Serbia and Montenegro,2017,1,0,1
LUX,Luxembourg,SCG,Serbia and Montenegro,2008,130,125,5
LUX,Luxembourg,SCG,Serbia and Montenegro,2009,46,28,18
LUX,Luxembourg,SCG,Serbia and Montenegro,2010,26,16,10
LUX,Luxembourg,SCG,Serbia and Montenegro,2011,19,14,5
LUX,Luxembourg,SCG,Serbia and Montenegro,2012,17,6,11
LUX,Luxembourg,SCG,Serbia and Montenegro,2013,6,5,1
LUX,Luxembourg,SCG,Serbia and Montenegro,2014,3,1,2
LUX,Luxembourg,SCG,Serbia and Montenegro,2015,1,2,-1
LUX,Luxembourg,SCG,Serbia and Montenegro,2016,6,5,1
LUX,Luxembourg,SCG,Serbia and Montenegro,2017,1,3,-2
MEX,Mexico,SCG,Serbia and Montenegro,2012,0,0,0
MEX,Mexico,SCG,Serbia and Montenegro,2013,0,0,0
MEX,Mexico,SCG,Serbia and Montenegro,2014,0,0,0
NLD,Netherlands,SCG,Serbia and Montenegro,2012,3,1,2
NLD,Netherlands,SCG,Serbia and Montenegro,2013,2,0,2
NLD,Netherlands,SCG,Serbia and Montenegro,2015,2,0,2
NLD,Netherlands,SCG,Serbia and Montenegro,2017,1,0,1
NZL,New Zealand,SCG,Serbia and Montenegro,2008,0,0,0
NZL,New Zealand,SCG,Serbia and Montenegro,2009,0,0,0
NZL,New Zealand,SCG,Serbia and Montenegro,2012,0,0,0
NOR,Norway,SCG,Serbia and Montenegro,2008,51,52,-1
NOR,Norway,SCG,Serbia and Montenegro,2009,0,0,0
NOR,Norway,SCG,Serbia and Montenegro,2010,53,0,53
NOR,Norway,SCG,Serbia and Montenegro,2011,0,0,0
NOR,Norway,SCG,Serbia and Montenegro,2012,0,0,0
NOR,Norway,SCG,Serbia and Montenegro,2013,0,0,0
NOR,Norway,SCG,Serbia and Montenegro,2014,0,0,0
NOR,Norway,SCG,Serbia and Montenegro,2015,0,0,0
NOR,Norway,SCG,Serbia and Montenegro,2016,0,0,0
NOR,Norway,SCG,Serbia and Montenegro,2017,0,0,0
POL,Poland,SCG,Serbia and Montenegro,2008,0,156,-156
POL,Poland,SCG,Serbia and Montenegro,2009,0,0,0
POL,Poland,SCG,Serbia and Montenegro,2010,0,0,0
POL,Poland,SCG,Serbia and Montenegro,2011,0,0,0
POL,Poland,SCG,Serbia and Montenegro,2012,0,0,0
POL,Poland,SCG,Serbia and Montenegro,2013,0,8,-8
POL,Poland,SCG,Serbia and Montenegro,2014,0,70,-70
POL,Poland,SCG,Serbia and Montenegro,2015,0,304,-304
POL,Poland,SCG,Serbia and Montenegro,2016,0,359,-359
POL,Poland,SCG,Serbia and Montenegro,2017,0,298,-298
SVK,Slovak Republic,SCG,Serbia and Montenegro,2008,0,0,0
SWE,Sweden,SCG,Serbia and Montenegro,2008,0,0,0
SWE,Sweden,SCG,Serbia and Montenegro,2009,0,0,0
SWE,Sweden,SCG,Serbia and Montenegro,2010,0,0,0
SWE,Sweden,SCG,Serbia and Montenegro,2011,0,0,0
SWE,Sweden,SCG,Serbia and Montenegro,2012,0,0,0
SWE,Sweden,SCG,Serbia and Montenegro,2013,0,0,0
SWE,Sweden,SCG,Serbia and Montenegro,2014,0,0,0
SWE,Sweden,SCG,Serbia and Montenegro,2015,0,0,0
SWE,Sweden,SCG,Serbia and Montenegro,2016,0,0,0
SWE,Sweden,SCG,Serbia and Montenegro,2017,0,0,0
USA,United States,SCG,Serbia and Montenegro,2008,0,3255,-3255
USA,United States,SCG,Serbia and Montenegro,2009,0,3166,-3166
USA,United States,SCG,Serbia and Montenegro,2010,0,2196,-2196
USA,United States,SCG,Serbia and Montenegro,2011,0,1398,-1398
USA,United States,SCG,Serbia and Montenegro,2012,0,801,-801
USA,United States,SCG,Serbia and Montenegro,2013,0,653,-653
USA,United States,SCG,Serbia and Montenegro,2014,0,267,-267
USA,United States,SCG,Serbia and Montenegro,2015,0,232,-232
USA,United States,SCG,Serbia and Montenegro,2016,0,202,-202
USA,United States,SCG,Serbia and Montenegro,2017,0,144,-144
CHL,Chile,SCG,Serbia and Montenegro,2008,0,5,-5
CHL,Chile,SCG,Serbia and Montenegro,2009,0,5,-5
CHL,Chile,SCG,Serbia and Montenegro,2010,0,0,0
CHL,Chile,SCG,Serbia and Montenegro,2011,0,0,0
CHL,Chile,SCG,Serbia and Montenegro,2012,0,1,-1
CHL,Chile,SCG,Serbia and Montenegro,2013,0,9,-9
CHL,Chile,SCG,Serbia and Montenegro,2014,0,5,-5
CHL,Chile,SCG,Serbia and Montenegro,2015,0,5,-5
CHL,Chile,SCG,Serbia and Montenegro,2016,0,2,-2
EST,Estonia,SCG,Serbia and Montenegro,2017,0,0,0
AUS,Australia,SYC,Seychelles,2008,13,41,-28
AUS,Australia,SYC,Seychelles,2009,11,38,-27
AUS,Australia,SYC,Seychelles,2010,17,58,-41
AUS,Australia,SYC,Seychelles,2011,17,37,-20
AUS,Australia,SYC,Seychelles,2012,24,55,-31
AUS,Australia,SYC,Seychelles,2013,11,32,-21
AUS,Australia,SYC,Seychelles,2014,13,47,-34
AUS,Australia,SYC,Seychelles,2015,0,25,-25
AUS,Australia,SYC,Seychelles,2016,0,28,-28
AUS,Australia,SYC,Seychelles,2017,0,14,-14
AUT,Austria,SYC,Seychelles,2008,0,1,-1
AUT,Austria,SYC,Seychelles,2009,0,4,-4
AUT,Austria,SYC,Seychelles,2010,0,1,-1
AUT,Austria,SYC,Seychelles,2011,2,0,2
AUT,Austria,SYC,Seychelles,2012,1,1,0
AUT,Austria,SYC,Seychelles,2013,1,5,-4
AUT,Austria,SYC,Seychelles,2014,4,2,2
AUT,Austria,SYC,Seychelles,2015,3,8,-5
AUT,Austria,SYC,Seychelles,2016,2,3,-1
AUT,Austria,SYC,Seychelles,2017,1,1,0
BEL,Belgium,SYC,Seychelles,2008,0,4,-4
BEL,Belgium,SYC,Seychelles,2009,0,1,-1
BEL,Belgium,SYC,Seychelles,2010,0,1,-1
BEL,Belgium,SYC,Seychelles,2012,3,2,1
BEL,Belgium,SYC,Seychelles,2013,1,2,-1
BEL,Belgium,SYC,Seychelles,2014,2,1,1
BEL,Belgium,SYC,Seychelles,2015,1,5,-4
BEL,Belgium,SYC,Seychelles,2016,0,4,-4
BEL,Belgium,SYC,Seychelles,2017,0,1,-1
CAN,Canada,SYC,Seychelles,2008,0,18,-18
CAN,Canada,SYC,Seychelles,2009,0,4,-4
CAN,Canada,SYC,Seychelles,2010,0,10,-10
CAN,Canada,SYC,Seychelles,2011,0,10,-10
CAN,Canada,SYC,Seychelles,2012,0,6,-6
CAN,Canada,SYC,Seychelles,2013,0,5,-5
CAN,Canada,SYC,Seychelles,2014,0,2,-2
CAN,Canada,SYC,Seychelles,2015,0,0,0
CAN,Canada,SYC,Seychelles,2016,0,5,-5
CAN,Canada,SYC,Seychelles,2017,0,5,-5
CZE,Czech Republic,SYC,Seychelles,2010,0,1,-1
CZE,Czech Republic,SYC,Seychelles,2012,1,2,-1
CZE,Czech Republic,SYC,Seychelles,2013,2,2,0
CZE,Czech Republic,SYC,Seychelles,2014,0,3,-3
DNK,Denmark,SYC,Seychelles,2008,0,0,0
DNK,Denmark,SYC,Seychelles,2009,0,0,0
DNK,Denmark,SYC,Seychelles,2010,0,1,-1
DNK,Denmark,SYC,Seychelles,2012,0,0,0
DNK,Denmark,SYC,Seychelles,2013,0,0,0
DNK,Denmark,SYC,Seychelles,2014,0,0,0
DNK,Denmark,SYC,Seychelles,2015,1,1,0
DNK,Denmark,SYC,Seychelles,2016,0,1,-1
DNK,Denmark,SYC,Seychelles,2017,1,0,1
FIN,Finland,SYC,Seychelles,2008,0,0,0
FIN,Finland,SYC,Seychelles,2009,1,1,0
FIN,Finland,SYC,Seychelles,2010,0,0,0
FIN,Finland,SYC,Seychelles,2011,0,2,-2
FIN,Finland,SYC,Seychelles,2012,0,0,0
FIN,Finland,SYC,Seychelles,2013,0,0,0
FIN,Finland,SYC,Seychelles,2014,0,0,0
FIN,Finland,SYC,Seychelles,2015,0,0,0
FIN,Finland,SYC,Seychelles,2016,0,0,0
FIN,Finland,SYC,Seychelles,2017,0,0,0
FRA,France,SYC,Seychelles,2008,0,6,-6
FRA,France,SYC,Seychelles,2009,0,10,-10
FRA,France,SYC,Seychelles,2010,0,11,-11
FRA,France,SYC,Seychelles,2011,0,29,-29
FRA,France,SYC,Seychelles,2012,0,9,-9
FRA,France,SYC,Seychelles,2013,0,20,-20
FRA,France,SYC,Seychelles,2014,0,13,-13
FRA,France,SYC,Seychelles,2015,0,14,-14
FRA,France,SYC,Seychelles,2016,0,14,-14
FRA,France,SYC,Seychelles,2017,0,5,-5
DEU,Germany,SYC,Seychelles,2008,13,8,5
DEU,Germany,SYC,Seychelles,2009,12,13,-1
DEU,Germany,SYC,Seychelles,2010,12,17,-5
DEU,Germany,SYC,Seychelles,2011,12,14,-2
DEU,Germany,SYC,Seychelles,2012,10,12,-2
DEU,Germany,SYC,Seychelles,2013,14,16,-2
DEU,Germany,SYC,Seychelles,2014,19,12,7
DEU,Germany,SYC,Seychelles,2015,11,11,0
DEU,Germany,SYC,Seychelles,2016,13,11,2
DEU,Germany,SYC,Seychelles,2017,10,6,4
HUN,Hungary,SYC,Seychelles,2008,0,0,0
HUN,Hungary,SYC,Seychelles,2009,0,1,-1
HUN,Hungary,SYC,Seychelles,2010,0,2,-2
HUN,Hungary,SYC,Seychelles,2011,0,1,-1
HUN,Hungary,SYC,Seychelles,2012,0,1,-1
HUN,Hungary,SYC,Seychelles,2013,0,2,-2
HUN,Hungary,SYC,Seychelles,2014,0,3,-3
HUN,Hungary,SYC,Seychelles,2015,0,0,0
HUN,Hungary,SYC,Seychelles,2016,1,3,-2
HUN,Hungary,SYC,Seychelles,2017,0,0,0
ISL,Iceland,SYC,Seychelles,2016,0,0,0
ISL,Iceland,SYC,Seychelles,2017,0,0,0
ITA,Italy,SYC,Seychelles,2008,1,22,-21
ITA,Italy,SYC,Seychelles,2009,2,30,-28
ITA,Italy,SYC,Seychelles,2010,6,15,-9
ITA,Italy,SYC,Seychelles,2011,1,14,-13
ITA,Italy,SYC,Seychelles,2012,1,5,-4
ITA,Italy,SYC,Seychelles,2013,12,7,5
ITA,Italy,SYC,Seychelles,2014,4,13,-9
ITA,Italy,SYC,Seychelles,2015,1,8,-7
ITA,Italy,SYC,Seychelles,2016,0,12,-12
ITA,Italy,SYC,Seychelles,2017,1,6,-5
JPN,Japan,SYC,Seychelles,2008,17,16,1
JPN,Japan,SYC,Seychelles,2009,16,16,0
JPN,Japan,SYC,Seychelles,2010,14,15,-1
JPN,Japan,SYC,Seychelles,2011,17,19,-2
JPN,Japan,SYC,Seychelles,2012,21,21,0
JPN,Japan,SYC,Seychelles,2013,25,25,0
JPN,Japan,SYC,Seychelles,2014,14,14,0
JPN,Japan,SYC,Seychelles,2015,18,18,0
JPN,Japan,SYC,Seychelles,2016,14,15,-1
JPN,Japan,SYC,Seychelles,2017,9,11,-2
KOR,Korea,SYC,Seychelles,2008,0,0,0
KOR,Korea,SYC,Seychelles,2009,1,1,0
KOR,Korea,SYC,Seychelles,2010,0,0,0
KOR,Korea,SYC,Seychelles,2011,0,0,0
KOR,Korea,SYC,Seychelles,2012,0,0,0
KOR,Korea,SYC,Seychelles,2013,3,1,2
KOR,Korea,SYC,Seychelles,2014,0,0,0
KOR,Korea,SYC,Seychelles,2015,0,0,0
KOR,Korea,SYC,Seychelles,2016,0,0,0
KOR,Korea,SYC,Seychelles,2017,0,0,0
LUX,Luxembourg,SYC,Seychelles,2008,0,0,0
LUX,Luxembourg,SYC,Seychelles,2009,0,0,0
LUX,Luxembourg,SYC,Seychelles,2010,0,0,0
LUX,Luxembourg,SYC,Seychelles,2011,0,0,0
LUX,Luxembourg,SYC,Seychelles,2012,0,0,0
LUX,Luxembourg,SYC,Seychelles,2013,0,0,0
LUX,Luxembourg,SYC,Seychelles,2014,0,0,0
LUX,Luxembourg,SYC,Seychelles,2015,0,0,0
LUX,Luxembourg,SYC,Seychelles,2016,0,0,0
LUX,Luxembourg,SYC,Seychelles,2017,0,1,-1
MEX,Mexico,SYC,Seychelles,2012,0,0,0
MEX,Mexico,SYC,Seychelles,2013,0,0,0
MEX,Mexico,SYC,Seychelles,2014,0,0,0
NLD,Netherlands,SYC,Seychelles,2008,1,2,-1
NLD,Netherlands,SYC,Seychelles,2010,0,3,-3
NLD,Netherlands,SYC,Seychelles,2012,1,3,-2
NLD,Netherlands,SYC,Seychelles,2013,0,0,0
NLD,Netherlands,SYC,Seychelles,2015,0,3,-3
NLD,Netherlands,SYC,Seychelles,2016,2,0,2
NLD,Netherlands,SYC,Seychelles,2017,0,3,-3
NZL,New Zealand,SYC,Seychelles,2008,2,12,-10
NZL,New Zealand,SYC,Seychelles,2009,7,16,-9
NZL,New Zealand,SYC,Seychelles,2010,1,4,-3
NZL,New Zealand,SYC,Seychelles,2011,2,1,1
NZL,New Zealand,SYC,Seychelles,2012,1,4,-3
NZL,New Zealand,SYC,Seychelles,2013,2,3,-1
NZL,New Zealand,SYC,Seychelles,2014,3,2,1
NZL,New Zealand,SYC,Seychelles,2015,3,2,1
NZL,New Zealand,SYC,Seychelles,2016,4,3,1
NZL,New Zealand,SYC,Seychelles,2017,0,1,-1
NOR,Norway,SYC,Seychelles,2008,0,0,0
NOR,Norway,SYC,Seychelles,2009,1,0,1
NOR,Norway,SYC,Seychelles,2010,5,1,4
NOR,Norway,SYC,Seychelles,2011,1,1,0
NOR,Norway,SYC,Seychelles,2012,0,0,0
NOR,Norway,SYC,Seychelles,2013,0,0,0
NOR,Norway,SYC,Seychelles,2014,0,0,0
NOR,Norway,SYC,Seychelles,2015,1,0,1
NOR,Norway,SYC,Seychelles,2016,1,1,0
NOR,Norway,SYC,Seychelles,2017,0,2,-2
POL,Poland,SYC,Seychelles,2009,0,0,0
POL,Poland,SYC,Seychelles,2010,0,0,0
POL,Poland,SYC,Seychelles,2011,0,0,0
POL,Poland,SYC,Seychelles,2012,0,1,-1
POL,Poland,SYC,Seychelles,2013,0,1,-1
POL,Poland,SYC,Seychelles,2014,0,0,0
POL,Poland,SYC,Seychelles,2015,0,2,-2
POL,Poland,SYC,Seychelles,2016,0,1,-1
POL,Poland,SYC,Seychelles,2017,0,1,-1
SVK,Slovak Republic,SYC,Seychelles,2008,0,0,0
SVK,Slovak Republic,SYC,Seychelles,2009,2,1,1
ESP,Spain,SYC,Seychelles,2008,1,2,-1
ESP,Spain,SYC,Seychelles,2009,1,3,-2
ESP,Spain,SYC,Seychelles,2010,0,3,-3
ESP,Spain,SYC,Seychelles,2011,6,2,4
ESP,Spain,SYC,Seychelles,2012,1,3,-2
ESP,Spain,SYC,Seychelles,2013,0,3,-3
ESP,Spain,SYC,Seychelles,2014,1,0,1
ESP,Spain,SYC,Seychelles,2015,0,3,-3
ESP,Spain,SYC,Seychelles,2016,0,4,-4
ESP,Spain,SYC,Seychelles,2017,1,6,-5
SWE,Sweden,SYC,Seychelles,2008,2,0,2
SWE,Sweden,SYC,Seychelles,2009,2,0,2
SWE,Sweden,SYC,Seychelles,2010,0,5,-5
SWE,Sweden,SYC,Seychelles,2011,0,4,-4
SWE,Sweden,SYC,Seychelles,2012,0,1,-1
SWE,Sweden,SYC,Seychelles,2013,1,2,-1
SWE,Sweden,SYC,Seychelles,2014,0,3,-3
SWE,Sweden,SYC,Seychelles,2015,0,0,0
SWE,Sweden,SYC,Seychelles,2016,0,1,-1
SWE,Sweden,SYC,Seychelles,2017,0,3,-3
CHE,Switzerland,SYC,Seychelles,2010,6,3,3
CHE,Switzerland,SYC,Seychelles,2011,1,6,-5
CHE,Switzerland,SYC,Seychelles,2012,3,1,2
CHE,Switzerland,SYC,Seychelles,2013,0,2,-2
CHE,Switzerland,SYC,Seychelles,2014,3,7,-4
CHE,Switzerland,SYC,Seychelles,2015,3,5,-2
CHE,Switzerland,SYC,Seychelles,2016,2,2,0
CHE,Switzerland,SYC,Seychelles,2017,3,5,-2
USA,United States,SYC,Seychelles,2008,0,16,-16
USA,United States,SYC,Seychelles,2009,0,10,-10
USA,United States,SYC,Seychelles,2010,0,8,-8
USA,United States,SYC,Seychelles,2011,0,15,-15
USA,United States,SYC,Seychelles,2012,0,7,-7
USA,United States,SYC,Seychelles,2013,0,6,-6
USA,United States,SYC,Seychelles,2014,0,7,-7
USA,United States,SYC,Seychelles,2015,0,11,-11
USA,United States,SYC,Seychelles,2016,0,16,-16
USA,United States,SYC,Seychelles,2017,0,10,-10
CHL,Chile,SYC,Seychelles,2008,0,0,0
CHL,Chile,SYC,Seychelles,2009,0,0,0
CHL,Chile,SYC,Seychelles,2010,0,0,0
CHL,Chile,SYC,Seychelles,2011,0,0,0
CHL,Chile,SYC,Seychelles,2012,0,0,0
CHL,Chile,SYC,Seychelles,2013,0,0,0
CHL,Chile,SYC,Seychelles,2014,0,0,0
CHL,Chile,SYC,Seychelles,2015,0,0,0
CHL,Chile,SYC,Seychelles,2016,0,0,0
EST,Estonia,SYC,Seychelles,2008,0,0,0
EST,Estonia,SYC,Seychelles,2009,0,0,0
EST,Estonia,SYC,Seychelles,2010,0,0,0
EST,Estonia,SYC,Seychelles,2011,0,0,0
EST,Estonia,SYC,Seychelles,2012,0,0,0
EST,Estonia,SYC,Seychelles,2013,0,0,0
EST,Estonia,SYC,Seychelles,2014,0,0,0
EST,Estonia,SYC,Seychelles,2015,0,0,0
EST,Estonia,SYC,Seychelles,2016,0,0,0
EST,Estonia,SYC,Seychelles,2017,0,0,0
AUS,Australia,SLE,Sierra Leone,2008,22,290,-268
AUS,Australia,SLE,Sierra Leone,2009,0,212,-212
AUS,Australia,SLE,Sierra Leone,2010,17,463,-446
AUS,Australia,SLE,Sierra Leone,2011,14,153,-139
AUS,Australia,SLE,Sierra Leone,2012,21,144,-123
AUS,Australia,SLE,Sierra Leone,2013,17,95,-78
AUS,Australia,SLE,Sierra Leone,2014,23,99,-76
AUS,Australia,SLE,Sierra Leone,2015,0,48,-48
AUS,Australia,SLE,Sierra Leone,2016,0,34,-34
AUS,Australia,SLE,Sierra Leone,2017,0,100,-100
AUT,Austria,SLE,Sierra Leone,2008,43,16,27
AUT,Austria,SLE,Sierra Leone,2009,34,30,4
AUT,Austria,SLE,Sierra Leone,2010,48,28,20
AUT,Austria,SLE,Sierra Leone,2011,27,36,-9
AUT,Austria,SLE,Sierra Leone,2012,31,44,-13
AUT,Austria,SLE,Sierra Leone,2013,30,36,-6
AUT,Austria,SLE,Sierra Leone,2014,19,30,-11
AUT,Austria,SLE,Sierra Leone,2015,20,35,-15
AUT,Austria,SLE,Sierra Leone,2016,36,36,0
AUT,Austria,SLE,Sierra Leone,2017,26,33,-7
BEL,Belgium,SLE,Sierra Leone,2008,0,42,-42
BEL,Belgium,SLE,Sierra Leone,2009,0,52,-52
BEL,Belgium,SLE,Sierra Leone,2010,6,53,-47
BEL,Belgium,SLE,Sierra Leone,2012,52,163,-111
BEL,Belgium,SLE,Sierra Leone,2013,66,124,-58
BEL,Belgium,SLE,Sierra Leone,2014,61,119,-58
BEL,Belgium,SLE,Sierra Leone,2015,69,93,-24
BEL,Belgium,SLE,Sierra Leone,2016,20,82,-62
BEL,Belgium,SLE,Sierra Leone,2017,21,96,-75
CAN,Canada,SLE,Sierra Leone,2008,0,103,-103
CAN,Canada,SLE,Sierra Leone,2009,0,70,-70
CAN,Canada,SLE,Sierra Leone,2010,0,63,-63
CAN,Canada,SLE,Sierra Leone,2011,0,96,-96
CAN,Canada,SLE,Sierra Leone,2012,0,72,-72
CAN,Canada,SLE,Sierra Leone,2013,0,63,-63
CAN,Canada,SLE,Sierra Leone,2014,0,60,-60
CAN,Canada,SLE,Sierra Leone,2015,0,94,-94
CAN,Canada,SLE,Sierra Leone,2016,0,90,-90
CAN,Canada,SLE,Sierra Leone,2017,0,40,-40
CZE,Czech Republic,SLE,Sierra Leone,2008,0,3,-3
CZE,Czech Republic,SLE,Sierra Leone,2009,0,5,-5
CZE,Czech Republic,SLE,Sierra Leone,2012,1,1,0
CZE,Czech Republic,SLE,Sierra Leone,2014,1,2,-1
CZE,Czech Republic,SLE,Sierra Leone,2015,0,3,-3
DNK,Denmark,SLE,Sierra Leone,2008,0,8,-8
DNK,Denmark,SLE,Sierra Leone,2009,2,8,-6
DNK,Denmark,SLE,Sierra Leone,2010,3,10,-7
DNK,Denmark,SLE,Sierra Leone,2011,0,5,-5
DNK,Denmark,SLE,Sierra Leone,2012,7,6,1
DNK,Denmark,SLE,Sierra Leone,2013,3,4,-1
DNK,Denmark,SLE,Sierra Leone,2014,3,6,-3
DNK,Denmark,SLE,Sierra Leone,2015,2,2,0
DNK,Denmark,SLE,Sierra Leone,2016,3,3,0
DNK,Denmark,SLE,Sierra Leone,2017,1,2,-1
FIN,Finland,SLE,Sierra Leone,2008,2,14,-12
FIN,Finland,SLE,Sierra Leone,2009,2,6,-4
FIN,Finland,SLE,Sierra Leone,2010,0,5,-5
FIN,Finland,SLE,Sierra Leone,2011,1,5,-4
FIN,Finland,SLE,Sierra Leone,2012,1,8,-7
FIN,Finland,SLE,Sierra Leone,2013,0,11,-11
FIN,Finland,SLE,Sierra Leone,2014,1,9,-8
FIN,Finland,SLE,Sierra Leone,2015,0,2,-2
FIN,Finland,SLE,Sierra Leone,2016,0,4,-4
FIN,Finland,SLE,Sierra Leone,2017,1,5,-4
FRA,France,SLE,Sierra Leone,2008,0,91,-91
FRA,France,SLE,Sierra Leone,2009,0,83,-83
FRA,France,SLE,Sierra Leone,2010,0,88,-88
FRA,France,SLE,Sierra Leone,2011,0,77,-77
FRA,France,SLE,Sierra Leone,2012,0,69,-69
FRA,France,SLE,Sierra Leone,2013,0,90,-90
FRA,France,SLE,Sierra Leone,2014,0,84,-84
FRA,France,SLE,Sierra Leone,2015,0,91,-91
FRA,France,SLE,Sierra Leone,2016,0,91,-91
FRA,France,SLE,Sierra Leone,2017,0,84,-84
DEU,Germany,SLE,Sierra Leone,2008,336,257,79
DEU,Germany,SLE,Sierra Leone,2009,327,231,96
DEU,Germany,SLE,Sierra Leone,2010,203,219,-16
DEU,Germany,SLE,Sierra Leone,2011,183,201,-18
DEU,Germany,SLE,Sierra Leone,2012,135,198,-63
DEU,Germany,SLE,Sierra Leone,2013,113,278,-165
DEU,Germany,SLE,Sierra Leone,2014,136,313,-177
DEU,Germany,SLE,Sierra Leone,2015,129,551,-422
DEU,Germany,SLE,Sierra Leone,2016,182,906,-724
DEU,Germany,SLE,Sierra Leone,2017,308,939,-631
HUN,Hungary,SLE,Sierra Leone,2008,0,1,-1
HUN,Hungary,SLE,Sierra Leone,2009,0,2,-2
HUN,Hungary,SLE,Sierra Leone,2010,0,3,-3
HUN,Hungary,SLE,Sierra Leone,2011,0,0,0
HUN,Hungary,SLE,Sierra Leone,2012,0,0,0
HUN,Hungary,SLE,Sierra Leone,2013,0,0,0
HUN,Hungary,SLE,Sierra Leone,2014,0,1,-1
HUN,Hungary,SLE,Sierra Leone,2015,0,0,0
HUN,Hungary,SLE,Sierra Leone,2016,0,2,-2
HUN,Hungary,SLE,Sierra Leone,2017,0,1,-1
ISL,Iceland,SLE,Sierra Leone,2008,0,0,0
ISL,Iceland,SLE,Sierra Leone,2009,0,2,-2
ISL,Iceland,SLE,Sierra Leone,2010,1,1,0
ISL,Iceland,SLE,Sierra Leone,2011,0,1,-1
ISL,Iceland,SLE,Sierra Leone,2012,0,1,-1
ISL,Iceland,SLE,Sierra Leone,2013,1,0,1
ISL,Iceland,SLE,Sierra Leone,2014,0,1,-1
ISL,Iceland,SLE,Sierra Leone,2015,0,0,0
ISL,Iceland,SLE,Sierra Leone,2016,0,0,0
ISL,Iceland,SLE,Sierra Leone,2017,0,1,-1
ITA,Italy,SLE,Sierra Leone,2008,3,84,-81
ITA,Italy,SLE,Sierra Leone,2009,4,78,-74
ITA,Italy,SLE,Sierra Leone,2010,4,106,-102
ITA,Italy,SLE,Sierra Leone,2011,2,68,-66
ITA,Italy,SLE,Sierra Leone,2012,5,114,-109
ITA,Italy,SLE,Sierra Leone,2013,6,68,-62
ITA,Italy,SLE,Sierra Leone,2014,1,68,-67
ITA,Italy,SLE,Sierra Leone,2015,6,122,-116
ITA,Italy,SLE,Sierra Leone,2016,0,207,-207
ITA,Italy,SLE,Sierra Leone,2017,5,690,-685
JPN,Japan,SLE,Sierra Leone,2008,41,42,-1
JPN,Japan,SLE,Sierra Leone,2009,32,34,-2
JPN,Japan,SLE,Sierra Leone,2010,22,30,-8
JPN,Japan,SLE,Sierra Leone,2011,36,35,1
JPN,Japan,SLE,Sierra Leone,2012,51,53,-2
JPN,Japan,SLE,Sierra Leone,2013,66,68,-2
JPN,Japan,SLE,Sierra Leone,2014,27,23,4
JPN,Japan,SLE,Sierra Leone,2015,17,21,-4
JPN,Japan,SLE,Sierra Leone,2016,57,61,-4
JPN,Japan,SLE,Sierra Leone,2017,74,78,-4
KOR,Korea,SLE,Sierra Leone,2008,1,0,1
KOR,Korea,SLE,Sierra Leone,2009,1,3,-2
KOR,Korea,SLE,Sierra Leone,2010,1,1,0
KOR,Korea,SLE,Sierra Leone,2011,2,5,-3
KOR,Korea,SLE,Sierra Leone,2012,2,2,0
KOR,Korea,SLE,Sierra Leone,2013,1,4,-3
KOR,Korea,SLE,Sierra Leone,2014,6,3,3
KOR,Korea,SLE,Sierra Leone,2015,2,16,-14
KOR,Korea,SLE,Sierra Leone,2016,9,3,6
KOR,Korea,SLE,Sierra Leone,2017,4,6,-2
LUX,Luxembourg,SLE,Sierra Leone,2008,5,3,2
LUX,Luxembourg,SLE,Sierra Leone,2009,1,2,-1
LUX,Luxembourg,SLE,Sierra Leone,2010,0,1,-1
LUX,Luxembourg,SLE,Sierra Leone,2011,0,1,-1
LUX,Luxembourg,SLE,Sierra Leone,2012,1,0,1
LUX,Luxembourg,SLE,Sierra Leone,2013,0,1,-1
LUX,Luxembourg,SLE,Sierra Leone,2014,1,1,0
LUX,Luxembourg,SLE,Sierra Leone,2015,1,1,0
LUX,Luxembourg,SLE,Sierra Leone,2016,2,4,-2
LUX,Luxembourg,SLE,Sierra Leone,2017,3,1,2
MEX,Mexico,SLE,Sierra Leone,2012,0,0,0
MEX,Mexico,SLE,Sierra Leone,2013,0,0,0
MEX,Mexico,SLE,Sierra Leone,2014,0,0,0
MEX,Mexico,SLE,Sierra Leone,2015,0,1,-1
MEX,Mexico,SLE,Sierra Leone,2017,0,3,-3
NLD,Netherlands,SLE,Sierra Leone,2008,2,67,-65
NLD,Netherlands,SLE,Sierra Leone,2009,9,82,-73
NLD,Netherlands,SLE,Sierra Leone,2010,12,67,-55
NLD,Netherlands,SLE,Sierra Leone,2011,15,29,-14
NLD,Netherlands,SLE,Sierra Leone,2012,9,51,-42
NLD,Netherlands,SLE,Sierra Leone,2013,14,59,-45
NLD,Netherlands,SLE,Sierra Leone,2014,9,92,-83
NLD,Netherlands,SLE,Sierra Leone,2015,2,72,-70
NLD,Netherlands,SLE,Sierra Leone,2016,7,77,-70
NLD,Netherlands,SLE,Sierra Leone,2017,11,92,-81
NZL,New Zealand,SLE,Sierra Leone,2008,1,3,-2
NZL,New Zealand,SLE,Sierra Leone,2010,5,1,4
NZL,New Zealand,SLE,Sierra Leone,2013,0,1,-1
NZL,New Zealand,SLE,Sierra Leone,2016,0,3,-3
NOR,Norway,SLE,Sierra Leone,2008,6,24,-18
NOR,Norway,SLE,Sierra Leone,2009,5,12,-7
NOR,Norway,SLE,Sierra Leone,2010,42,12,30
NOR,Norway,SLE,Sierra Leone,2011,7,18,-11
NOR,Norway,SLE,Sierra Leone,2012,5,19,-14
NOR,Norway,SLE,Sierra Leone,2013,3,13,-10
NOR,Norway,SLE,Sierra Leone,2014,6,22,-16
NOR,Norway,SLE,Sierra Leone,2015,9,7,2
NOR,Norway,SLE,Sierra Leone,2016,5,8,-3
NOR,Norway,SLE,Sierra Leone,2017,3,6,-3
POL,Poland,SLE,Sierra Leone,2009,0,8,-8
POL,Poland,SLE,Sierra Leone,2010,0,8,-8
POL,Poland,SLE,Sierra Leone,2011,0,9,-9
POL,Poland,SLE,Sierra Leone,2012,0,10,-10
POL,Poland,SLE,Sierra Leone,2013,0,4,-4
POL,Poland,SLE,Sierra Leone,2014,0,5,-5
POL,Poland,SLE,Sierra Leone,2015,0,3,-3
POL,Poland,SLE,Sierra Leone,2016,0,2,-2
POL,Poland,SLE,Sierra Leone,2017,0,1,-1
SVK,Slovak Republic,SLE,Sierra Leone,2008,0,0,0
ESP,Spain,SLE,Sierra Leone,2008,53,75,-22
ESP,Spain,SLE,Sierra Leone,2009,59,48,11
ESP,Spain,SLE,Sierra Leone,2010,57,43,14
ESP,Spain,SLE,Sierra Leone,2011,52,35,17
ESP,Spain,SLE,Sierra Leone,2012,27,41,-14
ESP,Spain,SLE,Sierra Leone,2013,49,42,7
ESP,Spain,SLE,Sierra Leone,2014,21,28,-7
ESP,Spain,SLE,Sierra Leone,2015,11,38,-27
ESP,Spain,SLE,Sierra Leone,2016,14,34,-20
ESP,Spain,SLE,Sierra Leone,2017,40,47,-7
SWE,Sweden,SLE,Sierra Leone,2008,7,47,-40
SWE,Sweden,SLE,Sierra Leone,2009,4,33,-29
SWE,Sweden,SLE,Sierra Leone,2010,9,44,-35
SWE,Sweden,SLE,Sierra Leone,2011,7,39,-32
SWE,Sweden,SLE,Sierra Leone,2012,4,47,-43
SWE,Sweden,SLE,Sierra Leone,2013,5,46,-41
SWE,Sweden,SLE,Sierra Leone,2014,5,42,-37
SWE,Sweden,SLE,Sierra Leone,2015,8,43,-35
SWE,Sweden,SLE,Sierra Leone,2016,5,44,-39
SWE,Sweden,SLE,Sierra Leone,2017,3,38,-35
CHE,Switzerland,SLE,Sierra Leone,2010,2,17,-15
CHE,Switzerland,SLE,Sierra Leone,2011,5,8,-3
CHE,Switzerland,SLE,Sierra Leone,2012,3,10,-7
CHE,Switzerland,SLE,Sierra Leone,2013,6,6,0
CHE,Switzerland,SLE,Sierra Leone,2014,0,5,-5
CHE,Switzerland,SLE,Sierra Leone,2015,2,12,-10
CHE,Switzerland,SLE,Sierra Leone,2016,1,1,0
CHE,Switzerland,SLE,Sierra Leone,2017,1,12,-11
TUR,Turkey,SLE,Sierra Leone,2010,0,5,-5
GBR,United Kingdom,SLE,Sierra Leone,2012,0,1000,-1000
USA,United States,SLE,Sierra Leone,2008,0,2795,-2795
USA,United States,SLE,Sierra Leone,2009,0,2687,-2687
USA,United States,SLE,Sierra Leone,2010,0,2011,-2011
USA,United States,SLE,Sierra Leone,2011,0,1985,-1985
USA,United States,SLE,Sierra Leone,2012,0,1688,-1688
USA,United States,SLE,Sierra Leone,2013,0,1651,-1651
USA,United States,SLE,Sierra Leone,2014,0,1740,-1740
USA,United States,SLE,Sierra Leone,2015,0,1599,-1599
USA,United States,SLE,Sierra Leone,2016,0,1535,-1535
USA,United States,SLE,Sierra Leone,2017,0,2058,-2058
CHL,Chile,SLE,Sierra Leone,2008,0,0,0
CHL,Chile,SLE,Sierra Leone,2009,0,0,0
CHL,Chile,SLE,Sierra Leone,2010,0,0,0
CHL,Chile,SLE,Sierra Leone,2011,0,0,0
CHL,Chile,SLE,Sierra Leone,2012,0,0,0
CHL,Chile,SLE,Sierra Leone,2013,0,0,0
CHL,Chile,SLE,Sierra Leone,2014,0,0,0
CHL,Chile,SLE,Sierra Leone,2015,0,0,0
CHL,Chile,SLE,Sierra Leone,2016,0,0,0
EST,Estonia,SLE,Sierra Leone,2008,0,0,0
EST,Estonia,SLE,Sierra Leone,2009,0,0,0
EST,Estonia,SLE,Sierra Leone,2010,0,0,0
EST,Estonia,SLE,Sierra Leone,2011,0,0,0
EST,Estonia,SLE,Sierra Leone,2012,0,0,0
EST,Estonia,SLE,Sierra Leone,2013,0,1,-1
EST,Estonia,SLE,Sierra Leone,2014,0,0,0
EST,Estonia,SLE,Sierra Leone,2015,0,1,-1
EST,Estonia,SLE,Sierra Leone,2016,0,3,-3
EST,Estonia,SLE,Sierra Leone,2017,0,3,-3
SVN,Slovenia,SLE,Sierra Leone,2010,0,1,-1
AUS,Australia,SRB,Serbia,2008,94,202,-108
AUS,Australia,SRB,Serbia,2009,107,228,-121
AUS,Australia,SRB,Serbia,2010,107,275,-168
AUS,Australia,SRB,Serbia,2011,124,237,-113
AUS,Australia,SRB,Serbia,2012,113,227,-114
AUS,Australia,SRB,Serbia,2013,139,244,-105
AUS,Australia,SRB,Serbia,2014,126,276,-150
AUS,Australia,SRB,Serbia,2015,100,255,-155
AUS,Australia,SRB,Serbia,2016,200,234,-34
AUS,Australia,SRB,Serbia,2017,0,235,-235
AUT,Austria,SRB,Serbia,2008,4834,6037,-1203
AUT,Austria,SRB,Serbia,2009,4471,4560,-89
AUT,Austria,SRB,Serbia,2010,5650,7134,-1484
AUT,Austria,SRB,Serbia,2011,5818,6051,-233
AUT,Austria,SRB,Serbia,2012,4966,6715,-1749
AUT,Austria,SRB,Serbia,2013,5029,7089,-2060
AUT,Austria,SRB,Serbia,2014,4873,7416,-2543
AUT,Austria,SRB,Serbia,2015,4690,7637,-2947
AUT,Austria,SRB,Serbia,2016,4875,7309,-2434
AUT,Austria,SRB,Serbia,2017,5096,7221,-2125
BEL,Belgium,SRB,Serbia,2008,0,175,-175
BEL,Belgium,SRB,Serbia,2009,0,201,-201
BEL,Belgium,SRB,Serbia,2010,56,362,-306
BEL,Belgium,SRB,Serbia,2011,0,329,-329
BEL,Belgium,SRB,Serbia,2012,810,671,139
BEL,Belgium,SRB,Serbia,2013,949,453,496
BEL,Belgium,SRB,Serbia,2014,715,369,346
BEL,Belgium,SRB,Serbia,2015,575,406,169
BEL,Belgium,SRB,Serbia,2016,215,323,-108
BEL,Belgium,SRB,Serbia,2017,254,395,-141
CAN,Canada,SRB,Serbia,2008,0,251,-251
CAN,Canada,SRB,Serbia,2009,0,349,-349
CAN,Canada,SRB,Serbia,2010,0,243,-243
CAN,Canada,SRB,Serbia,2011,0,280,-280
CAN,Canada,SRB,Serbia,2012,0,381,-381
CAN,Canada,SRB,Serbia,2013,0,295,-295
CAN,Canada,SRB,Serbia,2014,0,319,-319
CAN,Canada,SRB,Serbia,2015,0,576,-576
CAN,Canada,SRB,Serbia,2016,0,475,-475
CAN,Canada,SRB,Serbia,2017,0,375,-375
CZE,Czech Republic,SRB,Serbia,2008,8,297,-289
CZE,Czech Republic,SRB,Serbia,2009,9,184,-175
CZE,Czech Republic,SRB,Serbia,2010,6,201,-195
CZE,Czech Republic,SRB,Serbia,2011,9,123,-114
CZE,Czech Republic,SRB,Serbia,2012,74,179,-105
CZE,Czech Republic,SRB,Serbia,2013,146,151,-5
CZE,Czech Republic,SRB,Serbia,2014,140,215,-75
CZE,Czech Republic,SRB,Serbia,2015,151,232,-81
CZE,Czech Republic,SRB,Serbia,2016,155,230,-75
CZE,Czech Republic,SRB,Serbia,2017,113,414,-301
DNK,Denmark,SRB,Serbia,2008,9,83,-74
DNK,Denmark,SRB,Serbia,2009,13,77,-64
DNK,Denmark,SRB,Serbia,2010,24,106,-82
DNK,Denmark,SRB,Serbia,2011,29,87,-58
DNK,Denmark,SRB,Serbia,2012,42,87,-45
DNK,Denmark,SRB,Serbia,2013,39,111,-72
DNK,Denmark,SRB,Serbia,2014,51,120,-69
DNK,Denmark,SRB,Serbia,2015,75,135,-60
DNK,Denmark,SRB,Serbia,2016,60,122,-62
DNK,Denmark,SRB,Serbia,2017,73,136,-63
FIN,Finland,SRB,Serbia,2008,3,219,-216
FIN,Finland,SRB,Serbia,2009,8,55,-47
FIN,Finland,SRB,Serbia,2010,4,41,-37
FIN,Finland,SRB,Serbia,2011,5,32,-27
FIN,Finland,SRB,Serbia,2012,7,29,-22
FIN,Finland,SRB,Serbia,2013,6,48,-42
FIN,Finland,SRB,Serbia,2014,5,48,-43
FIN,Finland,SRB,Serbia,2015,9,63,-54
FIN,Finland,SRB,Serbia,2016,6,49,-43
FIN,Finland,SRB,Serbia,2017,14,44,-30
FRA,France,SRB,Serbia,2008,0,1471,-1471
FRA,France,SRB,Serbia,2009,0,1261,-1261
FRA,France,SRB,Serbia,2010,0,919,-919
FRA,France,SRB,Serbia,2011,0,901,-901
FRA,France,SRB,Serbia,2012,0,915,-915
FRA,France,SRB,Serbia,2013,0,1032,-1032
FRA,France,SRB,Serbia,2014,0,991,-991
FRA,France,SRB,Serbia,2015,0,945,-945
FRA,France,SRB,Serbia,2016,0,1089,-1089
FRA,France,SRB,Serbia,2017,0,963,-963
DEU,Germany,SRB,Serbia,2008,7019,5396,1623
DEU,Germany,SRB,Serbia,2009,7730,7024,706
DEU,Germany,SRB,Serbia,2010,10682,16666,-5984
DEU,Germany,SRB,Serbia,2011,14721,16524,-1803
DEU,Germany,SRB,Serbia,2012,16498,22107,-5609
DEU,Germany,SRB,Serbia,2013,19977,27302,-7325
DEU,Germany,SRB,Serbia,2014,23278,38440,-15162
DEU,Germany,SRB,Serbia,2015,33153,39719,-6566
DEU,Germany,SRB,Serbia,2016,32754,22896,9858
DEU,Germany,SRB,Serbia,2017,18554,24475,-5921
HUN,Hungary,SRB,Serbia,2008,165,4094,-3929
HUN,Hungary,SRB,Serbia,2009,296,1190,-894
HUN,Hungary,SRB,Serbia,2010,284,985,-701
HUN,Hungary,SRB,Serbia,2011,523,845,-322
HUN,Hungary,SRB,Serbia,2012,563,637,-74
HUN,Hungary,SRB,Serbia,2013,365,522,-157
HUN,Hungary,SRB,Serbia,2014,160,462,-302
HUN,Hungary,SRB,Serbia,2015,146,583,-437
HUN,Hungary,SRB,Serbia,2016,150,578,-428
HUN,Hungary,SRB,Serbia,2017,684,1659,-975
ISL,Iceland,SRB,Serbia,2008,16,17,-1
ISL,Iceland,SRB,Serbia,2009,20,13,7
ISL,Iceland,SRB,Serbia,2010,11,10,1
ISL,Iceland,SRB,Serbia,2011,4,15,-11
ISL,Iceland,SRB,Serbia,2012,11,9,2
ISL,Iceland,SRB,Serbia,2013,17,22,-5
ISL,Iceland,SRB,Serbia,2014,19,16,3
ISL,Iceland,SRB,Serbia,2015,13,25,-12
ISL,Iceland,SRB,Serbia,2016,13,38,-25
ISL,Iceland,SRB,Serbia,2017,15,55,-40
ITA,Italy,SRB,Serbia,2008,339,5581,-5242
ITA,Italy,SRB,Serbia,2009,435,4778,-4343
ITA,Italy,SRB,Serbia,2010,515,5056,-4541
ITA,Italy,SRB,Serbia,2011,372,1489,-1117
ITA,Italy,SRB,Serbia,2012,675,1289,-614
ITA,Italy,SRB,Serbia,2013,319,1028,-709
ITA,Italy,SRB,Serbia,2014,317,727,-410
ITA,Italy,SRB,Serbia,2015,308,788,-480
ITA,Italy,SRB,Serbia,2016,0,784,-784
ITA,Italy,SRB,Serbia,2017,234,903,-669
JPN,Japan,SRB,Serbia,2008,23,26,-3
JPN,Japan,SRB,Serbia,2009,95,102,-7
JPN,Japan,SRB,Serbia,2010,196,210,-14
JPN,Japan,SRB,Serbia,2011,102,113,-11
JPN,Japan,SRB,Serbia,2012,81,96,-15
JPN,Japan,SRB,Serbia,2013,88,106,-18
JPN,Japan,SRB,Serbia,2014,72,85,-13
JPN,Japan,SRB,Serbia,2015,93,84,9
JPN,Japan,SRB,Serbia,2016,111,119,-8
JPN,Japan,SRB,Serbia,2017,150,173,-23
KOR,Korea,SRB,Serbia,2008,0,0,0
KOR,Korea,SRB,Serbia,2009,3,22,-19
KOR,Korea,SRB,Serbia,2010,14,11,3
KOR,Korea,SRB,Serbia,2011,14,18,-4
KOR,Korea,SRB,Serbia,2012,13,15,-2
KOR,Korea,SRB,Serbia,2013,24,21,3
KOR,Korea,SRB,Serbia,2014,20,20,0
KOR,Korea,SRB,Serbia,2015,17,20,-3
KOR,Korea,SRB,Serbia,2016,33,26,7
KOR,Korea,SRB,Serbia,2017,31,20,11
LUX,Luxembourg,SRB,Serbia,2008,30,48,-18
LUX,Luxembourg,SRB,Serbia,2009,21,28,-7
LUX,Luxembourg,SRB,Serbia,2010,20,189,-169
LUX,Luxembourg,SRB,Serbia,2011,74,727,-653
LUX,Luxembourg,SRB,Serbia,2012,445,231,214
LUX,Luxembourg,SRB,Serbia,2013,167,131,36
LUX,Luxembourg,SRB,Serbia,2014,84,126,-42
LUX,Luxembourg,SRB,Serbia,2015,119,154,-35
LUX,Luxembourg,SRB,Serbia,2016,60,214,-154
LUX,Luxembourg,SRB,Serbia,2017,115,182,-67
MEX,Mexico,SRB,Serbia,2008,0,3,-3
MEX,Mexico,SRB,Serbia,2009,0,11,-11
MEX,Mexico,SRB,Serbia,2010,0,8,-8
MEX,Mexico,SRB,Serbia,2011,0,5,-5
MEX,Mexico,SRB,Serbia,2012,0,5,-5
MEX,Mexico,SRB,Serbia,2013,0,17,-17
MEX,Mexico,SRB,Serbia,2014,0,18,-18
MEX,Mexico,SRB,Serbia,2015,0,19,-19
MEX,Mexico,SRB,Serbia,2016,0,13,-13
MEX,Mexico,SRB,Serbia,2017,0,12,-12
NLD,Netherlands,SRB,Serbia,2010,71,279,-208
NLD,Netherlands,SRB,Serbia,2011,104,250,-146
NLD,Netherlands,SRB,Serbia,2012,115,261,-146
NLD,Netherlands,SRB,Serbia,2013,136,273,-137
NLD,Netherlands,SRB,Serbia,2014,176,303,-127
NLD,Netherlands,SRB,Serbia,2015,129,315,-186
NLD,Netherlands,SRB,Serbia,2016,139,361,-222
NLD,Netherlands,SRB,Serbia,2017,163,356,-193
NZL,New Zealand,SRB,Serbia,2008,0,5,-5
NZL,New Zealand,SRB,Serbia,2009,8,15,-7
NZL,New Zealand,SRB,Serbia,2010,4,10,-6
NZL,New Zealand,SRB,Serbia,2011,1,19,-18
NZL,New Zealand,SRB,Serbia,2012,4,26,-22
NZL,New Zealand,SRB,Serbia,2013,6,31,-25
NZL,New Zealand,SRB,Serbia,2014,1,40,-39
NZL,New Zealand,SRB,Serbia,2015,6,56,-50
NZL,New Zealand,SRB,Serbia,2016,1,70,-69
NZL,New Zealand,SRB,Serbia,2017,10,92,-82
NOR,Norway,SRB,Serbia,2008,18,397,-379
NOR,Norway,SRB,Serbia,2009,32,224,-192
NOR,Norway,SRB,Serbia,2010,3,212,-209
NOR,Norway,SRB,Serbia,2011,80,329,-249
NOR,Norway,SRB,Serbia,2012,67,502,-435
NOR,Norway,SRB,Serbia,2013,94,574,-480
NOR,Norway,SRB,Serbia,2014,81,562,-481
NOR,Norway,SRB,Serbia,2015,92,731,-639
NOR,Norway,SRB,Serbia,2016,115,751,-636
NOR,Norway,SRB,Serbia,2017,98,705,-607
POL,Poland,SRB,Serbia,2009,0,126,-126
POL,Poland,SRB,Serbia,2010,0,130,-130
POL,Poland,SRB,Serbia,2011,0,115,-115
POL,Poland,SRB,Serbia,2012,0,122,-122
POL,Poland,SRB,Serbia,2013,0,107,-107
POL,Poland,SRB,Serbia,2014,0,63,-63
POL,Poland,SRB,Serbia,2015,0,265,-265
POL,Poland,SRB,Serbia,2016,0,332,-332
POL,Poland,SRB,Serbia,2017,0,270,-270
SVK,Slovak Republic,SRB,Serbia,2008,7,66,-59
SVK,Slovak Republic,SRB,Serbia,2009,68,47,21
SVK,Slovak Republic,SRB,Serbia,2010,89,31,58
SVK,Slovak Republic,SRB,Serbia,2011,44,15,29
SVK,Slovak Republic,SRB,Serbia,2012,2,20,-18
SVK,Slovak Republic,SRB,Serbia,2013,0,27,-27
SVK,Slovak Republic,SRB,Serbia,2014,1,15,-14
SVK,Slovak Republic,SRB,Serbia,2015,0,46,-46
SVK,Slovak Republic,SRB,Serbia,2016,0,26,-26
SVK,Slovak Republic,SRB,Serbia,2017,0,35,-35
ESP,Spain,SRB,Serbia,2008,230,287,-57
ESP,Spain,SRB,Serbia,2009,254,233,21
ESP,Spain,SRB,Serbia,2010,242,342,-100
ESP,Spain,SRB,Serbia,2011,204,353,-149
ESP,Spain,SRB,Serbia,2012,215,288,-73
ESP,Spain,SRB,Serbia,2013,265,269,-4
ESP,Spain,SRB,Serbia,2014,177,341,-164
ESP,Spain,SRB,Serbia,2015,152,351,-199
ESP,Spain,SRB,Serbia,2016,152,427,-275
ESP,Spain,SRB,Serbia,2017,235,435,-200
SWE,Sweden,SRB,Serbia,2008,39,1791,-1752
SWE,Sweden,SRB,Serbia,2009,54,1021,-967
SWE,Sweden,SRB,Serbia,2010,83,864,-781
SWE,Sweden,SRB,Serbia,2011,94,1028,-934
SWE,Sweden,SRB,Serbia,2012,84,1264,-1180
SWE,Sweden,SRB,Serbia,2013,105,961,-856
SWE,Sweden,SRB,Serbia,2014,143,1696,-1553
SWE,Sweden,SRB,Serbia,2015,226,1693,-1467
SWE,Sweden,SRB,Serbia,2016,157,1598,-1441
SWE,Sweden,SRB,Serbia,2017,142,1961,-1819
CHE,Switzerland,SRB,Serbia,2008,1123,4937,-3814
CHE,Switzerland,SRB,Serbia,2009,1090,2624,-1534
CHE,Switzerland,SRB,Serbia,2010,1085,2346,-1261
CHE,Switzerland,SRB,Serbia,2011,912,1967,-1055
CHE,Switzerland,SRB,Serbia,2012,874,1658,-784
CHE,Switzerland,SRB,Serbia,2013,880,1731,-851
CHE,Switzerland,SRB,Serbia,2014,843,1506,-663
CHE,Switzerland,SRB,Serbia,2015,892,1506,-614
CHE,Switzerland,SRB,Serbia,2016,888,1528,-640
CHE,Switzerland,SRB,Serbia,2017,883,1395,-512
TUR,Turkey,SRB,Serbia,2010,0,156,-156
TUR,Turkey,SRB,Serbia,2016,245,228,17
TUR,Turkey,SRB,Serbia,2017,271,229,42
USA,United States,SRB,Serbia,2010,0,20,-20
USA,United States,SRB,Serbia,2011,0,244,-244
USA,United States,SRB,Serbia,2012,0,704,-704
USA,United States,SRB,Serbia,2013,0,866,-866
USA,United States,SRB,Serbia,2014,0,1143,-1143
USA,United States,SRB,Serbia,2015,0,1278,-1278
USA,United States,SRB,Serbia,2016,0,1351,-1351
USA,United States,SRB,Serbia,2017,0,1410,-1410
CHL,Chile,SRB,Serbia,2008,0,1,-1
CHL,Chile,SRB,Serbia,2009,0,7,-7
CHL,Chile,SRB,Serbia,2010,0,7,-7
CHL,Chile,SRB,Serbia,2011,0,14,-14
CHL,Chile,SRB,Serbia,2012,0,13,-13
CHL,Chile,SRB,Serbia,2013,0,4,-4
CHL,Chile,SRB,Serbia,2014,0,4,-4
CHL,Chile,SRB,Serbia,2015,0,13,-13
CHL,Chile,SRB,Serbia,2016,0,8,-8
EST,Estonia,SRB,Serbia,2008,0,0,0
EST,Estonia,SRB,Serbia,2009,0,3,-3
EST,Estonia,SRB,Serbia,2010,0,1,-1
EST,Estonia,SRB,Serbia,2011,0,3,-3
EST,Estonia,SRB,Serbia,2012,0,2,-2
EST,Estonia,SRB,Serbia,2013,0,3,-3
EST,Estonia,SRB,Serbia,2014,0,4,-4
EST,Estonia,SRB,Serbia,2015,0,8,-8
EST,Estonia,SRB,Serbia,2016,0,5,-5
EST,Estonia,SRB,Serbia,2017,0,12,-12
SVN,Slovenia,SRB,Serbia,2008,1393,7436,-6043
SVN,Slovenia,SRB,Serbia,2009,2207,2494,-287
SVN,Slovenia,SRB,Serbia,2010,1255,1506,-251
SVN,Slovenia,SRB,Serbia,2011,188,1753,-1565
SVN,Slovenia,SRB,Serbia,2012,167,1565,-1398
SVN,Slovenia,SRB,Serbia,2013,61,1439,-1378
SVN,Slovenia,SRB,Serbia,2014,110,1543,-1433
SVN,Slovenia,SRB,Serbia,2015,207,2236,-2029
SVN,Slovenia,SRB,Serbia,2016,256,2721,-2465
SVN,Slovenia,SRB,Serbia,2017,338,3828,-3490
AUS,Australia,SGP,Singapore,2008,400,2448,-2048
AUS,Australia,SGP,Singapore,2009,360,2102,-1742
AUS,Australia,SGP,Singapore,2010,377,1873,-1496
AUS,Australia,SGP,Singapore,2011,434,1493,-1059
AUS,Australia,SGP,Singapore,2012,385,1786,-1401
AUS,Australia,SGP,Singapore,2013,421,2039,-1618
AUS,Australia,SGP,Singapore,2014,453,1880,-1427
AUS,Australia,SGP,Singapore,2015,400,1931,-1531
AUS,Australia,SGP,Singapore,2016,400,1715,-1315
AUS,Australia,SGP,Singapore,2017,0,1560,-1560
AUT,Austria,SGP,Singapore,2008,15,30,-15
AUT,Austria,SGP,Singapore,2009,30,24,6
AUT,Austria,SGP,Singapore,2010,30,32,-2
AUT,Austria,SGP,Singapore,2011,28,49,-21
AUT,Austria,SGP,Singapore,2012,36,52,-16
AUT,Austria,SGP,Singapore,2013,46,53,-7
AUT,Austria,SGP,Singapore,2014,48,57,-9
AUT,Austria,SGP,Singapore,2015,38,43,-5
AUT,Austria,SGP,Singapore,2016,45,38,7
AUT,Austria,SGP,Singapore,2017,44,57,-13
BEL,Belgium,SGP,Singapore,2008,0,44,-44
BEL,Belgium,SGP,Singapore,2009,0,40,-40
BEL,Belgium,SGP,Singapore,2010,40,50,-10
BEL,Belgium,SGP,Singapore,2012,26,44,-18
BEL,Belgium,SGP,Singapore,2013,37,42,-5
BEL,Belgium,SGP,Singapore,2014,44,32,12
BEL,Belgium,SGP,Singapore,2015,31,33,-2
BEL,Belgium,SGP,Singapore,2016,28,38,-10
BEL,Belgium,SGP,Singapore,2017,25,41,-16
CAN,Canada,SGP,Singapore,2008,0,734,-734
CAN,Canada,SGP,Singapore,2009,0,366,-366
CAN,Canada,SGP,Singapore,2010,0,805,-805
CAN,Canada,SGP,Singapore,2011,0,219,-219
CAN,Canada,SGP,Singapore,2012,0,145,-145
CAN,Canada,SGP,Singapore,2013,0,141,-141
CAN,Canada,SGP,Singapore,2014,0,179,-179
CAN,Canada,SGP,Singapore,2015,0,255,-255
CAN,Canada,SGP,Singapore,2016,0,260,-260
CAN,Canada,SGP,Singapore,2017,0,315,-315
CZE,Czech Republic,SGP,Singapore,2008,0,11,-11
CZE,Czech Republic,SGP,Singapore,2009,0,13,-13
CZE,Czech Republic,SGP,Singapore,2010,0,21,-21
CZE,Czech Republic,SGP,Singapore,2011,0,6,-6
CZE,Czech Republic,SGP,Singapore,2012,1,10,-9
CZE,Czech Republic,SGP,Singapore,2013,6,4,2
CZE,Czech Republic,SGP,Singapore,2014,4,19,-15
CZE,Czech Republic,SGP,Singapore,2015,14,29,-15
CZE,Czech Republic,SGP,Singapore,2016,25,50,-25
CZE,Czech Republic,SGP,Singapore,2017,49,116,-67
DNK,Denmark,SGP,Singapore,2008,48,52,-4
DNK,Denmark,SGP,Singapore,2009,95,40,55
DNK,Denmark,SGP,Singapore,2010,110,43,67
DNK,Denmark,SGP,Singapore,2011,75,52,23
DNK,Denmark,SGP,Singapore,2012,123,52,71
DNK,Denmark,SGP,Singapore,2013,108,58,50
DNK,Denmark,SGP,Singapore,2014,122,29,93
DNK,Denmark,SGP,Singapore,2015,142,77,65
DNK,Denmark,SGP,Singapore,2016,147,70,77
DNK,Denmark,SGP,Singapore,2017,150,52,98
FIN,Finland,SGP,Singapore,2008,3,23,-20
FIN,Finland,SGP,Singapore,2009,9,16,-7
FIN,Finland,SGP,Singapore,2010,2,6,-4
FIN,Finland,SGP,Singapore,2011,12,16,-4
FIN,Finland,SGP,Singapore,2012,11,13,-2
FIN,Finland,SGP,Singapore,2013,5,8,-3
FIN,Finland,SGP,Singapore,2014,1,16,-15
FIN,Finland,SGP,Singapore,2015,5,16,-11
FIN,Finland,SGP,Singapore,2016,7,9,-2
FIN,Finland,SGP,Singapore,2017,6,11,-5
FRA,France,SGP,Singapore,2008,0,102,-102
FRA,France,SGP,Singapore,2009,0,113,-113
FRA,France,SGP,Singapore,2010,0,108,-108
FRA,France,SGP,Singapore,2011,0,106,-106
FRA,France,SGP,Singapore,2012,0,102,-102
FRA,France,SGP,Singapore,2013,0,98,-98
FRA,France,SGP,Singapore,2014,0,84,-84
FRA,France,SGP,Singapore,2015,0,113,-113
FRA,France,SGP,Singapore,2016,0,108,-108
FRA,France,SGP,Singapore,2017,0,120,-120
DEU,Germany,SGP,Singapore,2008,374,346,28
DEU,Germany,SGP,Singapore,2009,355,331,24
DEU,Germany,SGP,Singapore,2010,340,470,-130
DEU,Germany,SGP,Singapore,2011,374,456,-82
DEU,Germany,SGP,Singapore,2012,374,464,-90
DEU,Germany,SGP,Singapore,2013,372,496,-124
DEU,Germany,SGP,Singapore,2014,407,586,-179
DEU,Germany,SGP,Singapore,2015,446,604,-158
DEU,Germany,SGP,Singapore,2016,529,595,-66
DEU,Germany,SGP,Singapore,2017,462,591,-129
HUN,Hungary,SGP,Singapore,2008,0,19,-19
HUN,Hungary,SGP,Singapore,2009,1,21,-20
HUN,Hungary,SGP,Singapore,2010,3,13,-10
HUN,Hungary,SGP,Singapore,2011,1,21,-20
HUN,Hungary,SGP,Singapore,2012,0,12,-12
HUN,Hungary,SGP,Singapore,2013,8,12,-4
HUN,Hungary,SGP,Singapore,2014,1,15,-14
HUN,Hungary,SGP,Singapore,2015,3,18,-15
HUN,Hungary,SGP,Singapore,2016,2,14,-12
HUN,Hungary,SGP,Singapore,2017,0,20,-20
ISL,Iceland,SGP,Singapore,2008,1,0,1
ISL,Iceland,SGP,Singapore,2009,2,1,1
ISL,Iceland,SGP,Singapore,2010,1,0,1
ISL,Iceland,SGP,Singapore,2011,0,1,-1
ISL,Iceland,SGP,Singapore,2012,2,1,1
ISL,Iceland,SGP,Singapore,2013,0,4,-4
ISL,Iceland,SGP,Singapore,2014,3,1,2
ISL,Iceland,SGP,Singapore,2015,2,2,0
ISL,Iceland,SGP,Singapore,2016,3,2,1
ISL,Iceland,SGP,Singapore,2017,1,2,-1
ITA,Italy,SGP,Singapore,2008,3,19,-16
ITA,Italy,SGP,Singapore,2009,4,29,-25
ITA,Italy,SGP,Singapore,2010,4,20,-16
ITA,Italy,SGP,Singapore,2011,10,17,-7
ITA,Italy,SGP,Singapore,2012,11,16,-5
ITA,Italy,SGP,Singapore,2013,7,24,-17
ITA,Italy,SGP,Singapore,2014,9,20,-11
ITA,Italy,SGP,Singapore,2015,8,22,-14
ITA,Italy,SGP,Singapore,2016,0,5,-5
ITA,Italy,SGP,Singapore,2017,4,21,-17
JPN,Japan,SGP,Singapore,2008,377,561,-184
JPN,Japan,SGP,Singapore,2009,368,398,-30
JPN,Japan,SGP,Singapore,2010,422,486,-64
JPN,Japan,SGP,Singapore,2011,343,438,-95
JPN,Japan,SGP,Singapore,2012,357,473,-116
JPN,Japan,SGP,Singapore,2013,350,500,-150
JPN,Japan,SGP,Singapore,2014,367,524,-157
JPN,Japan,SGP,Singapore,2015,412,618,-206
JPN,Japan,SGP,Singapore,2016,541,700,-159
JPN,Japan,SGP,Singapore,2017,541,742,-201
KOR,Korea,SGP,Singapore,2008,212,239,-27
KOR,Korea,SGP,Singapore,2009,273,227,46
KOR,Korea,SGP,Singapore,2010,380,377,3
KOR,Korea,SGP,Singapore,2011,513,448,65
KOR,Korea,SGP,Singapore,2012,493,630,-137
KOR,Korea,SGP,Singapore,2013,658,621,37
KOR,Korea,SGP,Singapore,2014,678,620,58
KOR,Korea,SGP,Singapore,2015,785,616,169
KOR,Korea,SGP,Singapore,2016,878,719,159
KOR,Korea,SGP,Singapore,2017,879,743,136
LUX,Luxembourg,SGP,Singapore,2008,0,3,-3
LUX,Luxembourg,SGP,Singapore,2009,5,3,2
LUX,Luxembourg,SGP,Singapore,2010,1,4,-3
LUX,Luxembourg,SGP,Singapore,2011,2,4,-2
LUX,Luxembourg,SGP,Singapore,2012,2,4,-2
LUX,Luxembourg,SGP,Singapore,2013,5,5,0
LUX,Luxembourg,SGP,Singapore,2014,1,18,-17
LUX,Luxembourg,SGP,Singapore,2015,7,7,0
LUX,Luxembourg,SGP,Singapore,2016,3,11,-8
LUX,Luxembourg,SGP,Singapore,2017,4,17,-13
MEX,Mexico,SGP,Singapore,2008,0,1,-1
MEX,Mexico,SGP,Singapore,2009,0,1,-1
MEX,Mexico,SGP,Singapore,2010,0,3,-3
MEX,Mexico,SGP,Singapore,2011,0,1,-1
MEX,Mexico,SGP,Singapore,2012,0,4,-4
MEX,Mexico,SGP,Singapore,2013,0,8,-8
MEX,Mexico,SGP,Singapore,2014,0,1,-1
MEX,Mexico,SGP,Singapore,2015,0,2,-2
MEX,Mexico,SGP,Singapore,2016,0,2,-2
MEX,Mexico,SGP,Singapore,2017,0,1,-1
NLD,Netherlands,SGP,Singapore,2008,104,153,-49
NLD,Netherlands,SGP,Singapore,2009,125,151,-26
NLD,Netherlands,SGP,Singapore,2010,151,197,-46
NLD,Netherlands,SGP,Singapore,2011,177,221,-44
NLD,Netherlands,SGP,Singapore,2012,187,290,-103
NLD,Netherlands,SGP,Singapore,2013,231,264,-33
NLD,Netherlands,SGP,Singapore,2014,265,335,-70
NLD,Netherlands,SGP,Singapore,2015,274,351,-77
NLD,Netherlands,SGP,Singapore,2016,329,428,-99
NLD,Netherlands,SGP,Singapore,2017,354,444,-90
NZL,New Zealand,SGP,Singapore,2008,97,218,-121
NZL,New Zealand,SGP,Singapore,2009,112,186,-74
NZL,New Zealand,SGP,Singapore,2010,123,232,-109
NZL,New Zealand,SGP,Singapore,2011,106,234,-128
NZL,New Zealand,SGP,Singapore,2012,96,288,-192
NZL,New Zealand,SGP,Singapore,2013,96,272,-176
NZL,New Zealand,SGP,Singapore,2014,81,263,-182
NZL,New Zealand,SGP,Singapore,2015,101,355,-254
NZL,New Zealand,SGP,Singapore,2016,89,376,-287
NZL,New Zealand,SGP,Singapore,2017,127,363,-236
NOR,Norway,SGP,Singapore,2008,22,59,-37
NOR,Norway,SGP,Singapore,2009,36,58,-22
NOR,Norway,SGP,Singapore,2010,271,58,213
NOR,Norway,SGP,Singapore,2011,49,69,-20
NOR,Norway,SGP,Singapore,2012,35,51,-16
NOR,Norway,SGP,Singapore,2013,28,60,-32
NOR,Norway,SGP,Singapore,2014,39,27,12
NOR,Norway,SGP,Singapore,2015,28,29,-1
NOR,Norway,SGP,Singapore,2016,30,24,6
NOR,Norway,SGP,Singapore,2017,24,31,-7
POL,Poland,SGP,Singapore,2009,0,8,-8
POL,Poland,SGP,Singapore,2010,0,9,-9
POL,Poland,SGP,Singapore,2011,0,8,-8
POL,Poland,SGP,Singapore,2012,0,24,-24
POL,Poland,SGP,Singapore,2013,0,25,-25
POL,Poland,SGP,Singapore,2014,0,13,-13
POL,Poland,SGP,Singapore,2015,0,19,-19
POL,Poland,SGP,Singapore,2016,0,6,-6
POL,Poland,SGP,Singapore,2017,0,26,-26
SVK,Slovak Republic,SGP,Singapore,2008,0,1,-1
SVK,Slovak Republic,SGP,Singapore,2010,0,1,-1
SVK,Slovak Republic,SGP,Singapore,2011,0,1,-1
ESP,Spain,SGP,Singapore,2008,17,26,-9
ESP,Spain,SGP,Singapore,2009,16,25,-9
ESP,Spain,SGP,Singapore,2010,24,28,-4
ESP,Spain,SGP,Singapore,2011,11,32,-21
ESP,Spain,SGP,Singapore,2012,8,47,-39
ESP,Spain,SGP,Singapore,2013,26,38,-12
ESP,Spain,SGP,Singapore,2014,22,36,-14
ESP,Spain,SGP,Singapore,2015,10,40,-30
ESP,Spain,SGP,Singapore,2016,7,35,-28
ESP,Spain,SGP,Singapore,2017,21,60,-39
SWE,Sweden,SGP,Singapore,2008,23,107,-84
SWE,Sweden,SGP,Singapore,2009,22,66,-44
SWE,Sweden,SGP,Singapore,2010,40,59,-19
SWE,Sweden,SGP,Singapore,2011,70,21,49
SWE,Sweden,SGP,Singapore,2012,122,29,93
SWE,Sweden,SGP,Singapore,2013,11,44,-33
SWE,Sweden,SGP,Singapore,2014,43,29,14
SWE,Sweden,SGP,Singapore,2015,47,23,24
SWE,Sweden,SGP,Singapore,2016,19,36,-17
SWE,Sweden,SGP,Singapore,2017,18,70,-52
CHE,Switzerland,SGP,Singapore,2010,148,219,-71
CHE,Switzerland,SGP,Singapore,2011,175,204,-29
CHE,Switzerland,SGP,Singapore,2012,160,193,-33
CHE,Switzerland,SGP,Singapore,2013,166,168,-2
CHE,Switzerland,SGP,Singapore,2014,154,155,-1
CHE,Switzerland,SGP,Singapore,2015,141,162,-21
CHE,Switzerland,SGP,Singapore,2016,107,139,-32
CHE,Switzerland,SGP,Singapore,2017,110,159,-49
TUR,Turkey,SGP,Singapore,2010,0,9,-9
GBR,United Kingdom,SGP,Singapore,2011,1000,4000,-3000
GBR,United Kingdom,SGP,Singapore,2012,1000,4000,-3000
GBR,United Kingdom,SGP,Singapore,2013,1000,2000,-1000
GBR,United Kingdom,SGP,Singapore,2014,1000,3000,-2000
GBR,United Kingdom,SGP,Singapore,2015,0,1000,-1000
GBR,United Kingdom,SGP,Singapore,2016,0,1000,-1000
GBR,United Kingdom,SGP,Singapore,2017,0,6000,-6000
USA,United States,SGP,Singapore,2008,0,922,-922
USA,United States,SGP,Singapore,2009,0,832,-832
USA,United States,SGP,Singapore,2010,0,774,-774
USA,United States,SGP,Singapore,2011,0,690,-690
USA,United States,SGP,Singapore,2012,0,712,-712
USA,United States,SGP,Singapore,2013,0,835,-835
USA,United States,SGP,Singapore,2014,0,779,-779
USA,United States,SGP,Singapore,2015,0,781,-781
USA,United States,SGP,Singapore,2016,0,812,-812
USA,United States,SGP,Singapore,2017,0,818,-818
CHL,Chile,SGP,Singapore,2008,0,1,-1
CHL,Chile,SGP,Singapore,2009,0,5,-5
CHL,Chile,SGP,Singapore,2010,0,6,-6
CHL,Chile,SGP,Singapore,2011,0,4,-4
CHL,Chile,SGP,Singapore,2012,0,4,-4
CHL,Chile,SGP,Singapore,2013,0,4,-4
CHL,Chile,SGP,Singapore,2014,0,1,-1
CHL,Chile,SGP,Singapore,2015,0,3,-3
CHL,Chile,SGP,Singapore,2016,0,4,-4
EST,Estonia,SGP,Singapore,2008,0,0,0
EST,Estonia,SGP,Singapore,2009,0,0,0
EST,Estonia,SGP,Singapore,2010,0,0,0
EST,Estonia,SGP,Singapore,2011,0,1,-1
EST,Estonia,SGP,Singapore,2012,0,1,-1
EST,Estonia,SGP,Singapore,2013,0,1,-1
EST,Estonia,SGP,Singapore,2014,0,0,0
EST,Estonia,SGP,Singapore,2015,0,4,-4
EST,Estonia,SGP,Singapore,2016,0,1,-1
EST,Estonia,SGP,Singapore,2017,0,1,-1
SVN,Slovenia,SGP,Singapore,2013,0,5,-5
SVN,Slovenia,SGP,Singapore,2014,0,1,-1
SVN,Slovenia,SGP,Singapore,2017,0,1,-1
LUX,Luxembourg,SVK,Slovak Republic,2012,0,75,-75
LUX,Luxembourg,SVK,Slovak Republic,2013,0,62,-62
LUX,Luxembourg,SVK,Slovak Republic,2014,0,81,-81
LUX,Luxembourg,SVK,Slovak Republic,2015,0,86,-86
LUX,Luxembourg,SVK,Slovak Republic,2016,0,84,-84
NZL,New Zealand,SVK,Slovak Republic,2012,0,56,-56
NZL,New Zealand,SVK,Slovak Republic,2014,0,85,-85
CHL,Chile,SVK,Slovak Republic,2011,0,20,-20
CHL,Chile,SVK,Slovak Republic,2014,0,32,-32
AUS,Australia,SVN,Slovenia,2008,0,81,-81
FIN,Finland,SVN,Slovenia,2010,0,7,-7
ISL,Iceland,SVN,Slovenia,2009,0,7,-7
ISL,Iceland,SVN,Slovenia,2010,0,6,-6
ISL,Iceland,SVN,Slovenia,2015,0,8,-8
KOR,Korea,SVN,Slovenia,2010,0,8,-8
LUX,Luxembourg,SVN,Slovenia,2010,0,46,-46
LUX,Luxembourg,SVN,Slovenia,2011,0,61,-61
LUX,Luxembourg,SVN,Slovenia,2012,0,41,-41
LUX,Luxembourg,SVN,Slovenia,2013,0,66,-66
LUX,Luxembourg,SVN,Slovenia,2016,0,62,-62
NOR,Norway,SVN,Slovenia,2010,0,46,-46
CHL,Chile,SVN,Slovenia,2014,0,10,-10
CHL,Chile,SVN,Slovenia,2016,0,4,-4
EST,Estonia,SVN,Slovenia,2010,0,2,-2
AUS,Australia,SLB,Solomon Islands,2008,22,41,-19
AUS,Australia,SLB,Solomon Islands,2009,10,59,-49
AUS,Australia,SLB,Solomon Islands,2010,18,50,-32
AUS,Australia,SLB,Solomon Islands,2011,6,47,-41
AUS,Australia,SLB,Solomon Islands,2012,14,46,-32
AUS,Australia,SLB,Solomon Islands,2013,16,68,-52
AUS,Australia,SLB,Solomon Islands,2014,11,37,-26
AUS,Australia,SLB,Solomon Islands,2015,0,28,-28
AUS,Australia,SLB,Solomon Islands,2016,0,51,-51
AUS,Australia,SLB,Solomon Islands,2017,0,47,-47
AUT,Austria,SLB,Solomon Islands,2008,0,1,-1
AUT,Austria,SLB,Solomon Islands,2009,0,0,0
AUT,Austria,SLB,Solomon Islands,2010,0,3,-3
AUT,Austria,SLB,Solomon Islands,2011,0,1,-1
AUT,Austria,SLB,Solomon Islands,2012,1,1,0
AUT,Austria,SLB,Solomon Islands,2013,0,1,-1
AUT,Austria,SLB,Solomon Islands,2014,0,0,0
AUT,Austria,SLB,Solomon Islands,2015,0,1,-1
AUT,Austria,SLB,Solomon Islands,2016,0,0,0
AUT,Austria,SLB,Solomon Islands,2017,0,2,-2
BEL,Belgium,SLB,Solomon Islands,2008,0,5,-5
BEL,Belgium,SLB,Solomon Islands,2009,0,0,0
BEL,Belgium,SLB,Solomon Islands,2010,1,1,0
BEL,Belgium,SLB,Solomon Islands,2012,0,1,-1
CAN,Canada,SLB,Solomon Islands,2008,0,12,-12
CAN,Canada,SLB,Solomon Islands,2009,0,14,-14
CAN,Canada,SLB,Solomon Islands,2010,0,5,-5
CAN,Canada,SLB,Solomon Islands,2011,0,10,-10
CAN,Canada,SLB,Solomon Islands,2012,0,0,0
CAN,Canada,SLB,Solomon Islands,2013,0,3,-3
CAN,Canada,SLB,Solomon Islands,2014,0,1,-1
CAN,Canada,SLB,Solomon Islands,2015,0,0,0
CAN,Canada,SLB,Solomon Islands,2016,0,0,0
CAN,Canada,SLB,Solomon Islands,2017,0,0,0
DNK,Denmark,SLB,Solomon Islands,2013,0,0,0
DNK,Denmark,SLB,Solomon Islands,2014,0,0,0
DNK,Denmark,SLB,Solomon Islands,2015,0,2,-2
DNK,Denmark,SLB,Solomon Islands,2016,0,0,0
DNK,Denmark,SLB,Solomon Islands,2017,0,0,0
FIN,Finland,SLB,Solomon Islands,2008,0,0,0
FIN,Finland,SLB,Solomon Islands,2009,0,0,0
FIN,Finland,SLB,Solomon Islands,2010,0,0,0
FIN,Finland,SLB,Solomon Islands,2011,0,0,0
FIN,Finland,SLB,Solomon Islands,2012,0,1,-1
FIN,Finland,SLB,Solomon Islands,2013,0,0,0
FIN,Finland,SLB,Solomon Islands,2014,0,0,0
FIN,Finland,SLB,Solomon Islands,2015,0,0,0
FIN,Finland,SLB,Solomon Islands,2016,1,0,1
FIN,Finland,SLB,Solomon Islands,2017,1,1,0
FRA,France,SLB,Solomon Islands,2008,0,0,0
FRA,France,SLB,Solomon Islands,2009,0,0,0
FRA,France,SLB,Solomon Islands,2010,0,0,0
FRA,France,SLB,Solomon Islands,2011,0,0,0
FRA,France,SLB,Solomon Islands,2012,0,0,0
FRA,France,SLB,Solomon Islands,2013,0,0,0
FRA,France,SLB,Solomon Islands,2014,0,0,0
FRA,France,SLB,Solomon Islands,2015,0,0,0
FRA,France,SLB,Solomon Islands,2016,0,0,0
FRA,France,SLB,Solomon Islands,2017,0,0,0
DEU,Germany,SLB,Solomon Islands,2008,2,0,2
DEU,Germany,SLB,Solomon Islands,2009,0,2,-2
DEU,Germany,SLB,Solomon Islands,2010,0,7,-7
DEU,Germany,SLB,Solomon Islands,2011,2,3,-1
DEU,Germany,SLB,Solomon Islands,2012,1,2,-1
DEU,Germany,SLB,Solomon Islands,2013,0,8,-8
DEU,Germany,SLB,Solomon Islands,2014,1,7,-6
DEU,Germany,SLB,Solomon Islands,2015,3,16,-13
DEU,Germany,SLB,Solomon Islands,2016,3,4,-1
DEU,Germany,SLB,Solomon Islands,2017,1,3,-2
HUN,Hungary,SLB,Solomon Islands,2008,0,0,0
HUN,Hungary,SLB,Solomon Islands,2009,0,0,0
HUN,Hungary,SLB,Solomon Islands,2010,0,0,0
HUN,Hungary,SLB,Solomon Islands,2011,0,0,0
HUN,Hungary,SLB,Solomon Islands,2012,0,0,0
HUN,Hungary,SLB,Solomon Islands,2013,0,0,0
HUN,Hungary,SLB,Solomon Islands,2014,0,0,0
HUN,Hungary,SLB,Solomon Islands,2015,0,0,0
HUN,Hungary,SLB,Solomon Islands,2016,0,0,0
HUN,Hungary,SLB,Solomon Islands,2017,0,0,0
ISL,Iceland,SLB,Solomon Islands,2016,0,0,0
ISL,Iceland,SLB,Solomon Islands,2017,0,0,0
ITA,Italy,SLB,Solomon Islands,2008,0,2,-2
ITA,Italy,SLB,Solomon Islands,2009,0,1,-1
ITA,Italy,SLB,Solomon Islands,2010,0,0,0
ITA,Italy,SLB,Solomon Islands,2011,0,0,0
ITA,Italy,SLB,Solomon Islands,2012,0,1,-1
ITA,Italy,SLB,Solomon Islands,2013,0,0,0
ITA,Italy,SLB,Solomon Islands,2015,0,0,0
ITA,Italy,SLB,Solomon Islands,2016,0,0,0
ITA,Italy,SLB,Solomon Islands,2017,0,1,-1
JPN,Japan,SLB,Solomon Islands,2008,69,66,3
JPN,Japan,SLB,Solomon Islands,2009,80,88,-8
JPN,Japan,SLB,Solomon Islands,2010,77,79,-2
JPN,Japan,SLB,Solomon Islands,2011,60,60,0
JPN,Japan,SLB,Solomon Islands,2012,79,79,0
JPN,Japan,SLB,Solomon Islands,2013,62,67,-5
JPN,Japan,SLB,Solomon Islands,2014,54,55,-1
JPN,Japan,SLB,Solomon Islands,2015,74,80,-6
JPN,Japan,SLB,Solomon Islands,2016,75,76,-1
JPN,Japan,SLB,Solomon Islands,2017,78,79,-1
KOR,Korea,SLB,Solomon Islands,2008,2,0,2
KOR,Korea,SLB,Solomon Islands,2009,2,2,0
KOR,Korea,SLB,Solomon Islands,2010,1,1,0
KOR,Korea,SLB,Solomon Islands,2011,0,1,-1
KOR,Korea,SLB,Solomon Islands,2012,5,8,-3
KOR,Korea,SLB,Solomon Islands,2013,3,5,-2
KOR,Korea,SLB,Solomon Islands,2014,5,5,0
KOR,Korea,SLB,Solomon Islands,2015,5,6,-1
KOR,Korea,SLB,Solomon Islands,2016,8,9,-1
KOR,Korea,SLB,Solomon Islands,2017,6,5,1
LUX,Luxembourg,SLB,Solomon Islands,2008,0,0,0
LUX,Luxembourg,SLB,Solomon Islands,2009,0,0,0
LUX,Luxembourg,SLB,Solomon Islands,2010,0,0,0
LUX,Luxembourg,SLB,Solomon Islands,2011,0,0,0
LUX,Luxembourg,SLB,Solomon Islands,2012,0,0,0
LUX,Luxembourg,SLB,Solomon Islands,2013,0,0,0
LUX,Luxembourg,SLB,Solomon Islands,2014,0,0,0
LUX,Luxembourg,SLB,Solomon Islands,2015,0,0,0
LUX,Luxembourg,SLB,Solomon Islands,2016,0,0,0
LUX,Luxembourg,SLB,Solomon Islands,2017,0,0,0
MEX,Mexico,SLB,Solomon Islands,2012,0,0,0
MEX,Mexico,SLB,Solomon Islands,2013,0,0,0
MEX,Mexico,SLB,Solomon Islands,2014,0,0,0
NLD,Netherlands,SLB,Solomon Islands,2009,0,1,-1
NLD,Netherlands,SLB,Solomon Islands,2015,1,0,1
NZL,New Zealand,SLB,Solomon Islands,2008,57,83,-26
NZL,New Zealand,SLB,Solomon Islands,2009,25,65,-40
NZL,New Zealand,SLB,Solomon Islands,2010,72,66,6
NZL,New Zealand,SLB,Solomon Islands,2011,64,71,-7
NZL,New Zealand,SLB,Solomon Islands,2012,44,61,-17
NZL,New Zealand,SLB,Solomon Islands,2013,42,43,-1
NZL,New Zealand,SLB,Solomon Islands,2014,29,51,-22
NZL,New Zealand,SLB,Solomon Islands,2015,13,40,-27
NZL,New Zealand,SLB,Solomon Islands,2016,16,51,-35
NZL,New Zealand,SLB,Solomon Islands,2017,21,43,-22
NOR,Norway,SLB,Solomon Islands,2008,0,0,0
NOR,Norway,SLB,Solomon Islands,2009,0,0,0
NOR,Norway,SLB,Solomon Islands,2010,0,0,0
NOR,Norway,SLB,Solomon Islands,2011,0,0,0
NOR,Norway,SLB,Solomon Islands,2012,0,1,-1
NOR,Norway,SLB,Solomon Islands,2013,0,0,0
NOR,Norway,SLB,Solomon Islands,2014,0,0,0
NOR,Norway,SLB,Solomon Islands,2015,0,0,0
NOR,Norway,SLB,Solomon Islands,2016,1,0,1
NOR,Norway,SLB,Solomon Islands,2017,0,0,0
POL,Poland,SLB,Solomon Islands,2009,0,0,0
POL,Poland,SLB,Solomon Islands,2010,0,0,0
POL,Poland,SLB,Solomon Islands,2011,0,0,0
POL,Poland,SLB,Solomon Islands,2012,0,0,0
POL,Poland,SLB,Solomon Islands,2013,0,0,0
POL,Poland,SLB,Solomon Islands,2014,0,0,0
POL,Poland,SLB,Solomon Islands,2015,0,0,0
POL,Poland,SLB,Solomon Islands,2016,0,0,0
POL,Poland,SLB,Solomon Islands,2017,0,0,0
SVK,Slovak Republic,SLB,Solomon Islands,2008,0,0,0
ESP,Spain,SLB,Solomon Islands,2008,0,0,0
ESP,Spain,SLB,Solomon Islands,2009,0,0,0
ESP,Spain,SLB,Solomon Islands,2010,0,0,0
ESP,Spain,SLB,Solomon Islands,2011,0,0,0
ESP,Spain,SLB,Solomon Islands,2012,0,0,0
ESP,Spain,SLB,Solomon Islands,2013,0,2,-2
ESP,Spain,SLB,Solomon Islands,2014,0,0,0
ESP,Spain,SLB,Solomon Islands,2015,0,0,0
ESP,Spain,SLB,Solomon Islands,2016,0,1,-1
ESP,Spain,SLB,Solomon Islands,2017,0,2,-2
SWE,Sweden,SLB,Solomon Islands,2008,0,0,0
SWE,Sweden,SLB,Solomon Islands,2009,0,0,0
SWE,Sweden,SLB,Solomon Islands,2010,0,0,0
SWE,Sweden,SLB,Solomon Islands,2011,0,0,0
SWE,Sweden,SLB,Solomon Islands,2012,0,0,0
SWE,Sweden,SLB,Solomon Islands,2013,0,0,0
SWE,Sweden,SLB,Solomon Islands,2014,0,0,0
SWE,Sweden,SLB,Solomon Islands,2015,0,0,0
SWE,Sweden,SLB,Solomon Islands,2016,0,1,-1
SWE,Sweden,SLB,Solomon Islands,2017,1,1,0
CHE,Switzerland,SLB,Solomon Islands,2010,0,0,0
CHE,Switzerland,SLB,Solomon Islands,2011,0,0,0
CHE,Switzerland,SLB,Solomon Islands,2012,0,1,-1
CHE,Switzerland,SLB,Solomon Islands,2013,0,0,0
CHE,Switzerland,SLB,Solomon Islands,2015,0,556,-556
CHE,Switzerland,SLB,Solomon Islands,2016,0,0,0
CHE,Switzerland,SLB,Solomon Islands,2017,0,0,0
USA,United States,SLB,Solomon Islands,2008,0,7,-7
USA,United States,SLB,Solomon Islands,2010,0,6,-6
USA,United States,SLB,Solomon Islands,2013,0,3,-3
USA,United States,SLB,Solomon Islands,2014,0,5,-5
USA,United States,SLB,Solomon Islands,2016,0,3,-3
USA,United States,SLB,Solomon Islands,2017,0,6,-6
CHL,Chile,SLB,Solomon Islands,2008,0,0,0
CHL,Chile,SLB,Solomon Islands,2009,0,0,0
CHL,Chile,SLB,Solomon Islands,2010,0,0,0
CHL,Chile,SLB,Solomon Islands,2011,0,0,0
CHL,Chile,SLB,Solomon Islands,2012,0,0,0
CHL,Chile,SLB,Solomon Islands,2013,0,0,0
CHL,Chile,SLB,Solomon Islands,2014,0,0,0
CHL,Chile,SLB,Solomon Islands,2015,0,0,0
CHL,Chile,SLB,Solomon Islands,2016,0,0,0
EST,Estonia,SLB,Solomon Islands,2008,0,0,0
EST,Estonia,SLB,Solomon Islands,2009,0,0,0
EST,Estonia,SLB,Solomon Islands,2010,0,0,0
EST,Estonia,SLB,Solomon Islands,2011,0,0,0
EST,Estonia,SLB,Solomon Islands,2012,0,0,0
EST,Estonia,SLB,Solomon Islands,2013,0,0,0
EST,Estonia,SLB,Solomon Islands,2014,0,0,0
EST,Estonia,SLB,Solomon Islands,2015,0,0,0
EST,Estonia,SLB,Solomon Islands,2016,0,0,0
EST,Estonia,SLB,Solomon Islands,2017,0,0,0
SVN,Slovenia,SLB,Solomon Islands,2008,0,1,-1
AUS,Australia,SOM,Somalia,2008,92,155,-63
AUS,Australia,SOM,Somalia,2009,85,419,-334
AUS,Australia,SOM,Somalia,2010,82,657,-575
AUS,Australia,SOM,Somalia,2011,127,370,-243
AUS,Australia,SOM,Somalia,2012,138,346,-208
AUS,Australia,SOM,Somalia,2013,86,293,-207
AUS,Australia,SOM,Somalia,2014,97,523,-426
AUS,Australia,SOM,Somalia,2015,100,501,-401
AUS,Australia,SOM,Somalia,2016,100,676,-576
AUS,Australia,SOM,Somalia,2017,0,238,-238
AUT,Austria,SOM,Somalia,2008,46,258,-212
AUT,Austria,SOM,Somalia,2009,35,250,-215
AUT,Austria,SOM,Somalia,2010,59,180,-121
AUT,Austria,SOM,Somalia,2011,44,485,-441
AUT,Austria,SOM,Somalia,2012,118,486,-368
AUT,Austria,SOM,Somalia,2013,79,336,-257
AUT,Austria,SOM,Somalia,2014,118,978,-860
AUT,Austria,SOM,Somalia,2015,239,1902,-1663
AUT,Austria,SOM,Somalia,2016,368,1470,-1102
AUT,Austria,SOM,Somalia,2017,383,498,-115
BEL,Belgium,SOM,Somalia,2008,0,53,-53
BEL,Belgium,SOM,Somalia,2009,0,48,-48
BEL,Belgium,SOM,Somalia,2010,19,89,-70
BEL,Belgium,SOM,Somalia,2012,103,409,-306
BEL,Belgium,SOM,Somalia,2013,121,300,-179
BEL,Belgium,SOM,Somalia,2014,102,364,-262
BEL,Belgium,SOM,Somalia,2015,101,1985,-1884
BEL,Belgium,SOM,Somalia,2016,63,843,-780
BEL,Belgium,SOM,Somalia,2017,170,636,-466
CAN,Canada,SOM,Somalia,2008,0,1014,-1014
CAN,Canada,SOM,Somalia,2009,0,1214,-1214
CAN,Canada,SOM,Somalia,2010,0,1526,-1526
CAN,Canada,SOM,Somalia,2011,0,1532,-1532
CAN,Canada,SOM,Somalia,2012,0,1574,-1574
CAN,Canada,SOM,Somalia,2013,0,2029,-2029
CAN,Canada,SOM,Somalia,2014,0,1491,-1491
CAN,Canada,SOM,Somalia,2015,0,1157,-1157
CAN,Canada,SOM,Somalia,2016,0,1310,-1310
CAN,Canada,SOM,Somalia,2017,0,1390,-1390
CZE,Czech Republic,SOM,Somalia,2008,0,12,-12
CZE,Czech Republic,SOM,Somalia,2010,1,1,0
CZE,Czech Republic,SOM,Somalia,2011,1,1,0
CZE,Czech Republic,SOM,Somalia,2012,0,2,-2
CZE,Czech Republic,SOM,Somalia,2014,6,1,5
CZE,Czech Republic,SOM,Somalia,2015,0,1,-1
CZE,Czech Republic,SOM,Somalia,2016,0,1,-1
DNK,Denmark,SOM,Somalia,2008,46,82,-36
DNK,Denmark,SOM,Somalia,2009,88,80,8
DNK,Denmark,SOM,Somalia,2010,60,79,-19
DNK,Denmark,SOM,Somalia,2011,62,135,-73
DNK,Denmark,SOM,Somalia,2012,53,332,-279
DNK,Denmark,SOM,Somalia,2013,65,585,-520
DNK,Denmark,SOM,Somalia,2014,61,789,-728
DNK,Denmark,SOM,Somalia,2015,58,482,-424
DNK,Denmark,SOM,Somalia,2016,63,242,-179
DNK,Denmark,SOM,Somalia,2017,199,157,42
FIN,Finland,SOM,Somalia,2008,48,601,-553
FIN,Finland,SOM,Somalia,2009,20,840,-820
FIN,Finland,SOM,Somalia,2010,9,1041,-1032
FIN,Finland,SOM,Somalia,2011,6,745,-739
FIN,Finland,SOM,Somalia,2012,22,445,-423
FIN,Finland,SOM,Somalia,2013,55,724,-669
FIN,Finland,SOM,Somalia,2014,161,633,-472
FIN,Finland,SOM,Somalia,2015,88,654,-566
FIN,Finland,SOM,Somalia,2016,88,693,-605
FIN,Finland,SOM,Somalia,2017,38,517,-479
FRA,France,SOM,Somalia,2008,0,81,-81
FRA,France,SOM,Somalia,2009,0,133,-133
FRA,France,SOM,Somalia,2010,0,215,-215
FRA,France,SOM,Somalia,2011,0,223,-223
FRA,France,SOM,Somalia,2012,0,251,-251
FRA,France,SOM,Somalia,2013,0,208,-208
FRA,France,SOM,Somalia,2014,0,284,-284
FRA,France,SOM,Somalia,2015,0,197,-197
FRA,France,SOM,Somalia,2016,0,297,-297
FRA,France,SOM,Somalia,2017,0,510,-510
DEU,Germany,SOM,Somalia,2008,263,255,8
DEU,Germany,SOM,Somalia,2009,289,441,-152
DEU,Germany,SOM,Somalia,2010,439,2486,-2047
DEU,Germany,SOM,Somalia,2011,893,1266,-373
DEU,Germany,SOM,Somalia,2012,631,1519,-888
DEU,Germany,SOM,Somalia,2013,455,4174,-3719
DEU,Germany,SOM,Somalia,2014,1304,6464,-5160
DEU,Germany,SOM,Somalia,2015,2362,9653,-7291
DEU,Germany,SOM,Somalia,2016,4058,8537,-4479
DEU,Germany,SOM,Somalia,2017,2780,6383,-3603
HUN,Hungary,SOM,Somalia,2008,1,0,1
HUN,Hungary,SOM,Somalia,2009,0,0,0
HUN,Hungary,SOM,Somalia,2010,0,1,-1
HUN,Hungary,SOM,Somalia,2011,0,0,0
HUN,Hungary,SOM,Somalia,2012,0,0,0
HUN,Hungary,SOM,Somalia,2013,0,0,0
HUN,Hungary,SOM,Somalia,2014,0,69,-69
HUN,Hungary,SOM,Somalia,2015,0,60,-60
HUN,Hungary,SOM,Somalia,2016,0,31,-31
HUN,Hungary,SOM,Somalia,2017,0,11,-11
ISL,Iceland,SOM,Somalia,2008,0,0,0
ISL,Iceland,SOM,Somalia,2009,0,0,0
ISL,Iceland,SOM,Somalia,2010,0,0,0
ISL,Iceland,SOM,Somalia,2011,0,0,0
ISL,Iceland,SOM,Somalia,2012,0,1,-1
ISL,Iceland,SOM,Somalia,2013,0,0,0
ISL,Iceland,SOM,Somalia,2014,0,0,0
ISL,Iceland,SOM,Somalia,2015,0,3,-3
ISL,Iceland,SOM,Somalia,2016,0,3,-3
ISL,Iceland,SOM,Somalia,2017,0,5,-5
ITA,Italy,SOM,Somalia,2008,20,1070,-1050
ITA,Italy,SOM,Somalia,2009,20,1545,-1525
ITA,Italy,SOM,Somalia,2010,26,1185,-1159
ITA,Italy,SOM,Somalia,2011,34,711,-677
ITA,Italy,SOM,Somalia,2012,34,868,-834
ITA,Italy,SOM,Somalia,2013,33,982,-949
ITA,Italy,SOM,Somalia,2014,77,1664,-1587
ITA,Italy,SOM,Somalia,2015,98,1395,-1297
ITA,Italy,SOM,Somalia,2016,0,1230,-1230
ITA,Italy,SOM,Somalia,2017,72,2119,-2047
JPN,Japan,SOM,Somalia,2008,0,1,-1
JPN,Japan,SOM,Somalia,2009,1,1,0
JPN,Japan,SOM,Somalia,2010,0,0,0
JPN,Japan,SOM,Somalia,2011,0,2,-2
JPN,Japan,SOM,Somalia,2012,0,0,0
JPN,Japan,SOM,Somalia,2013,12,13,-1
JPN,Japan,SOM,Somalia,2014,19,21,-2
JPN,Japan,SOM,Somalia,2015,15,16,-1
JPN,Japan,SOM,Somalia,2016,15,20,-5
JPN,Japan,SOM,Somalia,2017,11,13,-2
KOR,Korea,SOM,Somalia,2008,2,0,2
KOR,Korea,SOM,Somalia,2009,0,0,0
KOR,Korea,SOM,Somalia,2010,1,2,-1
KOR,Korea,SOM,Somalia,2011,1,5,-4
KOR,Korea,SOM,Somalia,2012,1,4,-3
KOR,Korea,SOM,Somalia,2013,1,2,-1
KOR,Korea,SOM,Somalia,2014,4,2,2
KOR,Korea,SOM,Somalia,2015,2,5,-3
KOR,Korea,SOM,Somalia,2016,4,5,-1
KOR,Korea,SOM,Somalia,2017,3,4,-1
LUX,Luxembourg,SOM,Somalia,2008,5,8,-3
LUX,Luxembourg,SOM,Somalia,2009,1,4,-3
LUX,Luxembourg,SOM,Somalia,2010,1,26,-25
LUX,Luxembourg,SOM,Somalia,2011,11,6,5
LUX,Luxembourg,SOM,Somalia,2012,0,8,-8
LUX,Luxembourg,SOM,Somalia,2013,2,6,-4
LUX,Luxembourg,SOM,Somalia,2014,3,4,-1
LUX,Luxembourg,SOM,Somalia,2015,4,8,-4
LUX,Luxembourg,SOM,Somalia,2016,6,5,1
LUX,Luxembourg,SOM,Somalia,2017,7,11,-4
MEX,Mexico,SOM,Somalia,2008,0,1,-1
MEX,Mexico,SOM,Somalia,2009,0,1,-1
MEX,Mexico,SOM,Somalia,2012,0,0,0
MEX,Mexico,SOM,Somalia,2013,0,0,0
MEX,Mexico,SOM,Somalia,2014,0,0,0
NLD,Netherlands,SOM,Somalia,2008,38,19,19
NLD,Netherlands,SOM,Somalia,2009,-6,36,-42
NLD,Netherlands,SOM,Somalia,2010,9,25,-16
NLD,Netherlands,SOM,Somalia,2011,14,25,-11
NLD,Netherlands,SOM,Somalia,2012,7,133,-126
NLD,Netherlands,SOM,Somalia,2013,9,988,-979
NLD,Netherlands,SOM,Somalia,2014,17,1216,-1199
NLD,Netherlands,SOM,Somalia,2015,22,628,-606
NLD,Netherlands,SOM,Somalia,2016,17,433,-416
NLD,Netherlands,SOM,Somalia,2017,25,222,-197
NZL,New Zealand,SOM,Somalia,2008,0,22,-22
NZL,New Zealand,SOM,Somalia,2009,0,23,-23
NZL,New Zealand,SOM,Somalia,2010,0,29,-29
NZL,New Zealand,SOM,Somalia,2011,0,22,-22
NZL,New Zealand,SOM,Somalia,2012,0,34,-34
NZL,New Zealand,SOM,Somalia,2013,0,19,-19
NZL,New Zealand,SOM,Somalia,2014,0,57,-57
NZL,New Zealand,SOM,Somalia,2015,0,64,-64
NZL,New Zealand,SOM,Somalia,2016,1,26,-25
NZL,New Zealand,SOM,Somalia,2017,1,32,-31
NOR,Norway,SOM,Somalia,2008,113,1231,-1118
NOR,Norway,SOM,Somalia,2009,106,1270,-1164
NOR,Norway,SOM,Somalia,2010,207,1641,-1434
NOR,Norway,SOM,Somalia,2011,253,1704,-1451
NOR,Norway,SOM,Somalia,2012,213,3607,-3394
NOR,Norway,SOM,Somalia,2013,190,2765,-2575
NOR,Norway,SOM,Somalia,2014,200,1653,-1453
NOR,Norway,SOM,Somalia,2015,249,1884,-1635
NOR,Norway,SOM,Somalia,2016,222,911,-689
NOR,Norway,SOM,Somalia,2017,200,57,143
POL,Poland,SOM,Somalia,2009,0,7,-7
POL,Poland,SOM,Somalia,2010,0,7,-7
POL,Poland,SOM,Somalia,2011,0,6,-6
POL,Poland,SOM,Somalia,2012,0,15,-15
POL,Poland,SOM,Somalia,2013,0,9,-9
POL,Poland,SOM,Somalia,2014,0,5,-5
POL,Poland,SOM,Somalia,2015,0,19,-19
POL,Poland,SOM,Somalia,2016,0,17,-17
POL,Poland,SOM,Somalia,2017,0,7,-7
SVK,Slovak Republic,SOM,Somalia,2008,5,2,3
SVK,Slovak Republic,SOM,Somalia,2009,1,6,-5
SVK,Slovak Republic,SOM,Somalia,2010,2,26,-24
SVK,Slovak Republic,SOM,Somalia,2011,0,18,-18
SVK,Slovak Republic,SOM,Somalia,2014,0,2,-2
SVK,Slovak Republic,SOM,Somalia,2015,0,1,-1
ESP,Spain,SOM,Somalia,2008,7,97,-90
ESP,Spain,SOM,Somalia,2009,31,53,-22
ESP,Spain,SOM,Somalia,2010,48,21,27
ESP,Spain,SOM,Somalia,2011,49,19,30
ESP,Spain,SOM,Somalia,2012,33,20,13
ESP,Spain,SOM,Somalia,2013,11,48,-37
ESP,Spain,SOM,Somalia,2014,8,47,-39
ESP,Spain,SOM,Somalia,2015,16,72,-56
ESP,Spain,SOM,Somalia,2016,12,100,-88
ESP,Spain,SOM,Somalia,2017,23,46,-23
SWE,Sweden,SOM,Somalia,2008,259,4064,-3805
SWE,Sweden,SOM,Somalia,2009,133,6902,-6769
SWE,Sweden,SOM,Somalia,2010,328,6819,-6491
SWE,Sweden,SOM,Somalia,2011,358,3082,-2724
SWE,Sweden,SOM,Somalia,2012,447,4541,-4094
SWE,Sweden,SOM,Somalia,2013,371,10966,-10595
SWE,Sweden,SOM,Somalia,2014,368,4241,-3873
SWE,Sweden,SOM,Somalia,2015,496,3500,-3004
SWE,Sweden,SOM,Somalia,2016,288,3811,-3523
SWE,Sweden,SOM,Somalia,2017,191,2837,-2646
CHE,Switzerland,SOM,Somalia,2010,7,455,-448
CHE,Switzerland,SOM,Somalia,2011,12,400,-388
CHE,Switzerland,SOM,Somalia,2012,18,306,-288
CHE,Switzerland,SOM,Somalia,2013,20,502,-482
CHE,Switzerland,SOM,Somalia,2014,25,536,-511
CHE,Switzerland,SOM,Somalia,2015,18,420,-402
CHE,Switzerland,SOM,Somalia,2016,32,443,-411
CHE,Switzerland,SOM,Somalia,2017,33,351,-318
TUR,Turkey,SOM,Somalia,2010,0,213,-213
TUR,Turkey,SOM,Somalia,2016,793,701,92
TUR,Turkey,SOM,Somalia,2017,609,1452,-843
GBR,United Kingdom,SOM,Somalia,2012,0,1000,-1000
USA,United States,SOM,Somalia,2008,0,10745,-10745
USA,United States,SOM,Somalia,2009,0,13390,-13390
USA,United States,SOM,Somalia,2010,0,4558,-4558
USA,United States,SOM,Somalia,2011,0,4451,-4451
USA,United States,SOM,Somalia,2012,0,5204,-5204
USA,United States,SOM,Somalia,2013,0,3764,-3764
USA,United States,SOM,Somalia,2014,0,5190,-5190
USA,United States,SOM,Somalia,2015,0,6796,-6796
USA,United States,SOM,Somalia,2016,0,6958,-6958
USA,United States,SOM,Somalia,2017,0,7404,-7404
CHL,Chile,SOM,Somalia,2008,0,0,0
CHL,Chile,SOM,Somalia,2009,0,0,0
CHL,Chile,SOM,Somalia,2010,0,2,-2
CHL,Chile,SOM,Somalia,2011,0,0,0
CHL,Chile,SOM,Somalia,2012,0,0,0
CHL,Chile,SOM,Somalia,2013,0,0,0
CHL,Chile,SOM,Somalia,2014,0,0,0
CHL,Chile,SOM,Somalia,2015,0,0,0
CHL,Chile,SOM,Somalia,2016,0,0,0
EST,Estonia,SOM,Somalia,2008,0,0,0
EST,Estonia,SOM,Somalia,2009,0,0,0
EST,Estonia,SOM,Somalia,2010,0,0,0
EST,Estonia,SOM,Somalia,2011,0,0,0
EST,Estonia,SOM,Somalia,2012,0,0,0
EST,Estonia,SOM,Somalia,2013,0,0,0
EST,Estonia,SOM,Somalia,2014,0,0,0
EST,Estonia,SOM,Somalia,2015,0,0,0
EST,Estonia,SOM,Somalia,2016,0,1,-1
EST,Estonia,SOM,Somalia,2017,0,1,-1
SVN,Slovenia,SOM,Somalia,2015,0,1,-1
AUS,Australia,ZAF,South Africa,2008,824,6936,-6112
AUS,Australia,ZAF,South Africa,2009,733,11264,-10531
AUS,Australia,ZAF,South Africa,2010,895,11098,-10203
AUS,Australia,ZAF,South Africa,2011,896,8089,-7193
AUS,Australia,ZAF,South Africa,2012,916,8033,-7117
AUS,Australia,ZAF,South Africa,2013,1022,5798,-4776
AUS,Australia,ZAF,South Africa,2014,1067,4883,-3816
AUS,Australia,ZAF,South Africa,2015,1200,4669,-3469
AUS,Australia,ZAF,South Africa,2016,1100,3975,-2875
AUS,Australia,ZAF,South Africa,2017,0,4783,-4783
AUT,Austria,ZAF,South Africa,2008,50,65,-15
AUT,Austria,ZAF,South Africa,2009,61,75,-14
AUT,Austria,ZAF,South Africa,2010,44,75,-31
AUT,Austria,ZAF,South Africa,2011,45,44,1
AUT,Austria,ZAF,South Africa,2012,42,61,-19
AUT,Austria,ZAF,South Africa,2013,27,70,-43
AUT,Austria,ZAF,South Africa,2014,47,65,-18
AUT,Austria,ZAF,South Africa,2015,36,99,-63
AUT,Austria,ZAF,South Africa,2016,43,95,-52
AUT,Austria,ZAF,South Africa,2017,39,112,-73
BEL,Belgium,ZAF,South Africa,2008,0,213,-213
BEL,Belgium,ZAF,South Africa,2009,0,156,-156
BEL,Belgium,ZAF,South Africa,2010,100,182,-82
BEL,Belgium,ZAF,South Africa,2011,167,207,-40
BEL,Belgium,ZAF,South Africa,2012,159,172,-13
BEL,Belgium,ZAF,South Africa,2013,141,159,-18
BEL,Belgium,ZAF,South Africa,2014,85,103,-18
BEL,Belgium,ZAF,South Africa,2015,70,117,-47
BEL,Belgium,ZAF,South Africa,2016,77,166,-89
BEL,Belgium,ZAF,South Africa,2017,63,193,-130
CAN,Canada,ZAF,South Africa,2008,0,1122,-1122
CAN,Canada,ZAF,South Africa,2009,0,1188,-1188
CAN,Canada,ZAF,South Africa,2010,0,1238,-1238
CAN,Canada,ZAF,South Africa,2011,0,959,-959
CAN,Canada,ZAF,South Africa,2012,0,1242,-1242
CAN,Canada,ZAF,South Africa,2013,0,1238,-1238
CAN,Canada,ZAF,South Africa,2014,0,1001,-1001
CAN,Canada,ZAF,South Africa,2015,0,960,-960
CAN,Canada,ZAF,South Africa,2016,0,1075,-1075
CAN,Canada,ZAF,South Africa,2017,0,1570,-1570
CZE,Czech Republic,ZAF,South Africa,2008,0,75,-75
CZE,Czech Republic,ZAF,South Africa,2009,1,42,-41
CZE,Czech Republic,ZAF,South Africa,2010,0,35,-35
CZE,Czech Republic,ZAF,South Africa,2011,0,20,-20
CZE,Czech Republic,ZAF,South Africa,2012,20,38,-18
CZE,Czech Republic,ZAF,South Africa,2013,23,18,5
CZE,Czech Republic,ZAF,South Africa,2014,32,39,-7
CZE,Czech Republic,ZAF,South Africa,2015,25,38,-13
CZE,Czech Republic,ZAF,South Africa,2016,24,47,-23
CZE,Czech Republic,ZAF,South Africa,2017,21,78,-57
DNK,Denmark,ZAF,South Africa,2008,39,47,-8
DNK,Denmark,ZAF,South Africa,2009,23,53,-30
DNK,Denmark,ZAF,South Africa,2010,31,48,-17
DNK,Denmark,ZAF,South Africa,2011,38,38,0
DNK,Denmark,ZAF,South Africa,2012,41,37,4
DNK,Denmark,ZAF,South Africa,2013,26,44,-18
DNK,Denmark,ZAF,South Africa,2014,35,48,-13
DNK,Denmark,ZAF,South Africa,2015,33,81,-48
DNK,Denmark,ZAF,South Africa,2016,36,90,-54
DNK,Denmark,ZAF,South Africa,2017,26,90,-64
FIN,Finland,ZAF,South Africa,2008,15,27,-12
FIN,Finland,ZAF,South Africa,2009,11,25,-14
FIN,Finland,ZAF,South Africa,2010,10,30,-20
FIN,Finland,ZAF,South Africa,2011,12,15,-3
FIN,Finland,ZAF,South Africa,2012,10,22,-12
FIN,Finland,ZAF,South Africa,2013,8,14,-6
FIN,Finland,ZAF,South Africa,2014,9,20,-11
FIN,Finland,ZAF,South Africa,2015,6,13,-7
FIN,Finland,ZAF,South Africa,2016,2,14,-12
FIN,Finland,ZAF,South Africa,2017,10,32,-22
FRA,France,ZAF,South Africa,2008,0,168,-168
FRA,France,ZAF,South Africa,2009,0,193,-193
FRA,France,ZAF,South Africa,2010,0,174,-174
FRA,France,ZAF,South Africa,2011,0,179,-179
FRA,France,ZAF,South Africa,2012,0,191,-191
FRA,France,ZAF,South Africa,2013,0,191,-191
FRA,France,ZAF,South Africa,2014,0,192,-192
FRA,France,ZAF,South Africa,2015,0,272,-272
FRA,France,ZAF,South Africa,2016,0,259,-259
FRA,France,ZAF,South Africa,2017,0,271,-271
DEU,Germany,ZAF,South Africa,2008,956,886,70
DEU,Germany,ZAF,South Africa,2009,800,699,101
DEU,Germany,ZAF,South Africa,2010,640,698,-58
DEU,Germany,ZAF,South Africa,2011,540,804,-264
DEU,Germany,ZAF,South Africa,2012,507,760,-253
DEU,Germany,ZAF,South Africa,2013,559,810,-251
DEU,Germany,ZAF,South Africa,2014,543,785,-242
DEU,Germany,ZAF,South Africa,2015,511,882,-371
DEU,Germany,ZAF,South Africa,2016,480,914,-434
DEU,Germany,ZAF,South Africa,2017,466,1128,-662
HUN,Hungary,ZAF,South Africa,2008,3,39,-36
HUN,Hungary,ZAF,South Africa,2009,4,10,-6
HUN,Hungary,ZAF,South Africa,2010,6,31,-25
HUN,Hungary,ZAF,South Africa,2011,1,22,-21
HUN,Hungary,ZAF,South Africa,2012,1,16,-15
HUN,Hungary,ZAF,South Africa,2013,0,11,-11
HUN,Hungary,ZAF,South Africa,2014,1,26,-25
HUN,Hungary,ZAF,South Africa,2015,3,20,-17
HUN,Hungary,ZAF,South Africa,2016,2,33,-31
HUN,Hungary,ZAF,South Africa,2017,0,88,-88
ISL,Iceland,ZAF,South Africa,2008,1,3,-2
ISL,Iceland,ZAF,South Africa,2009,2,5,-3
ISL,Iceland,ZAF,South Africa,2010,3,2,1
ISL,Iceland,ZAF,South Africa,2011,1,10,-9
ISL,Iceland,ZAF,South Africa,2012,1,10,-9
ISL,Iceland,ZAF,South Africa,2013,8,2,6
ISL,Iceland,ZAF,South Africa,2014,7,2,5
ISL,Iceland,ZAF,South Africa,2015,1,2,-1
ISL,Iceland,ZAF,South Africa,2016,3,8,-5
ISL,Iceland,ZAF,South Africa,2017,5,7,-2
ITA,Italy,ZAF,South Africa,2008,4,99,-95
ITA,Italy,ZAF,South Africa,2009,6,77,-71
ITA,Italy,ZAF,South Africa,2010,7,69,-62
ITA,Italy,ZAF,South Africa,2011,9,59,-50
ITA,Italy,ZAF,South Africa,2012,8,73,-65
ITA,Italy,ZAF,South Africa,2013,12,97,-85
ITA,Italy,ZAF,South Africa,2014,21,106,-85
ITA,Italy,ZAF,South Africa,2015,58,61,-3
ITA,Italy,ZAF,South Africa,2016,0,59,-59
ITA,Italy,ZAF,South Africa,2017,14,84,-70
JPN,Japan,ZAF,South Africa,2008,518,590,-72
JPN,Japan,ZAF,South Africa,2009,357,333,24
JPN,Japan,ZAF,South Africa,2010,349,371,-22
JPN,Japan,ZAF,South Africa,2011,340,371,-31
JPN,Japan,ZAF,South Africa,2012,357,425,-68
JPN,Japan,ZAF,South Africa,2013,473,523,-50
JPN,Japan,ZAF,South Africa,2014,335,417,-82
JPN,Japan,ZAF,South Africa,2015,419,516,-97
JPN,Japan,ZAF,South Africa,2016,529,699,-170
JPN,Japan,ZAF,South Africa,2017,602,775,-173
KOR,Korea,ZAF,South Africa,2008,436,788,-352
KOR,Korea,ZAF,South Africa,2009,584,909,-325
KOR,Korea,ZAF,South Africa,2010,728,765,-37
KOR,Korea,ZAF,South Africa,2011,736,919,-183
KOR,Korea,ZAF,South Africa,2012,792,959,-167
KOR,Korea,ZAF,South Africa,2013,869,750,119
KOR,Korea,ZAF,South Africa,2014,720,705,15
KOR,Korea,ZAF,South Africa,2015,720,618,102
KOR,Korea,ZAF,South Africa,2016,634,873,-239
KOR,Korea,ZAF,South Africa,2017,784,866,-82
LUX,Luxembourg,ZAF,South Africa,2008,6,44,-38
LUX,Luxembourg,ZAF,South Africa,2009,14,22,-8
LUX,Luxembourg,ZAF,South Africa,2010,3,26,-23
LUX,Luxembourg,ZAF,South Africa,2011,9,23,-14
LUX,Luxembourg,ZAF,South Africa,2012,14,26,-12
LUX,Luxembourg,ZAF,South Africa,2013,21,28,-7
LUX,Luxembourg,ZAF,South Africa,2014,11,10,1
LUX,Luxembourg,ZAF,South Africa,2015,8,23,-15
LUX,Luxembourg,ZAF,South Africa,2016,7,20,-13
LUX,Luxembourg,ZAF,South Africa,2017,15,59,-44
MEX,Mexico,ZAF,South Africa,2008,0,14,-14
MEX,Mexico,ZAF,South Africa,2009,0,15,-15
MEX,Mexico,ZAF,South Africa,2010,0,14,-14
MEX,Mexico,ZAF,South Africa,2011,0,15,-15
MEX,Mexico,ZAF,South Africa,2012,0,19,-19
MEX,Mexico,ZAF,South Africa,2013,0,33,-33
MEX,Mexico,ZAF,South Africa,2014,0,28,-28
MEX,Mexico,ZAF,South Africa,2015,0,20,-20
MEX,Mexico,ZAF,South Africa,2016,0,27,-27
MEX,Mexico,ZAF,South Africa,2017,0,14,-14
NLD,Netherlands,ZAF,South Africa,2008,561,873,-312
NLD,Netherlands,ZAF,South Africa,2009,576,670,-94
NLD,Netherlands,ZAF,South Africa,2010,615,586,29
NLD,Netherlands,ZAF,South Africa,2011,482,658,-176
NLD,Netherlands,ZAF,South Africa,2012,564,614,-50
NLD,Netherlands,ZAF,South Africa,2013,528,630,-102
NLD,Netherlands,ZAF,South Africa,2014,484,696,-212
NLD,Netherlands,ZAF,South Africa,2015,529,820,-291
NLD,Netherlands,ZAF,South Africa,2016,615,1110,-495
NLD,Netherlands,ZAF,South Africa,2017,584,1124,-540
NZL,New Zealand,ZAF,South Africa,2008,493,3087,-2594
NZL,New Zealand,ZAF,South Africa,2009,674,1742,-1068
NZL,New Zealand,ZAF,South Africa,2010,736,1225,-489
NZL,New Zealand,ZAF,South Africa,2011,668,1231,-563
NZL,New Zealand,ZAF,South Africa,2012,503,1135,-632
NZL,New Zealand,ZAF,South Africa,2013,354,1215,-861
NZL,New Zealand,ZAF,South Africa,2014,237,1593,-1356
NZL,New Zealand,ZAF,South Africa,2015,168,2273,-2105
NZL,New Zealand,ZAF,South Africa,2016,213,4494,-4281
NZL,New Zealand,ZAF,South Africa,2017,296,5200,-4904
NOR,Norway,ZAF,South Africa,2008,39,63,-24
NOR,Norway,ZAF,South Africa,2009,41,67,-26
NOR,Norway,ZAF,South Africa,2010,51,59,-8
NOR,Norway,ZAF,South Africa,2011,58,59,-1
NOR,Norway,ZAF,South Africa,2012,30,80,-50
NOR,Norway,ZAF,South Africa,2013,44,64,-20
NOR,Norway,ZAF,South Africa,2014,43,58,-15
NOR,Norway,ZAF,South Africa,2015,28,52,-24
NOR,Norway,ZAF,South Africa,2016,43,59,-16
NOR,Norway,ZAF,South Africa,2017,17,570,-553
POL,Poland,ZAF,South Africa,2008,0,69,-69
POL,Poland,ZAF,South Africa,2009,0,61,-61
POL,Poland,ZAF,South Africa,2010,0,76,-76
POL,Poland,ZAF,South Africa,2011,0,58,-58
POL,Poland,ZAF,South Africa,2012,0,73,-73
POL,Poland,ZAF,South Africa,2013,0,0,0
POL,Poland,ZAF,South Africa,2014,0,28,-28
POL,Poland,ZAF,South Africa,2015,0,69,-69
POL,Poland,ZAF,South Africa,2016,0,63,-63
POL,Poland,ZAF,South Africa,2017,0,45,-45
SVK,Slovak Republic,ZAF,South Africa,2008,10,6,4
SVK,Slovak Republic,ZAF,South Africa,2009,3,3,0
SVK,Slovak Republic,ZAF,South Africa,2010,1,3,-2
SVK,Slovak Republic,ZAF,South Africa,2011,4,4,0
SVK,Slovak Republic,ZAF,South Africa,2012,0,3,-3
SVK,Slovak Republic,ZAF,South Africa,2013,0,2,-2
SVK,Slovak Republic,ZAF,South Africa,2014,0,2,-2
SVK,Slovak Republic,ZAF,South Africa,2015,0,3,-3
SVK,Slovak Republic,ZAF,South Africa,2016,0,1,-1
ESP,Spain,ZAF,South Africa,2008,68,132,-64
ESP,Spain,ZAF,South Africa,2009,53,83,-30
ESP,Spain,ZAF,South Africa,2010,59,104,-45
ESP,Spain,ZAF,South Africa,2011,68,158,-90
ESP,Spain,ZAF,South Africa,2012,46,162,-116
ESP,Spain,ZAF,South Africa,2013,66,161,-95
ESP,Spain,ZAF,South Africa,2014,66,152,-86
ESP,Spain,ZAF,South Africa,2015,55,156,-101
ESP,Spain,ZAF,South Africa,2016,52,196,-144
ESP,Spain,ZAF,South Africa,2017,109,209,-100
SWE,Sweden,ZAF,South Africa,2008,47,100,-53
SWE,Sweden,ZAF,South Africa,2009,39,96,-57
SWE,Sweden,ZAF,South Africa,2010,37,78,-41
SWE,Sweden,ZAF,South Africa,2011,31,97,-66
SWE,Sweden,ZAF,South Africa,2012,48,89,-41
SWE,Sweden,ZAF,South Africa,2013,24,68,-44
SWE,Sweden,ZAF,South Africa,2014,37,104,-67
SWE,Sweden,ZAF,South Africa,2015,48,116,-68
SWE,Sweden,ZAF,South Africa,2016,27,169,-142
SWE,Sweden,ZAF,South Africa,2017,31,169,-138
CHE,Switzerland,ZAF,South Africa,2010,143,253,-110
CHE,Switzerland,ZAF,South Africa,2011,186,244,-58
CHE,Switzerland,ZAF,South Africa,2012,141,236,-95
CHE,Switzerland,ZAF,South Africa,2013,175,211,-36
CHE,Switzerland,ZAF,South Africa,2014,131,184,-53
CHE,Switzerland,ZAF,South Africa,2015,96,192,-96
CHE,Switzerland,ZAF,South Africa,2016,132,236,-104
CHE,Switzerland,ZAF,South Africa,2017,152,187,-35
TUR,Turkey,ZAF,South Africa,2010,0,24,-24
TUR,Turkey,ZAF,South Africa,2016,127,238,-111
TUR,Turkey,ZAF,South Africa,2017,137,229,-92
GBR,United Kingdom,ZAF,South Africa,2008,6000,14000,-8000
GBR,United Kingdom,ZAF,South Africa,2009,4000,8000,-4000
GBR,United Kingdom,ZAF,South Africa,2011,2000,4000,-2000
GBR,United Kingdom,ZAF,South Africa,2012,2000,3000,-1000
GBR,United Kingdom,ZAF,South Africa,2013,2000,2000,0
GBR,United Kingdom,ZAF,South Africa,2014,1000,4000,-3000
GBR,United Kingdom,ZAF,South Africa,2015,1000,4000,-3000
GBR,United Kingdom,ZAF,South Africa,2016,0,6000,-6000
USA,United States,ZAF,South Africa,2008,0,2723,-2723
USA,United States,ZAF,South Africa,2009,0,3171,-3171
USA,United States,ZAF,South Africa,2010,0,2758,-2758
USA,United States,ZAF,South Africa,2011,0,2649,-2649
USA,United States,ZAF,South Africa,2012,0,2781,-2781
USA,United States,ZAF,South Africa,2013,0,2629,-2629
USA,United States,ZAF,South Africa,2014,0,2676,-2676
USA,United States,ZAF,South Africa,2015,0,2907,-2907
USA,United States,ZAF,South Africa,2016,0,3023,-3023
USA,United States,ZAF,South Africa,2017,0,2912,-2912
CHL,Chile,ZAF,South Africa,2008,0,55,-55
CHL,Chile,ZAF,South Africa,2009,0,67,-67
CHL,Chile,ZAF,South Africa,2010,0,36,-36
CHL,Chile,ZAF,South Africa,2011,0,36,-36
CHL,Chile,ZAF,South Africa,2012,0,54,-54
CHL,Chile,ZAF,South Africa,2013,0,70,-70
CHL,Chile,ZAF,South Africa,2014,0,47,-47
CHL,Chile,ZAF,South Africa,2015,0,56,-56
CHL,Chile,ZAF,South Africa,2016,0,27,-27
EST,Estonia,ZAF,South Africa,2008,0,5,-5
EST,Estonia,ZAF,South Africa,2009,0,0,0
EST,Estonia,ZAF,South Africa,2010,0,6,-6
EST,Estonia,ZAF,South Africa,2011,0,2,-2
EST,Estonia,ZAF,South Africa,2012,0,1,-1
EST,Estonia,ZAF,South Africa,2013,0,1,-1
EST,Estonia,ZAF,South Africa,2014,0,2,-2
EST,Estonia,ZAF,South Africa,2015,0,0,0
EST,Estonia,ZAF,South Africa,2016,0,4,-4
EST,Estonia,ZAF,South Africa,2017,0,6,-6
ISR,Israel,ZAF,South Africa,2008,0,257,-257
ISR,Israel,ZAF,South Africa,2009,0,274,-274
ISR,Israel,ZAF,South Africa,2010,0,212,-212
ISR,Israel,ZAF,South Africa,2011,0,174,-174
ISR,Israel,ZAF,South Africa,2012,0,125,-125
ISR,Israel,ZAF,South Africa,2013,0,161,-161
ISR,Israel,ZAF,South Africa,2014,0,117,-117
ISR,Israel,ZAF,South Africa,2015,0,189,-189
ISR,Israel,ZAF,South Africa,2016,0,220,-220
ISR,Israel,ZAF,South Africa,2017,0,281,-281
SVN,Slovenia,ZAF,South Africa,2009,0,2,-2
SVN,Slovenia,ZAF,South Africa,2011,0,2,-2
SVN,Slovenia,ZAF,South Africa,2012,0,3,-3
SVN,Slovenia,ZAF,South Africa,2013,0,6,-6
SVN,Slovenia,ZAF,South Africa,2014,0,4,-4
SVN,Slovenia,ZAF,South Africa,2015,0,2,-2
SVN,Slovenia,ZAF,South Africa,2016,0,2,-2
SVN,Slovenia,ZAF,South Africa,2017,0,10,-10
AUS,Australia,LKA,Sri Lanka,2008,409,4795,-4386
AUS,Australia,LKA,Sri Lanka,2009,336,4808,-4472
AUS,Australia,LKA,Sri Lanka,2010,417,5245,-4828
AUS,Australia,LKA,Sri Lanka,2011,528,4529,-4001
AUS,Australia,LKA,Sri Lanka,2012,519,5722,-5203
AUS,Australia,LKA,Sri Lanka,2013,457,5343,-4886
AUS,Australia,LKA,Sri Lanka,2014,502,4525,-4023
AUS,Australia,LKA,Sri Lanka,2015,500,3857,-3357
AUS,Australia,LKA,Sri Lanka,2016,500,3819,-3319
AUS,Australia,LKA,Sri Lanka,2017,0,3191,-3191
AUT,Austria,LKA,Sri Lanka,2008,29,50,-21
AUT,Austria,LKA,Sri Lanka,2009,27,51,-24
AUT,Austria,LKA,Sri Lanka,2010,35,30,5
AUT,Austria,LKA,Sri Lanka,2011,30,36,-6
AUT,Austria,LKA,Sri Lanka,2012,19,20,-1
AUT,Austria,LKA,Sri Lanka,2013,20,46,-26
AUT,Austria,LKA,Sri Lanka,2014,19,47,-28
AUT,Austria,LKA,Sri Lanka,2015,24,44,-20
AUT,Austria,LKA,Sri Lanka,2016,27,52,-25
AUT,Austria,LKA,Sri Lanka,2017,28,68,-40
BEL,Belgium,LKA,Sri Lanka,2008,0,53,-53
BEL,Belgium,LKA,Sri Lanka,2009,0,54,-54
BEL,Belgium,LKA,Sri Lanka,2010,22,71,-49
BEL,Belgium,LKA,Sri Lanka,2012,89,138,-49
BEL,Belgium,LKA,Sri Lanka,2013,93,127,-34
BEL,Belgium,LKA,Sri Lanka,2014,66,145,-79
BEL,Belgium,LKA,Sri Lanka,2015,36,184,-148
BEL,Belgium,LKA,Sri Lanka,2016,34,127,-93
BEL,Belgium,LKA,Sri Lanka,2017,21,120,-99
CAN,Canada,LKA,Sri Lanka,2008,0,4751,-4751
CAN,Canada,LKA,Sri Lanka,2009,0,4543,-4543
CAN,Canada,LKA,Sri Lanka,2010,0,4419,-4419
CAN,Canada,LKA,Sri Lanka,2011,0,3309,-3309
CAN,Canada,LKA,Sri Lanka,2012,0,3338,-3338
CAN,Canada,LKA,Sri Lanka,2013,0,2394,-2394
CAN,Canada,LKA,Sri Lanka,2014,0,2604,-2604
CAN,Canada,LKA,Sri Lanka,2015,0,1795,-1795
CAN,Canada,LKA,Sri Lanka,2016,0,1545,-1545
CAN,Canada,LKA,Sri Lanka,2017,0,2150,-2150
CZE,Czech Republic,LKA,Sri Lanka,2008,1,14,-13
CZE,Czech Republic,LKA,Sri Lanka,2009,0,17,-17
CZE,Czech Republic,LKA,Sri Lanka,2010,0,9,-9
CZE,Czech Republic,LKA,Sri Lanka,2011,0,5,-5
CZE,Czech Republic,LKA,Sri Lanka,2012,5,14,-9
CZE,Czech Republic,LKA,Sri Lanka,2013,13,12,1
CZE,Czech Republic,LKA,Sri Lanka,2014,5,19,-14
CZE,Czech Republic,LKA,Sri Lanka,2015,14,14,0
CZE,Czech Republic,LKA,Sri Lanka,2016,14,25,-11
CZE,Czech Republic,LKA,Sri Lanka,2017,6,25,-19
DNK,Denmark,LKA,Sri Lanka,2008,38,90,-52
DNK,Denmark,LKA,Sri Lanka,2009,53,106,-53
DNK,Denmark,LKA,Sri Lanka,2010,36,96,-60
DNK,Denmark,LKA,Sri Lanka,2011,26,70,-44
DNK,Denmark,LKA,Sri Lanka,2012,28,54,-26
DNK,Denmark,LKA,Sri Lanka,2013,28,113,-85
DNK,Denmark,LKA,Sri Lanka,2014,19,120,-101
DNK,Denmark,LKA,Sri Lanka,2015,38,84,-46
DNK,Denmark,LKA,Sri Lanka,2016,80,76,4
DNK,Denmark,LKA,Sri Lanka,2017,38,76,-38
FIN,Finland,LKA,Sri Lanka,2008,3,74,-71
FIN,Finland,LKA,Sri Lanka,2009,2,94,-92
FIN,Finland,LKA,Sri Lanka,2010,5,43,-38
FIN,Finland,LKA,Sri Lanka,2011,5,89,-84
FIN,Finland,LKA,Sri Lanka,2012,6,96,-90
FIN,Finland,LKA,Sri Lanka,2013,3,64,-61
FIN,Finland,LKA,Sri Lanka,2014,9,60,-51
FIN,Finland,LKA,Sri Lanka,2015,6,48,-42
FIN,Finland,LKA,Sri Lanka,2016,8,58,-50
FIN,Finland,LKA,Sri Lanka,2017,11,43,-32
FRA,France,LKA,Sri Lanka,2008,0,1937,-1937
FRA,France,LKA,Sri Lanka,2009,0,2849,-2849
FRA,France,LKA,Sri Lanka,2010,0,2719,-2719
FRA,France,LKA,Sri Lanka,2011,0,2415,-2415
FRA,France,LKA,Sri Lanka,2012,0,2452,-2452
FRA,France,LKA,Sri Lanka,2013,0,2461,-2461
FRA,France,LKA,Sri Lanka,2014,0,2534,-2534
FRA,France,LKA,Sri Lanka,2015,0,2335,-2335
FRA,France,LKA,Sri Lanka,2016,0,2545,-2545
FRA,France,LKA,Sri Lanka,2017,0,2242,-2242
DEU,Germany,LKA,Sri Lanka,2008,866,1090,-224
DEU,Germany,LKA,Sri Lanka,2009,879,1212,-333
DEU,Germany,LKA,Sri Lanka,2010,724,1181,-457
DEU,Germany,LKA,Sri Lanka,2011,576,1332,-756
DEU,Germany,LKA,Sri Lanka,2012,554,1248,-694
DEU,Germany,LKA,Sri Lanka,2013,591,1290,-699
DEU,Germany,LKA,Sri Lanka,2014,511,1214,-703
DEU,Germany,LKA,Sri Lanka,2015,534,1178,-644
DEU,Germany,LKA,Sri Lanka,2016,555,1065,-510
DEU,Germany,LKA,Sri Lanka,2017,497,1221,-724
HUN,Hungary,LKA,Sri Lanka,2008,0,6,-6
HUN,Hungary,LKA,Sri Lanka,2009,0,4,-4
HUN,Hungary,LKA,Sri Lanka,2010,2,3,-1
HUN,Hungary,LKA,Sri Lanka,2011,1,6,-5
HUN,Hungary,LKA,Sri Lanka,2012,0,6,-6
HUN,Hungary,LKA,Sri Lanka,2013,2,10,-8
HUN,Hungary,LKA,Sri Lanka,2014,0,9,-9
HUN,Hungary,LKA,Sri Lanka,2015,2,11,-9
HUN,Hungary,LKA,Sri Lanka,2016,5,11,-6
HUN,Hungary,LKA,Sri Lanka,2017,0,19,-19
ISL,Iceland,LKA,Sri Lanka,2008,10,9,1
ISL,Iceland,LKA,Sri Lanka,2009,3,7,-4
ISL,Iceland,LKA,Sri Lanka,2010,4,4,0
ISL,Iceland,LKA,Sri Lanka,2011,4,4,0
ISL,Iceland,LKA,Sri Lanka,2012,3,7,-4
ISL,Iceland,LKA,Sri Lanka,2013,4,7,-3
ISL,Iceland,LKA,Sri Lanka,2014,7,6,1
ISL,Iceland,LKA,Sri Lanka,2015,6,11,-5
ISL,Iceland,LKA,Sri Lanka,2016,4,3,1
ISL,Iceland,LKA,Sri Lanka,2017,3,6,-3
ITA,Italy,LKA,Sri Lanka,2008,270,6610,-6340
ITA,Italy,LKA,Sri Lanka,2009,326,6317,-5991
ITA,Italy,LKA,Sri Lanka,2010,442,7105,-6663
ITA,Italy,LKA,Sri Lanka,2011,497,6789,-6292
ITA,Italy,LKA,Sri Lanka,2012,596,7138,-6542
ITA,Italy,LKA,Sri Lanka,2013,692,6286,-5594
ITA,Italy,LKA,Sri Lanka,2014,588,5255,-4667
ITA,Italy,LKA,Sri Lanka,2015,554,4848,-4294
ITA,Italy,LKA,Sri Lanka,2016,0,3968,-3968
ITA,Italy,LKA,Sri Lanka,2017,509,3732,-3223
JPN,Japan,LKA,Sri Lanka,2008,637,1145,-508
JPN,Japan,LKA,Sri Lanka,2009,668,1309,-641
JPN,Japan,LKA,Sri Lanka,2010,635,1200,-565
JPN,Japan,LKA,Sri Lanka,2011,779,1364,-585
JPN,Japan,LKA,Sri Lanka,2012,798,1472,-674
JPN,Japan,LKA,Sri Lanka,2013,713,1538,-825
JPN,Japan,LKA,Sri Lanka,2014,669,2159,-1490
JPN,Japan,LKA,Sri Lanka,2015,667,3064,-2397
JPN,Japan,LKA,Sri Lanka,2016,820,4682,-3862
JPN,Japan,LKA,Sri Lanka,2017,1026,5551,-4525
KOR,Korea,LKA,Sri Lanka,2008,2252,4795,-2543
KOR,Korea,LKA,Sri Lanka,2009,2184,1722,462
KOR,Korea,LKA,Sri Lanka,2010,1846,4202,-2356
KOR,Korea,LKA,Sri Lanka,2011,2974,5892,-2918
KOR,Korea,LKA,Sri Lanka,2012,3819,4675,-856
KOR,Korea,LKA,Sri Lanka,2013,4160,5274,-1114
KOR,Korea,LKA,Sri Lanka,2014,2241,4836,-2595
KOR,Korea,LKA,Sri Lanka,2015,4876,5462,-586
KOR,Korea,LKA,Sri Lanka,2016,6005,7093,-1088
KOR,Korea,LKA,Sri Lanka,2017,4596,3878,718
LUX,Luxembourg,LKA,Sri Lanka,2008,1,1,0
LUX,Luxembourg,LKA,Sri Lanka,2009,0,2,-2
LUX,Luxembourg,LKA,Sri Lanka,2010,0,5,-5
LUX,Luxembourg,LKA,Sri Lanka,2011,1,3,-2
LUX,Luxembourg,LKA,Sri Lanka,2012,1,2,-1
LUX,Luxembourg,LKA,Sri Lanka,2013,0,7,-7
LUX,Luxembourg,LKA,Sri Lanka,2014,0,2,-2
LUX,Luxembourg,LKA,Sri Lanka,2015,0,4,-4
LUX,Luxembourg,LKA,Sri Lanka,2016,0,2,-2
LUX,Luxembourg,LKA,Sri Lanka,2017,1,0,1
MEX,Mexico,LKA,Sri Lanka,2010,0,2,-2
MEX,Mexico,LKA,Sri Lanka,2011,0,4,-4
MEX,Mexico,LKA,Sri Lanka,2012,0,7,-7
MEX,Mexico,LKA,Sri Lanka,2013,0,1,-1
MEX,Mexico,LKA,Sri Lanka,2014,0,11,-11
MEX,Mexico,LKA,Sri Lanka,2015,0,7,-7
MEX,Mexico,LKA,Sri Lanka,2017,0,2,-2
NLD,Netherlands,LKA,Sri Lanka,2008,70,149,-79
NLD,Netherlands,LKA,Sri Lanka,2009,57,120,-63
NLD,Netherlands,LKA,Sri Lanka,2010,72,142,-70
NLD,Netherlands,LKA,Sri Lanka,2011,79,161,-82
NLD,Netherlands,LKA,Sri Lanka,2012,56,151,-95
NLD,Netherlands,LKA,Sri Lanka,2013,66,158,-92
NLD,Netherlands,LKA,Sri Lanka,2014,38,199,-161
NLD,Netherlands,LKA,Sri Lanka,2015,56,147,-91
NLD,Netherlands,LKA,Sri Lanka,2016,49,154,-105
NLD,Netherlands,LKA,Sri Lanka,2017,50,124,-74
NZL,New Zealand,LKA,Sri Lanka,2008,54,667,-613
NZL,New Zealand,LKA,Sri Lanka,2009,89,523,-434
NZL,New Zealand,LKA,Sri Lanka,2010,125,585,-460
NZL,New Zealand,LKA,Sri Lanka,2011,96,677,-581
NZL,New Zealand,LKA,Sri Lanka,2012,102,785,-683
NZL,New Zealand,LKA,Sri Lanka,2013,118,791,-673
NZL,New Zealand,LKA,Sri Lanka,2014,93,746,-653
NZL,New Zealand,LKA,Sri Lanka,2015,131,1036,-905
NZL,New Zealand,LKA,Sri Lanka,2016,99,1128,-1029
NZL,New Zealand,LKA,Sri Lanka,2017,139,1329,-1190
NOR,Norway,LKA,Sri Lanka,2008,111,293,-182
NOR,Norway,LKA,Sri Lanka,2009,70,226,-156
NOR,Norway,LKA,Sri Lanka,2010,94,178,-84
NOR,Norway,LKA,Sri Lanka,2011,117,204,-87
NOR,Norway,LKA,Sri Lanka,2012,77,205,-128
NOR,Norway,LKA,Sri Lanka,2013,94,191,-97
NOR,Norway,LKA,Sri Lanka,2014,55,137,-82
NOR,Norway,LKA,Sri Lanka,2015,60,144,-84
NOR,Norway,LKA,Sri Lanka,2016,57,142,-85
NOR,Norway,LKA,Sri Lanka,2017,38,125,-87
POL,Poland,LKA,Sri Lanka,2008,0,18,-18
POL,Poland,LKA,Sri Lanka,2009,0,32,-32
POL,Poland,LKA,Sri Lanka,2010,0,32,-32
POL,Poland,LKA,Sri Lanka,2011,0,25,-25
POL,Poland,LKA,Sri Lanka,2012,0,23,-23
POL,Poland,LKA,Sri Lanka,2013,0,41,-41
POL,Poland,LKA,Sri Lanka,2014,0,19,-19
POL,Poland,LKA,Sri Lanka,2015,0,41,-41
POL,Poland,LKA,Sri Lanka,2016,0,38,-38
POL,Poland,LKA,Sri Lanka,2017,0,54,-54
SVK,Slovak Republic,LKA,Sri Lanka,2008,0,1,-1
SVK,Slovak Republic,LKA,Sri Lanka,2009,0,1,-1
SVK,Slovak Republic,LKA,Sri Lanka,2010,4,1,3
SVK,Slovak Republic,LKA,Sri Lanka,2011,0,4,-4
SVK,Slovak Republic,LKA,Sri Lanka,2014,0,1,-1
ESP,Spain,LKA,Sri Lanka,2008,18,72,-54
ESP,Spain,LKA,Sri Lanka,2009,26,50,-24
ESP,Spain,LKA,Sri Lanka,2010,25,35,-10
ESP,Spain,LKA,Sri Lanka,2011,18,40,-22
ESP,Spain,LKA,Sri Lanka,2012,16,38,-22
ESP,Spain,LKA,Sri Lanka,2013,9,40,-31
ESP,Spain,LKA,Sri Lanka,2014,13,36,-23
ESP,Spain,LKA,Sri Lanka,2015,7,23,-16
ESP,Spain,LKA,Sri Lanka,2016,23,48,-25
ESP,Spain,LKA,Sri Lanka,2017,35,32,3
SWE,Sweden,LKA,Sri Lanka,2008,35,165,-130
SWE,Sweden,LKA,Sri Lanka,2009,24,154,-130
SWE,Sweden,LKA,Sri Lanka,2010,40,138,-98
SWE,Sweden,LKA,Sri Lanka,2011,32,122,-90
SWE,Sweden,LKA,Sri Lanka,2012,41,159,-118
SWE,Sweden,LKA,Sri Lanka,2013,51,105,-54
SWE,Sweden,LKA,Sri Lanka,2014,54,126,-72
SWE,Sweden,LKA,Sri Lanka,2015,46,126,-80
SWE,Sweden,LKA,Sri Lanka,2016,22,118,-96
SWE,Sweden,LKA,Sri Lanka,2017,40,146,-106
CHE,Switzerland,LKA,Sri Lanka,2010,174,673,-499
CHE,Switzerland,LKA,Sri Lanka,2011,167,511,-344
CHE,Switzerland,LKA,Sri Lanka,2012,123,515,-392
CHE,Switzerland,LKA,Sri Lanka,2013,116,593,-477
CHE,Switzerland,LKA,Sri Lanka,2014,138,1659,-1521
CHE,Switzerland,LKA,Sri Lanka,2015,116,1635,-1519
CHE,Switzerland,LKA,Sri Lanka,2016,133,1101,-968
CHE,Switzerland,LKA,Sri Lanka,2017,142,811,-669
GBR,United Kingdom,LKA,Sri Lanka,2008,0,5000,-5000
GBR,United Kingdom,LKA,Sri Lanka,2009,0,7000,-7000
GBR,United Kingdom,LKA,Sri Lanka,2010,0,11000,-11000
GBR,United Kingdom,LKA,Sri Lanka,2011,1000,6000,-5000
GBR,United Kingdom,LKA,Sri Lanka,2012,2000,4000,-2000
GBR,United Kingdom,LKA,Sri Lanka,2013,2000,1000,1000
GBR,United Kingdom,LKA,Sri Lanka,2014,1000,2000,-1000
GBR,United Kingdom,LKA,Sri Lanka,2015,0,3000,-3000
USA,United States,LKA,Sri Lanka,2008,0,1935,-1935
USA,United States,LKA,Sri Lanka,2009,0,2009,-2009
USA,United States,LKA,Sri Lanka,2010,0,2036,-2036
USA,United States,LKA,Sri Lanka,2011,0,2053,-2053
USA,United States,LKA,Sri Lanka,2012,0,1994,-1994
USA,United States,LKA,Sri Lanka,2013,0,1847,-1847
USA,United States,LKA,Sri Lanka,2014,0,1767,-1767
USA,United States,LKA,Sri Lanka,2015,0,1763,-1763
USA,United States,LKA,Sri Lanka,2016,0,1913,-1913
USA,United States,LKA,Sri Lanka,2017,0,1627,-1627
CHL,Chile,LKA,Sri Lanka,2008,0,9,-9
CHL,Chile,LKA,Sri Lanka,2009,0,4,-4
CHL,Chile,LKA,Sri Lanka,2010,0,3,-3
CHL,Chile,LKA,Sri Lanka,2011,0,0,0
CHL,Chile,LKA,Sri Lanka,2012,0,3,-3
CHL,Chile,LKA,Sri Lanka,2013,0,2,-2
CHL,Chile,LKA,Sri Lanka,2014,0,2,-2
CHL,Chile,LKA,Sri Lanka,2015,0,6,-6
CHL,Chile,LKA,Sri Lanka,2016,0,3,-3
EST,Estonia,LKA,Sri Lanka,2008,0,1,-1
EST,Estonia,LKA,Sri Lanka,2009,0,0,0
EST,Estonia,LKA,Sri Lanka,2010,0,0,0
EST,Estonia,LKA,Sri Lanka,2011,0,1,-1
EST,Estonia,LKA,Sri Lanka,2012,0,0,0
EST,Estonia,LKA,Sri Lanka,2013,0,4,-4
EST,Estonia,LKA,Sri Lanka,2014,0,2,-2
EST,Estonia,LKA,Sri Lanka,2015,0,8,-8
EST,Estonia,LKA,Sri Lanka,2016,0,5,-5
EST,Estonia,LKA,Sri Lanka,2017,0,17,-17
SVN,Slovenia,LKA,Sri Lanka,2008,0,1,-1
SVN,Slovenia,LKA,Sri Lanka,2009,0,2,-2
SVN,Slovenia,LKA,Sri Lanka,2012,0,1,-1
SVN,Slovenia,LKA,Sri Lanka,2014,0,1,-1
SVN,Slovenia,LKA,Sri Lanka,2015,0,1,-1
SVN,Slovenia,LKA,Sri Lanka,2017,0,2,-2
AUS,Australia,SDN,Sudan,2008,140,1198,-1058
AUS,Australia,SDN,Sudan,2009,194,1071,-877
AUS,Australia,SDN,Sudan,2010,186,786,-600
AUS,Australia,SDN,Sudan,2011,229,694,-465
AUS,Australia,SDN,Sudan,2012,223,406,-183
AUS,Australia,SDN,Sudan,2013,183,475,-292
AUS,Australia,SDN,Sudan,2014,175,282,-107
AUS,Australia,SDN,Sudan,2015,200,216,-16
AUS,Australia,SDN,Sudan,2016,100,212,-112
AUS,Australia,SDN,Sudan,2017,0,135,-135
AUT,Austria,SDN,Sudan,2008,36,57,-21
AUT,Austria,SDN,Sudan,2009,47,69,-22
AUT,Austria,SDN,Sudan,2010,50,43,7
AUT,Austria,SDN,Sudan,2011,33,92,-59
AUT,Austria,SDN,Sudan,2012,47,81,-34
AUT,Austria,SDN,Sudan,2013,39,63,-24
AUT,Austria,SDN,Sudan,2014,31,116,-85
AUT,Austria,SDN,Sudan,2015,46,123,-77
AUT,Austria,SDN,Sudan,2016,43,64,-21
AUT,Austria,SDN,Sudan,2017,56,57,-1
BEL,Belgium,SDN,Sudan,2008,0,23,-23
BEL,Belgium,SDN,Sudan,2009,0,26,-26
BEL,Belgium,SDN,Sudan,2010,8,28,-20
BEL,Belgium,SDN,Sudan,2012,58,92,-34
BEL,Belgium,SDN,Sudan,2013,29,60,-31
BEL,Belgium,SDN,Sudan,2014,34,114,-80
BEL,Belgium,SDN,Sudan,2015,36,111,-75
BEL,Belgium,SDN,Sudan,2016,38,72,-34
BEL,Belgium,SDN,Sudan,2017,23,121,-98
CAN,Canada,SDN,Sudan,2008,0,620,-620
CAN,Canada,SDN,Sudan,2009,0,422,-422
CAN,Canada,SDN,Sudan,2010,0,612,-612
CAN,Canada,SDN,Sudan,2011,0,530,-530
CAN,Canada,SDN,Sudan,2012,0,444,-444
CAN,Canada,SDN,Sudan,2013,0,343,-343
CAN,Canada,SDN,Sudan,2014,0,484,-484
CAN,Canada,SDN,Sudan,2015,0,359,-359
CAN,Canada,SDN,Sudan,2016,0,445,-445
CAN,Canada,SDN,Sudan,2017,0,430,-430
CZE,Czech Republic,SDN,Sudan,2008,0,7,-7
CZE,Czech Republic,SDN,Sudan,2009,0,7,-7
CZE,Czech Republic,SDN,Sudan,2010,0,2,-2
CZE,Czech Republic,SDN,Sudan,2011,2,5,-3
CZE,Czech Republic,SDN,Sudan,2012,3,2,1
CZE,Czech Republic,SDN,Sudan,2013,5,2,3
CZE,Czech Republic,SDN,Sudan,2014,1,7,-6
CZE,Czech Republic,SDN,Sudan,2015,3,9,-6
CZE,Czech Republic,SDN,Sudan,2016,2,6,-4
CZE,Czech Republic,SDN,Sudan,2017,3,3,0
DNK,Denmark,SDN,Sudan,2008,11,46,-35
DNK,Denmark,SDN,Sudan,2009,5,14,-9
DNK,Denmark,SDN,Sudan,2010,12,24,-12
DNK,Denmark,SDN,Sudan,2011,8,31,-23
DNK,Denmark,SDN,Sudan,2012,9,18,-9
DNK,Denmark,SDN,Sudan,2013,13,31,-18
DNK,Denmark,SDN,Sudan,2014,9,60,-51
DNK,Denmark,SDN,Sudan,2015,7,32,-25
DNK,Denmark,SDN,Sudan,2016,20,31,-11
DNK,Denmark,SDN,Sudan,2017,9,29,-20
FIN,Finland,SDN,Sudan,2008,6,27,-21
FIN,Finland,SDN,Sudan,2009,3,9,-6
FIN,Finland,SDN,Sudan,2010,7,16,-9
FIN,Finland,SDN,Sudan,2011,2,10,-8
FIN,Finland,SDN,Sudan,2012,2,16,-14
FIN,Finland,SDN,Sudan,2013,0,13,-13
FIN,Finland,SDN,Sudan,2014,0,63,-63
FIN,Finland,SDN,Sudan,2015,1,212,-211
FIN,Finland,SDN,Sudan,2016,3,50,-47
FIN,Finland,SDN,Sudan,2017,1,27,-26
FRA,France,SDN,Sudan,2008,0,241,-241
FRA,France,SDN,Sudan,2009,0,237,-237
FRA,France,SDN,Sudan,2010,0,274,-274
FRA,France,SDN,Sudan,2011,0,328,-328
FRA,France,SDN,Sudan,2012,0,356,-356
FRA,France,SDN,Sudan,2013,0,297,-297
FRA,France,SDN,Sudan,2014,0,308,-308
FRA,France,SDN,Sudan,2015,0,772,-772
FRA,France,SDN,Sudan,2016,0,1990,-1990
FRA,France,SDN,Sudan,2017,0,4047,-4047
DEU,Germany,SDN,Sudan,2008,417,429,-12
DEU,Germany,SDN,Sudan,2009,384,396,-12
DEU,Germany,SDN,Sudan,2010,341,381,-40
DEU,Germany,SDN,Sudan,2011,237,259,-22
DEU,Germany,SDN,Sudan,2012,150,46,104
DEU,Germany,SDN,Sudan,2013,76,18,58
DEU,Germany,SDN,Sudan,2014,385,1497,-1112
DEU,Germany,SDN,Sudan,2015,844,5776,-4932
DEU,Germany,SDN,Sudan,2016,3598,2543,1055
DEU,Germany,SDN,Sudan,2017,1855,1900,-45
HUN,Hungary,SDN,Sudan,2008,0,10,-10
HUN,Hungary,SDN,Sudan,2009,0,12,-12
HUN,Hungary,SDN,Sudan,2010,2,4,-2
HUN,Hungary,SDN,Sudan,2011,0,4,-4
HUN,Hungary,SDN,Sudan,2012,0,7,-7
HUN,Hungary,SDN,Sudan,2013,2,12,-10
HUN,Hungary,SDN,Sudan,2014,0,25,-25
HUN,Hungary,SDN,Sudan,2015,1,43,-42
HUN,Hungary,SDN,Sudan,2016,2,24,-22
HUN,Hungary,SDN,Sudan,2017,0,42,-42
ISL,Iceland,SDN,Sudan,2008,0,0,0
ISL,Iceland,SDN,Sudan,2009,0,0,0
ISL,Iceland,SDN,Sudan,2010,0,0,0
ISL,Iceland,SDN,Sudan,2011,0,0,0
ISL,Iceland,SDN,Sudan,2012,0,0,0
ISL,Iceland,SDN,Sudan,2013,0,0,0
ISL,Iceland,SDN,Sudan,2014,0,1,-1
ISL,Iceland,SDN,Sudan,2015,1,1,0
ISL,Iceland,SDN,Sudan,2016,0,1,-1
ISL,Iceland,SDN,Sudan,2017,0,1,-1
ITA,Italy,SDN,Sudan,2008,4,480,-476
ITA,Italy,SDN,Sudan,2009,5,256,-251
ITA,Italy,SDN,Sudan,2010,11,128,-117
ITA,Italy,SDN,Sudan,2011,2,114,-112
ITA,Italy,SDN,Sudan,2012,14,459,-445
ITA,Italy,SDN,Sudan,2013,12,217,-205
ITA,Italy,SDN,Sudan,2014,11,171,-160
ITA,Italy,SDN,Sudan,2015,13,174,-161
ITA,Italy,SDN,Sudan,2016,0,169,-169
ITA,Italy,SDN,Sudan,2017,7,316,-309
JPN,Japan,SDN,Sudan,2008,123,137,-14
JPN,Japan,SDN,Sudan,2009,107,121,-14
JPN,Japan,SDN,Sudan,2010,50,85,-35
JPN,Japan,SDN,Sudan,2011,138,150,-12
JPN,Japan,SDN,Sudan,2012,198,210,-12
JPN,Japan,SDN,Sudan,2013,193,215,-22
JPN,Japan,SDN,Sudan,2014,177,192,-15
JPN,Japan,SDN,Sudan,2015,224,245,-21
JPN,Japan,SDN,Sudan,2016,161,182,-21
JPN,Japan,SDN,Sudan,2017,207,215,-8
KOR,Korea,SDN,Sudan,2008,86,69,17
KOR,Korea,SDN,Sudan,2009,63,85,-22
KOR,Korea,SDN,Sudan,2010,108,104,4
KOR,Korea,SDN,Sudan,2011,73,84,-11
KOR,Korea,SDN,Sudan,2012,80,69,11
KOR,Korea,SDN,Sudan,2013,64,66,-2
KOR,Korea,SDN,Sudan,2014,66,62,4
KOR,Korea,SDN,Sudan,2015,62,71,-9
KOR,Korea,SDN,Sudan,2016,57,122,-65
KOR,Korea,SDN,Sudan,2017,59,63,-4
LUX,Luxembourg,SDN,Sudan,2008,3,0,3
LUX,Luxembourg,SDN,Sudan,2009,3,2,1
LUX,Luxembourg,SDN,Sudan,2010,0,6,-6
LUX,Luxembourg,SDN,Sudan,2011,4,1,3
LUX,Luxembourg,SDN,Sudan,2012,0,1,-1
LUX,Luxembourg,SDN,Sudan,2013,0,4,-4
LUX,Luxembourg,SDN,Sudan,2014,4,5,-1
LUX,Luxembourg,SDN,Sudan,2015,4,5,-1
LUX,Luxembourg,SDN,Sudan,2016,2,9,-7
LUX,Luxembourg,SDN,Sudan,2017,6,18,-12
MEX,Mexico,SDN,Sudan,2012,0,0,0
MEX,Mexico,SDN,Sudan,2013,0,0,0
MEX,Mexico,SDN,Sudan,2014,0,0,0
NLD,Netherlands,SDN,Sudan,2008,22,56,-34
NLD,Netherlands,SDN,Sudan,2009,41,60,-19
NLD,Netherlands,SDN,Sudan,2010,29,71,-42
NLD,Netherlands,SDN,Sudan,2011,28,78,-50
NLD,Netherlands,SDN,Sudan,2012,22,75,-53
NLD,Netherlands,SDN,Sudan,2013,29,62,-33
NLD,Netherlands,SDN,Sudan,2014,30,131,-101
NLD,Netherlands,SDN,Sudan,2015,46,197,-151
NLD,Netherlands,SDN,Sudan,2016,26,238,-212
NLD,Netherlands,SDN,Sudan,2017,60,159,-99
NZL,New Zealand,SDN,Sudan,2008,1,4,-3
NZL,New Zealand,SDN,Sudan,2009,2,26,-24
NZL,New Zealand,SDN,Sudan,2010,0,7,-7
NZL,New Zealand,SDN,Sudan,2011,0,11,-11
NZL,New Zealand,SDN,Sudan,2012,1,9,-8
NZL,New Zealand,SDN,Sudan,2013,1,23,-22
NZL,New Zealand,SDN,Sudan,2014,0,6,-6
NZL,New Zealand,SDN,Sudan,2015,0,11,-11
NZL,New Zealand,SDN,Sudan,2016,1,24,-23
NZL,New Zealand,SDN,Sudan,2017,1,26,-25
NOR,Norway,SDN,Sudan,2008,10,88,-78
NOR,Norway,SDN,Sudan,2009,16,133,-117
NOR,Norway,SDN,Sudan,2010,30,173,-143
NOR,Norway,SDN,Sudan,2011,40,224,-184
NOR,Norway,SDN,Sudan,2012,28,493,-465
NOR,Norway,SDN,Sudan,2013,25,472,-447
NOR,Norway,SDN,Sudan,2014,19,325,-306
NOR,Norway,SDN,Sudan,2015,71,557,-486
NOR,Norway,SDN,Sudan,2016,44,543,-499
NOR,Norway,SDN,Sudan,2017,31,265,-234
POL,Poland,SDN,Sudan,2009,0,15,-15
POL,Poland,SDN,Sudan,2010,0,13,-13
POL,Poland,SDN,Sudan,2011,0,13,-13
POL,Poland,SDN,Sudan,2012,0,13,-13
POL,Poland,SDN,Sudan,2013,0,16,-16
POL,Poland,SDN,Sudan,2014,0,9,-9
POL,Poland,SDN,Sudan,2015,0,22,-22
POL,Poland,SDN,Sudan,2016,0,17,-17
POL,Poland,SDN,Sudan,2017,0,18,-18
SVK,Slovak Republic,SDN,Sudan,2008,1,1,0
SVK,Slovak Republic,SDN,Sudan,2009,5,88,-83
SVK,Slovak Republic,SDN,Sudan,2010,7,13,-6
SVK,Slovak Republic,SDN,Sudan,2011,4,2,2
SVK,Slovak Republic,SDN,Sudan,2012,0,1,-1
ESP,Spain,SDN,Sudan,2008,43,49,-6
ESP,Spain,SDN,Sudan,2009,21,29,-8
ESP,Spain,SDN,Sudan,2010,24,15,9
ESP,Spain,SDN,Sudan,2011,18,20,-2
ESP,Spain,SDN,Sudan,2012,20,58,-38
ESP,Spain,SDN,Sudan,2013,7,26,-19
ESP,Spain,SDN,Sudan,2014,9,48,-39
ESP,Spain,SDN,Sudan,2015,7,48,-41
ESP,Spain,SDN,Sudan,2016,24,38,-14
ESP,Spain,SDN,Sudan,2017,39,44,-5
SWE,Sweden,SDN,Sudan,2008,18,99,-81
SWE,Sweden,SDN,Sudan,2009,17,146,-129
SWE,Sweden,SDN,Sudan,2010,15,132,-117
SWE,Sweden,SDN,Sudan,2011,31,194,-163
SWE,Sweden,SDN,Sudan,2012,40,206,-166
SWE,Sweden,SDN,Sudan,2013,8,228,-220
SWE,Sweden,SDN,Sudan,2014,32,211,-179
SWE,Sweden,SDN,Sudan,2015,32,130,-98
SWE,Sweden,SDN,Sudan,2016,13,408,-395
SWE,Sweden,SDN,Sudan,2017,12,319,-307
CHE,Switzerland,SDN,Sudan,2010,4,28,-24
CHE,Switzerland,SDN,Sudan,2011,13,34,-21
CHE,Switzerland,SDN,Sudan,2012,4,46,-42
CHE,Switzerland,SDN,Sudan,2013,5,39,-34
CHE,Switzerland,SDN,Sudan,2014,4,63,-59
CHE,Switzerland,SDN,Sudan,2015,3,44,-41
CHE,Switzerland,SDN,Sudan,2016,3,59,-56
CHE,Switzerland,SDN,Sudan,2017,9,66,-57
TUR,Turkey,SDN,Sudan,2010,0,34,-34
TUR,Turkey,SDN,Sudan,2016,149,442,-293
TUR,Turkey,SDN,Sudan,2017,188,656,-468
USA,United States,SDN,Sudan,2008,0,3598,-3598
USA,United States,SDN,Sudan,2009,0,3577,-3577
USA,United States,SDN,Sudan,2010,0,2397,-2397
USA,United States,SDN,Sudan,2011,0,2628,-2628
USA,United States,SDN,Sudan,2012,0,2471,-2471
USA,United States,SDN,Sudan,2013,0,1945,-1945
USA,United States,SDN,Sudan,2014,0,2442,-2442
USA,United States,SDN,Sudan,2015,0,3580,-3580
USA,United States,SDN,Sudan,2016,0,3159,-3159
USA,United States,SDN,Sudan,2017,0,3515,-3515
CHL,Chile,SDN,Sudan,2008,0,0,0
CHL,Chile,SDN,Sudan,2009,0,0,0
CHL,Chile,SDN,Sudan,2010,0,0,0
CHL,Chile,SDN,Sudan,2011,0,0,0
CHL,Chile,SDN,Sudan,2012,0,0,0
CHL,Chile,SDN,Sudan,2013,0,0,0
CHL,Chile,SDN,Sudan,2014,0,0,0
CHL,Chile,SDN,Sudan,2015,0,0,0
CHL,Chile,SDN,Sudan,2016,0,0,0
EST,Estonia,SDN,Sudan,2008,0,0,0
EST,Estonia,SDN,Sudan,2009,0,0,0
EST,Estonia,SDN,Sudan,2010,0,0,0
EST,Estonia,SDN,Sudan,2011,0,0,0
EST,Estonia,SDN,Sudan,2012,0,0,0
EST,Estonia,SDN,Sudan,2013,0,1,-1
EST,Estonia,SDN,Sudan,2014,0,0,0
EST,Estonia,SDN,Sudan,2015,0,7,-7
EST,Estonia,SDN,Sudan,2016,0,5,-5
EST,Estonia,SDN,Sudan,2017,0,7,-7
SVN,Slovenia,SDN,Sudan,2014,0,1,-1
SVN,Slovenia,SDN,Sudan,2015,0,2,-2
AUS,Australia,SUR,Suriname,2008,0,4,-4
AUS,Australia,SUR,Suriname,2009,0,2,-2
AUS,Australia,SUR,Suriname,2010,0,2,-2
AUS,Australia,SUR,Suriname,2011,0,4,-4
AUS,Australia,SUR,Suriname,2012,0,0,0
AUS,Australia,SUR,Suriname,2013,0,5,-5
AUS,Australia,SUR,Suriname,2014,0,0,0
AUS,Australia,SUR,Suriname,2015,0,0,0
AUS,Australia,SUR,Suriname,2017,0,0,0
AUT,Austria,SUR,Suriname,2008,1,2,-1
AUT,Austria,SUR,Suriname,2009,0,0,0
AUT,Austria,SUR,Suriname,2010,1,4,-3
AUT,Austria,SUR,Suriname,2011,0,1,-1
AUT,Austria,SUR,Suriname,2012,0,0,0
AUT,Austria,SUR,Suriname,2013,1,0,1
AUT,Austria,SUR,Suriname,2014,2,1,1
AUT,Austria,SUR,Suriname,2015,1,0,1
AUT,Austria,SUR,Suriname,2016,0,1,-1
AUT,Austria,SUR,Suriname,2017,1,0,1
BEL,Belgium,SUR,Suriname,2008,0,60,-60
BEL,Belgium,SUR,Suriname,2009,0,105,-105
BEL,Belgium,SUR,Suriname,2010,23,148,-125
BEL,Belgium,SUR,Suriname,2011,0,219,-219
BEL,Belgium,SUR,Suriname,2012,61,279,-218
BEL,Belgium,SUR,Suriname,2013,92,263,-171
BEL,Belgium,SUR,Suriname,2014,57,249,-192
BEL,Belgium,SUR,Suriname,2015,72,238,-166
BEL,Belgium,SUR,Suriname,2016,64,223,-159
BEL,Belgium,SUR,Suriname,2017,52,303,-251
CAN,Canada,SUR,Suriname,2008,0,9,-9
CAN,Canada,SUR,Suriname,2009,0,12,-12
CAN,Canada,SUR,Suriname,2010,0,13,-13
CAN,Canada,SUR,Suriname,2011,0,11,-11
CAN,Canada,SUR,Suriname,2012,0,16,-16
CAN,Canada,SUR,Suriname,2013,0,4,-4
CAN,Canada,SUR,Suriname,2014,0,6,-6
CAN,Canada,SUR,Suriname,2015,0,10,-10
CAN,Canada,SUR,Suriname,2016,0,10,-10
CAN,Canada,SUR,Suriname,2017,0,5,-5
CZE,Czech Republic,SUR,Suriname,2012,0,2,-2
DNK,Denmark,SUR,Suriname,2008,0,1,-1
DNK,Denmark,SUR,Suriname,2009,0,0,0
DNK,Denmark,SUR,Suriname,2010,0,1,-1
DNK,Denmark,SUR,Suriname,2012,0,1,-1
DNK,Denmark,SUR,Suriname,2013,0,0,0
DNK,Denmark,SUR,Suriname,2014,0,0,0
DNK,Denmark,SUR,Suriname,2015,0,0,0
DNK,Denmark,SUR,Suriname,2016,0,0,0
DNK,Denmark,SUR,Suriname,2017,1,1,0
FIN,Finland,SUR,Suriname,2008,0,0,0
FIN,Finland,SUR,Suriname,2009,0,0,0
FIN,Finland,SUR,Suriname,2010,0,0,0
FIN,Finland,SUR,Suriname,2011,0,0,0
FIN,Finland,SUR,Suriname,2012,0,0,0
FIN,Finland,SUR,Suriname,2013,0,0,0
FIN,Finland,SUR,Suriname,2014,0,0,0
FIN,Finland,SUR,Suriname,2015,0,0,0
FIN,Finland,SUR,Suriname,2016,0,1,-1
FIN,Finland,SUR,Suriname,2017,0,0,0
FRA,France,SUR,Suriname,2008,0,531,-531
FRA,France,SUR,Suriname,2009,0,408,-408
FRA,France,SUR,Suriname,2010,0,598,-598
FRA,France,SUR,Suriname,2011,0,693,-693
FRA,France,SUR,Suriname,2012,0,736,-736
FRA,France,SUR,Suriname,2013,0,650,-650
FRA,France,SUR,Suriname,2014,0,649,-649
FRA,France,SUR,Suriname,2015,0,666,-666
FRA,France,SUR,Suriname,2016,0,390,-390
FRA,France,SUR,Suriname,2017,0,417,-417
DEU,Germany,SUR,Suriname,2008,5,10,-5
DEU,Germany,SUR,Suriname,2009,4,7,-3
DEU,Germany,SUR,Suriname,2010,9,8,1
DEU,Germany,SUR,Suriname,2011,4,3,1
DEU,Germany,SUR,Suriname,2012,5,10,-5
DEU,Germany,SUR,Suriname,2013,4,7,-3
DEU,Germany,SUR,Suriname,2014,4,6,-2
DEU,Germany,SUR,Suriname,2015,5,6,-1
DEU,Germany,SUR,Suriname,2016,4,10,-6
DEU,Germany,SUR,Suriname,2017,4,11,-7
HUN,Hungary,SUR,Suriname,2008,0,0,0
HUN,Hungary,SUR,Suriname,2009,0,0,0
HUN,Hungary,SUR,Suriname,2010,0,0,0
HUN,Hungary,SUR,Suriname,2011,0,0,0
HUN,Hungary,SUR,Suriname,2012,0,1,-1
HUN,Hungary,SUR,Suriname,2013,0,0,0
HUN,Hungary,SUR,Suriname,2014,0,0,0
HUN,Hungary,SUR,Suriname,2015,0,0,0
HUN,Hungary,SUR,Suriname,2016,0,0,0
HUN,Hungary,SUR,Suriname,2017,0,1,-1
ISL,Iceland,SUR,Suriname,2008,0,0,0
ISL,Iceland,SUR,Suriname,2009,0,0,0
ISL,Iceland,SUR,Suriname,2010,0,0,0
ISL,Iceland,SUR,Suriname,2011,0,0,0
ISL,Iceland,SUR,Suriname,2012,0,0,0
ISL,Iceland,SUR,Suriname,2016,0,1,-1
ISL,Iceland,SUR,Suriname,2017,1,1,0
ITA,Italy,SUR,Suriname,2008,0,2,-2
ITA,Italy,SUR,Suriname,2009,0,1,-1
ITA,Italy,SUR,Suriname,2010,0,0,0
ITA,Italy,SUR,Suriname,2011,0,2,-2
ITA,Italy,SUR,Suriname,2012,0,0,0
ITA,Italy,SUR,Suriname,2013,2,1,1
ITA,Italy,SUR,Suriname,2014,0,1,-1
ITA,Italy,SUR,Suriname,2015,0,2,-2
ITA,Italy,SUR,Suriname,2016,0,5,-5
ITA,Italy,SUR,Suriname,2017,0,1,-1
JPN,Japan,SUR,Suriname,2008,5,5,0
JPN,Japan,SUR,Suriname,2009,2,2,0
JPN,Japan,SUR,Suriname,2010,4,4,0
JPN,Japan,SUR,Suriname,2011,4,4,0
JPN,Japan,SUR,Suriname,2012,2,2,0
JPN,Japan,SUR,Suriname,2013,6,6,0
JPN,Japan,SUR,Suriname,2014,6,6,0
JPN,Japan,SUR,Suriname,2015,4,3,1
JPN,Japan,SUR,Suriname,2016,4,4,0
JPN,Japan,SUR,Suriname,2017,10,10,0
KOR,Korea,SUR,Suriname,2008,1,1,0
KOR,Korea,SUR,Suriname,2009,0,0,0
KOR,Korea,SUR,Suriname,2010,1,0,1
KOR,Korea,SUR,Suriname,2011,2,4,-2
KOR,Korea,SUR,Suriname,2012,4,2,2
KOR,Korea,SUR,Suriname,2013,0,0,0
KOR,Korea,SUR,Suriname,2014,1,2,-1
KOR,Korea,SUR,Suriname,2015,3,0,3
KOR,Korea,SUR,Suriname,2016,1,2,-1
KOR,Korea,SUR,Suriname,2017,1,2,-1
LUX,Luxembourg,SUR,Suriname,2008,0,0,0
LUX,Luxembourg,SUR,Suriname,2009,0,0,0
LUX,Luxembourg,SUR,Suriname,2010,0,0,0
LUX,Luxembourg,SUR,Suriname,2011,0,0,0
LUX,Luxembourg,SUR,Suriname,2012,0,0,0
LUX,Luxembourg,SUR,Suriname,2013,0,0,0
LUX,Luxembourg,SUR,Suriname,2014,0,0,0
LUX,Luxembourg,SUR,Suriname,2015,0,0,0
LUX,Luxembourg,SUR,Suriname,2016,0,0,0
LUX,Luxembourg,SUR,Suriname,2017,0,0,0
MEX,Mexico,SUR,Suriname,2008,0,1,-1
MEX,Mexico,SUR,Suriname,2009,0,1,-1
MEX,Mexico,SUR,Suriname,2010,0,1,-1
MEX,Mexico,SUR,Suriname,2011,0,3,-3
MEX,Mexico,SUR,Suriname,2012,0,0,0
MEX,Mexico,SUR,Suriname,2013,0,1,-1
MEX,Mexico,SUR,Suriname,2014,0,1,-1
MEX,Mexico,SUR,Suriname,2015,0,1,-1
MEX,Mexico,SUR,Suriname,2017,0,1,-1
NLD,Netherlands,SUR,Suriname,2008,296,1210,-914
NLD,Netherlands,SUR,Suriname,2009,203,1156,-953
NLD,Netherlands,SUR,Suriname,2010,227,1023,-796
NLD,Netherlands,SUR,Suriname,2011,232,967,-735
NLD,Netherlands,SUR,Suriname,2012,274,817,-543
NLD,Netherlands,SUR,Suriname,2013,255,673,-418
NLD,Netherlands,SUR,Suriname,2014,268,614,-346
NLD,Netherlands,SUR,Suriname,2015,167,578,-411
NLD,Netherlands,SUR,Suriname,2016,177,634,-457
NLD,Netherlands,SUR,Suriname,2017,163,846,-683
NZL,New Zealand,SUR,Suriname,2008,0,1,-1
NZL,New Zealand,SUR,Suriname,2010,0,1,-1
NZL,New Zealand,SUR,Suriname,2011,0,0,0
NZL,New Zealand,SUR,Suriname,2012,0,2,-2
NZL,New Zealand,SUR,Suriname,2014,0,1,-1
NOR,Norway,SUR,Suriname,2008,0,3,-3
NOR,Norway,SUR,Suriname,2009,2,1,1
NOR,Norway,SUR,Suriname,2010,0,0,0
NOR,Norway,SUR,Suriname,2011,0,1,-1
NOR,Norway,SUR,Suriname,2012,0,0,0
NOR,Norway,SUR,Suriname,2013,0,0,0
NOR,Norway,SUR,Suriname,2014,0,0,0
NOR,Norway,SUR,Suriname,2015,0,0,0
NOR,Norway,SUR,Suriname,2016,0,0,0
NOR,Norway,SUR,Suriname,2017,0,0,0
POL,Poland,SUR,Suriname,2009,0,0,0
POL,Poland,SUR,Suriname,2010,0,0,0
POL,Poland,SUR,Suriname,2011,0,0,0
POL,Poland,SUR,Suriname,2012,0,0,0
POL,Poland,SUR,Suriname,2013,0,0,0
POL,Poland,SUR,Suriname,2014,0,1,-1
POL,Poland,SUR,Suriname,2015,0,0,0
POL,Poland,SUR,Suriname,2016,0,3,-3
POL,Poland,SUR,Suriname,2017,0,7,-7
SVK,Slovak Republic,SUR,Suriname,2008,0,0,0
SVK,Slovak Republic,SUR,Suriname,2009,0,1,-1
ESP,Spain,SUR,Suriname,2008,3,10,-7
ESP,Spain,SUR,Suriname,2009,5,4,1
ESP,Spain,SUR,Suriname,2010,7,1,6
ESP,Spain,SUR,Suriname,2011,4,3,1
ESP,Spain,SUR,Suriname,2012,1,3,-2
ESP,Spain,SUR,Suriname,2013,1,3,-2
ESP,Spain,SUR,Suriname,2014,1,2,-1
ESP,Spain,SUR,Suriname,2015,0,4,-4
ESP,Spain,SUR,Suriname,2016,0,4,-4
ESP,Spain,SUR,Suriname,2017,1,2,-1
SWE,Sweden,SUR,Suriname,2008,0,0,0
SWE,Sweden,SUR,Suriname,2009,0,0,0
SWE,Sweden,SUR,Suriname,2010,0,0,0
SWE,Sweden,SUR,Suriname,2011,0,0,0
SWE,Sweden,SUR,Suriname,2012,0,1,-1
SWE,Sweden,SUR,Suriname,2013,0,0,0
SWE,Sweden,SUR,Suriname,2014,0,0,0
SWE,Sweden,SUR,Suriname,2015,0,2,-2
SWE,Sweden,SUR,Suriname,2016,0,0,0
SWE,Sweden,SUR,Suriname,2017,0,0,0
CHE,Switzerland,SUR,Suriname,2010,0,1,-1
CHE,Switzerland,SUR,Suriname,2011,0,3,-3
CHE,Switzerland,SUR,Suriname,2012,0,0,0
CHE,Switzerland,SUR,Suriname,2013,0,0,0
CHE,Switzerland,SUR,Suriname,2014,0,0,0
CHE,Switzerland,SUR,Suriname,2015,0,0,0
CHE,Switzerland,SUR,Suriname,2016,0,0,0
CHE,Switzerland,SUR,Suriname,2017,0,1,-1
USA,United States,SUR,Suriname,2008,0,218,-218
USA,United States,SUR,Suriname,2009,0,227,-227
USA,United States,SUR,Suriname,2010,0,216,-216
USA,United States,SUR,Suriname,2011,0,196,-196
USA,United States,SUR,Suriname,2012,0,187,-187
USA,United States,SUR,Suriname,2013,0,178,-178
USA,United States,SUR,Suriname,2014,0,158,-158
USA,United States,SUR,Suriname,2015,0,134,-134
USA,United States,SUR,Suriname,2016,0,156,-156
USA,United States,SUR,Suriname,2017,0,136,-136
CHL,Chile,SUR,Suriname,2008,0,0,0
CHL,Chile,SUR,Suriname,2009,0,0,0
CHL,Chile,SUR,Suriname,2010,0,1,-1
CHL,Chile,SUR,Suriname,2011,0,0,0
CHL,Chile,SUR,Suriname,2012,0,0,0
CHL,Chile,SUR,Suriname,2013,0,0,0
CHL,Chile,SUR,Suriname,2014,0,0,0
CHL,Chile,SUR,Suriname,2015,0,5,-5
CHL,Chile,SUR,Suriname,2016,0,4,-4
EST,Estonia,SUR,Suriname,2008,0,0,0
EST,Estonia,SUR,Suriname,2009,0,0,0
EST,Estonia,SUR,Suriname,2010,0,0,0
EST,Estonia,SUR,Suriname,2011,0,0,0
EST,Estonia,SUR,Suriname,2012,0,0,0
EST,Estonia,SUR,Suriname,2013,0,0,0
EST,Estonia,SUR,Suriname,2014,0,0,0
EST,Estonia,SUR,Suriname,2015,0,0,0
EST,Estonia,SUR,Suriname,2016,0,0,0
EST,Estonia,SUR,Suriname,2017,0,0,0
AUS,Australia,SWZ,Swaziland,2008,0,6,-6
AUS,Australia,SWZ,Swaziland,2009,5,13,-8
AUS,Australia,SWZ,Swaziland,2010,0,1,-1
AUS,Australia,SWZ,Swaziland,2011,0,1,-1
AUS,Australia,SWZ,Swaziland,2012,0,0,0
AUS,Australia,SWZ,Swaziland,2013,5,0,5
AUS,Australia,SWZ,Swaziland,2014,7,0,7
AUS,Australia,SWZ,Swaziland,2015,0,0,0
AUS,Australia,SWZ,Swaziland,2016,0,0,0
AUS,Australia,SWZ,Swaziland,2017,0,0,0
AUT,Austria,SWZ,Swaziland,2008,0,0,0
AUT,Austria,SWZ,Swaziland,2009,0,0,0
AUT,Austria,SWZ,Swaziland,2010,0,0,0
AUT,Austria,SWZ,Swaziland,2011,0,0,0
AUT,Austria,SWZ,Swaziland,2012,0,3,-3
AUT,Austria,SWZ,Swaziland,2013,0,0,0
AUT,Austria,SWZ,Swaziland,2014,0,4,-4
AUT,Austria,SWZ,Swaziland,2015,0,10,-10
AUT,Austria,SWZ,Swaziland,2016,0,1,-1
AUT,Austria,SWZ,Swaziland,2017,0,1,-1
BEL,Belgium,SWZ,Swaziland,2008,0,2,-2
BEL,Belgium,SWZ,Swaziland,2009,0,0,0
BEL,Belgium,SWZ,Swaziland,2010,3,4,-1
BEL,Belgium,SWZ,Swaziland,2012,0,3,-3
BEL,Belgium,SWZ,Swaziland,2013,1,1,0
BEL,Belgium,SWZ,Swaziland,2014,0,4,-4
BEL,Belgium,SWZ,Swaziland,2015,3,1,2
BEL,Belgium,SWZ,Swaziland,2016,2,1,1
CAN,Canada,SWZ,Swaziland,2008,0,6,-6
CAN,Canada,SWZ,Swaziland,2009,0,10,-10
CAN,Canada,SWZ,Swaziland,2010,0,3,-3
CAN,Canada,SWZ,Swaziland,2011,0,13,-13
CAN,Canada,SWZ,Swaziland,2012,0,17,-17
CAN,Canada,SWZ,Swaziland,2013,0,40,-40
CAN,Canada,SWZ,Swaziland,2014,0,38,-38
CAN,Canada,SWZ,Swaziland,2015,0,36,-36
CAN,Canada,SWZ,Swaziland,2016,0,15,-15
CAN,Canada,SWZ,Swaziland,2017,0,40,-40
DNK,Denmark,SWZ,Swaziland,2008,0,0,0
DNK,Denmark,SWZ,Swaziland,2009,0,1,-1
DNK,Denmark,SWZ,Swaziland,2010,3,2,1
DNK,Denmark,SWZ,Swaziland,2012,0,3,-3
DNK,Denmark,SWZ,Swaziland,2013,1,4,-3
DNK,Denmark,SWZ,Swaziland,2014,0,0,0
DNK,Denmark,SWZ,Swaziland,2015,3,3,0
DNK,Denmark,SWZ,Swaziland,2016,4,4,0
DNK,Denmark,SWZ,Swaziland,2017,5,1,4
FIN,Finland,SWZ,Swaziland,2008,0,0,0
FIN,Finland,SWZ,Swaziland,2009,0,0,0
FIN,Finland,SWZ,Swaziland,2010,0,0,0
FIN,Finland,SWZ,Swaziland,2011,0,2,-2
FIN,Finland,SWZ,Swaziland,2012,0,0,0
FIN,Finland,SWZ,Swaziland,2013,0,0,0
FIN,Finland,SWZ,Swaziland,2014,0,1,-1
FIN,Finland,SWZ,Swaziland,2015,0,0,0
FIN,Finland,SWZ,Swaziland,2016,0,0,0
FIN,Finland,SWZ,Swaziland,2017,2,2,0
FRA,France,SWZ,Swaziland,2008,0,0,0
FRA,France,SWZ,Swaziland,2009,0,1,-1
FRA,France,SWZ,Swaziland,2010,0,4,-4
FRA,France,SWZ,Swaziland,2011,0,1,-1
FRA,France,SWZ,Swaziland,2012,0,2,-2
FRA,France,SWZ,Swaziland,2013,0,0,0
FRA,France,SWZ,Swaziland,2014,0,0,0
FRA,France,SWZ,Swaziland,2015,0,0,0
FRA,France,SWZ,Swaziland,2016,0,1,-1
FRA,France,SWZ,Swaziland,2017,0,1,-1
DEU,Germany,SWZ,Swaziland,2008,7,3,4
DEU,Germany,SWZ,Swaziland,2009,0,2,-2
DEU,Germany,SWZ,Swaziland,2010,7,2,5
DEU,Germany,SWZ,Swaziland,2011,4,13,-9
DEU,Germany,SWZ,Swaziland,2012,7,11,-4
DEU,Germany,SWZ,Swaziland,2013,11,17,-6
DEU,Germany,SWZ,Swaziland,2014,5,7,-2
DEU,Germany,SWZ,Swaziland,2015,5,24,-19
DEU,Germany,SWZ,Swaziland,2016,8,6,2
DEU,Germany,SWZ,Swaziland,2017,4,6,-2
HUN,Hungary,SWZ,Swaziland,2008,0,0,0
HUN,Hungary,SWZ,Swaziland,2009,0,0,0
HUN,Hungary,SWZ,Swaziland,2010,0,0,0
HUN,Hungary,SWZ,Swaziland,2011,0,0,0
HUN,Hungary,SWZ,Swaziland,2012,0,0,0
HUN,Hungary,SWZ,Swaziland,2013,0,0,0
HUN,Hungary,SWZ,Swaziland,2014,0,0,0
HUN,Hungary,SWZ,Swaziland,2015,0,0,0
HUN,Hungary,SWZ,Swaziland,2016,0,0,0
HUN,Hungary,SWZ,Swaziland,2017,0,2,-2
ISL,Iceland,SWZ,Swaziland,2016,0,0,0
ISL,Iceland,SWZ,Swaziland,2017,0,0,0
ITA,Italy,SWZ,Swaziland,2008,0,1,-1
ITA,Italy,SWZ,Swaziland,2009,0,7,-7
ITA,Italy,SWZ,Swaziland,2010,0,2,-2
ITA,Italy,SWZ,Swaziland,2011,0,1,-1
ITA,Italy,SWZ,Swaziland,2012,0,1,-1
ITA,Italy,SWZ,Swaziland,2013,0,2,-2
ITA,Italy,SWZ,Swaziland,2014,1,2,-1
ITA,Italy,SWZ,Swaziland,2015,0,11,-11
ITA,Italy,SWZ,Swaziland,2016,0,1,-1
ITA,Italy,SWZ,Swaziland,2017,1,4,-3
JPN,Japan,SWZ,Swaziland,2008,93,93,0
JPN,Japan,SWZ,Swaziland,2009,24,23,1
JPN,Japan,SWZ,Swaziland,2010,35,36,-1
JPN,Japan,SWZ,Swaziland,2011,19,19,0
JPN,Japan,SWZ,Swaziland,2012,47,49,-2
JPN,Japan,SWZ,Swaziland,2013,202,201,1
JPN,Japan,SWZ,Swaziland,2014,31,33,-2
JPN,Japan,SWZ,Swaziland,2015,122,122,0
JPN,Japan,SWZ,Swaziland,2016,33,37,-4
JPN,Japan,SWZ,Swaziland,2017,37,34,3
KOR,Korea,SWZ,Swaziland,2008,1,0,1
KOR,Korea,SWZ,Swaziland,2009,1,0,1
KOR,Korea,SWZ,Swaziland,2010,0,2,-2
KOR,Korea,SWZ,Swaziland,2011,1,0,1
KOR,Korea,SWZ,Swaziland,2012,0,4,-4
KOR,Korea,SWZ,Swaziland,2013,3,5,-2
KOR,Korea,SWZ,Swaziland,2014,1,3,-2
KOR,Korea,SWZ,Swaziland,2015,3,0,3
KOR,Korea,SWZ,Swaziland,2016,6,2,4
KOR,Korea,SWZ,Swaziland,2017,1,3,-2
LUX,Luxembourg,SWZ,Swaziland,2008,0,0,0
LUX,Luxembourg,SWZ,Swaziland,2009,0,0,0
LUX,Luxembourg,SWZ,Swaziland,2010,0,0,0
LUX,Luxembourg,SWZ,Swaziland,2011,0,0,0
LUX,Luxembourg,SWZ,Swaziland,2012,0,0,0
LUX,Luxembourg,SWZ,Swaziland,2013,0,0,0
LUX,Luxembourg,SWZ,Swaziland,2014,0,0,0
LUX,Luxembourg,SWZ,Swaziland,2015,0,0,0
LUX,Luxembourg,SWZ,Swaziland,2016,0,0,0
LUX,Luxembourg,SWZ,Swaziland,2017,0,0,0
MEX,Mexico,SWZ,Swaziland,2008,0,1,-1
MEX,Mexico,SWZ,Swaziland,2012,0,0,0
MEX,Mexico,SWZ,Swaziland,2013,0,0,0
MEX,Mexico,SWZ,Swaziland,2014,0,0,0
NLD,Netherlands,SWZ,Swaziland,2008,4,0,4
NLD,Netherlands,SWZ,Swaziland,2009,2,1,1
NLD,Netherlands,SWZ,Swaziland,2010,1,1,0
NLD,Netherlands,SWZ,Swaziland,2011,0,4,-4
NLD,Netherlands,SWZ,Swaziland,2013,2,6,-4
NLD,Netherlands,SWZ,Swaziland,2015,4,5,-1
NLD,Netherlands,SWZ,Swaziland,2016,2,5,-3
NLD,Netherlands,SWZ,Swaziland,2017,3,3,0
NZL,New Zealand,SWZ,Swaziland,2010,0,1,-1
NZL,New Zealand,SWZ,Swaziland,2012,0,0,0
NZL,New Zealand,SWZ,Swaziland,2015,0,1,-1
NZL,New Zealand,SWZ,Swaziland,2016,0,1,-1
NZL,New Zealand,SWZ,Swaziland,2017,1,2,-1
NOR,Norway,SWZ,Swaziland,2008,0,0,0
NOR,Norway,SWZ,Swaziland,2009,0,1,-1
NOR,Norway,SWZ,Swaziland,2010,0,0,0
NOR,Norway,SWZ,Swaziland,2011,2,3,-1
NOR,Norway,SWZ,Swaziland,2012,0,1,-1
NOR,Norway,SWZ,Swaziland,2013,3,1,2
NOR,Norway,SWZ,Swaziland,2014,1,1,0
NOR,Norway,SWZ,Swaziland,2015,1,1,0
NOR,Norway,SWZ,Swaziland,2016,1,3,-2
NOR,Norway,SWZ,Swaziland,2017,1,2,-1
POL,Poland,SWZ,Swaziland,2009,0,0,0
POL,Poland,SWZ,Swaziland,2010,0,0,0
POL,Poland,SWZ,Swaziland,2011,0,0,0
POL,Poland,SWZ,Swaziland,2012,0,0,0
POL,Poland,SWZ,Swaziland,2013,0,0,0
POL,Poland,SWZ,Swaziland,2014,0,0,0
POL,Poland,SWZ,Swaziland,2015,0,0,0
POL,Poland,SWZ,Swaziland,2016,0,1,-1
POL,Poland,SWZ,Swaziland,2017,0,0,0
SVK,Slovak Republic,SWZ,Swaziland,2008,0,0,0
ESP,Spain,SWZ,Swaziland,2008,0,0,0
ESP,Spain,SWZ,Swaziland,2009,0,0,0
ESP,Spain,SWZ,Swaziland,2010,0,0,0
ESP,Spain,SWZ,Swaziland,2011,0,0,0
ESP,Spain,SWZ,Swaziland,2012,0,0,0
ESP,Spain,SWZ,Swaziland,2013,0,1,-1
ESP,Spain,SWZ,Swaziland,2014,0,0,0
ESP,Spain,SWZ,Swaziland,2015,0,2,-2
ESP,Spain,SWZ,Swaziland,2016,0,0,0
ESP,Spain,SWZ,Swaziland,2017,1,3,-2
SWE,Sweden,SWZ,Swaziland,2008,1,0,1
SWE,Sweden,SWZ,Swaziland,2009,0,0,0
SWE,Sweden,SWZ,Swaziland,2010,0,4,-4
SWE,Sweden,SWZ,Swaziland,2011,0,1,-1
SWE,Sweden,SWZ,Swaziland,2012,0,2,-2
SWE,Sweden,SWZ,Swaziland,2013,0,1,-1
SWE,Sweden,SWZ,Swaziland,2014,0,0,0
SWE,Sweden,SWZ,Swaziland,2015,0,3,-3
SWE,Sweden,SWZ,Swaziland,2016,0,2,-2
SWE,Sweden,SWZ,Swaziland,2017,1,1,0
CHE,Switzerland,SWZ,Swaziland,2010,0,0,0
CHE,Switzerland,SWZ,Swaziland,2011,0,0,0
CHE,Switzerland,SWZ,Swaziland,2012,0,0,0
CHE,Switzerland,SWZ,Swaziland,2013,1,2,-1
CHE,Switzerland,SWZ,Swaziland,2014,0,1,-1
CHE,Switzerland,SWZ,Swaziland,2015,0,0,0
CHE,Switzerland,SWZ,Swaziland,2016,0,2,-2
CHE,Switzerland,SWZ,Swaziland,2017,1,1,0
TUR,Turkey,SWZ,Swaziland,2010,0,1,-1
USA,United States,SWZ,Swaziland,2008,0,18,-18
USA,United States,SWZ,Swaziland,2009,0,42,-42
USA,United States,SWZ,Swaziland,2010,0,22,-22
USA,United States,SWZ,Swaziland,2011,0,19,-19
USA,United States,SWZ,Swaziland,2012,0,24,-24
USA,United States,SWZ,Swaziland,2013,0,15,-15
USA,United States,SWZ,Swaziland,2014,0,23,-23
USA,United States,SWZ,Swaziland,2015,0,19,-19
USA,United States,SWZ,Swaziland,2016,0,20,-20
USA,United States,SWZ,Swaziland,2017,0,19,-19
CHL,Chile,SWZ,Swaziland,2008,0,0,0
CHL,Chile,SWZ,Swaziland,2009,0,0,0
CHL,Chile,SWZ,Swaziland,2010,0,0,0
CHL,Chile,SWZ,Swaziland,2011,0,1,-1
CHL,Chile,SWZ,Swaziland,2012,0,0,0
CHL,Chile,SWZ,Swaziland,2013,0,0,0
CHL,Chile,SWZ,Swaziland,2014,0,0,0
CHL,Chile,SWZ,Swaziland,2015,0,0,0
CHL,Chile,SWZ,Swaziland,2016,0,0,0
EST,Estonia,SWZ,Swaziland,2008,0,1,-1
EST,Estonia,SWZ,Swaziland,2009,0,0,0
EST,Estonia,SWZ,Swaziland,2010,0,0,0
EST,Estonia,SWZ,Swaziland,2011,0,0,0
EST,Estonia,SWZ,Swaziland,2012,0,0,0
EST,Estonia,SWZ,Swaziland,2013,0,0,0
EST,Estonia,SWZ,Swaziland,2014,0,0,0
EST,Estonia,SWZ,Swaziland,2015,0,0,0
EST,Estonia,SWZ,Swaziland,2016,0,0,0
EST,Estonia,SWZ,Swaziland,2017,0,0,0
AUS,Australia,CHE,Switzerland,2008,0,283,-283
AUS,Australia,CHE,Switzerland,2009,0,275,-275
CAN,Canada,CHE,Switzerland,2008,0,357,-357
CAN,Canada,CHE,Switzerland,2009,0,328,-328
JPN,Japan,CHE,Switzerland,2008,0,665,-665
JPN,Japan,CHE,Switzerland,2009,0,444,-444
KOR,Korea,CHE,Switzerland,2008,0,62,-62
KOR,Korea,CHE,Switzerland,2009,0,85,-85
MEX,Mexico,CHE,Switzerland,2008,0,68,-68
MEX,Mexico,CHE,Switzerland,2009,0,93,-93
NZL,New Zealand,CHE,Switzerland,2008,0,137,-137
NZL,New Zealand,CHE,Switzerland,2009,0,126,-126
USA,United States,CHE,Switzerland,2008,0,720,-720
USA,United States,CHE,Switzerland,2009,0,798,-798
CHL,Chile,CHE,Switzerland,2008,0,60,-60
CHL,Chile,CHE,Switzerland,2009,0,84,-84
ISR,Israel,CHE,Switzerland,2008,0,60,-60
ISR,Israel,CHE,Switzerland,2009,0,79,-79
AUS,Australia,SYR,Syria,2008,100,228,-128
AUS,Australia,SYR,Syria,2009,95,250,-155
AUS,Australia,SYR,Syria,2010,81,179,-98
AUS,Australia,SYR,Syria,2011,72,235,-163
AUS,Australia,SYR,Syria,2012,53,261,-208
AUS,Australia,SYR,Syria,2013,46,209,-163
AUS,Australia,SYR,Syria,2014,63,967,-904
AUS,Australia,SYR,Syria,2015,100,2568,-2468
AUS,Australia,SYR,Syria,2016,100,2233,-2133
AUS,Australia,SYR,Syria,2017,0,8657,-8657
AUT,Austria,SYR,Syria,2008,73,186,-113
AUT,Austria,SYR,Syria,2009,93,300,-207
AUT,Austria,SYR,Syria,2010,82,231,-149
AUT,Austria,SYR,Syria,2011,74,441,-367
AUT,Austria,SYR,Syria,2012,113,903,-790
AUT,Austria,SYR,Syria,2013,119,1734,-1615
AUT,Austria,SYR,Syria,2014,272,7400,-7128
AUT,Austria,SYR,Syria,2015,707,22610,-21903
AUT,Austria,SYR,Syria,2016,1201,9040,-7839
AUT,Austria,SYR,Syria,2017,849,6691,-5842
BEL,Belgium,SYR,Syria,2008,0,160,-160
BEL,Belgium,SYR,Syria,2009,0,204,-204
BEL,Belgium,SYR,Syria,2010,37,230,-193
BEL,Belgium,SYR,Syria,2011,0,186,-186
BEL,Belgium,SYR,Syria,2012,33,902,-869
BEL,Belgium,SYR,Syria,2013,78,1045,-967
BEL,Belgium,SYR,Syria,2014,104,2780,-2676
BEL,Belgium,SYR,Syria,2015,153,10362,-10209
BEL,Belgium,SYR,Syria,2016,134,4422,-4288
BEL,Belgium,SYR,Syria,2017,236,5401,-5165
CAN,Canada,SYR,Syria,2008,0,919,-919
CAN,Canada,SYR,Syria,2009,0,917,-917
CAN,Canada,SYR,Syria,2010,0,1040,-1040
CAN,Canada,SYR,Syria,2011,0,1005,-1005
CAN,Canada,SYR,Syria,2012,0,649,-649
CAN,Canada,SYR,Syria,2013,0,1008,-1008
CAN,Canada,SYR,Syria,2014,0,2051,-2051
CAN,Canada,SYR,Syria,2015,0,9854,-9854
CAN,Canada,SYR,Syria,2016,0,34925,-34925
CAN,Canada,SYR,Syria,2017,0,12045,-12045
CZE,Czech Republic,SYR,Syria,2008,1,41,-40
CZE,Czech Republic,SYR,Syria,2009,0,48,-48
CZE,Czech Republic,SYR,Syria,2010,1,55,-54
CZE,Czech Republic,SYR,Syria,2011,0,55,-55
CZE,Czech Republic,SYR,Syria,2012,27,95,-68
CZE,Czech Republic,SYR,Syria,2013,47,177,-130
CZE,Czech Republic,SYR,Syria,2014,62,144,-82
CZE,Czech Republic,SYR,Syria,2015,76,236,-160
CZE,Czech Republic,SYR,Syria,2016,63,187,-124
CZE,Czech Republic,SYR,Syria,2017,67,151,-84
DNK,Denmark,SYR,Syria,2008,8,89,-81
DNK,Denmark,SYR,Syria,2009,7,177,-170
DNK,Denmark,SYR,Syria,2010,19,400,-381
DNK,Denmark,SYR,Syria,2011,16,558,-542
DNK,Denmark,SYR,Syria,2012,8,935,-927
DNK,Denmark,SYR,Syria,2013,11,1601,-1590
DNK,Denmark,SYR,Syria,2014,30,5351,-5321
DNK,Denmark,SYR,Syria,2015,96,11403,-11307
DNK,Denmark,SYR,Syria,2016,264,8827,-8563
DNK,Denmark,SYR,Syria,2017,711,2336,-1625
FIN,Finland,SYR,Syria,2008,4,26,-22
FIN,Finland,SYR,Syria,2009,3,13,-10
FIN,Finland,SYR,Syria,2010,2,21,-19
FIN,Finland,SYR,Syria,2011,1,46,-45
FIN,Finland,SYR,Syria,2012,2,150,-148
FIN,Finland,SYR,Syria,2013,0,173,-173
FIN,Finland,SYR,Syria,2014,2,570,-568
FIN,Finland,SYR,Syria,2015,0,578,-578
FIN,Finland,SYR,Syria,2016,5,1716,-1711
FIN,Finland,SYR,Syria,2017,3,1958,-1955
FRA,France,SYR,Syria,2008,0,392,-392
FRA,France,SYR,Syria,2009,0,403,-403
FRA,France,SYR,Syria,2010,0,355,-355
FRA,France,SYR,Syria,2011,0,472,-472
FRA,France,SYR,Syria,2012,0,764,-764
FRA,France,SYR,Syria,2013,0,1239,-1239
FRA,France,SYR,Syria,2014,0,1715,-1715
FRA,France,SYR,Syria,2015,0,2362,-2362
FRA,France,SYR,Syria,2016,0,3525,-3525
FRA,France,SYR,Syria,2017,0,4168,-4168
DEU,Germany,SYR,Syria,2008,1180,1969,-789
DEU,Germany,SYR,Syria,2009,1417,2338,-921
DEU,Germany,SYR,Syria,2010,1214,2983,-1769
DEU,Germany,SYR,Syria,2011,1060,4560,-3500
DEU,Germany,SYR,Syria,2012,1244,8530,-7286
DEU,Germany,SYR,Syria,2013,1960,19017,-17057
DEU,Germany,SYR,Syria,2014,3153,69074,-65921
DEU,Germany,SYR,Syria,2015,11216,309699,-298483
DEU,Germany,SYR,Syria,2016,33612,179435,-145823
DEU,Germany,SYR,Syria,2017,16456,76391,-59935
HUN,Hungary,SYR,Syria,2008,9,72,-63
HUN,Hungary,SYR,Syria,2009,13,73,-60
HUN,Hungary,SYR,Syria,2010,10,39,-29
HUN,Hungary,SYR,Syria,2011,17,72,-55
HUN,Hungary,SYR,Syria,2012,8,96,-88
HUN,Hungary,SYR,Syria,2013,19,120,-101
HUN,Hungary,SYR,Syria,2014,19,265,-246
HUN,Hungary,SYR,Syria,2015,12,280,-268
HUN,Hungary,SYR,Syria,2016,33,236,-203
HUN,Hungary,SYR,Syria,2017,28,580,-552
ISL,Iceland,SYR,Syria,2008,0,0,0
ISL,Iceland,SYR,Syria,2009,1,0,1
ISL,Iceland,SYR,Syria,2010,3,0,3
ISL,Iceland,SYR,Syria,2011,1,2,-1
ISL,Iceland,SYR,Syria,2012,0,3,-3
ISL,Iceland,SYR,Syria,2013,1,13,-12
ISL,Iceland,SYR,Syria,2014,0,3,-3
ISL,Iceland,SYR,Syria,2015,0,21,-21
ISL,Iceland,SYR,Syria,2016,0,94,-94
ISL,Iceland,SYR,Syria,2017,0,69,-69
ITA,Italy,SYR,Syria,2008,11,300,-289
ITA,Italy,SYR,Syria,2009,13,271,-258
ITA,Italy,SYR,Syria,2010,27,350,-323
ITA,Italy,SYR,Syria,2011,39,331,-292
ITA,Italy,SYR,Syria,2012,21,452,-431
ITA,Italy,SYR,Syria,2013,52,586,-534
ITA,Italy,SYR,Syria,2014,56,570,-514
ITA,Italy,SYR,Syria,2015,49,429,-380
ITA,Italy,SYR,Syria,2016,0,772,-772
ITA,Italy,SYR,Syria,2017,63,1300,-1237
JPN,Japan,SYR,Syria,2008,118,121,-3
JPN,Japan,SYR,Syria,2009,120,135,-15
JPN,Japan,SYR,Syria,2010,134,168,-34
JPN,Japan,SYR,Syria,2011,93,115,-22
JPN,Japan,SYR,Syria,2012,57,98,-41
JPN,Japan,SYR,Syria,2013,10,32,-22
JPN,Japan,SYR,Syria,2014,12,38,-26
JPN,Japan,SYR,Syria,2015,16,56,-40
JPN,Japan,SYR,Syria,2016,19,53,-34
JPN,Japan,SYR,Syria,2017,25,103,-78
KOR,Korea,SYR,Syria,2008,62,24,38
KOR,Korea,SYR,Syria,2009,30,30,0
KOR,Korea,SYR,Syria,2010,60,62,-2
KOR,Korea,SYR,Syria,2011,109,188,-79
KOR,Korea,SYR,Syria,2012,235,368,-133
KOR,Korea,SYR,Syria,2013,154,323,-169
KOR,Korea,SYR,Syria,2014,107,186,-79
KOR,Korea,SYR,Syria,2015,122,462,-340
KOR,Korea,SYR,Syria,2016,98,224,-126
KOR,Korea,SYR,Syria,2017,135,188,-53
LUX,Luxembourg,SYR,Syria,2008,0,0,0
LUX,Luxembourg,SYR,Syria,2009,6,3,3
LUX,Luxembourg,SYR,Syria,2010,0,0,0
LUX,Luxembourg,SYR,Syria,2011,7,10,-3
LUX,Luxembourg,SYR,Syria,2012,7,9,-2
LUX,Luxembourg,SYR,Syria,2013,5,19,-14
LUX,Luxembourg,SYR,Syria,2014,7,112,-105
LUX,Luxembourg,SYR,Syria,2015,10,682,-672
LUX,Luxembourg,SYR,Syria,2016,32,371,-339
LUX,Luxembourg,SYR,Syria,2017,10,529,-519
MEX,Mexico,SYR,Syria,2008,0,8,-8
MEX,Mexico,SYR,Syria,2009,0,8,-8
MEX,Mexico,SYR,Syria,2010,0,5,-5
MEX,Mexico,SYR,Syria,2011,0,11,-11
MEX,Mexico,SYR,Syria,2012,0,5,-5
MEX,Mexico,SYR,Syria,2013,0,19,-19
MEX,Mexico,SYR,Syria,2014,0,15,-15
MEX,Mexico,SYR,Syria,2015,0,9,-9
MEX,Mexico,SYR,Syria,2016,0,18,-18
MEX,Mexico,SYR,Syria,2017,0,13,-13
NLD,Netherlands,SYR,Syria,2008,4,65,-61
NLD,Netherlands,SYR,Syria,2009,24,80,-56
NLD,Netherlands,SYR,Syria,2010,17,101,-84
NLD,Netherlands,SYR,Syria,2011,16,90,-74
NLD,Netherlands,SYR,Syria,2012,21,134,-113
NLD,Netherlands,SYR,Syria,2013,4,576,-572
NLD,Netherlands,SYR,Syria,2014,42,6860,-6818
NLD,Netherlands,SYR,Syria,2015,198,17273,-17075
NLD,Netherlands,SYR,Syria,2016,346,25130,-24784
NLD,Netherlands,SYR,Syria,2017,644,15319,-14675
NZL,New Zealand,SYR,Syria,2008,1,12,-11
NZL,New Zealand,SYR,Syria,2009,0,17,-17
NZL,New Zealand,SYR,Syria,2010,3,10,-7
NZL,New Zealand,SYR,Syria,2011,1,18,-17
NZL,New Zealand,SYR,Syria,2012,0,21,-21
NZL,New Zealand,SYR,Syria,2013,1,19,-18
NZL,New Zealand,SYR,Syria,2014,1,56,-55
NZL,New Zealand,SYR,Syria,2015,0,76,-76
NZL,New Zealand,SYR,Syria,2016,1,438,-437
NZL,New Zealand,SYR,Syria,2017,0,358,-358
NOR,Norway,SYR,Syria,2008,4,85,-81
NOR,Norway,SYR,Syria,2009,7,55,-48
NOR,Norway,SYR,Syria,2010,11,70,-59
NOR,Norway,SYR,Syria,2011,11,67,-56
NOR,Norway,SYR,Syria,2012,8,368,-360
NOR,Norway,SYR,Syria,2013,11,841,-830
NOR,Norway,SYR,Syria,2014,13,2131,-2118
NOR,Norway,SYR,Syria,2015,24,4010,-3986
NOR,Norway,SYR,Syria,2016,24,11208,-11184
NOR,Norway,SYR,Syria,2017,88,6962,-6874
POL,Poland,SYR,Syria,2008,0,178,-178
POL,Poland,SYR,Syria,2009,0,168,-168
POL,Poland,SYR,Syria,2010,0,186,-186
POL,Poland,SYR,Syria,2011,0,160,-160
POL,Poland,SYR,Syria,2012,0,255,-255
POL,Poland,SYR,Syria,2013,0,300,-300
POL,Poland,SYR,Syria,2014,0,112,-112
POL,Poland,SYR,Syria,2015,0,275,-275
POL,Poland,SYR,Syria,2016,0,282,-282
POL,Poland,SYR,Syria,2017,0,279,-279
SVK,Slovak Republic,SYR,Syria,2008,8,4,4
SVK,Slovak Republic,SYR,Syria,2009,8,2,6
SVK,Slovak Republic,SYR,Syria,2010,9,4,5
SVK,Slovak Republic,SYR,Syria,2011,1,7,-6
SVK,Slovak Republic,SYR,Syria,2012,1,4,-3
SVK,Slovak Republic,SYR,Syria,2013,0,7,-7
SVK,Slovak Republic,SYR,Syria,2014,0,1,-1
SVK,Slovak Republic,SYR,Syria,2015,0,7,-7
SVK,Slovak Republic,SYR,Syria,2017,0,2,-2
ESP,Spain,SYR,Syria,2008,147,261,-114
ESP,Spain,SYR,Syria,2009,201,218,-17
ESP,Spain,SYR,Syria,2010,171,236,-65
ESP,Spain,SYR,Syria,2011,168,267,-99
ESP,Spain,SYR,Syria,2012,136,447,-311
ESP,Spain,SYR,Syria,2013,212,759,-547
ESP,Spain,SYR,Syria,2014,216,773,-557
ESP,Spain,SYR,Syria,2015,230,672,-442
ESP,Spain,SYR,Syria,2016,248,1178,-930
ESP,Spain,SYR,Syria,2017,257,1452,-1195
SWE,Sweden,SYR,Syria,2008,23,531,-508
SWE,Sweden,SYR,Syria,2009,8,747,-739
SWE,Sweden,SYR,Syria,2010,22,1047,-1025
SWE,Sweden,SYR,Syria,2011,40,1537,-1497
SWE,Sweden,SYR,Syria,2012,50,4730,-4680
SWE,Sweden,SYR,Syria,2013,47,11749,-11702
SWE,Sweden,SYR,Syria,2014,124,21674,-21550
SWE,Sweden,SYR,Syria,2015,123,28011,-27888
SWE,Sweden,SYR,Syria,2016,165,48973,-48808
SWE,Sweden,SYR,Syria,2017,228,20947,-20719
CHE,Switzerland,SYR,Syria,2010,37,149,-112
CHE,Switzerland,SYR,Syria,2011,26,233,-207
CHE,Switzerland,SYR,Syria,2012,21,290,-269
CHE,Switzerland,SYR,Syria,2013,24,280,-256
CHE,Switzerland,SYR,Syria,2014,25,1114,-1089
CHE,Switzerland,SYR,Syria,2015,19,1800,-1781
CHE,Switzerland,SYR,Syria,2016,19,1791,-1772
CHE,Switzerland,SYR,Syria,2017,28,1683,-1655
TUR,Turkey,SYR,Syria,2010,0,881,-881
TUR,Turkey,SYR,Syria,2016,7224,25689,-18465
TUR,Turkey,SYR,Syria,2017,9382,28189,-18807
GBR,United Kingdom,SYR,Syria,2014,0,1000,-1000
GBR,United Kingdom,SYR,Syria,2015,0,1000,-1000
USA,United States,SYR,Syria,2008,0,2641,-2641
USA,United States,SYR,Syria,2009,0,2442,-2442
USA,United States,SYR,Syria,2010,0,2555,-2555
USA,United States,SYR,Syria,2011,0,2785,-2785
USA,United States,SYR,Syria,2012,0,3014,-3014
USA,United States,SYR,Syria,2013,0,3366,-3366
USA,United States,SYR,Syria,2014,0,3540,-3540
USA,United States,SYR,Syria,2015,0,3840,-3840
USA,United States,SYR,Syria,2016,0,4800,-4800
USA,United States,SYR,Syria,2017,0,5877,-5877
CHL,Chile,SYR,Syria,2008,0,7,-7
CHL,Chile,SYR,Syria,2009,0,9,-9
CHL,Chile,SYR,Syria,2010,0,8,-8
CHL,Chile,SYR,Syria,2011,0,6,-6
CHL,Chile,SYR,Syria,2012,0,22,-22
CHL,Chile,SYR,Syria,2013,0,27,-27
CHL,Chile,SYR,Syria,2014,0,22,-22
CHL,Chile,SYR,Syria,2015,0,30,-30
CHL,Chile,SYR,Syria,2016,0,83,-83
EST,Estonia,SYR,Syria,2008,0,0,0
EST,Estonia,SYR,Syria,2009,0,0,0
EST,Estonia,SYR,Syria,2010,0,0,0
EST,Estonia,SYR,Syria,2011,0,2,-2
EST,Estonia,SYR,Syria,2012,0,1,-1
EST,Estonia,SYR,Syria,2013,0,0,0
EST,Estonia,SYR,Syria,2014,0,0,0
EST,Estonia,SYR,Syria,2015,0,12,-12
EST,Estonia,SYR,Syria,2016,0,62,-62
EST,Estonia,SYR,Syria,2017,0,79,-79
SVN,Slovenia,SYR,Syria,2008,0,3,-3
SVN,Slovenia,SYR,Syria,2009,0,2,-2
SVN,Slovenia,SYR,Syria,2010,0,1,-1
SVN,Slovenia,SYR,Syria,2011,0,7,-7
SVN,Slovenia,SYR,Syria,2012,0,2,-2
SVN,Slovenia,SYR,Syria,2013,0,2,-2
SVN,Slovenia,SYR,Syria,2014,0,2,-2
SVN,Slovenia,SYR,Syria,2015,0,3,-3
SVN,Slovenia,SYR,Syria,2016,1,11,-10
SVN,Slovenia,SYR,Syria,2017,1,9,-8
AUS,Australia,TWN,Chinese Taipei,2008,884,1031,-147
AUS,Australia,TWN,Chinese Taipei,2009,726,804,-78
AUS,Australia,TWN,Chinese Taipei,2010,778,823,-45
AUS,Australia,TWN,Chinese Taipei,2011,735,782,-47
AUS,Australia,TWN,Chinese Taipei,2012,584,783,-199
AUS,Australia,TWN,Chinese Taipei,2013,591,974,-383
AUS,Australia,TWN,Chinese Taipei,2014,529,948,-419
AUS,Australia,TWN,Chinese Taipei,2015,500,972,-472
AUS,Australia,TWN,Chinese Taipei,2016,400,1121,-721
AUS,Australia,TWN,Chinese Taipei,2017,0,1235,-1235
AUT,Austria,TWN,Chinese Taipei,2014,0,0,0
AUT,Austria,TWN,Chinese Taipei,2015,0,0,0
AUT,Austria,TWN,Chinese Taipei,2016,0,0,0
AUT,Austria,TWN,Chinese Taipei,2017,0,0,0
BEL,Belgium,TWN,Chinese Taipei,2008,0,101,-101
BEL,Belgium,TWN,Chinese Taipei,2009,0,73,-73
BEL,Belgium,TWN,Chinese Taipei,2010,85,94,-9
BEL,Belgium,TWN,Chinese Taipei,2011,0,109,-109
BEL,Belgium,TWN,Chinese Taipei,2012,82,110,-28
BEL,Belgium,TWN,Chinese Taipei,2013,104,208,-104
BEL,Belgium,TWN,Chinese Taipei,2014,80,131,-51
BEL,Belgium,TWN,Chinese Taipei,2015,80,98,-18
BEL,Belgium,TWN,Chinese Taipei,2016,95,139,-44
BEL,Belgium,TWN,Chinese Taipei,2017,75,157,-82
CAN,Canada,TWN,Chinese Taipei,2008,0,2993,-2993
CAN,Canada,TWN,Chinese Taipei,2009,0,2472,-2472
CAN,Canada,TWN,Chinese Taipei,2010,0,2629,-2629
CAN,Canada,TWN,Chinese Taipei,2011,0,1703,-1703
CAN,Canada,TWN,Chinese Taipei,2012,0,985,-985
CAN,Canada,TWN,Chinese Taipei,2013,0,768,-768
CAN,Canada,TWN,Chinese Taipei,2014,0,692,-692
CAN,Canada,TWN,Chinese Taipei,2015,0,617,-617
CAN,Canada,TWN,Chinese Taipei,2016,0,790,-790
CAN,Canada,TWN,Chinese Taipei,2017,0,795,-795
DNK,Denmark,TWN,Chinese Taipei,2010,24,23,1
DNK,Denmark,TWN,Chinese Taipei,2011,15,27,-12
DNK,Denmark,TWN,Chinese Taipei,2012,22,29,-7
DNK,Denmark,TWN,Chinese Taipei,2013,34,28,6
DNK,Denmark,TWN,Chinese Taipei,2014,43,33,10
DNK,Denmark,TWN,Chinese Taipei,2015,42,36,6
DNK,Denmark,TWN,Chinese Taipei,2016,63,37,26
DNK,Denmark,TWN,Chinese Taipei,2017,55,59,-4
FIN,Finland,TWN,Chinese Taipei,2008,0,0,0
FIN,Finland,TWN,Chinese Taipei,2009,0,0,0
FIN,Finland,TWN,Chinese Taipei,2010,0,0,0
FIN,Finland,TWN,Chinese Taipei,2011,0,0,0
FIN,Finland,TWN,Chinese Taipei,2012,0,0,0
FIN,Finland,TWN,Chinese Taipei,2013,0,0,0
FIN,Finland,TWN,Chinese Taipei,2014,0,0,0
FIN,Finland,TWN,Chinese Taipei,2015,0,0,0
FIN,Finland,TWN,Chinese Taipei,2016,0,0,0
FIN,Finland,TWN,Chinese Taipei,2017,0,0,0
FRA,France,TWN,Chinese Taipei,2008,0,99,-99
FRA,France,TWN,Chinese Taipei,2009,0,126,-126
FRA,France,TWN,Chinese Taipei,2010,0,134,-134
FRA,France,TWN,Chinese Taipei,2011,0,165,-165
FRA,France,TWN,Chinese Taipei,2012,0,168,-168
FRA,France,TWN,Chinese Taipei,2013,0,180,-180
FRA,France,TWN,Chinese Taipei,2014,0,216,-216
FRA,France,TWN,Chinese Taipei,2015,0,174,-174
FRA,France,TWN,Chinese Taipei,2016,0,187,-187
FRA,France,TWN,Chinese Taipei,2017,0,149,-149
DEU,Germany,TWN,Chinese Taipei,2016,1374,1662,-288
DEU,Germany,TWN,Chinese Taipei,2017,1242,1878,-636
HUN,Hungary,TWN,Chinese Taipei,2008,0,0,0
HUN,Hungary,TWN,Chinese Taipei,2009,0,0,0
HUN,Hungary,TWN,Chinese Taipei,2010,24,65,-41
HUN,Hungary,TWN,Chinese Taipei,2011,5,47,-42
HUN,Hungary,TWN,Chinese Taipei,2012,3,44,-41
HUN,Hungary,TWN,Chinese Taipei,2013,8,31,-23
HUN,Hungary,TWN,Chinese Taipei,2014,11,51,-40
HUN,Hungary,TWN,Chinese Taipei,2015,11,109,-98
HUN,Hungary,TWN,Chinese Taipei,2016,18,91,-73
HUN,Hungary,TWN,Chinese Taipei,2017,0,85,-85
ISL,Iceland,TWN,Chinese Taipei,2008,1,1,0
ISL,Iceland,TWN,Chinese Taipei,2009,1,4,-3
ISL,Iceland,TWN,Chinese Taipei,2010,4,4,0
ISL,Iceland,TWN,Chinese Taipei,2011,3,0,3
ISL,Iceland,TWN,Chinese Taipei,2012,0,0,0
ISL,Iceland,TWN,Chinese Taipei,2013,1,1,0
ISL,Iceland,TWN,Chinese Taipei,2014,0,0,0
ISL,Iceland,TWN,Chinese Taipei,2015,2,1,1
ISL,Iceland,TWN,Chinese Taipei,2016,0,0,0
ISL,Iceland,TWN,Chinese Taipei,2017,0,0,0
ITA,Italy,TWN,Chinese Taipei,2008,32,39,-7
ITA,Italy,TWN,Chinese Taipei,2009,37,41,-4
ITA,Italy,TWN,Chinese Taipei,2010,5,40,-35
ITA,Italy,TWN,Chinese Taipei,2011,14,64,-50
ITA,Italy,TWN,Chinese Taipei,2012,14,79,-65
ITA,Italy,TWN,Chinese Taipei,2013,21,123,-102
ITA,Italy,TWN,Chinese Taipei,2014,11,60,-49
ITA,Italy,TWN,Chinese Taipei,2015,8,85,-77
ITA,Italy,TWN,Chinese Taipei,2016,0,60,-60
ITA,Italy,TWN,Chinese Taipei,2017,18,73,-55
JPN,Japan,TWN,Chinese Taipei,2008,3669,5549,-1880
JPN,Japan,TWN,Chinese Taipei,2009,4015,5425,-1410
JPN,Japan,TWN,Chinese Taipei,2010,4661,6568,-1907
JPN,Japan,TWN,Chinese Taipei,2011,5306,5555,-249
JPN,Japan,TWN,Chinese Taipei,2012,5002,6602,-1600
JPN,Japan,TWN,Chinese Taipei,2013,4881,6596,-1715
JPN,Japan,TWN,Chinese Taipei,2014,5156,7704,-2548
JPN,Japan,TWN,Chinese Taipei,2015,5680,10836,-5156
JPN,Japan,TWN,Chinese Taipei,2016,7951,12242,-4291
JPN,Japan,TWN,Chinese Taipei,2017,9319,13737,-4418
KOR,Korea,TWN,Chinese Taipei,2008,1328,1357,-29
KOR,Korea,TWN,Chinese Taipei,2009,1369,1459,-90
KOR,Korea,TWN,Chinese Taipei,2010,1400,1440,-40
KOR,Korea,TWN,Chinese Taipei,2011,1496,1629,-133
KOR,Korea,TWN,Chinese Taipei,2012,1943,1633,310
KOR,Korea,TWN,Chinese Taipei,2013,1614,1952,-338
KOR,Korea,TWN,Chinese Taipei,2014,1969,1971,-2
KOR,Korea,TWN,Chinese Taipei,2015,2517,1992,525
KOR,Korea,TWN,Chinese Taipei,2016,2251,2339,-88
KOR,Korea,TWN,Chinese Taipei,2017,2544,2486,58
LUX,Luxembourg,TWN,Chinese Taipei,2008,1,8,-7
LUX,Luxembourg,TWN,Chinese Taipei,2009,7,10,-3
LUX,Luxembourg,TWN,Chinese Taipei,2010,0,0,0
LUX,Luxembourg,TWN,Chinese Taipei,2011,0,2,-2
LUX,Luxembourg,TWN,Chinese Taipei,2012,10,7,3
LUX,Luxembourg,TWN,Chinese Taipei,2013,1,1,0
LUX,Luxembourg,TWN,Chinese Taipei,2014,0,0,0
LUX,Luxembourg,TWN,Chinese Taipei,2015,0,7,-7
LUX,Luxembourg,TWN,Chinese Taipei,2016,3,6,-3
LUX,Luxembourg,TWN,Chinese Taipei,2017,2,10,-8
MEX,Mexico,TWN,Chinese Taipei,2008,0,29,-29
MEX,Mexico,TWN,Chinese Taipei,2009,0,42,-42
MEX,Mexico,TWN,Chinese Taipei,2010,0,55,-55
MEX,Mexico,TWN,Chinese Taipei,2011,0,64,-64
MEX,Mexico,TWN,Chinese Taipei,2012,0,57,-57
MEX,Mexico,TWN,Chinese Taipei,2013,0,183,-183
MEX,Mexico,TWN,Chinese Taipei,2014,0,83,-83
MEX,Mexico,TWN,Chinese Taipei,2015,0,59,-59
MEX,Mexico,TWN,Chinese Taipei,2016,0,43,-43
MEX,Mexico,TWN,Chinese Taipei,2017,0,58,-58
NLD,Netherlands,TWN,Chinese Taipei,2008,294,402,-108
NLD,Netherlands,TWN,Chinese Taipei,2009,312,351,-39
NLD,Netherlands,TWN,Chinese Taipei,2010,321,405,-84
NLD,Netherlands,TWN,Chinese Taipei,2011,361,443,-82
NLD,Netherlands,TWN,Chinese Taipei,2012,373,349,24
NLD,Netherlands,TWN,Chinese Taipei,2013,354,409,-55
NLD,Netherlands,TWN,Chinese Taipei,2014,292,462,-170
NLD,Netherlands,TWN,Chinese Taipei,2015,332,509,-177
NLD,Netherlands,TWN,Chinese Taipei,2016,363,644,-281
NLD,Netherlands,TWN,Chinese Taipei,2017,498,723,-225
NZL,New Zealand,TWN,Chinese Taipei,2008,226,565,-339
NZL,New Zealand,TWN,Chinese Taipei,2009,193,522,-329
NZL,New Zealand,TWN,Chinese Taipei,2010,211,588,-377
NZL,New Zealand,TWN,Chinese Taipei,2011,232,590,-358
NZL,New Zealand,TWN,Chinese Taipei,2012,225,560,-335
NZL,New Zealand,TWN,Chinese Taipei,2013,185,630,-445
NZL,New Zealand,TWN,Chinese Taipei,2014,204,604,-400
NZL,New Zealand,TWN,Chinese Taipei,2015,200,684,-484
NZL,New Zealand,TWN,Chinese Taipei,2016,225,683,-458
NZL,New Zealand,TWN,Chinese Taipei,2017,222,691,-469
NOR,Norway,TWN,Chinese Taipei,2008,7,29,-22
NOR,Norway,TWN,Chinese Taipei,2009,17,21,-4
NOR,Norway,TWN,Chinese Taipei,2010,12,12,0
NOR,Norway,TWN,Chinese Taipei,2011,0,0,0
NOR,Norway,TWN,Chinese Taipei,2012,0,0,0
NOR,Norway,TWN,Chinese Taipei,2013,0,0,0
NOR,Norway,TWN,Chinese Taipei,2014,0,0,0
NOR,Norway,TWN,Chinese Taipei,2015,0,0,0
NOR,Norway,TWN,Chinese Taipei,2016,0,0,0
NOR,Norway,TWN,Chinese Taipei,2017,0,0,0
POL,Poland,TWN,Chinese Taipei,2009,0,659,-659
POL,Poland,TWN,Chinese Taipei,2010,0,555,-555
POL,Poland,TWN,Chinese Taipei,2011,0,493,-493
POL,Poland,TWN,Chinese Taipei,2012,0,380,-380
POL,Poland,TWN,Chinese Taipei,2013,0,224,-224
POL,Poland,TWN,Chinese Taipei,2014,0,95,-95
POL,Poland,TWN,Chinese Taipei,2015,0,187,-187
POL,Poland,TWN,Chinese Taipei,2016,0,308,-308
POL,Poland,TWN,Chinese Taipei,2017,0,389,-389
SVK,Slovak Republic,TWN,Chinese Taipei,2008,0,4,-4
SVK,Slovak Republic,TWN,Chinese Taipei,2009,1,14,-13
SVK,Slovak Republic,TWN,Chinese Taipei,2010,1,2,-1
SVK,Slovak Republic,TWN,Chinese Taipei,2011,17,1,16
SVK,Slovak Republic,TWN,Chinese Taipei,2016,0,1,-1
SVK,Slovak Republic,TWN,Chinese Taipei,2017,0,1,-1
ESP,Spain,TWN,Chinese Taipei,2008,47,69,-22
ESP,Spain,TWN,Chinese Taipei,2009,81,76,5
ESP,Spain,TWN,Chinese Taipei,2010,51,101,-50
ESP,Spain,TWN,Chinese Taipei,2011,0,0,0
ESP,Spain,TWN,Chinese Taipei,2012,0,0,0
ESP,Spain,TWN,Chinese Taipei,2013,0,0,0
SWE,Sweden,TWN,Chinese Taipei,2008,11,128,-117
SWE,Sweden,TWN,Chinese Taipei,2009,17,110,-93
SWE,Sweden,TWN,Chinese Taipei,2010,25,103,-78
SWE,Sweden,TWN,Chinese Taipei,2011,38,88,-50
SWE,Sweden,TWN,Chinese Taipei,2012,64,91,-27
SWE,Sweden,TWN,Chinese Taipei,2013,35,95,-60
SWE,Sweden,TWN,Chinese Taipei,2014,46,131,-85
SWE,Sweden,TWN,Chinese Taipei,2015,59,106,-47
SWE,Sweden,TWN,Chinese Taipei,2016,32,122,-90
SWE,Sweden,TWN,Chinese Taipei,2017,33,141,-108
CHE,Switzerland,TWN,Chinese Taipei,2010,186,225,-39
CHE,Switzerland,TWN,Chinese Taipei,2011,188,280,-92
CHE,Switzerland,TWN,Chinese Taipei,2012,233,277,-44
CHE,Switzerland,TWN,Chinese Taipei,2013,214,342,-128
CHE,Switzerland,TWN,Chinese Taipei,2014,276,308,-32
CHE,Switzerland,TWN,Chinese Taipei,2015,226,338,-112
CHE,Switzerland,TWN,Chinese Taipei,2016,311,330,-19
CHE,Switzerland,TWN,Chinese Taipei,2017,299,335,-36
GBR,United Kingdom,TWN,Chinese Taipei,2008,1000,1000,0
GBR,United Kingdom,TWN,Chinese Taipei,2009,0,4000,-4000
GBR,United Kingdom,TWN,Chinese Taipei,2013,0,4000,-4000
USA,United States,TWN,Chinese Taipei,2008,0,9073,-9073
USA,United States,TWN,Chinese Taipei,2009,0,8038,-8038
USA,United States,TWN,Chinese Taipei,2010,0,6732,-6732
USA,United States,TWN,Chinese Taipei,2011,0,6154,-6154
USA,United States,TWN,Chinese Taipei,2012,0,5331,-5331
USA,United States,TWN,Chinese Taipei,2013,0,5385,-5385
USA,United States,TWN,Chinese Taipei,2014,0,4697,-4697
USA,United States,TWN,Chinese Taipei,2015,0,4888,-4888
USA,United States,TWN,Chinese Taipei,2016,0,5120,-5120
USA,United States,TWN,Chinese Taipei,2017,0,4858,-4858
CHL,Chile,TWN,Chinese Taipei,2008,0,31,-31
CHL,Chile,TWN,Chinese Taipei,2009,0,25,-25
CHL,Chile,TWN,Chinese Taipei,2010,0,29,-29
CHL,Chile,TWN,Chinese Taipei,2011,0,30,-30
CHL,Chile,TWN,Chinese Taipei,2012,0,37,-37
CHL,Chile,TWN,Chinese Taipei,2013,0,30,-30
CHL,Chile,TWN,Chinese Taipei,2014,0,36,-36
CHL,Chile,TWN,Chinese Taipei,2015,0,19,-19
CHL,Chile,TWN,Chinese Taipei,2016,0,26,-26
EST,Estonia,TWN,Chinese Taipei,2008,0,0,0
EST,Estonia,TWN,Chinese Taipei,2009,0,1,-1
EST,Estonia,TWN,Chinese Taipei,2010,0,0,0
EST,Estonia,TWN,Chinese Taipei,2011,0,0,0
EST,Estonia,TWN,Chinese Taipei,2012,0,1,-1
EST,Estonia,TWN,Chinese Taipei,2013,0,3,-3
EST,Estonia,TWN,Chinese Taipei,2014,0,0,0
EST,Estonia,TWN,Chinese Taipei,2015,0,1,-1
EST,Estonia,TWN,Chinese Taipei,2016,0,1,-1
EST,Estonia,TWN,Chinese Taipei,2017,0,0,0
SVN,Slovenia,TWN,Chinese Taipei,2012,0,1,-1
SVN,Slovenia,TWN,Chinese Taipei,2013,0,2,-2
SVN,Slovenia,TWN,Chinese Taipei,2014,0,4,-4
SVN,Slovenia,TWN,Chinese Taipei,2015,0,5,-5
SVN,Slovenia,TWN,Chinese Taipei,2016,0,4,-4
SVN,Slovenia,TWN,Chinese Taipei,2017,0,5,-5
AUS,Australia,TJK,Tajikistan,2008,0,0,0
AUS,Australia,TJK,Tajikistan,2009,0,6,-6
AUS,Australia,TJK,Tajikistan,2010,0,11,-11
AUS,Australia,TJK,Tajikistan,2011,0,7,-7
AUS,Australia,TJK,Tajikistan,2012,0,4,-4
AUS,Australia,TJK,Tajikistan,2013,0,4,-4
AUS,Australia,TJK,Tajikistan,2014,0,8,-8
AUS,Australia,TJK,Tajikistan,2015,0,0,0
AUS,Australia,TJK,Tajikistan,2017,0,0,0
AUT,Austria,TJK,Tajikistan,2008,3,16,-13
AUT,Austria,TJK,Tajikistan,2009,8,27,-19
AUT,Austria,TJK,Tajikistan,2010,16,41,-25
AUT,Austria,TJK,Tajikistan,2011,16,48,-32
AUT,Austria,TJK,Tajikistan,2012,16,75,-59
AUT,Austria,TJK,Tajikistan,2013,23,47,-24
AUT,Austria,TJK,Tajikistan,2014,10,41,-31
AUT,Austria,TJK,Tajikistan,2015,12,106,-94
AUT,Austria,TJK,Tajikistan,2016,37,120,-83
AUT,Austria,TJK,Tajikistan,2017,72,61,11
BEL,Belgium,TJK,Tajikistan,2008,0,5,-5
BEL,Belgium,TJK,Tajikistan,2009,0,6,-6
BEL,Belgium,TJK,Tajikistan,2010,0,6,-6
BEL,Belgium,TJK,Tajikistan,2012,11,17,-6
BEL,Belgium,TJK,Tajikistan,2013,14,4,10
BEL,Belgium,TJK,Tajikistan,2014,7,13,-6
BEL,Belgium,TJK,Tajikistan,2015,1,17,-16
BEL,Belgium,TJK,Tajikistan,2016,4,7,-3
BEL,Belgium,TJK,Tajikistan,2017,2,8,-6
CAN,Canada,TJK,Tajikistan,2008,0,15,-15
CAN,Canada,TJK,Tajikistan,2009,0,50,-50
CAN,Canada,TJK,Tajikistan,2010,0,52,-52
CAN,Canada,TJK,Tajikistan,2011,0,47,-47
CAN,Canada,TJK,Tajikistan,2012,0,34,-34
CAN,Canada,TJK,Tajikistan,2013,0,39,-39
CAN,Canada,TJK,Tajikistan,2014,0,24,-24
CAN,Canada,TJK,Tajikistan,2015,0,43,-43
CAN,Canada,TJK,Tajikistan,2016,0,30,-30
CAN,Canada,TJK,Tajikistan,2017,0,40,-40
CZE,Czech Republic,TJK,Tajikistan,2008,5,59,-54
CZE,Czech Republic,TJK,Tajikistan,2009,0,54,-54
CZE,Czech Republic,TJK,Tajikistan,2010,0,10,-10
CZE,Czech Republic,TJK,Tajikistan,2011,1,6,-5
CZE,Czech Republic,TJK,Tajikistan,2012,8,13,-5
CZE,Czech Republic,TJK,Tajikistan,2013,24,9,15
CZE,Czech Republic,TJK,Tajikistan,2014,6,19,-13
CZE,Czech Republic,TJK,Tajikistan,2015,5,18,-13
CZE,Czech Republic,TJK,Tajikistan,2016,8,36,-28
CZE,Czech Republic,TJK,Tajikistan,2017,14,29,-15
DNK,Denmark,TJK,Tajikistan,2008,0,0,0
DNK,Denmark,TJK,Tajikistan,2009,1,1,0
DNK,Denmark,TJK,Tajikistan,2010,0,1,-1
DNK,Denmark,TJK,Tajikistan,2011,1,1,0
DNK,Denmark,TJK,Tajikistan,2012,0,3,-3
DNK,Denmark,TJK,Tajikistan,2013,0,1,-1
DNK,Denmark,TJK,Tajikistan,2014,0,0,0
DNK,Denmark,TJK,Tajikistan,2015,1,1,0
DNK,Denmark,TJK,Tajikistan,2016,0,1,-1
DNK,Denmark,TJK,Tajikistan,2017,0,1,-1
FIN,Finland,TJK,Tajikistan,2008,1,11,-10
FIN,Finland,TJK,Tajikistan,2009,0,3,-3
FIN,Finland,TJK,Tajikistan,2010,0,4,-4
FIN,Finland,TJK,Tajikistan,2011,0,0,0
FIN,Finland,TJK,Tajikistan,2012,1,2,-1
FIN,Finland,TJK,Tajikistan,2013,0,1,-1
FIN,Finland,TJK,Tajikistan,2014,0,2,-2
FIN,Finland,TJK,Tajikistan,2015,0,7,-7
FIN,Finland,TJK,Tajikistan,2016,0,1,-1
FIN,Finland,TJK,Tajikistan,2017,0,0,0
FRA,France,TJK,Tajikistan,2008,0,10,-10
FRA,France,TJK,Tajikistan,2009,0,12,-12
FRA,France,TJK,Tajikistan,2010,0,7,-7
FRA,France,TJK,Tajikistan,2011,0,14,-14
FRA,France,TJK,Tajikistan,2012,0,8,-8
FRA,France,TJK,Tajikistan,2013,0,14,-14
FRA,France,TJK,Tajikistan,2014,0,14,-14
FRA,France,TJK,Tajikistan,2015,0,19,-19
FRA,France,TJK,Tajikistan,2016,0,18,-18
FRA,France,TJK,Tajikistan,2017,0,18,-18
DEU,Germany,TJK,Tajikistan,2008,127,153,-26
DEU,Germany,TJK,Tajikistan,2009,163,199,-36
DEU,Germany,TJK,Tajikistan,2010,119,235,-116
DEU,Germany,TJK,Tajikistan,2011,162,285,-123
DEU,Germany,TJK,Tajikistan,2012,156,207,-51
DEU,Germany,TJK,Tajikistan,2013,145,365,-220
DEU,Germany,TJK,Tajikistan,2014,197,649,-452
DEU,Germany,TJK,Tajikistan,2015,356,1008,-652
DEU,Germany,TJK,Tajikistan,2016,478,1497,-1019
DEU,Germany,TJK,Tajikistan,2017,808,1651,-843
HUN,Hungary,TJK,Tajikistan,2008,1,5,-4
HUN,Hungary,TJK,Tajikistan,2009,0,3,-3
HUN,Hungary,TJK,Tajikistan,2010,0,3,-3
HUN,Hungary,TJK,Tajikistan,2011,0,3,-3
HUN,Hungary,TJK,Tajikistan,2012,0,3,-3
HUN,Hungary,TJK,Tajikistan,2013,1,3,-2
HUN,Hungary,TJK,Tajikistan,2014,0,1,-1
HUN,Hungary,TJK,Tajikistan,2015,0,9,-9
HUN,Hungary,TJK,Tajikistan,2016,0,5,-5
HUN,Hungary,TJK,Tajikistan,2017,0,8,-8
ISL,Iceland,TJK,Tajikistan,2016,0,1,-1
ISL,Iceland,TJK,Tajikistan,2017,0,0,0
ITA,Italy,TJK,Tajikistan,2008,0,3,-3
ITA,Italy,TJK,Tajikistan,2009,0,8,-8
ITA,Italy,TJK,Tajikistan,2010,0,5,-5
ITA,Italy,TJK,Tajikistan,2011,0,6,-6
ITA,Italy,TJK,Tajikistan,2012,0,0,0
ITA,Italy,TJK,Tajikistan,2013,3,16,-13
ITA,Italy,TJK,Tajikistan,2014,0,4,-4
ITA,Italy,TJK,Tajikistan,2015,0,2,-2
ITA,Italy,TJK,Tajikistan,2016,0,10,-10
ITA,Italy,TJK,Tajikistan,2017,0,13,-13
JPN,Japan,TJK,Tajikistan,2008,125,149,-24
JPN,Japan,TJK,Tajikistan,2009,111,124,-13
JPN,Japan,TJK,Tajikistan,2010,118,128,-10
JPN,Japan,TJK,Tajikistan,2011,108,136,-28
JPN,Japan,TJK,Tajikistan,2012,118,120,-2
JPN,Japan,TJK,Tajikistan,2013,107,118,-11
JPN,Japan,TJK,Tajikistan,2014,101,126,-25
JPN,Japan,TJK,Tajikistan,2015,141,151,-10
JPN,Japan,TJK,Tajikistan,2016,180,214,-34
JPN,Japan,TJK,Tajikistan,2017,118,142,-24
KOR,Korea,TJK,Tajikistan,2008,30,39,-9
KOR,Korea,TJK,Tajikistan,2009,30,30,0
KOR,Korea,TJK,Tajikistan,2010,40,71,-31
KOR,Korea,TJK,Tajikistan,2011,67,110,-43
KOR,Korea,TJK,Tajikistan,2012,107,170,-63
KOR,Korea,TJK,Tajikistan,2013,91,99,-8
KOR,Korea,TJK,Tajikistan,2014,124,173,-49
KOR,Korea,TJK,Tajikistan,2015,119,119,0
KOR,Korea,TJK,Tajikistan,2016,125,161,-36
KOR,Korea,TJK,Tajikistan,2017,174,219,-45
LUX,Luxembourg,TJK,Tajikistan,2008,1,0,1
LUX,Luxembourg,TJK,Tajikistan,2009,0,0,0
LUX,Luxembourg,TJK,Tajikistan,2010,0,0,0
LUX,Luxembourg,TJK,Tajikistan,2011,0,0,0
LUX,Luxembourg,TJK,Tajikistan,2012,0,0,0
LUX,Luxembourg,TJK,Tajikistan,2013,0,1,-1
LUX,Luxembourg,TJK,Tajikistan,2014,0,1,-1
LUX,Luxembourg,TJK,Tajikistan,2015,0,1,-1
LUX,Luxembourg,TJK,Tajikistan,2016,0,2,-2
LUX,Luxembourg,TJK,Tajikistan,2017,0,5,-5
MEX,Mexico,TJK,Tajikistan,2012,0,3,-3
MEX,Mexico,TJK,Tajikistan,2013,0,0,0
MEX,Mexico,TJK,Tajikistan,2014,0,2,-2
MEX,Mexico,TJK,Tajikistan,2015,0,3,-3
MEX,Mexico,TJK,Tajikistan,2016,0,8,-8
MEX,Mexico,TJK,Tajikistan,2017,0,4,-4
NLD,Netherlands,TJK,Tajikistan,2009,5,5,0
NLD,Netherlands,TJK,Tajikistan,2010,1,3,-2
NLD,Netherlands,TJK,Tajikistan,2011,2,4,-2
NLD,Netherlands,TJK,Tajikistan,2012,2,1,1
NLD,Netherlands,TJK,Tajikistan,2013,0,9,-9
NLD,Netherlands,TJK,Tajikistan,2014,1,14,-13
NLD,Netherlands,TJK,Tajikistan,2015,3,8,-5
NLD,Netherlands,TJK,Tajikistan,2016,4,16,-12
NLD,Netherlands,TJK,Tajikistan,2017,13,12,1
NZL,New Zealand,TJK,Tajikistan,2008,0,0,0
NZL,New Zealand,TJK,Tajikistan,2009,2,4,-2
NZL,New Zealand,TJK,Tajikistan,2010,0,1,-1
NZL,New Zealand,TJK,Tajikistan,2011,1,0,1
NZL,New Zealand,TJK,Tajikistan,2012,0,6,-6
NZL,New Zealand,TJK,Tajikistan,2013,0,1,-1
NZL,New Zealand,TJK,Tajikistan,2016,0,5,-5
NZL,New Zealand,TJK,Tajikistan,2017,0,4,-4
NOR,Norway,TJK,Tajikistan,2008,0,7,-7
NOR,Norway,TJK,Tajikistan,2009,1,4,-3
NOR,Norway,TJK,Tajikistan,2010,0,1,-1
NOR,Norway,TJK,Tajikistan,2011,4,4,0
NOR,Norway,TJK,Tajikistan,2012,3,7,-4
NOR,Norway,TJK,Tajikistan,2013,0,7,-7
NOR,Norway,TJK,Tajikistan,2014,9,3,6
NOR,Norway,TJK,Tajikistan,2015,0,3,-3
NOR,Norway,TJK,Tajikistan,2016,4,5,-1
NOR,Norway,TJK,Tajikistan,2017,0,2,-2
POL,Poland,TJK,Tajikistan,2008,0,13,-13
POL,Poland,TJK,Tajikistan,2009,0,21,-21
POL,Poland,TJK,Tajikistan,2010,0,12,-12
POL,Poland,TJK,Tajikistan,2011,0,37,-37
POL,Poland,TJK,Tajikistan,2012,0,42,-42
POL,Poland,TJK,Tajikistan,2013,0,31,-31
POL,Poland,TJK,Tajikistan,2014,0,33,-33
POL,Poland,TJK,Tajikistan,2015,0,61,-61
POL,Poland,TJK,Tajikistan,2016,0,123,-123
POL,Poland,TJK,Tajikistan,2017,0,264,-264
SVK,Slovak Republic,TJK,Tajikistan,2008,0,8,-8
SVK,Slovak Republic,TJK,Tajikistan,2009,6,3,3
SVK,Slovak Republic,TJK,Tajikistan,2010,1,1,0
ESP,Spain,TJK,Tajikistan,2008,3,2,1
ESP,Spain,TJK,Tajikistan,2009,2,11,-9
ESP,Spain,TJK,Tajikistan,2010,3,8,-5
ESP,Spain,TJK,Tajikistan,2011,5,7,-2
ESP,Spain,TJK,Tajikistan,2012,6,16,-10
ESP,Spain,TJK,Tajikistan,2013,4,16,-12
ESP,Spain,TJK,Tajikistan,2014,2,10,-8
ESP,Spain,TJK,Tajikistan,2015,7,17,-10
ESP,Spain,TJK,Tajikistan,2016,3,13,-10
ESP,Spain,TJK,Tajikistan,2017,9,4,5
SWE,Sweden,TJK,Tajikistan,2008,2,20,-18
SWE,Sweden,TJK,Tajikistan,2009,2,19,-17
SWE,Sweden,TJK,Tajikistan,2010,6,6,0
SWE,Sweden,TJK,Tajikistan,2011,3,11,-8
SWE,Sweden,TJK,Tajikistan,2012,5,23,-18
SWE,Sweden,TJK,Tajikistan,2013,2,43,-41
SWE,Sweden,TJK,Tajikistan,2014,3,22,-19
SWE,Sweden,TJK,Tajikistan,2015,8,9,-1
SWE,Sweden,TJK,Tajikistan,2016,1,34,-33
SWE,Sweden,TJK,Tajikistan,2017,1,26,-25
CHE,Switzerland,TJK,Tajikistan,2010,1,11,-10
CHE,Switzerland,TJK,Tajikistan,2011,8,10,-2
CHE,Switzerland,TJK,Tajikistan,2012,5,15,-10
CHE,Switzerland,TJK,Tajikistan,2013,5,5,0
CHE,Switzerland,TJK,Tajikistan,2014,3,7,-4
CHE,Switzerland,TJK,Tajikistan,2015,3,5,-2
CHE,Switzerland,TJK,Tajikistan,2016,6,3,3
CHE,Switzerland,TJK,Tajikistan,2017,4,13,-9
TUR,Turkey,TJK,Tajikistan,2010,0,83,-83
TUR,Turkey,TJK,Tajikistan,2016,346,852,-506
TUR,Turkey,TJK,Tajikistan,2017,501,1616,-1115
USA,United States,TJK,Tajikistan,2008,0,231,-231
USA,United States,TJK,Tajikistan,2009,0,265,-265
USA,United States,TJK,Tajikistan,2010,0,299,-299
USA,United States,TJK,Tajikistan,2011,0,382,-382
USA,United States,TJK,Tajikistan,2012,0,411,-411
USA,United States,TJK,Tajikistan,2013,0,550,-550
USA,United States,TJK,Tajikistan,2014,0,516,-516
USA,United States,TJK,Tajikistan,2015,0,595,-595
USA,United States,TJK,Tajikistan,2016,0,593,-593
USA,United States,TJK,Tajikistan,2017,0,652,-652
CHL,Chile,TJK,Tajikistan,2008,0,0,0
CHL,Chile,TJK,Tajikistan,2009,0,0,0
CHL,Chile,TJK,Tajikistan,2010,0,0,0
CHL,Chile,TJK,Tajikistan,2011,0,0,0
CHL,Chile,TJK,Tajikistan,2012,0,0,0
CHL,Chile,TJK,Tajikistan,2013,0,0,0
CHL,Chile,TJK,Tajikistan,2014,0,0,0
CHL,Chile,TJK,Tajikistan,2015,0,0,0
CHL,Chile,TJK,Tajikistan,2016,0,0,0
EST,Estonia,TJK,Tajikistan,2008,0,0,0
EST,Estonia,TJK,Tajikistan,2009,0,0,0
EST,Estonia,TJK,Tajikistan,2010,0,0,0
EST,Estonia,TJK,Tajikistan,2011,0,0,0
EST,Estonia,TJK,Tajikistan,2012,0,0,0
EST,Estonia,TJK,Tajikistan,2013,0,1,-1
EST,Estonia,TJK,Tajikistan,2014,0,0,0
EST,Estonia,TJK,Tajikistan,2015,0,1,-1
EST,Estonia,TJK,Tajikistan,2016,0,1,-1
EST,Estonia,TJK,Tajikistan,2017,0,4,-4
SVN,Slovenia,TJK,Tajikistan,2008,0,1,-1
SVN,Slovenia,TJK,Tajikistan,2010,0,3,-3
SVN,Slovenia,TJK,Tajikistan,2013,0,2,-2
SVN,Slovenia,TJK,Tajikistan,2014,0,1,-1
SVN,Slovenia,TJK,Tajikistan,2015,0,1,-1
SVN,Slovenia,TJK,Tajikistan,2017,1,2,-1
AUS,Australia,TZA,Tanzania,2008,19,42,-23
AUS,Australia,TZA,Tanzania,2009,14,58,-44
AUS,Australia,TZA,Tanzania,2010,26,57,-31
AUS,Australia,TZA,Tanzania,2011,19,63,-44
AUS,Australia,TZA,Tanzania,2012,19,49,-30
AUS,Australia,TZA,Tanzania,2013,26,57,-31
AUS,Australia,TZA,Tanzania,2014,21,78,-57
AUS,Australia,TZA,Tanzania,2015,0,69,-69
AUS,Australia,TZA,Tanzania,2016,0,69,-69
AUS,Australia,TZA,Tanzania,2017,0,83,-83
AUT,Austria,TZA,Tanzania,2008,13,13,0
AUT,Austria,TZA,Tanzania,2009,8,12,-4
AUT,Austria,TZA,Tanzania,2010,5,15,-10
AUT,Austria,TZA,Tanzania,2011,10,18,-8
AUT,Austria,TZA,Tanzania,2012,13,13,0
AUT,Austria,TZA,Tanzania,2013,11,19,-8
AUT,Austria,TZA,Tanzania,2014,12,25,-13
AUT,Austria,TZA,Tanzania,2015,7,20,-13
AUT,Austria,TZA,Tanzania,2016,10,24,-14
AUT,Austria,TZA,Tanzania,2017,15,19,-4
BEL,Belgium,TZA,Tanzania,2008,0,42,-42
BEL,Belgium,TZA,Tanzania,2009,0,73,-73
BEL,Belgium,TZA,Tanzania,2010,47,69,-22
BEL,Belgium,TZA,Tanzania,2012,73,59,14
BEL,Belgium,TZA,Tanzania,2013,82,59,23
BEL,Belgium,TZA,Tanzania,2014,70,57,13
BEL,Belgium,TZA,Tanzania,2015,43,38,5
BEL,Belgium,TZA,Tanzania,2016,31,52,-21
BEL,Belgium,TZA,Tanzania,2017,24,66,-42
CAN,Canada,TZA,Tanzania,2008,0,230,-230
CAN,Canada,TZA,Tanzania,2009,0,136,-136
CAN,Canada,TZA,Tanzania,2010,0,200,-200
CAN,Canada,TZA,Tanzania,2011,0,215,-215
CAN,Canada,TZA,Tanzania,2012,0,224,-224
CAN,Canada,TZA,Tanzania,2013,0,182,-182
CAN,Canada,TZA,Tanzania,2014,0,133,-133
CAN,Canada,TZA,Tanzania,2015,0,157,-157
CAN,Canada,TZA,Tanzania,2016,0,115,-115
CAN,Canada,TZA,Tanzania,2017,0,195,-195
CZE,Czech Republic,TZA,Tanzania,2008,0,2,-2
CZE,Czech Republic,TZA,Tanzania,2012,1,2,-1
CZE,Czech Republic,TZA,Tanzania,2013,1,1,0
CZE,Czech Republic,TZA,Tanzania,2014,3,1,2
CZE,Czech Republic,TZA,Tanzania,2015,1,3,-2
CZE,Czech Republic,TZA,Tanzania,2016,0,2,-2
CZE,Czech Republic,TZA,Tanzania,2017,0,3,-3
DNK,Denmark,TZA,Tanzania,2008,12,41,-29
DNK,Denmark,TZA,Tanzania,2009,13,18,-5
DNK,Denmark,TZA,Tanzania,2010,16,25,-9
DNK,Denmark,TZA,Tanzania,2011,22,26,-4
DNK,Denmark,TZA,Tanzania,2012,26,30,-4
DNK,Denmark,TZA,Tanzania,2013,27,32,-5
DNK,Denmark,TZA,Tanzania,2014,17,15,2
DNK,Denmark,TZA,Tanzania,2015,29,0,29
DNK,Denmark,TZA,Tanzania,2016,18,19,-1
DNK,Denmark,TZA,Tanzania,2017,30,28,2
FIN,Finland,TZA,Tanzania,2008,12,37,-25
FIN,Finland,TZA,Tanzania,2009,5,25,-20
FIN,Finland,TZA,Tanzania,2010,2,31,-29
FIN,Finland,TZA,Tanzania,2011,5,26,-21
FIN,Finland,TZA,Tanzania,2012,5,39,-34
FIN,Finland,TZA,Tanzania,2013,5,22,-17
FIN,Finland,TZA,Tanzania,2014,2,26,-24
FIN,Finland,TZA,Tanzania,2015,7,16,-9
FIN,Finland,TZA,Tanzania,2016,5,18,-13
FIN,Finland,TZA,Tanzania,2017,7,12,-5
FRA,France,TZA,Tanzania,2008,0,18,-18
FRA,France,TZA,Tanzania,2009,0,21,-21
FRA,France,TZA,Tanzania,2010,0,11,-11
FRA,France,TZA,Tanzania,2011,0,18,-18
FRA,France,TZA,Tanzania,2012,0,15,-15
FRA,France,TZA,Tanzania,2013,0,14,-14
FRA,France,TZA,Tanzania,2014,0,16,-16
FRA,France,TZA,Tanzania,2015,0,26,-26
FRA,France,TZA,Tanzania,2016,0,28,-28
FRA,France,TZA,Tanzania,2017,0,20,-20
DEU,Germany,TZA,Tanzania,2008,156,167,-11
DEU,Germany,TZA,Tanzania,2009,178,178,0
DEU,Germany,TZA,Tanzania,2010,166,182,-16
DEU,Germany,TZA,Tanzania,2011,140,200,-60
DEU,Germany,TZA,Tanzania,2012,126,175,-49
DEU,Germany,TZA,Tanzania,2013,138,248,-110
DEU,Germany,TZA,Tanzania,2014,166,238,-72
DEU,Germany,TZA,Tanzania,2015,169,300,-131
DEU,Germany,TZA,Tanzania,2016,148,293,-145
DEU,Germany,TZA,Tanzania,2017,195,336,-141
HUN,Hungary,TZA,Tanzania,2008,0,8,-8
HUN,Hungary,TZA,Tanzania,2009,0,1,-1
HUN,Hungary,TZA,Tanzania,2010,0,1,-1
HUN,Hungary,TZA,Tanzania,2011,0,5,-5
HUN,Hungary,TZA,Tanzania,2012,0,8,-8
HUN,Hungary,TZA,Tanzania,2013,2,2,0
HUN,Hungary,TZA,Tanzania,2014,1,5,-4
HUN,Hungary,TZA,Tanzania,2015,0,1,-1
HUN,Hungary,TZA,Tanzania,2016,0,2,-2
HUN,Hungary,TZA,Tanzania,2017,0,5,-5
ISL,Iceland,TZA,Tanzania,2008,4,3,1
ISL,Iceland,TZA,Tanzania,2009,2,1,1
ISL,Iceland,TZA,Tanzania,2010,1,3,-2
ISL,Iceland,TZA,Tanzania,2011,1,2,-1
ISL,Iceland,TZA,Tanzania,2012,0,5,-5
ISL,Iceland,TZA,Tanzania,2013,4,6,-2
ISL,Iceland,TZA,Tanzania,2014,6,4,2
ISL,Iceland,TZA,Tanzania,2015,4,3,1
ISL,Iceland,TZA,Tanzania,2016,7,5,2
ISL,Iceland,TZA,Tanzania,2017,5,4,1
ITA,Italy,TZA,Tanzania,2008,9,68,-59
ITA,Italy,TZA,Tanzania,2009,14,113,-99
ITA,Italy,TZA,Tanzania,2010,10,89,-79
ITA,Italy,TZA,Tanzania,2011,11,62,-51
ITA,Italy,TZA,Tanzania,2012,15,93,-78
ITA,Italy,TZA,Tanzania,2013,13,80,-67
ITA,Italy,TZA,Tanzania,2014,14,67,-53
ITA,Italy,TZA,Tanzania,2015,19,87,-68
ITA,Italy,TZA,Tanzania,2016,0,89,-89
ITA,Italy,TZA,Tanzania,2017,14,95,-81
JPN,Japan,TZA,Tanzania,2008,260,261,-1
JPN,Japan,TZA,Tanzania,2009,222,246,-24
JPN,Japan,TZA,Tanzania,2010,266,292,-26
JPN,Japan,TZA,Tanzania,2011,198,196,2
JPN,Japan,TZA,Tanzania,2012,254,259,-5
JPN,Japan,TZA,Tanzania,2013,269,294,-25
JPN,Japan,TZA,Tanzania,2014,278,321,-43
JPN,Japan,TZA,Tanzania,2015,249,314,-65
JPN,Japan,TZA,Tanzania,2016,226,256,-30
JPN,Japan,TZA,Tanzania,2017,245,251,-6
KOR,Korea,TZA,Tanzania,2008,22,42,-20
KOR,Korea,TZA,Tanzania,2009,42,53,-11
KOR,Korea,TZA,Tanzania,2010,42,57,-15
KOR,Korea,TZA,Tanzania,2011,54,64,-10
KOR,Korea,TZA,Tanzania,2012,54,73,-19
KOR,Korea,TZA,Tanzania,2013,72,47,25
KOR,Korea,TZA,Tanzania,2014,55,67,-12
KOR,Korea,TZA,Tanzania,2015,54,67,-13
KOR,Korea,TZA,Tanzania,2016,73,65,8
KOR,Korea,TZA,Tanzania,2017,53,86,-33
LUX,Luxembourg,TZA,Tanzania,2008,0,1,-1
LUX,Luxembourg,TZA,Tanzania,2009,0,0,0
LUX,Luxembourg,TZA,Tanzania,2010,0,1,-1
LUX,Luxembourg,TZA,Tanzania,2011,0,2,-2
LUX,Luxembourg,TZA,Tanzania,2012,1,7,-6
LUX,Luxembourg,TZA,Tanzania,2013,5,3,2
LUX,Luxembourg,TZA,Tanzania,2014,0,1,-1
LUX,Luxembourg,TZA,Tanzania,2015,1,7,-6
LUX,Luxembourg,TZA,Tanzania,2016,0,3,-3
LUX,Luxembourg,TZA,Tanzania,2017,2,3,-1
MEX,Mexico,TZA,Tanzania,2008,0,3,-3
MEX,Mexico,TZA,Tanzania,2009,0,3,-3
MEX,Mexico,TZA,Tanzania,2010,0,1,-1
MEX,Mexico,TZA,Tanzania,2011,0,3,-3
MEX,Mexico,TZA,Tanzania,2012,0,1,-1
MEX,Mexico,TZA,Tanzania,2013,0,3,-3
MEX,Mexico,TZA,Tanzania,2014,0,2,-2
MEX,Mexico,TZA,Tanzania,2015,0,4,-4
NLD,Netherlands,TZA,Tanzania,2008,89,111,-22
NLD,Netherlands,TZA,Tanzania,2009,80,133,-53
NLD,Netherlands,TZA,Tanzania,2010,140,103,37
NLD,Netherlands,TZA,Tanzania,2011,108,81,27
NLD,Netherlands,TZA,Tanzania,2012,62,88,-26
NLD,Netherlands,TZA,Tanzania,2013,157,86,71
NLD,Netherlands,TZA,Tanzania,2014,64,71,-7
NLD,Netherlands,TZA,Tanzania,2015,80,94,-14
NLD,Netherlands,TZA,Tanzania,2016,103,73,30
NLD,Netherlands,TZA,Tanzania,2017,77,97,-20
NZL,New Zealand,TZA,Tanzania,2008,1,19,-18
NZL,New Zealand,TZA,Tanzania,2009,7,18,-11
NZL,New Zealand,TZA,Tanzania,2010,10,13,-3
NZL,New Zealand,TZA,Tanzania,2011,6,12,-6
NZL,New Zealand,TZA,Tanzania,2012,6,11,-5
NZL,New Zealand,TZA,Tanzania,2013,4,8,-4
NZL,New Zealand,TZA,Tanzania,2014,3,8,-5
NZL,New Zealand,TZA,Tanzania,2015,7,11,-4
NZL,New Zealand,TZA,Tanzania,2016,6,17,-11
NZL,New Zealand,TZA,Tanzania,2017,6,6,0
NOR,Norway,TZA,Tanzania,2008,80,101,-21
NOR,Norway,TZA,Tanzania,2009,73,98,-25
NOR,Norway,TZA,Tanzania,2010,70,89,-19
NOR,Norway,TZA,Tanzania,2011,83,81,2
NOR,Norway,TZA,Tanzania,2012,64,82,-18
NOR,Norway,TZA,Tanzania,2013,83,67,16
NOR,Norway,TZA,Tanzania,2014,68,81,-13
NOR,Norway,TZA,Tanzania,2015,64,74,-10
NOR,Norway,TZA,Tanzania,2016,69,60,9
NOR,Norway,TZA,Tanzania,2017,42,42,0
POL,Poland,TZA,Tanzania,2008,0,28,-28
POL,Poland,TZA,Tanzania,2009,0,36,-36
POL,Poland,TZA,Tanzania,2010,0,27,-27
POL,Poland,TZA,Tanzania,2011,0,31,-31
POL,Poland,TZA,Tanzania,2012,0,22,-22
POL,Poland,TZA,Tanzania,2013,0,25,-25
POL,Poland,TZA,Tanzania,2014,0,17,-17
POL,Poland,TZA,Tanzania,2015,0,16,-16
POL,Poland,TZA,Tanzania,2016,0,14,-14
POL,Poland,TZA,Tanzania,2017,0,12,-12
SVK,Slovak Republic,TZA,Tanzania,2008,0,0,0
SVK,Slovak Republic,TZA,Tanzania,2009,0,1,-1
ESP,Spain,TZA,Tanzania,2008,16,28,-12
ESP,Spain,TZA,Tanzania,2009,16,26,-10
ESP,Spain,TZA,Tanzania,2010,11,33,-22
ESP,Spain,TZA,Tanzania,2011,11,22,-11
ESP,Spain,TZA,Tanzania,2012,9,34,-25
ESP,Spain,TZA,Tanzania,2013,5,32,-27
ESP,Spain,TZA,Tanzania,2014,5,24,-19
ESP,Spain,TZA,Tanzania,2015,8,35,-27
ESP,Spain,TZA,Tanzania,2016,6,25,-19
ESP,Spain,TZA,Tanzania,2017,10,41,-31
SWE,Sweden,TZA,Tanzania,2008,22,93,-71
SWE,Sweden,TZA,Tanzania,2009,11,95,-84
SWE,Sweden,TZA,Tanzania,2010,17,104,-87
SWE,Sweden,TZA,Tanzania,2011,22,116,-94
SWE,Sweden,TZA,Tanzania,2012,30,108,-78
SWE,Sweden,TZA,Tanzania,2013,20,76,-56
SWE,Sweden,TZA,Tanzania,2014,40,100,-60
SWE,Sweden,TZA,Tanzania,2015,49,62,-13
SWE,Sweden,TZA,Tanzania,2016,40,86,-46
SWE,Sweden,TZA,Tanzania,2017,26,108,-82
CHE,Switzerland,TZA,Tanzania,2010,29,55,-26
CHE,Switzerland,TZA,Tanzania,2011,23,38,-15
CHE,Switzerland,TZA,Tanzania,2012,16,34,-18
CHE,Switzerland,TZA,Tanzania,2013,25,32,-7
CHE,Switzerland,TZA,Tanzania,2014,25,37,-12
CHE,Switzerland,TZA,Tanzania,2015,22,33,-11
CHE,Switzerland,TZA,Tanzania,2016,13,31,-18
CHE,Switzerland,TZA,Tanzania,2017,12,35,-23
TUR,Turkey,TZA,Tanzania,2010,0,30,-30
TUR,Turkey,TZA,Tanzania,2016,81,111,-30
TUR,Turkey,TZA,Tanzania,2017,0,0,0
GBR,United Kingdom,TZA,Tanzania,2011,0,1000,-1000
GBR,United Kingdom,TZA,Tanzania,2013,0,1000,-1000
USA,United States,TZA,Tanzania,2008,0,838,-838
USA,United States,TZA,Tanzania,2009,0,2773,-2773
USA,United States,TZA,Tanzania,2010,0,1850,-1850
USA,United States,TZA,Tanzania,2011,0,1427,-1427
USA,United States,TZA,Tanzania,2012,0,1516,-1516
USA,United States,TZA,Tanzania,2013,0,837,-837
USA,United States,TZA,Tanzania,2014,0,774,-774
USA,United States,TZA,Tanzania,2015,0,799,-799
USA,United States,TZA,Tanzania,2016,0,788,-788
USA,United States,TZA,Tanzania,2017,0,1415,-1415
CHL,Chile,TZA,Tanzania,2008,0,0,0
CHL,Chile,TZA,Tanzania,2009,0,0,0
CHL,Chile,TZA,Tanzania,2010,0,0,0
CHL,Chile,TZA,Tanzania,2011,0,1,-1
CHL,Chile,TZA,Tanzania,2012,0,0,0
CHL,Chile,TZA,Tanzania,2013,0,19,-19
CHL,Chile,TZA,Tanzania,2014,0,0,0
CHL,Chile,TZA,Tanzania,2015,0,0,0
CHL,Chile,TZA,Tanzania,2016,0,0,0
EST,Estonia,TZA,Tanzania,2008,0,2,-2
EST,Estonia,TZA,Tanzania,2009,0,0,0
EST,Estonia,TZA,Tanzania,2010,0,0,0
EST,Estonia,TZA,Tanzania,2011,0,2,-2
EST,Estonia,TZA,Tanzania,2012,0,1,-1
EST,Estonia,TZA,Tanzania,2013,0,0,0
EST,Estonia,TZA,Tanzania,2014,0,0,0
EST,Estonia,TZA,Tanzania,2015,0,1,-1
EST,Estonia,TZA,Tanzania,2016,0,0,0
EST,Estonia,TZA,Tanzania,2017,0,0,0
SVN,Slovenia,TZA,Tanzania,2013,0,2,-2
SVN,Slovenia,TZA,Tanzania,2014,0,1,-1
SVN,Slovenia,TZA,Tanzania,2015,0,1,-1
AUS,Australia,THA,Thailand,2008,345,2671,-2326
AUS,Australia,THA,Thailand,2009,300,2738,-2438
AUS,Australia,THA,Thailand,2010,352,2557,-2205
AUS,Australia,THA,Thailand,2011,417,2475,-2058
AUS,Australia,THA,Thailand,2012,424,2655,-2231
AUS,Australia,THA,Thailand,2013,511,3141,-2630
AUS,Australia,THA,Thailand,2014,504,2693,-2189
AUS,Australia,THA,Thailand,2015,500,2523,-2023
AUS,Australia,THA,Thailand,2016,500,2815,-2315
AUS,Australia,THA,Thailand,2017,0,2680,-2680
AUT,Austria,THA,Thailand,2008,161,351,-190
AUT,Austria,THA,Thailand,2009,173,344,-171
AUT,Austria,THA,Thailand,2010,186,347,-161
AUT,Austria,THA,Thailand,2011,207,369,-162
AUT,Austria,THA,Thailand,2012,189,345,-156
AUT,Austria,THA,Thailand,2013,182,331,-149
AUT,Austria,THA,Thailand,2014,206,364,-158
AUT,Austria,THA,Thailand,2015,321,586,-265
AUT,Austria,THA,Thailand,2016,326,360,-34
AUT,Austria,THA,Thailand,2017,218,339,-121
BEL,Belgium,THA,Thailand,2008,175,613,-438
BEL,Belgium,THA,Thailand,2009,183,602,-419
BEL,Belgium,THA,Thailand,2010,202,685,-483
BEL,Belgium,THA,Thailand,2011,226,580,-354
BEL,Belgium,THA,Thailand,2012,214,442,-228
BEL,Belgium,THA,Thailand,2013,210,447,-237
BEL,Belgium,THA,Thailand,2014,143,349,-206
BEL,Belgium,THA,Thailand,2015,108,425,-317
BEL,Belgium,THA,Thailand,2016,91,366,-275
BEL,Belgium,THA,Thailand,2017,98,409,-311
CAN,Canada,THA,Thailand,2008,0,519,-519
CAN,Canada,THA,Thailand,2009,0,512,-512
CAN,Canada,THA,Thailand,2010,0,499,-499
CAN,Canada,THA,Thailand,2011,0,396,-396
CAN,Canada,THA,Thailand,2012,0,296,-296
CAN,Canada,THA,Thailand,2013,0,400,-400
CAN,Canada,THA,Thailand,2014,0,608,-608
CAN,Canada,THA,Thailand,2015,0,484,-484
CAN,Canada,THA,Thailand,2016,0,460,-460
CAN,Canada,THA,Thailand,2017,0,600,-600
CZE,Czech Republic,THA,Thailand,2008,0,175,-175
CZE,Czech Republic,THA,Thailand,2009,0,122,-122
CZE,Czech Republic,THA,Thailand,2010,0,129,-129
CZE,Czech Republic,THA,Thailand,2011,0,90,-90
CZE,Czech Republic,THA,Thailand,2012,53,111,-58
CZE,Czech Republic,THA,Thailand,2013,166,150,16
CZE,Czech Republic,THA,Thailand,2014,90,269,-179
CZE,Czech Republic,THA,Thailand,2015,120,130,-10
CZE,Czech Republic,THA,Thailand,2016,93,233,-140
CZE,Czech Republic,THA,Thailand,2017,115,199,-84
DNK,Denmark,THA,Thailand,2008,116,692,-576
DNK,Denmark,THA,Thailand,2009,159,660,-501
DNK,Denmark,THA,Thailand,2010,183,806,-623
DNK,Denmark,THA,Thailand,2011,209,454,-245
DNK,Denmark,THA,Thailand,2012,213,457,-244
DNK,Denmark,THA,Thailand,2013,170,617,-447
DNK,Denmark,THA,Thailand,2014,206,490,-284
DNK,Denmark,THA,Thailand,2015,168,484,-316
DNK,Denmark,THA,Thailand,2016,186,438,-252
DNK,Denmark,THA,Thailand,2017,220,533,-313
FIN,Finland,THA,Thailand,2008,47,562,-515
FIN,Finland,THA,Thailand,2009,28,628,-600
FIN,Finland,THA,Thailand,2010,30,599,-569
FIN,Finland,THA,Thailand,2011,46,625,-579
FIN,Finland,THA,Thailand,2012,43,589,-546
FIN,Finland,THA,Thailand,2013,39,602,-563
FIN,Finland,THA,Thailand,2014,43,552,-509
FIN,Finland,THA,Thailand,2015,49,576,-527
FIN,Finland,THA,Thailand,2016,60,511,-451
FIN,Finland,THA,Thailand,2017,72,390,-318
FRA,France,THA,Thailand,2008,0,818,-818
FRA,France,THA,Thailand,2009,0,951,-951
FRA,France,THA,Thailand,2010,0,832,-832
FRA,France,THA,Thailand,2011,0,807,-807
FRA,France,THA,Thailand,2012,0,827,-827
FRA,France,THA,Thailand,2013,0,839,-839
FRA,France,THA,Thailand,2014,0,832,-832
FRA,France,THA,Thailand,2015,0,847,-847
FRA,France,THA,Thailand,2016,0,900,-900
FRA,France,THA,Thailand,2017,0,851,-851
DEU,Germany,THA,Thailand,2008,2843,3153,-310
DEU,Germany,THA,Thailand,2009,3000,3394,-394
DEU,Germany,THA,Thailand,2010,2716,3342,-626
DEU,Germany,THA,Thailand,2011,2167,3192,-1025
DEU,Germany,THA,Thailand,2012,2114,3256,-1142
DEU,Germany,THA,Thailand,2013,2241,3219,-978
DEU,Germany,THA,Thailand,2014,2277,3075,-798
DEU,Germany,THA,Thailand,2015,2181,3223,-1042
DEU,Germany,THA,Thailand,2016,2184,3442,-1258
DEU,Germany,THA,Thailand,2017,1867,3354,-1487
HUN,Hungary,THA,Thailand,2008,29,211,-182
HUN,Hungary,THA,Thailand,2009,38,155,-117
HUN,Hungary,THA,Thailand,2010,45,190,-145
HUN,Hungary,THA,Thailand,2011,28,201,-173
HUN,Hungary,THA,Thailand,2012,58,201,-143
HUN,Hungary,THA,Thailand,2013,63,211,-148
HUN,Hungary,THA,Thailand,2014,60,247,-187
HUN,Hungary,THA,Thailand,2015,73,266,-193
HUN,Hungary,THA,Thailand,2016,75,226,-151
HUN,Hungary,THA,Thailand,2017,0,339,-339
ISL,Iceland,THA,Thailand,2008,26,92,-66
ISL,Iceland,THA,Thailand,2009,43,41,2
ISL,Iceland,THA,Thailand,2010,19,49,-30
ISL,Iceland,THA,Thailand,2011,15,38,-23
ISL,Iceland,THA,Thailand,2012,14,35,-21
ISL,Iceland,THA,Thailand,2013,19,54,-35
ISL,Iceland,THA,Thailand,2014,9,38,-29
ISL,Iceland,THA,Thailand,2015,10,47,-37
ISL,Iceland,THA,Thailand,2016,17,58,-41
ISL,Iceland,THA,Thailand,2017,10,59,-49
ITA,Italy,THA,Thailand,2008,43,572,-529
ITA,Italy,THA,Thailand,2009,53,612,-559
ITA,Italy,THA,Thailand,2010,58,621,-563
ITA,Italy,THA,Thailand,2011,37,604,-567
ITA,Italy,THA,Thailand,2012,58,540,-482
ITA,Italy,THA,Thailand,2013,77,464,-387
ITA,Italy,THA,Thailand,2014,85,390,-305
ITA,Italy,THA,Thailand,2015,78,393,-315
ITA,Italy,THA,Thailand,2016,0,437,-437
ITA,Italy,THA,Thailand,2017,57,417,-360
JPN,Japan,THA,Thailand,2008,8321,10484,-2163
JPN,Japan,THA,Thailand,2009,8570,9904,-1334
JPN,Japan,THA,Thailand,2010,10171,10868,-697
JPN,Japan,THA,Thailand,2011,8748,13620,-4872
JPN,Japan,THA,Thailand,2012,16721,15362,1359
JPN,Japan,THA,Thailand,2013,13375,15431,-2056
JPN,Japan,THA,Thailand,2014,11233,14309,-3076
JPN,Japan,THA,Thailand,2015,11257,14509,-3252
JPN,Japan,THA,Thailand,2016,12279,15448,-3169
JPN,Japan,THA,Thailand,2017,13147,16372,-3225
KOR,Korea,THA,Thailand,2008,10200,8621,1579
KOR,Korea,THA,Thailand,2009,9631,5804,3827
KOR,Korea,THA,Thailand,2010,7904,6884,1020
KOR,Korea,THA,Thailand,2011,10217,10340,-123
KOR,Korea,THA,Thailand,2012,14565,13771,794
KOR,Korea,THA,Thailand,2013,9423,18335,-8912
KOR,Korea,THA,Thailand,2014,12658,48326,-35668
KOR,Korea,THA,Thailand,2015,20946,20122,824
KOR,Korea,THA,Thailand,2016,22392,28457,-6065
KOR,Korea,THA,Thailand,2017,22740,71506,-48766
LUX,Luxembourg,THA,Thailand,2008,5,16,-11
LUX,Luxembourg,THA,Thailand,2009,4,34,-30
LUX,Luxembourg,THA,Thailand,2010,10,34,-24
LUX,Luxembourg,THA,Thailand,2011,10,25,-15
LUX,Luxembourg,THA,Thailand,2012,7,31,-24
LUX,Luxembourg,THA,Thailand,2013,9,30,-21
LUX,Luxembourg,THA,Thailand,2014,7,25,-18
LUX,Luxembourg,THA,Thailand,2015,15,37,-22
LUX,Luxembourg,THA,Thailand,2016,17,33,-16
LUX,Luxembourg,THA,Thailand,2017,16,37,-21
MEX,Mexico,THA,Thailand,2008,0,9,-9
MEX,Mexico,THA,Thailand,2009,0,17,-17
MEX,Mexico,THA,Thailand,2010,0,7,-7
MEX,Mexico,THA,Thailand,2011,0,5,-5
MEX,Mexico,THA,Thailand,2012,0,5,-5
MEX,Mexico,THA,Thailand,2013,0,25,-25
MEX,Mexico,THA,Thailand,2014,0,18,-18
MEX,Mexico,THA,Thailand,2015,0,11,-11
MEX,Mexico,THA,Thailand,2016,0,11,-11
MEX,Mexico,THA,Thailand,2017,0,7,-7
NLD,Netherlands,THA,Thailand,2008,279,769,-490
NLD,Netherlands,THA,Thailand,2009,271,755,-484
NLD,Netherlands,THA,Thailand,2010,305,742,-437
NLD,Netherlands,THA,Thailand,2011,286,733,-447
NLD,Netherlands,THA,Thailand,2012,313,667,-354
NLD,Netherlands,THA,Thailand,2013,347,584,-237
NLD,Netherlands,THA,Thailand,2014,319,557,-238
NLD,Netherlands,THA,Thailand,2015,341,586,-245
NLD,Netherlands,THA,Thailand,2016,307,646,-339
NLD,Netherlands,THA,Thailand,2017,279,659,-380
NZL,New Zealand,THA,Thailand,2008,279,704,-425
NZL,New Zealand,THA,Thailand,2009,276,681,-405
NZL,New Zealand,THA,Thailand,2010,257,740,-483
NZL,New Zealand,THA,Thailand,2011,273,702,-429
NZL,New Zealand,THA,Thailand,2012,312,707,-395
NZL,New Zealand,THA,Thailand,2013,255,678,-423
NZL,New Zealand,THA,Thailand,2014,210,638,-428
NZL,New Zealand,THA,Thailand,2015,191,763,-572
NZL,New Zealand,THA,Thailand,2016,182,890,-708
NZL,New Zealand,THA,Thailand,2017,326,703,-377
NOR,Norway,THA,Thailand,2008,140,1317,-1177
NOR,Norway,THA,Thailand,2009,141,1308,-1167
NOR,Norway,THA,Thailand,2010,206,1171,-965
NOR,Norway,THA,Thailand,2011,246,1249,-1003
NOR,Norway,THA,Thailand,2012,195,1286,-1091
NOR,Norway,THA,Thailand,2013,221,1092,-871
NOR,Norway,THA,Thailand,2014,233,848,-615
NOR,Norway,THA,Thailand,2015,216,1007,-791
NOR,Norway,THA,Thailand,2016,236,1377,-1141
NOR,Norway,THA,Thailand,2017,195,1073,-878
POL,Poland,THA,Thailand,2008,0,920,-920
POL,Poland,THA,Thailand,2009,0,242,-242
POL,Poland,THA,Thailand,2010,0,207,-207
POL,Poland,THA,Thailand,2011,0,154,-154
POL,Poland,THA,Thailand,2012,0,164,-164
POL,Poland,THA,Thailand,2013,0,183,-183
POL,Poland,THA,Thailand,2014,0,94,-94
POL,Poland,THA,Thailand,2015,0,222,-222
POL,Poland,THA,Thailand,2016,0,208,-208
POL,Poland,THA,Thailand,2017,0,264,-264
PRT,Portugal,THA,Thailand,2008,0,105,-105
PRT,Portugal,THA,Thailand,2009,0,226,-226
PRT,Portugal,THA,Thailand,2010,0,298,-298
PRT,Portugal,THA,Thailand,2011,0,246,-246
PRT,Portugal,THA,Thailand,2012,0,116,-116
PRT,Portugal,THA,Thailand,2013,0,137,-137
PRT,Portugal,THA,Thailand,2014,0,264,-264
PRT,Portugal,THA,Thailand,2015,0,396,-396
PRT,Portugal,THA,Thailand,2016,0,297,-297
PRT,Portugal,THA,Thailand,2017,0,350,-350
SVK,Slovak Republic,THA,Thailand,2008,2,4,-2
SVK,Slovak Republic,THA,Thailand,2009,15,2,13
SVK,Slovak Republic,THA,Thailand,2010,14,2,12
SVK,Slovak Republic,THA,Thailand,2011,14,2,12
SVK,Slovak Republic,THA,Thailand,2012,0,5,-5
SVK,Slovak Republic,THA,Thailand,2013,0,6,-6
SVK,Slovak Republic,THA,Thailand,2014,1,7,-6
SVK,Slovak Republic,THA,Thailand,2015,0,5,-5
SVK,Slovak Republic,THA,Thailand,2016,0,5,-5
SVK,Slovak Republic,THA,Thailand,2017,0,8,-8
ESP,Spain,THA,Thailand,2008,240,237,3
ESP,Spain,THA,Thailand,2009,69,154,-85
ESP,Spain,THA,Thailand,2010,45,141,-96
ESP,Spain,THA,Thailand,2011,70,162,-92
ESP,Spain,THA,Thailand,2012,54,214,-160
ESP,Spain,THA,Thailand,2013,74,171,-97
ESP,Spain,THA,Thailand,2014,66,179,-113
ESP,Spain,THA,Thailand,2015,50,156,-106
ESP,Spain,THA,Thailand,2016,60,190,-130
ESP,Spain,THA,Thailand,2017,87,212,-125
SWE,Sweden,THA,Thailand,2008,184,3060,-2876
SWE,Sweden,THA,Thailand,2009,166,2994,-2828
SWE,Sweden,THA,Thailand,2010,200,2775,-2575
SWE,Sweden,THA,Thailand,2011,301,2533,-2232
SWE,Sweden,THA,Thailand,2012,364,2331,-1967
SWE,Sweden,THA,Thailand,2013,348,1771,-1423
SWE,Sweden,THA,Thailand,2014,423,1587,-1164
SWE,Sweden,THA,Thailand,2015,603,1274,-671
SWE,Sweden,THA,Thailand,2016,279,1359,-1080
SWE,Sweden,THA,Thailand,2017,195,1534,-1339
CHE,Switzerland,THA,Thailand,2010,437,877,-440
CHE,Switzerland,THA,Thailand,2011,427,934,-507
CHE,Switzerland,THA,Thailand,2012,387,857,-470
CHE,Switzerland,THA,Thailand,2013,405,864,-459
CHE,Switzerland,THA,Thailand,2014,412,748,-336
CHE,Switzerland,THA,Thailand,2015,357,885,-528
CHE,Switzerland,THA,Thailand,2016,394,839,-445
CHE,Switzerland,THA,Thailand,2017,399,852,-453
TUR,Turkey,THA,Thailand,2010,0,110,-110
TUR,Turkey,THA,Thailand,2016,359,366,-7
TUR,Turkey,THA,Thailand,2017,271,446,-175
GBR,United Kingdom,THA,Thailand,2008,1000,4000,-3000
GBR,United Kingdom,THA,Thailand,2009,2000,4000,-2000
GBR,United Kingdom,THA,Thailand,2010,2000,6000,-4000
GBR,United Kingdom,THA,Thailand,2011,1000,3000,-2000
GBR,United Kingdom,THA,Thailand,2012,3000,4000,-1000
GBR,United Kingdom,THA,Thailand,2013,1000,4000,-3000
GBR,United Kingdom,THA,Thailand,2014,1000,3000,-2000
GBR,United Kingdom,THA,Thailand,2015,2000,6000,-4000
USA,United States,THA,Thailand,2008,0,6637,-6637
USA,United States,THA,Thailand,2009,0,10444,-10444
USA,United States,THA,Thailand,2010,0,9384,-9384
USA,United States,THA,Thailand,2011,0,9962,-9962
USA,United States,THA,Thailand,2012,0,9459,-9459
USA,United States,THA,Thailand,2013,0,7583,-7583
USA,United States,THA,Thailand,2014,0,6197,-6197
USA,United States,THA,Thailand,2015,0,7502,-7502
USA,United States,THA,Thailand,2016,0,7039,-7039
USA,United States,THA,Thailand,2017,0,6311,-6311
CHL,Chile,THA,Thailand,2008,0,13,-13
CHL,Chile,THA,Thailand,2009,0,9,-9
CHL,Chile,THA,Thailand,2010,0,10,-10
CHL,Chile,THA,Thailand,2011,0,4,-4
CHL,Chile,THA,Thailand,2012,0,9,-9
CHL,Chile,THA,Thailand,2013,0,16,-16
CHL,Chile,THA,Thailand,2014,0,10,-10
CHL,Chile,THA,Thailand,2015,0,11,-11
CHL,Chile,THA,Thailand,2016,0,23,-23
EST,Estonia,THA,Thailand,2008,0,3,-3
EST,Estonia,THA,Thailand,2009,0,4,-4
EST,Estonia,THA,Thailand,2010,0,3,-3
EST,Estonia,THA,Thailand,2011,0,5,-5
EST,Estonia,THA,Thailand,2012,0,14,-14
EST,Estonia,THA,Thailand,2013,0,5,-5
EST,Estonia,THA,Thailand,2014,0,5,-5
EST,Estonia,THA,Thailand,2015,0,5,-5
EST,Estonia,THA,Thailand,2016,0,18,-18
EST,Estonia,THA,Thailand,2017,0,22,-22
SVN,Slovenia,THA,Thailand,2008,0,72,-72
SVN,Slovenia,THA,Thailand,2009,0,31,-31
SVN,Slovenia,THA,Thailand,2010,0,36,-36
SVN,Slovenia,THA,Thailand,2011,12,51,-39
SVN,Slovenia,THA,Thailand,2012,5,21,-16
SVN,Slovenia,THA,Thailand,2013,0,17,-17
SVN,Slovenia,THA,Thailand,2014,3,23,-20
SVN,Slovenia,THA,Thailand,2015,4,40,-36
SVN,Slovenia,THA,Thailand,2016,8,32,-24
SVN,Slovenia,THA,Thailand,2017,2,47,-45
AUS,Australia,TLS,Timor-Leste,2008,42,47,-5
AUS,Australia,TLS,Timor-Leste,2009,50,36,14
AUS,Australia,TLS,Timor-Leste,2010,62,33,29
AUS,Australia,TLS,Timor-Leste,2011,42,28,14
AUS,Australia,TLS,Timor-Leste,2012,30,21,9
AUS,Australia,TLS,Timor-Leste,2013,40,16,24
AUS,Australia,TLS,Timor-Leste,2014,29,35,-6
AUS,Australia,TLS,Timor-Leste,2015,0,13,-13
AUS,Australia,TLS,Timor-Leste,2016,0,23,-23
AUS,Australia,TLS,Timor-Leste,2017,0,22,-22
AUT,Austria,TLS,Timor-Leste,2008,0,0,0
AUT,Austria,TLS,Timor-Leste,2009,0,0,0
AUT,Austria,TLS,Timor-Leste,2010,0,0,0
AUT,Austria,TLS,Timor-Leste,2011,0,0,0
AUT,Austria,TLS,Timor-Leste,2012,0,0,0
AUT,Austria,TLS,Timor-Leste,2013,0,0,0
AUT,Austria,TLS,Timor-Leste,2014,0,0,0
AUT,Austria,TLS,Timor-Leste,2015,0,0,0
AUT,Austria,TLS,Timor-Leste,2016,0,0,0
AUT,Austria,TLS,Timor-Leste,2017,0,1,-1
BEL,Belgium,TLS,Timor-Leste,2008,0,0,0
BEL,Belgium,TLS,Timor-Leste,2009,0,0,0
BEL,Belgium,TLS,Timor-Leste,2010,0,3,-3
BEL,Belgium,TLS,Timor-Leste,2015,1,1,0
BEL,Belgium,TLS,Timor-Leste,2016,0,1,-1
BEL,Belgium,TLS,Timor-Leste,2017,0,2,-2
CAN,Canada,TLS,Timor-Leste,2008,0,0,0
CAN,Canada,TLS,Timor-Leste,2009,0,0,0
CAN,Canada,TLS,Timor-Leste,2010,0,0,0
CAN,Canada,TLS,Timor-Leste,2011,0,0,0
CAN,Canada,TLS,Timor-Leste,2012,0,0,0
CAN,Canada,TLS,Timor-Leste,2013,0,0,0
CAN,Canada,TLS,Timor-Leste,2014,0,1,-1
CAN,Canada,TLS,Timor-Leste,2015,0,0,0
CAN,Canada,TLS,Timor-Leste,2016,0,0,0
CAN,Canada,TLS,Timor-Leste,2017,0,0,0
DNK,Denmark,TLS,Timor-Leste,2014,0,0,0
DNK,Denmark,TLS,Timor-Leste,2015,0,0,0
DNK,Denmark,TLS,Timor-Leste,2016,0,0,0
DNK,Denmark,TLS,Timor-Leste,2017,0,0,0
FIN,Finland,TLS,Timor-Leste,2008,0,0,0
FIN,Finland,TLS,Timor-Leste,2009,0,0,0
FIN,Finland,TLS,Timor-Leste,2010,0,0,0
FIN,Finland,TLS,Timor-Leste,2011,0,0,0
FIN,Finland,TLS,Timor-Leste,2012,0,0,0
FIN,Finland,TLS,Timor-Leste,2013,0,0,0
FIN,Finland,TLS,Timor-Leste,2014,0,0,0
FIN,Finland,TLS,Timor-Leste,2015,0,0,0
FIN,Finland,TLS,Timor-Leste,2016,0,0,0
FIN,Finland,TLS,Timor-Leste,2017,0,0,0
FRA,France,TLS,Timor-Leste,2008,0,0,0
FRA,France,TLS,Timor-Leste,2009,0,0,0
FRA,France,TLS,Timor-Leste,2010,0,0,0
FRA,France,TLS,Timor-Leste,2011,0,0,0
FRA,France,TLS,Timor-Leste,2012,0,0,0
FRA,France,TLS,Timor-Leste,2013,0,0,0
FRA,France,TLS,Timor-Leste,2014,0,0,0
FRA,France,TLS,Timor-Leste,2015,0,0,0
FRA,France,TLS,Timor-Leste,2016,0,2,-2
FRA,France,TLS,Timor-Leste,2017,0,1,-1
DEU,Germany,TLS,Timor-Leste,2008,3,2,1
DEU,Germany,TLS,Timor-Leste,2009,3,4,-1
DEU,Germany,TLS,Timor-Leste,2010,0,0,0
DEU,Germany,TLS,Timor-Leste,2011,0,1,-1
DEU,Germany,TLS,Timor-Leste,2012,1,1,0
DEU,Germany,TLS,Timor-Leste,2013,0,0,0
DEU,Germany,TLS,Timor-Leste,2014,1,1,0
DEU,Germany,TLS,Timor-Leste,2015,0,1,-1
DEU,Germany,TLS,Timor-Leste,2016,0,1,-1
DEU,Germany,TLS,Timor-Leste,2017,1,2,-1
HUN,Hungary,TLS,Timor-Leste,2008,0,0,0
HUN,Hungary,TLS,Timor-Leste,2009,0,0,0
HUN,Hungary,TLS,Timor-Leste,2010,0,0,0
HUN,Hungary,TLS,Timor-Leste,2011,0,0,0
HUN,Hungary,TLS,Timor-Leste,2012,0,0,0
HUN,Hungary,TLS,Timor-Leste,2013,0,0,0
HUN,Hungary,TLS,Timor-Leste,2014,0,0,0
HUN,Hungary,TLS,Timor-Leste,2015,0,0,0
HUN,Hungary,TLS,Timor-Leste,2016,0,0,0
HUN,Hungary,TLS,Timor-Leste,2017,0,0,0
ISL,Iceland,TLS,Timor-Leste,2008,0,0,0
ISL,Iceland,TLS,Timor-Leste,2009,0,0,0
ISL,Iceland,TLS,Timor-Leste,2010,0,0,0
ISL,Iceland,TLS,Timor-Leste,2011,0,0,0
ISL,Iceland,TLS,Timor-Leste,2012,0,0,0
ISL,Iceland,TLS,Timor-Leste,2013,0,0,0
ISL,Iceland,TLS,Timor-Leste,2014,0,1,-1
ISL,Iceland,TLS,Timor-Leste,2015,1,0,1
ISL,Iceland,TLS,Timor-Leste,2016,0,0,0
ISL,Iceland,TLS,Timor-Leste,2017,0,0,0
ITA,Italy,TLS,Timor-Leste,2008,0,2,-2
ITA,Italy,TLS,Timor-Leste,2009,0,1,-1
ITA,Italy,TLS,Timor-Leste,2010,0,5,-5
ITA,Italy,TLS,Timor-Leste,2011,0,6,-6
ITA,Italy,TLS,Timor-Leste,2012,1,10,-9
ITA,Italy,TLS,Timor-Leste,2013,0,12,-12
ITA,Italy,TLS,Timor-Leste,2014,0,105,-105
ITA,Italy,TLS,Timor-Leste,2015,2,27,-25
ITA,Italy,TLS,Timor-Leste,2016,0,11,-11
ITA,Italy,TLS,Timor-Leste,2017,0,15,-15
JPN,Japan,TLS,Timor-Leste,2008,85,84,1
JPN,Japan,TLS,Timor-Leste,2009,123,126,-3
JPN,Japan,TLS,Timor-Leste,2010,120,125,-5
JPN,Japan,TLS,Timor-Leste,2011,110,109,1
JPN,Japan,TLS,Timor-Leste,2012,147,160,-13
JPN,Japan,TLS,Timor-Leste,2013,108,110,-2
JPN,Japan,TLS,Timor-Leste,2014,151,159,-8
JPN,Japan,TLS,Timor-Leste,2015,156,147,9
JPN,Japan,TLS,Timor-Leste,2016,160,166,-6
JPN,Japan,TLS,Timor-Leste,2017,158,166,-8
KOR,Korea,TLS,Timor-Leste,2008,20,11,9
KOR,Korea,TLS,Timor-Leste,2009,2,99,-97
KOR,Korea,TLS,Timor-Leste,2010,11,348,-337
KOR,Korea,TLS,Timor-Leste,2011,30,186,-156
KOR,Korea,TLS,Timor-Leste,2012,86,498,-412
KOR,Korea,TLS,Timor-Leste,2013,104,285,-181
KOR,Korea,TLS,Timor-Leste,2014,158,265,-107
KOR,Korea,TLS,Timor-Leste,2015,254,442,-188
KOR,Korea,TLS,Timor-Leste,2016,242,546,-304
KOR,Korea,TLS,Timor-Leste,2017,301,352,-51
LUX,Luxembourg,TLS,Timor-Leste,2008,0,0,0
LUX,Luxembourg,TLS,Timor-Leste,2009,0,0,0
LUX,Luxembourg,TLS,Timor-Leste,2010,0,0,0
LUX,Luxembourg,TLS,Timor-Leste,2011,0,0,0
LUX,Luxembourg,TLS,Timor-Leste,2012,0,0,0
LUX,Luxembourg,TLS,Timor-Leste,2013,0,0,0
LUX,Luxembourg,TLS,Timor-Leste,2014,0,0,0
LUX,Luxembourg,TLS,Timor-Leste,2015,0,0,0
LUX,Luxembourg,TLS,Timor-Leste,2016,0,0,0
LUX,Luxembourg,TLS,Timor-Leste,2017,0,0,0
MEX,Mexico,TLS,Timor-Leste,2012,0,0,0
MEX,Mexico,TLS,Timor-Leste,2013,0,1,-1
MEX,Mexico,TLS,Timor-Leste,2014,0,0,0
MEX,Mexico,TLS,Timor-Leste,2016,0,1,-1
NZL,New Zealand,TLS,Timor-Leste,2008,2,5,-3
NZL,New Zealand,TLS,Timor-Leste,2009,0,10,-10
NZL,New Zealand,TLS,Timor-Leste,2010,3,23,-20
NZL,New Zealand,TLS,Timor-Leste,2011,4,16,-12
NZL,New Zealand,TLS,Timor-Leste,2012,29,30,-1
NZL,New Zealand,TLS,Timor-Leste,2013,18,22,-4
NZL,New Zealand,TLS,Timor-Leste,2014,5,25,-20
NZL,New Zealand,TLS,Timor-Leste,2015,14,22,-8
NZL,New Zealand,TLS,Timor-Leste,2016,2,16,-14
NZL,New Zealand,TLS,Timor-Leste,2017,13,27,-14
NOR,Norway,TLS,Timor-Leste,2008,0,3,-3
NOR,Norway,TLS,Timor-Leste,2009,0,5,-5
NOR,Norway,TLS,Timor-Leste,2010,0,1,-1
NOR,Norway,TLS,Timor-Leste,2011,6,1,5
NOR,Norway,TLS,Timor-Leste,2012,3,2,1
NOR,Norway,TLS,Timor-Leste,2013,2,10,-8
NOR,Norway,TLS,Timor-Leste,2014,3,0,3
NOR,Norway,TLS,Timor-Leste,2015,7,1,6
NOR,Norway,TLS,Timor-Leste,2016,0,1,-1
NOR,Norway,TLS,Timor-Leste,2017,0,0,0
POL,Poland,TLS,Timor-Leste,2009,0,0,0
POL,Poland,TLS,Timor-Leste,2010,0,0,0
POL,Poland,TLS,Timor-Leste,2011,0,0,0
POL,Poland,TLS,Timor-Leste,2012,0,0,0
POL,Poland,TLS,Timor-Leste,2013,0,0,0
POL,Poland,TLS,Timor-Leste,2014,0,0,0
POL,Poland,TLS,Timor-Leste,2015,0,0,0
POL,Poland,TLS,Timor-Leste,2016,0,1,-1
POL,Poland,TLS,Timor-Leste,2017,0,0,0
SVK,Slovak Republic,TLS,Timor-Leste,2008,0,0,0
ESP,Spain,TLS,Timor-Leste,2008,1,1,0
ESP,Spain,TLS,Timor-Leste,2009,0,0,0
ESP,Spain,TLS,Timor-Leste,2010,0,0,0
ESP,Spain,TLS,Timor-Leste,2011,0,1,-1
ESP,Spain,TLS,Timor-Leste,2012,0,1,-1
ESP,Spain,TLS,Timor-Leste,2013,0,0,0
ESP,Spain,TLS,Timor-Leste,2014,0,2,-2
ESP,Spain,TLS,Timor-Leste,2015,0,1,-1
ESP,Spain,TLS,Timor-Leste,2016,0,3,-3
ESP,Spain,TLS,Timor-Leste,2017,0,1,-1
SWE,Sweden,TLS,Timor-Leste,2008,0,0,0
SWE,Sweden,TLS,Timor-Leste,2009,0,0,0
SWE,Sweden,TLS,Timor-Leste,2010,0,0,0
SWE,Sweden,TLS,Timor-Leste,2011,0,0,0
SWE,Sweden,TLS,Timor-Leste,2012,0,0,0
SWE,Sweden,TLS,Timor-Leste,2013,0,0,0
SWE,Sweden,TLS,Timor-Leste,2014,0,1,-1
SWE,Sweden,TLS,Timor-Leste,2015,0,0,0
SWE,Sweden,TLS,Timor-Leste,2016,0,0,0
SWE,Sweden,TLS,Timor-Leste,2017,0,2,-2
CHE,Switzerland,TLS,Timor-Leste,2010,0,0,0
CHE,Switzerland,TLS,Timor-Leste,2011,0,0,0
CHE,Switzerland,TLS,Timor-Leste,2012,0,0,0
CHE,Switzerland,TLS,Timor-Leste,2013,0,0,0
USA,United States,TLS,Timor-Leste,2015,0,3,-3
USA,United States,TLS,Timor-Leste,2017,0,1,-1
CHL,Chile,TLS,Timor-Leste,2008,0,0,0
CHL,Chile,TLS,Timor-Leste,2009,0,0,0
CHL,Chile,TLS,Timor-Leste,2010,0,0,0
CHL,Chile,TLS,Timor-Leste,2011,0,0,0
CHL,Chile,TLS,Timor-Leste,2012,0,0,0
CHL,Chile,TLS,Timor-Leste,2013,0,0,0
CHL,Chile,TLS,Timor-Leste,2014,0,0,0
CHL,Chile,TLS,Timor-Leste,2015,0,0,0
CHL,Chile,TLS,Timor-Leste,2016,0,0,0
EST,Estonia,TLS,Timor-Leste,2008,0,0,0
EST,Estonia,TLS,Timor-Leste,2009,0,0,0
EST,Estonia,TLS,Timor-Leste,2010,0,0,0
EST,Estonia,TLS,Timor-Leste,2011,0,0,0
EST,Estonia,TLS,Timor-Leste,2012,0,0,0
EST,Estonia,TLS,Timor-Leste,2013,0,0,0
EST,Estonia,TLS,Timor-Leste,2014,0,0,0
EST,Estonia,TLS,Timor-Leste,2015,0,0,0
EST,Estonia,TLS,Timor-Leste,2016,0,0,0
EST,Estonia,TLS,Timor-Leste,2017,0,0,0
AUS,Australia,TGO,Togo,2008,0,141,-141
AUS,Australia,TGO,Togo,2009,0,57,-57
AUS,Australia,TGO,Togo,2010,0,66,-66
AUS,Australia,TGO,Togo,2011,0,76,-76
AUS,Australia,TGO,Togo,2012,0,15,-15
AUS,Australia,TGO,Togo,2013,0,7,-7
AUS,Australia,TGO,Togo,2014,0,17,-17
AUS,Australia,TGO,Togo,2015,0,0,0
AUS,Australia,TGO,Togo,2017,0,3,-3
AUT,Austria,TGO,Togo,2008,5,13,-8
AUT,Austria,TGO,Togo,2009,5,1,4
AUT,Austria,TGO,Togo,2010,5,7,-2
AUT,Austria,TGO,Togo,2011,4,7,-3
AUT,Austria,TGO,Togo,2012,4,9,-5
AUT,Austria,TGO,Togo,2013,3,10,-7
AUT,Austria,TGO,Togo,2014,6,8,-2
AUT,Austria,TGO,Togo,2015,4,10,-6
AUT,Austria,TGO,Togo,2016,12,16,-4
AUT,Austria,TGO,Togo,2017,8,7,1
BEL,Belgium,TGO,Togo,2008,0,182,-182
BEL,Belgium,TGO,Togo,2009,0,225,-225
BEL,Belgium,TGO,Togo,2010,34,213,-179
BEL,Belgium,TGO,Togo,2011,0,225,-225
BEL,Belgium,TGO,Togo,2012,95,349,-254
BEL,Belgium,TGO,Togo,2013,169,348,-179
BEL,Belgium,TGO,Togo,2014,222,230,-8
BEL,Belgium,TGO,Togo,2015,139,317,-178
BEL,Belgium,TGO,Togo,2016,91,275,-184
BEL,Belgium,TGO,Togo,2017,71,242,-171
CAN,Canada,TGO,Togo,2008,0,351,-351
CAN,Canada,TGO,Togo,2009,0,400,-400
CAN,Canada,TGO,Togo,2010,0,354,-354
CAN,Canada,TGO,Togo,2011,0,261,-261
CAN,Canada,TGO,Togo,2012,0,299,-299
CAN,Canada,TGO,Togo,2013,0,315,-315
CAN,Canada,TGO,Togo,2014,0,248,-248
CAN,Canada,TGO,Togo,2015,0,258,-258
CAN,Canada,TGO,Togo,2016,0,245,-245
CAN,Canada,TGO,Togo,2017,0,205,-205
CZE,Czech Republic,TGO,Togo,2008,0,2,-2
CZE,Czech Republic,TGO,Togo,2010,0,1,-1
CZE,Czech Republic,TGO,Togo,2014,0,1,-1
CZE,Czech Republic,TGO,Togo,2015,0,2,-2
CZE,Czech Republic,TGO,Togo,2016,0,2,-2
DNK,Denmark,TGO,Togo,2008,3,5,-2
DNK,Denmark,TGO,Togo,2009,0,5,-5
DNK,Denmark,TGO,Togo,2010,4,6,-2
DNK,Denmark,TGO,Togo,2012,1,2,-1
DNK,Denmark,TGO,Togo,2013,1,5,-4
DNK,Denmark,TGO,Togo,2014,1,6,-5
DNK,Denmark,TGO,Togo,2015,2,2,0
DNK,Denmark,TGO,Togo,2016,1,2,-1
DNK,Denmark,TGO,Togo,2017,2,3,-1
FIN,Finland,TGO,Togo,2008,0,5,-5
FIN,Finland,TGO,Togo,2009,0,4,-4
FIN,Finland,TGO,Togo,2010,0,7,-7
FIN,Finland,TGO,Togo,2011,0,3,-3
FIN,Finland,TGO,Togo,2012,2,6,-4
FIN,Finland,TGO,Togo,2013,0,3,-3
FIN,Finland,TGO,Togo,2014,2,12,-10
FIN,Finland,TGO,Togo,2015,1,5,-4
FIN,Finland,TGO,Togo,2016,0,11,-11
FIN,Finland,TGO,Togo,2017,0,7,-7
FRA,France,TGO,Togo,2008,0,835,-835
FRA,France,TGO,Togo,2009,0,741,-741
FRA,France,TGO,Togo,2010,0,766,-766
FRA,France,TGO,Togo,2011,0,641,-641
FRA,France,TGO,Togo,2012,0,697,-697
FRA,France,TGO,Togo,2013,0,695,-695
FRA,France,TGO,Togo,2014,0,769,-769
FRA,France,TGO,Togo,2015,0,631,-631
FRA,France,TGO,Togo,2016,0,633,-633
FRA,France,TGO,Togo,2017,0,517,-517
DEU,Germany,TGO,Togo,2008,433,394,39
DEU,Germany,TGO,Togo,2009,357,462,-105
DEU,Germany,TGO,Togo,2010,272,426,-154
DEU,Germany,TGO,Togo,2011,258,422,-164
DEU,Germany,TGO,Togo,2012,244,448,-204
DEU,Germany,TGO,Togo,2013,228,439,-211
DEU,Germany,TGO,Togo,2014,252,620,-368
DEU,Germany,TGO,Togo,2015,283,784,-501
DEU,Germany,TGO,Togo,2016,289,825,-536
DEU,Germany,TGO,Togo,2017,243,933,-690
HUN,Hungary,TGO,Togo,2008,0,2,-2
HUN,Hungary,TGO,Togo,2009,0,2,-2
HUN,Hungary,TGO,Togo,2010,1,0,1
HUN,Hungary,TGO,Togo,2011,0,0,0
HUN,Hungary,TGO,Togo,2012,0,2,-2
HUN,Hungary,TGO,Togo,2013,0,1,-1
HUN,Hungary,TGO,Togo,2014,0,1,-1
HUN,Hungary,TGO,Togo,2015,0,1,-1
HUN,Hungary,TGO,Togo,2016,1,1,0
HUN,Hungary,TGO,Togo,2017,0,8,-8
ISL,Iceland,TGO,Togo,2008,0,0,0
ISL,Iceland,TGO,Togo,2009,0,0,0
ISL,Iceland,TGO,Togo,2010,0,0,0
ISL,Iceland,TGO,Togo,2011,0,1,-1
ISL,Iceland,TGO,Togo,2012,0,0,0
ISL,Iceland,TGO,Togo,2013,2,3,-1
ISL,Iceland,TGO,Togo,2014,3,1,2
ISL,Iceland,TGO,Togo,2015,1,1,0
ISL,Iceland,TGO,Togo,2016,0,1,-1
ISL,Iceland,TGO,Togo,2017,0,1,-1
ITA,Italy,TGO,Togo,2008,4,631,-627
ITA,Italy,TGO,Togo,2009,7,453,-446
ITA,Italy,TGO,Togo,2010,17,407,-390
ITA,Italy,TGO,Togo,2011,17,382,-365
ITA,Italy,TGO,Togo,2012,17,514,-497
ITA,Italy,TGO,Togo,2013,21,447,-426
ITA,Italy,TGO,Togo,2014,25,356,-331
ITA,Italy,TGO,Togo,2015,25,358,-333
ITA,Italy,TGO,Togo,2016,0,419,-419
ITA,Italy,TGO,Togo,2017,29,817,-788
JPN,Japan,TGO,Togo,2008,39,39,0
JPN,Japan,TGO,Togo,2009,24,28,-4
JPN,Japan,TGO,Togo,2010,25,26,-1
JPN,Japan,TGO,Togo,2011,47,54,-7
JPN,Japan,TGO,Togo,2012,62,66,-4
JPN,Japan,TGO,Togo,2013,58,59,-1
JPN,Japan,TGO,Togo,2014,21,22,-1
JPN,Japan,TGO,Togo,2015,35,39,-4
JPN,Japan,TGO,Togo,2016,33,37,-4
JPN,Japan,TGO,Togo,2017,24,28,-4
KOR,Korea,TGO,Togo,2008,5,5,0
KOR,Korea,TGO,Togo,2009,4,4,0
KOR,Korea,TGO,Togo,2010,3,2,1
KOR,Korea,TGO,Togo,2011,2,9,-7
KOR,Korea,TGO,Togo,2012,5,6,-1
KOR,Korea,TGO,Togo,2013,12,6,6
KOR,Korea,TGO,Togo,2014,5,13,-8
KOR,Korea,TGO,Togo,2015,11,13,-2
KOR,Korea,TGO,Togo,2016,10,9,1
KOR,Korea,TGO,Togo,2017,11,16,-5
LUX,Luxembourg,TGO,Togo,2008,1,18,-17
LUX,Luxembourg,TGO,Togo,2009,4,20,-16
LUX,Luxembourg,TGO,Togo,2010,6,15,-9
LUX,Luxembourg,TGO,Togo,2011,5,17,-12
LUX,Luxembourg,TGO,Togo,2012,10,12,-2
LUX,Luxembourg,TGO,Togo,2013,2,18,-16
LUX,Luxembourg,TGO,Togo,2014,5,14,-9
LUX,Luxembourg,TGO,Togo,2015,3,21,-18
LUX,Luxembourg,TGO,Togo,2016,3,18,-15
LUX,Luxembourg,TGO,Togo,2017,3,20,-17
MEX,Mexico,TGO,Togo,2008,0,3,-3
MEX,Mexico,TGO,Togo,2009,0,4,-4
MEX,Mexico,TGO,Togo,2010,0,2,-2
MEX,Mexico,TGO,Togo,2011,0,2,-2
MEX,Mexico,TGO,Togo,2012,0,1,-1
MEX,Mexico,TGO,Togo,2013,0,4,-4
MEX,Mexico,TGO,Togo,2014,0,2,-2
MEX,Mexico,TGO,Togo,2015,0,3,-3
MEX,Mexico,TGO,Togo,2016,0,4,-4
MEX,Mexico,TGO,Togo,2017,0,11,-11
NLD,Netherlands,TGO,Togo,2008,2,30,-28
NLD,Netherlands,TGO,Togo,2009,10,32,-22
NLD,Netherlands,TGO,Togo,2010,7,25,-18
NLD,Netherlands,TGO,Togo,2011,3,23,-20
NLD,Netherlands,TGO,Togo,2012,9,24,-15
NLD,Netherlands,TGO,Togo,2013,7,12,-5
NLD,Netherlands,TGO,Togo,2014,7,21,-14
NLD,Netherlands,TGO,Togo,2015,4,8,-4
NLD,Netherlands,TGO,Togo,2016,7,18,-11
NLD,Netherlands,TGO,Togo,2017,-1,17,-18
NZL,New Zealand,TGO,Togo,2012,0,0,0
NZL,New Zealand,TGO,Togo,2014,0,1,-1
NOR,Norway,TGO,Togo,2008,3,7,-4
NOR,Norway,TGO,Togo,2009,1,8,-7
NOR,Norway,TGO,Togo,2010,0,5,-5
NOR,Norway,TGO,Togo,2011,1,1,0
NOR,Norway,TGO,Togo,2012,1,2,-1
NOR,Norway,TGO,Togo,2013,1,2,-1
NOR,Norway,TGO,Togo,2014,0,3,-3
NOR,Norway,TGO,Togo,2015,1,0,1
NOR,Norway,TGO,Togo,2016,1,4,-3
NOR,Norway,TGO,Togo,2017,0,3,-3
POL,Poland,TGO,Togo,2009,0,9,-9
POL,Poland,TGO,Togo,2010,0,7,-7
POL,Poland,TGO,Togo,2011,0,10,-10
POL,Poland,TGO,Togo,2012,0,5,-5
POL,Poland,TGO,Togo,2013,0,10,-10
POL,Poland,TGO,Togo,2014,0,5,-5
POL,Poland,TGO,Togo,2015,0,9,-9
POL,Poland,TGO,Togo,2016,0,3,-3
POL,Poland,TGO,Togo,2017,0,5,-5
SVK,Slovak Republic,TGO,Togo,2008,0,0,0
ESP,Spain,TGO,Togo,2008,30,80,-50
ESP,Spain,TGO,Togo,2009,41,28,13
ESP,Spain,TGO,Togo,2010,24,29,-5
ESP,Spain,TGO,Togo,2011,37,42,-5
ESP,Spain,TGO,Togo,2012,19,36,-17
ESP,Spain,TGO,Togo,2013,31,44,-13
ESP,Spain,TGO,Togo,2014,10,22,-12
ESP,Spain,TGO,Togo,2015,12,30,-18
ESP,Spain,TGO,Togo,2016,8,35,-27
ESP,Spain,TGO,Togo,2017,18,42,-24
SWE,Sweden,TGO,Togo,2008,4,7,-3
SWE,Sweden,TGO,Togo,2009,0,9,-9
SWE,Sweden,TGO,Togo,2010,0,8,-8
SWE,Sweden,TGO,Togo,2011,0,18,-18
SWE,Sweden,TGO,Togo,2012,2,19,-17
SWE,Sweden,TGO,Togo,2013,4,13,-9
SWE,Sweden,TGO,Togo,2014,2,10,-8
SWE,Sweden,TGO,Togo,2015,0,10,-10
SWE,Sweden,TGO,Togo,2016,1,9,-8
SWE,Sweden,TGO,Togo,2017,1,7,-6
CHE,Switzerland,TGO,Togo,2010,18,83,-65
CHE,Switzerland,TGO,Togo,2011,14,98,-84
CHE,Switzerland,TGO,Togo,2012,19,68,-49
CHE,Switzerland,TGO,Togo,2013,18,82,-64
CHE,Switzerland,TGO,Togo,2014,18,71,-53
CHE,Switzerland,TGO,Togo,2015,6,58,-52
CHE,Switzerland,TGO,Togo,2016,12,73,-61
CHE,Switzerland,TGO,Togo,2017,11,79,-68
TUR,Turkey,TGO,Togo,2010,0,3,-3
USA,United States,TGO,Togo,2008,0,1661,-1661
USA,United States,TGO,Togo,2009,0,1680,-1680
USA,United States,TGO,Togo,2010,0,1563,-1563
USA,United States,TGO,Togo,2011,0,1506,-1506
USA,United States,TGO,Togo,2012,0,1756,-1756
USA,United States,TGO,Togo,2013,0,1257,-1257
USA,United States,TGO,Togo,2014,0,1612,-1612
USA,United States,TGO,Togo,2015,0,1547,-1547
USA,United States,TGO,Togo,2016,0,1938,-1938
USA,United States,TGO,Togo,2017,0,1572,-1572
CHL,Chile,TGO,Togo,2008,0,0,0
CHL,Chile,TGO,Togo,2009,0,0,0
CHL,Chile,TGO,Togo,2010,0,0,0
CHL,Chile,TGO,Togo,2011,0,0,0
CHL,Chile,TGO,Togo,2012,0,0,0
CHL,Chile,TGO,Togo,2013,0,1,-1
CHL,Chile,TGO,Togo,2014,0,0,0
CHL,Chile,TGO,Togo,2015,0,1,-1
CHL,Chile,TGO,Togo,2016,0,1,-1
EST,Estonia,TGO,Togo,2008,0,0,0
EST,Estonia,TGO,Togo,2009,0,0,0
EST,Estonia,TGO,Togo,2010,0,0,0
EST,Estonia,TGO,Togo,2011,0,0,0
EST,Estonia,TGO,Togo,2012,0,0,0
EST,Estonia,TGO,Togo,2013,0,0,0
EST,Estonia,TGO,Togo,2014,0,0,0
EST,Estonia,TGO,Togo,2015,0,1,-1
EST,Estonia,TGO,Togo,2016,0,0,0
EST,Estonia,TGO,Togo,2017,0,0,0
SVN,Slovenia,TGO,Togo,2010,0,1,-1
AUS,Australia,TKL,Tokelau,2009,0,0,0
AUS,Australia,TKL,Tokelau,2010,0,0,0
AUS,Australia,TKL,Tokelau,2011,0,0,0
AUS,Australia,TKL,Tokelau,2012,0,0,0
AUS,Australia,TKL,Tokelau,2013,0,0,0
AUS,Australia,TKL,Tokelau,2014,0,0,0
AUS,Australia,TKL,Tokelau,2015,0,0,0
AUS,Australia,TKL,Tokelau,2016,0,0,0
AUS,Australia,TKL,Tokelau,2017,0,0,0
AUT,Austria,TKL,Tokelau,2014,0,0,0
AUT,Austria,TKL,Tokelau,2015,0,0,0
AUT,Austria,TKL,Tokelau,2016,0,0,0
AUT,Austria,TKL,Tokelau,2017,0,0,0
BEL,Belgium,TKL,Tokelau,2010,0,0,0
CAN,Canada,TKL,Tokelau,2008,0,0,0
CAN,Canada,TKL,Tokelau,2009,0,0,0
CAN,Canada,TKL,Tokelau,2010,0,0,0
CAN,Canada,TKL,Tokelau,2011,0,0,0
CAN,Canada,TKL,Tokelau,2012,0,0,0
CAN,Canada,TKL,Tokelau,2013,0,0,0
CAN,Canada,TKL,Tokelau,2014,0,0,0
CAN,Canada,TKL,Tokelau,2015,0,0,0
CAN,Canada,TKL,Tokelau,2016,0,0,0
CAN,Canada,TKL,Tokelau,2017,0,0,0
DNK,Denmark,TKL,Tokelau,2015,0,0,0
DNK,Denmark,TKL,Tokelau,2016,0,0,0
FIN,Finland,TKL,Tokelau,2008,0,0,0
FIN,Finland,TKL,Tokelau,2009,0,0,0
FIN,Finland,TKL,Tokelau,2010,0,0,0
FIN,Finland,TKL,Tokelau,2011,0,0,0
FIN,Finland,TKL,Tokelau,2012,0,0,0
FIN,Finland,TKL,Tokelau,2013,0,0,0
FIN,Finland,TKL,Tokelau,2014,0,0,0
FIN,Finland,TKL,Tokelau,2015,0,0,0
FIN,Finland,TKL,Tokelau,2016,0,0,0
FIN,Finland,TKL,Tokelau,2017,0,0,0
FRA,France,TKL,Tokelau,2008,0,0,0
FRA,France,TKL,Tokelau,2009,0,0,0
FRA,France,TKL,Tokelau,2010,0,0,0
FRA,France,TKL,Tokelau,2011,0,0,0
FRA,France,TKL,Tokelau,2012,0,0,0
FRA,France,TKL,Tokelau,2013,0,0,0
FRA,France,TKL,Tokelau,2014,0,0,0
FRA,France,TKL,Tokelau,2015,0,0,0
FRA,France,TKL,Tokelau,2016,0,0,0
FRA,France,TKL,Tokelau,2017,0,0,0
HUN,Hungary,TKL,Tokelau,2008,0,0,0
HUN,Hungary,TKL,Tokelau,2009,0,0,0
HUN,Hungary,TKL,Tokelau,2010,0,0,0
HUN,Hungary,TKL,Tokelau,2011,0,0,0
HUN,Hungary,TKL,Tokelau,2012,0,0,0
HUN,Hungary,TKL,Tokelau,2013,0,0,0
HUN,Hungary,TKL,Tokelau,2014,0,0,0
HUN,Hungary,TKL,Tokelau,2015,0,0,0
HUN,Hungary,TKL,Tokelau,2016,0,0,0
HUN,Hungary,TKL,Tokelau,2017,0,0,0
ISL,Iceland,TKL,Tokelau,2016,0,0,0
ISL,Iceland,TKL,Tokelau,2017,0,0,0
ITA,Italy,TKL,Tokelau,2015,0,0,0
JPN,Japan,TKL,Tokelau,2008,0,0,0
JPN,Japan,TKL,Tokelau,2009,0,0,0
JPN,Japan,TKL,Tokelau,2010,0,0,0
JPN,Japan,TKL,Tokelau,2011,0,0,0
JPN,Japan,TKL,Tokelau,2012,0,0,0
JPN,Japan,TKL,Tokelau,2013,0,0,0
JPN,Japan,TKL,Tokelau,2014,0,0,0
JPN,Japan,TKL,Tokelau,2015,0,0,0
JPN,Japan,TKL,Tokelau,2016,0,0,0
JPN,Japan,TKL,Tokelau,2017,0,0,0
KOR,Korea,TKL,Tokelau,2008,0,0,0
KOR,Korea,TKL,Tokelau,2009,0,1,-1
KOR,Korea,TKL,Tokelau,2010,0,0,0
KOR,Korea,TKL,Tokelau,2011,0,0,0
KOR,Korea,TKL,Tokelau,2012,0,0,0
KOR,Korea,TKL,Tokelau,2013,0,0,0
KOR,Korea,TKL,Tokelau,2014,0,0,0
KOR,Korea,TKL,Tokelau,2015,0,0,0
KOR,Korea,TKL,Tokelau,2016,0,0,0
KOR,Korea,TKL,Tokelau,2017,0,0,0
LUX,Luxembourg,TKL,Tokelau,2008,0,0,0
LUX,Luxembourg,TKL,Tokelau,2009,0,0,0
LUX,Luxembourg,TKL,Tokelau,2010,0,0,0
LUX,Luxembourg,TKL,Tokelau,2011,0,0,0
LUX,Luxembourg,TKL,Tokelau,2012,0,0,0
LUX,Luxembourg,TKL,Tokelau,2013,0,0,0
LUX,Luxembourg,TKL,Tokelau,2014,0,0,0
LUX,Luxembourg,TKL,Tokelau,2015,0,0,0
LUX,Luxembourg,TKL,Tokelau,2016,0,0,0
LUX,Luxembourg,TKL,Tokelau,2017,0,0,0
MEX,Mexico,TKL,Tokelau,2012,0,0,0
MEX,Mexico,TKL,Tokelau,2013,0,0,0
MEX,Mexico,TKL,Tokelau,2014,0,0,0
NOR,Norway,TKL,Tokelau,2008,0,0,0
NOR,Norway,TKL,Tokelau,2009,0,0,0
NOR,Norway,TKL,Tokelau,2010,0,0,0
NOR,Norway,TKL,Tokelau,2011,0,0,0
NOR,Norway,TKL,Tokelau,2012,0,0,0
NOR,Norway,TKL,Tokelau,2013,0,0,0
NOR,Norway,TKL,Tokelau,2014,0,0,0
NOR,Norway,TKL,Tokelau,2015,0,0,0
NOR,Norway,TKL,Tokelau,2016,0,0,0
NOR,Norway,TKL,Tokelau,2017,0,0,0
POL,Poland,TKL,Tokelau,2009,0,0,0
POL,Poland,TKL,Tokelau,2010,0,0,0
POL,Poland,TKL,Tokelau,2011,0,0,0
POL,Poland,TKL,Tokelau,2012,0,0,0
POL,Poland,TKL,Tokelau,2013,0,0,0
POL,Poland,TKL,Tokelau,2014,0,0,0
POL,Poland,TKL,Tokelau,2015,0,0,0
POL,Poland,TKL,Tokelau,2016,0,0,0
POL,Poland,TKL,Tokelau,2017,0,0,0
ESP,Spain,TKL,Tokelau,2008,0,0,0
ESP,Spain,TKL,Tokelau,2009,0,0,0
ESP,Spain,TKL,Tokelau,2010,0,0,0
ESP,Spain,TKL,Tokelau,2011,0,0,0
ESP,Spain,TKL,Tokelau,2012,0,0,0
ESP,Spain,TKL,Tokelau,2013,0,0,0
SWE,Sweden,TKL,Tokelau,2008,0,0,0
SWE,Sweden,TKL,Tokelau,2009,0,0,0
SWE,Sweden,TKL,Tokelau,2010,0,0,0
SWE,Sweden,TKL,Tokelau,2011,0,0,0
SWE,Sweden,TKL,Tokelau,2012,0,0,0
SWE,Sweden,TKL,Tokelau,2013,0,0,0
SWE,Sweden,TKL,Tokelau,2014,0,0,0
SWE,Sweden,TKL,Tokelau,2015,0,0,0
CHL,Chile,TKL,Tokelau,2008,0,0,0
CHL,Chile,TKL,Tokelau,2009,0,0,0
CHL,Chile,TKL,Tokelau,2010,0,0,0
CHL,Chile,TKL,Tokelau,2011,0,0,0
CHL,Chile,TKL,Tokelau,2012,0,0,0
CHL,Chile,TKL,Tokelau,2013,0,0,0
CHL,Chile,TKL,Tokelau,2014,0,0,0
CHL,Chile,TKL,Tokelau,2015,0,0,0
CHL,Chile,TKL,Tokelau,2016,0,0,0
EST,Estonia,TKL,Tokelau,2017,0,0,0
AUS,Australia,TON,Tonga,2008,38,233,-195
AUS,Australia,TON,Tonga,2009,40,209,-169
AUS,Australia,TON,Tonga,2010,37,211,-174
AUS,Australia,TON,Tonga,2011,39,201,-162
AUS,Australia,TON,Tonga,2012,30,228,-198
AUS,Australia,TON,Tonga,2013,25,204,-179
AUS,Australia,TON,Tonga,2014,34,204,-170
AUS,Australia,TON,Tonga,2015,0,142,-142
AUS,Australia,TON,Tonga,2016,0,132,-132
AUS,Australia,TON,Tonga,2017,0,165,-165
AUT,Austria,TON,Tonga,2008,0,2,-2
AUT,Austria,TON,Tonga,2009,0,0,0
AUT,Austria,TON,Tonga,2010,0,0,0
AUT,Austria,TON,Tonga,2011,0,0,0
AUT,Austria,TON,Tonga,2012,1,0,1
AUT,Austria,TON,Tonga,2013,0,0,0
AUT,Austria,TON,Tonga,2014,0,0,0
AUT,Austria,TON,Tonga,2015,0,0,0
AUT,Austria,TON,Tonga,2016,0,1,-1
AUT,Austria,TON,Tonga,2017,0,1,-1
BEL,Belgium,TON,Tonga,2010,0,0,0
BEL,Belgium,TON,Tonga,2012,0,2,-2
CAN,Canada,TON,Tonga,2008,0,0,0
CAN,Canada,TON,Tonga,2009,0,5,-5
CAN,Canada,TON,Tonga,2010,0,5,-5
CAN,Canada,TON,Tonga,2011,0,2,-2
CAN,Canada,TON,Tonga,2012,0,3,-3
CAN,Canada,TON,Tonga,2013,0,5,-5
CAN,Canada,TON,Tonga,2014,0,2,-2
CAN,Canada,TON,Tonga,2015,0,10,-10
CAN,Canada,TON,Tonga,2016,0,0,0
CAN,Canada,TON,Tonga,2017,0,0,0
CZE,Czech Republic,TON,Tonga,2014,1,1,0
DNK,Denmark,TON,Tonga,2008,0,1,-1
DNK,Denmark,TON,Tonga,2009,0,0,0
DNK,Denmark,TON,Tonga,2012,0,0,0
DNK,Denmark,TON,Tonga,2013,0,0,0
DNK,Denmark,TON,Tonga,2014,0,0,0
DNK,Denmark,TON,Tonga,2015,0,0,0
DNK,Denmark,TON,Tonga,2016,0,0,0
DNK,Denmark,TON,Tonga,2017,0,0,0
FIN,Finland,TON,Tonga,2008,0,0,0
FIN,Finland,TON,Tonga,2009,0,0,0
FIN,Finland,TON,Tonga,2010,0,0,0
FIN,Finland,TON,Tonga,2011,0,0,0
FIN,Finland,TON,Tonga,2012,0,0,0
FIN,Finland,TON,Tonga,2013,0,2,-2
FIN,Finland,TON,Tonga,2014,0,0,0
FIN,Finland,TON,Tonga,2015,0,0,0
FIN,Finland,TON,Tonga,2016,0,0,0
FIN,Finland,TON,Tonga,2017,0,0,0
FRA,France,TON,Tonga,2008,0,9,-9
FRA,France,TON,Tonga,2009,0,15,-15
FRA,France,TON,Tonga,2010,0,8,-8
FRA,France,TON,Tonga,2011,0,12,-12
FRA,France,TON,Tonga,2012,0,6,-6
FRA,France,TON,Tonga,2013,0,14,-14
FRA,France,TON,Tonga,2014,0,8,-8
FRA,France,TON,Tonga,2015,0,16,-16
FRA,France,TON,Tonga,2016,0,7,-7
FRA,France,TON,Tonga,2017,0,12,-12
DEU,Germany,TON,Tonga,2008,5,3,2
DEU,Germany,TON,Tonga,2009,6,5,1
DEU,Germany,TON,Tonga,2010,6,4,2
DEU,Germany,TON,Tonga,2011,2,6,-4
DEU,Germany,TON,Tonga,2012,3,6,-3
DEU,Germany,TON,Tonga,2013,2,4,-2
DEU,Germany,TON,Tonga,2014,4,9,-5
DEU,Germany,TON,Tonga,2015,2,3,-1
DEU,Germany,TON,Tonga,2016,3,3,0
DEU,Germany,TON,Tonga,2017,2,4,-2
HUN,Hungary,TON,Tonga,2008,0,0,0
HUN,Hungary,TON,Tonga,2009,0,0,0
HUN,Hungary,TON,Tonga,2010,0,0,0
HUN,Hungary,TON,Tonga,2011,0,0,0
HUN,Hungary,TON,Tonga,2012,0,0,0
HUN,Hungary,TON,Tonga,2013,0,0,0
HUN,Hungary,TON,Tonga,2014,0,0,0
HUN,Hungary,TON,Tonga,2015,0,0,0
HUN,Hungary,TON,Tonga,2016,0,0,0
HUN,Hungary,TON,Tonga,2017,0,0,0
ISL,Iceland,TON,Tonga,2008,0,1,-1
ISL,Iceland,TON,Tonga,2009,1,0,1
ISL,Iceland,TON,Tonga,2010,0,0,0
ISL,Iceland,TON,Tonga,2011,0,0,0
ISL,Iceland,TON,Tonga,2012,0,0,0
ISL,Iceland,TON,Tonga,2013,0,0,0
ISL,Iceland,TON,Tonga,2014,0,0,0
ISL,Iceland,TON,Tonga,2015,0,0,0
ISL,Iceland,TON,Tonga,2016,0,0,0
ISL,Iceland,TON,Tonga,2017,0,0,0
ITA,Italy,TON,Tonga,2008,0,2,-2
ITA,Italy,TON,Tonga,2009,0,2,-2
ITA,Italy,TON,Tonga,2010,0,1,-1
ITA,Italy,TON,Tonga,2011,0,0,0
ITA,Italy,TON,Tonga,2012,0,2,-2
ITA,Italy,TON,Tonga,2013,0,0,0
ITA,Italy,TON,Tonga,2014,0,1,-1
ITA,Italy,TON,Tonga,2015,0,0,0
ITA,Italy,TON,Tonga,2016,0,6,-6
ITA,Italy,TON,Tonga,2017,0,4,-4
JPN,Japan,TON,Tonga,2008,74,79,-5
JPN,Japan,TON,Tonga,2009,58,52,6
JPN,Japan,TON,Tonga,2010,73,72,1
JPN,Japan,TON,Tonga,2011,53,61,-8
JPN,Japan,TON,Tonga,2012,48,62,-14
JPN,Japan,TON,Tonga,2013,59,71,-12
JPN,Japan,TON,Tonga,2014,63,66,-3
JPN,Japan,TON,Tonga,2015,56,68,-12
JPN,Japan,TON,Tonga,2016,65,77,-12
JPN,Japan,TON,Tonga,2017,73,91,-18
KOR,Korea,TON,Tonga,2008,0,1,-1
KOR,Korea,TON,Tonga,2009,1,0,1
KOR,Korea,TON,Tonga,2010,0,2,-2
KOR,Korea,TON,Tonga,2011,1,0,1
KOR,Korea,TON,Tonga,2012,1,2,-1
KOR,Korea,TON,Tonga,2013,0,0,0
KOR,Korea,TON,Tonga,2014,1,1,0
KOR,Korea,TON,Tonga,2015,2,2,0
KOR,Korea,TON,Tonga,2016,1,2,-1
KOR,Korea,TON,Tonga,2017,4,1,3
LUX,Luxembourg,TON,Tonga,2008,0,0,0
LUX,Luxembourg,TON,Tonga,2009,0,0,0
LUX,Luxembourg,TON,Tonga,2010,0,0,0
LUX,Luxembourg,TON,Tonga,2011,0,0,0
LUX,Luxembourg,TON,Tonga,2012,0,0,0
LUX,Luxembourg,TON,Tonga,2013,0,0,0
LUX,Luxembourg,TON,Tonga,2014,0,0,0
LUX,Luxembourg,TON,Tonga,2015,0,0,0
LUX,Luxembourg,TON,Tonga,2016,0,0,0
LUX,Luxembourg,TON,Tonga,2017,0,0,0
MEX,Mexico,TON,Tonga,2009,0,1,-1
MEX,Mexico,TON,Tonga,2012,0,0,0
MEX,Mexico,TON,Tonga,2013,0,0,0
MEX,Mexico,TON,Tonga,2014,0,0,0
NZL,New Zealand,TON,Tonga,2008,237,723,-486
NZL,New Zealand,TON,Tonga,2009,267,536,-269
NZL,New Zealand,TON,Tonga,2010,295,591,-296
NZL,New Zealand,TON,Tonga,2011,292,594,-302
NZL,New Zealand,TON,Tonga,2012,288,513,-225
NZL,New Zealand,TON,Tonga,2013,245,623,-378
NZL,New Zealand,TON,Tonga,2014,192,664,-472
NZL,New Zealand,TON,Tonga,2015,211,788,-577
NZL,New Zealand,TON,Tonga,2016,217,679,-462
NZL,New Zealand,TON,Tonga,2017,231,709,-478
NOR,Norway,TON,Tonga,2008,0,0,0
NOR,Norway,TON,Tonga,2009,0,0,0
NOR,Norway,TON,Tonga,2010,0,0,0
NOR,Norway,TON,Tonga,2011,0,0,0
NOR,Norway,TON,Tonga,2012,0,0,0
NOR,Norway,TON,Tonga,2013,0,0,0
NOR,Norway,TON,Tonga,2014,0,0,0
NOR,Norway,TON,Tonga,2015,0,0,0
NOR,Norway,TON,Tonga,2016,0,0,0
NOR,Norway,TON,Tonga,2017,0,0,0
POL,Poland,TON,Tonga,2009,0,0,0
POL,Poland,TON,Tonga,2010,0,0,0
POL,Poland,TON,Tonga,2011,0,0,0
POL,Poland,TON,Tonga,2012,0,0,0
POL,Poland,TON,Tonga,2013,0,0,0
POL,Poland,TON,Tonga,2014,0,0,0
POL,Poland,TON,Tonga,2015,0,0,0
POL,Poland,TON,Tonga,2016,0,0,0
POL,Poland,TON,Tonga,2017,0,0,0
SVK,Slovak Republic,TON,Tonga,2008,0,0,0
ESP,Spain,TON,Tonga,2008,0,1,-1
ESP,Spain,TON,Tonga,2009,0,0,0
ESP,Spain,TON,Tonga,2010,1,0,1
ESP,Spain,TON,Tonga,2011,0,0,0
ESP,Spain,TON,Tonga,2012,1,1,0
ESP,Spain,TON,Tonga,2013,0,0,0
ESP,Spain,TON,Tonga,2014,0,1,-1
ESP,Spain,TON,Tonga,2015,0,2,-2
ESP,Spain,TON,Tonga,2016,0,2,-2
SWE,Sweden,TON,Tonga,2008,0,0,0
SWE,Sweden,TON,Tonga,2009,0,1,-1
SWE,Sweden,TON,Tonga,2010,0,0,0
SWE,Sweden,TON,Tonga,2011,0,0,0
SWE,Sweden,TON,Tonga,2012,0,0,0
SWE,Sweden,TON,Tonga,2013,0,0,0
SWE,Sweden,TON,Tonga,2014,0,0,0
SWE,Sweden,TON,Tonga,2015,0,0,0
SWE,Sweden,TON,Tonga,2016,1,1,0
SWE,Sweden,TON,Tonga,2017,0,0,0
CHE,Switzerland,TON,Tonga,2010,0,1,-1
CHE,Switzerland,TON,Tonga,2011,0,2,-2
CHE,Switzerland,TON,Tonga,2012,1,0,1
CHE,Switzerland,TON,Tonga,2013,0,0,0
CHE,Switzerland,TON,Tonga,2017,0,1,-1
USA,United States,TON,Tonga,2008,0,365,-365
USA,United States,TON,Tonga,2009,0,379,-379
USA,United States,TON,Tonga,2010,0,343,-343
USA,United States,TON,Tonga,2011,0,408,-408
USA,United States,TON,Tonga,2012,0,276,-276
USA,United States,TON,Tonga,2013,0,348,-348
USA,United States,TON,Tonga,2014,0,320,-320
USA,United States,TON,Tonga,2015,0,327,-327
USA,United States,TON,Tonga,2016,0,283,-283
USA,United States,TON,Tonga,2017,0,262,-262
CHL,Chile,TON,Tonga,2008,0,1,-1
CHL,Chile,TON,Tonga,2009,0,0,0
CHL,Chile,TON,Tonga,2010,0,0,0
CHL,Chile,TON,Tonga,2011,0,0,0
CHL,Chile,TON,Tonga,2012,0,0,0
CHL,Chile,TON,Tonga,2013,0,1,-1
CHL,Chile,TON,Tonga,2014,0,0,0
CHL,Chile,TON,Tonga,2015,0,0,0
CHL,Chile,TON,Tonga,2016,0,0,0
EST,Estonia,TON,Tonga,2008,0,0,0
EST,Estonia,TON,Tonga,2009,0,0,0
EST,Estonia,TON,Tonga,2010,0,0,0
EST,Estonia,TON,Tonga,2011,0,0,0
EST,Estonia,TON,Tonga,2012,0,0,0
EST,Estonia,TON,Tonga,2013,0,0,0
EST,Estonia,TON,Tonga,2014,0,0,0
EST,Estonia,TON,Tonga,2015,0,0,0
EST,Estonia,TON,Tonga,2016,0,0,0
EST,Estonia,TON,Tonga,2017,0,0,0
AUS,Australia,TTO,Trinidad and Tobago,2008,12,16,-4
AUS,Australia,TTO,Trinidad and Tobago,2009,16,20,-4
AUS,Australia,TTO,Trinidad and Tobago,2010,9,26,-17
AUS,Australia,TTO,Trinidad and Tobago,2011,0,18,-18
AUS,Australia,TTO,Trinidad and Tobago,2012,14,34,-20
AUS,Australia,TTO,Trinidad and Tobago,2013,13,34,-21
AUS,Australia,TTO,Trinidad and Tobago,2014,14,29,-15
AUS,Australia,TTO,Trinidad and Tobago,2015,0,34,-34
AUS,Australia,TTO,Trinidad and Tobago,2016,0,30,-30
AUS,Australia,TTO,Trinidad and Tobago,2017,0,35,-35
AUT,Austria,TTO,Trinidad and Tobago,2008,5,3,2
AUT,Austria,TTO,Trinidad and Tobago,2009,5,3,2
AUT,Austria,TTO,Trinidad and Tobago,2010,2,2,0
AUT,Austria,TTO,Trinidad and Tobago,2011,2,2,0
AUT,Austria,TTO,Trinidad and Tobago,2012,1,1,0
AUT,Austria,TTO,Trinidad and Tobago,2013,4,1,3
AUT,Austria,TTO,Trinidad and Tobago,2014,2,2,0
AUT,Austria,TTO,Trinidad and Tobago,2015,2,6,-4
AUT,Austria,TTO,Trinidad and Tobago,2016,3,4,-1
AUT,Austria,TTO,Trinidad and Tobago,2017,4,5,-1
BEL,Belgium,TTO,Trinidad and Tobago,2008,0,6,-6
BEL,Belgium,TTO,Trinidad and Tobago,2009,0,8,-8
BEL,Belgium,TTO,Trinidad and Tobago,2010,2,4,-2
BEL,Belgium,TTO,Trinidad and Tobago,2012,4,9,-5
BEL,Belgium,TTO,Trinidad and Tobago,2013,9,3,6
BEL,Belgium,TTO,Trinidad and Tobago,2014,3,4,-1
BEL,Belgium,TTO,Trinidad and Tobago,2015,3,9,-6
BEL,Belgium,TTO,Trinidad and Tobago,2016,1,8,-7
BEL,Belgium,TTO,Trinidad and Tobago,2017,5,10,-5
CAN,Canada,TTO,Trinidad and Tobago,2008,0,1002,-1002
CAN,Canada,TTO,Trinidad and Tobago,2009,0,1134,-1134
CAN,Canada,TTO,Trinidad and Tobago,2010,0,914,-914
CAN,Canada,TTO,Trinidad and Tobago,2011,0,588,-588
CAN,Canada,TTO,Trinidad and Tobago,2012,0,579,-579
CAN,Canada,TTO,Trinidad and Tobago,2013,0,427,-427
CAN,Canada,TTO,Trinidad and Tobago,2014,0,430,-430
CAN,Canada,TTO,Trinidad and Tobago,2015,0,348,-348
CAN,Canada,TTO,Trinidad and Tobago,2016,0,325,-325
CAN,Canada,TTO,Trinidad and Tobago,2017,0,375,-375
CZE,Czech Republic,TTO,Trinidad and Tobago,2008,0,1,-1
CZE,Czech Republic,TTO,Trinidad and Tobago,2009,0,1,-1
CZE,Czech Republic,TTO,Trinidad and Tobago,2011,0,1,-1
DNK,Denmark,TTO,Trinidad and Tobago,2008,4,2,2
DNK,Denmark,TTO,Trinidad and Tobago,2009,4,7,-3
DNK,Denmark,TTO,Trinidad and Tobago,2010,1,12,-11
DNK,Denmark,TTO,Trinidad and Tobago,2011,6,2,4
DNK,Denmark,TTO,Trinidad and Tobago,2012,4,6,-2
DNK,Denmark,TTO,Trinidad and Tobago,2013,6,6,0
DNK,Denmark,TTO,Trinidad and Tobago,2014,5,9,-4
DNK,Denmark,TTO,Trinidad and Tobago,2015,3,3,0
DNK,Denmark,TTO,Trinidad and Tobago,2016,3,5,-2
DNK,Denmark,TTO,Trinidad and Tobago,2017,4,4,0
FIN,Finland,TTO,Trinidad and Tobago,2008,1,0,1
FIN,Finland,TTO,Trinidad and Tobago,2009,0,1,-1
FIN,Finland,TTO,Trinidad and Tobago,2010,0,0,0
FIN,Finland,TTO,Trinidad and Tobago,2011,1,1,0
FIN,Finland,TTO,Trinidad and Tobago,2012,0,2,-2
FIN,Finland,TTO,Trinidad and Tobago,2013,0,4,-4
FIN,Finland,TTO,Trinidad and Tobago,2014,0,1,-1
FIN,Finland,TTO,Trinidad and Tobago,2015,0,0,0
FIN,Finland,TTO,Trinidad and Tobago,2016,0,5,-5
FIN,Finland,TTO,Trinidad and Tobago,2017,0,3,-3
FRA,France,TTO,Trinidad and Tobago,2008,0,11,-11
FRA,France,TTO,Trinidad and Tobago,2009,0,15,-15
FRA,France,TTO,Trinidad and Tobago,2010,0,18,-18
FRA,France,TTO,Trinidad and Tobago,2011,0,16,-16
FRA,France,TTO,Trinidad and Tobago,2012,0,16,-16
FRA,France,TTO,Trinidad and Tobago,2013,0,15,-15
FRA,France,TTO,Trinidad and Tobago,2014,0,27,-27
FRA,France,TTO,Trinidad and Tobago,2015,0,26,-26
FRA,France,TTO,Trinidad and Tobago,2016,0,21,-21
FRA,France,TTO,Trinidad and Tobago,2017,0,27,-27
DEU,Germany,TTO,Trinidad and Tobago,2008,84,27,57
DEU,Germany,TTO,Trinidad and Tobago,2009,37,36,1
DEU,Germany,TTO,Trinidad and Tobago,2010,56,54,2
DEU,Germany,TTO,Trinidad and Tobago,2011,23,33,-10
DEU,Germany,TTO,Trinidad and Tobago,2012,22,44,-22
DEU,Germany,TTO,Trinidad and Tobago,2013,28,30,-2
DEU,Germany,TTO,Trinidad and Tobago,2014,27,35,-8
DEU,Germany,TTO,Trinidad and Tobago,2015,20,33,-13
DEU,Germany,TTO,Trinidad and Tobago,2016,19,41,-22
DEU,Germany,TTO,Trinidad and Tobago,2017,13,32,-19
HUN,Hungary,TTO,Trinidad and Tobago,2008,0,5,-5
HUN,Hungary,TTO,Trinidad and Tobago,2009,0,1,-1
HUN,Hungary,TTO,Trinidad and Tobago,2010,0,2,-2
HUN,Hungary,TTO,Trinidad and Tobago,2011,0,1,-1
HUN,Hungary,TTO,Trinidad and Tobago,2012,0,0,0
HUN,Hungary,TTO,Trinidad and Tobago,2013,0,4,-4
HUN,Hungary,TTO,Trinidad and Tobago,2014,0,0,0
HUN,Hungary,TTO,Trinidad and Tobago,2015,0,1,-1
HUN,Hungary,TTO,Trinidad and Tobago,2016,0,0,0
HUN,Hungary,TTO,Trinidad and Tobago,2017,0,1,-1
ISL,Iceland,TTO,Trinidad and Tobago,2008,0,1,-1
ISL,Iceland,TTO,Trinidad and Tobago,2009,0,0,0
ISL,Iceland,TTO,Trinidad and Tobago,2010,0,1,-1
ISL,Iceland,TTO,Trinidad and Tobago,2011,0,0,0
ISL,Iceland,TTO,Trinidad and Tobago,2012,1,0,1
ISL,Iceland,TTO,Trinidad and Tobago,2013,0,0,0
ISL,Iceland,TTO,Trinidad and Tobago,2014,2,2,0
ISL,Iceland,TTO,Trinidad and Tobago,2015,0,3,-3
ISL,Iceland,TTO,Trinidad and Tobago,2016,2,2,0
ISL,Iceland,TTO,Trinidad and Tobago,2017,2,1,1
ITA,Italy,TTO,Trinidad and Tobago,2008,0,7,-7
ITA,Italy,TTO,Trinidad and Tobago,2009,0,1,-1
ITA,Italy,TTO,Trinidad and Tobago,2010,0,7,-7
ITA,Italy,TTO,Trinidad and Tobago,2011,0,6,-6
ITA,Italy,TTO,Trinidad and Tobago,2012,0,4,-4
ITA,Italy,TTO,Trinidad and Tobago,2013,1,6,-5
ITA,Italy,TTO,Trinidad and Tobago,2014,0,2,-2
ITA,Italy,TTO,Trinidad and Tobago,2015,1,1,0
ITA,Italy,TTO,Trinidad and Tobago,2016,0,1,-1
ITA,Italy,TTO,Trinidad and Tobago,2017,1,1,0
JPN,Japan,TTO,Trinidad and Tobago,2008,67,75,-8
JPN,Japan,TTO,Trinidad and Tobago,2009,43,46,-3
JPN,Japan,TTO,Trinidad and Tobago,2010,55,61,-6
JPN,Japan,TTO,Trinidad and Tobago,2011,22,30,-8
JPN,Japan,TTO,Trinidad and Tobago,2012,44,40,4
JPN,Japan,TTO,Trinidad and Tobago,2013,39,39,0
JPN,Japan,TTO,Trinidad and Tobago,2014,47,49,-2
JPN,Japan,TTO,Trinidad and Tobago,2015,26,40,-14
JPN,Japan,TTO,Trinidad and Tobago,2016,11,36,-25
JPN,Japan,TTO,Trinidad and Tobago,2017,13,36,-23
KOR,Korea,TTO,Trinidad and Tobago,2008,6,7,-1
KOR,Korea,TTO,Trinidad and Tobago,2009,3,4,-1
KOR,Korea,TTO,Trinidad and Tobago,2010,5,4,1
KOR,Korea,TTO,Trinidad and Tobago,2011,2,2,0
KOR,Korea,TTO,Trinidad and Tobago,2012,2,1,1
KOR,Korea,TTO,Trinidad and Tobago,2013,2,7,-5
KOR,Korea,TTO,Trinidad and Tobago,2014,0,3,-3
KOR,Korea,TTO,Trinidad and Tobago,2015,9,7,2
KOR,Korea,TTO,Trinidad and Tobago,2016,4,3,1
KOR,Korea,TTO,Trinidad and Tobago,2017,2,5,-3
LUX,Luxembourg,TTO,Trinidad and Tobago,2008,0,1,-1
LUX,Luxembourg,TTO,Trinidad and Tobago,2009,0,0,0
LUX,Luxembourg,TTO,Trinidad and Tobago,2010,0,0,0
LUX,Luxembourg,TTO,Trinidad and Tobago,2011,0,1,-1
LUX,Luxembourg,TTO,Trinidad and Tobago,2012,0,1,-1
LUX,Luxembourg,TTO,Trinidad and Tobago,2013,0,2,-2
LUX,Luxembourg,TTO,Trinidad and Tobago,2014,1,0,1
LUX,Luxembourg,TTO,Trinidad and Tobago,2015,1,0,1
LUX,Luxembourg,TTO,Trinidad and Tobago,2016,1,2,-1
LUX,Luxembourg,TTO,Trinidad and Tobago,2017,1,0,1
MEX,Mexico,TTO,Trinidad and Tobago,2008,0,3,-3
MEX,Mexico,TTO,Trinidad and Tobago,2009,0,5,-5
MEX,Mexico,TTO,Trinidad and Tobago,2010,0,1,-1
MEX,Mexico,TTO,Trinidad and Tobago,2012,0,0,0
MEX,Mexico,TTO,Trinidad and Tobago,2013,0,5,-5
MEX,Mexico,TTO,Trinidad and Tobago,2014,0,3,-3
MEX,Mexico,TTO,Trinidad and Tobago,2015,0,5,-5
MEX,Mexico,TTO,Trinidad and Tobago,2016,0,3,-3
MEX,Mexico,TTO,Trinidad and Tobago,2017,0,5,-5
NLD,Netherlands,TTO,Trinidad and Tobago,2008,12,15,-3
NLD,Netherlands,TTO,Trinidad and Tobago,2010,11,15,-4
NLD,Netherlands,TTO,Trinidad and Tobago,2011,18,24,-6
NLD,Netherlands,TTO,Trinidad and Tobago,2012,11,15,-4
NLD,Netherlands,TTO,Trinidad and Tobago,2013,10,9,1
NLD,Netherlands,TTO,Trinidad and Tobago,2014,5,24,-19
NLD,Netherlands,TTO,Trinidad and Tobago,2015,12,16,-4
NLD,Netherlands,TTO,Trinidad and Tobago,2016,10,29,-19
NLD,Netherlands,TTO,Trinidad and Tobago,2017,8,46,-38
NZL,New Zealand,TTO,Trinidad and Tobago,2008,4,3,1
NZL,New Zealand,TTO,Trinidad and Tobago,2009,4,2,2
NZL,New Zealand,TTO,Trinidad and Tobago,2010,2,6,-4
NZL,New Zealand,TTO,Trinidad and Tobago,2011,1,7,-6
NZL,New Zealand,TTO,Trinidad and Tobago,2012,4,7,-3
NZL,New Zealand,TTO,Trinidad and Tobago,2013,2,13,-11
NZL,New Zealand,TTO,Trinidad and Tobago,2014,2,4,-2
NZL,New Zealand,TTO,Trinidad and Tobago,2015,4,10,-6
NZL,New Zealand,TTO,Trinidad and Tobago,2016,6,2,4
NZL,New Zealand,TTO,Trinidad and Tobago,2017,0,14,-14
NOR,Norway,TTO,Trinidad and Tobago,2008,3,12,-9
NOR,Norway,TTO,Trinidad and Tobago,2009,3,3,0
NOR,Norway,TTO,Trinidad and Tobago,2010,5,9,-4
NOR,Norway,TTO,Trinidad and Tobago,2011,3,5,-2
NOR,Norway,TTO,Trinidad and Tobago,2012,5,11,-6
NOR,Norway,TTO,Trinidad and Tobago,2013,8,13,-5
NOR,Norway,TTO,Trinidad and Tobago,2014,2,8,-6
NOR,Norway,TTO,Trinidad and Tobago,2015,3,2,1
NOR,Norway,TTO,Trinidad and Tobago,2016,11,8,3
NOR,Norway,TTO,Trinidad and Tobago,2017,2,8,-6
POL,Poland,TTO,Trinidad and Tobago,2009,0,4,-4
POL,Poland,TTO,Trinidad and Tobago,2010,0,1,-1
POL,Poland,TTO,Trinidad and Tobago,2011,0,3,-3
POL,Poland,TTO,Trinidad and Tobago,2012,0,4,-4
POL,Poland,TTO,Trinidad and Tobago,2013,0,2,-2
POL,Poland,TTO,Trinidad and Tobago,2014,0,0,0
POL,Poland,TTO,Trinidad and Tobago,2015,0,6,-6
POL,Poland,TTO,Trinidad and Tobago,2016,0,6,-6
POL,Poland,TTO,Trinidad and Tobago,2017,0,3,-3
SVK,Slovak Republic,TTO,Trinidad and Tobago,2008,0,1,-1
SVK,Slovak Republic,TTO,Trinidad and Tobago,2009,0,2,-2
SVK,Slovak Republic,TTO,Trinidad and Tobago,2011,0,1,-1
SVK,Slovak Republic,TTO,Trinidad and Tobago,2015,0,1,-1
ESP,Spain,TTO,Trinidad and Tobago,2008,3,13,-10
ESP,Spain,TTO,Trinidad and Tobago,2009,6,7,-1
ESP,Spain,TTO,Trinidad and Tobago,2010,4,10,-6
ESP,Spain,TTO,Trinidad and Tobago,2011,5,13,-8
ESP,Spain,TTO,Trinidad and Tobago,2012,4,9,-5
ESP,Spain,TTO,Trinidad and Tobago,2013,7,18,-11
ESP,Spain,TTO,Trinidad and Tobago,2014,4,12,-8
ESP,Spain,TTO,Trinidad and Tobago,2015,4,13,-9
ESP,Spain,TTO,Trinidad and Tobago,2016,8,18,-10
ESP,Spain,TTO,Trinidad and Tobago,2017,12,28,-16
SWE,Sweden,TTO,Trinidad and Tobago,2008,3,8,-5
SWE,Sweden,TTO,Trinidad and Tobago,2009,1,5,-4
SWE,Sweden,TTO,Trinidad and Tobago,2010,2,19,-17
SWE,Sweden,TTO,Trinidad and Tobago,2011,2,9,-7
SWE,Sweden,TTO,Trinidad and Tobago,2012,9,8,1
SWE,Sweden,TTO,Trinidad and Tobago,2013,5,5,0
SWE,Sweden,TTO,Trinidad and Tobago,2014,3,3,0
SWE,Sweden,TTO,Trinidad and Tobago,2015,7,2,5
SWE,Sweden,TTO,Trinidad and Tobago,2016,5,4,1
SWE,Sweden,TTO,Trinidad and Tobago,2017,3,13,-10
CHE,Switzerland,TTO,Trinidad and Tobago,2010,8,7,1
CHE,Switzerland,TTO,Trinidad and Tobago,2011,6,7,-1
CHE,Switzerland,TTO,Trinidad and Tobago,2012,1,16,-15
CHE,Switzerland,TTO,Trinidad and Tobago,2013,7,14,-7
CHE,Switzerland,TTO,Trinidad and Tobago,2014,6,10,-4
CHE,Switzerland,TTO,Trinidad and Tobago,2015,0,6,-6
CHE,Switzerland,TTO,Trinidad and Tobago,2016,8,13,-5
CHE,Switzerland,TTO,Trinidad and Tobago,2017,7,3,4
GBR,United Kingdom,TTO,Trinidad and Tobago,2013,1000,1000,0
USA,United States,TTO,Trinidad and Tobago,2008,0,5937,-5937
USA,United States,TTO,Trinidad and Tobago,2009,0,6256,-6256
USA,United States,TTO,Trinidad and Tobago,2010,0,5435,-5435
USA,United States,TTO,Trinidad and Tobago,2011,0,5023,-5023
USA,United States,TTO,Trinidad and Tobago,2012,0,5214,-5214
USA,United States,TTO,Trinidad and Tobago,2013,0,4724,-4724
USA,United States,TTO,Trinidad and Tobago,2014,0,3988,-3988
USA,United States,TTO,Trinidad and Tobago,2015,0,3212,-3212
USA,United States,TTO,Trinidad and Tobago,2016,0,3469,-3469
USA,United States,TTO,Trinidad and Tobago,2017,0,3100,-3100
CHL,Chile,TTO,Trinidad and Tobago,2008,0,7,-7
CHL,Chile,TTO,Trinidad and Tobago,2009,0,3,-3
CHL,Chile,TTO,Trinidad and Tobago,2010,0,3,-3
CHL,Chile,TTO,Trinidad and Tobago,2011,0,1,-1
CHL,Chile,TTO,Trinidad and Tobago,2012,0,3,-3
CHL,Chile,TTO,Trinidad and Tobago,2013,0,3,-3
CHL,Chile,TTO,Trinidad and Tobago,2014,0,3,-3
CHL,Chile,TTO,Trinidad and Tobago,2015,0,4,-4
CHL,Chile,TTO,Trinidad and Tobago,2016,0,2,-2
EST,Estonia,TTO,Trinidad and Tobago,2008,0,0,0
EST,Estonia,TTO,Trinidad and Tobago,2009,0,0,0
EST,Estonia,TTO,Trinidad and Tobago,2010,0,0,0
EST,Estonia,TTO,Trinidad and Tobago,2011,0,0,0
EST,Estonia,TTO,Trinidad and Tobago,2012,0,0,0
EST,Estonia,TTO,Trinidad and Tobago,2013,0,0,0
EST,Estonia,TTO,Trinidad and Tobago,2014,0,0,0
EST,Estonia,TTO,Trinidad and Tobago,2015,0,0,0
EST,Estonia,TTO,Trinidad and Tobago,2016,0,0,0
EST,Estonia,TTO,Trinidad and Tobago,2017,0,0,0
SVN,Slovenia,TTO,Trinidad and Tobago,2008,0,1,-1
SVN,Slovenia,TTO,Trinidad and Tobago,2009,0,31,-31
SVN,Slovenia,TTO,Trinidad and Tobago,2010,0,1,-1
SVN,Slovenia,TTO,Trinidad and Tobago,2015,0,2,-2
AUS,Australia,TUN,Tunisia,2008,6,7,-1
AUS,Australia,TUN,Tunisia,2009,0,7,-7
AUS,Australia,TUN,Tunisia,2010,11,7,4
AUS,Australia,TUN,Tunisia,2011,9,13,-4
AUS,Australia,TUN,Tunisia,2012,10,15,-5
AUS,Australia,TUN,Tunisia,2013,6,26,-20
AUS,Australia,TUN,Tunisia,2014,8,28,-20
AUS,Australia,TUN,Tunisia,2015,0,22,-22
AUS,Australia,TUN,Tunisia,2016,0,28,-28
AUS,Australia,TUN,Tunisia,2017,0,26,-26
AUT,Austria,TUN,Tunisia,2008,104,189,-85
AUT,Austria,TUN,Tunisia,2009,103,156,-53
AUT,Austria,TUN,Tunisia,2010,97,190,-93
AUT,Austria,TUN,Tunisia,2011,120,247,-127
AUT,Austria,TUN,Tunisia,2012,132,235,-103
AUT,Austria,TUN,Tunisia,2013,117,190,-73
AUT,Austria,TUN,Tunisia,2014,118,273,-155
AUT,Austria,TUN,Tunisia,2015,104,295,-191
AUT,Austria,TUN,Tunisia,2016,155,305,-150
AUT,Austria,TUN,Tunisia,2017,209,276,-67
BEL,Belgium,TUN,Tunisia,2008,100,669,-569
BEL,Belgium,TUN,Tunisia,2009,135,607,-472
BEL,Belgium,TUN,Tunisia,2010,137,717,-580
BEL,Belgium,TUN,Tunisia,2011,155,812,-657
BEL,Belgium,TUN,Tunisia,2012,177,794,-617
BEL,Belgium,TUN,Tunisia,2013,269,709,-440
BEL,Belgium,TUN,Tunisia,2014,282,662,-380
BEL,Belgium,TUN,Tunisia,2015,225,650,-425
BEL,Belgium,TUN,Tunisia,2016,156,627,-471
BEL,Belgium,TUN,Tunisia,2017,129,653,-524
CAN,Canada,TUN,Tunisia,2008,0,950,-950
CAN,Canada,TUN,Tunisia,2009,0,1195,-1195
CAN,Canada,TUN,Tunisia,2010,0,1299,-1299
CAN,Canada,TUN,Tunisia,2011,0,1441,-1441
CAN,Canada,TUN,Tunisia,2012,0,1495,-1495
CAN,Canada,TUN,Tunisia,2013,0,1624,-1624
CAN,Canada,TUN,Tunisia,2014,0,1472,-1472
CAN,Canada,TUN,Tunisia,2015,0,1283,-1283
CAN,Canada,TUN,Tunisia,2016,0,1310,-1310
CAN,Canada,TUN,Tunisia,2017,0,1435,-1435
CZE,Czech Republic,TUN,Tunisia,2008,3,80,-77
CZE,Czech Republic,TUN,Tunisia,2009,2,105,-103
CZE,Czech Republic,TUN,Tunisia,2010,1,47,-46
CZE,Czech Republic,TUN,Tunisia,2011,3,47,-44
CZE,Czech Republic,TUN,Tunisia,2012,6,58,-52
CZE,Czech Republic,TUN,Tunisia,2013,28,46,-18
CZE,Czech Republic,TUN,Tunisia,2014,21,81,-60
CZE,Czech Republic,TUN,Tunisia,2015,45,70,-25
CZE,Czech Republic,TUN,Tunisia,2016,16,113,-97
CZE,Czech Republic,TUN,Tunisia,2017,18,124,-106
DNK,Denmark,TUN,Tunisia,2008,11,18,-7
DNK,Denmark,TUN,Tunisia,2009,6,28,-22
DNK,Denmark,TUN,Tunisia,2010,7,26,-19
DNK,Denmark,TUN,Tunisia,2011,12,20,-8
DNK,Denmark,TUN,Tunisia,2012,6,19,-13
DNK,Denmark,TUN,Tunisia,2013,12,34,-22
DNK,Denmark,TUN,Tunisia,2014,14,23,-9
DNK,Denmark,TUN,Tunisia,2015,9,41,-32
DNK,Denmark,TUN,Tunisia,2016,15,42,-27
DNK,Denmark,TUN,Tunisia,2017,15,26,-11
FIN,Finland,TUN,Tunisia,2008,1,37,-36
FIN,Finland,TUN,Tunisia,2009,2,42,-40
FIN,Finland,TUN,Tunisia,2010,2,33,-31
FIN,Finland,TUN,Tunisia,2011,9,25,-16
FIN,Finland,TUN,Tunisia,2012,10,40,-30
FIN,Finland,TUN,Tunisia,2013,5,25,-20
FIN,Finland,TUN,Tunisia,2014,7,36,-29
FIN,Finland,TUN,Tunisia,2015,7,52,-45
FIN,Finland,TUN,Tunisia,2016,7,44,-37
FIN,Finland,TUN,Tunisia,2017,7,34,-27
FRA,France,TUN,Tunisia,2008,0,8802,-8802
FRA,France,TUN,Tunisia,2009,0,10341,-10341
FRA,France,TUN,Tunisia,2010,0,10692,-10692
FRA,France,TUN,Tunisia,2011,0,10296,-10296
FRA,France,TUN,Tunisia,2012,0,11276,-11276
FRA,France,TUN,Tunisia,2013,0,11572,-11572
FRA,France,TUN,Tunisia,2014,0,11904,-11904
FRA,France,TUN,Tunisia,2015,0,10508,-10508
FRA,France,TUN,Tunisia,2016,0,11283,-11283
FRA,France,TUN,Tunisia,2017,0,11669,-11669
DEU,Germany,TUN,Tunisia,2008,1600,1868,-268
DEU,Germany,TUN,Tunisia,2009,1600,1837,-237
DEU,Germany,TUN,Tunisia,2010,1387,1955,-568
DEU,Germany,TUN,Tunisia,2011,1431,2748,-1317
DEU,Germany,TUN,Tunisia,2012,1580,3046,-1466
DEU,Germany,TUN,Tunisia,2013,1683,3859,-2176
DEU,Germany,TUN,Tunisia,2014,2022,4950,-2928
DEU,Germany,TUN,Tunisia,2015,2188,5299,-3111
DEU,Germany,TUN,Tunisia,2016,3186,5541,-2355
DEU,Germany,TUN,Tunisia,2017,2596,5105,-2509
HUN,Hungary,TUN,Tunisia,2008,2,26,-24
HUN,Hungary,TUN,Tunisia,2009,5,29,-24
HUN,Hungary,TUN,Tunisia,2010,2,19,-17
HUN,Hungary,TUN,Tunisia,2011,1,14,-13
HUN,Hungary,TUN,Tunisia,2012,2,20,-18
HUN,Hungary,TUN,Tunisia,2013,0,20,-20
HUN,Hungary,TUN,Tunisia,2014,3,75,-72
HUN,Hungary,TUN,Tunisia,2015,2,100,-98
HUN,Hungary,TUN,Tunisia,2016,8,83,-75
HUN,Hungary,TUN,Tunisia,2017,0,125,-125
ISL,Iceland,TUN,Tunisia,2008,0,2,-2
ISL,Iceland,TUN,Tunisia,2009,0,0,0
ISL,Iceland,TUN,Tunisia,2010,0,2,-2
ISL,Iceland,TUN,Tunisia,2011,0,2,-2
ISL,Iceland,TUN,Tunisia,2012,2,3,-1
ISL,Iceland,TUN,Tunisia,2013,0,1,-1
ISL,Iceland,TUN,Tunisia,2014,0,3,-3
ISL,Iceland,TUN,Tunisia,2015,1,4,-3
ISL,Iceland,TUN,Tunisia,2016,1,3,-2
ISL,Iceland,TUN,Tunisia,2017,1,5,-4
ITA,Italy,TUN,Tunisia,2008,401,6947,-6546
ITA,Italy,TUN,Tunisia,2009,484,5692,-5208
ITA,Italy,TUN,Tunisia,2010,532,6007,-5475
ITA,Italy,TUN,Tunisia,2011,571,5888,-5317
ITA,Italy,TUN,Tunisia,2012,676,5447,-4771
ITA,Italy,TUN,Tunisia,2013,655,4313,-3658
ITA,Italy,TUN,Tunisia,2014,705,3740,-3035
ITA,Italy,TUN,Tunisia,2015,611,3861,-3250
ITA,Italy,TUN,Tunisia,2016,0,3671,-3671
ITA,Italy,TUN,Tunisia,2017,471,3565,-3094
JPN,Japan,TUN,Tunisia,2008,75,102,-27
JPN,Japan,TUN,Tunisia,2009,59,74,-15
JPN,Japan,TUN,Tunisia,2010,70,82,-12
JPN,Japan,TUN,Tunisia,2011,117,123,-6
JPN,Japan,TUN,Tunisia,2012,97,89,8
JPN,Japan,TUN,Tunisia,2013,72,95,-23
JPN,Japan,TUN,Tunisia,2014,84,90,-6
JPN,Japan,TUN,Tunisia,2015,90,102,-12
JPN,Japan,TUN,Tunisia,2016,75,90,-15
JPN,Japan,TUN,Tunisia,2017,97,128,-31
KOR,Korea,TUN,Tunisia,2008,26,29,-3
KOR,Korea,TUN,Tunisia,2009,24,28,-4
KOR,Korea,TUN,Tunisia,2010,24,36,-12
KOR,Korea,TUN,Tunisia,2011,30,41,-11
KOR,Korea,TUN,Tunisia,2012,27,37,-10
KOR,Korea,TUN,Tunisia,2013,30,53,-23
KOR,Korea,TUN,Tunisia,2014,48,68,-20
KOR,Korea,TUN,Tunisia,2015,47,56,-9
KOR,Korea,TUN,Tunisia,2016,50,62,-12
KOR,Korea,TUN,Tunisia,2017,51,66,-15
LUX,Luxembourg,TUN,Tunisia,2008,4,36,-32
LUX,Luxembourg,TUN,Tunisia,2009,13,36,-23
LUX,Luxembourg,TUN,Tunisia,2010,15,36,-21
LUX,Luxembourg,TUN,Tunisia,2011,7,61,-54
LUX,Luxembourg,TUN,Tunisia,2012,21,62,-41
LUX,Luxembourg,TUN,Tunisia,2013,23,79,-56
LUX,Luxembourg,TUN,Tunisia,2014,41,85,-44
LUX,Luxembourg,TUN,Tunisia,2015,43,94,-51
LUX,Luxembourg,TUN,Tunisia,2016,30,83,-53
LUX,Luxembourg,TUN,Tunisia,2017,21,145,-124
MEX,Mexico,TUN,Tunisia,2008,0,1,-1
MEX,Mexico,TUN,Tunisia,2009,0,2,-2
MEX,Mexico,TUN,Tunisia,2010,0,7,-7
MEX,Mexico,TUN,Tunisia,2011,0,3,-3
MEX,Mexico,TUN,Tunisia,2012,0,3,-3
MEX,Mexico,TUN,Tunisia,2013,0,8,-8
MEX,Mexico,TUN,Tunisia,2014,0,7,-7
MEX,Mexico,TUN,Tunisia,2015,0,6,-6
MEX,Mexico,TUN,Tunisia,2016,0,6,-6
MEX,Mexico,TUN,Tunisia,2017,0,7,-7
NLD,Netherlands,TUN,Tunisia,2008,45,100,-55
NLD,Netherlands,TUN,Tunisia,2009,44,108,-64
NLD,Netherlands,TUN,Tunisia,2010,53,97,-44
NLD,Netherlands,TUN,Tunisia,2011,35,122,-87
NLD,Netherlands,TUN,Tunisia,2012,35,144,-109
NLD,Netherlands,TUN,Tunisia,2013,76,146,-70
NLD,Netherlands,TUN,Tunisia,2014,59,129,-70
NLD,Netherlands,TUN,Tunisia,2015,41,128,-87
NLD,Netherlands,TUN,Tunisia,2016,50,162,-112
NLD,Netherlands,TUN,Tunisia,2017,42,209,-167
NZL,New Zealand,TUN,Tunisia,2008,1,1,0
NZL,New Zealand,TUN,Tunisia,2009,0,2,-2
NZL,New Zealand,TUN,Tunisia,2010,1,3,-2
NZL,New Zealand,TUN,Tunisia,2011,1,2,-1
NZL,New Zealand,TUN,Tunisia,2012,0,1,-1
NZL,New Zealand,TUN,Tunisia,2013,0,3,-3
NZL,New Zealand,TUN,Tunisia,2014,2,6,-4
NZL,New Zealand,TUN,Tunisia,2015,0,2,-2
NZL,New Zealand,TUN,Tunisia,2016,4,3,1
NZL,New Zealand,TUN,Tunisia,2017,1,2,-1
NOR,Norway,TUN,Tunisia,2008,11,35,-24
NOR,Norway,TUN,Tunisia,2009,4,46,-42
NOR,Norway,TUN,Tunisia,2010,17,24,-7
NOR,Norway,TUN,Tunisia,2011,17,53,-36
NOR,Norway,TUN,Tunisia,2012,12,47,-35
NOR,Norway,TUN,Tunisia,2013,18,28,-10
NOR,Norway,TUN,Tunisia,2014,12,36,-24
NOR,Norway,TUN,Tunisia,2015,16,38,-22
NOR,Norway,TUN,Tunisia,2016,18,35,-17
NOR,Norway,TUN,Tunisia,2017,11,48,-37
POL,Poland,TUN,Tunisia,2008,0,297,-297
POL,Poland,TUN,Tunisia,2009,0,350,-350
POL,Poland,TUN,Tunisia,2010,0,498,-498
POL,Poland,TUN,Tunisia,2011,0,450,-450
POL,Poland,TUN,Tunisia,2012,0,453,-453
POL,Poland,TUN,Tunisia,2013,0,402,-402
POL,Poland,TUN,Tunisia,2014,0,235,-235
POL,Poland,TUN,Tunisia,2015,0,403,-403
POL,Poland,TUN,Tunisia,2016,0,342,-342
POL,Poland,TUN,Tunisia,2017,0,284,-284
SVK,Slovak Republic,TUN,Tunisia,2008,3,10,-7
SVK,Slovak Republic,TUN,Tunisia,2009,1,6,-5
SVK,Slovak Republic,TUN,Tunisia,2010,2,14,-12
SVK,Slovak Republic,TUN,Tunisia,2011,1,5,-4
SVK,Slovak Republic,TUN,Tunisia,2012,0,6,-6
SVK,Slovak Republic,TUN,Tunisia,2013,0,10,-10
SVK,Slovak Republic,TUN,Tunisia,2014,1,6,-5
SVK,Slovak Republic,TUN,Tunisia,2015,1,8,-7
SVK,Slovak Republic,TUN,Tunisia,2016,0,4,-4
SVK,Slovak Republic,TUN,Tunisia,2017,0,4,-4
ESP,Spain,TUN,Tunisia,2008,102,232,-130
ESP,Spain,TUN,Tunisia,2009,133,194,-61
ESP,Spain,TUN,Tunisia,2010,173,160,13
ESP,Spain,TUN,Tunisia,2011,173,208,-35
ESP,Spain,TUN,Tunisia,2012,147,183,-36
ESP,Spain,TUN,Tunisia,2013,159,205,-46
ESP,Spain,TUN,Tunisia,2014,97,214,-117
ESP,Spain,TUN,Tunisia,2015,81,213,-132
ESP,Spain,TUN,Tunisia,2016,127,247,-120
ESP,Spain,TUN,Tunisia,2017,163,256,-93
SWE,Sweden,TUN,Tunisia,2008,28,183,-155
SWE,Sweden,TUN,Tunisia,2009,14,209,-195
SWE,Sweden,TUN,Tunisia,2010,34,250,-216
SWE,Sweden,TUN,Tunisia,2011,34,228,-194
SWE,Sweden,TUN,Tunisia,2012,28,288,-260
SWE,Sweden,TUN,Tunisia,2013,28,208,-180
SWE,Sweden,TUN,Tunisia,2014,40,193,-153
SWE,Sweden,TUN,Tunisia,2015,58,221,-163
SWE,Sweden,TUN,Tunisia,2016,27,201,-174
SWE,Sweden,TUN,Tunisia,2017,39,250,-211
CHE,Switzerland,TUN,Tunisia,2010,139,569,-430
CHE,Switzerland,TUN,Tunisia,2011,134,523,-389
CHE,Switzerland,TUN,Tunisia,2012,151,503,-352
CHE,Switzerland,TUN,Tunisia,2013,136,509,-373
CHE,Switzerland,TUN,Tunisia,2014,142,458,-316
CHE,Switzerland,TUN,Tunisia,2015,142,521,-379
CHE,Switzerland,TUN,Tunisia,2016,138,584,-446
CHE,Switzerland,TUN,Tunisia,2017,137,475,-338
TUR,Turkey,TUN,Tunisia,2010,0,46,-46
TUR,Turkey,TUN,Tunisia,2016,234,608,-374
TUR,Turkey,TUN,Tunisia,2017,275,810,-535
GBR,United Kingdom,TUN,Tunisia,2013,0,2000,-2000
USA,United States,TUN,Tunisia,2008,0,410,-410
USA,United States,TUN,Tunisia,2009,0,416,-416
USA,United States,TUN,Tunisia,2010,0,418,-418
USA,United States,TUN,Tunisia,2011,0,440,-440
USA,United States,TUN,Tunisia,2012,0,422,-422
USA,United States,TUN,Tunisia,2013,0,445,-445
USA,United States,TUN,Tunisia,2014,0,429,-429
USA,United States,TUN,Tunisia,2015,0,518,-518
USA,United States,TUN,Tunisia,2016,0,518,-518
USA,United States,TUN,Tunisia,2017,0,535,-535
CHL,Chile,TUN,Tunisia,2008,0,2,-2
CHL,Chile,TUN,Tunisia,2009,0,2,-2
CHL,Chile,TUN,Tunisia,2010,0,1,-1
CHL,Chile,TUN,Tunisia,2011,0,1,-1
CHL,Chile,TUN,Tunisia,2012,0,2,-2
CHL,Chile,TUN,Tunisia,2013,0,3,-3
CHL,Chile,TUN,Tunisia,2014,0,1,-1
CHL,Chile,TUN,Tunisia,2015,0,6,-6
CHL,Chile,TUN,Tunisia,2016,0,7,-7
EST,Estonia,TUN,Tunisia,2008,0,1,-1
EST,Estonia,TUN,Tunisia,2009,0,0,0
EST,Estonia,TUN,Tunisia,2010,0,0,0
EST,Estonia,TUN,Tunisia,2011,0,1,-1
EST,Estonia,TUN,Tunisia,2012,0,1,-1
EST,Estonia,TUN,Tunisia,2013,0,1,-1
EST,Estonia,TUN,Tunisia,2014,0,1,-1
EST,Estonia,TUN,Tunisia,2015,0,1,-1
EST,Estonia,TUN,Tunisia,2016,0,7,-7
EST,Estonia,TUN,Tunisia,2017,0,2,-2
ISR,Israel,TUN,Tunisia,2008,0,8,-8
ISR,Israel,TUN,Tunisia,2009,0,14,-14
ISR,Israel,TUN,Tunisia,2010,0,16,-16
ISR,Israel,TUN,Tunisia,2011,0,46,-46
ISR,Israel,TUN,Tunisia,2012,0,40,-40
ISR,Israel,TUN,Tunisia,2013,0,6,-6
ISR,Israel,TUN,Tunisia,2014,0,12,-12
ISR,Israel,TUN,Tunisia,2015,0,12,-12
ISR,Israel,TUN,Tunisia,2016,0,14,-14
ISR,Israel,TUN,Tunisia,2017,0,43,-43
SVN,Slovenia,TUN,Tunisia,2008,0,5,-5
SVN,Slovenia,TUN,Tunisia,2009,0,9,-9
SVN,Slovenia,TUN,Tunisia,2010,0,12,-12
SVN,Slovenia,TUN,Tunisia,2011,0,13,-13
SVN,Slovenia,TUN,Tunisia,2013,1,4,-3
SVN,Slovenia,TUN,Tunisia,2015,1,11,-10
SVN,Slovenia,TUN,Tunisia,2016,0,2,-2
SVN,Slovenia,TUN,Tunisia,2017,2,12,-10
AUS,Australia,TUR,Turkey,2008,0,546,-546
AUS,Australia,TUR,Turkey,2009,0,591,-591
AUS,Australia,TUR,Turkey,2011,0,705,-705
AUS,Australia,TUR,Turkey,2012,0,612,-612
AUS,Australia,TUR,Turkey,2013,0,564,-564
AUS,Australia,TUR,Turkey,2014,0,604,-604
AUS,Australia,TUR,Turkey,2015,0,542,-542
AUT,Austria,TUR,Turkey,2008,0,4983,-4983
AUT,Austria,TUR,Turkey,2009,0,4735,-4735
AUT,Austria,TUR,Turkey,2011,0,3812,-3812
AUT,Austria,TUR,Turkey,2012,0,4088,-4088
AUT,Austria,TUR,Turkey,2013,0,4476,-4476
AUT,Austria,TUR,Turkey,2014,0,3684,-3684
AUT,Austria,TUR,Turkey,2015,0,3653,-3653
BEL,Belgium,TUR,Turkey,2008,0,3172,-3172
BEL,Belgium,TUR,Turkey,2009,0,3118,-3118
BEL,Belgium,TUR,Turkey,2011,0,2897,-2897
BEL,Belgium,TUR,Turkey,2012,0,2391,-2391
BEL,Belgium,TUR,Turkey,2013,0,1973,-1973
BEL,Belgium,TUR,Turkey,2014,0,1617,-1617
BEL,Belgium,TUR,Turkey,2015,0,1724,-1724
CAN,Canada,TUR,Turkey,2008,0,1122,-1122
CAN,Canada,TUR,Turkey,2009,0,1238,-1238
CAN,Canada,TUR,Turkey,2011,0,1255,-1255
CAN,Canada,TUR,Turkey,2012,0,1068,-1068
CAN,Canada,TUR,Turkey,2013,0,729,-729
CAN,Canada,TUR,Turkey,2014,0,717,-717
CAN,Canada,TUR,Turkey,2015,0,874,-874
CZE,Czech Republic,TUR,Turkey,2008,0,394,-394
CZE,Czech Republic,TUR,Turkey,2009,0,398,-398
CZE,Czech Republic,TUR,Turkey,2011,0,430,-430
CZE,Czech Republic,TUR,Turkey,2012,0,366,-366
CZE,Czech Republic,TUR,Turkey,2013,0,435,-435
CZE,Czech Republic,TUR,Turkey,2014,0,390,-390
CZE,Czech Republic,TUR,Turkey,2015,0,381,-381
DNK,Denmark,TUR,Turkey,2008,0,571,-571
DNK,Denmark,TUR,Turkey,2009,0,649,-649
DNK,Denmark,TUR,Turkey,2011,0,400,-400
DNK,Denmark,TUR,Turkey,2012,0,326,-326
DNK,Denmark,TUR,Turkey,2013,0,523,-523
DNK,Denmark,TUR,Turkey,2014,0,436,-436
DNK,Denmark,TUR,Turkey,2015,0,417,-417
FIN,Finland,TUR,Turkey,2008,0,439,-439
FIN,Finland,TUR,Turkey,2009,0,430,-430
FIN,Finland,TUR,Turkey,2011,0,312,-312
FIN,Finland,TUR,Turkey,2012,0,409,-409
FIN,Finland,TUR,Turkey,2013,0,382,-382
FIN,Finland,TUR,Turkey,2014,0,346,-346
FIN,Finland,TUR,Turkey,2015,0,297,-297
FRA,France,TUR,Turkey,2008,0,7153,-7153
FRA,France,TUR,Turkey,2009,0,6717,-6717
FRA,France,TUR,Turkey,2011,0,5464,-5464
FRA,France,TUR,Turkey,2012,0,5753,-5753
FRA,France,TUR,Turkey,2013,0,5922,-5922
FRA,France,TUR,Turkey,2014,0,5290,-5290
FRA,France,TUR,Turkey,2015,0,4948,-4948
DEU,Germany,TUR,Turkey,2008,0,26653,-26653
DEU,Germany,TUR,Turkey,2009,0,27212,-27212
DEU,Germany,TUR,Turkey,2011,0,28610,-28610
DEU,Germany,TUR,Turkey,2012,0,26150,-26150
DEU,Germany,TUR,Turkey,2013,0,23230,-23230
DEU,Germany,TUR,Turkey,2014,0,22058,-22058
DEU,Germany,TUR,Turkey,2015,0,23698,-23698
HUN,Hungary,TUR,Turkey,2008,0,720,-720
HUN,Hungary,TUR,Turkey,2009,0,520,-520
HUN,Hungary,TUR,Turkey,2011,0,576,-576
HUN,Hungary,TUR,Turkey,2012,0,569,-569
HUN,Hungary,TUR,Turkey,2013,0,499,-499
HUN,Hungary,TUR,Turkey,2014,0,567,-567
HUN,Hungary,TUR,Turkey,2015,0,565,-565
ISL,Iceland,TUR,Turkey,2008,0,7,-7
ISL,Iceland,TUR,Turkey,2009,0,2,-2
ISL,Iceland,TUR,Turkey,2011,0,3,-3
ISL,Iceland,TUR,Turkey,2012,0,4,-4
ISL,Iceland,TUR,Turkey,2013,0,7,-7
ISL,Iceland,TUR,Turkey,2014,0,7,-7
ISL,Iceland,TUR,Turkey,2015,0,7,-7
ISL,Iceland,TUR,Turkey,2016,0,6,-6
ISL,Iceland,TUR,Turkey,2017,0,10,-10
ITA,Italy,TUR,Turkey,2008,0,1441,-1441
ITA,Italy,TUR,Turkey,2009,0,1394,-1394
ITA,Italy,TUR,Turkey,2011,0,1397,-1397
ITA,Italy,TUR,Turkey,2012,0,1202,-1202
ITA,Italy,TUR,Turkey,2013,0,1169,-1169
ITA,Italy,TUR,Turkey,2014,0,927,-927
ITA,Italy,TUR,Turkey,2015,0,875,-875
JPN,Japan,TUR,Turkey,2008,0,663,-663
JPN,Japan,TUR,Turkey,2009,0,489,-489
JPN,Japan,TUR,Turkey,2011,0,599,-599
JPN,Japan,TUR,Turkey,2012,0,833,-833
JPN,Japan,TUR,Turkey,2013,0,908,-908
JPN,Japan,TUR,Turkey,2014,0,1150,-1150
JPN,Japan,TUR,Turkey,2015,0,1236,-1236
KOR,Korea,TUR,Turkey,2008,0,386,-386
KOR,Korea,TUR,Turkey,2009,0,318,-318
KOR,Korea,TUR,Turkey,2011,0,367,-367
KOR,Korea,TUR,Turkey,2012,0,321,-321
KOR,Korea,TUR,Turkey,2013,0,308,-308
KOR,Korea,TUR,Turkey,2014,0,324,-324
KOR,Korea,TUR,Turkey,2015,0,338,-338
LUX,Luxembourg,TUR,Turkey,2008,0,37,-37
LUX,Luxembourg,TUR,Turkey,2009,0,74,-74
LUX,Luxembourg,TUR,Turkey,2011,0,77,-77
LUX,Luxembourg,TUR,Turkey,2012,0,90,-90
LUX,Luxembourg,TUR,Turkey,2013,0,63,-63
LUX,Luxembourg,TUR,Turkey,2014,0,66,-66
LUX,Luxembourg,TUR,Turkey,2015,0,96,-96
LUX,Luxembourg,TUR,Turkey,2016,0,114,-114
LUX,Luxembourg,TUR,Turkey,2017,0,231,-231
MEX,Mexico,TUR,Turkey,2008,0,17,-17
MEX,Mexico,TUR,Turkey,2009,0,31,-31
MEX,Mexico,TUR,Turkey,2011,0,20,-20
MEX,Mexico,TUR,Turkey,2012,0,17,-17
MEX,Mexico,TUR,Turkey,2013,0,54,-54
MEX,Mexico,TUR,Turkey,2014,0,38,-38
MEX,Mexico,TUR,Turkey,2015,0,30,-30
NLD,Netherlands,TUR,Turkey,2008,0,3299,-3299
NLD,Netherlands,TUR,Turkey,2009,0,3468,-3468
NLD,Netherlands,TUR,Turkey,2011,0,3387,-3387
NLD,Netherlands,TUR,Turkey,2012,0,3190,-3190
NLD,Netherlands,TUR,Turkey,2013,0,3035,-3035
NLD,Netherlands,TUR,Turkey,2014,0,2840,-2840
NLD,Netherlands,TUR,Turkey,2015,0,2843,-2843
NZL,New Zealand,TUR,Turkey,2008,0,45,-45
NZL,New Zealand,TUR,Turkey,2009,0,53,-53
NZL,New Zealand,TUR,Turkey,2011,0,55,-55
NZL,New Zealand,TUR,Turkey,2012,0,42,-42
NZL,New Zealand,TUR,Turkey,2013,0,44,-44
NZL,New Zealand,TUR,Turkey,2014,0,76,-76
NZL,New Zealand,TUR,Turkey,2015,0,78,-78
NZL,New Zealand,TUR,Turkey,2016,0,67,-67
NZL,New Zealand,TUR,Turkey,2017,0,77,-77
NOR,Norway,TUR,Turkey,2008,0,308,-308
NOR,Norway,TUR,Turkey,2009,0,414,-414
NOR,Norway,TUR,Turkey,2011,0,281,-281
NOR,Norway,TUR,Turkey,2012,0,306,-306
NOR,Norway,TUR,Turkey,2013,0,290,-290
NOR,Norway,TUR,Turkey,2014,0,290,-290
NOR,Norway,TUR,Turkey,2015,0,247,-247
POL,Poland,TUR,Turkey,2008,0,918,-918
POL,Poland,TUR,Turkey,2009,0,1002,-1002
POL,Poland,TUR,Turkey,2011,0,1239,-1239
POL,Poland,TUR,Turkey,2012,0,1340,-1340
POL,Poland,TUR,Turkey,2013,0,1420,-1420
POL,Poland,TUR,Turkey,2014,0,922,-922
POL,Poland,TUR,Turkey,2015,0,1669,-1669
SVK,Slovak Republic,TUR,Turkey,2008,0,10,-10
SVK,Slovak Republic,TUR,Turkey,2009,0,8,-8
SVK,Slovak Republic,TUR,Turkey,2011,0,13,-13
SVK,Slovak Republic,TUR,Turkey,2012,0,10,-10
SVK,Slovak Republic,TUR,Turkey,2013,0,12,-12
SVK,Slovak Republic,TUR,Turkey,2014,0,5,-5
SVK,Slovak Republic,TUR,Turkey,2015,0,13,-13
SVK,Slovak Republic,TUR,Turkey,2016,0,8,-8
SVK,Slovak Republic,TUR,Turkey,2017,0,9,-9
ESP,Spain,TUR,Turkey,2008,0,514,-514
ESP,Spain,TUR,Turkey,2009,0,461,-461
ESP,Spain,TUR,Turkey,2011,0,640,-640
ESP,Spain,TUR,Turkey,2012,0,590,-590
ESP,Spain,TUR,Turkey,2013,0,546,-546
ESP,Spain,TUR,Turkey,2014,0,527,-527
ESP,Spain,TUR,Turkey,2015,0,641,-641
SWE,Sweden,TUR,Turkey,2008,0,1458,-1458
SWE,Sweden,TUR,Turkey,2009,0,1970,-1970
SWE,Sweden,TUR,Turkey,2011,0,1965,-1965
SWE,Sweden,TUR,Turkey,2012,0,1793,-1793
SWE,Sweden,TUR,Turkey,2013,0,1326,-1326
SWE,Sweden,TUR,Turkey,2014,0,1216,-1216
SWE,Sweden,TUR,Turkey,2015,0,1228,-1228
CHE,Switzerland,TUR,Turkey,2008,0,2146,-2146
CHE,Switzerland,TUR,Turkey,2009,0,2198,-2198
CHE,Switzerland,TUR,Turkey,2011,0,1787,-1787
CHE,Switzerland,TUR,Turkey,2012,0,1637,-1637
CHE,Switzerland,TUR,Turkey,2013,0,1659,-1659
CHE,Switzerland,TUR,Turkey,2014,0,1665,-1665
CHE,Switzerland,TUR,Turkey,2015,0,1548,-1548
GBR,United Kingdom,TUR,Turkey,2011,0,1000,-1000
GBR,United Kingdom,TUR,Turkey,2012,0,1000,-1000
GBR,United Kingdom,TUR,Turkey,2013,0,5000,-5000
GBR,United Kingdom,TUR,Turkey,2014,0,4000,-4000
GBR,United Kingdom,TUR,Turkey,2015,0,2000,-2000
USA,United States,TUR,Turkey,2008,0,4210,-4210
USA,United States,TUR,Turkey,2009,0,4958,-4958
USA,United States,TUR,Turkey,2011,0,4403,-4403
USA,United States,TUR,Turkey,2012,0,4162,-4162
USA,United States,TUR,Turkey,2013,0,4144,-4144
USA,United States,TUR,Turkey,2014,0,3834,-3834
USA,United States,TUR,Turkey,2015,0,4201,-4201
CHL,Chile,TUR,Turkey,2008,0,39,-39
CHL,Chile,TUR,Turkey,2009,0,30,-30
CHL,Chile,TUR,Turkey,2011,0,38,-38
CHL,Chile,TUR,Turkey,2012,0,66,-66
CHL,Chile,TUR,Turkey,2013,0,33,-33
CHL,Chile,TUR,Turkey,2014,0,41,-41
CHL,Chile,TUR,Turkey,2015,0,78,-78
CHL,Chile,TUR,Turkey,2016,0,64,-64
EST,Estonia,TUR,Turkey,2008,0,11,-11
EST,Estonia,TUR,Turkey,2009,0,21,-21
EST,Estonia,TUR,Turkey,2011,0,18,-18
EST,Estonia,TUR,Turkey,2012,0,22,-22
EST,Estonia,TUR,Turkey,2013,0,38,-38
EST,Estonia,TUR,Turkey,2014,0,22,-22
EST,Estonia,TUR,Turkey,2015,0,66,-66
EST,Estonia,TUR,Turkey,2016,0,61,-61
EST,Estonia,TUR,Turkey,2017,0,97,-97
ISR,Israel,TUR,Turkey,2008,0,98,-98
ISR,Israel,TUR,Turkey,2009,0,145,-145
ISR,Israel,TUR,Turkey,2011,0,104,-104
ISR,Israel,TUR,Turkey,2012,0,62,-62
ISR,Israel,TUR,Turkey,2013,0,64,-64
ISR,Israel,TUR,Turkey,2014,0,57,-57
ISR,Israel,TUR,Turkey,2015,0,90,-90
ISR,Israel,TUR,Turkey,2016,0,239,-239
SVN,Slovenia,TUR,Turkey,2008,0,105,-105
SVN,Slovenia,TUR,Turkey,2009,0,95,-95
SVN,Slovenia,TUR,Turkey,2011,0,169,-169
SVN,Slovenia,TUR,Turkey,2012,0,83,-83
SVN,Slovenia,TUR,Turkey,2013,0,92,-92
SVN,Slovenia,TUR,Turkey,2014,0,54,-54
SVN,Slovenia,TUR,Turkey,2015,0,49,-49
SVN,Slovenia,TUR,Turkey,2016,0,39,-39
SVN,Slovenia,TUR,Turkey,2017,0,71,-71
AUS,Australia,TKM,Turkmenistan,2008,0,1,-1
AUS,Australia,TKM,Turkmenistan,2009,0,1,-1
AUS,Australia,TKM,Turkmenistan,2010,0,6,-6
AUS,Australia,TKM,Turkmenistan,2011,0,3,-3
AUS,Australia,TKM,Turkmenistan,2012,0,2,-2
AUS,Australia,TKM,Turkmenistan,2013,0,2,-2
AUS,Australia,TKM,Turkmenistan,2014,0,0,0
AUS,Australia,TKM,Turkmenistan,2015,0,0,0
AUS,Australia,TKM,Turkmenistan,2017,0,3,-3
AUT,Austria,TKM,Turkmenistan,2008,9,9,0
AUT,Austria,TKM,Turkmenistan,2009,5,31,-26
AUT,Austria,TKM,Turkmenistan,2010,11,31,-20
AUT,Austria,TKM,Turkmenistan,2011,15,40,-25
AUT,Austria,TKM,Turkmenistan,2012,18,31,-13
AUT,Austria,TKM,Turkmenistan,2013,25,14,11
AUT,Austria,TKM,Turkmenistan,2014,9,22,-13
AUT,Austria,TKM,Turkmenistan,2015,20,24,-4
AUT,Austria,TKM,Turkmenistan,2016,11,14,-3
AUT,Austria,TKM,Turkmenistan,2017,14,23,-9
BEL,Belgium,TKM,Turkmenistan,2008,0,0,0
BEL,Belgium,TKM,Turkmenistan,2009,0,0,0
BEL,Belgium,TKM,Turkmenistan,2010,0,8,-8
BEL,Belgium,TKM,Turkmenistan,2013,6,7,-1
BEL,Belgium,TKM,Turkmenistan,2015,1,4,-3
BEL,Belgium,TKM,Turkmenistan,2016,1,1,0
BEL,Belgium,TKM,Turkmenistan,2017,0,6,-6
CAN,Canada,TKM,Turkmenistan,2008,0,13,-13
CAN,Canada,TKM,Turkmenistan,2009,0,20,-20
CAN,Canada,TKM,Turkmenistan,2010,0,30,-30
CAN,Canada,TKM,Turkmenistan,2011,0,20,-20
CAN,Canada,TKM,Turkmenistan,2012,0,19,-19
CAN,Canada,TKM,Turkmenistan,2013,0,14,-14
CAN,Canada,TKM,Turkmenistan,2014,0,5,-5
CAN,Canada,TKM,Turkmenistan,2015,0,8,-8
CAN,Canada,TKM,Turkmenistan,2016,0,15,-15
CAN,Canada,TKM,Turkmenistan,2017,0,25,-25
CZE,Czech Republic,TKM,Turkmenistan,2008,0,12,-12
CZE,Czech Republic,TKM,Turkmenistan,2009,0,8,-8
CZE,Czech Republic,TKM,Turkmenistan,2010,0,1,-1
CZE,Czech Republic,TKM,Turkmenistan,2011,0,5,-5
CZE,Czech Republic,TKM,Turkmenistan,2012,3,5,-2
CZE,Czech Republic,TKM,Turkmenistan,2013,7,4,3
CZE,Czech Republic,TKM,Turkmenistan,2014,3,6,-3
CZE,Czech Republic,TKM,Turkmenistan,2015,1,3,-2
CZE,Czech Republic,TKM,Turkmenistan,2016,3,8,-5
CZE,Czech Republic,TKM,Turkmenistan,2017,2,9,-7
DNK,Denmark,TKM,Turkmenistan,2008,1,2,-1
DNK,Denmark,TKM,Turkmenistan,2009,0,2,-2
DNK,Denmark,TKM,Turkmenistan,2010,0,1,-1
DNK,Denmark,TKM,Turkmenistan,2012,1,0,1
DNK,Denmark,TKM,Turkmenistan,2013,1,0,1
DNK,Denmark,TKM,Turkmenistan,2014,0,4,-4
DNK,Denmark,TKM,Turkmenistan,2015,0,0,0
DNK,Denmark,TKM,Turkmenistan,2016,1,1,0
DNK,Denmark,TKM,Turkmenistan,2017,1,1,0
FIN,Finland,TKM,Turkmenistan,2008,0,3,-3
FIN,Finland,TKM,Turkmenistan,2009,0,3,-3
FIN,Finland,TKM,Turkmenistan,2010,0,1,-1
FIN,Finland,TKM,Turkmenistan,2011,0,0,0
FIN,Finland,TKM,Turkmenistan,2012,0,1,-1
FIN,Finland,TKM,Turkmenistan,2013,0,0,0
FIN,Finland,TKM,Turkmenistan,2014,0,0,0
FIN,Finland,TKM,Turkmenistan,2015,0,1,-1
FIN,Finland,TKM,Turkmenistan,2016,0,6,-6
FIN,Finland,TKM,Turkmenistan,2017,0,3,-3
FRA,France,TKM,Turkmenistan,2008,0,10,-10
FRA,France,TKM,Turkmenistan,2009,0,15,-15
FRA,France,TKM,Turkmenistan,2010,0,14,-14
FRA,France,TKM,Turkmenistan,2011,0,15,-15
FRA,France,TKM,Turkmenistan,2012,0,8,-8
FRA,France,TKM,Turkmenistan,2013,0,29,-29
FRA,France,TKM,Turkmenistan,2014,0,14,-14
FRA,France,TKM,Turkmenistan,2015,0,19,-19
FRA,France,TKM,Turkmenistan,2016,0,14,-14
FRA,France,TKM,Turkmenistan,2017,0,15,-15
DEU,Germany,TKM,Turkmenistan,2008,91,147,-56
DEU,Germany,TKM,Turkmenistan,2009,105,144,-39
DEU,Germany,TKM,Turkmenistan,2010,99,120,-21
DEU,Germany,TKM,Turkmenistan,2011,111,164,-53
DEU,Germany,TKM,Turkmenistan,2012,105,149,-44
DEU,Germany,TKM,Turkmenistan,2013,106,244,-138
DEU,Germany,TKM,Turkmenistan,2014,128,454,-326
DEU,Germany,TKM,Turkmenistan,2015,178,458,-280
DEU,Germany,TKM,Turkmenistan,2016,215,448,-233
DEU,Germany,TKM,Turkmenistan,2017,158,280,-122
HUN,Hungary,TKM,Turkmenistan,2008,0,1,-1
HUN,Hungary,TKM,Turkmenistan,2009,0,2,-2
HUN,Hungary,TKM,Turkmenistan,2010,0,3,-3
HUN,Hungary,TKM,Turkmenistan,2011,1,5,-4
HUN,Hungary,TKM,Turkmenistan,2012,0,2,-2
HUN,Hungary,TKM,Turkmenistan,2013,0,5,-5
HUN,Hungary,TKM,Turkmenistan,2014,2,16,-14
HUN,Hungary,TKM,Turkmenistan,2015,3,13,-10
HUN,Hungary,TKM,Turkmenistan,2016,4,7,-3
HUN,Hungary,TKM,Turkmenistan,2017,0,6,-6
ISL,Iceland,TKM,Turkmenistan,2016,0,0,0
ISL,Iceland,TKM,Turkmenistan,2017,0,0,0
ITA,Italy,TKM,Turkmenistan,2008,0,48,-48
ITA,Italy,TKM,Turkmenistan,2009,0,22,-22
ITA,Italy,TKM,Turkmenistan,2010,1,11,-10
ITA,Italy,TKM,Turkmenistan,2011,4,5,-1
ITA,Italy,TKM,Turkmenistan,2012,0,6,-6
ITA,Italy,TKM,Turkmenistan,2013,3,10,-7
ITA,Italy,TKM,Turkmenistan,2014,0,9,-9
ITA,Italy,TKM,Turkmenistan,2015,1,14,-13
ITA,Italy,TKM,Turkmenistan,2016,0,9,-9
ITA,Italy,TKM,Turkmenistan,2017,0,8,-8
JPN,Japan,TKM,Turkmenistan,2008,38,40,-2
JPN,Japan,TKM,Turkmenistan,2009,111,118,-7
JPN,Japan,TKM,Turkmenistan,2010,70,74,-4
JPN,Japan,TKM,Turkmenistan,2011,32,39,-7
JPN,Japan,TKM,Turkmenistan,2012,42,52,-10
JPN,Japan,TKM,Turkmenistan,2013,105,104,1
JPN,Japan,TKM,Turkmenistan,2014,43,50,-7
JPN,Japan,TKM,Turkmenistan,2015,152,154,-2
JPN,Japan,TKM,Turkmenistan,2016,39,37,2
JPN,Japan,TKM,Turkmenistan,2017,57,62,-5
KOR,Korea,TKM,Turkmenistan,2008,3,2,1
KOR,Korea,TKM,Turkmenistan,2009,2,9,-7
KOR,Korea,TKM,Turkmenistan,2010,7,11,-4
KOR,Korea,TKM,Turkmenistan,2011,3,8,-5
KOR,Korea,TKM,Turkmenistan,2012,12,22,-10
KOR,Korea,TKM,Turkmenistan,2013,9,12,-3
KOR,Korea,TKM,Turkmenistan,2014,5,7,-2
KOR,Korea,TKM,Turkmenistan,2015,13,13,0
KOR,Korea,TKM,Turkmenistan,2016,18,35,-17
KOR,Korea,TKM,Turkmenistan,2017,12,41,-29
LUX,Luxembourg,TKM,Turkmenistan,2008,0,0,0
LUX,Luxembourg,TKM,Turkmenistan,2009,0,0,0
LUX,Luxembourg,TKM,Turkmenistan,2010,0,0,0
LUX,Luxembourg,TKM,Turkmenistan,2011,0,0,0
LUX,Luxembourg,TKM,Turkmenistan,2012,0,0,0
LUX,Luxembourg,TKM,Turkmenistan,2013,0,0,0
LUX,Luxembourg,TKM,Turkmenistan,2014,0,0,0
LUX,Luxembourg,TKM,Turkmenistan,2015,0,1,-1
LUX,Luxembourg,TKM,Turkmenistan,2016,0,0,0
LUX,Luxembourg,TKM,Turkmenistan,2017,0,6,-6
MEX,Mexico,TKM,Turkmenistan,2008,0,1,-1
MEX,Mexico,TKM,Turkmenistan,2009,0,1,-1
MEX,Mexico,TKM,Turkmenistan,2012,0,0,0
MEX,Mexico,TKM,Turkmenistan,2013,0,1,-1
MEX,Mexico,TKM,Turkmenistan,2014,0,0,0
MEX,Mexico,TKM,Turkmenistan,2016,0,0,0
NLD,Netherlands,TKM,Turkmenistan,2009,2,8,-6
NLD,Netherlands,TKM,Turkmenistan,2010,0,2,-2
NLD,Netherlands,TKM,Turkmenistan,2011,2,6,-4
NLD,Netherlands,TKM,Turkmenistan,2012,1,4,-3
NLD,Netherlands,TKM,Turkmenistan,2013,1,3,-2
NLD,Netherlands,TKM,Turkmenistan,2014,1,4,-3
NLD,Netherlands,TKM,Turkmenistan,2015,0,5,-5
NLD,Netherlands,TKM,Turkmenistan,2016,3,7,-4
NLD,Netherlands,TKM,Turkmenistan,2017,4,6,-2
NZL,New Zealand,TKM,Turkmenistan,2014,0,1,-1
NZL,New Zealand,TKM,Turkmenistan,2016,0,1,-1
NOR,Norway,TKM,Turkmenistan,2008,0,7,-7
NOR,Norway,TKM,Turkmenistan,2009,3,3,0
NOR,Norway,TKM,Turkmenistan,2010,1,7,-6
NOR,Norway,TKM,Turkmenistan,2011,3,3,0
NOR,Norway,TKM,Turkmenistan,2012,2,2,0
NOR,Norway,TKM,Turkmenistan,2013,2,2,0
NOR,Norway,TKM,Turkmenistan,2014,0,2,-2
NOR,Norway,TKM,Turkmenistan,2015,2,4,-2
NOR,Norway,TKM,Turkmenistan,2016,3,0,3
NOR,Norway,TKM,Turkmenistan,2017,1,6,-5
POL,Poland,TKM,Turkmenistan,2008,0,25,-25
POL,Poland,TKM,Turkmenistan,2009,0,40,-40
POL,Poland,TKM,Turkmenistan,2010,0,33,-33
POL,Poland,TKM,Turkmenistan,2011,0,32,-32
POL,Poland,TKM,Turkmenistan,2012,0,42,-42
POL,Poland,TKM,Turkmenistan,2013,0,51,-51
POL,Poland,TKM,Turkmenistan,2014,0,19,-19
POL,Poland,TKM,Turkmenistan,2015,0,25,-25
POL,Poland,TKM,Turkmenistan,2016,0,39,-39
POL,Poland,TKM,Turkmenistan,2017,0,51,-51
SVK,Slovak Republic,TKM,Turkmenistan,2008,0,0,0
SVK,Slovak Republic,TKM,Turkmenistan,2009,0,1,-1
SVK,Slovak Republic,TKM,Turkmenistan,2015,0,1,-1
ESP,Spain,TKM,Turkmenistan,2008,2,2,0
ESP,Spain,TKM,Turkmenistan,2009,0,4,-4
ESP,Spain,TKM,Turkmenistan,2010,0,6,-6
ESP,Spain,TKM,Turkmenistan,2011,1,8,-7
ESP,Spain,TKM,Turkmenistan,2012,1,4,-3
ESP,Spain,TKM,Turkmenistan,2013,1,9,-8
ESP,Spain,TKM,Turkmenistan,2014,4,6,-2
ESP,Spain,TKM,Turkmenistan,2015,3,9,-6
ESP,Spain,TKM,Turkmenistan,2016,2,11,-9
ESP,Spain,TKM,Turkmenistan,2017,5,10,-5
SWE,Sweden,TKM,Turkmenistan,2008,1,8,-7
SWE,Sweden,TKM,Turkmenistan,2009,0,7,-7
SWE,Sweden,TKM,Turkmenistan,2010,0,0,0
SWE,Sweden,TKM,Turkmenistan,2011,3,5,-2
SWE,Sweden,TKM,Turkmenistan,2012,0,1,-1
SWE,Sweden,TKM,Turkmenistan,2013,0,2,-2
SWE,Sweden,TKM,Turkmenistan,2014,0,5,-5
SWE,Sweden,TKM,Turkmenistan,2015,2,3,-1
SWE,Sweden,TKM,Turkmenistan,2016,0,2,-2
SWE,Sweden,TKM,Turkmenistan,2017,0,1,-1
CHE,Switzerland,TKM,Turkmenistan,2010,1,7,-6
CHE,Switzerland,TKM,Turkmenistan,2011,1,4,-3
CHE,Switzerland,TKM,Turkmenistan,2012,1,10,-9
CHE,Switzerland,TKM,Turkmenistan,2013,0,3,-3
CHE,Switzerland,TKM,Turkmenistan,2014,2,10,-8
CHE,Switzerland,TKM,Turkmenistan,2015,0,4,-4
CHE,Switzerland,TKM,Turkmenistan,2016,1,12,-11
CHE,Switzerland,TKM,Turkmenistan,2017,2,6,-4
TUR,Turkey,TKM,Turkmenistan,2010,0,1186,-1186
TUR,Turkey,TKM,Turkmenistan,2016,3555,8394,-4839
TUR,Turkey,TKM,Turkmenistan,2017,4001,20317,-16316
USA,United States,TKM,Turkmenistan,2008,0,274,-274
USA,United States,TKM,Turkmenistan,2009,0,290,-290
USA,United States,TKM,Turkmenistan,2010,0,224,-224
USA,United States,TKM,Turkmenistan,2011,0,260,-260
USA,United States,TKM,Turkmenistan,2012,0,223,-223
USA,United States,TKM,Turkmenistan,2013,0,210,-210
USA,United States,TKM,Turkmenistan,2014,0,254,-254
USA,United States,TKM,Turkmenistan,2015,0,226,-226
USA,United States,TKM,Turkmenistan,2016,0,235,-235
USA,United States,TKM,Turkmenistan,2017,0,251,-251
CHL,Chile,TKM,Turkmenistan,2008,0,0,0
CHL,Chile,TKM,Turkmenistan,2009,0,0,0
CHL,Chile,TKM,Turkmenistan,2010,0,0,0
CHL,Chile,TKM,Turkmenistan,2011,0,0,0
CHL,Chile,TKM,Turkmenistan,2012,0,0,0
CHL,Chile,TKM,Turkmenistan,2013,0,0,0
CHL,Chile,TKM,Turkmenistan,2014,0,0,0
CHL,Chile,TKM,Turkmenistan,2015,0,0,0
CHL,Chile,TKM,Turkmenistan,2016,0,0,0
EST,Estonia,TKM,Turkmenistan,2008,0,0,0
EST,Estonia,TKM,Turkmenistan,2009,0,0,0
EST,Estonia,TKM,Turkmenistan,2010,0,0,0
EST,Estonia,TKM,Turkmenistan,2011,0,0,0
EST,Estonia,TKM,Turkmenistan,2012,0,1,-1
EST,Estonia,TKM,Turkmenistan,2013,0,1,-1
EST,Estonia,TKM,Turkmenistan,2014,0,0,0
EST,Estonia,TKM,Turkmenistan,2015,0,0,0
EST,Estonia,TKM,Turkmenistan,2016,0,2,-2
EST,Estonia,TKM,Turkmenistan,2017,0,0,0
AUS,Australia,TUV,Tuvalu,2008,0,0,0
AUS,Australia,TUV,Tuvalu,2009,0,0,0
AUS,Australia,TUV,Tuvalu,2010,0,17,-17
AUS,Australia,TUV,Tuvalu,2011,0,0,0
AUS,Australia,TUV,Tuvalu,2012,0,6,-6
AUS,Australia,TUV,Tuvalu,2013,0,0,0
AUS,Australia,TUV,Tuvalu,2014,0,7,-7
AUS,Australia,TUV,Tuvalu,2015,0,0,0
AUS,Australia,TUV,Tuvalu,2017,0,3,-3
AUT,Austria,TUV,Tuvalu,2008,0,0,0
AUT,Austria,TUV,Tuvalu,2009,0,0,0
AUT,Austria,TUV,Tuvalu,2010,0,0,0
AUT,Austria,TUV,Tuvalu,2011,0,0,0
AUT,Austria,TUV,Tuvalu,2012,0,0,0
AUT,Austria,TUV,Tuvalu,2013,0,1,-1
AUT,Austria,TUV,Tuvalu,2014,0,0,0
AUT,Austria,TUV,Tuvalu,2015,0,0,0
AUT,Austria,TUV,Tuvalu,2016,0,0,0
AUT,Austria,TUV,Tuvalu,2017,0,0,0
BEL,Belgium,TUV,Tuvalu,2009,0,0,0
BEL,Belgium,TUV,Tuvalu,2010,0,0,0
BEL,Belgium,TUV,Tuvalu,2017,0,1,-1
CAN,Canada,TUV,Tuvalu,2008,0,0,0
CAN,Canada,TUV,Tuvalu,2009,0,0,0
CAN,Canada,TUV,Tuvalu,2010,0,0,0
CAN,Canada,TUV,Tuvalu,2011,0,1,-1
CAN,Canada,TUV,Tuvalu,2012,0,0,0
CAN,Canada,TUV,Tuvalu,2013,0,0,0
CAN,Canada,TUV,Tuvalu,2014,0,0,0
CAN,Canada,TUV,Tuvalu,2015,0,0,0
CAN,Canada,TUV,Tuvalu,2016,0,0,0
CAN,Canada,TUV,Tuvalu,2017,0,0,0
DNK,Denmark,TUV,Tuvalu,2014,0,0,0
DNK,Denmark,TUV,Tuvalu,2015,0,1,-1
DNK,Denmark,TUV,Tuvalu,2016,0,0,0
DNK,Denmark,TUV,Tuvalu,2017,0,0,0
FIN,Finland,TUV,Tuvalu,2008,0,0,0
FIN,Finland,TUV,Tuvalu,2009,0,0,0
FIN,Finland,TUV,Tuvalu,2010,0,0,0
FIN,Finland,TUV,Tuvalu,2011,0,0,0
FIN,Finland,TUV,Tuvalu,2012,0,0,0
FIN,Finland,TUV,Tuvalu,2013,0,0,0
FIN,Finland,TUV,Tuvalu,2014,0,0,0
FIN,Finland,TUV,Tuvalu,2015,0,0,0
FIN,Finland,TUV,Tuvalu,2016,0,0,0
FIN,Finland,TUV,Tuvalu,2017,0,0,0
FRA,France,TUV,Tuvalu,2008,0,0,0
FRA,France,TUV,Tuvalu,2009,0,0,0
FRA,France,TUV,Tuvalu,2010,0,0,0
FRA,France,TUV,Tuvalu,2011,0,0,0
FRA,France,TUV,Tuvalu,2012,0,0,0
FRA,France,TUV,Tuvalu,2013,0,0,0
FRA,France,TUV,Tuvalu,2014,0,1,-1
FRA,France,TUV,Tuvalu,2015,0,0,0
FRA,France,TUV,Tuvalu,2016,0,0,0
FRA,France,TUV,Tuvalu,2017,0,0,0
DEU,Germany,TUV,Tuvalu,2008,102,147,-45
DEU,Germany,TUV,Tuvalu,2009,146,81,65
DEU,Germany,TUV,Tuvalu,2010,50,33,17
DEU,Germany,TUV,Tuvalu,2011,33,38,-5
DEU,Germany,TUV,Tuvalu,2012,60,27,33
DEU,Germany,TUV,Tuvalu,2013,15,4,11
DEU,Germany,TUV,Tuvalu,2014,2,2,0
DEU,Germany,TUV,Tuvalu,2015,1,2,-1
DEU,Germany,TUV,Tuvalu,2016,2,2,0
DEU,Germany,TUV,Tuvalu,2017,1,3,-2
HUN,Hungary,TUV,Tuvalu,2008,0,0,0
HUN,Hungary,TUV,Tuvalu,2009,0,0,0
HUN,Hungary,TUV,Tuvalu,2010,0,0,0
HUN,Hungary,TUV,Tuvalu,2011,0,0,0
HUN,Hungary,TUV,Tuvalu,2012,0,0,0
HUN,Hungary,TUV,Tuvalu,2013,0,0,0
HUN,Hungary,TUV,Tuvalu,2014,0,0,0
HUN,Hungary,TUV,Tuvalu,2015,0,0,0
HUN,Hungary,TUV,Tuvalu,2016,0,0,0
HUN,Hungary,TUV,Tuvalu,2017,0,0,0
ISL,Iceland,TUV,Tuvalu,2016,0,0,0
ISL,Iceland,TUV,Tuvalu,2017,0,0,0
ITA,Italy,TUV,Tuvalu,2008,0,1,-1
ITA,Italy,TUV,Tuvalu,2009,0,0,0
ITA,Italy,TUV,Tuvalu,2010,0,0,0
ITA,Italy,TUV,Tuvalu,2011,0,0,0
ITA,Italy,TUV,Tuvalu,2012,0,0,0
ITA,Italy,TUV,Tuvalu,2013,0,0,0
ITA,Italy,TUV,Tuvalu,2015,0,0,0
JPN,Japan,TUV,Tuvalu,2008,28,30,-2
JPN,Japan,TUV,Tuvalu,2009,20,20,0
JPN,Japan,TUV,Tuvalu,2010,22,23,-1
JPN,Japan,TUV,Tuvalu,2011,10,17,-7
JPN,Japan,TUV,Tuvalu,2012,24,23,1
JPN,Japan,TUV,Tuvalu,2013,16,16,0
JPN,Japan,TUV,Tuvalu,2014,28,28,0
JPN,Japan,TUV,Tuvalu,2015,39,39,0
JPN,Japan,TUV,Tuvalu,2016,24,24,0
JPN,Japan,TUV,Tuvalu,2017,30,31,-1
KOR,Korea,TUV,Tuvalu,2008,1,0,1
KOR,Korea,TUV,Tuvalu,2009,0,0,0
KOR,Korea,TUV,Tuvalu,2010,0,0,0
KOR,Korea,TUV,Tuvalu,2011,1,3,-2
KOR,Korea,TUV,Tuvalu,2012,2,2,0
KOR,Korea,TUV,Tuvalu,2013,1,0,1
KOR,Korea,TUV,Tuvalu,2014,0,0,0
KOR,Korea,TUV,Tuvalu,2015,0,0,0
KOR,Korea,TUV,Tuvalu,2016,0,0,0
KOR,Korea,TUV,Tuvalu,2017,0,0,0
LUX,Luxembourg,TUV,Tuvalu,2008,0,0,0
LUX,Luxembourg,TUV,Tuvalu,2009,0,0,0
LUX,Luxembourg,TUV,Tuvalu,2010,0,0,0
LUX,Luxembourg,TUV,Tuvalu,2011,0,0,0
LUX,Luxembourg,TUV,Tuvalu,2012,0,0,0
LUX,Luxembourg,TUV,Tuvalu,2013,0,0,0
LUX,Luxembourg,TUV,Tuvalu,2014,0,0,0
LUX,Luxembourg,TUV,Tuvalu,2015,0,0,0
LUX,Luxembourg,TUV,Tuvalu,2016,0,0,0
LUX,Luxembourg,TUV,Tuvalu,2017,0,0,0
MEX,Mexico,TUV,Tuvalu,2012,0,0,0
MEX,Mexico,TUV,Tuvalu,2013,0,0,0
MEX,Mexico,TUV,Tuvalu,2014,0,0,0
NZL,New Zealand,TUV,Tuvalu,2008,20,25,-5
NZL,New Zealand,TUV,Tuvalu,2009,18,42,-24
NZL,New Zealand,TUV,Tuvalu,2010,31,40,-9
NZL,New Zealand,TUV,Tuvalu,2011,24,28,-4
NZL,New Zealand,TUV,Tuvalu,2012,25,41,-16
NZL,New Zealand,TUV,Tuvalu,2013,22,74,-52
NZL,New Zealand,TUV,Tuvalu,2014,16,64,-48
NZL,New Zealand,TUV,Tuvalu,2015,12,98,-86
NZL,New Zealand,TUV,Tuvalu,2016,25,56,-31
NZL,New Zealand,TUV,Tuvalu,2017,12,100,-88
NOR,Norway,TUV,Tuvalu,2008,0,0,0
NOR,Norway,TUV,Tuvalu,2009,0,0,0
NOR,Norway,TUV,Tuvalu,2010,0,0,0
NOR,Norway,TUV,Tuvalu,2011,0,0,0
NOR,Norway,TUV,Tuvalu,2012,0,0,0
NOR,Norway,TUV,Tuvalu,2013,0,0,0
NOR,Norway,TUV,Tuvalu,2014,0,0,0
NOR,Norway,TUV,Tuvalu,2015,0,0,0
NOR,Norway,TUV,Tuvalu,2016,0,0,0
NOR,Norway,TUV,Tuvalu,2017,0,0,0
POL,Poland,TUV,Tuvalu,2009,0,0,0
POL,Poland,TUV,Tuvalu,2010,0,0,0
POL,Poland,TUV,Tuvalu,2011,0,0,0
POL,Poland,TUV,Tuvalu,2012,0,0,0
POL,Poland,TUV,Tuvalu,2013,0,0,0
POL,Poland,TUV,Tuvalu,2014,0,0,0
POL,Poland,TUV,Tuvalu,2015,0,0,0
POL,Poland,TUV,Tuvalu,2016,0,0,0
POL,Poland,TUV,Tuvalu,2017,0,0,0
SVK,Slovak Republic,TUV,Tuvalu,2008,0,0,0
ESP,Spain,TUV,Tuvalu,2008,0,0,0
ESP,Spain,TUV,Tuvalu,2009,0,1,-1
ESP,Spain,TUV,Tuvalu,2010,0,0,0
ESP,Spain,TUV,Tuvalu,2011,4,0,4
ESP,Spain,TUV,Tuvalu,2012,0,0,0
ESP,Spain,TUV,Tuvalu,2013,0,0,0
ESP,Spain,TUV,Tuvalu,2014,0,4,-4
ESP,Spain,TUV,Tuvalu,2015,0,0,0
ESP,Spain,TUV,Tuvalu,2016,0,0,0
ESP,Spain,TUV,Tuvalu,2017,0,1,-1
SWE,Sweden,TUV,Tuvalu,2008,0,0,0
SWE,Sweden,TUV,Tuvalu,2009,0,0,0
SWE,Sweden,TUV,Tuvalu,2010,0,0,0
SWE,Sweden,TUV,Tuvalu,2011,0,0,0
SWE,Sweden,TUV,Tuvalu,2012,0,0,0
SWE,Sweden,TUV,Tuvalu,2013,0,0,0
SWE,Sweden,TUV,Tuvalu,2014,0,0,0
SWE,Sweden,TUV,Tuvalu,2015,0,0,0
CHE,Switzerland,TUV,Tuvalu,2010,0,0,0
CHE,Switzerland,TUV,Tuvalu,2011,0,0,0
CHE,Switzerland,TUV,Tuvalu,2012,0,0,0
CHE,Switzerland,TUV,Tuvalu,2013,0,0,0
USA,United States,TUV,Tuvalu,2017,0,3,-3
CHL,Chile,TUV,Tuvalu,2008,0,0,0
CHL,Chile,TUV,Tuvalu,2009,0,0,0
CHL,Chile,TUV,Tuvalu,2010,0,0,0
CHL,Chile,TUV,Tuvalu,2011,0,0,0
CHL,Chile,TUV,Tuvalu,2012,0,0,0
CHL,Chile,TUV,Tuvalu,2013,0,0,0
CHL,Chile,TUV,Tuvalu,2014,0,0,0
CHL,Chile,TUV,Tuvalu,2015,0,0,0
CHL,Chile,TUV,Tuvalu,2016,0,0,0
EST,Estonia,TUV,Tuvalu,2008,0,0,0
EST,Estonia,TUV,Tuvalu,2009,0,0,0
EST,Estonia,TUV,Tuvalu,2010,0,0,0
EST,Estonia,TUV,Tuvalu,2011,0,0,0
EST,Estonia,TUV,Tuvalu,2012,0,0,0
EST,Estonia,TUV,Tuvalu,2013,0,0,0
EST,Estonia,TUV,Tuvalu,2014,0,0,0
EST,Estonia,TUV,Tuvalu,2015,0,0,0
EST,Estonia,TUV,Tuvalu,2016,0,0,0
EST,Estonia,TUV,Tuvalu,2017,0,0,0
AUS,Australia,UGA,Uganda,2008,19,64,-45
AUS,Australia,UGA,Uganda,2009,17,47,-30
AUS,Australia,UGA,Uganda,2010,21,63,-42
AUS,Australia,UGA,Uganda,2011,13,87,-74
AUS,Australia,UGA,Uganda,2012,19,51,-32
AUS,Australia,UGA,Uganda,2013,18,68,-50
AUS,Australia,UGA,Uganda,2014,24,94,-70
AUS,Australia,UGA,Uganda,2015,0,71,-71
AUS,Australia,UGA,Uganda,2016,0,76,-76
AUS,Australia,UGA,Uganda,2017,0,65,-65
AUT,Austria,UGA,Uganda,2008,27,34,-7
AUT,Austria,UGA,Uganda,2009,27,27,0
AUT,Austria,UGA,Uganda,2010,26,28,-2
AUT,Austria,UGA,Uganda,2011,17,39,-22
AUT,Austria,UGA,Uganda,2012,20,46,-26
AUT,Austria,UGA,Uganda,2013,22,27,-5
AUT,Austria,UGA,Uganda,2014,31,44,-13
AUT,Austria,UGA,Uganda,2015,24,71,-47
AUT,Austria,UGA,Uganda,2016,38,56,-18
AUT,Austria,UGA,Uganda,2017,35,45,-10
BEL,Belgium,UGA,Uganda,2008,0,56,-56
BEL,Belgium,UGA,Uganda,2009,0,63,-63
BEL,Belgium,UGA,Uganda,2010,29,56,-27
BEL,Belgium,UGA,Uganda,2012,65,73,-8
BEL,Belgium,UGA,Uganda,2013,70,72,-2
BEL,Belgium,UGA,Uganda,2014,45,65,-20
BEL,Belgium,UGA,Uganda,2015,34,70,-36
BEL,Belgium,UGA,Uganda,2016,37,72,-35
BEL,Belgium,UGA,Uganda,2017,27,61,-34
CAN,Canada,UGA,Uganda,2008,0,204,-204
CAN,Canada,UGA,Uganda,2009,0,185,-185
CAN,Canada,UGA,Uganda,2010,0,216,-216
CAN,Canada,UGA,Uganda,2011,0,213,-213
CAN,Canada,UGA,Uganda,2012,0,222,-222
CAN,Canada,UGA,Uganda,2013,0,204,-204
CAN,Canada,UGA,Uganda,2014,0,170,-170
CAN,Canada,UGA,Uganda,2015,0,182,-182
CAN,Canada,UGA,Uganda,2016,0,180,-180
CAN,Canada,UGA,Uganda,2017,0,215,-215
CZE,Czech Republic,UGA,Uganda,2008,0,4,-4
CZE,Czech Republic,UGA,Uganda,2009,0,2,-2
CZE,Czech Republic,UGA,Uganda,2010,0,2,-2
CZE,Czech Republic,UGA,Uganda,2011,0,1,-1
CZE,Czech Republic,UGA,Uganda,2012,0,1,-1
CZE,Czech Republic,UGA,Uganda,2013,1,2,-1
CZE,Czech Republic,UGA,Uganda,2014,0,9,-9
CZE,Czech Republic,UGA,Uganda,2015,0,5,-5
CZE,Czech Republic,UGA,Uganda,2016,0,2,-2
DNK,Denmark,UGA,Uganda,2008,16,46,-30
DNK,Denmark,UGA,Uganda,2009,20,64,-44
DNK,Denmark,UGA,Uganda,2010,34,65,-31
DNK,Denmark,UGA,Uganda,2011,26,38,-12
DNK,Denmark,UGA,Uganda,2012,33,49,-16
DNK,Denmark,UGA,Uganda,2013,20,57,-37
DNK,Denmark,UGA,Uganda,2014,27,85,-58
DNK,Denmark,UGA,Uganda,2015,20,69,-49
DNK,Denmark,UGA,Uganda,2016,21,60,-39
DNK,Denmark,UGA,Uganda,2017,29,55,-26
FIN,Finland,UGA,Uganda,2008,0,23,-23
FIN,Finland,UGA,Uganda,2009,1,9,-8
FIN,Finland,UGA,Uganda,2010,2,13,-11
FIN,Finland,UGA,Uganda,2011,0,9,-9
FIN,Finland,UGA,Uganda,2012,3,11,-8
FIN,Finland,UGA,Uganda,2013,1,21,-20
FIN,Finland,UGA,Uganda,2014,0,20,-20
FIN,Finland,UGA,Uganda,2015,1,14,-13
FIN,Finland,UGA,Uganda,2016,0,23,-23
FIN,Finland,UGA,Uganda,2017,1,16,-15
FRA,France,UGA,Uganda,2008,0,24,-24
FRA,France,UGA,Uganda,2009,0,13,-13
FRA,France,UGA,Uganda,2010,0,17,-17
FRA,France,UGA,Uganda,2011,0,26,-26
FRA,France,UGA,Uganda,2012,0,26,-26
FRA,France,UGA,Uganda,2013,0,26,-26
FRA,France,UGA,Uganda,2014,0,22,-22
FRA,France,UGA,Uganda,2015,0,38,-38
FRA,France,UGA,Uganda,2016,0,46,-46
FRA,France,UGA,Uganda,2017,0,39,-39
DEU,Germany,UGA,Uganda,2008,146,165,-19
DEU,Germany,UGA,Uganda,2009,134,183,-49
DEU,Germany,UGA,Uganda,2010,144,217,-73
DEU,Germany,UGA,Uganda,2011,110,226,-116
DEU,Germany,UGA,Uganda,2012,123,233,-110
DEU,Germany,UGA,Uganda,2013,137,225,-88
DEU,Germany,UGA,Uganda,2014,117,225,-108
DEU,Germany,UGA,Uganda,2015,122,320,-198
DEU,Germany,UGA,Uganda,2016,126,374,-248
DEU,Germany,UGA,Uganda,2017,151,368,-217
HUN,Hungary,UGA,Uganda,2008,0,6,-6
HUN,Hungary,UGA,Uganda,2009,0,5,-5
HUN,Hungary,UGA,Uganda,2010,1,1,0
HUN,Hungary,UGA,Uganda,2011,0,7,-7
HUN,Hungary,UGA,Uganda,2012,0,2,-2
HUN,Hungary,UGA,Uganda,2013,0,7,-7
HUN,Hungary,UGA,Uganda,2014,1,8,-7
HUN,Hungary,UGA,Uganda,2015,0,7,-7
HUN,Hungary,UGA,Uganda,2016,0,9,-9
HUN,Hungary,UGA,Uganda,2017,0,21,-21
ISL,Iceland,UGA,Uganda,2008,6,7,-1
ISL,Iceland,UGA,Uganda,2009,12,9,3
ISL,Iceland,UGA,Uganda,2010,1,8,-7
ISL,Iceland,UGA,Uganda,2011,4,12,-8
ISL,Iceland,UGA,Uganda,2012,2,9,-7
ISL,Iceland,UGA,Uganda,2013,15,7,8
ISL,Iceland,UGA,Uganda,2014,11,11,0
ISL,Iceland,UGA,Uganda,2015,7,11,-4
ISL,Iceland,UGA,Uganda,2016,14,14,0
ISL,Iceland,UGA,Uganda,2017,7,12,-5
ITA,Italy,UGA,Uganda,2008,7,44,-37
ITA,Italy,UGA,Uganda,2009,7,37,-30
ITA,Italy,UGA,Uganda,2010,3,42,-39
ITA,Italy,UGA,Uganda,2011,3,29,-26
ITA,Italy,UGA,Uganda,2012,1,44,-43
ITA,Italy,UGA,Uganda,2013,7,34,-27
ITA,Italy,UGA,Uganda,2014,5,43,-38
ITA,Italy,UGA,Uganda,2015,6,49,-43
ITA,Italy,UGA,Uganda,2016,0,45,-45
ITA,Italy,UGA,Uganda,2017,8,52,-44
JPN,Japan,UGA,Uganda,2008,146,159,-13
JPN,Japan,UGA,Uganda,2009,110,123,-13
JPN,Japan,UGA,Uganda,2010,142,167,-25
JPN,Japan,UGA,Uganda,2011,138,153,-15
JPN,Japan,UGA,Uganda,2012,183,210,-27
JPN,Japan,UGA,Uganda,2013,223,247,-24
JPN,Japan,UGA,Uganda,2014,138,180,-42
JPN,Japan,UGA,Uganda,2015,189,223,-34
JPN,Japan,UGA,Uganda,2016,134,153,-19
JPN,Japan,UGA,Uganda,2017,169,207,-38
KOR,Korea,UGA,Uganda,2008,28,45,-17
KOR,Korea,UGA,Uganda,2009,33,28,5
KOR,Korea,UGA,Uganda,2010,46,36,10
KOR,Korea,UGA,Uganda,2011,39,113,-74
KOR,Korea,UGA,Uganda,2012,52,88,-36
KOR,Korea,UGA,Uganda,2013,56,74,-18
KOR,Korea,UGA,Uganda,2014,60,121,-61
KOR,Korea,UGA,Uganda,2015,86,189,-103
KOR,Korea,UGA,Uganda,2016,98,215,-117
KOR,Korea,UGA,Uganda,2017,109,138,-29
LUX,Luxembourg,UGA,Uganda,2008,1,2,-1
LUX,Luxembourg,UGA,Uganda,2009,0,0,0
LUX,Luxembourg,UGA,Uganda,2010,1,1,0
LUX,Luxembourg,UGA,Uganda,2011,1,2,-1
LUX,Luxembourg,UGA,Uganda,2012,0,0,0
LUX,Luxembourg,UGA,Uganda,2013,0,1,-1
LUX,Luxembourg,UGA,Uganda,2014,0,5,-5
LUX,Luxembourg,UGA,Uganda,2015,2,3,-1
LUX,Luxembourg,UGA,Uganda,2016,2,3,-1
LUX,Luxembourg,UGA,Uganda,2017,0,2,-2
MEX,Mexico,UGA,Uganda,2008,0,1,-1
MEX,Mexico,UGA,Uganda,2010,0,2,-2
MEX,Mexico,UGA,Uganda,2011,0,1,-1
MEX,Mexico,UGA,Uganda,2012,0,0,0
MEX,Mexico,UGA,Uganda,2013,0,2,-2
MEX,Mexico,UGA,Uganda,2014,0,3,-3
MEX,Mexico,UGA,Uganda,2015,0,2,-2
MEX,Mexico,UGA,Uganda,2016,0,2,-2
NLD,Netherlands,UGA,Uganda,2008,71,124,-53
NLD,Netherlands,UGA,Uganda,2009,62,110,-48
NLD,Netherlands,UGA,Uganda,2010,115,98,17
NLD,Netherlands,UGA,Uganda,2011,84,73,11
NLD,Netherlands,UGA,Uganda,2012,48,93,-45
NLD,Netherlands,UGA,Uganda,2013,107,154,-47
NLD,Netherlands,UGA,Uganda,2014,49,203,-154
NLD,Netherlands,UGA,Uganda,2015,73,205,-132
NLD,Netherlands,UGA,Uganda,2016,75,185,-110
NLD,Netherlands,UGA,Uganda,2017,57,169,-112
NZL,New Zealand,UGA,Uganda,2008,0,9,-9
NZL,New Zealand,UGA,Uganda,2009,3,4,-1
NZL,New Zealand,UGA,Uganda,2010,1,3,-2
NZL,New Zealand,UGA,Uganda,2011,1,2,-1
NZL,New Zealand,UGA,Uganda,2012,1,9,-8
NZL,New Zealand,UGA,Uganda,2013,0,3,-3
NZL,New Zealand,UGA,Uganda,2014,2,3,-1
NZL,New Zealand,UGA,Uganda,2015,2,3,-1
NZL,New Zealand,UGA,Uganda,2016,3,1,2
NZL,New Zealand,UGA,Uganda,2017,2,7,-5
NOR,Norway,UGA,Uganda,2008,44,85,-41
NOR,Norway,UGA,Uganda,2009,74,76,-2
NOR,Norway,UGA,Uganda,2010,60,82,-22
NOR,Norway,UGA,Uganda,2011,62,71,-9
NOR,Norway,UGA,Uganda,2012,55,118,-63
NOR,Norway,UGA,Uganda,2013,52,108,-56
NOR,Norway,UGA,Uganda,2014,49,107,-58
NOR,Norway,UGA,Uganda,2015,47,106,-59
NOR,Norway,UGA,Uganda,2016,59,57,2
NOR,Norway,UGA,Uganda,2017,33,49,-16
POL,Poland,UGA,Uganda,2009,0,7,-7
POL,Poland,UGA,Uganda,2010,0,9,-9
POL,Poland,UGA,Uganda,2011,0,8,-8
POL,Poland,UGA,Uganda,2012,0,11,-11
POL,Poland,UGA,Uganda,2013,0,22,-22
POL,Poland,UGA,Uganda,2014,0,3,-3
POL,Poland,UGA,Uganda,2015,0,12,-12
POL,Poland,UGA,Uganda,2016,0,9,-9
POL,Poland,UGA,Uganda,2017,0,9,-9
SVK,Slovak Republic,UGA,Uganda,2008,0,0,0
SVK,Slovak Republic,UGA,Uganda,2009,0,1,-1
SVK,Slovak Republic,UGA,Uganda,2016,0,2,-2
ESP,Spain,UGA,Uganda,2008,4,25,-21
ESP,Spain,UGA,Uganda,2009,9,17,-8
ESP,Spain,UGA,Uganda,2010,19,15,4
ESP,Spain,UGA,Uganda,2011,14,21,-7
ESP,Spain,UGA,Uganda,2012,4,17,-13
ESP,Spain,UGA,Uganda,2013,13,16,-3
ESP,Spain,UGA,Uganda,2014,7,13,-6
ESP,Spain,UGA,Uganda,2015,4,22,-18
ESP,Spain,UGA,Uganda,2016,10,16,-6
ESP,Spain,UGA,Uganda,2017,13,24,-11
SWE,Sweden,UGA,Uganda,2008,10,147,-137
SWE,Sweden,UGA,Uganda,2009,14,132,-118
SWE,Sweden,UGA,Uganda,2010,21,191,-170
SWE,Sweden,UGA,Uganda,2011,26,179,-153
SWE,Sweden,UGA,Uganda,2012,26,224,-198
SWE,Sweden,UGA,Uganda,2013,28,320,-292
SWE,Sweden,UGA,Uganda,2014,30,333,-303
SWE,Sweden,UGA,Uganda,2015,34,239,-205
SWE,Sweden,UGA,Uganda,2016,20,201,-181
SWE,Sweden,UGA,Uganda,2017,43,177,-134
CHE,Switzerland,UGA,Uganda,2010,13,32,-19
CHE,Switzerland,UGA,Uganda,2011,15,38,-23
CHE,Switzerland,UGA,Uganda,2012,9,17,-8
CHE,Switzerland,UGA,Uganda,2013,15,26,-11
CHE,Switzerland,UGA,Uganda,2014,7,26,-19
CHE,Switzerland,UGA,Uganda,2015,12,26,-14
CHE,Switzerland,UGA,Uganda,2016,8,23,-15
CHE,Switzerland,UGA,Uganda,2017,6,27,-21
TUR,Turkey,UGA,Uganda,2010,0,8,-8
TUR,Turkey,UGA,Uganda,2016,69,167,-98
TUR,Turkey,UGA,Uganda,2017,86,361,-275
GBR,United Kingdom,UGA,Uganda,2011,0,1000,-1000
GBR,United Kingdom,UGA,Uganda,2015,1000,1000,0
USA,United States,UGA,Uganda,2008,0,1174,-1174
USA,United States,UGA,Uganda,2009,0,1364,-1364
USA,United States,UGA,Uganda,2010,0,1085,-1085
USA,United States,UGA,Uganda,2011,0,1239,-1239
USA,United States,UGA,Uganda,2012,0,1340,-1340
USA,United States,UGA,Uganda,2013,0,1350,-1350
USA,United States,UGA,Uganda,2014,0,1409,-1409
USA,United States,UGA,Uganda,2015,0,1664,-1664
USA,United States,UGA,Uganda,2016,0,1649,-1649
USA,United States,UGA,Uganda,2017,0,1898,-1898
CHL,Chile,UGA,Uganda,2008,0,0,0
CHL,Chile,UGA,Uganda,2009,0,0,0
CHL,Chile,UGA,Uganda,2010,0,0,0
CHL,Chile,UGA,Uganda,2011,0,1,-1
CHL,Chile,UGA,Uganda,2012,0,0,0
CHL,Chile,UGA,Uganda,2013,0,0,0
CHL,Chile,UGA,Uganda,2014,0,0,0
CHL,Chile,UGA,Uganda,2015,0,1,-1
CHL,Chile,UGA,Uganda,2016,0,0,0
EST,Estonia,UGA,Uganda,2008,0,0,0
EST,Estonia,UGA,Uganda,2009,0,0,0
EST,Estonia,UGA,Uganda,2010,0,4,-4
EST,Estonia,UGA,Uganda,2011,0,0,0
EST,Estonia,UGA,Uganda,2012,0,0,0
EST,Estonia,UGA,Uganda,2013,0,1,-1
EST,Estonia,UGA,Uganda,2014,0,0,0
EST,Estonia,UGA,Uganda,2015,0,1,-1
EST,Estonia,UGA,Uganda,2016,0,2,-2
EST,Estonia,UGA,Uganda,2017,0,3,-3
SVN,Slovenia,UGA,Uganda,2010,0,1,-1
SVN,Slovenia,UGA,Uganda,2015,0,1,-1
AUS,Australia,UKR,Ukraine,2008,74,291,-217
AUS,Australia,UKR,Ukraine,2009,65,341,-276
AUS,Australia,UKR,Ukraine,2010,50,327,-277
AUS,Australia,UKR,Ukraine,2011,77,374,-297
AUS,Australia,UKR,Ukraine,2012,70,363,-293
AUS,Australia,UKR,Ukraine,2013,66,417,-351
AUS,Australia,UKR,Ukraine,2014,67,353,-286
AUS,Australia,UKR,Ukraine,2015,100,392,-292
AUS,Australia,UKR,Ukraine,2016,100,412,-312
AUS,Australia,UKR,Ukraine,2017,0,428,-428
AUT,Austria,UKR,Ukraine,2008,586,874,-288
AUT,Austria,UKR,Ukraine,2009,548,853,-305
AUT,Austria,UKR,Ukraine,2010,555,910,-355
AUT,Austria,UKR,Ukraine,2011,507,963,-456
AUT,Austria,UKR,Ukraine,2012,513,1125,-612
AUT,Austria,UKR,Ukraine,2013,538,1288,-750
AUT,Austria,UKR,Ukraine,2014,631,1833,-1202
AUT,Austria,UKR,Ukraine,2015,690,1992,-1302
AUT,Austria,UKR,Ukraine,2016,938,1621,-683
AUT,Austria,UKR,Ukraine,2017,982,1627,-645
BEL,Belgium,UKR,Ukraine,2008,100,387,-287
BEL,Belgium,UKR,Ukraine,2009,105,421,-316
BEL,Belgium,UKR,Ukraine,2010,151,583,-432
BEL,Belgium,UKR,Ukraine,2011,152,611,-459
BEL,Belgium,UKR,Ukraine,2012,236,610,-374
BEL,Belgium,UKR,Ukraine,2013,281,511,-230
BEL,Belgium,UKR,Ukraine,2014,249,880,-631
BEL,Belgium,UKR,Ukraine,2015,276,800,-524
BEL,Belgium,UKR,Ukraine,2016,205,546,-341
BEL,Belgium,UKR,Ukraine,2017,164,689,-525
CAN,Canada,UKR,Ukraine,2008,0,1935,-1935
CAN,Canada,UKR,Ukraine,2009,0,2363,-2363
CAN,Canada,UKR,Ukraine,2010,0,3157,-3157
CAN,Canada,UKR,Ukraine,2011,0,2516,-2516
CAN,Canada,UKR,Ukraine,2012,0,2263,-2263
CAN,Canada,UKR,Ukraine,2013,0,2484,-2484
CAN,Canada,UKR,Ukraine,2014,0,2539,-2539
CAN,Canada,UKR,Ukraine,2015,0,2376,-2376
CAN,Canada,UKR,Ukraine,2016,0,3365,-3365
CAN,Canada,UKR,Ukraine,2017,0,3305,-3305
CZE,Czech Republic,UKR,Ukraine,2008,156,18731,-18575
CZE,Czech Republic,UKR,Ukraine,2009,33,8084,-8051
CZE,Czech Republic,UKR,Ukraine,2010,44,3476,-3432
CZE,Czech Republic,UKR,Ukraine,2011,91,1980,-1889
CZE,Czech Republic,UKR,Ukraine,2012,7733,5919,1814
CZE,Czech Republic,UKR,Ukraine,2013,10965,3744,7221
CZE,Czech Republic,UKR,Ukraine,2014,4488,8445,-3957
CZE,Czech Republic,UKR,Ukraine,2015,3208,5454,-2246
CZE,Czech Republic,UKR,Ukraine,2016,2443,5778,-3335
CZE,Czech Republic,UKR,Ukraine,2017,2650,10340,-7690
DNK,Denmark,UKR,Ukraine,2008,1028,1778,-750
DNK,Denmark,UKR,Ukraine,2009,1387,1421,-34
DNK,Denmark,UKR,Ukraine,2010,1359,1242,117
DNK,Denmark,UKR,Ukraine,2011,990,1179,-189
DNK,Denmark,UKR,Ukraine,2012,919,1152,-233
DNK,Denmark,UKR,Ukraine,2013,744,1280,-536
DNK,Denmark,UKR,Ukraine,2014,615,1474,-859
DNK,Denmark,UKR,Ukraine,2015,630,1086,-456
DNK,Denmark,UKR,Ukraine,2016,834,1250,-416
DNK,Denmark,UKR,Ukraine,2017,753,1580,-827
FIN,Finland,UKR,Ukraine,2008,24,249,-225
FIN,Finland,UKR,Ukraine,2009,21,236,-215
FIN,Finland,UKR,Ukraine,2010,20,203,-183
FIN,Finland,UKR,Ukraine,2011,16,271,-255
FIN,Finland,UKR,Ukraine,2012,26,333,-307
FIN,Finland,UKR,Ukraine,2013,33,368,-335
FIN,Finland,UKR,Ukraine,2014,44,445,-401
FIN,Finland,UKR,Ukraine,2015,33,502,-469
FIN,Finland,UKR,Ukraine,2016,54,517,-463
FIN,Finland,UKR,Ukraine,2017,55,545,-490
FRA,France,UKR,Ukraine,2008,0,822,-822
FRA,France,UKR,Ukraine,2009,0,803,-803
FRA,France,UKR,Ukraine,2010,0,737,-737
FRA,France,UKR,Ukraine,2011,0,797,-797
FRA,France,UKR,Ukraine,2012,0,918,-918
FRA,France,UKR,Ukraine,2013,0,1078,-1078
FRA,France,UKR,Ukraine,2014,0,1241,-1241
FRA,France,UKR,Ukraine,2015,0,1348,-1348
FRA,France,UKR,Ukraine,2016,0,1556,-1556
FRA,France,UKR,Ukraine,2017,0,1477,-1477
DEU,Germany,UKR,Ukraine,2008,6337,6869,-532
DEU,Germany,UKR,Ukraine,2009,5679,6947,-1268
DEU,Germany,UKR,Ukraine,2010,4847,6870,-2023
DEU,Germany,UKR,Ukraine,2011,4094,7585,-3491
DEU,Germany,UKR,Ukraine,2012,4074,8198,-4124
DEU,Germany,UKR,Ukraine,2013,4336,8342,-4006
DEU,Germany,UKR,Ukraine,2014,4594,13477,-8883
DEU,Germany,UKR,Ukraine,2015,5376,15778,-10402
DEU,Germany,UKR,Ukraine,2016,6834,13303,-6469
DEU,Germany,UKR,Ukraine,2017,7466,13107,-5641
GRC,Greece,UKR,Ukraine,2008,0,695,-695
GRC,Greece,UKR,Ukraine,2009,0,830,-830
GRC,Greece,UKR,Ukraine,2010,0,947,-947
GRC,Greece,UKR,Ukraine,2011,0,863,-863
HUN,Hungary,UKR,Ukraine,2008,346,4071,-3725
HUN,Hungary,UKR,Ukraine,2009,564,1887,-1323
HUN,Hungary,UKR,Ukraine,2010,432,1619,-1187
HUN,Hungary,UKR,Ukraine,2011,455,1280,-825
HUN,Hungary,UKR,Ukraine,2012,474,859,-385
HUN,Hungary,UKR,Ukraine,2013,327,558,-231
HUN,Hungary,UKR,Ukraine,2014,477,717,-240
HUN,Hungary,UKR,Ukraine,2015,469,1143,-674
HUN,Hungary,UKR,Ukraine,2016,439,1202,-763
HUN,Hungary,UKR,Ukraine,2017,1312,6325,-5013
ISL,Iceland,UKR,Ukraine,2008,21,37,-16
ISL,Iceland,UKR,Ukraine,2009,21,16,5
ISL,Iceland,UKR,Ukraine,2010,9,16,-7
ISL,Iceland,UKR,Ukraine,2011,12,24,-12
ISL,Iceland,UKR,Ukraine,2012,6,35,-29
ISL,Iceland,UKR,Ukraine,2013,12,24,-12
ISL,Iceland,UKR,Ukraine,2014,8,20,-12
ISL,Iceland,UKR,Ukraine,2015,5,33,-28
ISL,Iceland,UKR,Ukraine,2016,8,39,-31
ISL,Iceland,UKR,Ukraine,2017,11,35,-24
ITA,Italy,UKR,Ukraine,2008,875,24039,-23164
ITA,Italy,UKR,Ukraine,2009,1044,22594,-21550
ITA,Italy,UKR,Ukraine,2010,1211,30416,-29205
ITA,Italy,UKR,Ukraine,2011,1212,17889,-16677
ITA,Italy,UKR,Ukraine,2012,1440,11510,-10070
ITA,Italy,UKR,Ukraine,2013,1698,12814,-11116
ITA,Italy,UKR,Ukraine,2014,1763,9665,-7902
ITA,Italy,UKR,Ukraine,2015,1656,9337,-7681
ITA,Italy,UKR,Ukraine,2016,0,8740,-8740
ITA,Italy,UKR,Ukraine,2017,1556,7864,-6308
JPN,Japan,UKR,Ukraine,2008,810,841,-31
JPN,Japan,UKR,Ukraine,2009,878,917,-39
JPN,Japan,UKR,Ukraine,2010,745,722,23
JPN,Japan,UKR,Ukraine,2011,565,580,-15
JPN,Japan,UKR,Ukraine,2012,783,986,-203
JPN,Japan,UKR,Ukraine,2013,727,802,-75
JPN,Japan,UKR,Ukraine,2014,973,945,28
JPN,Japan,UKR,Ukraine,2015,720,822,-102
JPN,Japan,UKR,Ukraine,2016,819,1103,-284
JPN,Japan,UKR,Ukraine,2017,887,1139,-252
KOR,Korea,UKR,Ukraine,2008,408,444,-36
KOR,Korea,UKR,Ukraine,2009,388,291,97
KOR,Korea,UKR,Ukraine,2010,312,389,-77
KOR,Korea,UKR,Ukraine,2011,390,335,55
KOR,Korea,UKR,Ukraine,2012,484,580,-96
KOR,Korea,UKR,Ukraine,2013,442,522,-80
KOR,Korea,UKR,Ukraine,2014,447,674,-227
KOR,Korea,UKR,Ukraine,2015,498,968,-470
KOR,Korea,UKR,Ukraine,2016,653,1240,-587
KOR,Korea,UKR,Ukraine,2017,819,1298,-479
LUX,Luxembourg,UKR,Ukraine,2008,13,45,-32
LUX,Luxembourg,UKR,Ukraine,2009,16,46,-30
LUX,Luxembourg,UKR,Ukraine,2010,10,42,-32
LUX,Luxembourg,UKR,Ukraine,2011,9,62,-53
LUX,Luxembourg,UKR,Ukraine,2012,14,49,-35
LUX,Luxembourg,UKR,Ukraine,2013,10,57,-47
LUX,Luxembourg,UKR,Ukraine,2014,20,120,-100
LUX,Luxembourg,UKR,Ukraine,2015,25,143,-118
LUX,Luxembourg,UKR,Ukraine,2016,49,142,-93
LUX,Luxembourg,UKR,Ukraine,2017,52,180,-128
MEX,Mexico,UKR,Ukraine,2008,0,38,-38
MEX,Mexico,UKR,Ukraine,2009,0,55,-55
MEX,Mexico,UKR,Ukraine,2010,0,40,-40
MEX,Mexico,UKR,Ukraine,2011,0,35,-35
MEX,Mexico,UKR,Ukraine,2012,0,34,-34
MEX,Mexico,UKR,Ukraine,2013,0,121,-121
MEX,Mexico,UKR,Ukraine,2014,0,101,-101
MEX,Mexico,UKR,Ukraine,2015,0,102,-102
MEX,Mexico,UKR,Ukraine,2016,0,92,-92
MEX,Mexico,UKR,Ukraine,2017,0,80,-80
NLD,Netherlands,UKR,Ukraine,2008,161,451,-290
NLD,Netherlands,UKR,Ukraine,2009,175,450,-275
NLD,Netherlands,UKR,Ukraine,2010,158,456,-298
NLD,Netherlands,UKR,Ukraine,2011,168,585,-417
NLD,Netherlands,UKR,Ukraine,2012,231,620,-389
NLD,Netherlands,UKR,Ukraine,2013,224,712,-488
NLD,Netherlands,UKR,Ukraine,2014,211,870,-659
NLD,Netherlands,UKR,Ukraine,2015,257,1119,-862
NLD,Netherlands,UKR,Ukraine,2016,309,1086,-777
NLD,Netherlands,UKR,Ukraine,2017,456,1163,-707
NZL,New Zealand,UKR,Ukraine,2008,15,35,-20
NZL,New Zealand,UKR,Ukraine,2009,7,38,-31
NZL,New Zealand,UKR,Ukraine,2010,14,43,-29
NZL,New Zealand,UKR,Ukraine,2011,7,52,-45
NZL,New Zealand,UKR,Ukraine,2012,15,85,-70
NZL,New Zealand,UKR,Ukraine,2013,11,90,-79
NZL,New Zealand,UKR,Ukraine,2014,14,120,-106
NZL,New Zealand,UKR,Ukraine,2015,13,114,-101
NZL,New Zealand,UKR,Ukraine,2016,20,110,-90
NZL,New Zealand,UKR,Ukraine,2017,22,71,-49
NOR,Norway,UKR,Ukraine,2008,85,343,-258
NOR,Norway,UKR,Ukraine,2009,82,360,-278
NOR,Norway,UKR,Ukraine,2010,99,360,-261
NOR,Norway,UKR,Ukraine,2011,145,492,-347
NOR,Norway,UKR,Ukraine,2012,121,488,-367
NOR,Norway,UKR,Ukraine,2013,164,462,-298
NOR,Norway,UKR,Ukraine,2014,120,446,-326
NOR,Norway,UKR,Ukraine,2015,139,525,-386
NOR,Norway,UKR,Ukraine,2016,156,488,-332
NOR,Norway,UKR,Ukraine,2017,139,473,-334
POL,Poland,UKR,Ukraine,2008,0,10311,-10311
POL,Poland,UKR,Ukraine,2009,0,10125,-10125
POL,Poland,UKR,Ukraine,2010,0,10250,-10250
POL,Poland,UKR,Ukraine,2011,0,10133,-10133
POL,Poland,UKR,Ukraine,2012,0,11829,-11829
POL,Poland,UKR,Ukraine,2013,0,11897,-11897
POL,Poland,UKR,Ukraine,2014,0,7790,-7790
POL,Poland,UKR,Ukraine,2015,0,45237,-45237
POL,Poland,UKR,Ukraine,2016,0,63843,-63843
POL,Poland,UKR,Ukraine,2017,0,78968,-78968
PRT,Portugal,UKR,Ukraine,2008,0,3624,-3624
PRT,Portugal,UKR,Ukraine,2009,0,2362,-2362
PRT,Portugal,UKR,Ukraine,2010,0,2057,-2057
PRT,Portugal,UKR,Ukraine,2011,0,1761,-1761
PRT,Portugal,UKR,Ukraine,2012,0,1460,-1460
PRT,Portugal,UKR,Ukraine,2013,0,1075,-1075
PRT,Portugal,UKR,Ukraine,2014,0,953,-953
PRT,Portugal,UKR,Ukraine,2015,0,1098,-1098
PRT,Portugal,UKR,Ukraine,2016,0,1240,-1240
PRT,Portugal,UKR,Ukraine,2017,0,1247,-1247
SVK,Slovak Republic,UKR,Ukraine,2008,6,98,-92
SVK,Slovak Republic,UKR,Ukraine,2009,1,99,-98
SVK,Slovak Republic,UKR,Ukraine,2010,1,107,-106
SVK,Slovak Republic,UKR,Ukraine,2011,1,105,-104
SVK,Slovak Republic,UKR,Ukraine,2012,1,92,-91
SVK,Slovak Republic,UKR,Ukraine,2013,3,77,-74
SVK,Slovak Republic,UKR,Ukraine,2014,2,94,-92
SVK,Slovak Republic,UKR,Ukraine,2015,0,192,-192
SVK,Slovak Republic,UKR,Ukraine,2016,0,154,-154
SVK,Slovak Republic,UKR,Ukraine,2017,0,202,-202
ESP,Spain,UKR,Ukraine,2008,4257,6863,-2606
ESP,Spain,UKR,Ukraine,2009,4548,4751,-203
ESP,Spain,UKR,Ukraine,2010,4256,4925,-669
ESP,Spain,UKR,Ukraine,2011,4165,5093,-928
ESP,Spain,UKR,Ukraine,2012,4511,3678,833
ESP,Spain,UKR,Ukraine,2013,5449,3348,2101
ESP,Spain,UKR,Ukraine,2014,2890,5680,-2790
ESP,Spain,UKR,Ukraine,2015,2156,8849,-6693
ESP,Spain,UKR,Ukraine,2016,2588,6876,-4288
ESP,Spain,UKR,Ukraine,2017,3540,7768,-4228
SWE,Sweden,UKR,Ukraine,2008,34,376,-342
SWE,Sweden,UKR,Ukraine,2009,30,466,-436
SWE,Sweden,UKR,Ukraine,2010,60,550,-490
SWE,Sweden,UKR,Ukraine,2011,85,601,-516
SWE,Sweden,UKR,Ukraine,2012,77,622,-545
SWE,Sweden,UKR,Ukraine,2013,79,549,-470
SWE,Sweden,UKR,Ukraine,2014,121,605,-484
SWE,Sweden,UKR,Ukraine,2015,185,653,-468
SWE,Sweden,UKR,Ukraine,2016,88,712,-624
SWE,Sweden,UKR,Ukraine,2017,107,965,-858
CHE,Switzerland,UKR,Ukraine,2010,252,738,-486
CHE,Switzerland,UKR,Ukraine,2011,224,811,-587
CHE,Switzerland,UKR,Ukraine,2012,278,771,-493
CHE,Switzerland,UKR,Ukraine,2013,277,860,-583
CHE,Switzerland,UKR,Ukraine,2014,269,840,-571
CHE,Switzerland,UKR,Ukraine,2015,289,866,-577
CHE,Switzerland,UKR,Ukraine,2016,288,743,-455
CHE,Switzerland,UKR,Ukraine,2017,339,667,-328
TUR,Turkey,UKR,Ukraine,2010,0,949,-949
TUR,Turkey,UKR,Ukraine,2016,3364,6531,-3167
TUR,Turkey,UKR,Ukraine,2017,3987,6303,-2316
GBR,United Kingdom,UKR,Ukraine,2011,0,1000,-1000
GBR,United Kingdom,UKR,Ukraine,2013,0,1000,-1000
USA,United States,UKR,Ukraine,2008,0,10813,-10813
USA,United States,UKR,Ukraine,2009,0,11223,-11223
USA,United States,UKR,Ukraine,2010,0,8477,-8477
USA,United States,UKR,Ukraine,2011,0,8292,-8292
USA,United States,UKR,Ukraine,2012,0,7642,-7642
USA,United States,UKR,Ukraine,2013,0,8193,-8193
USA,United States,UKR,Ukraine,2014,0,7752,-7752
USA,United States,UKR,Ukraine,2015,0,7987,-7987
USA,United States,UKR,Ukraine,2016,0,10422,-10422
USA,United States,UKR,Ukraine,2017,0,10135,-10135
CHL,Chile,UKR,Ukraine,2008,0,18,-18
CHL,Chile,UKR,Ukraine,2009,0,16,-16
CHL,Chile,UKR,Ukraine,2010,0,24,-24
CHL,Chile,UKR,Ukraine,2011,0,29,-29
CHL,Chile,UKR,Ukraine,2012,0,32,-32
CHL,Chile,UKR,Ukraine,2013,0,26,-26
CHL,Chile,UKR,Ukraine,2014,0,36,-36
CHL,Chile,UKR,Ukraine,2015,0,44,-44
CHL,Chile,UKR,Ukraine,2016,0,55,-55
EST,Estonia,UKR,Ukraine,2008,0,183,-183
EST,Estonia,UKR,Ukraine,2009,0,221,-221
EST,Estonia,UKR,Ukraine,2010,0,88,-88
EST,Estonia,UKR,Ukraine,2011,0,264,-264
EST,Estonia,UKR,Ukraine,2012,0,188,-188
EST,Estonia,UKR,Ukraine,2013,0,324,-324
EST,Estonia,UKR,Ukraine,2014,0,395,-395
EST,Estonia,UKR,Ukraine,2015,0,1200,-1200
EST,Estonia,UKR,Ukraine,2016,243,1091,-848
EST,Estonia,UKR,Ukraine,2017,293,1037,-744
SVN,Slovenia,UKR,Ukraine,2008,152,516,-364
SVN,Slovenia,UKR,Ukraine,2009,218,31,187
SVN,Slovenia,UKR,Ukraine,2010,163,334,-171
SVN,Slovenia,UKR,Ukraine,2011,66,392,-326
SVN,Slovenia,UKR,Ukraine,2012,44,197,-153
SVN,Slovenia,UKR,Ukraine,2013,18,185,-167
SVN,Slovenia,UKR,Ukraine,2014,15,272,-257
SVN,Slovenia,UKR,Ukraine,2015,26,394,-368
SVN,Slovenia,UKR,Ukraine,2016,49,281,-232
SVN,Slovenia,UKR,Ukraine,2017,58,324,-266
AUS,Australia,ARE,United Arab Emirates,2008,80,4,76
AUS,Australia,ARE,United Arab Emirates,2009,58,5,53
AUS,Australia,ARE,United Arab Emirates,2010,60,7,53
AUS,Australia,ARE,United Arab Emirates,2011,72,2,70
AUS,Australia,ARE,United Arab Emirates,2012,55,12,43
AUS,Australia,ARE,United Arab Emirates,2013,90,3,87
AUS,Australia,ARE,United Arab Emirates,2014,122,11,111
AUS,Australia,ARE,United Arab Emirates,2015,100,20,80
AUS,Australia,ARE,United Arab Emirates,2016,100,14,86
AUS,Australia,ARE,United Arab Emirates,2017,0,25,-25
AUT,Austria,ARE,United Arab Emirates,2008,1,3,-2
AUT,Austria,ARE,United Arab Emirates,2009,4,7,-3
AUT,Austria,ARE,United Arab Emirates,2010,5,30,-25
AUT,Austria,ARE,United Arab Emirates,2011,2,5,-3
AUT,Austria,ARE,United Arab Emirates,2012,21,5,16
AUT,Austria,ARE,United Arab Emirates,2013,4,5,-1
AUT,Austria,ARE,United Arab Emirates,2014,4,6,-2
AUT,Austria,ARE,United Arab Emirates,2015,5,16,-11
AUT,Austria,ARE,United Arab Emirates,2016,9,7,2
AUT,Austria,ARE,United Arab Emirates,2017,7,5,2
BEL,Belgium,ARE,United Arab Emirates,2010,0,2,-2
BEL,Belgium,ARE,United Arab Emirates,2012,2,3,-1
BEL,Belgium,ARE,United Arab Emirates,2013,0,5,-5
BEL,Belgium,ARE,United Arab Emirates,2014,1,2,-1
BEL,Belgium,ARE,United Arab Emirates,2015,7,2,5
BEL,Belgium,ARE,United Arab Emirates,2016,3,1,2
BEL,Belgium,ARE,United Arab Emirates,2017,0,12,-12
CAN,Canada,ARE,United Arab Emirates,2008,0,33,-33
CAN,Canada,ARE,United Arab Emirates,2009,0,37,-37
CAN,Canada,ARE,United Arab Emirates,2010,0,86,-86
CAN,Canada,ARE,United Arab Emirates,2011,0,60,-60
CAN,Canada,ARE,United Arab Emirates,2012,0,54,-54
CAN,Canada,ARE,United Arab Emirates,2013,0,46,-46
CAN,Canada,ARE,United Arab Emirates,2014,0,40,-40
CAN,Canada,ARE,United Arab Emirates,2015,0,33,-33
CAN,Canada,ARE,United Arab Emirates,2016,0,25,-25
CAN,Canada,ARE,United Arab Emirates,2017,0,10,-10
CZE,Czech Republic,ARE,United Arab Emirates,2012,0,1,-1
DNK,Denmark,ARE,United Arab Emirates,2008,0,0,0
DNK,Denmark,ARE,United Arab Emirates,2009,1,1,0
DNK,Denmark,ARE,United Arab Emirates,2010,1,3,-2
DNK,Denmark,ARE,United Arab Emirates,2012,0,1,-1
DNK,Denmark,ARE,United Arab Emirates,2013,0,0,0
DNK,Denmark,ARE,United Arab Emirates,2014,0,1,-1
DNK,Denmark,ARE,United Arab Emirates,2015,2,1,1
DNK,Denmark,ARE,United Arab Emirates,2016,0,0,0
DNK,Denmark,ARE,United Arab Emirates,2017,1,2,-1
FIN,Finland,ARE,United Arab Emirates,2008,0,0,0
FIN,Finland,ARE,United Arab Emirates,2009,0,0,0
FIN,Finland,ARE,United Arab Emirates,2010,0,0,0
FIN,Finland,ARE,United Arab Emirates,2011,0,1,-1
FIN,Finland,ARE,United Arab Emirates,2012,0,0,0
FIN,Finland,ARE,United Arab Emirates,2013,0,1,-1
FIN,Finland,ARE,United Arab Emirates,2014,0,0,0
FIN,Finland,ARE,United Arab Emirates,2015,0,0,0
FIN,Finland,ARE,United Arab Emirates,2016,0,2,-2
FIN,Finland,ARE,United Arab Emirates,2017,0,0,0
FRA,France,ARE,United Arab Emirates,2008,0,6,-6
FRA,France,ARE,United Arab Emirates,2009,0,7,-7
FRA,France,ARE,United Arab Emirates,2010,0,7,-7
FRA,France,ARE,United Arab Emirates,2011,0,9,-9
FRA,France,ARE,United Arab Emirates,2012,0,3,-3
FRA,France,ARE,United Arab Emirates,2013,0,6,-6
FRA,France,ARE,United Arab Emirates,2014,0,8,-8
FRA,France,ARE,United Arab Emirates,2015,0,4,-4
FRA,France,ARE,United Arab Emirates,2016,0,2,-2
FRA,France,ARE,United Arab Emirates,2017,0,1,-1
DEU,Germany,ARE,United Arab Emirates,2008,663,476,187
DEU,Germany,ARE,United Arab Emirates,2009,500,758,-258
DEU,Germany,ARE,United Arab Emirates,2010,617,688,-71
DEU,Germany,ARE,United Arab Emirates,2011,512,563,-51
DEU,Germany,ARE,United Arab Emirates,2012,586,831,-245
DEU,Germany,ARE,United Arab Emirates,2013,1070,1315,-245
DEU,Germany,ARE,United Arab Emirates,2014,1176,1707,-531
DEU,Germany,ARE,United Arab Emirates,2015,1183,2086,-903
DEU,Germany,ARE,United Arab Emirates,2016,1452,1953,-501
DEU,Germany,ARE,United Arab Emirates,2017,2012,1647,365
HUN,Hungary,ARE,United Arab Emirates,2008,1,0,1
HUN,Hungary,ARE,United Arab Emirates,2009,0,0,0
HUN,Hungary,ARE,United Arab Emirates,2010,0,1,-1
HUN,Hungary,ARE,United Arab Emirates,2011,1,0,1
HUN,Hungary,ARE,United Arab Emirates,2012,0,1,-1
HUN,Hungary,ARE,United Arab Emirates,2013,0,2,-2
HUN,Hungary,ARE,United Arab Emirates,2014,1,1,0
HUN,Hungary,ARE,United Arab Emirates,2015,0,1,-1
HUN,Hungary,ARE,United Arab Emirates,2016,1,2,-1
HUN,Hungary,ARE,United Arab Emirates,2017,0,3,-3
ISL,Iceland,ARE,United Arab Emirates,2008,1,0,1
ISL,Iceland,ARE,United Arab Emirates,2009,0,0,0
ISL,Iceland,ARE,United Arab Emirates,2010,0,0,0
ISL,Iceland,ARE,United Arab Emirates,2011,1,0,1
ISL,Iceland,ARE,United Arab Emirates,2012,0,0,0
ISL,Iceland,ARE,United Arab Emirates,2016,0,0,0
ISL,Iceland,ARE,United Arab Emirates,2017,0,0,0
ITA,Italy,ARE,United Arab Emirates,2008,0,7,-7
ITA,Italy,ARE,United Arab Emirates,2009,0,3,-3
ITA,Italy,ARE,United Arab Emirates,2010,0,8,-8
ITA,Italy,ARE,United Arab Emirates,2011,0,1,-1
ITA,Italy,ARE,United Arab Emirates,2012,0,6,-6
ITA,Italy,ARE,United Arab Emirates,2013,0,6,-6
ITA,Italy,ARE,United Arab Emirates,2014,1,6,-5
ITA,Italy,ARE,United Arab Emirates,2015,3,3,0
ITA,Italy,ARE,United Arab Emirates,2016,0,2,-2
ITA,Italy,ARE,United Arab Emirates,2017,2,6,-4
JPN,Japan,ARE,United Arab Emirates,2008,44,55,-11
JPN,Japan,ARE,United Arab Emirates,2009,46,72,-26
JPN,Japan,ARE,United Arab Emirates,2010,25,28,-3
JPN,Japan,ARE,United Arab Emirates,2011,41,47,-6
JPN,Japan,ARE,United Arab Emirates,2012,50,51,-1
JPN,Japan,ARE,United Arab Emirates,2013,97,107,-10
JPN,Japan,ARE,United Arab Emirates,2014,102,117,-15
JPN,Japan,ARE,United Arab Emirates,2015,90,107,-17
JPN,Japan,ARE,United Arab Emirates,2016,96,92,4
JPN,Japan,ARE,United Arab Emirates,2017,89,102,-13
KOR,Korea,ARE,United Arab Emirates,2008,11,18,-7
KOR,Korea,ARE,United Arab Emirates,2009,5,12,-7
KOR,Korea,ARE,United Arab Emirates,2010,20,8,12
KOR,Korea,ARE,United Arab Emirates,2011,28,14,14
KOR,Korea,ARE,United Arab Emirates,2012,24,59,-35
KOR,Korea,ARE,United Arab Emirates,2013,137,251,-114
KOR,Korea,ARE,United Arab Emirates,2014,428,507,-79
KOR,Korea,ARE,United Arab Emirates,2015,588,560,28
KOR,Korea,ARE,United Arab Emirates,2016,559,445,114
KOR,Korea,ARE,United Arab Emirates,2017,463,542,-79
LUX,Luxembourg,ARE,United Arab Emirates,2008,0,0,0
LUX,Luxembourg,ARE,United Arab Emirates,2009,0,0,0
LUX,Luxembourg,ARE,United Arab Emirates,2010,0,0,0
LUX,Luxembourg,ARE,United Arab Emirates,2011,0,0,0
LUX,Luxembourg,ARE,United Arab Emirates,2012,0,0,0
LUX,Luxembourg,ARE,United Arab Emirates,2013,0,0,0
LUX,Luxembourg,ARE,United Arab Emirates,2014,0,0,0
LUX,Luxembourg,ARE,United Arab Emirates,2015,0,0,0
LUX,Luxembourg,ARE,United Arab Emirates,2016,0,1,-1
LUX,Luxembourg,ARE,United Arab Emirates,2017,0,0,0
MEX,Mexico,ARE,United Arab Emirates,2008,0,6,-6
MEX,Mexico,ARE,United Arab Emirates,2009,0,9,-9
MEX,Mexico,ARE,United Arab Emirates,2012,0,0,0
MEX,Mexico,ARE,United Arab Emirates,2013,0,0,0
MEX,Mexico,ARE,United Arab Emirates,2014,0,0,0
NLD,Netherlands,ARE,United Arab Emirates,2008,6,6,0
NLD,Netherlands,ARE,United Arab Emirates,2009,6,6,0
NLD,Netherlands,ARE,United Arab Emirates,2010,3,1,2
NLD,Netherlands,ARE,United Arab Emirates,2011,0,1,-1
NLD,Netherlands,ARE,United Arab Emirates,2012,5,7,-2
NLD,Netherlands,ARE,United Arab Emirates,2013,4,9,-5
NLD,Netherlands,ARE,United Arab Emirates,2014,2,6,-4
NLD,Netherlands,ARE,United Arab Emirates,2015,14,5,9
NLD,Netherlands,ARE,United Arab Emirates,2016,3,2,1
NLD,Netherlands,ARE,United Arab Emirates,2017,1,4,-3
NZL,New Zealand,ARE,United Arab Emirates,2008,0,12,-12
NZL,New Zealand,ARE,United Arab Emirates,2009,0,9,-9
NZL,New Zealand,ARE,United Arab Emirates,2010,2,16,-14
NZL,New Zealand,ARE,United Arab Emirates,2011,9,14,-5
NZL,New Zealand,ARE,United Arab Emirates,2012,10,8,2
NZL,New Zealand,ARE,United Arab Emirates,2013,20,4,16
NZL,New Zealand,ARE,United Arab Emirates,2014,4,6,-2
NZL,New Zealand,ARE,United Arab Emirates,2015,3,2,1
NZL,New Zealand,ARE,United Arab Emirates,2016,6,8,-2
NZL,New Zealand,ARE,United Arab Emirates,2017,1,9,-8
NOR,Norway,ARE,United Arab Emirates,2008,0,3,-3
NOR,Norway,ARE,United Arab Emirates,2009,0,3,-3
NOR,Norway,ARE,United Arab Emirates,2010,0,2,-2
NOR,Norway,ARE,United Arab Emirates,2011,0,3,-3
NOR,Norway,ARE,United Arab Emirates,2012,2,0,2
NOR,Norway,ARE,United Arab Emirates,2013,0,3,-3
NOR,Norway,ARE,United Arab Emirates,2014,0,1,-1
NOR,Norway,ARE,United Arab Emirates,2015,0,0,0
NOR,Norway,ARE,United Arab Emirates,2016,1,0,1
NOR,Norway,ARE,United Arab Emirates,2017,0,1,-1
POL,Poland,ARE,United Arab Emirates,2009,0,0,0
POL,Poland,ARE,United Arab Emirates,2010,0,0,0
POL,Poland,ARE,United Arab Emirates,2011,0,0,0
POL,Poland,ARE,United Arab Emirates,2012,0,0,0
POL,Poland,ARE,United Arab Emirates,2013,0,0,0
POL,Poland,ARE,United Arab Emirates,2014,0,0,0
POL,Poland,ARE,United Arab Emirates,2015,0,0,0
POL,Poland,ARE,United Arab Emirates,2016,0,0,0
POL,Poland,ARE,United Arab Emirates,2017,0,0,0
SVK,Slovak Republic,ARE,United Arab Emirates,2008,2,0,2
SVK,Slovak Republic,ARE,United Arab Emirates,2013,0,1,-1
ESP,Spain,ARE,United Arab Emirates,2008,1,4,-3
ESP,Spain,ARE,United Arab Emirates,2009,0,6,-6
ESP,Spain,ARE,United Arab Emirates,2010,5,2,3
ESP,Spain,ARE,United Arab Emirates,2011,4,13,-9
ESP,Spain,ARE,United Arab Emirates,2012,2,8,-6
ESP,Spain,ARE,United Arab Emirates,2013,7,12,-5
ESP,Spain,ARE,United Arab Emirates,2014,3,15,-12
ESP,Spain,ARE,United Arab Emirates,2015,1,10,-9
ESP,Spain,ARE,United Arab Emirates,2016,5,26,-21
ESP,Spain,ARE,United Arab Emirates,2017,11,30,-19
SWE,Sweden,ARE,United Arab Emirates,2008,1,5,-4
SWE,Sweden,ARE,United Arab Emirates,2009,2,6,-4
SWE,Sweden,ARE,United Arab Emirates,2010,10,4,6
SWE,Sweden,ARE,United Arab Emirates,2011,3,0,3
SWE,Sweden,ARE,United Arab Emirates,2012,14,2,12
SWE,Sweden,ARE,United Arab Emirates,2013,4,3,1
SWE,Sweden,ARE,United Arab Emirates,2014,0,5,-5
SWE,Sweden,ARE,United Arab Emirates,2015,9,3,6
SWE,Sweden,ARE,United Arab Emirates,2016,1,1,0
SWE,Sweden,ARE,United Arab Emirates,2017,3,2,1
CHE,Switzerland,ARE,United Arab Emirates,2010,8,11,-3
CHE,Switzerland,ARE,United Arab Emirates,2011,10,4,6
CHE,Switzerland,ARE,United Arab Emirates,2012,7,6,1
CHE,Switzerland,ARE,United Arab Emirates,2013,9,14,-5
CHE,Switzerland,ARE,United Arab Emirates,2014,8,5,3
CHE,Switzerland,ARE,United Arab Emirates,2015,5,8,-3
CHE,Switzerland,ARE,United Arab Emirates,2016,10,9,1
CHE,Switzerland,ARE,United Arab Emirates,2017,6,9,-3
TUR,Turkey,ARE,United Arab Emirates,2010,0,2,-2
GBR,United Kingdom,ARE,United Arab Emirates,2012,0,1000,-1000
GBR,United Kingdom,ARE,United Arab Emirates,2014,0,2000,-2000
GBR,United Kingdom,ARE,United Arab Emirates,2015,0,1000,-1000
USA,United States,ARE,United Arab Emirates,2008,0,693,-693
USA,United States,ARE,United Arab Emirates,2009,0,697,-697
USA,United States,ARE,United Arab Emirates,2010,0,779,-779
USA,United States,ARE,United Arab Emirates,2011,0,707,-707
USA,United States,ARE,United Arab Emirates,2012,0,854,-854
USA,United States,ARE,United Arab Emirates,2013,0,910,-910
USA,United States,ARE,United Arab Emirates,2014,0,1039,-1039
USA,United States,ARE,United Arab Emirates,2015,0,1193,-1193
USA,United States,ARE,United Arab Emirates,2016,0,1370,-1370
USA,United States,ARE,United Arab Emirates,2017,0,1314,-1314
CHL,Chile,ARE,United Arab Emirates,2008,0,0,0
CHL,Chile,ARE,United Arab Emirates,2009,0,0,0
CHL,Chile,ARE,United Arab Emirates,2010,0,0,0
CHL,Chile,ARE,United Arab Emirates,2011,0,0,0
CHL,Chile,ARE,United Arab Emirates,2012,0,0,0
CHL,Chile,ARE,United Arab Emirates,2013,0,0,0
CHL,Chile,ARE,United Arab Emirates,2014,0,0,0
CHL,Chile,ARE,United Arab Emirates,2015,0,0,0
CHL,Chile,ARE,United Arab Emirates,2016,0,0,0
EST,Estonia,ARE,United Arab Emirates,2008,0,0,0
EST,Estonia,ARE,United Arab Emirates,2009,0,0,0
EST,Estonia,ARE,United Arab Emirates,2010,0,0,0
EST,Estonia,ARE,United Arab Emirates,2011,0,0,0
EST,Estonia,ARE,United Arab Emirates,2012,0,0,0
EST,Estonia,ARE,United Arab Emirates,2013,0,0,0
EST,Estonia,ARE,United Arab Emirates,2014,0,0,0
EST,Estonia,ARE,United Arab Emirates,2015,0,0,0
EST,Estonia,ARE,United Arab Emirates,2016,0,0,0
EST,Estonia,ARE,United Arab Emirates,2017,0,0,0
AUT,Austria,GBR,United Kingdom,2008,0,1259,-1259
AUT,Austria,GBR,United Kingdom,2009,0,1136,-1136
AUT,Austria,GBR,United Kingdom,2010,0,1227,-1227
AUT,Austria,GBR,United Kingdom,2011,0,1295,-1295
AUT,Austria,GBR,United Kingdom,2016,0,1452,-1452
AUT,Austria,GBR,United Kingdom,2017,0,1510,-1510
BEL,Belgium,GBR,United Kingdom,2008,0,2363,-2363
BEL,Belgium,GBR,United Kingdom,2009,0,1894,-1894
BEL,Belgium,GBR,United Kingdom,2010,0,2205,-2205
BEL,Belgium,GBR,United Kingdom,2016,0,1572,-1572
BEL,Belgium,GBR,United Kingdom,2017,0,1600,-1600
CAN,Canada,GBR,United Kingdom,2009,0,8872,-8872
CZE,Czech Republic,GBR,United Kingdom,2008,0,716,-716
CZE,Czech Republic,GBR,United Kingdom,2009,0,387,-387
CZE,Czech Republic,GBR,United Kingdom,2010,0,316,-316
CZE,Czech Republic,GBR,United Kingdom,2016,0,356,-356
CZE,Czech Republic,GBR,United Kingdom,2017,0,445,-445
DNK,Denmark,GBR,United Kingdom,2008,0,983,-983
DNK,Denmark,GBR,United Kingdom,2009,0,860,-860
DNK,Denmark,GBR,United Kingdom,2010,0,975,-975
DNK,Denmark,GBR,United Kingdom,2011,0,1064,-1064
DNK,Denmark,GBR,United Kingdom,2016,0,1607,-1607
DNK,Denmark,GBR,United Kingdom,2017,0,1746,-1746
FIN,Finland,GBR,United Kingdom,2008,0,327,-327
FIN,Finland,GBR,United Kingdom,2009,0,282,-282
FIN,Finland,GBR,United Kingdom,2010,0,260,-260
FIN,Finland,GBR,United Kingdom,2016,0,378,-378
FIN,Finland,GBR,United Kingdom,2017,0,324,-324
FRA,France,GBR,United Kingdom,2008,0,0,0
HUN,Hungary,GBR,United Kingdom,2008,0,421,-421
HUN,Hungary,GBR,United Kingdom,2009,0,335,-335
HUN,Hungary,GBR,United Kingdom,2010,0,332,-332
ISL,Iceland,GBR,United Kingdom,2008,0,117,-117
ISL,Iceland,GBR,United Kingdom,2009,0,107,-107
ISL,Iceland,GBR,United Kingdom,2010,0,107,-107
ISL,Iceland,GBR,United Kingdom,2011,0,123,-123
ISL,Iceland,GBR,United Kingdom,2012,0,84,-84
ISL,Iceland,GBR,United Kingdom,2013,0,113,-113
ISL,Iceland,GBR,United Kingdom,2014,0,128,-128
ISL,Iceland,GBR,United Kingdom,2015,0,161,-161
ISL,Iceland,GBR,United Kingdom,2016,0,205,-205
ISL,Iceland,GBR,United Kingdom,2017,0,224,-224
IRL,Ireland,GBR,United Kingdom,2008,0,6800,-6800
JPN,Japan,GBR,United Kingdom,2008,0,5952,-5952
JPN,Japan,GBR,United Kingdom,2017,0,6741,-6741
KOR,Korea,GBR,United Kingdom,2008,0,1550,-1550
KOR,Korea,GBR,United Kingdom,2016,0,1540,-1540
KOR,Korea,GBR,United Kingdom,2017,0,1336,-1336
LUX,Luxembourg,GBR,United Kingdom,2008,0,491,-491
LUX,Luxembourg,GBR,United Kingdom,2009,0,446,-446
LUX,Luxembourg,GBR,United Kingdom,2010,0,415,-415
LUX,Luxembourg,GBR,United Kingdom,2011,0,427,-427
LUX,Luxembourg,GBR,United Kingdom,2012,0,439,-439
LUX,Luxembourg,GBR,United Kingdom,2015,0,452,-452
LUX,Luxembourg,GBR,United Kingdom,2016,0,457,-457
LUX,Luxembourg,GBR,United Kingdom,2017,0,554,-554
MEX,Mexico,GBR,United Kingdom,2008,0,170,-170
MEX,Mexico,GBR,United Kingdom,2009,0,255,-255
MEX,Mexico,GBR,United Kingdom,2010,0,248,-248
MEX,Mexico,GBR,United Kingdom,2011,0,228,-228
MEX,Mexico,GBR,United Kingdom,2016,0,317,-317
MEX,Mexico,GBR,United Kingdom,2017,0,253,-253
NLD,Netherlands,GBR,United Kingdom,2008,0,4731,-4731
NLD,Netherlands,GBR,United Kingdom,2009,0,4422,-4422
NLD,Netherlands,GBR,United Kingdom,2010,0,4366,-4366
NOR,Norway,GBR,United Kingdom,2008,0,1249,-1249
NOR,Norway,GBR,United Kingdom,2009,0,1256,-1256
NOR,Norway,GBR,United Kingdom,2010,0,1462,-1462
NOR,Norway,GBR,United Kingdom,2016,0,906,-906
NOR,Norway,GBR,United Kingdom,2017,0,902,-902
PRT,Portugal,GBR,United Kingdom,2008,0,2670,-2670
PRT,Portugal,GBR,United Kingdom,2009,0,2154,-2154
SVK,Slovak Republic,GBR,United Kingdom,2008,0,242,-242
SVK,Slovak Republic,GBR,United Kingdom,2009,0,212,-212
SVK,Slovak Republic,GBR,United Kingdom,2010,0,126,-126
SVK,Slovak Republic,GBR,United Kingdom,2011,0,153,-153
SVK,Slovak Republic,GBR,United Kingdom,2012,0,60,-60
SVK,Slovak Republic,GBR,United Kingdom,2014,0,62,-62
SVK,Slovak Republic,GBR,United Kingdom,2015,0,103,-103
SVK,Slovak Republic,GBR,United Kingdom,2016,0,130,-130
SVK,Slovak Republic,GBR,United Kingdom,2017,0,109,-109
ESP,Spain,GBR,United Kingdom,2008,0,23758,-23758
SWE,Sweden,GBR,United Kingdom,2008,0,1719,-1719
SWE,Sweden,GBR,United Kingdom,2009,0,1638,-1638
SWE,Sweden,GBR,United Kingdom,2010,0,1435,-1435
SWE,Sweden,GBR,United Kingdom,2016,0,1934,-1934
SWE,Sweden,GBR,United Kingdom,2017,0,2048,-2048
CHE,Switzerland,GBR,United Kingdom,2008,0,5633,-5633
CHE,Switzerland,GBR,United Kingdom,2009,0,4761,-4761
CHE,Switzerland,GBR,United Kingdom,2010,0,5465,-5465
CHE,Switzerland,GBR,United Kingdom,2016,0,3575,-3575
CHE,Switzerland,GBR,United Kingdom,2017,0,3760,-3760
TUR,Turkey,GBR,United Kingdom,2010,0,1146,-1146
CHL,Chile,GBR,United Kingdom,2008,0,0,0
CHL,Chile,GBR,United Kingdom,2009,0,0,0
CHL,Chile,GBR,United Kingdom,2010,0,0,0
CHL,Chile,GBR,United Kingdom,2013,0,0,0
CHL,Chile,GBR,United Kingdom,2015,0,0,0
CHL,Chile,GBR,United Kingdom,2016,0,64,-64
EST,Estonia,GBR,United Kingdom,2008,0,46,-46
EST,Estonia,GBR,United Kingdom,2009,0,56,-56
EST,Estonia,GBR,United Kingdom,2010,0,17,-17
EST,Estonia,GBR,United Kingdom,2014,0,4,-4
EST,Estonia,GBR,United Kingdom,2015,0,116,-116
EST,Estonia,GBR,United Kingdom,2016,0,111,-111
EST,Estonia,GBR,United Kingdom,2017,0,168,-168
ISR,Israel,GBR,United Kingdom,2008,0,505,-505
ISR,Israel,GBR,United Kingdom,2009,0,708,-708
ISR,Israel,GBR,United Kingdom,2010,0,632,-632
ISR,Israel,GBR,United Kingdom,2011,0,485,-485
ISR,Israel,GBR,United Kingdom,2013,0,403,-403
ISR,Israel,GBR,United Kingdom,2014,0,486,-486
ISR,Israel,GBR,United Kingdom,2016,0,632,-632
ISR,Israel,GBR,United Kingdom,2017,0,468,-468
SVN,Slovenia,GBR,United Kingdom,2008,0,129,-129
SVN,Slovenia,GBR,United Kingdom,2009,0,107,-107
SVN,Slovenia,GBR,United Kingdom,2010,0,3,-3
SVN,Slovenia,GBR,United Kingdom,2011,0,120,-120
SVN,Slovenia,GBR,United Kingdom,2014,0,80,-80
SVN,Slovenia,GBR,United Kingdom,2015,0,83,-83
SVN,Slovenia,GBR,United Kingdom,2016,0,105,-105
SVN,Slovenia,GBR,United Kingdom,2017,0,123,-123
AUS,Australia,URY,Uruguay,2008,79,42,37
AUS,Australia,URY,Uruguay,2009,84,32,52
AUS,Australia,URY,Uruguay,2010,55,29,26
AUS,Australia,URY,Uruguay,2011,68,23,45
AUS,Australia,URY,Uruguay,2012,64,38,26
AUS,Australia,URY,Uruguay,2013,66,15,51
AUS,Australia,URY,Uruguay,2014,54,24,30
AUS,Australia,URY,Uruguay,2015,100,15,85
AUS,Australia,URY,Uruguay,2016,0,16,-16
AUS,Australia,URY,Uruguay,2017,0,21,-21
AUT,Austria,URY,Uruguay,2008,6,16,-10
AUT,Austria,URY,Uruguay,2009,9,8,1
AUT,Austria,URY,Uruguay,2010,11,8,3
AUT,Austria,URY,Uruguay,2011,6,6,0
AUT,Austria,URY,Uruguay,2012,9,9,0
AUT,Austria,URY,Uruguay,2013,5,9,-4
AUT,Austria,URY,Uruguay,2014,6,12,-6
AUT,Austria,URY,Uruguay,2015,6,15,-9
AUT,Austria,URY,Uruguay,2016,9,13,-4
AUT,Austria,URY,Uruguay,2017,10,15,-5
BEL,Belgium,URY,Uruguay,2008,0,16,-16
BEL,Belgium,URY,Uruguay,2009,0,7,-7
BEL,Belgium,URY,Uruguay,2010,7,21,-14
BEL,Belgium,URY,Uruguay,2012,3,13,-10
BEL,Belgium,URY,Uruguay,2013,13,11,2
BEL,Belgium,URY,Uruguay,2014,6,15,-9
BEL,Belgium,URY,Uruguay,2015,3,8,-5
BEL,Belgium,URY,Uruguay,2016,11,11,0
BEL,Belgium,URY,Uruguay,2017,12,21,-9
CAN,Canada,URY,Uruguay,2008,0,159,-159
CAN,Canada,URY,Uruguay,2009,0,99,-99
CAN,Canada,URY,Uruguay,2010,0,93,-93
CAN,Canada,URY,Uruguay,2011,0,81,-81
CAN,Canada,URY,Uruguay,2012,0,47,-47
CAN,Canada,URY,Uruguay,2013,0,58,-58
CAN,Canada,URY,Uruguay,2014,0,43,-43
CAN,Canada,URY,Uruguay,2015,0,50,-50
CAN,Canada,URY,Uruguay,2016,0,55,-55
CAN,Canada,URY,Uruguay,2017,0,25,-25
CZE,Czech Republic,URY,Uruguay,2008,0,2,-2
CZE,Czech Republic,URY,Uruguay,2009,0,1,-1
CZE,Czech Republic,URY,Uruguay,2010,0,3,-3
CZE,Czech Republic,URY,Uruguay,2011,0,2,-2
CZE,Czech Republic,URY,Uruguay,2012,0,3,-3
CZE,Czech Republic,URY,Uruguay,2013,1,4,-3
CZE,Czech Republic,URY,Uruguay,2014,2,2,0
CZE,Czech Republic,URY,Uruguay,2015,2,5,-3
CZE,Czech Republic,URY,Uruguay,2016,3,5,-2
DNK,Denmark,URY,Uruguay,2008,4,2,2
DNK,Denmark,URY,Uruguay,2009,5,3,2
DNK,Denmark,URY,Uruguay,2010,4,3,1
DNK,Denmark,URY,Uruguay,2011,4,4,0
DNK,Denmark,URY,Uruguay,2012,1,11,-10
DNK,Denmark,URY,Uruguay,2013,4,2,2
DNK,Denmark,URY,Uruguay,2014,2,4,-2
DNK,Denmark,URY,Uruguay,2015,11,11,0
DNK,Denmark,URY,Uruguay,2016,4,5,-1
DNK,Denmark,URY,Uruguay,2017,9,7,2
FIN,Finland,URY,Uruguay,2008,1,7,-6
FIN,Finland,URY,Uruguay,2009,0,6,-6
FIN,Finland,URY,Uruguay,2010,0,4,-4
FIN,Finland,URY,Uruguay,2011,1,7,-6
FIN,Finland,URY,Uruguay,2012,1,1,0
FIN,Finland,URY,Uruguay,2013,0,8,-8
FIN,Finland,URY,Uruguay,2014,6,6,0
FIN,Finland,URY,Uruguay,2015,2,15,-13
FIN,Finland,URY,Uruguay,2016,1,1,0
FIN,Finland,URY,Uruguay,2017,4,8,-4
FRA,France,URY,Uruguay,2008,0,39,-39
FRA,France,URY,Uruguay,2009,0,39,-39
FRA,France,URY,Uruguay,2010,0,35,-35
FRA,France,URY,Uruguay,2011,0,34,-34
FRA,France,URY,Uruguay,2012,0,50,-50
FRA,France,URY,Uruguay,2013,0,30,-30
FRA,France,URY,Uruguay,2014,0,38,-38
FRA,France,URY,Uruguay,2015,0,38,-38
FRA,France,URY,Uruguay,2016,0,43,-43
FRA,France,URY,Uruguay,2017,0,32,-32
DEU,Germany,URY,Uruguay,2008,70,85,-15
DEU,Germany,URY,Uruguay,2009,82,79,3
DEU,Germany,URY,Uruguay,2010,78,67,11
DEU,Germany,URY,Uruguay,2011,53,68,-15
DEU,Germany,URY,Uruguay,2012,54,102,-48
DEU,Germany,URY,Uruguay,2013,67,108,-41
DEU,Germany,URY,Uruguay,2014,75,102,-27
DEU,Germany,URY,Uruguay,2015,65,119,-54
DEU,Germany,URY,Uruguay,2016,57,107,-50
DEU,Germany,URY,Uruguay,2017,67,126,-59
HUN,Hungary,URY,Uruguay,2008,0,6,-6
HUN,Hungary,URY,Uruguay,2009,0,1,-1
HUN,Hungary,URY,Uruguay,2010,0,0,0
HUN,Hungary,URY,Uruguay,2011,0,1,-1
HUN,Hungary,URY,Uruguay,2012,0,2,-2
HUN,Hungary,URY,Uruguay,2013,0,0,0
HUN,Hungary,URY,Uruguay,2014,0,4,-4
HUN,Hungary,URY,Uruguay,2015,1,3,-2
HUN,Hungary,URY,Uruguay,2016,0,2,-2
HUN,Hungary,URY,Uruguay,2017,0,3,-3
ISL,Iceland,URY,Uruguay,2008,1,0,1
ISL,Iceland,URY,Uruguay,2009,0,0,0
ISL,Iceland,URY,Uruguay,2010,0,0,0
ISL,Iceland,URY,Uruguay,2011,2,1,1
ISL,Iceland,URY,Uruguay,2012,0,0,0
ISL,Iceland,URY,Uruguay,2013,0,1,-1
ISL,Iceland,URY,Uruguay,2014,0,0,0
ISL,Iceland,URY,Uruguay,2015,0,0,0
ISL,Iceland,URY,Uruguay,2016,0,1,-1
ISL,Iceland,URY,Uruguay,2017,0,1,-1
ITA,Italy,URY,Uruguay,2008,27,241,-214
ITA,Italy,URY,Uruguay,2009,30,187,-157
ITA,Italy,URY,Uruguay,2010,22,140,-118
ITA,Italy,URY,Uruguay,2011,15,137,-122
ITA,Italy,URY,Uruguay,2012,15,103,-88
ITA,Italy,URY,Uruguay,2013,20,99,-79
ITA,Italy,URY,Uruguay,2014,9,71,-62
ITA,Italy,URY,Uruguay,2015,15,62,-47
ITA,Italy,URY,Uruguay,2016,0,66,-66
ITA,Italy,URY,Uruguay,2017,12,86,-74
JPN,Japan,URY,Uruguay,2008,61,73,-12
JPN,Japan,URY,Uruguay,2009,63,60,3
JPN,Japan,URY,Uruguay,2010,58,61,-3
JPN,Japan,URY,Uruguay,2011,58,55,3
JPN,Japan,URY,Uruguay,2012,36,41,-5
JPN,Japan,URY,Uruguay,2013,36,41,-5
JPN,Japan,URY,Uruguay,2014,30,35,-5
JPN,Japan,URY,Uruguay,2015,49,45,4
JPN,Japan,URY,Uruguay,2016,30,35,-5
JPN,Japan,URY,Uruguay,2017,24,32,-8
KOR,Korea,URY,Uruguay,2008,6,6,0
KOR,Korea,URY,Uruguay,2009,4,14,-10
KOR,Korea,URY,Uruguay,2010,11,7,4
KOR,Korea,URY,Uruguay,2011,7,7,0
KOR,Korea,URY,Uruguay,2012,12,12,0
KOR,Korea,URY,Uruguay,2013,10,8,2
KOR,Korea,URY,Uruguay,2014,3,7,-4
KOR,Korea,URY,Uruguay,2015,6,5,1
KOR,Korea,URY,Uruguay,2016,7,8,-1
KOR,Korea,URY,Uruguay,2017,9,11,-2
LUX,Luxembourg,URY,Uruguay,2008,2,1,1
LUX,Luxembourg,URY,Uruguay,2009,1,8,-7
LUX,Luxembourg,URY,Uruguay,2010,1,2,-1
LUX,Luxembourg,URY,Uruguay,2011,1,2,-1
LUX,Luxembourg,URY,Uruguay,2012,0,0,0
LUX,Luxembourg,URY,Uruguay,2013,3,1,2
LUX,Luxembourg,URY,Uruguay,2014,3,4,-1
LUX,Luxembourg,URY,Uruguay,2015,0,0,0
LUX,Luxembourg,URY,Uruguay,2016,5,2,3
LUX,Luxembourg,URY,Uruguay,2017,1,0,1
MEX,Mexico,URY,Uruguay,2008,0,135,-135
MEX,Mexico,URY,Uruguay,2009,0,231,-231
MEX,Mexico,URY,Uruguay,2010,0,232,-232
MEX,Mexico,URY,Uruguay,2011,0,160,-160
MEX,Mexico,URY,Uruguay,2012,0,122,-122
MEX,Mexico,URY,Uruguay,2013,0,480,-480
MEX,Mexico,URY,Uruguay,2014,0,292,-292
MEX,Mexico,URY,Uruguay,2015,0,194,-194
MEX,Mexico,URY,Uruguay,2016,0,184,-184
MEX,Mexico,URY,Uruguay,2017,0,129,-129
NLD,Netherlands,URY,Uruguay,2008,8,21,-13
NLD,Netherlands,URY,Uruguay,2009,19,12,7
NLD,Netherlands,URY,Uruguay,2010,16,13,3
NLD,Netherlands,URY,Uruguay,2011,6,14,-8
NLD,Netherlands,URY,Uruguay,2012,11,21,-10
NLD,Netherlands,URY,Uruguay,2013,18,24,-6
NLD,Netherlands,URY,Uruguay,2014,23,25,-2
NLD,Netherlands,URY,Uruguay,2015,16,17,-1
NLD,Netherlands,URY,Uruguay,2016,9,30,-21
NLD,Netherlands,URY,Uruguay,2017,15,24,-9
NZL,New Zealand,URY,Uruguay,2008,15,101,-86
NZL,New Zealand,URY,Uruguay,2009,40,91,-51
NZL,New Zealand,URY,Uruguay,2010,42,100,-58
NZL,New Zealand,URY,Uruguay,2011,44,141,-97
NZL,New Zealand,URY,Uruguay,2012,44,115,-71
NZL,New Zealand,URY,Uruguay,2013,25,131,-106
NZL,New Zealand,URY,Uruguay,2014,37,151,-114
NZL,New Zealand,URY,Uruguay,2015,52,159,-107
NZL,New Zealand,URY,Uruguay,2016,50,160,-110
NZL,New Zealand,URY,Uruguay,2017,89,170,-81
NOR,Norway,URY,Uruguay,2008,3,9,-6
NOR,Norway,URY,Uruguay,2009,1,6,-5
NOR,Norway,URY,Uruguay,2010,3,6,-3
NOR,Norway,URY,Uruguay,2011,2,9,-7
NOR,Norway,URY,Uruguay,2012,6,2,4
NOR,Norway,URY,Uruguay,2013,1,5,-4
NOR,Norway,URY,Uruguay,2014,1,6,-5
NOR,Norway,URY,Uruguay,2015,2,3,-1
NOR,Norway,URY,Uruguay,2016,2,1,1
NOR,Norway,URY,Uruguay,2017,3,7,-4
POL,Poland,URY,Uruguay,2009,0,4,-4
POL,Poland,URY,Uruguay,2010,0,4,-4
POL,Poland,URY,Uruguay,2011,0,5,-5
POL,Poland,URY,Uruguay,2012,0,5,-5
POL,Poland,URY,Uruguay,2013,0,3,-3
POL,Poland,URY,Uruguay,2014,0,0,0
POL,Poland,URY,Uruguay,2015,0,5,-5
POL,Poland,URY,Uruguay,2016,0,9,-9
POL,Poland,URY,Uruguay,2017,0,6,-6
SVK,Slovak Republic,URY,Uruguay,2008,1,2,-1
SVK,Slovak Republic,URY,Uruguay,2009,0,4,-4
SVK,Slovak Republic,URY,Uruguay,2010,2,1,1
SVK,Slovak Republic,URY,Uruguay,2015,0,1,-1
ESP,Spain,URY,Uruguay,2008,2749,4332,-1583
ESP,Spain,URY,Uruguay,2009,3751,1669,2082
ESP,Spain,URY,Uruguay,2010,3412,1466,1946
ESP,Spain,URY,Uruguay,2011,3022,1324,1698
ESP,Spain,URY,Uruguay,2012,2653,991,1662
ESP,Spain,URY,Uruguay,2013,2824,918,1906
ESP,Spain,URY,Uruguay,2014,1525,1027,498
ESP,Spain,URY,Uruguay,2015,923,1245,-322
ESP,Spain,URY,Uruguay,2016,737,1851,-1114
ESP,Spain,URY,Uruguay,2017,1209,2437,-1228
SWE,Sweden,URY,Uruguay,2008,12,32,-20
SWE,Sweden,URY,Uruguay,2009,4,25,-21
SWE,Sweden,URY,Uruguay,2010,13,17,-4
SWE,Sweden,URY,Uruguay,2011,4,13,-9
SWE,Sweden,URY,Uruguay,2012,7,15,-8
SWE,Sweden,URY,Uruguay,2013,14,12,2
SWE,Sweden,URY,Uruguay,2014,4,12,-8
SWE,Sweden,URY,Uruguay,2015,12,15,-3
SWE,Sweden,URY,Uruguay,2016,11,16,-5
SWE,Sweden,URY,Uruguay,2017,6,17,-11
CHE,Switzerland,URY,Uruguay,2010,25,52,-27
CHE,Switzerland,URY,Uruguay,2011,18,34,-16
CHE,Switzerland,URY,Uruguay,2012,29,35,-6
CHE,Switzerland,URY,Uruguay,2013,18,13,5
CHE,Switzerland,URY,Uruguay,2014,13,39,-26
CHE,Switzerland,URY,Uruguay,2015,23,22,1
CHE,Switzerland,URY,Uruguay,2016,22,19,3
CHE,Switzerland,URY,Uruguay,2017,12,17,-5
GBR,United Kingdom,URY,Uruguay,2012,0,1000,-1000
USA,United States,URY,Uruguay,2008,0,1451,-1451
USA,United States,URY,Uruguay,2009,0,1775,-1775
USA,United States,URY,Uruguay,2010,0,1331,-1331
USA,United States,URY,Uruguay,2011,0,1553,-1553
USA,United States,URY,Uruguay,2012,0,1374,-1374
USA,United States,URY,Uruguay,2013,0,1352,-1352
USA,United States,URY,Uruguay,2014,0,1128,-1128
USA,United States,URY,Uruguay,2015,0,1078,-1078
USA,United States,URY,Uruguay,2016,0,972,-972
USA,United States,URY,Uruguay,2017,0,1001,-1001
CHL,Chile,URY,Uruguay,2008,0,594,-594
CHL,Chile,URY,Uruguay,2009,0,398,-398
CHL,Chile,URY,Uruguay,2010,0,482,-482
CHL,Chile,URY,Uruguay,2011,0,462,-462
CHL,Chile,URY,Uruguay,2012,0,447,-447
CHL,Chile,URY,Uruguay,2013,0,442,-442
CHL,Chile,URY,Uruguay,2014,0,415,-415
CHL,Chile,URY,Uruguay,2015,0,515,-515
CHL,Chile,URY,Uruguay,2016,0,434,-434
EST,Estonia,URY,Uruguay,2008,0,0,0
EST,Estonia,URY,Uruguay,2009,0,0,0
EST,Estonia,URY,Uruguay,2010,0,0,0
EST,Estonia,URY,Uruguay,2011,0,0,0
EST,Estonia,URY,Uruguay,2012,0,0,0
EST,Estonia,URY,Uruguay,2013,0,0,0
EST,Estonia,URY,Uruguay,2014,0,0,0
EST,Estonia,URY,Uruguay,2015,0,1,-1
EST,Estonia,URY,Uruguay,2016,0,1,-1
EST,Estonia,URY,Uruguay,2017,0,0,0
ISR,Israel,URY,Uruguay,2008,0,79,-79
ISR,Israel,URY,Uruguay,2009,0,87,-87
ISR,Israel,URY,Uruguay,2010,0,90,-90
ISR,Israel,URY,Uruguay,2011,0,48,-48
ISR,Israel,URY,Uruguay,2012,0,67,-67
ISR,Israel,URY,Uruguay,2013,0,62,-62
ISR,Israel,URY,Uruguay,2014,0,52,-52
ISR,Israel,URY,Uruguay,2015,0,65,-65
ISR,Israel,URY,Uruguay,2016,0,58,-58
ISR,Israel,URY,Uruguay,2017,0,69,-69
SVN,Slovenia,URY,Uruguay,2008,0,1,-1
SVN,Slovenia,URY,Uruguay,2009,0,1,-1
SVN,Slovenia,URY,Uruguay,2015,0,3,-3
SVN,Slovenia,URY,Uruguay,2016,0,1,-1
AUS,Australia,UZB,Uzbekistan,2008,13,92,-79
AUS,Australia,UZB,Uzbekistan,2009,5,78,-73
AUS,Australia,UZB,Uzbekistan,2010,0,76,-76
AUS,Australia,UZB,Uzbekistan,2011,6,73,-67
AUS,Australia,UZB,Uzbekistan,2012,0,98,-98
AUS,Australia,UZB,Uzbekistan,2013,9,96,-87
AUS,Australia,UZB,Uzbekistan,2014,17,80,-63
AUS,Australia,UZB,Uzbekistan,2015,0,72,-72
AUS,Australia,UZB,Uzbekistan,2016,0,72,-72
AUS,Australia,UZB,Uzbekistan,2017,0,61,-61
AUT,Austria,UZB,Uzbekistan,2008,19,45,-26
AUT,Austria,UZB,Uzbekistan,2009,27,69,-42
AUT,Austria,UZB,Uzbekistan,2010,28,38,-10
AUT,Austria,UZB,Uzbekistan,2011,23,55,-32
AUT,Austria,UZB,Uzbekistan,2012,39,60,-21
AUT,Austria,UZB,Uzbekistan,2013,37,62,-25
AUT,Austria,UZB,Uzbekistan,2014,27,78,-51
AUT,Austria,UZB,Uzbekistan,2015,26,67,-41
AUT,Austria,UZB,Uzbekistan,2016,29,69,-40
AUT,Austria,UZB,Uzbekistan,2017,53,70,-17
BEL,Belgium,UZB,Uzbekistan,2008,0,66,-66
BEL,Belgium,UZB,Uzbekistan,2009,0,62,-62
BEL,Belgium,UZB,Uzbekistan,2010,14,56,-42
BEL,Belgium,UZB,Uzbekistan,2012,36,43,-7
BEL,Belgium,UZB,Uzbekistan,2013,30,27,3
BEL,Belgium,UZB,Uzbekistan,2014,23,25,-2
BEL,Belgium,UZB,Uzbekistan,2015,19,24,-5
BEL,Belgium,UZB,Uzbekistan,2016,20,19,1
BEL,Belgium,UZB,Uzbekistan,2017,29,26,3
CAN,Canada,UZB,Uzbekistan,2008,0,215,-215
CAN,Canada,UZB,Uzbekistan,2009,0,288,-288
CAN,Canada,UZB,Uzbekistan,2010,0,289,-289
CAN,Canada,UZB,Uzbekistan,2011,0,162,-162
CAN,Canada,UZB,Uzbekistan,2012,0,234,-234
CAN,Canada,UZB,Uzbekistan,2013,0,167,-167
CAN,Canada,UZB,Uzbekistan,2014,0,164,-164
CAN,Canada,UZB,Uzbekistan,2015,0,189,-189
CAN,Canada,UZB,Uzbekistan,2016,0,215,-215
CAN,Canada,UZB,Uzbekistan,2017,0,180,-180
CZE,Czech Republic,UZB,Uzbekistan,2008,2,1459,-1457
CZE,Czech Republic,UZB,Uzbekistan,2009,1,456,-455
CZE,Czech Republic,UZB,Uzbekistan,2010,1,139,-138
CZE,Czech Republic,UZB,Uzbekistan,2011,3,95,-92
CZE,Czech Republic,UZB,Uzbekistan,2012,188,201,-13
CZE,Czech Republic,UZB,Uzbekistan,2013,327,147,180
CZE,Czech Republic,UZB,Uzbekistan,2014,135,325,-190
CZE,Czech Republic,UZB,Uzbekistan,2015,136,168,-32
CZE,Czech Republic,UZB,Uzbekistan,2016,74,259,-185
CZE,Czech Republic,UZB,Uzbekistan,2017,100,376,-276
DNK,Denmark,UZB,Uzbekistan,2008,18,22,-4
DNK,Denmark,UZB,Uzbekistan,2009,11,12,-1
DNK,Denmark,UZB,Uzbekistan,2010,14,16,-2
DNK,Denmark,UZB,Uzbekistan,2011,4,22,-18
DNK,Denmark,UZB,Uzbekistan,2012,13,14,-1
DNK,Denmark,UZB,Uzbekistan,2013,1,33,-32
DNK,Denmark,UZB,Uzbekistan,2014,12,14,-2
DNK,Denmark,UZB,Uzbekistan,2015,6,16,-10
DNK,Denmark,UZB,Uzbekistan,2016,26,20,6
DNK,Denmark,UZB,Uzbekistan,2017,10,10,0
FIN,Finland,UZB,Uzbekistan,2008,3,18,-15
FIN,Finland,UZB,Uzbekistan,2009,6,24,-18
FIN,Finland,UZB,Uzbekistan,2010,5,14,-9
FIN,Finland,UZB,Uzbekistan,2011,1,10,-9
FIN,Finland,UZB,Uzbekistan,2012,7,14,-7
FIN,Finland,UZB,Uzbekistan,2013,2,68,-66
FIN,Finland,UZB,Uzbekistan,2014,1,35,-34
FIN,Finland,UZB,Uzbekistan,2015,2,29,-27
FIN,Finland,UZB,Uzbekistan,2016,3,96,-93
FIN,Finland,UZB,Uzbekistan,2017,3,213,-210
FRA,France,UZB,Uzbekistan,2008,0,85,-85
FRA,France,UZB,Uzbekistan,2009,0,64,-64
FRA,France,UZB,Uzbekistan,2010,0,64,-64
FRA,France,UZB,Uzbekistan,2011,0,63,-63
FRA,France,UZB,Uzbekistan,2012,0,51,-51
FRA,France,UZB,Uzbekistan,2013,0,57,-57
FRA,France,UZB,Uzbekistan,2014,0,66,-66
FRA,France,UZB,Uzbekistan,2015,0,50,-50
FRA,France,UZB,Uzbekistan,2016,0,44,-44
FRA,France,UZB,Uzbekistan,2017,0,47,-47
DEU,Germany,UZB,Uzbekistan,2008,491,745,-254
DEU,Germany,UZB,Uzbekistan,2009,577,721,-144
DEU,Germany,UZB,Uzbekistan,2010,467,742,-275
DEU,Germany,UZB,Uzbekistan,2011,464,755,-291
DEU,Germany,UZB,Uzbekistan,2012,470,618,-148
DEU,Germany,UZB,Uzbekistan,2013,430,516,-86
DEU,Germany,UZB,Uzbekistan,2014,380,513,-133
DEU,Germany,UZB,Uzbekistan,2015,345,636,-291
DEU,Germany,UZB,Uzbekistan,2016,337,678,-341
DEU,Germany,UZB,Uzbekistan,2017,338,705,-367
HUN,Hungary,UZB,Uzbekistan,2008,2,24,-22
HUN,Hungary,UZB,Uzbekistan,2009,2,11,-9
HUN,Hungary,UZB,Uzbekistan,2010,2,15,-13
HUN,Hungary,UZB,Uzbekistan,2011,4,8,-4
HUN,Hungary,UZB,Uzbekistan,2012,0,16,-16
HUN,Hungary,UZB,Uzbekistan,2013,1,18,-17
HUN,Hungary,UZB,Uzbekistan,2014,0,23,-23
HUN,Hungary,UZB,Uzbekistan,2015,3,27,-24
HUN,Hungary,UZB,Uzbekistan,2016,4,22,-18
HUN,Hungary,UZB,Uzbekistan,2017,0,17,-17
ISL,Iceland,UZB,Uzbekistan,2008,0,1,-1
ISL,Iceland,UZB,Uzbekistan,2009,1,1,0
ISL,Iceland,UZB,Uzbekistan,2010,0,0,0
ISL,Iceland,UZB,Uzbekistan,2011,0,1,-1
ISL,Iceland,UZB,Uzbekistan,2012,0,3,-3
ISL,Iceland,UZB,Uzbekistan,2013,0,0,0
ISL,Iceland,UZB,Uzbekistan,2014,1,1,0
ISL,Iceland,UZB,Uzbekistan,2015,1,3,-2
ISL,Iceland,UZB,Uzbekistan,2016,2,0,2
ISL,Iceland,UZB,Uzbekistan,2017,1,2,-1
ITA,Italy,UZB,Uzbekistan,2008,11,106,-95
ITA,Italy,UZB,Uzbekistan,2009,15,110,-95
ITA,Italy,UZB,Uzbekistan,2010,13,126,-113
ITA,Italy,UZB,Uzbekistan,2011,5,67,-62
ITA,Italy,UZB,Uzbekistan,2012,15,62,-47
ITA,Italy,UZB,Uzbekistan,2013,16,70,-54
ITA,Italy,UZB,Uzbekistan,2014,11,63,-52
ITA,Italy,UZB,Uzbekistan,2015,18,35,-17
ITA,Italy,UZB,Uzbekistan,2016,0,41,-41
ITA,Italy,UZB,Uzbekistan,2017,7,36,-29
JPN,Japan,UZB,Uzbekistan,2008,306,373,-67
JPN,Japan,UZB,Uzbekistan,2009,260,339,-79
JPN,Japan,UZB,Uzbekistan,2010,297,425,-128
JPN,Japan,UZB,Uzbekistan,2011,366,432,-66
JPN,Japan,UZB,Uzbekistan,2012,279,433,-154
JPN,Japan,UZB,Uzbekistan,2013,282,456,-174
JPN,Japan,UZB,Uzbekistan,2014,264,509,-245
JPN,Japan,UZB,Uzbekistan,2015,277,514,-237
JPN,Japan,UZB,Uzbekistan,2016,303,734,-431
JPN,Japan,UZB,Uzbekistan,2017,302,1400,-1098
KOR,Korea,UZB,Uzbekistan,2008,5471,9441,-3970
KOR,Korea,UZB,Uzbekistan,2009,5162,4684,478
KOR,Korea,UZB,Uzbekistan,2010,4387,8567,-4180
KOR,Korea,UZB,Uzbekistan,2011,5404,8180,-2776
KOR,Korea,UZB,Uzbekistan,2012,7756,11354,-3598
KOR,Korea,UZB,Uzbekistan,2013,9161,12333,-3172
KOR,Korea,UZB,Uzbekistan,2014,9876,12920,-3044
KOR,Korea,UZB,Uzbekistan,2015,11140,14246,-3106
KOR,Korea,UZB,Uzbekistan,2016,9845,16151,-6306
KOR,Korea,UZB,Uzbekistan,2017,12096,18486,-6390
LUX,Luxembourg,UZB,Uzbekistan,2008,0,7,-7
LUX,Luxembourg,UZB,Uzbekistan,2009,0,2,-2
LUX,Luxembourg,UZB,Uzbekistan,2010,0,1,-1
LUX,Luxembourg,UZB,Uzbekistan,2011,0,1,-1
LUX,Luxembourg,UZB,Uzbekistan,2012,0,2,-2
LUX,Luxembourg,UZB,Uzbekistan,2013,0,1,-1
LUX,Luxembourg,UZB,Uzbekistan,2014,0,1,-1
LUX,Luxembourg,UZB,Uzbekistan,2015,0,3,-3
LUX,Luxembourg,UZB,Uzbekistan,2016,1,2,-1
LUX,Luxembourg,UZB,Uzbekistan,2017,0,5,-5
MEX,Mexico,UZB,Uzbekistan,2008,0,4,-4
MEX,Mexico,UZB,Uzbekistan,2009,0,4,-4
MEX,Mexico,UZB,Uzbekistan,2010,0,2,-2
MEX,Mexico,UZB,Uzbekistan,2011,0,5,-5
MEX,Mexico,UZB,Uzbekistan,2012,0,0,0
MEX,Mexico,UZB,Uzbekistan,2013,0,4,-4
MEX,Mexico,UZB,Uzbekistan,2014,0,2,-2
MEX,Mexico,UZB,Uzbekistan,2015,0,6,-6
MEX,Mexico,UZB,Uzbekistan,2016,0,2,-2
MEX,Mexico,UZB,Uzbekistan,2017,0,4,-4
NLD,Netherlands,UZB,Uzbekistan,2009,11,32,-21
NLD,Netherlands,UZB,Uzbekistan,2010,16,28,-12
NLD,Netherlands,UZB,Uzbekistan,2011,11,41,-30
NLD,Netherlands,UZB,Uzbekistan,2012,17,39,-22
NLD,Netherlands,UZB,Uzbekistan,2013,26,28,-2
NLD,Netherlands,UZB,Uzbekistan,2014,20,58,-38
NLD,Netherlands,UZB,Uzbekistan,2015,15,32,-17
NLD,Netherlands,UZB,Uzbekistan,2016,21,42,-21
NLD,Netherlands,UZB,Uzbekistan,2017,27,44,-17
NZL,New Zealand,UZB,Uzbekistan,2008,1,7,-6
NZL,New Zealand,UZB,Uzbekistan,2009,5,17,-12
NZL,New Zealand,UZB,Uzbekistan,2010,6,3,3
NZL,New Zealand,UZB,Uzbekistan,2011,5,8,-3
NZL,New Zealand,UZB,Uzbekistan,2012,1,8,-7
NZL,New Zealand,UZB,Uzbekistan,2013,2,17,-15
NZL,New Zealand,UZB,Uzbekistan,2014,2,18,-16
NZL,New Zealand,UZB,Uzbekistan,2015,6,20,-14
NZL,New Zealand,UZB,Uzbekistan,2016,5,19,-14
NZL,New Zealand,UZB,Uzbekistan,2017,6,17,-11
NOR,Norway,UZB,Uzbekistan,2008,0,57,-57
NOR,Norway,UZB,Uzbekistan,2009,6,21,-15
NOR,Norway,UZB,Uzbekistan,2010,5,28,-23
NOR,Norway,UZB,Uzbekistan,2011,4,45,-41
NOR,Norway,UZB,Uzbekistan,2012,19,38,-19
NOR,Norway,UZB,Uzbekistan,2013,9,38,-29
NOR,Norway,UZB,Uzbekistan,2014,8,41,-33
NOR,Norway,UZB,Uzbekistan,2015,9,48,-39
NOR,Norway,UZB,Uzbekistan,2016,6,78,-72
NOR,Norway,UZB,Uzbekistan,2017,5,48,-43
POL,Poland,UZB,Uzbekistan,2008,0,163,-163
POL,Poland,UZB,Uzbekistan,2009,0,151,-151
POL,Poland,UZB,Uzbekistan,2010,0,161,-161
POL,Poland,UZB,Uzbekistan,2011,0,183,-183
POL,Poland,UZB,Uzbekistan,2012,0,183,-183
POL,Poland,UZB,Uzbekistan,2013,0,215,-215
POL,Poland,UZB,Uzbekistan,2014,0,158,-158
POL,Poland,UZB,Uzbekistan,2015,0,511,-511
POL,Poland,UZB,Uzbekistan,2016,0,877,-877
POL,Poland,UZB,Uzbekistan,2017,0,781,-781
SVK,Slovak Republic,UZB,Uzbekistan,2008,3,2,1
SVK,Slovak Republic,UZB,Uzbekistan,2009,2,1,1
SVK,Slovak Republic,UZB,Uzbekistan,2010,3,1,2
SVK,Slovak Republic,UZB,Uzbekistan,2011,0,4,-4
SVK,Slovak Republic,UZB,Uzbekistan,2012,0,1,-1
SVK,Slovak Republic,UZB,Uzbekistan,2015,0,4,-4
SVK,Slovak Republic,UZB,Uzbekistan,2017,0,1,-1
ESP,Spain,UZB,Uzbekistan,2008,42,71,-29
ESP,Spain,UZB,Uzbekistan,2009,49,52,-3
ESP,Spain,UZB,Uzbekistan,2010,46,60,-14
ESP,Spain,UZB,Uzbekistan,2011,46,96,-50
ESP,Spain,UZB,Uzbekistan,2012,17,74,-57
ESP,Spain,UZB,Uzbekistan,2013,69,77,-8
ESP,Spain,UZB,Uzbekistan,2014,34,70,-36
ESP,Spain,UZB,Uzbekistan,2015,28,64,-36
ESP,Spain,UZB,Uzbekistan,2016,27,82,-55
ESP,Spain,UZB,Uzbekistan,2017,39,65,-26
SWE,Sweden,UZB,Uzbekistan,2008,18,222,-204
SWE,Sweden,UZB,Uzbekistan,2009,18,231,-213
SWE,Sweden,UZB,Uzbekistan,2010,11,307,-296
SWE,Sweden,UZB,Uzbekistan,2011,28,400,-372
SWE,Sweden,UZB,Uzbekistan,2012,28,343,-315
SWE,Sweden,UZB,Uzbekistan,2013,42,235,-193
SWE,Sweden,UZB,Uzbekistan,2014,50,222,-172
SWE,Sweden,UZB,Uzbekistan,2015,67,214,-147
SWE,Sweden,UZB,Uzbekistan,2016,43,218,-175
SWE,Sweden,UZB,Uzbekistan,2017,32,211,-179
CHE,Switzerland,UZB,Uzbekistan,2010,14,66,-52
CHE,Switzerland,UZB,Uzbekistan,2011,33,59,-26
CHE,Switzerland,UZB,Uzbekistan,2012,9,62,-53
CHE,Switzerland,UZB,Uzbekistan,2013,27,73,-46
CHE,Switzerland,UZB,Uzbekistan,2015,26,61,-35
CHE,Switzerland,UZB,Uzbekistan,2016,20,49,-29
CHE,Switzerland,UZB,Uzbekistan,2017,20,20,0
TUR,Turkey,UZB,Uzbekistan,2010,0,575,-575
TUR,Turkey,UZB,Uzbekistan,2016,3236,8975,-5739
TUR,Turkey,UZB,Uzbekistan,2017,5528,17871,-12343
USA,United States,UZB,Uzbekistan,2008,0,6375,-6375
USA,United States,UZB,Uzbekistan,2009,0,5467,-5467
USA,United States,UZB,Uzbekistan,2010,0,4770,-4770
USA,United States,UZB,Uzbekistan,2011,0,5056,-5056
USA,United States,UZB,Uzbekistan,2012,0,4726,-4726
USA,United States,UZB,Uzbekistan,2013,0,4382,-4382
USA,United States,UZB,Uzbekistan,2014,0,5194,-5194
USA,United States,UZB,Uzbekistan,2015,0,3977,-3977
USA,United States,UZB,Uzbekistan,2016,0,4359,-4359
USA,United States,UZB,Uzbekistan,2017,0,4095,-4095
CHL,Chile,UZB,Uzbekistan,2008,0,2,-2
CHL,Chile,UZB,Uzbekistan,2009,0,0,0
CHL,Chile,UZB,Uzbekistan,2010,0,0,0
CHL,Chile,UZB,Uzbekistan,2011,0,1,-1
CHL,Chile,UZB,Uzbekistan,2012,0,2,-2
CHL,Chile,UZB,Uzbekistan,2013,0,0,0
CHL,Chile,UZB,Uzbekistan,2014,0,0,0
CHL,Chile,UZB,Uzbekistan,2015,0,0,0
CHL,Chile,UZB,Uzbekistan,2016,0,4,-4
EST,Estonia,UZB,Uzbekistan,2008,0,1,-1
EST,Estonia,UZB,Uzbekistan,2009,0,5,-5
EST,Estonia,UZB,Uzbekistan,2010,0,0,0
EST,Estonia,UZB,Uzbekistan,2011,0,5,-5
EST,Estonia,UZB,Uzbekistan,2012,0,3,-3
EST,Estonia,UZB,Uzbekistan,2013,0,6,-6
EST,Estonia,UZB,Uzbekistan,2014,0,8,-8
EST,Estonia,UZB,Uzbekistan,2015,0,6,-6
EST,Estonia,UZB,Uzbekistan,2016,0,7,-7
EST,Estonia,UZB,Uzbekistan,2017,0,6,-6
SVN,Slovenia,UZB,Uzbekistan,2008,0,5,-5
SVN,Slovenia,UZB,Uzbekistan,2009,0,7,-7
SVN,Slovenia,UZB,Uzbekistan,2010,0,4,-4
SVN,Slovenia,UZB,Uzbekistan,2011,3,5,-2
SVN,Slovenia,UZB,Uzbekistan,2013,0,3,-3
SVN,Slovenia,UZB,Uzbekistan,2014,0,4,-4
SVN,Slovenia,UZB,Uzbekistan,2015,0,7,-7
SVN,Slovenia,UZB,Uzbekistan,2016,0,5,-5
SVN,Slovenia,UZB,Uzbekistan,2017,0,4,-4
AUS,Australia,VUT,Vanuatu,2008,10,25,-15
AUS,Australia,VUT,Vanuatu,2009,11,14,-3
AUS,Australia,VUT,Vanuatu,2010,7,34,-27
AUS,Australia,VUT,Vanuatu,2011,8,24,-16
AUS,Australia,VUT,Vanuatu,2012,9,27,-18
AUS,Australia,VUT,Vanuatu,2013,7,35,-28
AUS,Australia,VUT,Vanuatu,2014,7,14,-7
AUS,Australia,VUT,Vanuatu,2015,0,25,-25
AUS,Australia,VUT,Vanuatu,2016,0,20,-20
AUS,Australia,VUT,Vanuatu,2017,0,15,-15
AUT,Austria,VUT,Vanuatu,2008,0,5,-5
AUT,Austria,VUT,Vanuatu,2009,1,0,1
AUT,Austria,VUT,Vanuatu,2010,0,0,0
AUT,Austria,VUT,Vanuatu,2011,0,1,-1
AUT,Austria,VUT,Vanuatu,2012,1,0,1
AUT,Austria,VUT,Vanuatu,2013,0,0,0
AUT,Austria,VUT,Vanuatu,2014,0,0,0
AUT,Austria,VUT,Vanuatu,2015,0,0,0
AUT,Austria,VUT,Vanuatu,2016,0,0,0
AUT,Austria,VUT,Vanuatu,2017,0,0,0
BEL,Belgium,VUT,Vanuatu,2008,0,0,0
BEL,Belgium,VUT,Vanuatu,2009,0,0,0
BEL,Belgium,VUT,Vanuatu,2010,0,0,0
BEL,Belgium,VUT,Vanuatu,2013,0,2,-2
BEL,Belgium,VUT,Vanuatu,2014,1,1,0
CAN,Canada,VUT,Vanuatu,2008,0,0,0
CAN,Canada,VUT,Vanuatu,2009,0,1,-1
CAN,Canada,VUT,Vanuatu,2010,0,0,0
CAN,Canada,VUT,Vanuatu,2011,0,0,0
CAN,Canada,VUT,Vanuatu,2012,0,0,0
CAN,Canada,VUT,Vanuatu,2013,0,0,0
CAN,Canada,VUT,Vanuatu,2014,0,2,-2
CAN,Canada,VUT,Vanuatu,2015,0,0,0
CAN,Canada,VUT,Vanuatu,2016,0,0,0
CAN,Canada,VUT,Vanuatu,2017,0,0,0
CZE,Czech Republic,VUT,Vanuatu,2009,0,1,-1
CZE,Czech Republic,VUT,Vanuatu,2013,0,1,-1
DNK,Denmark,VUT,Vanuatu,2014,0,0,0
DNK,Denmark,VUT,Vanuatu,2015,0,0,0
DNK,Denmark,VUT,Vanuatu,2016,2,0,2
DNK,Denmark,VUT,Vanuatu,2017,1,0,1
FIN,Finland,VUT,Vanuatu,2008,0,1,-1
FIN,Finland,VUT,Vanuatu,2009,0,0,0
FIN,Finland,VUT,Vanuatu,2010,0,0,0
FIN,Finland,VUT,Vanuatu,2011,0,0,0
FIN,Finland,VUT,Vanuatu,2012,0,0,0
FIN,Finland,VUT,Vanuatu,2013,0,0,0
FIN,Finland,VUT,Vanuatu,2014,0,0,0
FIN,Finland,VUT,Vanuatu,2015,0,0,0
FIN,Finland,VUT,Vanuatu,2016,0,0,0
FIN,Finland,VUT,Vanuatu,2017,0,0,0
FRA,France,VUT,Vanuatu,2008,0,1,-1
FRA,France,VUT,Vanuatu,2009,0,6,-6
FRA,France,VUT,Vanuatu,2010,0,3,-3
FRA,France,VUT,Vanuatu,2011,0,3,-3
FRA,France,VUT,Vanuatu,2012,0,3,-3
FRA,France,VUT,Vanuatu,2013,0,4,-4
FRA,France,VUT,Vanuatu,2014,0,2,-2
FRA,France,VUT,Vanuatu,2015,0,3,-3
FRA,France,VUT,Vanuatu,2016,0,6,-6
FRA,France,VUT,Vanuatu,2017,0,2,-2
DEU,Germany,VUT,Vanuatu,2008,3,1,2
DEU,Germany,VUT,Vanuatu,2009,2,2,0
DEU,Germany,VUT,Vanuatu,2010,1,1,0
DEU,Germany,VUT,Vanuatu,2011,2,3,-1
DEU,Germany,VUT,Vanuatu,2012,1,0,1
DEU,Germany,VUT,Vanuatu,2013,2,4,-2
DEU,Germany,VUT,Vanuatu,2014,3,6,-3
DEU,Germany,VUT,Vanuatu,2015,3,3,0
DEU,Germany,VUT,Vanuatu,2016,2,2,0
DEU,Germany,VUT,Vanuatu,2017,4,3,1
HUN,Hungary,VUT,Vanuatu,2008,0,0,0
HUN,Hungary,VUT,Vanuatu,2009,0,0,0
HUN,Hungary,VUT,Vanuatu,2010,0,1,-1
HUN,Hungary,VUT,Vanuatu,2011,0,0,0
HUN,Hungary,VUT,Vanuatu,2012,0,0,0
HUN,Hungary,VUT,Vanuatu,2013,0,0,0
HUN,Hungary,VUT,Vanuatu,2014,0,0,0
HUN,Hungary,VUT,Vanuatu,2015,0,0,0
HUN,Hungary,VUT,Vanuatu,2016,0,0,0
HUN,Hungary,VUT,Vanuatu,2017,0,0,0
ISL,Iceland,VUT,Vanuatu,2016,0,0,0
ISL,Iceland,VUT,Vanuatu,2017,0,0,0
ITA,Italy,VUT,Vanuatu,2008,0,0,0
ITA,Italy,VUT,Vanuatu,2009,0,0,0
ITA,Italy,VUT,Vanuatu,2010,0,0,0
ITA,Italy,VUT,Vanuatu,2011,0,0,0
ITA,Italy,VUT,Vanuatu,2012,0,0,0
ITA,Italy,VUT,Vanuatu,2013,0,0,0
ITA,Italy,VUT,Vanuatu,2015,0,0,0
ITA,Italy,VUT,Vanuatu,2016,0,2,-2
JPN,Japan,VUT,Vanuatu,2008,47,46,1
JPN,Japan,VUT,Vanuatu,2009,52,54,-2
JPN,Japan,VUT,Vanuatu,2010,54,55,-1
JPN,Japan,VUT,Vanuatu,2011,30,27,3
JPN,Japan,VUT,Vanuatu,2012,47,49,-2
JPN,Japan,VUT,Vanuatu,2013,38,37,1
JPN,Japan,VUT,Vanuatu,2014,40,39,1
JPN,Japan,VUT,Vanuatu,2015,59,60,-1
JPN,Japan,VUT,Vanuatu,2016,45,48,-3
JPN,Japan,VUT,Vanuatu,2017,61,64,-3
KOR,Korea,VUT,Vanuatu,2008,1,0,1
KOR,Korea,VUT,Vanuatu,2009,0,0,0
KOR,Korea,VUT,Vanuatu,2010,1,1,0
KOR,Korea,VUT,Vanuatu,2011,0,0,0
KOR,Korea,VUT,Vanuatu,2012,2,2,0
KOR,Korea,VUT,Vanuatu,2013,0,0,0
KOR,Korea,VUT,Vanuatu,2014,0,1,-1
KOR,Korea,VUT,Vanuatu,2015,1,2,-1
KOR,Korea,VUT,Vanuatu,2016,0,0,0
KOR,Korea,VUT,Vanuatu,2017,3,0,3
LUX,Luxembourg,VUT,Vanuatu,2008,0,0,0
LUX,Luxembourg,VUT,Vanuatu,2009,0,0,0
LUX,Luxembourg,VUT,Vanuatu,2010,0,0,0
LUX,Luxembourg,VUT,Vanuatu,2011,0,0,0
LUX,Luxembourg,VUT,Vanuatu,2012,0,0,0
LUX,Luxembourg,VUT,Vanuatu,2013,0,1,-1
LUX,Luxembourg,VUT,Vanuatu,2014,1,0,1
LUX,Luxembourg,VUT,Vanuatu,2015,0,0,0
LUX,Luxembourg,VUT,Vanuatu,2016,0,0,0
LUX,Luxembourg,VUT,Vanuatu,2017,0,0,0
MEX,Mexico,VUT,Vanuatu,2008,0,1,-1
MEX,Mexico,VUT,Vanuatu,2009,0,1,-1
MEX,Mexico,VUT,Vanuatu,2010,0,2,-2
MEX,Mexico,VUT,Vanuatu,2012,0,0,0
MEX,Mexico,VUT,Vanuatu,2013,0,0,0
MEX,Mexico,VUT,Vanuatu,2014,0,0,0
NLD,Netherlands,VUT,Vanuatu,2011,0,1,-1
NZL,New Zealand,VUT,Vanuatu,2008,17,31,-14
NZL,New Zealand,VUT,Vanuatu,2009,25,34,-9
NZL,New Zealand,VUT,Vanuatu,2010,11,46,-35
NZL,New Zealand,VUT,Vanuatu,2011,28,51,-23
NZL,New Zealand,VUT,Vanuatu,2012,18,49,-31
NZL,New Zealand,VUT,Vanuatu,2013,16,50,-34
NZL,New Zealand,VUT,Vanuatu,2014,14,48,-34
NZL,New Zealand,VUT,Vanuatu,2015,14,38,-24
NZL,New Zealand,VUT,Vanuatu,2016,15,68,-53
NZL,New Zealand,VUT,Vanuatu,2017,15,54,-39
NOR,Norway,VUT,Vanuatu,2008,0,0,0
NOR,Norway,VUT,Vanuatu,2009,1,0,1
NOR,Norway,VUT,Vanuatu,2010,0,0,0
NOR,Norway,VUT,Vanuatu,2011,0,0,0
NOR,Norway,VUT,Vanuatu,2012,0,0,0
NOR,Norway,VUT,Vanuatu,2013,0,0,0
NOR,Norway,VUT,Vanuatu,2014,0,0,0
NOR,Norway,VUT,Vanuatu,2015,0,0,0
NOR,Norway,VUT,Vanuatu,2016,0,0,0
NOR,Norway,VUT,Vanuatu,2017,0,0,0
POL,Poland,VUT,Vanuatu,2009,0,0,0
POL,Poland,VUT,Vanuatu,2010,0,0,0
POL,Poland,VUT,Vanuatu,2011,0,0,0
POL,Poland,VUT,Vanuatu,2012,0,0,0
POL,Poland,VUT,Vanuatu,2013,0,0,0
POL,Poland,VUT,Vanuatu,2014,0,0,0
POL,Poland,VUT,Vanuatu,2015,0,0,0
POL,Poland,VUT,Vanuatu,2016,0,0,0
POL,Poland,VUT,Vanuatu,2017,0,1,-1
SVK,Slovak Republic,VUT,Vanuatu,2008,0,0,0
SVK,Slovak Republic,VUT,Vanuatu,2010,0,1,-1
SVK,Slovak Republic,VUT,Vanuatu,2011,0,1,-1
ESP,Spain,VUT,Vanuatu,2008,0,0,0
ESP,Spain,VUT,Vanuatu,2009,0,1,-1
ESP,Spain,VUT,Vanuatu,2010,0,0,0
ESP,Spain,VUT,Vanuatu,2011,0,1,-1
ESP,Spain,VUT,Vanuatu,2012,0,0,0
ESP,Spain,VUT,Vanuatu,2013,0,0,0
ESP,Spain,VUT,Vanuatu,2014,0,0,0
ESP,Spain,VUT,Vanuatu,2015,0,0,0
ESP,Spain,VUT,Vanuatu,2016,0,3,-3
ESP,Spain,VUT,Vanuatu,2017,0,2,-2
SWE,Sweden,VUT,Vanuatu,2008,0,0,0
SWE,Sweden,VUT,Vanuatu,2009,0,1,-1
SWE,Sweden,VUT,Vanuatu,2010,0,0,0
SWE,Sweden,VUT,Vanuatu,2011,0,0,0
SWE,Sweden,VUT,Vanuatu,2012,0,0,0
SWE,Sweden,VUT,Vanuatu,2013,0,0,0
SWE,Sweden,VUT,Vanuatu,2014,0,0,0
SWE,Sweden,VUT,Vanuatu,2015,0,0,0
SWE,Sweden,VUT,Vanuatu,2016,0,1,-1
SWE,Sweden,VUT,Vanuatu,2017,0,0,0
CHE,Switzerland,VUT,Vanuatu,2010,0,0,0
CHE,Switzerland,VUT,Vanuatu,2011,0,0,0
CHE,Switzerland,VUT,Vanuatu,2012,1,0,1
CHE,Switzerland,VUT,Vanuatu,2013,0,0,0
USA,United States,VUT,Vanuatu,2008,0,5,-5
USA,United States,VUT,Vanuatu,2009,0,6,-6
USA,United States,VUT,Vanuatu,2010,0,5,-5
USA,United States,VUT,Vanuatu,2011,0,4,-4
USA,United States,VUT,Vanuatu,2012,0,3,-3
USA,United States,VUT,Vanuatu,2013,0,7,-7
USA,United States,VUT,Vanuatu,2014,0,3,-3
USA,United States,VUT,Vanuatu,2015,0,4,-4
USA,United States,VUT,Vanuatu,2016,0,3,-3
USA,United States,VUT,Vanuatu,2017,0,6,-6
CHL,Chile,VUT,Vanuatu,2008,0,0,0
CHL,Chile,VUT,Vanuatu,2009,0,0,0
CHL,Chile,VUT,Vanuatu,2010,0,0,0
CHL,Chile,VUT,Vanuatu,2011,0,0,0
CHL,Chile,VUT,Vanuatu,2012,0,0,0
CHL,Chile,VUT,Vanuatu,2013,0,0,0
CHL,Chile,VUT,Vanuatu,2014,0,0,0
CHL,Chile,VUT,Vanuatu,2015,0,0,0
CHL,Chile,VUT,Vanuatu,2016,0,0,0
EST,Estonia,VUT,Vanuatu,2008,0,0,0
EST,Estonia,VUT,Vanuatu,2009,0,0,0
EST,Estonia,VUT,Vanuatu,2010,0,0,0
EST,Estonia,VUT,Vanuatu,2011,0,0,0
EST,Estonia,VUT,Vanuatu,2012,0,0,0
EST,Estonia,VUT,Vanuatu,2013,0,0,0
EST,Estonia,VUT,Vanuatu,2014,0,0,0
EST,Estonia,VUT,Vanuatu,2015,0,0,0
EST,Estonia,VUT,Vanuatu,2016,0,0,0
EST,Estonia,VUT,Vanuatu,2017,0,0,0
AUS,Australia,VEN,Venezuela,2008,10,277,-267
AUS,Australia,VEN,Venezuela,2009,20,286,-266
AUS,Australia,VEN,Venezuela,2010,15,381,-366
AUS,Australia,VEN,Venezuela,2011,14,270,-256
AUS,Australia,VEN,Venezuela,2012,30,313,-283
AUS,Australia,VEN,Venezuela,2013,25,286,-261
AUS,Australia,VEN,Venezuela,2014,42,220,-178
AUS,Australia,VEN,Venezuela,2015,0,260,-260
AUS,Australia,VEN,Venezuela,2016,0,251,-251
AUS,Australia,VEN,Venezuela,2017,0,267,-267
AUT,Austria,VEN,Venezuela,2008,32,53,-21
AUT,Austria,VEN,Venezuela,2009,37,64,-27
AUT,Austria,VEN,Venezuela,2010,41,46,-5
AUT,Austria,VEN,Venezuela,2011,32,56,-24
AUT,Austria,VEN,Venezuela,2012,34,64,-30
AUT,Austria,VEN,Venezuela,2013,34,52,-18
AUT,Austria,VEN,Venezuela,2014,40,53,-13
AUT,Austria,VEN,Venezuela,2015,26,91,-65
AUT,Austria,VEN,Venezuela,2016,39,95,-56
AUT,Austria,VEN,Venezuela,2017,41,137,-96
BEL,Belgium,VEN,Venezuela,2008,0,102,-102
BEL,Belgium,VEN,Venezuela,2009,0,80,-80
BEL,Belgium,VEN,Venezuela,2010,54,127,-73
BEL,Belgium,VEN,Venezuela,2011,0,114,-114
BEL,Belgium,VEN,Venezuela,2012,57,106,-49
BEL,Belgium,VEN,Venezuela,2013,84,90,-6
BEL,Belgium,VEN,Venezuela,2014,52,92,-40
BEL,Belgium,VEN,Venezuela,2015,38,109,-71
BEL,Belgium,VEN,Venezuela,2016,24,136,-112
BEL,Belgium,VEN,Venezuela,2017,40,275,-235
CAN,Canada,VEN,Venezuela,2008,0,1239,-1239
CAN,Canada,VEN,Venezuela,2009,0,1352,-1352
CAN,Canada,VEN,Venezuela,2010,0,998,-998
CAN,Canada,VEN,Venezuela,2011,0,1451,-1451
CAN,Canada,VEN,Venezuela,2012,0,1366,-1366
CAN,Canada,VEN,Venezuela,2013,0,1022,-1022
CAN,Canada,VEN,Venezuela,2014,0,1483,-1483
CAN,Canada,VEN,Venezuela,2015,0,929,-929
CAN,Canada,VEN,Venezuela,2016,0,1020,-1020
CAN,Canada,VEN,Venezuela,2017,0,1020,-1020
CZE,Czech Republic,VEN,Venezuela,2008,0,22,-22
CZE,Czech Republic,VEN,Venezuela,2009,1,16,-15
CZE,Czech Republic,VEN,Venezuela,2010,0,11,-11
CZE,Czech Republic,VEN,Venezuela,2011,0,15,-15
CZE,Czech Republic,VEN,Venezuela,2012,6,14,-8
CZE,Czech Republic,VEN,Venezuela,2013,13,18,-5
CZE,Czech Republic,VEN,Venezuela,2014,12,19,-7
CZE,Czech Republic,VEN,Venezuela,2015,8,18,-10
CZE,Czech Republic,VEN,Venezuela,2016,9,28,-19
CZE,Czech Republic,VEN,Venezuela,2017,6,48,-42
DNK,Denmark,VEN,Venezuela,2008,17,27,-10
DNK,Denmark,VEN,Venezuela,2009,19,39,-20
DNK,Denmark,VEN,Venezuela,2010,19,34,-15
DNK,Denmark,VEN,Venezuela,2011,24,16,8
DNK,Denmark,VEN,Venezuela,2012,18,27,-9
DNK,Denmark,VEN,Venezuela,2013,22,36,-14
DNK,Denmark,VEN,Venezuela,2014,20,29,-9
DNK,Denmark,VEN,Venezuela,2015,14,29,-15
DNK,Denmark,VEN,Venezuela,2016,13,29,-16
DNK,Denmark,VEN,Venezuela,2017,14,44,-30
FIN,Finland,VEN,Venezuela,2008,0,9,-9
FIN,Finland,VEN,Venezuela,2009,0,7,-7
FIN,Finland,VEN,Venezuela,2010,0,18,-18
FIN,Finland,VEN,Venezuela,2011,0,17,-17
FIN,Finland,VEN,Venezuela,2012,0,19,-19
FIN,Finland,VEN,Venezuela,2013,2,13,-11
FIN,Finland,VEN,Venezuela,2014,4,22,-18
FIN,Finland,VEN,Venezuela,2015,2,18,-16
FIN,Finland,VEN,Venezuela,2016,0,14,-14
FIN,Finland,VEN,Venezuela,2017,2,11,-9
FRA,France,VEN,Venezuela,2008,0,228,-228
FRA,France,VEN,Venezuela,2009,0,247,-247
FRA,France,VEN,Venezuela,2010,0,209,-209
FRA,France,VEN,Venezuela,2011,0,251,-251
FRA,France,VEN,Venezuela,2012,0,248,-248
FRA,France,VEN,Venezuela,2013,0,271,-271
FRA,France,VEN,Venezuela,2014,0,337,-337
FRA,France,VEN,Venezuela,2015,0,282,-282
FRA,France,VEN,Venezuela,2016,0,296,-296
FRA,France,VEN,Venezuela,2017,0,339,-339
DEU,Germany,VEN,Venezuela,2008,448,515,-67
DEU,Germany,VEN,Venezuela,2009,436,551,-115
DEU,Germany,VEN,Venezuela,2010,412,527,-115
DEU,Germany,VEN,Venezuela,2011,306,560,-254
DEU,Germany,VEN,Venezuela,2012,374,679,-305
DEU,Germany,VEN,Venezuela,2013,376,702,-326
DEU,Germany,VEN,Venezuela,2014,434,792,-358
DEU,Germany,VEN,Venezuela,2015,386,880,-494
DEU,Germany,VEN,Venezuela,2016,373,975,-602
DEU,Germany,VEN,Venezuela,2017,373,1264,-891
HUN,Hungary,VEN,Venezuela,2008,0,24,-24
HUN,Hungary,VEN,Venezuela,2009,1,25,-24
HUN,Hungary,VEN,Venezuela,2010,6,14,-8
HUN,Hungary,VEN,Venezuela,2011,3,12,-9
HUN,Hungary,VEN,Venezuela,2012,2,20,-18
HUN,Hungary,VEN,Venezuela,2013,5,22,-17
HUN,Hungary,VEN,Venezuela,2014,2,15,-13
HUN,Hungary,VEN,Venezuela,2015,2,18,-16
HUN,Hungary,VEN,Venezuela,2016,8,40,-32
HUN,Hungary,VEN,Venezuela,2017,0,47,-47
ISL,Iceland,VEN,Venezuela,2008,9,4,5
ISL,Iceland,VEN,Venezuela,2009,1,1,0
ISL,Iceland,VEN,Venezuela,2010,1,2,-1
ISL,Iceland,VEN,Venezuela,2011,1,3,-2
ISL,Iceland,VEN,Venezuela,2012,0,0,0
ISL,Iceland,VEN,Venezuela,2013,1,1,0
ISL,Iceland,VEN,Venezuela,2014,3,1,2
ISL,Iceland,VEN,Venezuela,2015,1,1,0
ISL,Iceland,VEN,Venezuela,2016,0,6,-6
ISL,Iceland,VEN,Venezuela,2017,1,13,-12
ITA,Italy,VEN,Venezuela,2008,75,848,-773
ITA,Italy,VEN,Venezuela,2009,90,704,-614
ITA,Italy,VEN,Venezuela,2010,70,802,-732
ITA,Italy,VEN,Venezuela,2011,77,738,-661
ITA,Italy,VEN,Venezuela,2012,56,584,-528
ITA,Italy,VEN,Venezuela,2013,69,528,-459
ITA,Italy,VEN,Venezuela,2014,50,523,-473
ITA,Italy,VEN,Venezuela,2015,77,672,-595
ITA,Italy,VEN,Venezuela,2016,0,967,-967
ITA,Italy,VEN,Venezuela,2017,66,1568,-1502
JPN,Japan,VEN,Venezuela,2008,383,412,-29
JPN,Japan,VEN,Venezuela,2009,257,266,-9
JPN,Japan,VEN,Venezuela,2010,168,173,-5
JPN,Japan,VEN,Venezuela,2011,111,127,-16
JPN,Japan,VEN,Venezuela,2012,161,173,-12
JPN,Japan,VEN,Venezuela,2013,363,395,-32
JPN,Japan,VEN,Venezuela,2014,102,120,-18
JPN,Japan,VEN,Venezuela,2015,276,318,-42
JPN,Japan,VEN,Venezuela,2016,95,128,-33
JPN,Japan,VEN,Venezuela,2017,88,137,-49
KOR,Korea,VEN,Venezuela,2008,38,48,-10
KOR,Korea,VEN,Venezuela,2009,41,36,5
KOR,Korea,VEN,Venezuela,2010,32,23,9
KOR,Korea,VEN,Venezuela,2011,28,39,-11
KOR,Korea,VEN,Venezuela,2012,41,48,-7
KOR,Korea,VEN,Venezuela,2013,39,45,-6
KOR,Korea,VEN,Venezuela,2014,44,36,8
KOR,Korea,VEN,Venezuela,2015,31,35,-4
KOR,Korea,VEN,Venezuela,2016,35,44,-9
KOR,Korea,VEN,Venezuela,2017,44,53,-9
LUX,Luxembourg,VEN,Venezuela,2008,4,2,2
LUX,Luxembourg,VEN,Venezuela,2009,2,5,-3
LUX,Luxembourg,VEN,Venezuela,2010,1,5,-4
LUX,Luxembourg,VEN,Venezuela,2011,2,12,-10
LUX,Luxembourg,VEN,Venezuela,2012,0,7,-7
LUX,Luxembourg,VEN,Venezuela,2013,2,11,-9
LUX,Luxembourg,VEN,Venezuela,2014,4,10,-6
LUX,Luxembourg,VEN,Venezuela,2015,2,22,-20
LUX,Luxembourg,VEN,Venezuela,2016,4,14,-10
LUX,Luxembourg,VEN,Venezuela,2017,6,20,-14
MEX,Mexico,VEN,Venezuela,2008,0,743,-743
MEX,Mexico,VEN,Venezuela,2009,0,1310,-1310
MEX,Mexico,VEN,Venezuela,2010,0,1664,-1664
MEX,Mexico,VEN,Venezuela,2011,0,1290,-1290
MEX,Mexico,VEN,Venezuela,2012,0,1173,-1173
MEX,Mexico,VEN,Venezuela,2013,0,2808,-2808
MEX,Mexico,VEN,Venezuela,2014,0,2624,-2624
MEX,Mexico,VEN,Venezuela,2015,0,2235,-2235
MEX,Mexico,VEN,Venezuela,2016,0,2537,-2537
MEX,Mexico,VEN,Venezuela,2017,0,3383,-3383
NLD,Netherlands,VEN,Venezuela,2008,71,149,-78
NLD,Netherlands,VEN,Venezuela,2009,49,140,-91
NLD,Netherlands,VEN,Venezuela,2010,74,130,-56
NLD,Netherlands,VEN,Venezuela,2011,70,139,-69
NLD,Netherlands,VEN,Venezuela,2012,65,139,-74
NLD,Netherlands,VEN,Venezuela,2013,78,120,-42
NLD,Netherlands,VEN,Venezuela,2014,55,141,-86
NLD,Netherlands,VEN,Venezuela,2015,70,137,-67
NLD,Netherlands,VEN,Venezuela,2016,71,129,-58
NLD,Netherlands,VEN,Venezuela,2017,54,201,-147
NZL,New Zealand,VEN,Venezuela,2008,3,12,-9
NZL,New Zealand,VEN,Venezuela,2009,1,13,-12
NZL,New Zealand,VEN,Venezuela,2010,7,8,-1
NZL,New Zealand,VEN,Venezuela,2011,7,15,-8
NZL,New Zealand,VEN,Venezuela,2012,6,15,-9
NZL,New Zealand,VEN,Venezuela,2013,7,7,0
NZL,New Zealand,VEN,Venezuela,2014,2,11,-9
NZL,New Zealand,VEN,Venezuela,2015,3,11,-8
NZL,New Zealand,VEN,Venezuela,2016,0,24,-24
NZL,New Zealand,VEN,Venezuela,2017,10,16,-6
NOR,Norway,VEN,Venezuela,2008,20,141,-121
NOR,Norway,VEN,Venezuela,2009,27,84,-57
NOR,Norway,VEN,Venezuela,2010,29,67,-38
NOR,Norway,VEN,Venezuela,2011,38,127,-89
NOR,Norway,VEN,Venezuela,2012,19,114,-95
NOR,Norway,VEN,Venezuela,2013,40,90,-50
NOR,Norway,VEN,Venezuela,2014,37,70,-33
NOR,Norway,VEN,Venezuela,2015,30,39,-9
NOR,Norway,VEN,Venezuela,2016,49,30,19
NOR,Norway,VEN,Venezuela,2017,25,53,-28
POL,Poland,VEN,Venezuela,2008,0,21,-21
POL,Poland,VEN,Venezuela,2009,0,23,-23
POL,Poland,VEN,Venezuela,2010,0,36,-36
POL,Poland,VEN,Venezuela,2011,0,30,-30
POL,Poland,VEN,Venezuela,2012,0,44,-44
POL,Poland,VEN,Venezuela,2013,0,39,-39
POL,Poland,VEN,Venezuela,2014,0,14,-14
POL,Poland,VEN,Venezuela,2015,0,45,-45
POL,Poland,VEN,Venezuela,2016,0,43,-43
POL,Poland,VEN,Venezuela,2017,0,66,-66
PRT,Portugal,VEN,Venezuela,2008,0,159,-159
PRT,Portugal,VEN,Venezuela,2009,0,116,-116
PRT,Portugal,VEN,Venezuela,2010,0,126,-126
PRT,Portugal,VEN,Venezuela,2011,0,141,-141
PRT,Portugal,VEN,Venezuela,2012,0,101,-101
PRT,Portugal,VEN,Venezuela,2013,0,96,-96
PRT,Portugal,VEN,Venezuela,2014,0,144,-144
PRT,Portugal,VEN,Venezuela,2015,0,241,-241
PRT,Portugal,VEN,Venezuela,2016,0,453,-453
PRT,Portugal,VEN,Venezuela,2017,0,924,-924
SVK,Slovak Republic,VEN,Venezuela,2008,4,3,1
SVK,Slovak Republic,VEN,Venezuela,2009,1,1,0
SVK,Slovak Republic,VEN,Venezuela,2010,0,1,-1
SVK,Slovak Republic,VEN,Venezuela,2011,0,1,-1
SVK,Slovak Republic,VEN,Venezuela,2016,0,1,-1
ESP,Spain,VEN,Venezuela,2008,3433,8693,-5260
ESP,Spain,VEN,Venezuela,2009,4339,5736,-1397
ESP,Spain,VEN,Venezuela,2010,4129,6460,-2331
ESP,Spain,VEN,Venezuela,2011,4180,6767,-2587
ESP,Spain,VEN,Venezuela,2012,4548,4609,-61
ESP,Spain,VEN,Venezuela,2013,6133,4691,1442
ESP,Spain,VEN,Venezuela,2014,3099,7199,-4100
ESP,Spain,VEN,Venezuela,2015,2482,10529,-8047
ESP,Spain,VEN,Venezuela,2016,2293,18507,-16214
ESP,Spain,VEN,Venezuela,2017,3073,31468,-28395
SWE,Sweden,VEN,Venezuela,2008,15,62,-47
SWE,Sweden,VEN,Venezuela,2009,7,45,-38
SWE,Sweden,VEN,Venezuela,2010,7,52,-45
SWE,Sweden,VEN,Venezuela,2011,17,62,-45
SWE,Sweden,VEN,Venezuela,2012,17,77,-60
SWE,Sweden,VEN,Venezuela,2013,11,47,-36
SWE,Sweden,VEN,Venezuela,2014,13,45,-32
SWE,Sweden,VEN,Venezuela,2015,9,45,-36
SWE,Sweden,VEN,Venezuela,2016,8,47,-39
SWE,Sweden,VEN,Venezuela,2017,8,67,-59
CHE,Switzerland,VEN,Venezuela,2010,72,144,-72
CHE,Switzerland,VEN,Venezuela,2011,74,135,-61
CHE,Switzerland,VEN,Venezuela,2012,81,141,-60
CHE,Switzerland,VEN,Venezuela,2013,63,134,-71
CHE,Switzerland,VEN,Venezuela,2014,40,139,-99
CHE,Switzerland,VEN,Venezuela,2015,56,130,-74
CHE,Switzerland,VEN,Venezuela,2016,51,138,-87
CHE,Switzerland,VEN,Venezuela,2017,54,124,-70
TUR,Turkey,VEN,Venezuela,2010,0,8,-8
GBR,United Kingdom,VEN,Venezuela,2013,0,1000,-1000
USA,United States,VEN,Venezuela,2008,0,10514,-10514
USA,United States,VEN,Venezuela,2009,0,11154,-11154
USA,United States,VEN,Venezuela,2010,0,9409,-9409
USA,United States,VEN,Venezuela,2011,0,9183,-9183
USA,United States,VEN,Venezuela,2012,0,9387,-9387
USA,United States,VEN,Venezuela,2013,0,9572,-9572
USA,United States,VEN,Venezuela,2014,0,8427,-8427
USA,United States,VEN,Venezuela,2015,0,9144,-9144
USA,United States,VEN,Venezuela,2016,0,10772,-10772
USA,United States,VEN,Venezuela,2017,0,11809,-11809
CHL,Chile,VEN,Venezuela,2008,0,504,-504
CHL,Chile,VEN,Venezuela,2009,0,507,-507
CHL,Chile,VEN,Venezuela,2010,0,547,-547
CHL,Chile,VEN,Venezuela,2011,0,782,-782
CHL,Chile,VEN,Venezuela,2012,0,824,-824
CHL,Chile,VEN,Venezuela,2013,0,1019,-1019
CHL,Chile,VEN,Venezuela,2014,0,2309,-2309
CHL,Chile,VEN,Venezuela,2015,0,7351,-7351
CHL,Chile,VEN,Venezuela,2016,0,21889,-21889
EST,Estonia,VEN,Venezuela,2008,0,2,-2
EST,Estonia,VEN,Venezuela,2009,0,1,-1
EST,Estonia,VEN,Venezuela,2010,0,0,0
EST,Estonia,VEN,Venezuela,2011,0,0,0
EST,Estonia,VEN,Venezuela,2012,0,2,-2
EST,Estonia,VEN,Venezuela,2013,0,0,0
EST,Estonia,VEN,Venezuela,2014,0,1,-1
EST,Estonia,VEN,Venezuela,2015,0,3,-3
EST,Estonia,VEN,Venezuela,2016,0,1,-1
EST,Estonia,VEN,Venezuela,2017,0,10,-10
ISR,Israel,VEN,Venezuela,2008,0,46,-46
ISR,Israel,VEN,Venezuela,2009,0,31,-31
ISR,Israel,VEN,Venezuela,2010,0,101,-101
ISR,Israel,VEN,Venezuela,2011,0,77,-77
ISR,Israel,VEN,Venezuela,2012,0,33,-33
ISR,Israel,VEN,Venezuela,2013,0,47,-47
ISR,Israel,VEN,Venezuela,2014,0,59,-59
ISR,Israel,VEN,Venezuela,2015,0,84,-84
ISR,Israel,VEN,Venezuela,2016,0,70,-70
ISR,Israel,VEN,Venezuela,2017,0,130,-130
SVN,Slovenia,VEN,Venezuela,2008,0,2,-2
SVN,Slovenia,VEN,Venezuela,2010,0,5,-5
SVN,Slovenia,VEN,Venezuela,2011,1,7,-6
SVN,Slovenia,VEN,Venezuela,2013,0,1,-1
SVN,Slovenia,VEN,Venezuela,2015,0,8,-8
SVN,Slovenia,VEN,Venezuela,2016,0,1,-1
SVN,Slovenia,VEN,Venezuela,2017,0,6,-6
AUS,Australia,VNM,Viet Nam,2008,819,3043,-2224
AUS,Australia,VNM,Viet Nam,2009,691,3273,-2582
AUS,Australia,VNM,Viet Nam,2010,702,3844,-3142
AUS,Australia,VNM,Viet Nam,2011,780,4802,-4022
AUS,Australia,VNM,Viet Nam,2012,669,4804,-4135
AUS,Australia,VNM,Viet Nam,2013,621,5716,-5095
AUS,Australia,VNM,Viet Nam,2014,565,5237,-4672
AUS,Australia,VNM,Viet Nam,2015,600,5074,-4474
AUS,Australia,VNM,Viet Nam,2016,600,5377,-4777
AUS,Australia,VNM,Viet Nam,2017,0,5526,-5526
AUT,Austria,VNM,Viet Nam,2008,49,84,-35
AUT,Austria,VNM,Viet Nam,2009,76,70,6
AUT,Austria,VNM,Viet Nam,2010,56,77,-21
AUT,Austria,VNM,Viet Nam,2011,62,86,-24
AUT,Austria,VNM,Viet Nam,2012,72,108,-36
AUT,Austria,VNM,Viet Nam,2013,63,98,-35
AUT,Austria,VNM,Viet Nam,2014,41,118,-77
AUT,Austria,VNM,Viet Nam,2015,80,161,-81
AUT,Austria,VNM,Viet Nam,2016,73,162,-89
AUT,Austria,VNM,Viet Nam,2017,83,211,-128
BEL,Belgium,VNM,Viet Nam,2008,171,245,-74
BEL,Belgium,VNM,Viet Nam,2009,167,310,-143
BEL,Belgium,VNM,Viet Nam,2010,158,295,-137
BEL,Belgium,VNM,Viet Nam,2011,187,352,-165
BEL,Belgium,VNM,Viet Nam,2012,234,276,-42
BEL,Belgium,VNM,Viet Nam,2013,181,326,-145
BEL,Belgium,VNM,Viet Nam,2014,187,230,-43
BEL,Belgium,VNM,Viet Nam,2015,139,255,-116
BEL,Belgium,VNM,Viet Nam,2016,124,278,-154
BEL,Belgium,VNM,Viet Nam,2017,142,276,-134
CAN,Canada,VNM,Viet Nam,2008,0,1784,-1784
CAN,Canada,VNM,Viet Nam,2009,0,2171,-2171
CAN,Canada,VNM,Viet Nam,2010,0,1942,-1942
CAN,Canada,VNM,Viet Nam,2011,0,1723,-1723
CAN,Canada,VNM,Viet Nam,2012,0,1729,-1729
CAN,Canada,VNM,Viet Nam,2013,0,2112,-2112
CAN,Canada,VNM,Viet Nam,2014,0,2494,-2494
CAN,Canada,VNM,Viet Nam,2015,0,2591,-2591
CAN,Canada,VNM,Viet Nam,2016,0,2445,-2445
CAN,Canada,VNM,Viet Nam,2017,0,2505,-2505
CZE,Czech Republic,VNM,Viet Nam,2008,69,13368,-13299
CZE,Czech Republic,VNM,Viet Nam,2009,37,2306,-2269
CZE,Czech Republic,VNM,Viet Nam,2010,36,1422,-1386
CZE,Czech Republic,VNM,Viet Nam,2011,53,708,-655
CZE,Czech Republic,VNM,Viet Nam,2012,1663,1571,92
CZE,Czech Republic,VNM,Viet Nam,2013,2371,1186,1185
CZE,Czech Republic,VNM,Viet Nam,2014,1899,1745,154
CZE,Czech Republic,VNM,Viet Nam,2015,1534,1305,229
CZE,Czech Republic,VNM,Viet Nam,2016,1211,1752,-541
CZE,Czech Republic,VNM,Viet Nam,2017,880,2196,-1316
DNK,Denmark,VNM,Viet Nam,2008,75,143,-68
DNK,Denmark,VNM,Viet Nam,2009,58,165,-107
DNK,Denmark,VNM,Viet Nam,2010,76,178,-102
DNK,Denmark,VNM,Viet Nam,2011,107,126,-19
DNK,Denmark,VNM,Viet Nam,2012,72,144,-72
DNK,Denmark,VNM,Viet Nam,2013,102,158,-56
DNK,Denmark,VNM,Viet Nam,2014,54,191,-137
DNK,Denmark,VNM,Viet Nam,2015,63,164,-101
DNK,Denmark,VNM,Viet Nam,2016,80,137,-57
DNK,Denmark,VNM,Viet Nam,2017,114,207,-93
FIN,Finland,VNM,Viet Nam,2008,18,317,-299
FIN,Finland,VNM,Viet Nam,2009,20,300,-280
FIN,Finland,VNM,Viet Nam,2010,23,272,-249
FIN,Finland,VNM,Viet Nam,2011,23,360,-337
FIN,Finland,VNM,Viet Nam,2012,17,379,-362
FIN,Finland,VNM,Viet Nam,2013,33,402,-369
FIN,Finland,VNM,Viet Nam,2014,44,506,-462
FIN,Finland,VNM,Viet Nam,2015,30,679,-649
FIN,Finland,VNM,Viet Nam,2016,54,942,-888
FIN,Finland,VNM,Viet Nam,2017,41,616,-575
FRA,France,VNM,Viet Nam,2008,0,1249,-1249
FRA,France,VNM,Viet Nam,2009,0,1352,-1352
FRA,France,VNM,Viet Nam,2010,0,1153,-1153
FRA,France,VNM,Viet Nam,2011,0,1148,-1148
FRA,France,VNM,Viet Nam,2012,0,1328,-1328
FRA,France,VNM,Viet Nam,2013,0,1359,-1359
FRA,France,VNM,Viet Nam,2014,0,1466,-1466
FRA,France,VNM,Viet Nam,2015,0,1012,-1012
FRA,France,VNM,Viet Nam,2016,0,1003,-1003
FRA,France,VNM,Viet Nam,2017,0,1023,-1023
DEU,Germany,VNM,Viet Nam,2008,4313,4045,268
DEU,Germany,VNM,Viet Nam,2009,3720,4469,-749
DEU,Germany,VNM,Viet Nam,2010,3267,4310,-1043
DEU,Germany,VNM,Viet Nam,2011,2990,4206,-1216
DEU,Germany,VNM,Viet Nam,2012,2411,3887,-1476
DEU,Germany,VNM,Viet Nam,2013,2535,4126,-1591
DEU,Germany,VNM,Viet Nam,2014,2347,5053,-2706
DEU,Germany,VNM,Viet Nam,2015,2393,6117,-3724
DEU,Germany,VNM,Viet Nam,2016,2811,6998,-4187
DEU,Germany,VNM,Viet Nam,2017,2601,7045,-4444
HUN,Hungary,VNM,Viet Nam,2008,34,300,-266
HUN,Hungary,VNM,Viet Nam,2009,20,227,-207
HUN,Hungary,VNM,Viet Nam,2010,47,212,-165
HUN,Hungary,VNM,Viet Nam,2011,22,225,-203
HUN,Hungary,VNM,Viet Nam,2012,14,269,-255
HUN,Hungary,VNM,Viet Nam,2013,91,294,-203
HUN,Hungary,VNM,Viet Nam,2014,51,276,-225
HUN,Hungary,VNM,Viet Nam,2015,34,347,-313
HUN,Hungary,VNM,Viet Nam,2016,56,280,-224
HUN,Hungary,VNM,Viet Nam,2017,76,731,-655
ISL,Iceland,VNM,Viet Nam,2008,7,42,-35
ISL,Iceland,VNM,Viet Nam,2009,5,22,-17
ISL,Iceland,VNM,Viet Nam,2010,1,37,-36
ISL,Iceland,VNM,Viet Nam,2011,8,36,-28
ISL,Iceland,VNM,Viet Nam,2012,1,20,-19
ISL,Iceland,VNM,Viet Nam,2013,4,32,-28
ISL,Iceland,VNM,Viet Nam,2014,7,42,-35
ISL,Iceland,VNM,Viet Nam,2015,6,43,-37
ISL,Iceland,VNM,Viet Nam,2016,6,66,-60
ISL,Iceland,VNM,Viet Nam,2017,6,66,-60
ITA,Italy,VNM,Viet Nam,2008,7,326,-319
ITA,Italy,VNM,Viet Nam,2009,7,301,-294
ITA,Italy,VNM,Viet Nam,2010,7,306,-299
ITA,Italy,VNM,Viet Nam,2011,10,230,-220
ITA,Italy,VNM,Viet Nam,2012,9,141,-132
ITA,Italy,VNM,Viet Nam,2013,12,159,-147
ITA,Italy,VNM,Viet Nam,2014,14,199,-185
ITA,Italy,VNM,Viet Nam,2015,14,220,-206
ITA,Italy,VNM,Viet Nam,2016,0,247,-247
ITA,Italy,VNM,Viet Nam,2017,12,203,-191
JPN,Japan,VNM,Viet Nam,2008,7160,12528,-5368
JPN,Japan,VNM,Viet Nam,2009,9895,10930,-1035
JPN,Japan,VNM,Viet Nam,2010,10025,11932,-1907
JPN,Japan,VNM,Viet Nam,2011,9971,13913,-3942
JPN,Japan,VNM,Viet Nam,2012,9796,19481,-9685
JPN,Japan,VNM,Viet Nam,2013,10427,31740,-21313
JPN,Japan,VNM,Viet Nam,2014,12461,42993,-30532
JPN,Japan,VNM,Viet Nam,2015,14365,65850,-51485
JPN,Japan,VNM,Viet Nam,2016,18376,77540,-59164
JPN,Japan,VNM,Viet Nam,2017,28069,98615,-70546
KOR,Korea,VNM,Viet Nam,2008,7998,23960,-15962
KOR,Korea,VNM,Viet Nam,2009,9821,16427,-6606
KOR,Korea,VNM,Viet Nam,2010,9488,22934,-13446
KOR,Korea,VNM,Viet Nam,2011,14155,27873,-13718
KOR,Korea,VNM,Viet Nam,2012,18573,24743,-6170
KOR,Korea,VNM,Viet Nam,2013,20484,22248,-1764
KOR,Korea,VNM,Viet Nam,2014,17740,28012,-10272
KOR,Korea,VNM,Viet Nam,2015,24533,30244,-5711
KOR,Korea,VNM,Viet Nam,2016,27711,40099,-12388
KOR,Korea,VNM,Viet Nam,2017,27447,47964,-20517
LUX,Luxembourg,VNM,Viet Nam,2008,11,22,-11
LUX,Luxembourg,VNM,Viet Nam,2009,4,15,-11
LUX,Luxembourg,VNM,Viet Nam,2010,13,17,-4
LUX,Luxembourg,VNM,Viet Nam,2011,11,21,-10
LUX,Luxembourg,VNM,Viet Nam,2012,12,20,-8
LUX,Luxembourg,VNM,Viet Nam,2013,14,28,-14
LUX,Luxembourg,VNM,Viet Nam,2014,21,22,-1
LUX,Luxembourg,VNM,Viet Nam,2015,19,34,-15
LUX,Luxembourg,VNM,Viet Nam,2016,15,33,-18
LUX,Luxembourg,VNM,Viet Nam,2017,18,29,-11
MEX,Mexico,VNM,Viet Nam,2008,0,8,-8
MEX,Mexico,VNM,Viet Nam,2009,0,8,-8
MEX,Mexico,VNM,Viet Nam,2010,0,4,-4
MEX,Mexico,VNM,Viet Nam,2011,0,5,-5
MEX,Mexico,VNM,Viet Nam,2012,0,1,-1
MEX,Mexico,VNM,Viet Nam,2013,0,20,-20
MEX,Mexico,VNM,Viet Nam,2014,0,7,-7
MEX,Mexico,VNM,Viet Nam,2015,0,5,-5
MEX,Mexico,VNM,Viet Nam,2016,0,9,-9
MEX,Mexico,VNM,Viet Nam,2017,0,12,-12
NLD,Netherlands,VNM,Viet Nam,2008,237,331,-94
NLD,Netherlands,VNM,Viet Nam,2009,188,352,-164
NLD,Netherlands,VNM,Viet Nam,2010,267,361,-94
NLD,Netherlands,VNM,Viet Nam,2011,225,442,-217
NLD,Netherlands,VNM,Viet Nam,2012,221,359,-138
NLD,Netherlands,VNM,Viet Nam,2013,269,368,-99
NLD,Netherlands,VNM,Viet Nam,2014,220,392,-172
NLD,Netherlands,VNM,Viet Nam,2015,209,473,-264
NLD,Netherlands,VNM,Viet Nam,2016,254,683,-429
NLD,Netherlands,VNM,Viet Nam,2017,336,870,-534
NZL,New Zealand,VNM,Viet Nam,2008,121,453,-332
NZL,New Zealand,VNM,Viet Nam,2009,109,505,-396
NZL,New Zealand,VNM,Viet Nam,2010,142,607,-465
NZL,New Zealand,VNM,Viet Nam,2011,183,519,-336
NZL,New Zealand,VNM,Viet Nam,2012,196,548,-352
NZL,New Zealand,VNM,Viet Nam,2013,192,543,-351
NZL,New Zealand,VNM,Viet Nam,2014,226,607,-381
NZL,New Zealand,VNM,Viet Nam,2015,196,729,-533
NZL,New Zealand,VNM,Viet Nam,2016,164,889,-725
NZL,New Zealand,VNM,Viet Nam,2017,202,1106,-904
NOR,Norway,VNM,Viet Nam,2008,90,319,-229
NOR,Norway,VNM,Viet Nam,2009,99,203,-104
NOR,Norway,VNM,Viet Nam,2010,115,277,-162
NOR,Norway,VNM,Viet Nam,2011,126,322,-196
NOR,Norway,VNM,Viet Nam,2012,134,357,-223
NOR,Norway,VNM,Viet Nam,2013,156,342,-186
NOR,Norway,VNM,Viet Nam,2014,125,284,-159
NOR,Norway,VNM,Viet Nam,2015,121,241,-120
NOR,Norway,VNM,Viet Nam,2016,148,352,-204
NOR,Norway,VNM,Viet Nam,2017,87,356,-269
POL,Poland,VNM,Viet Nam,2008,0,2788,-2788
POL,Poland,VNM,Viet Nam,2009,0,2981,-2981
POL,Poland,VNM,Viet Nam,2010,0,2402,-2402
POL,Poland,VNM,Viet Nam,2011,0,2113,-2113
POL,Poland,VNM,Viet Nam,2012,0,4031,-4031
POL,Poland,VNM,Viet Nam,2013,0,2788,-2788
POL,Poland,VNM,Viet Nam,2014,0,1968,-1968
POL,Poland,VNM,Viet Nam,2015,0,3297,-3297
POL,Poland,VNM,Viet Nam,2016,0,3226,-3226
POL,Poland,VNM,Viet Nam,2017,0,3980,-3980
SVK,Slovak Republic,VNM,Viet Nam,2008,3,32,-29
SVK,Slovak Republic,VNM,Viet Nam,2009,343,28,315
SVK,Slovak Republic,VNM,Viet Nam,2010,181,39,142
SVK,Slovak Republic,VNM,Viet Nam,2011,66,63,3
SVK,Slovak Republic,VNM,Viet Nam,2012,0,55,-55
SVK,Slovak Republic,VNM,Viet Nam,2013,1,86,-85
SVK,Slovak Republic,VNM,Viet Nam,2014,1,35,-34
SVK,Slovak Republic,VNM,Viet Nam,2015,0,25,-25
SVK,Slovak Republic,VNM,Viet Nam,2016,0,18,-18
SVK,Slovak Republic,VNM,Viet Nam,2017,0,21,-21
ESP,Spain,VNM,Viet Nam,2008,28,76,-48
ESP,Spain,VNM,Viet Nam,2009,37,88,-51
ESP,Spain,VNM,Viet Nam,2010,33,163,-130
ESP,Spain,VNM,Viet Nam,2011,57,136,-79
ESP,Spain,VNM,Viet Nam,2012,35,132,-97
ESP,Spain,VNM,Viet Nam,2013,74,128,-54
ESP,Spain,VNM,Viet Nam,2014,33,184,-151
ESP,Spain,VNM,Viet Nam,2015,42,213,-171
ESP,Spain,VNM,Viet Nam,2016,48,308,-260
ESP,Spain,VNM,Viet Nam,2017,78,441,-363
SWE,Sweden,VNM,Viet Nam,2008,44,442,-398
SWE,Sweden,VNM,Viet Nam,2009,29,539,-510
SWE,Sweden,VNM,Viet Nam,2010,41,659,-618
SWE,Sweden,VNM,Viet Nam,2011,85,725,-640
SWE,Sweden,VNM,Viet Nam,2012,112,649,-537
SWE,Sweden,VNM,Viet Nam,2013,83,536,-453
SWE,Sweden,VNM,Viet Nam,2014,113,678,-565
SWE,Sweden,VNM,Viet Nam,2015,218,694,-476
SWE,Sweden,VNM,Viet Nam,2016,77,752,-675
SWE,Sweden,VNM,Viet Nam,2017,86,1075,-989
CHE,Switzerland,VNM,Viet Nam,2010,230,395,-165
CHE,Switzerland,VNM,Viet Nam,2011,234,337,-103
CHE,Switzerland,VNM,Viet Nam,2012,234,321,-87
CHE,Switzerland,VNM,Viet Nam,2013,222,360,-138
CHE,Switzerland,VNM,Viet Nam,2014,215,400,-185
CHE,Switzerland,VNM,Viet Nam,2015,207,399,-192
CHE,Switzerland,VNM,Viet Nam,2016,220,462,-242
CHE,Switzerland,VNM,Viet Nam,2017,246,398,-152
TUR,Turkey,VNM,Viet Nam,2010,0,7,-7
TUR,Turkey,VNM,Viet Nam,2016,161,280,-119
TUR,Turkey,VNM,Viet Nam,2017,386,238,148
GBR,United Kingdom,VNM,Viet Nam,2010,0,3000,-3000
GBR,United Kingdom,VNM,Viet Nam,2014,1000,3000,-2000
GBR,United Kingdom,VNM,Viet Nam,2015,0,1000,-1000
USA,United States,VNM,Viet Nam,2008,0,31497,-31497
USA,United States,VNM,Viet Nam,2009,0,29234,-29234
USA,United States,VNM,Viet Nam,2010,0,30632,-30632
USA,United States,VNM,Viet Nam,2011,0,34157,-34157
USA,United States,VNM,Viet Nam,2012,0,28304,-28304
USA,United States,VNM,Viet Nam,2013,0,27101,-27101
USA,United States,VNM,Viet Nam,2014,0,30283,-30283
USA,United States,VNM,Viet Nam,2015,0,30832,-30832
USA,United States,VNM,Viet Nam,2016,0,41451,-41451
USA,United States,VNM,Viet Nam,2017,0,38231,-38231
CHL,Chile,VNM,Viet Nam,2008,0,0,0
CHL,Chile,VNM,Viet Nam,2009,0,0,0
CHL,Chile,VNM,Viet Nam,2010,0,0,0
CHL,Chile,VNM,Viet Nam,2011,0,0,0
CHL,Chile,VNM,Viet Nam,2012,0,2,-2
CHL,Chile,VNM,Viet Nam,2013,0,3,-3
CHL,Chile,VNM,Viet Nam,2014,0,10,-10
CHL,Chile,VNM,Viet Nam,2015,0,2,-2
CHL,Chile,VNM,Viet Nam,2016,0,0,0
EST,Estonia,VNM,Viet Nam,2008,0,2,-2
EST,Estonia,VNM,Viet Nam,2009,0,0,0
EST,Estonia,VNM,Viet Nam,2010,0,3,-3
EST,Estonia,VNM,Viet Nam,2011,0,0,0
EST,Estonia,VNM,Viet Nam,2012,0,6,-6
EST,Estonia,VNM,Viet Nam,2013,0,1,-1
EST,Estonia,VNM,Viet Nam,2014,0,1,-1
EST,Estonia,VNM,Viet Nam,2015,0,5,-5
EST,Estonia,VNM,Viet Nam,2016,0,7,-7
EST,Estonia,VNM,Viet Nam,2017,0,10,-10
SVN,Slovenia,VNM,Viet Nam,2008,0,1,-1
SVN,Slovenia,VNM,Viet Nam,2010,0,1,-1
SVN,Slovenia,VNM,Viet Nam,2011,0,2,-2
SVN,Slovenia,VNM,Viet Nam,2013,0,3,-3
SVN,Slovenia,VNM,Viet Nam,2014,0,2,-2
SVN,Slovenia,VNM,Viet Nam,2015,1,4,-3
SVN,Slovenia,VNM,Viet Nam,2016,0,1,-1
SVN,Slovenia,VNM,Viet Nam,2017,1,4,-3
AUS,Australia,YEM,Yemen,2008,5,17,-12
AUS,Australia,YEM,Yemen,2009,0,11,-11
AUS,Australia,YEM,Yemen,2010,8,4,4
AUS,Australia,YEM,Yemen,2011,0,10,-10
AUS,Australia,YEM,Yemen,2012,0,15,-15
AUS,Australia,YEM,Yemen,2013,5,10,-5
AUS,Australia,YEM,Yemen,2014,0,8,-8
AUS,Australia,YEM,Yemen,2015,0,36,-36
AUS,Australia,YEM,Yemen,2016,0,50,-50
AUS,Australia,YEM,Yemen,2017,0,40,-40
AUT,Austria,YEM,Yemen,2008,3,10,-7
AUT,Austria,YEM,Yemen,2009,5,15,-10
AUT,Austria,YEM,Yemen,2010,8,24,-16
AUT,Austria,YEM,Yemen,2011,6,15,-9
AUT,Austria,YEM,Yemen,2012,11,7,4
AUT,Austria,YEM,Yemen,2013,6,15,-9
AUT,Austria,YEM,Yemen,2014,12,23,-11
AUT,Austria,YEM,Yemen,2015,16,122,-106
AUT,Austria,YEM,Yemen,2016,14,69,-55
AUT,Austria,YEM,Yemen,2017,27,45,-18
BEL,Belgium,YEM,Yemen,2008,0,2,-2
BEL,Belgium,YEM,Yemen,2009,0,1,-1
BEL,Belgium,YEM,Yemen,2010,2,14,-12
BEL,Belgium,YEM,Yemen,2012,1,14,-13
BEL,Belgium,YEM,Yemen,2013,3,20,-17
BEL,Belgium,YEM,Yemen,2014,13,18,-5
BEL,Belgium,YEM,Yemen,2015,3,44,-41
BEL,Belgium,YEM,Yemen,2016,5,29,-24
BEL,Belgium,YEM,Yemen,2017,2,16,-14
CAN,Canada,YEM,Yemen,2008,0,129,-129
CAN,Canada,YEM,Yemen,2009,0,128,-128
CAN,Canada,YEM,Yemen,2010,0,211,-211
CAN,Canada,YEM,Yemen,2011,0,159,-159
CAN,Canada,YEM,Yemen,2012,0,174,-174
CAN,Canada,YEM,Yemen,2013,0,217,-217
CAN,Canada,YEM,Yemen,2014,0,149,-149
CAN,Canada,YEM,Yemen,2015,0,206,-206
CAN,Canada,YEM,Yemen,2016,0,160,-160
CAN,Canada,YEM,Yemen,2017,0,250,-250
CZE,Czech Republic,YEM,Yemen,2008,0,17,-17
CZE,Czech Republic,YEM,Yemen,2009,0,10,-10
CZE,Czech Republic,YEM,Yemen,2010,0,4,-4
CZE,Czech Republic,YEM,Yemen,2011,0,7,-7
CZE,Czech Republic,YEM,Yemen,2012,7,11,-4
CZE,Czech Republic,YEM,Yemen,2013,18,18,0
CZE,Czech Republic,YEM,Yemen,2014,20,18,2
CZE,Czech Republic,YEM,Yemen,2015,14,19,-5
CZE,Czech Republic,YEM,Yemen,2016,10,22,-12
CZE,Czech Republic,YEM,Yemen,2017,5,16,-11
DNK,Denmark,YEM,Yemen,2008,2,1,1
DNK,Denmark,YEM,Yemen,2009,0,5,-5
DNK,Denmark,YEM,Yemen,2010,0,4,-4
DNK,Denmark,YEM,Yemen,2011,0,4,-4
DNK,Denmark,YEM,Yemen,2012,1,1,0
DNK,Denmark,YEM,Yemen,2013,1,4,-3
DNK,Denmark,YEM,Yemen,2014,0,1,-1
DNK,Denmark,YEM,Yemen,2015,1,5,-4
DNK,Denmark,YEM,Yemen,2016,2,3,-1
DNK,Denmark,YEM,Yemen,2017,5,3,2
FIN,Finland,YEM,Yemen,2008,0,1,-1
FIN,Finland,YEM,Yemen,2009,0,0,0
FIN,Finland,YEM,Yemen,2010,0,4,-4
FIN,Finland,YEM,Yemen,2011,0,5,-5
FIN,Finland,YEM,Yemen,2012,0,11,-11
FIN,Finland,YEM,Yemen,2013,1,3,-2
FIN,Finland,YEM,Yemen,2014,0,10,-10
FIN,Finland,YEM,Yemen,2015,1,6,-5
FIN,Finland,YEM,Yemen,2016,0,58,-58
FIN,Finland,YEM,Yemen,2017,1,67,-66
FRA,France,YEM,Yemen,2008,0,14,-14
FRA,France,YEM,Yemen,2009,0,28,-28
FRA,France,YEM,Yemen,2010,0,19,-19
FRA,France,YEM,Yemen,2011,0,37,-37
FRA,France,YEM,Yemen,2012,0,32,-32
FRA,France,YEM,Yemen,2013,0,50,-50
FRA,France,YEM,Yemen,2014,0,40,-40
FRA,France,YEM,Yemen,2015,0,52,-52
FRA,France,YEM,Yemen,2016,0,83,-83
FRA,France,YEM,Yemen,2017,0,103,-103
DEU,Germany,YEM,Yemen,2008,303,466,-163
DEU,Germany,YEM,Yemen,2009,345,488,-143
DEU,Germany,YEM,Yemen,2010,352,465,-113
DEU,Germany,YEM,Yemen,2011,242,352,-110
DEU,Germany,YEM,Yemen,2012,265,370,-105
DEU,Germany,YEM,Yemen,2013,270,514,-244
DEU,Germany,YEM,Yemen,2014,265,645,-380
DEU,Germany,YEM,Yemen,2015,242,1010,-768
DEU,Germany,YEM,Yemen,2016,347,981,-634
DEU,Germany,YEM,Yemen,2017,224,1158,-934
HUN,Hungary,YEM,Yemen,2008,0,8,-8
HUN,Hungary,YEM,Yemen,2009,2,19,-17
HUN,Hungary,YEM,Yemen,2010,3,15,-12
HUN,Hungary,YEM,Yemen,2011,1,9,-8
HUN,Hungary,YEM,Yemen,2012,3,26,-23
HUN,Hungary,YEM,Yemen,2013,5,15,-10
HUN,Hungary,YEM,Yemen,2014,2,35,-33
HUN,Hungary,YEM,Yemen,2015,10,63,-53
HUN,Hungary,YEM,Yemen,2016,12,42,-30
HUN,Hungary,YEM,Yemen,2017,0,56,-56
ISL,Iceland,YEM,Yemen,2008,2,3,-1
ISL,Iceland,YEM,Yemen,2009,1,1,0
ISL,Iceland,YEM,Yemen,2010,1,1,0
ISL,Iceland,YEM,Yemen,2011,0,0,0
ISL,Iceland,YEM,Yemen,2012,0,0,0
ISL,Iceland,YEM,Yemen,2013,0,0,0
ISL,Iceland,YEM,Yemen,2014,0,0,0
ISL,Iceland,YEM,Yemen,2015,0,0,0
ISL,Iceland,YEM,Yemen,2016,0,1,-1
ISL,Iceland,YEM,Yemen,2017,0,0,0
ITA,Italy,YEM,Yemen,2008,2,26,-24
ITA,Italy,YEM,Yemen,2009,2,26,-24
ITA,Italy,YEM,Yemen,2010,2,18,-16
ITA,Italy,YEM,Yemen,2011,0,16,-16
ITA,Italy,YEM,Yemen,2012,5,8,-3
ITA,Italy,YEM,Yemen,2013,0,21,-21
ITA,Italy,YEM,Yemen,2014,0,28,-28
ITA,Italy,YEM,Yemen,2015,0,23,-23
ITA,Italy,YEM,Yemen,2016,0,39,-39
ITA,Italy,YEM,Yemen,2017,0,48,-48
JPN,Japan,YEM,Yemen,2008,60,67,-7
JPN,Japan,YEM,Yemen,2009,65,76,-11
JPN,Japan,YEM,Yemen,2010,93,96,-3
JPN,Japan,YEM,Yemen,2011,15,20,-5
JPN,Japan,YEM,Yemen,2012,49,52,-3
JPN,Japan,YEM,Yemen,2013,85,97,-12
JPN,Japan,YEM,Yemen,2014,76,92,-16
JPN,Japan,YEM,Yemen,2015,13,26,-13
JPN,Japan,YEM,Yemen,2016,7,12,-5
JPN,Japan,YEM,Yemen,2017,21,29,-8
KOR,Korea,YEM,Yemen,2008,8,10,-2
KOR,Korea,YEM,Yemen,2009,13,16,-3
KOR,Korea,YEM,Yemen,2010,10,21,-11
KOR,Korea,YEM,Yemen,2011,14,28,-14
KOR,Korea,YEM,Yemen,2012,45,52,-7
KOR,Korea,YEM,Yemen,2013,37,86,-49
KOR,Korea,YEM,Yemen,2014,51,168,-117
KOR,Korea,YEM,Yemen,2015,61,96,-35
KOR,Korea,YEM,Yemen,2016,67,160,-93
KOR,Korea,YEM,Yemen,2017,97,187,-90
LUX,Luxembourg,YEM,Yemen,2008,0,0,0
LUX,Luxembourg,YEM,Yemen,2009,0,0,0
LUX,Luxembourg,YEM,Yemen,2010,0,0,0
LUX,Luxembourg,YEM,Yemen,2011,0,0,0
LUX,Luxembourg,YEM,Yemen,2012,0,0,0
LUX,Luxembourg,YEM,Yemen,2013,0,0,0
LUX,Luxembourg,YEM,Yemen,2014,0,0,0
LUX,Luxembourg,YEM,Yemen,2015,0,1,-1
LUX,Luxembourg,YEM,Yemen,2016,1,1,0
LUX,Luxembourg,YEM,Yemen,2017,0,2,-2
MEX,Mexico,YEM,Yemen,2011,0,1,-1
MEX,Mexico,YEM,Yemen,2012,0,0,0
MEX,Mexico,YEM,Yemen,2013,0,0,0
MEX,Mexico,YEM,Yemen,2014,0,0,0
MEX,Mexico,YEM,Yemen,2015,0,1,-1
MEX,Mexico,YEM,Yemen,2017,0,2,-2
NLD,Netherlands,YEM,Yemen,2008,13,16,-3
NLD,Netherlands,YEM,Yemen,2009,9,17,-8
NLD,Netherlands,YEM,Yemen,2010,7,18,-11
NLD,Netherlands,YEM,Yemen,2011,2,21,-19
NLD,Netherlands,YEM,Yemen,2012,9,23,-14
NLD,Netherlands,YEM,Yemen,2013,13,21,-8
NLD,Netherlands,YEM,Yemen,2014,6,53,-47
NLD,Netherlands,YEM,Yemen,2015,11,58,-47
NLD,Netherlands,YEM,Yemen,2016,7,74,-67
NLD,Netherlands,YEM,Yemen,2017,8,191,-183
NZL,New Zealand,YEM,Yemen,2008,1,11,-10
NZL,New Zealand,YEM,Yemen,2009,1,1,0
NZL,New Zealand,YEM,Yemen,2010,0,1,-1
NZL,New Zealand,YEM,Yemen,2011,0,2,-2
NZL,New Zealand,YEM,Yemen,2012,2,6,-4
NZL,New Zealand,YEM,Yemen,2013,0,7,-7
NZL,New Zealand,YEM,Yemen,2014,0,6,-6
NZL,New Zealand,YEM,Yemen,2015,1,12,-11
NZL,New Zealand,YEM,Yemen,2016,1,24,-23
NZL,New Zealand,YEM,Yemen,2017,0,6,-6
NOR,Norway,YEM,Yemen,2008,0,19,-19
NOR,Norway,YEM,Yemen,2009,1,40,-39
NOR,Norway,YEM,Yemen,2010,0,46,-46
NOR,Norway,YEM,Yemen,2011,3,41,-38
NOR,Norway,YEM,Yemen,2012,1,19,-18
NOR,Norway,YEM,Yemen,2013,6,16,-10
NOR,Norway,YEM,Yemen,2014,1,11,-10
NOR,Norway,YEM,Yemen,2015,2,55,-53
NOR,Norway,YEM,Yemen,2016,2,78,-76
NOR,Norway,YEM,Yemen,2017,7,79,-72
POL,Poland,YEM,Yemen,2008,0,36,-36
POL,Poland,YEM,Yemen,2009,0,35,-35
POL,Poland,YEM,Yemen,2010,0,37,-37
POL,Poland,YEM,Yemen,2011,0,36,-36
POL,Poland,YEM,Yemen,2012,0,40,-40
POL,Poland,YEM,Yemen,2013,0,36,-36
POL,Poland,YEM,Yemen,2014,0,18,-18
POL,Poland,YEM,Yemen,2015,0,56,-56
POL,Poland,YEM,Yemen,2016,0,71,-71
POL,Poland,YEM,Yemen,2017,0,87,-87
SVK,Slovak Republic,YEM,Yemen,2008,2,0,2
SVK,Slovak Republic,YEM,Yemen,2009,2,3,-1
SVK,Slovak Republic,YEM,Yemen,2010,2,2,0
SVK,Slovak Republic,YEM,Yemen,2011,0,1,-1
SVK,Slovak Republic,YEM,Yemen,2012,0,1,-1
SVK,Slovak Republic,YEM,Yemen,2015,0,1,-1
SVK,Slovak Republic,YEM,Yemen,2016,0,1,-1
ESP,Spain,YEM,Yemen,2008,4,9,-5
ESP,Spain,YEM,Yemen,2009,7,12,-5
ESP,Spain,YEM,Yemen,2010,8,7,1
ESP,Spain,YEM,Yemen,2011,12,13,-1
ESP,Spain,YEM,Yemen,2012,2,14,-12
ESP,Spain,YEM,Yemen,2013,13,27,-14
ESP,Spain,YEM,Yemen,2014,2,25,-23
ESP,Spain,YEM,Yemen,2015,2,36,-34
ESP,Spain,YEM,Yemen,2016,11,33,-22
ESP,Spain,YEM,Yemen,2017,15,56,-41
SWE,Sweden,YEM,Yemen,2008,0,25,-25
SWE,Sweden,YEM,Yemen,2009,1,106,-105
SWE,Sweden,YEM,Yemen,2010,0,92,-92
SWE,Sweden,YEM,Yemen,2011,6,213,-207
SWE,Sweden,YEM,Yemen,2012,4,194,-190
SWE,Sweden,YEM,Yemen,2013,18,208,-190
SWE,Sweden,YEM,Yemen,2014,4,121,-117
SWE,Sweden,YEM,Yemen,2015,13,184,-171
SWE,Sweden,YEM,Yemen,2016,8,414,-406
SWE,Sweden,YEM,Yemen,2017,7,348,-341
CHE,Switzerland,YEM,Yemen,2010,0,34,-34
CHE,Switzerland,YEM,Yemen,2011,4,34,-30
CHE,Switzerland,YEM,Yemen,2012,3,41,-38
CHE,Switzerland,YEM,Yemen,2013,15,30,-15
CHE,Switzerland,YEM,Yemen,2014,3,55,-52
CHE,Switzerland,YEM,Yemen,2015,4,53,-49
CHE,Switzerland,YEM,Yemen,2016,5,14,-9
CHE,Switzerland,YEM,Yemen,2017,5,27,-22
TUR,Turkey,YEM,Yemen,2010,0,46,-46
TUR,Turkey,YEM,Yemen,2016,438,1839,-1401
TUR,Turkey,YEM,Yemen,2017,528,3726,-3198
USA,United States,YEM,Yemen,2008,0,1872,-1872
USA,United States,YEM,Yemen,2009,0,3134,-3134
USA,United States,YEM,Yemen,2010,0,3591,-3591
USA,United States,YEM,Yemen,2011,0,3361,-3361
USA,United States,YEM,Yemen,2012,0,2620,-2620
USA,United States,YEM,Yemen,2013,0,3532,-3532
USA,United States,YEM,Yemen,2014,0,3492,-3492
USA,United States,YEM,Yemen,2015,0,3194,-3194
USA,United States,YEM,Yemen,2016,0,13040,-13040
USA,United States,YEM,Yemen,2017,0,6029,-6029
CHL,Chile,YEM,Yemen,2008,0,0,0
CHL,Chile,YEM,Yemen,2009,0,1,-1
CHL,Chile,YEM,Yemen,2010,0,0,0
CHL,Chile,YEM,Yemen,2011,0,0,0
CHL,Chile,YEM,Yemen,2012,0,0,0
CHL,Chile,YEM,Yemen,2013,0,0,0
CHL,Chile,YEM,Yemen,2014,0,1,-1
CHL,Chile,YEM,Yemen,2015,0,1,-1
CHL,Chile,YEM,Yemen,2016,0,0,0
EST,Estonia,YEM,Yemen,2008,0,0,0
EST,Estonia,YEM,Yemen,2009,0,0,0
EST,Estonia,YEM,Yemen,2010,0,0,0
EST,Estonia,YEM,Yemen,2011,0,0,0
EST,Estonia,YEM,Yemen,2012,0,0,0
EST,Estonia,YEM,Yemen,2013,0,0,0
EST,Estonia,YEM,Yemen,2014,0,0,0
EST,Estonia,YEM,Yemen,2015,0,2,-2
EST,Estonia,YEM,Yemen,2016,0,2,-2
EST,Estonia,YEM,Yemen,2017,0,6,-6
ISR,Israel,YEM,Yemen,2008,0,0,0
ISR,Israel,YEM,Yemen,2009,0,42,-42
ISR,Israel,YEM,Yemen,2010,0,13,-13
ISR,Israel,YEM,Yemen,2011,0,17,-17
ISR,Israel,YEM,Yemen,2012,0,25,-25
ISR,Israel,YEM,Yemen,2013,0,52,-52
ISR,Israel,YEM,Yemen,2014,0,7,-7
ISR,Israel,YEM,Yemen,2015,0,3,-3
ISR,Israel,YEM,Yemen,2016,0,16,-16
SVN,Slovenia,YEM,Yemen,2009,0,1,-1
SVN,Slovenia,YEM,Yemen,2015,0,2,-2
SVN,Slovenia,YEM,Yemen,2016,0,1,-1
SVN,Slovenia,YEM,Yemen,2017,0,2,-2
AUS,Australia,ZMB,Zambia,2008,29,104,-75
AUS,Australia,ZMB,Zambia,2009,39,86,-47
AUS,Australia,ZMB,Zambia,2010,40,131,-91
AUS,Australia,ZMB,Zambia,2011,40,184,-144
AUS,Australia,ZMB,Zambia,2012,36,181,-145
AUS,Australia,ZMB,Zambia,2013,45,210,-165
AUS,Australia,ZMB,Zambia,2014,47,163,-116
AUS,Australia,ZMB,Zambia,2015,100,177,-77
AUS,Australia,ZMB,Zambia,2016,0,102,-102
AUS,Australia,ZMB,Zambia,2017,0,124,-124
AUT,Austria,ZMB,Zambia,2008,2,11,-9
AUT,Austria,ZMB,Zambia,2009,5,9,-4
AUT,Austria,ZMB,Zambia,2010,2,7,-5
AUT,Austria,ZMB,Zambia,2011,4,4,0
AUT,Austria,ZMB,Zambia,2012,6,7,-1
AUT,Austria,ZMB,Zambia,2013,4,5,-1
AUT,Austria,ZMB,Zambia,2014,1,4,-3
AUT,Austria,ZMB,Zambia,2015,1,4,-3
AUT,Austria,ZMB,Zambia,2016,3,4,-1
AUT,Austria,ZMB,Zambia,2017,1,13,-12
BEL,Belgium,ZMB,Zambia,2008,0,25,-25
BEL,Belgium,ZMB,Zambia,2009,0,24,-24
BEL,Belgium,ZMB,Zambia,2010,10,11,-1
BEL,Belgium,ZMB,Zambia,2012,18,21,-3
BEL,Belgium,ZMB,Zambia,2013,23,7,16
BEL,Belgium,ZMB,Zambia,2014,7,13,-6
BEL,Belgium,ZMB,Zambia,2015,7,16,-9
BEL,Belgium,ZMB,Zambia,2016,4,11,-7
BEL,Belgium,ZMB,Zambia,2017,5,18,-13
CAN,Canada,ZMB,Zambia,2008,0,64,-64
CAN,Canada,ZMB,Zambia,2009,0,60,-60
CAN,Canada,ZMB,Zambia,2010,0,102,-102
CAN,Canada,ZMB,Zambia,2011,0,69,-69
CAN,Canada,ZMB,Zambia,2012,0,46,-46
CAN,Canada,ZMB,Zambia,2013,0,59,-59
CAN,Canada,ZMB,Zambia,2014,0,46,-46
CAN,Canada,ZMB,Zambia,2015,0,56,-56
CAN,Canada,ZMB,Zambia,2016,0,55,-55
CAN,Canada,ZMB,Zambia,2017,0,85,-85
CZE,Czech Republic,ZMB,Zambia,2008,0,3,-3
CZE,Czech Republic,ZMB,Zambia,2009,0,4,-4
CZE,Czech Republic,ZMB,Zambia,2010,0,6,-6
CZE,Czech Republic,ZMB,Zambia,2011,0,2,-2
CZE,Czech Republic,ZMB,Zambia,2012,2,5,-3
CZE,Czech Republic,ZMB,Zambia,2013,10,6,4
CZE,Czech Republic,ZMB,Zambia,2014,3,9,-6
CZE,Czech Republic,ZMB,Zambia,2015,4,7,-3
CZE,Czech Republic,ZMB,Zambia,2016,5,7,-2
CZE,Czech Republic,ZMB,Zambia,2017,2,5,-3
DNK,Denmark,ZMB,Zambia,2008,9,25,-16
DNK,Denmark,ZMB,Zambia,2009,2,25,-23
DNK,Denmark,ZMB,Zambia,2010,12,19,-7
DNK,Denmark,ZMB,Zambia,2011,10,22,-12
DNK,Denmark,ZMB,Zambia,2012,10,21,-11
DNK,Denmark,ZMB,Zambia,2013,10,25,-15
DNK,Denmark,ZMB,Zambia,2014,14,15,-1
DNK,Denmark,ZMB,Zambia,2015,8,17,-9
DNK,Denmark,ZMB,Zambia,2016,5,16,-11
DNK,Denmark,ZMB,Zambia,2017,12,15,-3
FIN,Finland,ZMB,Zambia,2008,5,19,-14
FIN,Finland,ZMB,Zambia,2009,0,10,-10
FIN,Finland,ZMB,Zambia,2010,0,10,-10
FIN,Finland,ZMB,Zambia,2011,8,13,-5
FIN,Finland,ZMB,Zambia,2012,0,7,-7
FIN,Finland,ZMB,Zambia,2013,4,13,-9
FIN,Finland,ZMB,Zambia,2014,2,5,-3
FIN,Finland,ZMB,Zambia,2015,4,10,-6
FIN,Finland,ZMB,Zambia,2016,6,12,-6
FIN,Finland,ZMB,Zambia,2017,2,10,-8
FRA,France,ZMB,Zambia,2008,0,5,-5
FRA,France,ZMB,Zambia,2009,0,13,-13
FRA,France,ZMB,Zambia,2010,0,4,-4
FRA,France,ZMB,Zambia,2011,0,5,-5
FRA,France,ZMB,Zambia,2012,0,2,-2
FRA,France,ZMB,Zambia,2013,0,6,-6
FRA,France,ZMB,Zambia,2014,0,5,-5
FRA,France,ZMB,Zambia,2015,0,4,-4
FRA,France,ZMB,Zambia,2016,0,5,-5
FRA,France,ZMB,Zambia,2017,0,8,-8
DEU,Germany,ZMB,Zambia,2008,60,54,6
DEU,Germany,ZMB,Zambia,2009,75,37,38
DEU,Germany,ZMB,Zambia,2010,38,37,1
DEU,Germany,ZMB,Zambia,2011,41,55,-14
DEU,Germany,ZMB,Zambia,2012,27,51,-24
DEU,Germany,ZMB,Zambia,2013,40,71,-31
DEU,Germany,ZMB,Zambia,2014,35,72,-37
DEU,Germany,ZMB,Zambia,2015,47,65,-18
DEU,Germany,ZMB,Zambia,2016,40,81,-41
DEU,Germany,ZMB,Zambia,2017,34,89,-55
HUN,Hungary,ZMB,Zambia,2008,0,1,-1
HUN,Hungary,ZMB,Zambia,2009,1,1,0
HUN,Hungary,ZMB,Zambia,2010,0,5,-5
HUN,Hungary,ZMB,Zambia,2011,0,5,-5
HUN,Hungary,ZMB,Zambia,2012,0,1,-1
HUN,Hungary,ZMB,Zambia,2013,1,5,-4
HUN,Hungary,ZMB,Zambia,2014,0,3,-3
HUN,Hungary,ZMB,Zambia,2015,0,2,-2
HUN,Hungary,ZMB,Zambia,2016,0,1,-1
HUN,Hungary,ZMB,Zambia,2017,0,7,-7
ISL,Iceland,ZMB,Zambia,2008,0,0,0
ISL,Iceland,ZMB,Zambia,2009,1,1,0
ISL,Iceland,ZMB,Zambia,2010,0,0,0
ISL,Iceland,ZMB,Zambia,2011,0,1,-1
ISL,Iceland,ZMB,Zambia,2012,0,1,-1
ISL,Iceland,ZMB,Zambia,2013,1,0,1
ISL,Iceland,ZMB,Zambia,2014,0,0,0
ISL,Iceland,ZMB,Zambia,2015,0,0,0
ISL,Iceland,ZMB,Zambia,2016,0,0,0
ISL,Iceland,ZMB,Zambia,2017,0,0,0
ITA,Italy,ZMB,Zambia,2008,2,25,-23
ITA,Italy,ZMB,Zambia,2009,2,18,-16
ITA,Italy,ZMB,Zambia,2010,0,17,-17
ITA,Italy,ZMB,Zambia,2011,4,23,-19
ITA,Italy,ZMB,Zambia,2012,0,12,-12
ITA,Italy,ZMB,Zambia,2013,7,15,-8
ITA,Italy,ZMB,Zambia,2014,1,21,-20
ITA,Italy,ZMB,Zambia,2015,3,12,-9
ITA,Italy,ZMB,Zambia,2016,0,19,-19
ITA,Italy,ZMB,Zambia,2017,1,11,-10
JPN,Japan,ZMB,Zambia,2008,74,79,-5
JPN,Japan,ZMB,Zambia,2009,115,123,-8
JPN,Japan,ZMB,Zambia,2010,129,162,-33
JPN,Japan,ZMB,Zambia,2011,156,158,-2
JPN,Japan,ZMB,Zambia,2012,230,254,-24
JPN,Japan,ZMB,Zambia,2013,231,235,-4
JPN,Japan,ZMB,Zambia,2014,180,194,-14
JPN,Japan,ZMB,Zambia,2015,179,193,-14
JPN,Japan,ZMB,Zambia,2016,169,200,-31
JPN,Japan,ZMB,Zambia,2017,199,242,-43
KOR,Korea,ZMB,Zambia,2008,2,7,-5
KOR,Korea,ZMB,Zambia,2009,7,7,0
KOR,Korea,ZMB,Zambia,2010,5,6,-1
KOR,Korea,ZMB,Zambia,2011,10,15,-5
KOR,Korea,ZMB,Zambia,2012,18,11,7
KOR,Korea,ZMB,Zambia,2013,14,10,4
KOR,Korea,ZMB,Zambia,2014,4,18,-14
KOR,Korea,ZMB,Zambia,2015,7,16,-9
KOR,Korea,ZMB,Zambia,2016,13,11,2
KOR,Korea,ZMB,Zambia,2017,13,19,-6
LUX,Luxembourg,ZMB,Zambia,2008,0,0,0
LUX,Luxembourg,ZMB,Zambia,2009,0,0,0
LUX,Luxembourg,ZMB,Zambia,2010,0,1,-1
LUX,Luxembourg,ZMB,Zambia,2011,0,0,0
LUX,Luxembourg,ZMB,Zambia,2012,0,0,0
LUX,Luxembourg,ZMB,Zambia,2013,0,0,0
LUX,Luxembourg,ZMB,Zambia,2014,0,0,0
LUX,Luxembourg,ZMB,Zambia,2015,0,0,0
LUX,Luxembourg,ZMB,Zambia,2016,0,0,0
LUX,Luxembourg,ZMB,Zambia,2017,0,2,-2
MEX,Mexico,ZMB,Zambia,2012,0,0,0
MEX,Mexico,ZMB,Zambia,2013,0,1,-1
MEX,Mexico,ZMB,Zambia,2014,0,1,-1
MEX,Mexico,ZMB,Zambia,2016,0,2,-2
NLD,Netherlands,ZMB,Zambia,2008,30,40,-10
NLD,Netherlands,ZMB,Zambia,2009,22,45,-23
NLD,Netherlands,ZMB,Zambia,2010,29,53,-24
NLD,Netherlands,ZMB,Zambia,2011,43,49,-6
NLD,Netherlands,ZMB,Zambia,2012,32,50,-18
NLD,Netherlands,ZMB,Zambia,2013,48,36,12
NLD,Netherlands,ZMB,Zambia,2014,34,37,-3
NLD,Netherlands,ZMB,Zambia,2015,39,36,3
NLD,Netherlands,ZMB,Zambia,2016,47,40,7
NLD,Netherlands,ZMB,Zambia,2017,35,30,5
NZL,New Zealand,ZMB,Zambia,2008,18,41,-23
NZL,New Zealand,ZMB,Zambia,2009,3,29,-26
NZL,New Zealand,ZMB,Zambia,2010,30,28,2
NZL,New Zealand,ZMB,Zambia,2011,25,7,18
NZL,New Zealand,ZMB,Zambia,2012,17,36,-19
NZL,New Zealand,ZMB,Zambia,2013,9,4,5
NZL,New Zealand,ZMB,Zambia,2014,5,14,-9
NZL,New Zealand,ZMB,Zambia,2015,2,7,-5
NZL,New Zealand,ZMB,Zambia,2016,2,19,-17
NZL,New Zealand,ZMB,Zambia,2017,5,9,-4
NOR,Norway,ZMB,Zambia,2008,17,37,-20
NOR,Norway,ZMB,Zambia,2009,27,44,-17
NOR,Norway,ZMB,Zambia,2010,27,47,-20
NOR,Norway,ZMB,Zambia,2011,32,45,-13
NOR,Norway,ZMB,Zambia,2012,28,45,-17
NOR,Norway,ZMB,Zambia,2013,39,51,-12
NOR,Norway,ZMB,Zambia,2014,39,38,1
NOR,Norway,ZMB,Zambia,2015,38,42,-4
NOR,Norway,ZMB,Zambia,2016,45,22,23
NOR,Norway,ZMB,Zambia,2017,14,27,-13
POL,Poland,ZMB,Zambia,2009,0,12,-12
POL,Poland,ZMB,Zambia,2010,0,15,-15
POL,Poland,ZMB,Zambia,2011,0,12,-12
POL,Poland,ZMB,Zambia,2012,0,9,-9
POL,Poland,ZMB,Zambia,2013,0,6,-6
POL,Poland,ZMB,Zambia,2014,0,3,-3
POL,Poland,ZMB,Zambia,2015,0,2,-2
POL,Poland,ZMB,Zambia,2016,0,13,-13
POL,Poland,ZMB,Zambia,2017,0,8,-8
SVK,Slovak Republic,ZMB,Zambia,2008,0,1,-1
SVK,Slovak Republic,ZMB,Zambia,2009,0,4,-4
SVK,Slovak Republic,ZMB,Zambia,2010,0,1,-1
ESP,Spain,ZMB,Zambia,2008,4,7,-3
ESP,Spain,ZMB,Zambia,2009,0,9,-9
ESP,Spain,ZMB,Zambia,2010,1,3,-2
ESP,Spain,ZMB,Zambia,2011,1,3,-2
ESP,Spain,ZMB,Zambia,2012,0,1,-1
ESP,Spain,ZMB,Zambia,2013,2,7,-5
ESP,Spain,ZMB,Zambia,2014,0,5,-5
ESP,Spain,ZMB,Zambia,2015,1,4,-3
ESP,Spain,ZMB,Zambia,2016,3,8,-5
ESP,Spain,ZMB,Zambia,2017,3,13,-10
SWE,Sweden,ZMB,Zambia,2008,11,28,-17
SWE,Sweden,ZMB,Zambia,2009,4,21,-17
SWE,Sweden,ZMB,Zambia,2010,7,12,-5
SWE,Sweden,ZMB,Zambia,2011,5,22,-17
SWE,Sweden,ZMB,Zambia,2012,6,29,-23
SWE,Sweden,ZMB,Zambia,2013,5,24,-19
SWE,Sweden,ZMB,Zambia,2014,8,46,-38
SWE,Sweden,ZMB,Zambia,2015,15,21,-6
SWE,Sweden,ZMB,Zambia,2016,7,32,-25
SWE,Sweden,ZMB,Zambia,2017,25,47,-22
CHE,Switzerland,ZMB,Zambia,2010,4,9,-5
CHE,Switzerland,ZMB,Zambia,2011,1,8,-7
CHE,Switzerland,ZMB,Zambia,2012,5,7,-2
CHE,Switzerland,ZMB,Zambia,2013,6,14,-8
CHE,Switzerland,ZMB,Zambia,2014,6,15,-9
CHE,Switzerland,ZMB,Zambia,2015,5,5,0
CHE,Switzerland,ZMB,Zambia,2016,2,12,-10
CHE,Switzerland,ZMB,Zambia,2017,9,16,-7
USA,United States,ZMB,Zambia,2008,0,613,-613
USA,United States,ZMB,Zambia,2009,0,704,-704
USA,United States,ZMB,Zambia,2010,0,628,-628
USA,United States,ZMB,Zambia,2011,0,652,-652
USA,United States,ZMB,Zambia,2012,0,643,-643
USA,United States,ZMB,Zambia,2013,0,505,-505
USA,United States,ZMB,Zambia,2014,0,441,-441
USA,United States,ZMB,Zambia,2015,0,460,-460
USA,United States,ZMB,Zambia,2016,0,487,-487
USA,United States,ZMB,Zambia,2017,0,537,-537
CHL,Chile,ZMB,Zambia,2008,0,0,0
CHL,Chile,ZMB,Zambia,2009,0,0,0
CHL,Chile,ZMB,Zambia,2010,0,0,0
CHL,Chile,ZMB,Zambia,2011,0,1,-1
CHL,Chile,ZMB,Zambia,2012,0,0,0
CHL,Chile,ZMB,Zambia,2013,0,0,0
CHL,Chile,ZMB,Zambia,2014,0,1,-1
CHL,Chile,ZMB,Zambia,2015,0,0,0
CHL,Chile,ZMB,Zambia,2016,0,0,0
EST,Estonia,ZMB,Zambia,2008,0,0,0
EST,Estonia,ZMB,Zambia,2009,0,0,0
EST,Estonia,ZMB,Zambia,2010,0,0,0
EST,Estonia,ZMB,Zambia,2011,0,0,0
EST,Estonia,ZMB,Zambia,2012,0,0,0
EST,Estonia,ZMB,Zambia,2013,0,1,-1
EST,Estonia,ZMB,Zambia,2014,0,0,0
EST,Estonia,ZMB,Zambia,2015,0,0,0
EST,Estonia,ZMB,Zambia,2016,0,0,0
EST,Estonia,ZMB,Zambia,2017,0,0,0
SVN,Slovenia,ZMB,Zambia,2015,0,1,-1
SVN,Slovenia,ZMB,Zambia,2017,0,1,-1
AUS,Australia,ZWE,Zimbabwe,2008,170,1429,-1259
AUS,Australia,ZWE,Zimbabwe,2009,157,1628,-1471
AUS,Australia,ZWE,Zimbabwe,2010,185,1763,-1578
AUS,Australia,ZWE,Zimbabwe,2011,206,1418,-1212
AUS,Australia,ZWE,Zimbabwe,2012,151,1060,-909
AUS,Australia,ZWE,Zimbabwe,2013,214,1059,-845
AUS,Australia,ZWE,Zimbabwe,2014,158,831,-673
AUS,Australia,ZWE,Zimbabwe,2015,300,806,-506
AUS,Australia,ZWE,Zimbabwe,2016,200,767,-567
AUS,Australia,ZWE,Zimbabwe,2017,0,850,-850
AUT,Austria,ZWE,Zimbabwe,2008,11,22,-11
AUT,Austria,ZWE,Zimbabwe,2009,13,29,-16
AUT,Austria,ZWE,Zimbabwe,2010,19,43,-24
AUT,Austria,ZWE,Zimbabwe,2011,20,28,-8
AUT,Austria,ZWE,Zimbabwe,2012,14,25,-11
AUT,Austria,ZWE,Zimbabwe,2013,21,21,0
AUT,Austria,ZWE,Zimbabwe,2014,15,22,-7
AUT,Austria,ZWE,Zimbabwe,2015,19,14,5
AUT,Austria,ZWE,Zimbabwe,2016,11,22,-11
AUT,Austria,ZWE,Zimbabwe,2017,14,25,-11
BEL,Belgium,ZWE,Zimbabwe,2008,0,26,-26
BEL,Belgium,ZWE,Zimbabwe,2009,0,40,-40
BEL,Belgium,ZWE,Zimbabwe,2010,0,40,-40
BEL,Belgium,ZWE,Zimbabwe,2012,29,26,3
BEL,Belgium,ZWE,Zimbabwe,2013,14,29,-15
BEL,Belgium,ZWE,Zimbabwe,2014,21,18,3
BEL,Belgium,ZWE,Zimbabwe,2015,10,22,-12
BEL,Belgium,ZWE,Zimbabwe,2016,10,22,-12
BEL,Belgium,ZWE,Zimbabwe,2017,15,25,-10
CAN,Canada,ZWE,Zimbabwe,2008,0,611,-611
CAN,Canada,ZWE,Zimbabwe,2009,0,508,-508
CAN,Canada,ZWE,Zimbabwe,2010,0,494,-494
CAN,Canada,ZWE,Zimbabwe,2011,0,434,-434
CAN,Canada,ZWE,Zimbabwe,2012,0,437,-437
CAN,Canada,ZWE,Zimbabwe,2013,0,408,-408
CAN,Canada,ZWE,Zimbabwe,2014,0,332,-332
CAN,Canada,ZWE,Zimbabwe,2015,0,238,-238
CAN,Canada,ZWE,Zimbabwe,2016,0,285,-285
CAN,Canada,ZWE,Zimbabwe,2017,0,420,-420
CZE,Czech Republic,ZWE,Zimbabwe,2008,0,5,-5
CZE,Czech Republic,ZWE,Zimbabwe,2009,0,5,-5
CZE,Czech Republic,ZWE,Zimbabwe,2010,0,2,-2
CZE,Czech Republic,ZWE,Zimbabwe,2011,0,2,-2
CZE,Czech Republic,ZWE,Zimbabwe,2012,0,5,-5
CZE,Czech Republic,ZWE,Zimbabwe,2013,2,6,-4
CZE,Czech Republic,ZWE,Zimbabwe,2014,4,8,-4
CZE,Czech Republic,ZWE,Zimbabwe,2015,3,6,-3
CZE,Czech Republic,ZWE,Zimbabwe,2016,1,6,-5
CZE,Czech Republic,ZWE,Zimbabwe,2017,1,11,-10
DNK,Denmark,ZWE,Zimbabwe,2008,5,10,-5
DNK,Denmark,ZWE,Zimbabwe,2009,5,17,-12
DNK,Denmark,ZWE,Zimbabwe,2010,5,12,-7
DNK,Denmark,ZWE,Zimbabwe,2011,2,15,-13
DNK,Denmark,ZWE,Zimbabwe,2012,8,5,3
DNK,Denmark,ZWE,Zimbabwe,2013,10,9,1
DNK,Denmark,ZWE,Zimbabwe,2014,7,9,-2
DNK,Denmark,ZWE,Zimbabwe,2015,7,5,2
DNK,Denmark,ZWE,Zimbabwe,2016,9,8,1
DNK,Denmark,ZWE,Zimbabwe,2017,6,19,-13
FIN,Finland,ZWE,Zimbabwe,2008,0,4,-4
FIN,Finland,ZWE,Zimbabwe,2009,0,4,-4
FIN,Finland,ZWE,Zimbabwe,2010,0,5,-5
FIN,Finland,ZWE,Zimbabwe,2011,0,2,-2
FIN,Finland,ZWE,Zimbabwe,2012,1,3,-2
FIN,Finland,ZWE,Zimbabwe,2013,0,10,-10
FIN,Finland,ZWE,Zimbabwe,2014,0,7,-7
FIN,Finland,ZWE,Zimbabwe,2015,1,5,-4
FIN,Finland,ZWE,Zimbabwe,2016,1,10,-9
FIN,Finland,ZWE,Zimbabwe,2017,5,4,1
FRA,France,ZWE,Zimbabwe,2008,0,19,-19
FRA,France,ZWE,Zimbabwe,2009,0,18,-18
FRA,France,ZWE,Zimbabwe,2010,0,20,-20
FRA,France,ZWE,Zimbabwe,2011,0,11,-11
FRA,France,ZWE,Zimbabwe,2012,0,16,-16
FRA,France,ZWE,Zimbabwe,2013,0,13,-13
FRA,France,ZWE,Zimbabwe,2014,0,16,-16
FRA,France,ZWE,Zimbabwe,2015,0,17,-17
FRA,France,ZWE,Zimbabwe,2016,0,23,-23
FRA,France,ZWE,Zimbabwe,2017,0,16,-16
DEU,Germany,ZWE,Zimbabwe,2008,92,166,-74
DEU,Germany,ZWE,Zimbabwe,2009,148,277,-129
DEU,Germany,ZWE,Zimbabwe,2010,132,181,-49
DEU,Germany,ZWE,Zimbabwe,2011,91,177,-86
DEU,Germany,ZWE,Zimbabwe,2012,129,170,-41
DEU,Germany,ZWE,Zimbabwe,2013,106,163,-57
DEU,Germany,ZWE,Zimbabwe,2014,112,166,-54
DEU,Germany,ZWE,Zimbabwe,2015,110,204,-94
DEU,Germany,ZWE,Zimbabwe,2016,85,443,-358
DEU,Germany,ZWE,Zimbabwe,2017,109,580,-471
HUN,Hungary,ZWE,Zimbabwe,2008,0,1,-1
HUN,Hungary,ZWE,Zimbabwe,2009,0,6,-6
HUN,Hungary,ZWE,Zimbabwe,2010,1,1,0
HUN,Hungary,ZWE,Zimbabwe,2011,1,4,-3
HUN,Hungary,ZWE,Zimbabwe,2012,0,1,-1
HUN,Hungary,ZWE,Zimbabwe,2013,1,1,0
HUN,Hungary,ZWE,Zimbabwe,2014,1,2,-1
HUN,Hungary,ZWE,Zimbabwe,2015,0,6,-6
HUN,Hungary,ZWE,Zimbabwe,2016,1,16,-15
HUN,Hungary,ZWE,Zimbabwe,2017,0,25,-25
ISL,Iceland,ZWE,Zimbabwe,2008,1,0,1
ISL,Iceland,ZWE,Zimbabwe,2009,0,0,0
ISL,Iceland,ZWE,Zimbabwe,2010,0,0,0
ISL,Iceland,ZWE,Zimbabwe,2011,0,0,0
ISL,Iceland,ZWE,Zimbabwe,2012,0,0,0
ISL,Iceland,ZWE,Zimbabwe,2013,0,0,0
ISL,Iceland,ZWE,Zimbabwe,2014,0,1,-1
ISL,Iceland,ZWE,Zimbabwe,2015,0,1,-1
ISL,Iceland,ZWE,Zimbabwe,2016,0,0,0
ISL,Iceland,ZWE,Zimbabwe,2017,0,0,0
ITA,Italy,ZWE,Zimbabwe,2008,3,30,-27
ITA,Italy,ZWE,Zimbabwe,2009,3,17,-14
ITA,Italy,ZWE,Zimbabwe,2010,0,32,-32
ITA,Italy,ZWE,Zimbabwe,2011,1,11,-10
ITA,Italy,ZWE,Zimbabwe,2012,0,17,-17
ITA,Italy,ZWE,Zimbabwe,2013,1,11,-10
ITA,Italy,ZWE,Zimbabwe,2014,0,14,-14
ITA,Italy,ZWE,Zimbabwe,2015,1,11,-10
ITA,Italy,ZWE,Zimbabwe,2016,0,14,-14
ITA,Italy,ZWE,Zimbabwe,2017,0,20,-20
JPN,Japan,ZWE,Zimbabwe,2008,59,70,-11
JPN,Japan,ZWE,Zimbabwe,2009,71,74,-3
JPN,Japan,ZWE,Zimbabwe,2010,112,113,-1
JPN,Japan,ZWE,Zimbabwe,2011,82,89,-7
JPN,Japan,ZWE,Zimbabwe,2012,159,163,-4
JPN,Japan,ZWE,Zimbabwe,2013,193,205,-12
JPN,Japan,ZWE,Zimbabwe,2014,94,98,-4
JPN,Japan,ZWE,Zimbabwe,2015,176,196,-20
JPN,Japan,ZWE,Zimbabwe,2016,179,194,-15
JPN,Japan,ZWE,Zimbabwe,2017,104,139,-35
KOR,Korea,ZWE,Zimbabwe,2008,13,18,-5
KOR,Korea,ZWE,Zimbabwe,2009,9,9,0
KOR,Korea,ZWE,Zimbabwe,2010,9,15,-6
KOR,Korea,ZWE,Zimbabwe,2011,13,14,-1
KOR,Korea,ZWE,Zimbabwe,2012,15,18,-3
KOR,Korea,ZWE,Zimbabwe,2013,12,20,-8
KOR,Korea,ZWE,Zimbabwe,2014,25,20,5
KOR,Korea,ZWE,Zimbabwe,2015,17,40,-23
KOR,Korea,ZWE,Zimbabwe,2016,28,30,-2
KOR,Korea,ZWE,Zimbabwe,2017,30,37,-7
LUX,Luxembourg,ZWE,Zimbabwe,2008,0,2,-2
LUX,Luxembourg,ZWE,Zimbabwe,2009,2,0,2
LUX,Luxembourg,ZWE,Zimbabwe,2010,0,4,-4
LUX,Luxembourg,ZWE,Zimbabwe,2011,0,1,-1
LUX,Luxembourg,ZWE,Zimbabwe,2012,1,0,1
LUX,Luxembourg,ZWE,Zimbabwe,2013,0,1,-1
LUX,Luxembourg,ZWE,Zimbabwe,2014,1,5,-4
LUX,Luxembourg,ZWE,Zimbabwe,2015,0,4,-4
LUX,Luxembourg,ZWE,Zimbabwe,2016,0,2,-2
LUX,Luxembourg,ZWE,Zimbabwe,2017,2,1,1
MEX,Mexico,ZWE,Zimbabwe,2011,0,2,-2
MEX,Mexico,ZWE,Zimbabwe,2012,0,0,0
MEX,Mexico,ZWE,Zimbabwe,2013,0,6,-6
MEX,Mexico,ZWE,Zimbabwe,2014,0,5,-5
MEX,Mexico,ZWE,Zimbabwe,2016,0,1,-1
MEX,Mexico,ZWE,Zimbabwe,2017,0,1,-1
NLD,Netherlands,ZWE,Zimbabwe,2008,41,111,-70
NLD,Netherlands,ZWE,Zimbabwe,2009,40,115,-75
NLD,Netherlands,ZWE,Zimbabwe,2010,80,100,-20
NLD,Netherlands,ZWE,Zimbabwe,2011,76,77,-1
NLD,Netherlands,ZWE,Zimbabwe,2012,67,70,-3
NLD,Netherlands,ZWE,Zimbabwe,2013,95,65,30
NLD,Netherlands,ZWE,Zimbabwe,2014,77,60,17
NLD,Netherlands,ZWE,Zimbabwe,2015,60,67,-7
NLD,Netherlands,ZWE,Zimbabwe,2016,60,76,-16
NLD,Netherlands,ZWE,Zimbabwe,2017,45,102,-57
NZL,New Zealand,ZWE,Zimbabwe,2008,39,377,-338
NZL,New Zealand,ZWE,Zimbabwe,2009,34,245,-211
NZL,New Zealand,ZWE,Zimbabwe,2010,40,124,-84
NZL,New Zealand,ZWE,Zimbabwe,2011,77,101,-24
NZL,New Zealand,ZWE,Zimbabwe,2012,39,91,-52
NZL,New Zealand,ZWE,Zimbabwe,2013,28,55,-27
NZL,New Zealand,ZWE,Zimbabwe,2014,28,84,-56
NZL,New Zealand,ZWE,Zimbabwe,2015,7,62,-55
NZL,New Zealand,ZWE,Zimbabwe,2016,8,100,-92
NZL,New Zealand,ZWE,Zimbabwe,2017,11,132,-121
NOR,Norway,ZWE,Zimbabwe,2008,12,13,-1
NOR,Norway,ZWE,Zimbabwe,2009,7,11,-4
NOR,Norway,ZWE,Zimbabwe,2010,7,22,-15
NOR,Norway,ZWE,Zimbabwe,2011,13,20,-7
NOR,Norway,ZWE,Zimbabwe,2012,13,20,-7
NOR,Norway,ZWE,Zimbabwe,2013,13,19,-6
NOR,Norway,ZWE,Zimbabwe,2014,7,13,-6
NOR,Norway,ZWE,Zimbabwe,2015,13,14,-1
NOR,Norway,ZWE,Zimbabwe,2016,13,18,-5
NOR,Norway,ZWE,Zimbabwe,2017,9,28,-19
POL,Poland,ZWE,Zimbabwe,2008,0,27,-27
POL,Poland,ZWE,Zimbabwe,2009,0,32,-32
POL,Poland,ZWE,Zimbabwe,2010,0,36,-36
POL,Poland,ZWE,Zimbabwe,2011,0,27,-27
POL,Poland,ZWE,Zimbabwe,2012,0,30,-30
POL,Poland,ZWE,Zimbabwe,2013,0,25,-25
POL,Poland,ZWE,Zimbabwe,2014,0,11,-11
POL,Poland,ZWE,Zimbabwe,2015,0,19,-19
POL,Poland,ZWE,Zimbabwe,2016,0,35,-35
POL,Poland,ZWE,Zimbabwe,2017,0,40,-40
SVK,Slovak Republic,ZWE,Zimbabwe,2008,0,1,-1
SVK,Slovak Republic,ZWE,Zimbabwe,2010,0,2,-2
SVK,Slovak Republic,ZWE,Zimbabwe,2015,0,1,-1
ESP,Spain,ZWE,Zimbabwe,2008,6,17,-11
ESP,Spain,ZWE,Zimbabwe,2009,5,15,-10
ESP,Spain,ZWE,Zimbabwe,2010,7,15,-8
ESP,Spain,ZWE,Zimbabwe,2011,6,11,-5
ESP,Spain,ZWE,Zimbabwe,2012,3,9,-6
ESP,Spain,ZWE,Zimbabwe,2013,2,10,-8
ESP,Spain,ZWE,Zimbabwe,2014,8,16,-8
ESP,Spain,ZWE,Zimbabwe,2015,3,12,-9
ESP,Spain,ZWE,Zimbabwe,2016,5,21,-16
ESP,Spain,ZWE,Zimbabwe,2017,6,24,-18
SWE,Sweden,ZWE,Zimbabwe,2008,1,28,-27
SWE,Sweden,ZWE,Zimbabwe,2009,7,20,-13
SWE,Sweden,ZWE,Zimbabwe,2010,6,23,-17
SWE,Sweden,ZWE,Zimbabwe,2011,3,30,-27
SWE,Sweden,ZWE,Zimbabwe,2012,7,26,-19
SWE,Sweden,ZWE,Zimbabwe,2013,3,15,-12
SWE,Sweden,ZWE,Zimbabwe,2014,7,39,-32
SWE,Sweden,ZWE,Zimbabwe,2015,10,25,-15
SWE,Sweden,ZWE,Zimbabwe,2016,5,53,-48
SWE,Sweden,ZWE,Zimbabwe,2017,13,34,-21
CHE,Switzerland,ZWE,Zimbabwe,2010,29,53,-24
CHE,Switzerland,ZWE,Zimbabwe,2011,31,48,-17
CHE,Switzerland,ZWE,Zimbabwe,2012,47,27,20
CHE,Switzerland,ZWE,Zimbabwe,2013,44,41,3
CHE,Switzerland,ZWE,Zimbabwe,2014,26,28,-2
CHE,Switzerland,ZWE,Zimbabwe,2015,33,35,-2
CHE,Switzerland,ZWE,Zimbabwe,2016,41,34,7
CHE,Switzerland,ZWE,Zimbabwe,2017,17,25,-8
TUR,Turkey,ZWE,Zimbabwe,2010,0,2,-2
GBR,United Kingdom,ZWE,Zimbabwe,2011,1000,1000,0
GBR,United Kingdom,ZWE,Zimbabwe,2012,0,2000,-2000
GBR,United Kingdom,ZWE,Zimbabwe,2015,0,1000,-1000
USA,United States,ZWE,Zimbabwe,2008,0,953,-953
USA,United States,ZWE,Zimbabwe,2009,0,983,-983
USA,United States,ZWE,Zimbabwe,2010,0,1274,-1274
USA,United States,ZWE,Zimbabwe,2011,0,1016,-1016
USA,United States,ZWE,Zimbabwe,2012,0,914,-914
USA,United States,ZWE,Zimbabwe,2013,0,924,-924
USA,United States,ZWE,Zimbabwe,2014,0,797,-797
USA,United States,ZWE,Zimbabwe,2015,0,779,-779
USA,United States,ZWE,Zimbabwe,2016,0,815,-815
USA,United States,ZWE,Zimbabwe,2017,0,810,-810
CHL,Chile,ZWE,Zimbabwe,2008,0,2,-2
CHL,Chile,ZWE,Zimbabwe,2009,0,0,0
CHL,Chile,ZWE,Zimbabwe,2010,0,0,0
CHL,Chile,ZWE,Zimbabwe,2011,0,0,0
CHL,Chile,ZWE,Zimbabwe,2012,0,0,0
CHL,Chile,ZWE,Zimbabwe,2013,0,0,0
CHL,Chile,ZWE,Zimbabwe,2014,0,1,-1
CHL,Chile,ZWE,Zimbabwe,2015,0,1,-1
CHL,Chile,ZWE,Zimbabwe,2016,0,0,0
EST,Estonia,ZWE,Zimbabwe,2008,0,0,0
EST,Estonia,ZWE,Zimbabwe,2009,0,0,0
EST,Estonia,ZWE,Zimbabwe,2010,0,0,0
EST,Estonia,ZWE,Zimbabwe,2011,0,0,0
EST,Estonia,ZWE,Zimbabwe,2012,0,0,0
EST,Estonia,ZWE,Zimbabwe,2013,0,0,0
EST,Estonia,ZWE,Zimbabwe,2014,0,0,0
EST,Estonia,ZWE,Zimbabwe,2015,0,0,0
EST,Estonia,ZWE,Zimbabwe,2016,0,4,-4
EST,Estonia,ZWE,Zimbabwe,2017,0,1,-1
SVN,Slovenia,ZWE,Zimbabwe,2010,0,1,-1
SVN,Slovenia,ZWE,Zimbabwe,2012,0,1,-1
SVN,Slovenia,TKM,Turkmenistan,2015,0,2,-2
SVN,Slovenia,TKM,Turkmenistan,2016,0,2,-2
LVA,Latvia,DZA,Algeria,2014,0,0,0
LVA,Latvia,DZA,Algeria,2015,0,0,0
LVA,Latvia,DZA,Algeria,2017,0,7,-7
LVA,Latvia,PRT,Portugal,2008,0,9,-9
LVA,Latvia,PRT,Portugal,2009,0,10,-10
LVA,Latvia,PRT,Portugal,2010,0,11,-11
LVA,Latvia,PRT,Portugal,2014,0,19,-19
LVA,Latvia,PRT,Portugal,2015,0,19,-19
LVA,Latvia,PRT,Portugal,2017,0,7,-7
LVA,Latvia,CAF,Central African Republic,2014,0,0,0
LVA,Latvia,CAF,Central African Republic,2015,0,0,0
LVA,Latvia,CAF,Central African Republic,2017,0,0,0
LVA,Latvia,LTU,Lithuania,2008,0,285,-285
LVA,Latvia,LTU,Lithuania,2009,0,212,-212
LVA,Latvia,LTU,Lithuania,2010,0,137,-137
LVA,Latvia,LTU,Lithuania,2013,0,163,-163
LVA,Latvia,LTU,Lithuania,2014,0,184,-184
LVA,Latvia,LTU,Lithuania,2015,0,184,-184
LVA,Latvia,LTU,Lithuania,2017,0,173,-173
LVA,Latvia,MDA,Moldova,2008,0,45,-45
LVA,Latvia,MDA,Moldova,2009,0,9,-9
LVA,Latvia,MDA,Moldova,2010,0,9,-9
LVA,Latvia,MDA,Moldova,2014,0,12,-12
LVA,Latvia,MDA,Moldova,2015,0,12,-12
LVA,Latvia,MDA,Moldova,2017,0,22,-22
LVA,Latvia,BGR,Bulgaria,2008,0,248,-248
LVA,Latvia,BGR,Bulgaria,2009,0,16,-16
LVA,Latvia,BGR,Bulgaria,2010,0,22,-22
LVA,Latvia,BGR,Bulgaria,2014,0,26,-26
LVA,Latvia,BGR,Bulgaria,2015,0,26,-26
LVA,Latvia,BGR,Bulgaria,2017,0,10,-10
LVA,Latvia,KGZ,Kyrgyzstan,2008,0,4,-4
LVA,Latvia,KGZ,Kyrgyzstan,2009,0,3,-3
LVA,Latvia,KGZ,Kyrgyzstan,2010,0,6,-6
LVA,Latvia,KGZ,Kyrgyzstan,2014,0,1,-1
LVA,Latvia,KGZ,Kyrgyzstan,2015,0,1,-1
LVA,Latvia,KGZ,Kyrgyzstan,2017,0,7,-7
LVA,Latvia,TLS,Timor-Leste,2014,0,0,0
LVA,Latvia,TLS,Timor-Leste,2015,0,0,0
LVA,Latvia,TLS,Timor-Leste,2017,0,0,0
LVA,Latvia,MNE,Montenegro,2014,0,0,0
LVA,Latvia,MNE,Montenegro,2015,0,0,0
LVA,Latvia,MNE,Montenegro,2017,0,1,-1
LVA,Latvia,LBN,Lebanon,2009,0,1,-1
LVA,Latvia,LBN,Lebanon,2010,0,3,-3
LVA,Latvia,LBN,Lebanon,2014,0,1,-1
LVA,Latvia,LBN,Lebanon,2015,0,1,-1
LVA,Latvia,LBN,Lebanon,2017,0,5,-5
LVA,Latvia,BRB,Barbados,2014,0,0,0
LVA,Latvia,BRB,Barbados,2015,0,0,0
LVA,Latvia,BRB,Barbados,2017,0,0,0
LVA,Latvia,PNG,Papua New Guinea,2014,0,0,0
LVA,Latvia,PNG,Papua New Guinea,2015,0,0,0
LVA,Latvia,PNG,Papua New Guinea,2017,0,0,0
LVA,Latvia,COD,Democratic Republic of the Congo,2014,0,0,0
LVA,Latvia,COD,Democratic Republic of the Congo,2015,0,0,0
LVA,Latvia,COD,Democratic Republic of the Congo,2017,0,3,-3
LVA,Latvia,COG,Congo,2014,0,0,0
LVA,Latvia,COG,Congo,2015,0,0,0
LVA,Latvia,COG,Congo,2017,0,0,0
LVA,Latvia,BOL,Bolivia,2014,0,0,0
LVA,Latvia,BOL,Bolivia,2015,0,0,0
LVA,Latvia,BOL,Bolivia,2017,0,0,0
LVA,Latvia,MOZ,Mozambique,2014,0,0,0
LVA,Latvia,MOZ,Mozambique,2015,0,0,0
LVA,Latvia,MOZ,Mozambique,2017,0,0,0
LVA,Latvia,EGY,Egypt,2014,0,7,-7
LVA,Latvia,EGY,Egypt,2015,0,7,-7
LVA,Latvia,EGY,Egypt,2017,0,20,-20
LVA,Latvia,URY,Uruguay,2014,0,1,-1
LVA,Latvia,URY,Uruguay,2015,0,1,-1
LVA,Latvia,URY,Uruguay,2017,0,0,0
LVA,Latvia,NGA,Nigeria,2014,0,5,-5
LVA,Latvia,NGA,Nigeria,2015,0,5,-5
LVA,Latvia,NGA,Nigeria,2017,0,7,-7
LVA,Latvia,BRN,Brunei Darussalam,2014,0,0,0
LVA,Latvia,BRN,Brunei Darussalam,2015,0,0,0
LVA,Latvia,BRN,Brunei Darussalam,2017,0,0,0
LVA,Latvia,THA,Thailand,2014,0,2,-2
LVA,Latvia,THA,Thailand,2015,0,2,-2
LVA,Latvia,THA,Thailand,2017,0,5,-5
LVA,Latvia,MDV,Maldives,2014,0,0,0
LVA,Latvia,MDV,Maldives,2015,0,0,0
LVA,Latvia,MDV,Maldives,2017,0,0,0
LVA,Latvia,BFA,Burkina Faso,2014,0,0,0
LVA,Latvia,BFA,Burkina Faso,2015,0,0,0
LVA,Latvia,BFA,Burkina Faso,2017,0,0,0
LVA,Latvia,PRY,Paraguay,2014,0,0,0
LVA,Latvia,PRY,Paraguay,2015,0,0,0
LVA,Latvia,PRY,Paraguay,2017,0,0,0
LVA,Latvia,FSM,Micronesia,2014,0,0,0
LVA,Latvia,FSM,Micronesia,2015,0,0,0
LVA,Latvia,FSM,Micronesia,2017,0,0,0
LVA,Latvia,BIH,Bosnia and Herzegovina,2014,0,1,-1
LVA,Latvia,BIH,Bosnia and Herzegovina,2015,0,1,-1
LVA,Latvia,BIH,Bosnia and Herzegovina,2017,0,2,-2
LVA,Latvia,MAR,Morocco,2014,0,0,0
LVA,Latvia,MAR,Morocco,2015,0,0,0
LVA,Latvia,MAR,Morocco,2017,0,4,-4
LVA,Latvia,PRI,Puerto Rico,2014,0,0,0
LVA,Latvia,PRI,Puerto Rico,2017,0,0,0
LVA,Latvia,NIU,Niue,2014,0,0,0
LVA,Latvia,NIU,Niue,2017,0,0,0
LVA,Latvia,BTN,Bhutan,2014,0,0,0
LVA,Latvia,BTN,Bhutan,2015,0,0,0
LVA,Latvia,BTN,Bhutan,2017,0,0,0
LVA,Latvia,MAC,Macau,2014,0,0,0
LVA,Latvia,MAC,Macau,2017,0,0,0
LVA,Latvia,COK,Cook Islands,2014,0,0,0
LVA,Latvia,COK,Cook Islands,2017,0,0,0
LVA,Latvia,PLW,Palau,2014,0,0,0
LVA,Latvia,PLW,Palau,2015,0,0,0
LVA,Latvia,PLW,Palau,2017,0,0,0
LVA,Latvia,MLI,Mali,2014,0,0,0
LVA,Latvia,MLI,Mali,2015,0,0,0
LVA,Latvia,MLI,Mali,2017,0,0,0
LVA,Latvia,TCD,Chad,2014,0,0,0
LVA,Latvia,TCD,Chad,2015,0,0,0
LVA,Latvia,TCD,Chad,2017,0,0,0
LVA,Latvia,RWA,Rwanda,2014,0,0,0
LVA,Latvia,RWA,Rwanda,2015,0,0,0
LVA,Latvia,RWA,Rwanda,2017,0,0,0
LVA,Latvia,COM,Comoros,2014,0,0,0
LVA,Latvia,COM,Comoros,2015,0,0,0
LVA,Latvia,COM,Comoros,2017,0,0,0
LVA,Latvia,MYS,Malaysia,2014,0,1,-1
LVA,Latvia,MYS,Malaysia,2015,0,1,-1
LVA,Latvia,MYS,Malaysia,2017,0,1,-1
LVA,Latvia,SLB,Solomon Islands,2014,0,0,0
LVA,Latvia,SLB,Solomon Islands,2015,0,0,0
LVA,Latvia,SLB,Solomon Islands,2017,0,0,0
LVA,Latvia,CPV,Cape Verde,2014,0,0,0
LVA,Latvia,CPV,Cape Verde,2015,0,0,0
LVA,Latvia,CPV,Cape Verde,2017,0,0,0
LVA,Latvia,VEN,Venezuela,2014,0,0,0
LVA,Latvia,VEN,Venezuela,2015,0,0,0
LVA,Latvia,VEN,Venezuela,2017,0,2,-2
LVA,Latvia,SYR,Syria,2008,0,1,-1
LVA,Latvia,SYR,Syria,2009,0,2,-2
LVA,Latvia,SYR,Syria,2010,0,0,0
LVA,Latvia,SYR,Syria,2014,0,2,-2
LVA,Latvia,SYR,Syria,2015,0,2,-2
LVA,Latvia,SYR,Syria,2017,0,4,-4
LVA,Latvia,BHS,Bahamas,2014,0,0,0
LVA,Latvia,BHS,Bahamas,2015,0,0,0
LVA,Latvia,BHS,Bahamas,2017,0,0,0
LVA,Latvia,GUY,Guyana,2014,0,0,0
LVA,Latvia,GUY,Guyana,2015,0,0,0
LVA,Latvia,GUY,Guyana,2017,0,0,0
LVA,Latvia,MDG,Madagascar,2014,0,0,0
LVA,Latvia,MDG,Madagascar,2015,0,0,0
LVA,Latvia,MDG,Madagascar,2017,0,0,0
LVA,Latvia,VUT,Vanuatu,2014,0,0,0
LVA,Latvia,VUT,Vanuatu,2015,0,0,0
LVA,Latvia,VUT,Vanuatu,2017,0,0,0
LVA,Latvia,JOR,Jordan,2014,0,1,-1
LVA,Latvia,JOR,Jordan,2015,0,1,-1
LVA,Latvia,JOR,Jordan,2017,0,0,0
LVA,Latvia,YEM,Yemen,2014,0,0,0
LVA,Latvia,YEM,Yemen,2015,0,0,0
LVA,Latvia,YEM,Yemen,2017,0,0,0
LVA,Latvia,IRQ,Iraq,2014,0,0,0
LVA,Latvia,IRQ,Iraq,2015,0,0,0
LVA,Latvia,IRQ,Iraq,2017,0,1,-1
LVA,Latvia,BMU,Bermuda,2014,0,0,0
LVA,Latvia,BMU,Bermuda,2015,0,0,0
LVA,Latvia,BMU,Bermuda,2017,0,0,0
LVA,Latvia,JAM,Jamaica,2014,0,0,0
LVA,Latvia,JAM,Jamaica,2015,0,0,0
LVA,Latvia,JAM,Jamaica,2017,0,0,0
LVA,Latvia,UGA,Uganda,2014,0,0,0
LVA,Latvia,UGA,Uganda,2015,0,0,0
LVA,Latvia,UGA,Uganda,2017,0,0,0
LVA,Latvia,AZE,Azerbaijan,2008,0,2,-2
LVA,Latvia,AZE,Azerbaijan,2009,0,11,-11
LVA,Latvia,AZE,Azerbaijan,2010,0,3,-3
LVA,Latvia,AZE,Azerbaijan,2014,0,24,-24
LVA,Latvia,AZE,Azerbaijan,2015,0,24,-24
LVA,Latvia,AZE,Azerbaijan,2017,0,99,-99
LVA,Latvia,MKD,North Macedonia,2014,0,2,-2
LVA,Latvia,MKD,North Macedonia,2015,0,2,-2
LVA,Latvia,MKD,North Macedonia,2017,0,2,-2
LVA,Latvia,ARG,Argentina,2014,0,0,0
LVA,Latvia,ARG,Argentina,2015,0,0,0
LVA,Latvia,ARG,Argentina,2017,0,3,-3
LVA,Latvia,TTO,Trinidad and Tobago,2014,0,0,0
LVA,Latvia,TTO,Trinidad and Tobago,2015,0,0,0
LVA,Latvia,TTO,Trinidad and Tobago,2017,0,0,0
LVA,Latvia,BLZ,Belize,2014,0,0,0
LVA,Latvia,BLZ,Belize,2015,0,0,0
LVA,Latvia,BLZ,Belize,2017,0,0,0
LVA,Latvia,VNM,Viet Nam,2008,0,2,-2
LVA,Latvia,VNM,Viet Nam,2009,0,7,-7
LVA,Latvia,VNM,Viet Nam,2010,0,0,0
LVA,Latvia,VNM,Viet Nam,2014,0,3,-3
LVA,Latvia,VNM,Viet Nam,2015,0,3,-3
LVA,Latvia,VNM,Viet Nam,2017,0,8,-8
LVA,Latvia,BHR,Bahrain,2014,0,0,0
LVA,Latvia,BHR,Bahrain,2015,0,0,0
LVA,Latvia,BHR,Bahrain,2017,0,0,0
LVA,Latvia,KWT,Kuwait,2014,0,1,-1
LVA,Latvia,KWT,Kuwait,2015,0,1,-1
LVA,Latvia,KWT,Kuwait,2017,0,0,0
LVA,Latvia,UKR,Ukraine,2008,0,107,-107
LVA,Latvia,UKR,Ukraine,2009,0,78,-78
LVA,Latvia,UKR,Ukraine,2010,0,91,-91
LVA,Latvia,UKR,Ukraine,2013,0,383,-383
LVA,Latvia,UKR,Ukraine,2014,0,547,-547
LVA,Latvia,UKR,Ukraine,2015,0,547,-547
LVA,Latvia,UKR,Ukraine,2017,0,873,-873
LVA,Latvia,NAM,Namibia,2014,0,0,0
LVA,Latvia,NAM,Namibia,2015,0,0,0
LVA,Latvia,NAM,Namibia,2017,0,0,0
LVA,Latvia,ATG,Antigua and Barbuda,2014,0,0,0
LVA,Latvia,ATG,Antigua and Barbuda,2015,0,0,0
LVA,Latvia,ATG,Antigua and Barbuda,2017,0,0,0
LVA,Latvia,PAK,Pakistan,2008,0,1,-1
LVA,Latvia,PAK,Pakistan,2009,0,1,-1
LVA,Latvia,PAK,Pakistan,2010,0,2,-2
LVA,Latvia,PAK,Pakistan,2014,0,2,-2
LVA,Latvia,PAK,Pakistan,2015,0,2,-2
LVA,Latvia,PAK,Pakistan,2017,0,77,-77
LVA,Latvia,PRK,Democratic People's Republic of Korea,2014,0,0,0
LVA,Latvia,PRK,Democratic People's Republic of Korea,2015,0,0,0
LVA,Latvia,PRK,Democratic People's Republic of Korea,2017,0,0,0
LVA,Latvia,IND,India,2008,0,4,-4
LVA,Latvia,IND,India,2009,0,7,-7
LVA,Latvia,IND,India,2010,0,5,-5
LVA,Latvia,IND,India,2014,0,50,-50
LVA,Latvia,IND,India,2015,0,50,-50
LVA,Latvia,IND,India,2017,0,634,-634
LVA,Latvia,LCA,Saint Lucia,2014,0,0,0
LVA,Latvia,LCA,Saint Lucia,2015,0,0,0
LVA,Latvia,LCA,Saint Lucia,2017,0,0,0
LVA,Latvia,TUV,Tuvalu,2014,0,0,0
LVA,Latvia,TUV,Tuvalu,2015,0,0,0
LVA,Latvia,TUV,Tuvalu,2017,0,0,0
LVA,Latvia,MNG,Mongolia,2014,0,1,-1
LVA,Latvia,MNG,Mongolia,2015,0,1,-1
LVA,Latvia,MNG,Mongolia,2017,0,3,-3
LVA,Latvia,TON,Tonga,2014,0,0,0
LVA,Latvia,TON,Tonga,2015,0,0,0
LVA,Latvia,TON,Tonga,2017,0,0,0
LVA,Latvia,BEN,Benin,2014,0,0,0
LVA,Latvia,BEN,Benin,2015,0,0,0
LVA,Latvia,BEN,Benin,2017,0,1,-1
LVA,Latvia,KAZ,Kazakhstan,2008,0,5,-5
LVA,Latvia,KAZ,Kazakhstan,2009,0,11,-11
LVA,Latvia,KAZ,Kazakhstan,2010,0,23,-23
LVA,Latvia,KAZ,Kazakhstan,2014,0,36,-36
LVA,Latvia,KAZ,Kazakhstan,2015,0,36,-36
LVA,Latvia,KAZ,Kazakhstan,2017,0,90,-90
LVA,Latvia,SOM,Somalia,2014,0,0,0
LVA,Latvia,SOM,Somalia,2015,0,0,0
LVA,Latvia,SOM,Somalia,2017,0,0,0
LVA,Latvia,GRC,Greece,2008,0,4,-4
LVA,Latvia,GRC,Greece,2009,0,5,-5
LVA,Latvia,GRC,Greece,2010,0,1,-1
LVA,Latvia,GRC,Greece,2014,0,5,-5
LVA,Latvia,GRC,Greece,2015,0,5,-5
LVA,Latvia,GRC,Greece,2017,0,6,-6
LVA,Latvia,TGO,Togo,2014,0,0,0
LVA,Latvia,TGO,Togo,2015,0,0,0
LVA,Latvia,TGO,Togo,2017,0,0,0
LVA,Latvia,PAN,Panama,2014,0,0,0
LVA,Latvia,PAN,Panama,2015,0,0,0
LVA,Latvia,PAN,Panama,2017,0,1,-1
LVA,Latvia,SLE,Sierra Leone,2014,0,0,0
LVA,Latvia,SLE,Sierra Leone,2015,0,0,0
LVA,Latvia,SLE,Sierra Leone,2017,0,0,0
LVA,Latvia,GIN,Guinea,2014,0,0,0
LVA,Latvia,GIN,Guinea,2015,0,0,0
LVA,Latvia,GIN,Guinea,2017,0,0,0
LVA,Latvia,ARM,Armenia,2008,0,8,-8
LVA,Latvia,ARM,Armenia,2009,0,5,-5
LVA,Latvia,ARM,Armenia,2010,0,3,-3
LVA,Latvia,ARM,Armenia,2014,0,14,-14
LVA,Latvia,ARM,Armenia,2015,0,14,-14
LVA,Latvia,ARM,Armenia,2017,0,39,-39
LVA,Latvia,MWI,Malawi,2014,0,0,0
LVA,Latvia,MWI,Malawi,2015,0,0,0
LVA,Latvia,MWI,Malawi,2017,0,0,0
LVA,Latvia,SRB,Serbia,2008,0,4,-4
LVA,Latvia,SRB,Serbia,2010,0,1,-1
LVA,Latvia,SRB,Serbia,2014,0,2,-2
LVA,Latvia,SRB,Serbia,2015,0,2,-2
LVA,Latvia,SRB,Serbia,2017,0,2,-2
LVA,Latvia,AGO,Angola,2014,0,0,0
LVA,Latvia,AGO,Angola,2015,0,0,0
LVA,Latvia,AGO,Angola,2017,0,0,0
LVA,Latvia,NPL,Nepal,2014,0,5,-5
LVA,Latvia,NPL,Nepal,2015,0,5,-5
LVA,Latvia,NPL,Nepal,2017,0,12,-12
LVA,Latvia,TWN,Chinese Taipei,2014,0,0,0
LVA,Latvia,TWN,Chinese Taipei,2015,0,0,0
LVA,Latvia,TWN,Chinese Taipei,2017,0,6,-6
LVA,Latvia,HTI,Haiti,2014,0,0,0
LVA,Latvia,HTI,Haiti,2015,0,0,0
LVA,Latvia,HTI,Haiti,2017,0,0,0
LVA,Latvia,TKL,Tokelau,2014,0,0,0
LVA,Latvia,TKL,Tokelau,2017,0,0,0
LVA,Latvia,MHL,Marshall Islands,2014,0,0,0
LVA,Latvia,MHL,Marshall Islands,2015,0,0,0
LVA,Latvia,MHL,Marshall Islands,2017,0,0,0
LVA,Latvia,SWZ,Swaziland,2014,0,0,0
LVA,Latvia,SWZ,Swaziland,2015,0,0,0
LVA,Latvia,SWZ,Swaziland,2017,0,0,0
LVA,Latvia,ETH,Ethiopia,2014,0,0,0
LVA,Latvia,ETH,Ethiopia,2015,0,0,0
LVA,Latvia,ETH,Ethiopia,2017,0,0,0
LVA,Latvia,KNA,Saint Kitts and Nevis,2014,0,0,0
LVA,Latvia,KNA,Saint Kitts and Nevis,2015,0,0,0
LVA,Latvia,KNA,Saint Kitts and Nevis,2017,0,0,0
LVA,Latvia,BRA,Brazil,2008,0,12,-12
LVA,Latvia,BRA,Brazil,2010,0,4,-4
LVA,Latvia,BRA,Brazil,2014,0,5,-5
LVA,Latvia,BRA,Brazil,2015,0,5,-5
LVA,Latvia,BRA,Brazil,2017,0,7,-7
LVA,Latvia,GHA,Ghana,2014,0,4,-4
LVA,Latvia,GHA,Ghana,2015,0,4,-4
LVA,Latvia,GHA,Ghana,2017,0,4,-4
LVA,Latvia,MLT,Malta,2008,0,3,-3
LVA,Latvia,MLT,Malta,2009,0,1,-1
LVA,Latvia,MLT,Malta,2010,0,1,-1
LVA,Latvia,MLT,Malta,2014,0,1,-1
LVA,Latvia,MLT,Malta,2015,0,1,-1
LVA,Latvia,MLT,Malta,2017,0,2,-2
LVA,Latvia,GNB,Guinea-Bissau,2014,0,0,0
LVA,Latvia,GNB,Guinea-Bissau,2015,0,0,0
LVA,Latvia,GNB,Guinea-Bissau,2017,0,0,0
LVA,Latvia,GTM,Guatemala,2014,0,0,0
LVA,Latvia,GTM,Guatemala,2015,0,0,0
LVA,Latvia,GTM,Guatemala,2017,0,1,-1
LVA,Latvia,PSE,West Bank and Gaza Strip,2014,0,0,0
LVA,Latvia,PSE,West Bank and Gaza Strip,2015,0,0,0
LVA,Latvia,PSE,West Bank and Gaza Strip,2017,0,1,-1
LVA,Latvia,LKA,Sri Lanka,2008,0,1,-1
LVA,Latvia,LKA,Sri Lanka,2010,0,0,0
LVA,Latvia,LKA,Sri Lanka,2014,0,7,-7
LVA,Latvia,LKA,Sri Lanka,2015,0,7,-7
LVA,Latvia,LKA,Sri Lanka,2017,0,54,-54
LVA,Latvia,CIV,Côte d'Ivoire,2014,0,0,0
LVA,Latvia,CIV,Côte d'Ivoire,2015,0,0,0
LVA,Latvia,CIV,Côte d'Ivoire,2017,0,0,0
LVA,Latvia,HKG,"Hong Kong, China",2014,0,0,0
LVA,Latvia,HKG,"Hong Kong, China",2017,0,0,0
LVA,Latvia,KEN,Kenya,2014,0,0,0
LVA,Latvia,KEN,Kenya,2015,0,0,0
LVA,Latvia,KEN,Kenya,2017,0,1,-1
LVA,Latvia,AND,Andorra,2014,0,0,0
LVA,Latvia,AND,Andorra,2015,0,0,0
LVA,Latvia,AND,Andorra,2017,0,0,0
LVA,Latvia,DJI,Djibouti,2014,0,0,0
LVA,Latvia,DJI,Djibouti,2015,0,0,0
LVA,Latvia,DJI,Djibouti,2017,0,0,0
LVA,Latvia,ECU,Ecuador,2014,0,0,0
LVA,Latvia,ECU,Ecuador,2015,0,0,0
LVA,Latvia,ECU,Ecuador,2017,0,1,-1
LVA,Latvia,SCG,Serbia and Montenegro,2014,0,0,0
LVA,Latvia,SCG,Serbia and Montenegro,2017,0,0,0
LVA,Latvia,IRN,Iran,2014,0,1,-1
LVA,Latvia,IRN,Iran,2015,0,1,-1
LVA,Latvia,IRN,Iran,2017,0,2,-2
LVA,Latvia,ERI,Eritrea,2014,0,0,0
LVA,Latvia,ERI,Eritrea,2015,0,0,0
LVA,Latvia,ERI,Eritrea,2017,0,0,0
LVA,Latvia,BGD,Bangladesh,2014,0,0,0
LVA,Latvia,BGD,Bangladesh,2015,0,0,0
LVA,Latvia,BGD,Bangladesh,2017,0,4,-4
LVA,Latvia,VCT,Saint Vincent and the Grenadines,2014,0,0,0
LVA,Latvia,VCT,Saint Vincent and the Grenadines,2015,0,0,0
LVA,Latvia,VCT,Saint Vincent and the Grenadines,2017,0,0,0
LVA,Latvia,QAT,Qatar,2014,0,0,0
LVA,Latvia,QAT,Qatar,2015,0,0,0
LVA,Latvia,QAT,Qatar,2017,0,0,0
LVA,Latvia,CRI,Costa Rica,2014,0,0,0
LVA,Latvia,CRI,Costa Rica,2015,0,0,0
LVA,Latvia,CRI,Costa Rica,2017,0,0,0
LVA,Latvia,DMA,Dominica,2014,0,0,0
LVA,Latvia,DMA,Dominica,2015,0,0,0
LVA,Latvia,DMA,Dominica,2017,0,0,0
LVA,Latvia,MCO,Monaco,2014,0,0,0
LVA,Latvia,MCO,Monaco,2015,0,0,0
LVA,Latvia,MCO,Monaco,2017,0,0,0
LVA,Latvia,IDN,Indonesia,2014,0,2,-2
LVA,Latvia,IDN,Indonesia,2015,0,2,-2
LVA,Latvia,IDN,Indonesia,2017,0,1,-1
LVA,Latvia,SYC,Seychelles,2014,0,0,0
LVA,Latvia,SYC,Seychelles,2015,0,0,0
LVA,Latvia,SYC,Seychelles,2017,0,0,0
LVA,Latvia,HRV,Croatia,2014,0,1,-1
LVA,Latvia,HRV,Croatia,2015,0,1,-1
LVA,Latvia,HRV,Croatia,2017,0,3,-3
LVA,Latvia,NER,Niger,2014,0,0,0
LVA,Latvia,NER,Niger,2015,0,0,0
LVA,Latvia,NER,Niger,2017,0,0,0
LVA,Latvia,CYP,Cyprus,2014,0,2,-2
LVA,Latvia,CYP,Cyprus,2015,0,2,-2
LVA,Latvia,CYP,Cyprus,2017,0,1,-1
LVA,Latvia,GNQ,Equatorial Guinea,2014,0,0,0
LVA,Latvia,GNQ,Equatorial Guinea,2015,0,0,0
LVA,Latvia,GNQ,Equatorial Guinea,2017,0,0,0
LVA,Latvia,SEN,Senegal,2014,0,0,0
LVA,Latvia,SEN,Senegal,2015,0,0,0
LVA,Latvia,SEN,Senegal,2017,0,1,-1
LVA,Latvia,LBY,Libya,2014,0,0,0
LVA,Latvia,LBY,Libya,2015,0,0,0
LVA,Latvia,LBY,Libya,2017,0,2,-2
LVA,Latvia,ZWE,Zimbabwe,2014,0,0,0
LVA,Latvia,ZWE,Zimbabwe,2015,0,0,0
LVA,Latvia,ZWE,Zimbabwe,2017,0,0,0
LVA,Latvia,KIR,Kiribati,2014,0,0,0
LVA,Latvia,KIR,Kiribati,2015,0,0,0
LVA,Latvia,KIR,Kiribati,2017,0,0,0
LVA,Latvia,SGP,Singapore,2014,0,2,-2
LVA,Latvia,SGP,Singapore,2015,0,2,-2
LVA,Latvia,SGP,Singapore,2017,0,2,-2
LVA,Latvia,ARE,United Arab Emirates,2014,0,0,0
LVA,Latvia,ARE,United Arab Emirates,2015,0,0,0
LVA,Latvia,ARE,United Arab Emirates,2017,0,0,0
LVA,Latvia,NRU,Nauru,2014,0,0,0
LVA,Latvia,NRU,Nauru,2015,0,0,0
LVA,Latvia,NRU,Nauru,2017,0,0,0
LVA,Latvia,ZAF,South Africa,2014,0,3,-3
LVA,Latvia,ZAF,South Africa,2015,0,3,-3
LVA,Latvia,ZAF,South Africa,2017,0,2,-2
LVA,Latvia,TUR,Turkey,2008,0,4,-4
LVA,Latvia,TUR,Turkey,2009,0,8,-8
LVA,Latvia,TUR,Turkey,2014,0,11,-11
LVA,Latvia,TUR,Turkey,2015,0,11,-11
LVA,Latvia,TUR,Turkey,2017,0,47,-47
LVA,Latvia,RUS,Russia,2008,0,403,-403
LVA,Latvia,RUS,Russia,2009,0,709,-709
LVA,Latvia,RUS,Russia,2010,0,868,-868
LVA,Latvia,RUS,Russia,2013,0,2469,-2469
LVA,Latvia,RUS,Russia,2014,0,1309,-1309
LVA,Latvia,RUS,Russia,2015,0,1309,-1309
LVA,Latvia,RUS,Russia,2017,0,874,-874
LVA,Latvia,HND,Honduras,2014,0,0,0
LVA,Latvia,HND,Honduras,2015,0,0,0
LVA,Latvia,HND,Honduras,2017,0,1,-1
LVA,Latvia,BWA,Botswana,2014,0,0,0
LVA,Latvia,BWA,Botswana,2015,0,0,0
LVA,Latvia,BWA,Botswana,2017,0,0,0
LVA,Latvia,GMB,Gambia,2014,0,0,0
LVA,Latvia,GMB,Gambia,2015,0,0,0
LVA,Latvia,GMB,Gambia,2017,0,1,-1
LVA,Latvia,LAO,Laos,2014,0,0,0
LVA,Latvia,LAO,Laos,2015,0,0,0
LVA,Latvia,LAO,Laos,2017,0,0,0
LVA,Latvia,MRT,Mauritania,2014,0,1,-1
LVA,Latvia,MRT,Mauritania,2015,0,1,-1
LVA,Latvia,MRT,Mauritania,2017,0,0,0
LVA,Latvia,AFG,Afghanistan,2014,0,1,-1
LVA,Latvia,AFG,Afghanistan,2015,0,1,-1
LVA,Latvia,AFG,Afghanistan,2017,0,0,0
LVA,Latvia,LIE,Liechtenstein,2014,0,0,0
LVA,Latvia,LIE,Liechtenstein,2015,0,0,0
LVA,Latvia,LIE,Liechtenstein,2017,0,0,0
LVA,Latvia,ALB,Albania,2014,0,2,-2
LVA,Latvia,ALB,Albania,2015,0,2,-2
LVA,Latvia,ALB,Albania,2017,0,2,-2
LVA,Latvia,LBR,Liberia,2014,0,0,0
LVA,Latvia,LBR,Liberia,2015,0,0,0
LVA,Latvia,LBR,Liberia,2017,0,0,0
LVA,Latvia,TZA,Tanzania,2014,0,0,0
LVA,Latvia,TZA,Tanzania,2015,0,0,0
LVA,Latvia,TZA,Tanzania,2017,0,0,0
LVA,Latvia,CMR,Cameroon,2014,0,0,0
LVA,Latvia,CMR,Cameroon,2015,0,0,0
LVA,Latvia,CMR,Cameroon,2017,0,2,-2
LVA,Latvia,ZMB,Zambia,2014,0,0,0
LVA,Latvia,ZMB,Zambia,2015,0,0,0
LVA,Latvia,ZMB,Zambia,2017,0,0,0
LVA,Latvia,SUR,Suriname,2014,0,0,0
LVA,Latvia,SUR,Suriname,2015,0,0,0
LVA,Latvia,SUR,Suriname,2017,0,0,0
LVA,Latvia,TUN,Tunisia,2014,0,1,-1
LVA,Latvia,TUN,Tunisia,2015,0,1,-1
LVA,Latvia,TUN,Tunisia,2017,0,0,0
LVA,Latvia,FJI,Fiji,2014,0,0,0
LVA,Latvia,FJI,Fiji,2015,0,0,0
LVA,Latvia,FJI,Fiji,2017,0,0,0
LVA,Latvia,CHL,Chile,2017,0,1,-1
LVA,Latvia,GAB,Gabon,2014,0,1,-1
LVA,Latvia,GAB,Gabon,2015,0,1,-1
LVA,Latvia,GAB,Gabon,2017,0,0,0
LVA,Latvia,MUS,Mauritius,2014,0,0,0
LVA,Latvia,MUS,Mauritius,2015,0,0,0
LVA,Latvia,MUS,Mauritius,2017,0,2,-2
LVA,Latvia,GRD,Grenada,2014,0,0,0
LVA,Latvia,GRD,Grenada,2015,0,0,0
LVA,Latvia,GRD,Grenada,2017,0,0,0
LVA,Latvia,ROU,Romania,2008,0,190,-190
LVA,Latvia,ROU,Romania,2009,0,74,-74
LVA,Latvia,ROU,Romania,2010,0,8,-8
LVA,Latvia,ROU,Romania,2014,0,14,-14
LVA,Latvia,ROU,Romania,2015,0,14,-14
LVA,Latvia,ROU,Romania,2017,0,32,-32
LVA,Latvia,GBR,United Kingdom,2008,0,67,-67
LVA,Latvia,GBR,United Kingdom,2009,0,52,-52
LVA,Latvia,GBR,United Kingdom,2017,0,56,-56
LVA,Latvia,TJK,Tajikistan,2014,0,7,-7
LVA,Latvia,TJK,Tajikistan,2015,0,7,-7
LVA,Latvia,TJK,Tajikistan,2017,0,18,-18
LVA,Latvia,ISR,Israel,2008,0,22,-22
LVA,Latvia,ISR,Israel,2009,0,11,-11
LVA,Latvia,ISR,Israel,2010,0,10,-10
LVA,Latvia,ISR,Israel,2013,0,60,-60
LVA,Latvia,ISR,Israel,2014,0,20,-20
LVA,Latvia,ISR,Israel,2015,0,20,-20
LVA,Latvia,ISR,Israel,2017,0,21,-21
LVA,Latvia,TKM,Turkmenistan,2009,0,4,-4
LVA,Latvia,TKM,Turkmenistan,2010,0,2,-2
LVA,Latvia,TKM,Turkmenistan,2014,0,1,-1
LVA,Latvia,TKM,Turkmenistan,2015,0,1,-1
LVA,Latvia,TKM,Turkmenistan,2017,0,8,-8
LVA,Latvia,SAU,Saudi Arabia,2014,0,0,0
LVA,Latvia,SAU,Saudi Arabia,2015,0,0,0
LVA,Latvia,SAU,Saudi Arabia,2017,0,0,0
LVA,Latvia,OMN,Oman,2014,0,0,0
LVA,Latvia,OMN,Oman,2015,0,0,0
LVA,Latvia,OMN,Oman,2017,0,0,0
LVA,Latvia,UZB,Uzbekistan,2008,0,12,-12
LVA,Latvia,UZB,Uzbekistan,2009,0,6,-6
LVA,Latvia,UZB,Uzbekistan,2010,0,26,-26
LVA,Latvia,UZB,Uzbekistan,2014,0,124,-124
LVA,Latvia,UZB,Uzbekistan,2015,0,124,-124
LVA,Latvia,UZB,Uzbekistan,2017,0,347,-347
LVA,Latvia,COL,Colombia,2014,0,0,0
LVA,Latvia,COL,Colombia,2015,0,0,0
LVA,Latvia,COL,Colombia,2017,0,3,-3
LVA,Latvia,SLV,El Salvador,2014,0,0,0
LVA,Latvia,SLV,El Salvador,2015,0,0,0
LVA,Latvia,SLV,El Salvador,2017,0,0,0
LVA,Latvia,GEO,Georgia,2008,0,7,-7
LVA,Latvia,GEO,Georgia,2009,0,18,-18
LVA,Latvia,GEO,Georgia,2010,0,11,-11
LVA,Latvia,GEO,Georgia,2014,0,23,-23
LVA,Latvia,GEO,Georgia,2015,0,23,-23
LVA,Latvia,GEO,Georgia,2017,0,22,-22
LVA,Latvia,MMR,Myanmar,2014,0,0,0
LVA,Latvia,MMR,Myanmar,2015,0,0,0
LVA,Latvia,MMR,Myanmar,2017,0,0,0
LVA,Latvia,CHN,China,2008,0,2,-2
LVA,Latvia,CHN,China,2009,0,3,-3
LVA,Latvia,CHN,China,2010,0,1,-1
LVA,Latvia,CHN,China,2014,0,57,-57
LVA,Latvia,CHN,China,2015,0,57,-57
LVA,Latvia,CHN,China,2017,0,51,-51
LVA,Latvia,SMR,San Marino,2014,0,0,0
LVA,Latvia,SMR,San Marino,2015,0,0,0
LVA,Latvia,SMR,San Marino,2017,0,0,0
LVA,Latvia,DOM,Dominican Republic,2014,0,0,0
LVA,Latvia,DOM,Dominican Republic,2015,0,0,0
LVA,Latvia,DOM,Dominican Republic,2017,0,0,0
LVA,Latvia,SDN,Sudan,2014,0,0,0
LVA,Latvia,SDN,Sudan,2015,0,0,0
LVA,Latvia,SDN,Sudan,2017,0,0,0
LVA,Latvia,LSO,Lesotho,2014,0,0,0
LVA,Latvia,LSO,Lesotho,2015,0,0,0
LVA,Latvia,LSO,Lesotho,2017,0,0,0
LVA,Latvia,STP,Sao Tome and Principe,2014,0,0,0
LVA,Latvia,STP,Sao Tome and Principe,2017,0,0,0
LVA,Latvia,IRL,Ireland,2008,0,9,-9
LVA,Latvia,IRL,Ireland,2009,0,7,-7
LVA,Latvia,IRL,Ireland,2010,0,9,-9
LVA,Latvia,IRL,Ireland,2014,0,21,-21
LVA,Latvia,IRL,Ireland,2015,0,21,-21
LVA,Latvia,IRL,Ireland,2017,0,7,-7
LVA,Latvia,BLR,Belarus,2008,0,86,-86
LVA,Latvia,BLR,Belarus,2009,0,57,-57
LVA,Latvia,BLR,Belarus,2010,0,38,-38
LVA,Latvia,BLR,Belarus,2013,0,312,-312
LVA,Latvia,BLR,Belarus,2014,0,299,-299
LVA,Latvia,BLR,Belarus,2015,0,299,-299
LVA,Latvia,BLR,Belarus,2017,0,254,-254
LVA,Latvia,PER,Peru,2014,0,1,-1
LVA,Latvia,PER,Peru,2015,0,1,-1
LVA,Latvia,PER,Peru,2017,0,1,-1
LVA,Latvia,CUB,Cuba,2014,0,2,-2
LVA,Latvia,CUB,Cuba,2015,0,2,-2
LVA,Latvia,CUB,Cuba,2017,0,1,-1
LVA,Latvia,BDI,Burundi,2014,0,0,0
LVA,Latvia,BDI,Burundi,2015,0,0,0
LVA,Latvia,BDI,Burundi,2017,0,0,0
LVA,Latvia,KHM,Cambodia,2014,0,0,0
LVA,Latvia,KHM,Cambodia,2015,0,0,0
LVA,Latvia,KHM,Cambodia,2017,0,0,0
LVA,Latvia,NIC,Nicaragua,2014,0,0,0
LVA,Latvia,NIC,Nicaragua,2015,0,0,0
LVA,Latvia,NIC,Nicaragua,2017,0,0,0
LVA,Latvia,GUM,Guam,2014,0,0,0
LVA,Latvia,GUM,Guam,2017,0,0,0
LVA,Latvia,PHL,Philippines,2014,0,53,-53
LVA,Latvia,PHL,Philippines,2015,0,53,-53
LVA,Latvia,PHL,Philippines,2017,0,2,-2
LVA,Latvia,WSM,Samoa,2014,0,0,0
LVA,Latvia,WSM,Samoa,2015,0,0,0
LVA,Latvia,WSM,Samoa,2017,0,0,0
GBR,United Kingdom,ALB,Albania,2011,1000,0,1000
BEL,Belgium,AND,Andorra,2015,1,0,1
ITA,Italy,AND,Andorra,2014,0,0,0
AUS,Australia,AGO,Angola,2016,0,0,0
NZL,New Zealand,AGO,Angola,2009,0,0,0
CZE,Czech Republic,ATG,Antigua and Barbuda,2014,1,0,1
ITA,Italy,ATG,Antigua and Barbuda,2014,0,0,0
NLD,Netherlands,ATG,Antigua and Barbuda,2009,1,0,1
GBR,United Kingdom,ARG,Argentina,2013,1000,0,1000
NLD,Netherlands,AZE,Azerbaijan,2008,7,0,7
NLD,Netherlands,BHS,Bahamas,2009,1,0,1
NLD,Netherlands,BHS,Bahamas,2010,2,0,2
NZL,New Zealand,BHS,Bahamas,2009,0,0,0
BEL,Belgium,BHR,Bahrain,2017,2,0,2
CZE,Czech Republic,BHR,Bahrain,2012,1,0,1
ITA,Italy,BHR,Bahrain,2014,0,0,0
NLD,Netherlands,BHR,Bahrain,2008,1,0,1
NLD,Netherlands,BHR,Bahrain,2009,1,0,1
BEL,Belgium,BRB,Barbados,2014,1,0,1
CZE,Czech Republic,BRB,Barbados,2014,1,0,1
ITA,Italy,BRB,Barbados,2014,0,0,0
NLD,Netherlands,BRB,Barbados,2014,1,0,1
NZL,New Zealand,BRB,Barbados,2009,2,0,2
NZL,New Zealand,BRB,Barbados,2011,1,0,1
AUS,Australia,BLZ,Belize,2016,0,0,0
BEL,Belgium,BLZ,Belize,2015,1,0,1
DNK,Denmark,BLZ,Belize,2011,1,0,1
NLD,Netherlands,BLZ,Belize,2010,3,0,3
CZE,Czech Republic,BEN,Benin,2016,1,0,1
ITA,Italy,BMU,Bermuda,2014,0,0,0
NZL,New Zealand,BMU,Bermuda,2010,0,0,0
NZL,New Zealand,BMU,Bermuda,2013,1,0,1
CHE,Switzerland,BMU,Bermuda,2016,0,0,0
NLD,Netherlands,BIH,Bosnia and Herzegovina,2008,116,0,116
BEL,Belgium,BWA,Botswana,2015,6,0,6
BEL,Belgium,BWA,Botswana,2016,1,0,1
ITA,Italy,BWA,Botswana,2014,0,0,0
GBR,United Kingdom,BRA,Brazil,2008,3000,0,3000
AUS,Australia,BFA,Burkina Faso,2016,0,0,0
CZE,Czech Republic,BFA,Burkina Faso,2015,1,0,1
CZE,Czech Republic,BFA,Burkina Faso,2016,1,0,1
SVK,Slovak Republic,KHM,Cambodia,2011,1,0,1
CZE,Czech Republic,CMR,Cameroon,2017,5,0,5
NLD,Netherlands,CAF,Central African Republic,2011,1,0,1
CZE,Czech Republic,TCD,Chad,2014,1,0,1
NZL,New Zealand,TCD,Chad,2008,1,0,1
NZL,New Zealand,TCD,Chad,2012,1,0,1
NZL,New Zealand,TCD,Chad,2017,4,0,4
SVK,Slovak Republic,TCD,Chad,2010,2,0,2
AUS,Australia,COM,Comoros,2016,0,0,0
NLD,Netherlands,COM,Comoros,2010,1,0,1
NLD,Netherlands,COM,Comoros,2012,1,0,1
NZL,New Zealand,COM,Comoros,2014,1,0,1
ITA,Italy,COK,Cook Islands,2014,0,0,0
ITA,Italy,COK,Cook Islands,2015,0,0,0
NZL,New Zealand,COK,Cook Islands,2008,0,0,0
NZL,New Zealand,COK,Cook Islands,2009,0,0,0
NZL,New Zealand,COK,Cook Islands,2010,1,0,1
NZL,New Zealand,COK,Cook Islands,2011,3,0,3
NZL,New Zealand,COK,Cook Islands,2012,0,0,0
CHE,Switzerland,COK,Cook Islands,2016,1,0,1
SVN,Slovenia,CRI,Costa Rica,2012,2,0,2
NZL,New Zealand,CIV,Côte d'Ivoire,2009,0,0,0
NLD,Netherlands,HRV,Croatia,2008,105,0,105
AUS,Australia,PRK,Democratic People's Republic of Korea,2008,152,0,152
BEL,Belgium,PRK,Democratic People's Republic of Korea,2016,7,0,7
CZE,Czech Republic,PRK,Democratic People's Republic of Korea,2014,1,0,1
NLD,Netherlands,PRK,Democratic People's Republic of Korea,2009,474,0,474
NLD,Netherlands,PRK,Democratic People's Republic of Korea,2012,692,0,692
NZL,New Zealand,PRK,Democratic People's Republic of Korea,2008,2,0,2
NZL,New Zealand,PRK,Democratic People's Republic of Korea,2010,2,0,2
NZL,New Zealand,PRK,Democratic People's Republic of Korea,2011,2,0,2
NZL,New Zealand,PRK,Democratic People's Republic of Korea,2012,1,0,1
SVK,Slovak Republic,PRK,Democratic People's Republic of Korea,2009,3,0,3
NLD,Netherlands,COD,Democratic Republic of the Congo,2008,-18,0,-18
CHE,Switzerland,COD,Democratic Republic of the Congo,2011,7,0,7
DNK,Denmark,DJI,Djibouti,2011,1,0,1
NLD,Netherlands,DJI,Djibouti,2012,1,0,1
ESP,Spain,DJI,Djibouti,2017,2,0,2
DNK,Denmark,DMA,Dominica,2010,1,0,1
NZL,New Zealand,DMA,Dominica,2010,0,0,0
AUS,Australia,DOM,Dominican Republic,2016,0,0,0
NZL,New Zealand,DOM,Dominican Republic,2017,3,0,3
CZE,Czech Republic,SLV,El Salvador,2016,2,0,2
AUS,Australia,GNQ,Equatorial Guinea,2008,0,0,0
CZE,Czech Republic,ERI,Eritrea,2013,1,0,1
NLD,Netherlands,FJI,Fiji,2010,3,0,3
AUS,Australia,GAB,Gabon,2016,0,0,0
DNK,Denmark,GAB,Gabon,2011,1,0,1
NZL,New Zealand,GAB,Gabon,2008,0,0,0
AUS,Australia,GMB,Gambia,2016,0,0,0
NZL,New Zealand,GMB,Gambia,2017,2,0,2
NZL,New Zealand,GEO,Georgia,2014,1,0,1
BEL,Belgium,GRD,Grenada,2014,2,0,2
ITA,Italy,GRD,Grenada,2014,0,0,0
ITA,Italy,GRD,Grenada,2017,1,0,1
NZL,New Zealand,GRD,Grenada,2011,1,0,1
NZL,New Zealand,GRD,Grenada,2015,1,0,1
NZL,New Zealand,GRD,Grenada,2016,1,0,1
AUS,Australia,GUM,Guam,2008,5,0,5
ITA,Italy,GUM,Guam,2014,0,0,0
ITA,Italy,GUM,Guam,2015,0,0,0
NZL,New Zealand,GUM,Guam,2009,0,0,0
NZL,New Zealand,GUM,Guam,2010,0,0,0
NZL,New Zealand,GUM,Guam,2012,0,0,0
CHE,Switzerland,GUM,Guam,2016,0,0,0
SVK,Slovak Republic,GTM,Guatemala,2009,1,0,1
SVN,Slovenia,GIN,Guinea,2011,1,0,1
AUS,Australia,GNB,Guinea-Bissau,2016,0,0,0
CZE,Czech Republic,GNB,Guinea-Bissau,2013,1,0,1
CZE,Czech Republic,GNB,Guinea-Bissau,2014,1,0,1
CZE,Czech Republic,GNB,Guinea-Bissau,2015,1,0,1
NZL,New Zealand,GNB,Guinea-Bissau,2009,0,0,0
AUS,Australia,GUY,Guyana,2016,0,0,0
CZE,Czech Republic,GUY,Guyana,2013,1,0,1
CZE,Czech Republic,GUY,Guyana,2014,1,0,1
DNK,Denmark,GUY,Guyana,2011,2,0,2
NZL,New Zealand,GUY,Guyana,2014,1,0,1
SVN,Slovenia,GUY,Guyana,2011,1,0,1
AUS,Australia,HTI,Haiti,2016,0,0,0
CZE,Czech Republic,HTI,Haiti,2015,2,0,2
NZL,New Zealand,HTI,Haiti,2008,1,0,1
NZL,New Zealand,HTI,Haiti,2015,1,0,1
AUS,Australia,HND,Honduras,2016,0,0,0
NZL,New Zealand,HND,Honduras,2009,0,0,0
ITA,Italy,HKG,"Hong Kong, China",2015,0,0,0
NLD,Netherlands,HKG,"Hong Kong, China",2014,0,0,0
SVK,Slovak Republic,HKG,"Hong Kong, China",2014,1,0,1
CHE,Switzerland,HKG,"Hong Kong, China",2016,0,0,0
GBR,United Kingdom,HKG,"Hong Kong, China",2009,2000,0,2000
SVN,Slovenia,IDN,Indonesia,2014,1,0,1
GBR,United Kingdom,IRN,Iran,2015,1000,0,1000
GBR,United Kingdom,JOR,Jordan,2012,1000,0,1000
SVN,Slovenia,JOR,Jordan,2015,1,0,1
SVN,Slovenia,KEN,Kenya,2014,1,0,1
NLD,Netherlands,KIR,Kiribati,2014,0,0,0
SVK,Slovak Republic,KIR,Kiribati,2009,1,0,1
NLD,Netherlands,KGZ,Kyrgyzstan,2008,8,0,8
NLD,Netherlands,KGZ,Kyrgyzstan,2011,8,0,8
NLD,Netherlands,KGZ,Kyrgyzstan,2012,9,0,9
CZE,Czech Republic,LAO,Laos,2014,3,0,3
CZE,Czech Republic,LAO,Laos,2015,1,0,1
DNK,Denmark,LAO,Laos,2011,1,0,1
BEL,Belgium,LSO,Lesotho,2012,1,0,1
DNK,Denmark,LSO,Lesotho,2010,1,0,1
NZL,New Zealand,LSO,Lesotho,2008,4,0,4
NZL,New Zealand,LSO,Lesotho,2009,1,0,1
NZL,New Zealand,LBR,Liberia,2011,1,0,1
NZL,New Zealand,LBY,Libya,2009,0,0,0
GBR,United Kingdom,LBY,Libya,2015,1000,0,1000
SVN,Slovenia,LBY,Libya,2012,1,0,1
CZE,Czech Republic,LIE,Liechtenstein,2009,1,0,1
CZE,Czech Republic,LIE,Liechtenstein,2013,4,0,4
DNK,Denmark,LIE,Liechtenstein,2011,3,0,3
ITA,Italy,LIE,Liechtenstein,2014,1,0,1
NZL,New Zealand,LIE,Liechtenstein,2011,1,0,1
NZL,New Zealand,LIE,Liechtenstein,2014,1,0,1
ITA,Italy,MAC,Macau,2014,0,0,0
ITA,Italy,MAC,Macau,2015,0,0,0
NLD,Netherlands,MAC,Macau,2014,0,0,0
SWE,Sweden,MAC,Macau,2008,0,0,0
SWE,Sweden,MAC,Macau,2009,0,0,0
CHE,Switzerland,MAC,Macau,2016,0,0,0
ITA,Italy,MKD,North Macedonia,2008,312,0,312
ITA,Italy,MKD,North Macedonia,2009,387,0,387
ITA,Italy,MKD,North Macedonia,2010,552,0,552
ITA,Italy,MKD,North Macedonia,2011,471,0,471
ITA,Italy,MKD,North Macedonia,2012,649,0,649
ITA,Italy,MKD,North Macedonia,2013,821,0,821
ITA,Italy,MKD,North Macedonia,2014,0,0,0
ITA,Italy,MKD,North Macedonia,2015,824,0,824
NLD,Netherlands,MKD,North Macedonia,2008,35,0,35
CZE,Czech Republic,MDG,Madagascar,2013,1,0,1
CZE,Czech Republic,MDG,Madagascar,2015,1,0,1
NZL,New Zealand,MDG,Madagascar,2009,1,0,1
NZL,New Zealand,MDG,Madagascar,2014,1,0,1
GBR,United Kingdom,MWI,Malawi,2011,1000,0,1000
GBR,United Kingdom,MWI,Malawi,2012,1000,0,1000
ITA,Italy,MDV,Maldives,2014,0,0,0
NLD,Netherlands,MDV,Maldives,2009,-1,0,-1
NLD,Netherlands,MDV,Maldives,2010,2,0,2
CZE,Czech Republic,MLI,Mali,2013,1,0,1
DNK,Denmark,MLI,Mali,2011,2,0,2
CZE,Czech Republic,MLT,Malta,2010,2,0,2
NZL,New Zealand,MLT,Malta,2008,0,0,0
AUS,Australia,MHL,Marshall Islands,2016,0,0,0
NLD,Netherlands,MHL,Marshall Islands,2014,0,0,0
NZL,New Zealand,MHL,Marshall Islands,2013,5,0,5
NZL,New Zealand,MHL,Marshall Islands,2014,1,0,1
CHE,Switzerland,MHL,Marshall Islands,2016,0,0,0
DNK,Denmark,MRT,Mauritania,2010,1,0,1
DNK,Denmark,FSM,Micronesia,2014,0,0,0
ITA,Italy,FSM,Micronesia,2014,2,0,2
ITA,Italy,FSM,Micronesia,2015,0,0,0
NZL,New Zealand,FSM,Micronesia,2011,2,0,2
CHE,Switzerland,FSM,Micronesia,2016,0,0,0
AUS,Australia,MCO,Monaco,2016,0,0,0
BEL,Belgium,MCO,Monaco,2012,1,0,1
BEL,Belgium,MCO,Monaco,2015,1,0,1
SVK,Slovak Republic,MAR,Morocco,2017,1,0,1
CHE,Switzerland,NRU,Nauru,2016,0,0,0
SVK,Slovak Republic,NPL,Nepal,2017,1,0,1
SVK,Slovak Republic,NIC,Nicaragua,2011,1,0,1
AUS,Australia,NER,Niger,2016,0,0,0
DNK,Denmark,NER,Niger,2011,1,0,1
SVK,Slovak Republic,NER,Niger,2011,1,0,1
SVN,Slovenia,NGA,Nigeria,2012,3,0,3
AUS,Australia,NIU,Niue,2008,0,0,0
ITA,Italy,NIU,Niue,2008,0,0,0
ITA,Italy,NIU,Niue,2009,0,0,0
ITA,Italy,NIU,Niue,2010,0,0,0
ITA,Italy,NIU,Niue,2011,0,0,0
ITA,Italy,NIU,Niue,2012,0,0,0
ITA,Italy,NIU,Niue,2014,0,0,0
ITA,Italy,NIU,Niue,2015,0,0,0
NZL,New Zealand,NIU,Niue,2008,0,0,0
NZL,New Zealand,NIU,Niue,2010,0,0,0
NZL,New Zealand,NIU,Niue,2011,0,0,0
NZL,New Zealand,NIU,Niue,2012,0,0,0
CHE,Switzerland,NIU,Niue,2016,0,0,0
ITA,Italy,PLW,Palau,2014,0,0,0
CHE,Switzerland,PLW,Palau,2016,0,0,0
CHE,Switzerland,PSE,West Bank and Gaza Strip,2016,0,0,0
AUS,Australia,PAN,Panama,2016,0,0,0
NZL,New Zealand,PAN,Panama,2015,2,0,2
GBR,United Kingdom,PAN,Panama,2015,1000,0,1000
BEL,Belgium,PNG,Papua New Guinea,2012,1,0,1
BEL,Belgium,PNG,Papua New Guinea,2013,1,0,1
BEL,Belgium,PNG,Papua New Guinea,2015,1,0,1
DNK,Denmark,PNG,Papua New Guinea,2010,1,0,1
NLD,Netherlands,PNG,Papua New Guinea,2012,2,0,2
CZE,Czech Republic,PRY,Paraguay,2017,4,0,4
NZL,New Zealand,PRY,Paraguay,2017,4,0,4
AUS,Australia,PRI,Puerto Rico,2008,0,0,0
ITA,Italy,PRI,Puerto Rico,2014,0,0,0
ITA,Italy,PRI,Puerto Rico,2015,0,0,0
CHE,Switzerland,PRI,Puerto Rico,2016,0,0,0
AUS,Australia,QAT,Qatar,2016,0,0,0
DNK,Denmark,QAT,Qatar,2011,1,0,1
NZL,New Zealand,QAT,Qatar,2008,0,0,0
NZL,New Zealand,QAT,Qatar,2010,0,0,0
NZL,New Zealand,QAT,Qatar,2011,1,0,1
NZL,New Zealand,QAT,Qatar,2016,1,0,1
NLD,Netherlands,RUS,Russia,2008,370,0,370
SVK,Slovak Republic,RWA,Rwanda,2017,1,0,1
AUS,Australia,KNA,Saint Kitts and Nevis,2016,0,0,0
BEL,Belgium,KNA,Saint Kitts and Nevis,2017,4,0,4
ITA,Italy,KNA,Saint Kitts and Nevis,2014,0,0,0
NLD,Netherlands,KNA,Saint Kitts and Nevis,2011,1,0,1
NLD,Netherlands,KNA,Saint Kitts and Nevis,2014,1,0,1
NZL,New Zealand,KNA,Saint Kitts and Nevis,2014,1,0,1
NZL,New Zealand,KNA,Saint Kitts and Nevis,2015,2,0,2
NLD,Netherlands,LCA,Saint Lucia,2010,1,0,1
NZL,New Zealand,LCA,Saint Lucia,2008,4,0,4
NZL,New Zealand,LCA,Saint Lucia,2011,3,0,3
NZL,New Zealand,LCA,Saint Lucia,2015,2,0,2
AUS,Australia,VCT,Saint Vincent and the Grenadines,2016,0,0,0
BEL,Belgium,VCT,Saint Vincent and the Grenadines,2014,1,0,1
CZE,Czech Republic,VCT,Saint Vincent and the Grenadines,2012,1,0,1
ITA,Italy,VCT,Saint Vincent and the Grenadines,2014,0,0,0
NZL,New Zealand,VCT,Saint Vincent and the Grenadines,2014,1,0,1
CZE,Czech Republic,WSM,Samoa,2012,1,0,1
BEL,Belgium,SMR,San Marino,2013,1,0,1
NZL,New Zealand,SMR,San Marino,2008,1,0,1
CHE,Switzerland,SMR,San Marino,2011,1,0,1
CZE,Czech Republic,STP,Sao Tome and Principe,2013,1,0,1
ITA,Italy,STP,Sao Tome and Principe,2014,0,0,0
NLD,Netherlands,STP,Sao Tome and Principe,2014,-1,0,-1
DNK,Denmark,SAU,Saudi Arabia,2011,3,0,3
ITA,Italy,SCG,Serbia and Montenegro,2008,0,0,0
ITA,Italy,SCG,Serbia and Montenegro,2009,0,0,0
ITA,Italy,SCG,Serbia and Montenegro,2010,0,0,0
ITA,Italy,SCG,Serbia and Montenegro,2011,0,0,0
ITA,Italy,SCG,Serbia and Montenegro,2012,0,0,0
ITA,Italy,SCG,Serbia and Montenegro,2013,0,0,0
ITA,Italy,SCG,Serbia and Montenegro,2014,0,0,0
ITA,Italy,SCG,Serbia and Montenegro,2015,0,0,0
NLD,Netherlands,SCG,Serbia and Montenegro,2008,34,0,34
NLD,Netherlands,SCG,Serbia and Montenegro,2009,16,0,16
NLD,Netherlands,SCG,Serbia and Montenegro,2010,16,0,16
NLD,Netherlands,SCG,Serbia and Montenegro,2011,11,0,11
NLD,Netherlands,SCG,Serbia and Montenegro,2014,1,0,1
SVK,Slovak Republic,SCG,Serbia and Montenegro,2009,3,0,3
SVK,Slovak Republic,SCG,Serbia and Montenegro,2010,2,0,2
SVK,Slovak Republic,SCG,Serbia and Montenegro,2011,1,0,1
CHE,Switzerland,SCG,Serbia and Montenegro,2016,0,0,0
SVN,Slovenia,SCG,Serbia and Montenegro,2011,2,0,2
SVN,Slovenia,SCG,Serbia and Montenegro,2012,2,0,2
SVN,Slovenia,SCG,Serbia and Montenegro,2013,16,0,16
SVN,Slovenia,SCG,Serbia and Montenegro,2014,10,0,10
SVN,Slovenia,SCG,Serbia and Montenegro,2015,5,0,5
SVN,Slovenia,SCG,Serbia and Montenegro,2016,8,0,8
SVN,Slovenia,SCG,Serbia and Montenegro,2017,21,0,21
NLD,Netherlands,SYC,Seychelles,2011,1,0,1
CZE,Czech Republic,SLE,Sierra Leone,2013,2,0,2
NZL,New Zealand,SLE,Sierra Leone,2012,2,0,2
NZL,New Zealand,SLE,Sierra Leone,2015,3,0,3
NZL,New Zealand,SLE,Sierra Leone,2017,2,0,2
SVK,Slovak Republic,SLE,Sierra Leone,2009,1,0,1
SVN,Slovenia,SLE,Sierra Leone,2013,1,0,1
NLD,Netherlands,SRB,Serbia,2008,19,0,19
NLD,Netherlands,SRB,Serbia,2009,30,0,30
BEL,Belgium,SLB,Solomon Islands,2013,4,0,4
BEL,Belgium,SLB,Solomon Islands,2016,1,0,1
ITA,Italy,SLB,Solomon Islands,2014,0,0,0
CZE,Czech Republic,SOM,Somalia,2013,4,0,4
GBR,United Kingdom,ZAF,South Africa,2010,4000,0,4000
AUS,Australia,SUR,Suriname,2016,0,0,0
BEL,Belgium,SWZ,Swaziland,2017,2,0,2
DNK,Denmark,SWZ,Swaziland,2011,2,0,2
NLD,Netherlands,SWZ,Swaziland,2012,4,0,4
NLD,Netherlands,SWZ,Swaziland,2014,1,0,1
NZL,New Zealand,SWZ,Swaziland,2008,1,0,1
NZL,New Zealand,SWZ,Swaziland,2009,0,0,0
NZL,New Zealand,SWZ,Swaziland,2011,1,0,1
SVN,Slovenia,TWN,Chinese Taipei,2011,1,0,1
AUS,Australia,TJK,Tajikistan,2016,0,0,0
NLD,Netherlands,TJK,Tajikistan,2008,1,0,1
SVK,Slovak Republic,TJK,Tajikistan,2014,2,0,2
CHE,Switzerland,TLS,Timor-Leste,2016,0,0,0
AUS,Australia,TKL,Tokelau,2008,0,0,0
ITA,Italy,TKL,Tokelau,2014,0,0,0
NZL,New Zealand,TKL,Tokelau,2010,0,0,0
NZL,New Zealand,TKL,Tokelau,2011,0,0,0
NZL,New Zealand,TKL,Tokelau,2012,0,0,0
NZL,New Zealand,TKL,Tokelau,2013,1,0,1
CHE,Switzerland,TKL,Tokelau,2016,0,0,0
DNK,Denmark,TON,Tonga,2010,5,0,5
NLD,Netherlands,TTO,Trinidad and Tobago,2009,5,0,5
SVN,Slovenia,TUN,Tunisia,2012,3,0,3
AUS,Australia,TKM,Turkmenistan,2016,0,0,0
BEL,Belgium,TKM,Turkmenistan,2012,4,0,4
BEL,Belgium,TKM,Turkmenistan,2014,1,0,1
NLD,Netherlands,TKM,Turkmenistan,2008,1,0,1
NZL,New Zealand,TKM,Turkmenistan,2009,1,0,1
AUS,Australia,TUV,Tuvalu,2016,0,0,0
ITA,Italy,TUV,Tuvalu,2014,0,0,0
CHE,Switzerland,TUV,Tuvalu,2016,0,0,0
CZE,Czech Republic,ARE,United Arab Emirates,2014,2,0,2
DNK,Denmark,ARE,United Arab Emirates,2011,1,0,1
SVN,Slovenia,ARE,United Arab Emirates,2016,1,0,1
CZE,Czech Republic,URY,Uruguay,2017,3,0,3
ITA,Italy,VUT,Vanuatu,2014,0,0,0
NLD,Netherlands,VUT,Vanuatu,2009,1,0,1
NLD,Netherlands,VUT,Vanuatu,2012,1,0,1
CHE,Switzerland,VUT,Vanuatu,2016,0,0,0
SVK,Slovak Republic,UGA,Uganda,2011,1,0,1
CHE,Switzerland,TON,Tonga,2015,0,0,0
CHE,Switzerland,TON,Tonga,2016,0,0,0
SVK,Slovak Republic,URY,Uruguay,2011,1,0,1
AUS,Australia,LCA,Saint Lucia,2016,0,0,0
CZE,Czech Republic,VUT,Vanuatu,2014,1,0,1
NLD,Netherlands,MNE,Montenegro,2009,3,0,3
CZE,Czech Republic,TTO,Trinidad and Tobago,2014,1,0,1
NLD,Netherlands,TON,Tonga,2008,1,0,1
AUS,Australia,TGO,Togo,2016,0,0,0
CHE,Switzerland,UZB,Uzbekistan,2014,28,0,28
BEL,Belgium,LCA,Saint Lucia,2012,2,0,2
BEL,Belgium,LCA,Saint Lucia,2014,1,0,1
NLD,Netherlands,UZB,Uzbekistan,2008,16,0,16
BEL,Belgium,VUT,Vanuatu,2015,1,0,1
DNK,Denmark,TGO,Togo,2011,5,0,5
NZL,New Zealand,MNE,Montenegro,2013,1,0,1
ALB,Albania,GBR,United Kingdom,2011,0,1000,-1000
AND,Andorra,BEL,Belgium,2015,0,1,-1
AND,Andorra,ITA,Italy,2014,0,0,0
AGO,Angola,AUS,Australia,2016,0,0,0
AGO,Angola,NZL,New Zealand,2009,0,0,0
ATG,Antigua and Barbuda,CZE,Czech Republic,2014,0,1,-1
ATG,Antigua and Barbuda,ITA,Italy,2014,0,0,0
ATG,Antigua and Barbuda,NLD,Netherlands,2009,0,1,-1
ARG,Argentina,GBR,United Kingdom,2013,0,1000,-1000
AZE,Azerbaijan,NLD,Netherlands,2008,0,7,-7
BHS,Bahamas,NLD,Netherlands,2009,0,1,-1
BHS,Bahamas,NLD,Netherlands,2010,0,2,-2
BHS,Bahamas,NZL,New Zealand,2009,0,0,0
BHR,Bahrain,BEL,Belgium,2017,0,2,-2
BHR,Bahrain,CZE,Czech Republic,2012,0,1,-1
BHR,Bahrain,ITA,Italy,2014,0,0,0
BHR,Bahrain,NLD,Netherlands,2008,0,1,-1
BHR,Bahrain,NLD,Netherlands,2009,0,1,-1
BRB,Barbados,BEL,Belgium,2014,0,1,-1
BRB,Barbados,CZE,Czech Republic,2014,0,1,-1
BRB,Barbados,ITA,Italy,2014,0,0,0
BRB,Barbados,NLD,Netherlands,2014,0,1,-1
BRB,Barbados,NZL,New Zealand,2009,0,2,-2
BRB,Barbados,NZL,New Zealand,2011,0,1,-1
BLZ,Belize,AUS,Australia,2016,0,0,0
BLZ,Belize,BEL,Belgium,2015,0,1,-1
BLZ,Belize,DNK,Denmark,2011,0,1,-1
BLZ,Belize,NLD,Netherlands,2010,0,3,-3
BEN,Benin,CZE,Czech Republic,2016,0,1,-1
BMU,Bermuda,ITA,Italy,2014,0,0,0
BMU,Bermuda,NZL,New Zealand,2010,0,0,0
BMU,Bermuda,NZL,New Zealand,2013,0,1,-1
BMU,Bermuda,CHE,Switzerland,2016,0,0,0
BIH,Bosnia and Herzegovina,NLD,Netherlands,2008,0,116,-116
BWA,Botswana,BEL,Belgium,2015,0,6,-6
BWA,Botswana,BEL,Belgium,2016,0,1,-1
BWA,Botswana,ITA,Italy,2014,0,0,0
BRA,Brazil,GBR,United Kingdom,2008,0,3000,-3000
BFA,Burkina Faso,AUS,Australia,2016,0,0,0
BFA,Burkina Faso,CZE,Czech Republic,2015,0,1,-1
BFA,Burkina Faso,CZE,Czech Republic,2016,0,1,-1
KHM,Cambodia,SVK,Slovak Republic,2011,0,1,-1
CMR,Cameroon,CZE,Czech Republic,2017,0,5,-5
CAF,Central African Republic,NLD,Netherlands,2011,0,1,-1
TCD,Chad,CZE,Czech Republic,2014,0,1,-1
TCD,Chad,NZL,New Zealand,2008,0,1,-1
TCD,Chad,NZL,New Zealand,2012,0,1,-1
TCD,Chad,NZL,New Zealand,2017,0,4,-4
TCD,Chad,SVK,Slovak Republic,2010,0,2,-2
COM,Comoros,AUS,Australia,2016,0,0,0
COM,Comoros,NLD,Netherlands,2010,0,1,-1
COM,Comoros,NLD,Netherlands,2012,0,1,-1
COM,Comoros,NZL,New Zealand,2014,0,1,-1
COK,Cook Islands,ITA,Italy,2014,0,0,0
COK,Cook Islands,ITA,Italy,2015,0,0,0
COK,Cook Islands,NZL,New Zealand,2008,0,0,0
COK,Cook Islands,NZL,New Zealand,2009,0,0,0
COK,Cook Islands,NZL,New Zealand,2010,0,1,-1
COK,Cook Islands,NZL,New Zealand,2011,0,3,-3
COK,Cook Islands,NZL,New Zealand,2012,0,0,0
COK,Cook Islands,CHE,Switzerland,2016,0,1,-1
CRI,Costa Rica,SVN,Slovenia,2012,0,2,-2
CIV,Côte d'Ivoire,NZL,New Zealand,2009,0,0,0
HRV,Croatia,NLD,Netherlands,2008,0,105,-105
PRK,Democratic People's Republic of Korea,AUS,Australia,2008,0,152,-152
PRK,Democratic People's Republic of Korea,BEL,Belgium,2016,0,7,-7
PRK,Democratic People's Republic of Korea,CZE,Czech Republic,2014,0,1,-1
PRK,Democratic People's Republic of Korea,NLD,Netherlands,2009,0,474,-474
PRK,Democratic People's Republic of Korea,NLD,Netherlands,2012,0,692,-692
PRK,Democratic People's Republic of Korea,NZL,New Zealand,2008,0,2,-2
PRK,Democratic People's Republic of Korea,NZL,New Zealand,2010,0,2,-2
PRK,Democratic People's Republic of Korea,NZL,New Zealand,2011,0,2,-2
PRK,Democratic People's Republic of Korea,NZL,New Zealand,2012,0,1,-1
PRK,Democratic People's Republic of Korea,SVK,Slovak Republic,2009,0,3,-3
COD,Democratic Republic of the Congo,NLD,Netherlands,2008,0,-18,18
COD,Democratic Republic of the Congo,CHE,Switzerland,2011,0,7,-7
DJI,Djibouti,DNK,Denmark,2011,0,1,-1
DJI,Djibouti,NLD,Netherlands,2012,0,1,-1
DJI,Djibouti,ESP,Spain,2017,0,2,-2
DMA,Dominica,DNK,Denmark,2010,0,1,-1
DMA,Dominica,NZL,New Zealand,2010,0,0,0
DOM,Dominican Republic,AUS,Australia,2016,0,0,0
DOM,Dominican Republic,NZL,New Zealand,2017,0,3,-3
SLV,El Salvador,CZE,Czech Republic,2016,0,2,-2
GNQ,Equatorial Guinea,AUS,Australia,2008,0,0,0
ERI,Eritrea,CZE,Czech Republic,2013,0,1,-1
FJI,Fiji,NLD,Netherlands,2010,0,3,-3
GAB,Gabon,AUS,Australia,2016,0,0,0
GAB,Gabon,DNK,Denmark,2011,0,1,-1
GAB,Gabon,NZL,New Zealand,2008,0,0,0
GMB,Gambia,AUS,Australia,2016,0,0,0
GMB,Gambia,NZL,New Zealand,2017,0,2,-2
GEO,Georgia,NZL,New Zealand,2014,0,1,-1
GRD,Grenada,BEL,Belgium,2014,0,2,-2
GRD,Grenada,ITA,Italy,2014,0,0,0
GRD,Grenada,ITA,Italy,2017,0,1,-1
GRD,Grenada,NZL,New Zealand,2011,0,1,-1
GRD,Grenada,NZL,New Zealand,2015,0,1,-1
GRD,Grenada,NZL,New Zealand,2016,0,1,-1
GUM,Guam,AUS,Australia,2008,0,5,-5
GUM,Guam,ITA,Italy,2014,0,0,0
GUM,Guam,ITA,Italy,2015,0,0,0
GUM,Guam,NZL,New Zealand,2009,0,0,0
GUM,Guam,NZL,New Zealand,2010,0,0,0
GUM,Guam,NZL,New Zealand,2012,0,0,0
GUM,Guam,CHE,Switzerland,2016,0,0,0
GTM,Guatemala,SVK,Slovak Republic,2009,0,1,-1
GIN,Guinea,SVN,Slovenia,2011,0,1,-1
GNB,Guinea-Bissau,AUS,Australia,2016,0,0,0
GNB,Guinea-Bissau,CZE,Czech Republic,2013,0,1,-1
GNB,Guinea-Bissau,CZE,Czech Republic,2014,0,1,-1
GNB,Guinea-Bissau,CZE,Czech Republic,2015,0,1,-1
GNB,Guinea-Bissau,NZL,New Zealand,2009,0,0,0
GUY,Guyana,AUS,Australia,2016,0,0,0
GUY,Guyana,CZE,Czech Republic,2013,0,1,-1
GUY,Guyana,CZE,Czech Republic,2014,0,1,-1
GUY,Guyana,DNK,Denmark,2011,0,2,-2
GUY,Guyana,NZL,New Zealand,2014,0,1,-1
GUY,Guyana,SVN,Slovenia,2011,0,1,-1
HTI,Haiti,AUS,Australia,2016,0,0,0
HTI,Haiti,CZE,Czech Republic,2015,0,2,-2
HTI,Haiti,NZL,New Zealand,2008,0,1,-1
HTI,Haiti,NZL,New Zealand,2015,0,1,-1
HND,Honduras,AUS,Australia,2016,0,0,0
HND,Honduras,NZL,New Zealand,2009,0,0,0
HKG,"Hong Kong, China",ITA,Italy,2015,0,0,0
HKG,"Hong Kong, China",NLD,Netherlands,2014,0,0,0
HKG,"Hong Kong, China",SVK,Slovak Republic,2014,0,1,-1
HKG,"Hong Kong, China",CHE,Switzerland,2016,0,0,0
HKG,"Hong Kong, China",GBR,United Kingdom,2009,0,2000,-2000
IDN,Indonesia,SVN,Slovenia,2014,0,1,-1
IRN,Iran,GBR,United Kingdom,2015,0,1000,-1000
JOR,Jordan,GBR,United Kingdom,2012,0,1000,-1000
JOR,Jordan,SVN,Slovenia,2015,0,1,-1
KEN,Kenya,SVN,Slovenia,2014,0,1,-1
KIR,Kiribati,NLD,Netherlands,2014,0,0,0
KIR,Kiribati,SVK,Slovak Republic,2009,0,1,-1
KGZ,Kyrgyzstan,NLD,Netherlands,2008,0,8,-8
KGZ,Kyrgyzstan,NLD,Netherlands,2011,0,8,-8
KGZ,Kyrgyzstan,NLD,Netherlands,2012,0,9,-9
LAO,Laos,CZE,Czech Republic,2014,0,3,-3
LAO,Laos,CZE,Czech Republic,2015,0,1,-1
LAO,Laos,DNK,Denmark,2011,0,1,-1
LSO,Lesotho,BEL,Belgium,2012,0,1,-1
LSO,Lesotho,DNK,Denmark,2010,0,1,-1
LSO,Lesotho,NZL,New Zealand,2008,0,4,-4
LSO,Lesotho,NZL,New Zealand,2009,0,1,-1
LBR,Liberia,NZL,New Zealand,2011,0,1,-1
LBY,Libya,NZL,New Zealand,2009,0,0,0
LBY,Libya,GBR,United Kingdom,2015,0,1000,-1000
LBY,Libya,SVN,Slovenia,2012,0,1,-1
LIE,Liechtenstein,CZE,Czech Republic,2009,0,1,-1
LIE,Liechtenstein,CZE,Czech Republic,2013,0,4,-4
LIE,Liechtenstein,DNK,Denmark,2011,0,3,-3
LIE,Liechtenstein,ITA,Italy,2014,0,1,-1
LIE,Liechtenstein,NZL,New Zealand,2011,0,1,-1
LIE,Liechtenstein,NZL,New Zealand,2014,0,1,-1
MAC,Macau,ITA,Italy,2014,0,0,0
MAC,Macau,ITA,Italy,2015,0,0,0
MAC,Macau,NLD,Netherlands,2014,0,0,0
MAC,Macau,SWE,Sweden,2008,0,0,0
MAC,Macau,SWE,Sweden,2009,0,0,0
MAC,Macau,CHE,Switzerland,2016,0,0,0
MKD,North Macedonia,ITA,Italy,2008,0,312,-312
MKD,North Macedonia,ITA,Italy,2009,0,387,-387
MKD,North Macedonia,ITA,Italy,2010,0,552,-552
MKD,North Macedonia,ITA,Italy,2011,0,471,-471
MKD,North Macedonia,ITA,Italy,2012,0,649,-649
MKD,North Macedonia,ITA,Italy,2013,0,821,-821
MKD,North Macedonia,ITA,Italy,2014,0,0,0
MKD,North Macedonia,ITA,Italy,2015,0,824,-824
MKD,North Macedonia,NLD,Netherlands,2008,0,35,-35
MDG,Madagascar,CZE,Czech Republic,2013,0,1,-1
MDG,Madagascar,CZE,Czech Republic,2015,0,1,-1
MDG,Madagascar,NZL,New Zealand,2009,0,1,-1
MDG,Madagascar,NZL,New Zealand,2014,0,1,-1
MWI,Malawi,GBR,United Kingdom,2011,0,1000,-1000
MWI,Malawi,GBR,United Kingdom,2012,0,1000,-1000
MDV,Maldives,ITA,Italy,2014,0,0,0
MDV,Maldives,NLD,Netherlands,2009,0,-1,1
MDV,Maldives,NLD,Netherlands,2010,0,2,-2
MLI,Mali,CZE,Czech Republic,2013,0,1,-1
MLI,Mali,DNK,Denmark,2011,0,2,-2
MLT,Malta,CZE,Czech Republic,2010,0,2,-2
MLT,Malta,NZL,New Zealand,2008,0,0,0
MHL,Marshall Islands,AUS,Australia,2016,0,0,0
MHL,Marshall Islands,NLD,Netherlands,2014,0,0,0
MHL,Marshall Islands,NZL,New Zealand,2013,0,5,-5
MHL,Marshall Islands,NZL,New Zealand,2014,0,1,-1
MHL,Marshall Islands,CHE,Switzerland,2016,0,0,0
MRT,Mauritania,DNK,Denmark,2010,0,1,-1
FSM,Micronesia,DNK,Denmark,2014,0,0,0
FSM,Micronesia,ITA,Italy,2014,0,2,-2
FSM,Micronesia,ITA,Italy,2015,0,0,0
FSM,Micronesia,NZL,New Zealand,2011,0,2,-2
FSM,Micronesia,CHE,Switzerland,2016,0,0,0
MCO,Monaco,AUS,Australia,2016,0,0,0
MCO,Monaco,BEL,Belgium,2012,0,1,-1
MCO,Monaco,BEL,Belgium,2015,0,1,-1
MAR,Morocco,SVK,Slovak Republic,2017,0,1,-1
NRU,Nauru,CHE,Switzerland,2016,0,0,0
NPL,Nepal,SVK,Slovak Republic,2017,0,1,-1
NIC,Nicaragua,SVK,Slovak Republic,2011,0,1,-1
NER,Niger,AUS,Australia,2016,0,0,0
NER,Niger,DNK,Denmark,2011,0,1,-1
NER,Niger,SVK,Slovak Republic,2011,0,1,-1
NGA,Nigeria,SVN,Slovenia,2012,0,3,-3
NIU,Niue,AUS,Australia,2008,0,0,0
NIU,Niue,ITA,Italy,2008,0,0,0
NIU,Niue,ITA,Italy,2009,0,0,0
NIU,Niue,ITA,Italy,2010,0,0,0
NIU,Niue,ITA,Italy,2011,0,0,0
NIU,Niue,ITA,Italy,2012,0,0,0
NIU,Niue,ITA,Italy,2014,0,0,0
NIU,Niue,ITA,Italy,2015,0,0,0
NIU,Niue,NZL,New Zealand,2008,0,0,0
NIU,Niue,NZL,New Zealand,2010,0,0,0
NIU,Niue,NZL,New Zealand,2011,0,0,0
NIU,Niue,NZL,New Zealand,2012,0,0,0
NIU,Niue,CHE,Switzerland,2016,0,0,0
PLW,Palau,ITA,Italy,2014,0,0,0
PLW,Palau,CHE,Switzerland,2016,0,0,0
PSE,West Bank and Gaza Strip,CHE,Switzerland,2016,0,0,0
PAN,Panama,AUS,Australia,2016,0,0,0
PAN,Panama,NZL,New Zealand,2015,0,2,-2
PAN,Panama,GBR,United Kingdom,2015,0,1000,-1000
PNG,Papua New Guinea,BEL,Belgium,2012,0,1,-1
PNG,Papua New Guinea,BEL,Belgium,2013,0,1,-1
PNG,Papua New Guinea,BEL,Belgium,2015,0,1,-1
PNG,Papua New Guinea,DNK,Denmark,2010,0,1,-1
PNG,Papua New Guinea,NLD,Netherlands,2012,0,2,-2
PRY,Paraguay,CZE,Czech Republic,2017,0,4,-4
PRY,Paraguay,NZL,New Zealand,2017,0,4,-4
PRI,Puerto Rico,AUS,Australia,2008,0,0,0
PRI,Puerto Rico,ITA,Italy,2014,0,0,0
PRI,Puerto Rico,ITA,Italy,2015,0,0,0
PRI,Puerto Rico,CHE,Switzerland,2016,0,0,0
QAT,Qatar,AUS,Australia,2016,0,0,0
QAT,Qatar,DNK,Denmark,2011,0,1,-1
QAT,Qatar,NZL,New Zealand,2008,0,0,0
QAT,Qatar,NZL,New Zealand,2010,0,0,0
QAT,Qatar,NZL,New Zealand,2011,0,1,-1
QAT,Qatar,NZL,New Zealand,2016,0,1,-1
RUS,Russia,NLD,Netherlands,2008,0,370,-370
RWA,Rwanda,SVK,Slovak Republic,2017,0,1,-1
KNA,Saint Kitts and Nevis,AUS,Australia,2016,0,0,0
KNA,Saint Kitts and Nevis,BEL,Belgium,2017,0,4,-4
KNA,Saint Kitts and Nevis,ITA,Italy,2014,0,0,0
KNA,Saint Kitts and Nevis,NLD,Netherlands,2011,0,1,-1
KNA,Saint Kitts and Nevis,NLD,Netherlands,2014,0,1,-1
KNA,Saint Kitts and Nevis,NZL,New Zealand,2014,0,1,-1
KNA,Saint Kitts and Nevis,NZL,New Zealand,2015,0,2,-2
LCA,Saint Lucia,NLD,Netherlands,2010,0,1,-1
LCA,Saint Lucia,NZL,New Zealand,2008,0,4,-4
LCA,Saint Lucia,NZL,New Zealand,2011,0,3,-3
LCA,Saint Lucia,NZL,New Zealand,2015,0,2,-2
VCT,Saint Vincent and the Grenadines,AUS,Australia,2016,0,0,0
VCT,Saint Vincent and the Grenadines,BEL,Belgium,2014,0,1,-1
VCT,Saint Vincent and the Grenadines,CZE,Czech Republic,2012,0,1,-1
VCT,Saint Vincent and the Grenadines,ITA,Italy,2014,0,0,0
VCT,Saint Vincent and the Grenadines,NZL,New Zealand,2014,0,1,-1
WSM,Samoa,CZE,Czech Republic,2012,0,1,-1
SMR,San Marino,BEL,Belgium,2013,0,1,-1
SMR,San Marino,NZL,New Zealand,2008,0,1,-1
SMR,San Marino,CHE,Switzerland,2011,0,1,-1
STP,Sao Tome and Principe,CZE,Czech Republic,2013,0,1,-1
STP,Sao Tome and Principe,ITA,Italy,2014,0,0,0
STP,Sao Tome and Principe,NLD,Netherlands,2014,0,-1,1
SAU,Saudi Arabia,DNK,Denmark,2011,0,3,-3
SCG,Serbia and Montenegro,ITA,Italy,2008,0,0,0
SCG,Serbia and Montenegro,ITA,Italy,2009,0,0,0
SCG,Serbia and Montenegro,ITA,Italy,2010,0,0,0
SCG,Serbia and Montenegro,ITA,Italy,2011,0,0,0
SCG,Serbia and Montenegro,ITA,Italy,2012,0,0,0
SCG,Serbia and Montenegro,ITA,Italy,2013,0,0,0
SCG,Serbia and Montenegro,ITA,Italy,2014,0,0,0
SCG,Serbia and Montenegro,ITA,Italy,2015,0,0,0
SCG,Serbia and Montenegro,NLD,Netherlands,2008,0,34,-34
SCG,Serbia and Montenegro,NLD,Netherlands,2009,0,16,-16
SCG,Serbia and Montenegro,NLD,Netherlands,2010,0,16,-16
SCG,Serbia and Montenegro,NLD,Netherlands,2011,0,11,-11
SCG,Serbia and Montenegro,NLD,Netherlands,2014,0,1,-1
SCG,Serbia and Montenegro,SVK,Slovak Republic,2009,0,3,-3
SCG,Serbia and Montenegro,SVK,Slovak Republic,2010,0,2,-2
SCG,Serbia and Montenegro,SVK,Slovak Republic,2011,0,1,-1
SCG,Serbia and Montenegro,CHE,Switzerland,2016,0,0,0
SCG,Serbia and Montenegro,SVN,Slovenia,2011,0,2,-2
SCG,Serbia and Montenegro,SVN,Slovenia,2012,0,2,-2
SCG,Serbia and Montenegro,SVN,Slovenia,2013,0,16,-16
SCG,Serbia and Montenegro,SVN,Slovenia,2014,0,10,-10
SCG,Serbia and Montenegro,SVN,Slovenia,2015,0,5,-5
SCG,Serbia and Montenegro,SVN,Slovenia,2016,0,8,-8
SCG,Serbia and Montenegro,SVN,Slovenia,2017,0,21,-21
SYC,Seychelles,NLD,Netherlands,2011,0,1,-1
SLE,Sierra Leone,CZE,Czech Republic,2013,0,2,-2
SLE,Sierra Leone,NZL,New Zealand,2012,0,2,-2
SLE,Sierra Leone,NZL,New Zealand,2015,0,3,-3
SLE,Sierra Leone,NZL,New Zealand,2017,0,2,-2
SLE,Sierra Leone,SVK,Slovak Republic,2009,0,1,-1
SLE,Sierra Leone,SVN,Slovenia,2013,0,1,-1
SRB,Serbia,NLD,Netherlands,2008,0,19,-19
SRB,Serbia,NLD,Netherlands,2009,0,30,-30
SLB,Solomon Islands,BEL,Belgium,2013,0,4,-4
SLB,Solomon Islands,BEL,Belgium,2016,0,1,-1
SLB,Solomon Islands,ITA,Italy,2014,0,0,0
SOM,Somalia,CZE,Czech Republic,2013,0,4,-4
ZAF,South Africa,GBR,United Kingdom,2010,0,4000,-4000
SUR,Suriname,AUS,Australia,2016,0,0,0
SWZ,Swaziland,BEL,Belgium,2017,0,2,-2
SWZ,Swaziland,DNK,Denmark,2011,0,2,-2
SWZ,Swaziland,NLD,Netherlands,2012,0,4,-4
SWZ,Swaziland,NLD,Netherlands,2014,0,1,-1
SWZ,Swaziland,NZL,New Zealand,2008,0,1,-1
SWZ,Swaziland,NZL,New Zealand,2009,0,0,0
SWZ,Swaziland,NZL,New Zealand,2011,0,1,-1
TWN,Chinese Taipei,SVN,Slovenia,2011,0,1,-1
TJK,Tajikistan,AUS,Australia,2016,0,0,0
TJK,Tajikistan,NLD,Netherlands,2008,0,1,-1
TJK,Tajikistan,SVK,Slovak Republic,2014,0,2,-2
TLS,Timor-Leste,CHE,Switzerland,2016,0,0,0
TKL,Tokelau,AUS,Australia,2008,0,0,0
TKL,Tokelau,ITA,Italy,2014,0,0,0
TKL,Tokelau,NZL,New Zealand,2010,0,0,0
TKL,Tokelau,NZL,New Zealand,2011,0,0,0
TKL,Tokelau,NZL,New Zealand,2012,0,0,0
TKL,Tokelau,NZL,New Zealand,2013,0,1,-1
TKL,Tokelau,CHE,Switzerland,2016,0,0,0
TON,Tonga,DNK,Denmark,2010,0,5,-5
TTO,Trinidad and Tobago,NLD,Netherlands,2009,0,5,-5
TUN,Tunisia,SVN,Slovenia,2012,0,3,-3
TKM,Turkmenistan,AUS,Australia,2016,0,0,0
TKM,Turkmenistan,BEL,Belgium,2012,0,4,-4
TKM,Turkmenistan,BEL,Belgium,2014,0,1,-1
TKM,Turkmenistan,NLD,Netherlands,2008,0,1,-1
TKM,Turkmenistan,NZL,New Zealand,2009,0,1,-1
TUV,Tuvalu,AUS,Australia,2016,0,0,0
TUV,Tuvalu,ITA,Italy,2014,0,0,0
TUV,Tuvalu,CHE,Switzerland,2016,0,0,0
ARE,United Arab Emirates,CZE,Czech Republic,2014,0,2,-2
ARE,United Arab Emirates,DNK,Denmark,2011,0,1,-1
ARE,United Arab Emirates,SVN,Slovenia,2016,0,1,-1
URY,Uruguay,CZE,Czech Republic,2017,0,3,-3
VUT,Vanuatu,ITA,Italy,2014,0,0,0
VUT,Vanuatu,NLD,Netherlands,2009,0,1,-1
VUT,Vanuatu,NLD,Netherlands,2012,0,1,-1
VUT,Vanuatu,CHE,Switzerland,2016,0,0,0
UGA,Uganda,SVK,Slovak Republic,2011,0,1,-1
TON,Tonga,CHE,Switzerland,2015,0,0,0
TON,Tonga,CHE,Switzerland,2016,0,0,0
URY,Uruguay,SVK,Slovak Republic,2011,0,1,-1
LCA,Saint Lucia,AUS,Australia,2016,0,0,0
VUT,Vanuatu,CZE,Czech Republic,2014,0,1,-1
MNE,Montenegro,NLD,Netherlands,2009,0,3,-3
TTO,Trinidad and Tobago,CZE,Czech Republic,2014,0,1,-1
TON,Tonga,NLD,Netherlands,2008,0,1,-1
TGO,Togo,AUS,Australia,2016,0,0,0
UZB,Uzbekistan,CHE,Switzerland,2014,0,28,-28
LCA,Saint Lucia,BEL,Belgium,2012,0,2,-2
LCA,Saint Lucia,BEL,Belgium,2014,0,1,-1
UZB,Uzbekistan,NLD,Netherlands,2008,0,16,-16
VUT,Vanuatu,BEL,Belgium,2015,0,1,-1
TGO,Togo,DNK,Denmark,2011,0,5,-5
MNE,Montenegro,NZL,New Zealand,2013,0,1,-1
